GEOID20,Tot_2018_ag,D_2018_ag,R_2018_ag,Tot_2018_gov,D_2018_gov,R_2018_gov,Tot_2018_ltg,D_2018_ltg,R_2018_ltg,Tot_2020_sen,D_2020_sen,R_2020_sen,Tot_2021_sen_sproff,D_2021_sen_sproff,R_2021_sen_sproff,Tot_2020_sen_spec,D_2020_sen_spec,R_2020_sen_spec,Tot_2020_pres,D_2020_pres,R_2020_pres,Tot_2021_sen_roff,D_2021_sen_roff,R_2021_sen_roff,Tot_2016_pres,D_2016_pres,R_2016_pres,Tot_2016_sen,D_2016_sen,R_2016_sen
13091000LEE,2640,941,1699,2764,1002,1751,2565,917,1648,3127,1088,1973,2782,1110,1672,3097,1114,1924,3180,1194,1961,2782,1098,1684,2741,979,1691,2510,755,1678
130910RAWLI,550,134,416,564,128,435,524,118,406,647,148,487,552,138,414,635,148,474,650,163,481,551,137,414,573,125,439,532,109,406
130910MITCH,235,47,188,250,52,198,230,46,184,272,52,215,248,54,194,267,54,208,278,55,220,247,53,194,238,56,181,219,38,175
130910EDDIN,639,192,447,664,195,466,618,187,431,768,231,527,712,220,492,767,232,526,776,235,540,710,220,490,648,195,439,586,150,418
130910MULLI,281,63,218,298,65,232,280,69,211,357,72,276,332,71,261,353,71,276,367,75,290,332,70,262,307,70,231,285,45,235
130910PLAIN,283,34,249,294,26,268,280,25,255,335,37,297,319,40,279,335,40,291,339,38,299,319,39,280,294,33,257,272,25,241
1315300ROZR,7852,2694,5158,7973,2688,5218,7591,2524,5067,9894,3390,6311,8891,3249,5642,9839,3404,6241,9977,3553,6311,8902,3238,5664,7631,2475,4961,7183,2053,4934
1315300HEFS,854,300,554,868,301,564,832,287,545,1041,343,683,976,330,646,1037,348,676,1051,362,678,973,325,648,794,282,502,744,251,479
1315300RECR,3960,3121,839,4079,3237,814,3779,2976,803,4953,3706,1084,4318,3479,839,4970,3806,1063,5033,3879,1089,4310,3464,846,4277,3188,984,3924,2698,1093
13153000VHS,3417,975,2442,3474,972,2467,3377,959,2418,4775,1515,3157,4388,1476,2912,4734,1526,3126,4803,1578,3164,4393,1470,2923,3390,899,2402,3215,739,2358
13153000BMS,5745,1792,3953,5807,1796,3954,5643,1761,3882,7555,2562,4826,6806,2516,4290,7498,2594,4769,7619,2684,4810,6807,2493,4314,5528,1499,3874,5300,1275,3821
1315300HHPC,4767,2435,2332,4861,2420,2394,4617,2334,2283,5959,2982,2802,5244,2836,2408,5946,3037,2773,6024,3109,2822,5240,2827,2413,5254,2351,2740,4948,2005,2755
1305900006A,1860,982,878,1901,993,887,1834,943,891,2670,1399,1188,2456,1364,1092,2661,1402,1208,2704,1453,1211,2457,1348,1109,1865,947,845,1805,822,929
13269000005,1320,197,1123,1353,183,1162,1279,186,1093,1606,233,1342,1440,240,1200,1588,236,1326,1627,252,1364,1437,242,1195,1409,204,1186,1322,192,1088
13319000010,1172,625,547,1229,645,579,1137,603,534,1238,641,578,1145,629,516,1231,655,562,1258,667,585,1140,623,517,1214,629,570,1112,526,567
13209000005,823,336,487,859,358,494,825,339,486,942,363,561,835,372,463,920,375,526,960,406,545,831,364,467,879,367,499,814,297,496
13209000001,303,90,213,318,91,224,305,81,224,341,93,244,314,90,224,329,86,241,343,97,244,313,87,226,311,90,220,295,66,223
13161000402,375,30,345,389,20,368,371,24,347,475,33,439,435,23,412,466,30,427,480,29,451,435,23,412,434,38,387,396,31,352
13209000007,548,143,405,578,142,433,550,129,421,616,169,435,568,152,416,600,166,425,623,160,461,566,151,415,608,148,454,534,113,403
13185000001,2911,537,2374,2955,540,2392,2855,531,2324,3936,830,3030,3474,737,2737,3857,782,2999,3969,854,3073,3479,739,2740,3074,577,2431,2897,513,2289
13153000TMS,2765,1585,1180,2798,1601,1183,2709,1550,1159,3591,2038,1457,3158,1918,1240,3594,2076,1447,3644,2099,1495,3154,1901,1253,2877,1496,1294,2728,1311,1317
13071000008,709,64,645,731,52,673,668,53,615,893,100,781,814,88,726,894,93,794,896,99,795,811,88,723,776,76,689,732,60,654
13183000002,1086,373,713,1114,366,742,1078,369,709,1676,598,1026,1396,518,878,1662,589,1014,1692,601,1060,1397,519,878,1110,332,739,1058,290,708
13015000003,3253,1139,2114,3330,1137,2163,3291,1146,2145,4348,1479,2754,3741,1371,2370,4341,1510,2724,4382,1520,2797,3739,1354,2385,3510,1080,2301,3338,942,2234
13015000016,2643,976,1667,2709,983,1697,2666,984,1682,3745,1283,2346,3092,1184,1908,3708,1274,2313,3815,1320,2431,3094,1165,1929,2928,940,1880,2746,827,1765
13015000005,5488,1424,4064,5592,1397,4136,5523,1417,4106,7473,1888,5385,6286,1710,4576,7411,1903,5326,7535,1943,5494,6288,1675,4613,5976,1349,4451,5697,1203,4208
13015000011,2106,533,1573,2151,509,1626,2131,521,1610,2779,703,2012,2382,666,1716,2730,687,1974,2789,707,2057,2383,660,1723,2323,464,1801,2214,414,1676
1315300FMMS,5207,2244,2963,5285,2278,2943,5112,2223,2889,6482,2883,3453,5750,2799,2951,6454,2905,3412,6523,2984,3441,5749,2779,2970,5393,2101,3107,5171,1815,3153
1315300NSES,1483,538,945,1505,535,955,1446,525,921,1778,651,1082,1633,638,995,1783,666,1087,1793,669,1106,1637,638,999,1540,518,994,1467,443,976
1315300CENT,4222,1699,2523,4281,1678,2561,4130,1652,2478,5527,2300,3094,4898,2203,2695,5498,2300,3092,5582,2360,3143,4895,2190,2705,4450,1522,2798,4195,1315,2710
13015000014,1519,143,1376,1556,132,1411,1533,142,1391,2079,209,1830,1817,185,1632,2051,204,1800,2092,206,1861,1816,182,1634,1677,159,1482,1582,156,1350
13183000006,154,35,119,163,32,130,150,35,115,207,37,167,170,26,144,203,34,168,210,33,174,170,26,144,169,31,132,161,32,124
13185000009,2108,401,1707,2139,403,1720,2062,385,1677,2779,625,2107,2414,535,1879,2710,571,2074,2802,624,2154,2415,535,1880,2157,437,1682,2008,382,1554
13185000003,12595,6852,5743,12820,7059,5680,12203,6600,5603,16021,8632,7011,13928,7865,6063,15846,8516,6930,16258,9135,6911,13919,7849,6070,13670,7148,6179,12804,6139,6180
13185000006,1664,1436,228,1707,1501,200,1555,1344,211,2095,1726,326,1835,1596,239,2085,1735,298,2142,1831,302,1830,1593,237,1876,1627,232,1703,1415,254
13185000005,5054,1610,3444,5139,1662,3440,4937,1583,3354,6501,2280,4103,5668,2055,3613,6400,2188,4055,6565,2395,4096,5667,2059,3608,5344,1605,3590,5066,1360,3502
13185000007,2177,621,1556,2219,621,1584,2124,576,1548,2946,778,2113,2552,704,1848,2911,750,2096,2981,806,2146,2553,712,1841,2375,661,1669,2217,589,1544
13275000115,625,103,522,644,108,533,616,101,515,827,146,669,711,133,578,812,138,658,836,149,684,706,132,574,721,120,591,660,107,523
1305900007C,1832,1106,726,1856,1165,672,1819,1123,696,2054,1248,758,1877,1214,663,2036,1257,725,2051,1344,665,1880,1194,686,1825,1075,637,1857,890,869
13173000001,2569,738,1831,2681,762,1910,2488,677,1811,3519,944,2481,3036,910,2126,3428,918,2409,3576,1019,2509,3032,905,2127,2863,806,1984,2574,661,1792
13263000008,675,430,245,696,438,253,656,407,249,822,480,330,759,476,283,815,480,324,824,488,330,759,478,281,754,464,275,716,399,293
13133000008,4615,796,3819,4657,821,3809,4556,787,3769,6131,1207,4847,6009,1272,4737,6107,1251,4801,6160,1421,4689,6015,1228,4787,4291,798,3409,4220,582,3562
13133000001,2359,1246,1113,2410,1278,1122,2278,1180,1098,2793,1437,1312,2573,1406,1167,2782,1450,1296,2816,1501,1287,2578,1403,1175,2612,1404,1165,2471,1195,1226
13263000002,478,228,250,487,228,257,460,208,252,558,273,282,524,272,252,558,273,273,561,289,272,525,273,252,526,277,243,481,219,240
13133000004,1029,539,490,1049,546,498,964,497,467,1279,649,609,1136,623,513,1276,663,595,1296,673,614,1133,617,516,1062,533,511,1000,455,530
13133000005,603,319,284,622,324,296,577,292,285,696,352,336,648,340,308,692,363,323,708,368,338,647,338,309,627,342,280,585,288,289
13133000006,253,123,130,257,124,131,237,113,124,263,118,143,247,117,130,266,123,141,267,125,140,247,117,130,248,122,125,238,105,128
1315300MCMS,5296,1930,3366,5372,1986,3330,5221,1927,3294,6962,2596,4227,6298,2524,3774,6901,2607,4155,7018,2713,4203,6302,2519,3783,5238,1733,3345,4977,1448,3349
1305900002A,1773,1470,303,1845,1525,302,1678,1373,305,2333,1808,465,2083,1735,348,2326,1822,452,2358,1867,460,2082,1723,359,1928,1561,325,1770,1346,377
1305900001A,1492,893,599,1531,906,604,1455,862,593,1933,1156,709,1739,1114,625,1925,1159,702,1944,1202,714,1738,1099,639,1613,937,618,1538,787,678
1305900005C,1457,1275,182,1473,1308,151,1446,1280,166,1594,1385,188,1550,1381,169,1590,1373,190,1598,1421,158,1552,1377,175,1439,1245,155,1432,1137,225
1305900005D,1437,1054,383,1482,1106,357,1387,1017,370,1879,1373,457,1674,1302,372,1863,1392,430,1896,1430,430,1674,1298,376,1483,1113,325,1400,972,374
1315300ANNX,2864,922,1942,2906,926,1953,2809,895,1914,3446,1168,2198,3101,1133,1968,3419,1174,2170,3457,1220,2177,3099,1127,1972,3146,889,2154,3010,760,2137
13273000001,1635,1226,409,1695,1298,391,1569,1165,404,1871,1366,477,1765,1376,389,1869,1370,454,1892,1434,439,1765,1373,392,1836,1395,427,1690,1130,530
13015000004,4290,1219,3071,4349,1246,3054,4313,1234,3079,5827,1638,4043,5128,1569,3559,5778,1694,3976,5869,1774,4034,5130,1534,3596,4243,1192,2936,4079,982,2916
13015000018,872,215,657,890,209,673,872,207,665,1289,297,959,1100,286,814,1278,298,934,1297,302,974,1102,287,815,841,149,669,813,138,626
13015000009,761,96,665,785,73,705,767,82,685,1006,107,877,912,109,803,996,113,863,1018,113,897,911,104,807,774,60,698,727,67,622
13015000015,1455,227,1228,1481,194,1270,1471,203,1268,1939,271,1625,1717,254,1463,1916,266,1613,1955,275,1648,1715,248,1467,1583,205,1329,1518,199,1232
13071000016,257,24,233,259,17,241,251,17,234,305,26,274,264,26,238,305,27,271,310,27,281,264,26,238,278,27,245,270,24,236
13071000023,527,54,473,550,53,495,517,51,466,662,73,581,570,62,508,658,76,575,679,84,594,571,64,507,569,69,494,517,52,451
13015000007,1546,299,1247,1588,292,1282,1561,303,1258,2015,396,1569,1780,374,1406,2003,401,1568,2027,415,1583,1779,365,1414,1750,294,1400,1667,255,1307
13071000001,1187,893,294,1243,947,292,1090,802,288,1556,1097,433,1364,1041,323,1551,1118,407,1590,1152,429,1365,1044,321,1426,1089,317,1249,836,379
13071000015,514,71,443,528,66,459,488,57,431,667,103,556,573,87,486,664,102,550,669,108,558,578,87,491,568,75,483,535,71,458
1314100003B,398,329,69,419,355,61,365,306,59,478,366,99,441,357,84,472,364,100,482,381,96,440,355,85,433,375,54,402,309,84
13151000028,2926,2480,446,2989,2553,422,2794,2379,415,3763,3063,572,3147,2762,385,3752,3096,563,3812,3173,595,3144,2747,397,3218,2603,538,2957,2240,605
13161000202,797,34,763,829,23,801,811,34,777,953,45,897,848,36,812,934,42,882,961,43,913,851,38,813,877,43,820,800,43,738
131870000DA,11348,2301,9047,11558,2228,9157,11234,2214,9020,15363,2926,11941,13699,2868,10831,15324,2903,12019,15531,3126,12163,13697,2820,10877,12334,2220,9619,11924,1955,9197
13151000035,1374,951,423,1393,969,418,1323,906,417,1968,1418,520,1794,1363,431,1970,1433,500,1990,1451,522,1794,1359,435,1134,660,449,1066,586,449
13151000052,3131,1079,2052,3168,1084,2058,3066,1059,2007,3813,1523,2208,3509,1511,1998,3791,1548,2187,3837,1589,2217,3506,1496,2010,3193,965,2149,3030,810,2094
13275000110,1234,407,827,1250,426,813,1200,395,805,1472,522,929,1337,490,847,1448,499,920,1488,583,889,1339,494,845,1304,460,805,1260,370,854
13275000108,1296,278,1018,1312,272,1030,1253,262,991,1606,377,1194,1427,356,1071,1586,377,1163,1617,419,1183,1426,358,1068,1379,267,1075,1316,234,1033
13275000109,1085,817,268,1117,857,252,1015,753,262,1291,938,321,1182,898,284,1271,929,322,1311,999,300,1175,893,282,1218,918,282,1111,786,303
13185000002,5633,2562,3071,5712,2625,3042,5479,2492,2987,7652,3461,3950,6526,3149,3377,7559,3402,3896,7755,3646,3979,6531,3140,3391,5966,2425,3344,5599,2159,3182
13185000008,2261,362,1899,2304,353,1934,2223,355,1868,2903,483,2366,2594,439,2155,2846,452,2333,2933,497,2416,2593,442,2151,2427,353,2020,2248,322,1840
13003000001,920,129,791,951,115,833,884,105,779,1185,164,1008,1012,130,882,1145,160,962,1197,160,1026,1009,131,878,992,136,850,899,117,758
13003000002,398,32,366,418,26,392,383,28,355,517,46,461,458,31,427,496,41,443,527,45,479,458,32,426,408,29,375,366,34,321
13023000001,4712,1021,3691,4860,1002,3816,4646,979,3667,5644,1249,4281,5112,1214,3898,5613,1265,4257,5706,1311,4328,5110,1190,3920,4943,1101,3719,4768,923,3698
130050DOUGL,3700,515,3185,3830,489,3321,3586,468,3118,4590,591,3929,4131,559,3572,4512,577,3880,4668,625,4018,4128,559,3569,4019,608,3364,3615,474,3046
13175000022,1163,416,747,1200,420,775,1132,392,740,1416,531,861,1300,507,793,1397,530,853,1435,547,883,1301,505,796,1225,442,769,1141,381,733
13175000004,2670,1960,710,2779,2069,699,2562,1882,680,3268,2276,892,2854,2202,652,3269,2381,825,3323,2447,849,2852,2187,665,3001,2214,745,2760,1790,914
13093000002,398,198,200,420,212,207,387,180,207,447,212,229,410,207,203,438,209,225,448,215,230,409,206,203,449,233,212,405,185,213
13093000007,1610,764,846,1669,800,864,1514,705,809,1803,841,927,1646,821,825,1788,851,912,1828,885,926,1645,808,837,1681,840,829,1533,633,873
13027001402,620,301,319,637,319,315,601,291,310,753,374,367,685,349,336,733,370,349,762,395,363,684,349,335,672,347,316,615,290,307
13027001199,1847,1083,764,1924,1130,787,1784,1019,765,2281,1286,954,2017,1231,786,2214,1281,894,2340,1408,915,2016,1233,783,2237,1383,822,2036,1154,824
13027000660,1037,313,724,1053,315,735,989,284,705,1316,371,922,1189,360,829,1314,375,901,1334,399,925,1191,361,830,1136,370,755,1028,293,698
13151000061,2430,1328,1102,2479,1331,1127,2360,1259,1101,2999,1774,1156,2736,1707,1029,2993,1793,1143,3024,1828,1167,2734,1696,1038,2448,1229,1149,2330,1078,1168
13151000037,2115,555,1560,2164,556,1592,2094,546,1548,2700,809,1838,2442,809,1633,2685,801,1831,2722,861,1834,2438,812,1626,2160,465,1644,2065,381,1603
13161000301,351,85,266,369,82,284,348,83,265,488,107,366,408,91,317,477,101,363,497,111,381,409,92,317,391,91,291,348,68,266
13025000003,1688,202,1486,1723,171,1539,1634,174,1460,2513,276,2191,2151,250,1901,2457,259,2123,2548,267,2259,2155,248,1907,1924,210,1683,1763,216,1473
13151000030,3041,1597,1444,3093,1604,1467,2949,1535,1414,3801,2033,1673,3379,1961,1418,3782,2040,1658,3819,2067,1709,3379,1950,1429,3092,1390,1595,2904,1260,1540
13151000051,2710,1404,1306,2752,1423,1308,2645,1366,1279,3296,1797,1432,2994,1734,1260,3290,1814,1407,3329,1827,1466,2994,1720,1274,2706,1209,1430,2559,1063,1404
13275000117,407,79,328,415,85,329,407,74,333,492,85,400,423,74,349,486,79,398,493,90,401,423,72,351,440,83,348,406,73,317
13275000114,1202,265,937,1227,273,948,1179,264,915,1580,399,1150,1386,354,1032,1558,380,1142,1589,412,1159,1390,359,1031,1304,294,978,1224,243,933
13275000120,1522,506,1016,1547,540,996,1485,510,975,1921,728,1159,1757,682,1075,1892,701,1154,1936,752,1157,1756,682,1074,1638,531,1063,1562,457,1045
13185000004,742,252,490,758,260,496,722,237,485,939,309,614,846,302,544,931,305,609,950,329,614,846,300,546,739,231,488,684,208,457
13029000003,1291,273,1018,1328,260,1060,1259,255,1004,1846,395,1410,1563,366,1197,1815,394,1374,1856,393,1442,1564,364,1200,1485,383,1059,1413,333,1024
13237000101,1805,821,984,1845,829,1010,1767,776,991,2227,978,1213,2040,934,1106,2210,981,1189,2256,1004,1229,2040,929,1111,1916,875,1009,1797,737,1012
13161000100,658,328,330,693,354,337,655,323,332,809,383,407,724,390,334,809,392,400,824,408,406,723,385,338,750,366,374,660,288,358
13027001230,211,53,158,212,53,158,205,51,154,245,65,177,221,64,157,239,64,174,248,67,181,221,64,157,227,52,173,209,47,154
130750000DB,1365,297,1068,1386,306,1077,1318,276,1042,1661,402,1231,1480,371,1109,1642,384,1229,1672,404,1249,1480,372,1108,1416,280,1092,1345,261,1034
1307500000C,882,399,483,912,416,491,858,378,480,1157,476,650,1004,454,550,1156,492,630,1166,514,637,1007,457,550,962,455,494,867,354,477
13021000GF1,2829,2559,270,2934,2690,226,2713,2454,259,3291,2868,350,2876,2652,224,3290,2896,322,3342,2987,326,2865,2626,239,2945,2689,189,2703,2270,351
13021000GF3,1480,1336,144,1527,1392,129,1392,1261,131,1697,1480,177,1551,1436,115,1701,1512,167,1726,1543,175,1545,1429,116,1675,1507,153,1540,1265,230
13021000EM1,827,788,39,859,836,22,782,756,26,966,891,47,845,831,14,968,909,41,987,929,47,842,826,16,984,954,26,889,797,78
13021000VV2,1099,819,280,1133,843,279,1066,794,272,1232,899,306,1132,861,271,1234,909,293,1251,939,291,1133,857,276,1164,842,281,1109,717,340
13021000VV4,2038,1812,226,2090,1882,197,1950,1746,204,2324,1956,307,2102,1878,224,2322,2007,279,2348,2042,283,2099,1870,229,2198,1944,223,2013,1648,312
1304900005W,155,10,145,158,9,148,151,10,141,221,16,201,174,10,164,210,17,189,224,18,205,174,10,164,207,14,191,180,24,148
1304900003S,310,19,291,321,19,302,298,15,283,429,22,401,367,14,353,417,20,385,441,22,418,369,18,351,430,32,393,361,32,318
1304900005F,392,42,350,397,44,350,385,40,345,548,50,478,459,53,406,526,56,459,554,60,486,460,56,404,469,48,411,424,55,344
13049000002,1149,636,513,1192,657,525,1097,592,505,1541,769,723,1356,739,617,1480,750,683,1577,844,711,1361,739,622,1444,780,644,1234,632,561
13071000002,2284,790,1494,2365,824,1514,2225,754,1471,2956,1110,1797,2620,1049,1571,2933,1086,1798,2996,1169,1799,2618,1045,1573,2494,901,1522,2331,683,1566
131210SS08B,448,213,235,453,222,225,441,203,238,559,279,264,550,275,275,550,270,264,563,308,252,550,266,284,438,210,210,425,130,277
1312100008B,2214,872,1342,2244,969,1239,2200,916,1284,2778,1208,1520,2655,1193,1462,2745,1219,1463,2790,1444,1298,2653,1123,1530,2326,982,1221,2301,623,1574
1312100012N,311,298,13,324,316,8,308,294,14,426,397,17,419,409,10,419,392,16,425,402,18,416,404,12,373,359,8,353,321,22
1312100RW09,4138,1409,2729,4199,1484,2655,4100,1425,2675,5205,1914,3187,5040,1941,3099,5155,1913,3133,5224,2128,3025,5045,1880,3165,4348,1402,2756,4342,1027,3132
1312100RW01,3284,1287,1997,3338,1365,1923,3246,1302,1944,4210,1743,2375,3894,1702,2192,4173,1773,2310,4254,1928,2276,3895,1648,2247,3432,1253,2034,3374,937,2284
1312100MP01,324,168,156,329,174,149,321,169,152,385,183,188,372,191,181,383,186,185,386,193,186,370,187,183,339,163,156,324,142,158
1312100012J,1063,1033,30,1107,1091,14,1001,983,18,1395,1308,58,1296,1260,36,1406,1308,59,1420,1327,78,1296,1255,41,1246,1201,26,1144,1046,74
1312100HP01,1728,1284,444,1774,1293,462,1676,1230,446,2189,1570,543,2025,1551,474,2184,1597,526,2204,1622,556,2027,1544,483,1770,1205,495,1675,1049,538
1312100JC11,2027,864,1163,2055,910,1126,1988,845,1143,2664,1194,1408,2456,1145,1311,2641,1197,1387,2677,1297,1347,2457,1121,1336,2173,886,1210,2131,659,1369
1312100JC07,2598,1391,1207,2646,1462,1155,2570,1393,1177,3592,2037,1485,3384,2037,1347,3534,1994,1444,3629,2167,1424,3392,2011,1381,2738,1404,1226,2624,1069,1441
1312100JC09,1874,1083,791,1893,1119,748,1834,1063,771,2402,1367,983,2227,1324,903,2377,1344,964,2424,1436,957,2230,1324,906,1970,1066,815,1884,822,953
1322900003A,914,54,860,928,48,876,898,54,844,1211,92,1104,1035,79,956,1176,86,1071,1222,101,1113,1037,82,955,990,77,905,933,63,845
1300100003C,899,205,694,933,203,727,876,195,681,1122,281,819,1009,257,752,1109,262,831,1135,288,843,1007,257,750,1038,252,771,973,203,744
13273000005,388,126,262,393,125,267,368,121,247,449,148,298,418,141,277,442,146,293,453,154,298,418,140,278,404,136,266,387,112,266
13003000003,708,246,462,736,245,487,668,220,448,852,270,565,722,270,452,828,273,539,867,291,566,724,266,458,762,257,489,687,226,445
1305900003B,2294,1800,494,2348,1893,425,2264,1807,457,2282,1759,465,1945,1615,330,2261,1742,441,2308,1842,430,1942,1590,352,2878,2093,642,2795,1721,926
13263000005,497,391,106,544,436,104,467,370,97,620,474,135,557,457,100,614,477,127,644,517,123,554,451,103,600,488,106,521,375,134
13015000010,1380,217,1163,1412,206,1188,1392,213,1179,1859,267,1543,1632,285,1347,1853,290,1529,1882,305,1550,1631,272,1359,1510,223,1252,1437,217,1159
13273000003,510,235,275,532,249,279,498,220,278,575,262,309,542,259,283,570,263,298,582,273,306,544,258,286,540,251,282,514,214,291
13183000005,432,68,364,446,65,376,425,67,358,542,94,435,461,81,380,529,89,427,546,89,451,460,81,379,455,63,382,426,73,337
13123000009,944,155,789,962,149,803,933,154,779,1238,193,1025,1120,191,929,1226,194,1016,1249,227,1013,1120,188,932,977,151,803,914,127,737
13025000002,2023,223,1800,2099,194,1890,1987,201,1786,2755,249,2463,2422,233,2189,2639,247,2319,2807,268,2522,2426,234,2192,2326,274,2021,2094,258,1737
13025000001,1840,131,1709,1872,96,1769,1781,113,1668,2348,163,2158,2039,130,1909,2292,146,2104,2391,164,2210,2037,133,1904,2042,135,1863,1842,137,1634
13161000201,424,50,374,441,39,399,425,43,382,513,71,432,449,60,389,508,70,431,521,68,447,450,65,385,473,50,412,430,41,368
13123000010,903,164,739,932,149,769,892,161,731,1257,194,1026,1113,198,915,1226,187,1014,1282,215,1050,1112,196,916,948,154,763,886,119,712
13151000055,2261,810,1451,2292,812,1454,2232,789,1443,2777,1101,1622,2583,1093,1490,2755,1105,1604,2784,1111,1633,2585,1084,1501,2382,725,1579,2253,629,1539
13151000039,3681,3145,536,3738,3215,506,3536,3022,514,4313,3551,658,3852,3367,485,4316,3612,610,4359,3662,667,3851,3362,489,3574,2889,605,3385,2537,727
1322900004C,447,22,425,454,23,430,444,22,422,656,48,599,594,48,546,643,52,582,660,55,602,593,49,544,561,47,511,523,39,480
132250000C1,565,108,457,569,92,471,548,96,452,684,135,538,629,122,507,676,130,535,683,133,541,631,124,507,555,102,442,528,80,429
13303001488,1457,824,633,1515,882,632,1401,796,605,1726,980,716,1538,914,624,1701,983,699,1759,1024,726,1538,911,627,1539,880,641,1421,766,633
13029000008,2344,719,1625,2380,727,1633,2312,704,1608,3953,1347,2501,3585,1265,2320,3893,1291,2480,3992,1393,2528,3589,1274,2315,2011,515,1417,1929,399,1425
13029000006,1786,413,1373,1809,425,1362,1743,396,1347,2247,534,1658,2127,494,1633,2226,525,1649,2262,573,1654,2129,494,1635,2022,537,1402,1941,426,1425
13029000010,1280,313,967,1300,311,966,1250,304,946,1669,409,1194,1449,383,1066,1655,413,1190,1679,436,1214,1452,387,1065,1778,436,1273,1705,342,1278
13029FTSTEW,0,0,0,0,0,0,0,0,0,0,0,0,0,0,0,0,0,0,0,0,0,0,0,0,0,0,0,0,0,0
13029000004,837,349,488,848,362,476,816,347,469,1258,525,693,1109,503,606,1239,519,687,1272,535,716,1107,506,601,1028,272,715,983,219,715
13237000105,2337,360,1977,2384,345,2022,2337,356,1981,3037,493,2503,2906,515,2391,3015,498,2478,3051,558,2472,2905,498,2407,2336,376,1918,2268,315,1892
13263000004,286,175,111,302,176,125,273,150,123,368,208,155,329,195,134,371,213,153,377,217,158,329,195,134,347,215,129,318,175,133
13319000008,577,461,116,601,483,118,551,436,115,647,516,125,613,503,110,647,511,123,655,534,121,613,501,112,663,530,129,600,457,136
13319000005,534,307,227,555,318,237,516,293,223,642,345,283,600,343,257,648,347,292,658,360,295,597,341,256,547,301,237,511,266,233
13269000006,1288,495,793,1319,513,800,1253,477,776,1515,556,927,1398,566,832,1510,563,928,1531,580,935,1399,562,837,1337,543,779,1245,454,757
13209000002,339,37,302,347,34,312,337,31,306,372,49,317,342,44,298,360,47,309,374,48,325,342,44,298,333,36,293,311,30,278
13177000004,1862,505,1357,1900,512,1379,1816,479,1337,2243,651,1548,1940,621,1319,2226,660,1513,2273,677,1572,1940,624,1316,2015,460,1501,1907,413,1433
13177000005,726,119,607,736,114,621,724,117,607,972,176,784,904,165,739,966,170,784,977,174,794,902,163,739,756,128,613,733,117,598
131210EP04B,1193,1168,25,1202,1187,13,1152,1138,14,1545,1484,38,1435,1411,24,1546,1484,42,1555,1490,57,1433,1406,27,846,814,23,792,718,57
131210011E3,1810,1771,39,1833,1803,27,1752,1710,42,2052,1964,59,1874,1840,34,2060,1983,53,2065,1988,64,1874,1837,37,1772,1711,38,1700,1589,77
131210SC19B,669,638,31,687,664,21,644,616,28,829,773,33,763,743,20,831,784,32,831,786,37,764,742,22,720,696,23,675,601,61
1312100002J,1404,1201,203,1432,1271,143,1394,1224,170,1615,1379,199,1519,1346,173,1606,1357,202,1608,1412,163,1519,1328,191,2158,1844,220,2089,1570,396
1312100001T,780,714,66,796,739,53,761,703,58,889,794,76,839,780,59,886,776,72,886,808,67,839,771,68,764,695,49,728,611,80
131210CP051,849,811,38,871,843,27,818,778,40,970,917,33,923,903,20,967,921,33,971,921,43,922,904,18,926,877,39,873,778,80
1312100002G,2319,1994,325,2357,2103,223,2304,2005,299,2900,2426,408,2711,2320,391,2866,2373,405,2916,2523,349,2714,2283,431,2320,1968,247,2274,1617,495
13151000059,1888,756,1132,1927,748,1170,1835,702,1133,2737,1241,1437,2359,1168,1191,2730,1242,1425,2768,1263,1471,2360,1164,1196,1960,609,1299,1841,569,1193
13257000004,549,109,440,566,108,452,541,105,436,729,135,580,621,129,492,734,138,576,742,152,580,621,129,492,609,116,478,567,98,449
13257000001,2111,400,1711,2168,397,1752,2089,392,1697,2807,521,2229,2390,483,1907,2801,503,2237,2836,569,2233,2390,483,1907,2339,436,1843,2185,366,1741
13257000003,1477,279,1198,1512,277,1224,1462,272,1190,1958,364,1559,1676,348,1328,1929,346,1547,1982,399,1564,1675,347,1328,1625,307,1280,1533,255,1218
13257000008,1473,285,1188,1505,284,1209,1451,278,1173,1954,364,1552,1662,338,1324,1942,356,1542,1969,392,1553,1663,338,1325,1613,302,1270,1522,256,1202
13257000007,1147,224,923,1169,220,941,1128,216,912,1516,280,1202,1293,268,1025,1496,268,1199,1528,307,1204,1294,268,1026,1261,239,987,1178,199,938
13257000006,635,121,514,645,119,524,630,118,512,836,158,667,716,150,566,792,133,652,842,168,670,718,150,568,691,129,549,655,111,522
13257000002,1321,257,1064,1353,255,1088,1300,245,1055,1751,325,1392,1489,306,1183,1737,315,1390,1771,356,1392,1489,306,1183,1449,275,1138,1367,233,1080
13257000005,165,32,133,169,32,136,163,32,131,217,40,172,187,37,150,207,34,169,215,42,172,187,37,150,179,33,141,171,30,134
13119000003,1484,225,1259,1513,211,1290,1454,200,1254,2055,295,1731,1782,282,1500,2057,281,1741,2089,325,1750,1782,283,1499,1532,216,1276,1455,209,1181
13119000001,1355,135,1220,1375,132,1237,1318,132,1186,1765,183,1564,1514,162,1352,1739,172,1539,1776,193,1570,1513,161,1352,1380,144,1216,1295,139,1117
13119000004,1163,262,901,1192,257,924,1113,229,884,1581,336,1211,1344,300,1044,1578,340,1204,1596,382,1199,1348,306,1042,1284,294,963,1192,235,897
13119000005,665,88,577,681,80,596,650,80,570,910,112,780,791,95,696,897,100,776,925,110,805,794,98,696,706,86,608,643,90,530
1312500EDGH,85,8,77,89,7,82,82,8,74,118,11,107,113,12,101,118,10,107,120,11,109,113,12,101,96,6,90,89,14,74
132890000HV,474,131,343,492,119,371,453,107,346,554,145,401,500,145,355,555,149,401,562,151,410,501,144,357,494,138,342,454,123,314
13177000001,307,145,162,319,156,163,298,139,159,343,156,184,327,161,166,345,159,185,349,160,189,326,160,166,329,162,163,312,146,161
13177000003,410,52,358,421,49,371,407,46,361,491,64,421,453,64,389,485,64,415,493,65,425,453,62,391,435,42,387,427,49,370
1300100001B,753,93,660,779,78,698,734,78,656,973,133,824,855,96,759,972,110,850,988,115,866,854,100,754,783,92,682,728,81,633
1300100001C,517,48,469,542,40,501,510,43,467,634,45,583,579,42,537,627,41,581,646,46,598,579,41,538,546,42,499,516,45,458
13001000002,1111,711,400,1162,761,399,1045,664,381,1410,864,514,1242,818,424,1415,872,521,1447,907,531,1240,816,424,1179,742,427,1054,581,445
1300100004B,569,19,550,585,13,571,568,18,550,666,25,639,639,22,617,664,20,641,672,23,647,638,20,618,588,21,566,559,13,535
132250000B1,1623,458,1165,1662,444,1210,1602,438,1164,2013,581,1390,1794,576,1218,2006,577,1392,2034,600,1408,1795,572,1223,1696,443,1216,1610,392,1163
13303000088,348,158,190,371,169,200,335,150,185,425,198,224,402,194,208,421,195,221,437,208,227,400,192,208,378,174,201,352,146,202
13273000002,831,259,572,845,267,575,815,253,562,950,299,638,900,291,609,942,297,632,957,310,637,899,288,611,907,286,610,869,234,613
13071000019,1207,257,950,1235,252,977,1159,237,922,1600,366,1209,1392,340,1052,1582,375,1187,1613,372,1226,1390,335,1055,1312,279,1007,1237,235,964
13249000001,1874,356,1518,1933,353,1565,1860,345,1515,2256,439,1783,2056,438,1618,2226,440,1755,2275,462,1800,2058,435,1623,1909,401,1472,1828,345,1445
13275000111,419,177,242,430,185,243,391,153,238,586,231,343,502,209,293,574,222,339,587,239,344,503,209,294,515,246,267,462,188,261
13275000105,1112,913,199,1149,960,187,1064,878,186,1444,1130,278,1257,1054,203,1446,1157,259,1486,1211,263,1257,1053,204,1232,1004,208,1110,849,226
13237000107,2432,439,1993,2466,411,2037,2401,419,1982,3181,563,2560,2891,541,2350,3169,563,2551,3214,591,2579,2892,532,2360,2442,409,1977,2356,370,1914
1312500MILL,456,36,420,481,26,454,452,34,418,590,42,542,512,35,477,573,44,523,594,38,554,512,37,475,511,33,473,475,36,425
1312500GIBS,408,39,369,432,35,394,405,36,369,486,50,425,432,46,386,472,52,415,505,58,442,433,47,386,465,46,410,427,49,359
13197000955,401,85,316,418,78,333,388,81,307,585,107,460,483,99,384,577,110,455,586,105,476,483,99,384,473,100,363,441,89,324
13119000002,901,98,803,919,76,835,890,85,805,1185,118,1043,1013,103,910,1185,117,1047,1192,128,1053,1015,104,911,950,120,813,877,114,707
13151000060,2565,1115,1450,2606,1122,1454,2509,1086,1423,3096,1466,1570,2774,1374,1400,3087,1475,1545,3115,1487,1588,2778,1369,1409,2617,982,1552,2504,854,1540
13151000057,1639,740,899,1671,757,904,1604,721,883,2017,1034,935,1846,994,852,2014,1054,915,2042,1071,949,1844,987,857,1741,673,1011,1637,574,986
13151000053,2855,1911,944,2887,1955,915,2770,1840,930,3364,2370,943,3132,2317,815,3372,2399,925,3412,2442,947,3133,2301,832,2776,1736,1001,2631,1516,1058
13151000038,3207,2090,1117,3250,2129,1094,3126,2030,1096,3868,2574,1217,3460,2451,1009,3850,2591,1186,3891,2635,1221,3464,2433,1031,3193,1903,1199,3026,1665,1263
13151000034,3009,2212,797,3064,2256,788,2933,2156,777,4212,3257,874,3740,3030,710,4211,3255,863,4242,3288,916,3738,3024,714,3065,2047,940,2869,1819,939
13275000107,892,204,688,908,208,696,874,198,676,1076,276,787,998,263,735,1065,257,788,1082,310,766,998,264,734,962,228,712,915,178,712
13151000025,3411,2196,1215,3463,2224,1214,3302,2106,1196,4818,3216,1481,4299,3073,1226,4811,3241,1462,4844,3274,1504,4295,3053,1242,3320,1852,1371,3133,1651,1350
13119000007,1337,113,1224,1357,97,1251,1313,104,1209,1739,162,1545,1535,149,1386,1729,156,1548,1757,173,1563,1535,144,1391,1420,132,1258,1340,117,1173
13137000002,3093,573,2520,3171,572,2578,3037,551,2486,4140,814,3204,3620,785,2835,4106,805,3203,4182,861,3269,3618,759,2859,3338,611,2632,3139,499,2468
13137000004,382,76,306,391,73,310,371,69,302,518,103,396,432,89,343,509,103,390,521,110,402,432,86,346,413,69,333,391,66,304
13137000005,453,111,342,462,108,350,446,102,344,721,162,538,579,153,426,713,173,522,738,190,538,583,154,429,462,115,323,436,101,312
13137000001,5288,858,4430,5407,811,4534,5245,833,4412,6978,1079,5718,6330,1104,5226,6939,1085,5719,7022,1177,5752,6336,1068,5268,5632,819,4642,5441,721,4457
132250000F2,1347,911,436,1382,932,444,1294,856,438,1610,1012,579,1449,967,482,1593,1033,534,1630,1055,564,1450,968,482,1412,950,442,1341,823,486
13151000046,2419,2141,278,2456,2194,248,2334,2066,268,2909,2526,329,2741,2477,264,2915,2547,316,2930,2567,347,2738,2463,275,2454,2093,307,2305,1898,348
13151000041,1842,1059,783,1880,1076,789,1791,1033,758,2374,1412,900,2068,1307,761,2385,1452,882,2405,1454,932,2066,1302,764,1977,992,935,1854,877,913
13151000056,2271,1455,816,2302,1465,820,2212,1407,805,2695,1726,903,2433,1653,780,2673,1758,876,2701,1754,917,2431,1652,779,2290,1311,929,2167,1167,914
13119000006,1085,189,896,1112,183,919,1055,176,879,1411,259,1120,1207,254,953,1402,252,1118,1431,282,1130,1208,249,959,1203,251,921,1127,209,884
13123000001,1634,315,1319,1663,305,1349,1594,301,1293,2243,475,1724,1989,441,1548,2241,472,1729,2282,504,1763,1988,433,1555,1718,306,1372,1589,262,1251
13123000006,572,132,440,582,123,456,559,122,437,718,153,550,687,157,530,712,161,540,721,168,547,687,157,530,589,127,451,548,108,414
1311100SUGC,1339,247,1092,1366,230,1126,1306,237,1069,1794,306,1457,1661,315,1346,1774,307,1443,1810,335,1459,1663,306,1357,1426,224,1168,1357,206,1099
132250000F3,1507,1288,219,1538,1341,192,1434,1241,193,1660,1345,286,1451,1223,228,1653,1358,266,1678,1399,266,1450,1221,229,1804,1575,204,1703,1396,273
13279000513,3202,900,2302,3275,900,2358,3150,863,2287,3982,1206,2708,3447,1083,2364,3935,1195,2671,4026,1271,2709,3443,1074,2369,3434,975,2394,3238,799,2347
13279015361,1806,459,1347,1859,456,1397,1769,434,1335,2239,576,1629,1963,518,1445,2196,555,1593,2267,597,1656,1959,520,1439,1977,488,1453,1853,417,1379
13279000514,1975,684,1291,2019,708,1304,1929,648,1281,2541,865,1629,2158,776,1382,2509,861,1609,2567,890,1653,2144,753,1391,2072,712,1329,1954,592,1305
13109000011,3319,1026,2293,3447,1040,2392,3224,950,2274,4191,1251,2876,3740,1201,2539,4147,1248,2828,4247,1324,2888,3737,1198,2539,3602,1130,2404,3327,852,2395
13031000011,3127,1590,1537,3215,1680,1521,3054,1549,1505,3996,1981,1926,3554,1863,1691,3961,1969,1901,4047,2077,1911,3551,1863,1688,3473,1794,1568,3286,1454,1701
13031000014,2969,1499,1470,3054,1559,1461,2889,1444,1445,3744,1892,1755,3313,1794,1519,3731,1883,1738,3781,1985,1733,3313,1792,1521,3239,1549,1569,3096,1290,1674
13031000013,3357,1166,2191,3428,1204,2192,3317,1171,2146,4308,1655,2554,3796,1469,2327,4272,1583,2569,4345,1709,2561,3799,1468,2331,3627,1187,2295,3559,1003,2408
13031000004,1830,380,1450,1865,384,1465,1807,382,1425,2466,563,1851,2218,512,1706,2428,530,1840,2480,565,1880,2217,510,1707,1767,394,1317,1705,329,1314
1305900001D,1987,1209,778,2025,1229,768,1962,1193,769,2284,1386,849,2233,1428,805,2280,1397,840,2308,1464,811,2232,1403,829,1997,1192,711,1955,1083,789
13175000015,522,39,483,544,24,516,518,33,485,674,44,624,615,33,582,664,40,614,683,44,632,615,32,583,563,34,516,537,31,497
13175000016,1233,300,933,1269,282,981,1193,281,912,1592,378,1178,1425,364,1061,1574,390,1162,1610,398,1199,1423,361,1062,1263,316,930,1195,259,902
132250000F1,1450,868,582,1492,900,588,1385,833,552,1750,1033,681,1487,923,564,1742,1059,656,1773,1079,681,1485,918,567,1532,889,610,1446,757,648
13303000097,3676,1984,1692,3816,2081,1720,3542,1912,1630,4374,2337,1957,4026,2312,1714,4330,2392,1882,4463,2486,1942,4018,2297,1721,3982,2194,1738,3678,1871,1763
1300100005B,643,102,541,665,90,570,627,88,539,825,136,676,727,118,609,824,127,686,843,132,709,729,118,611,694,103,583,646,92,541
1300100004D,942,95,847,972,80,888,927,82,845,1165,129,1021,1023,115,908,1151,110,1031,1179,130,1048,1022,118,904,1013,93,908,943,91,833
130010003A1,524,23,501,537,16,519,509,19,490,600,25,570,539,21,518,597,16,578,611,20,587,538,20,518,554,21,528,528,27,489
132250000B2,2892,1051,1841,2942,1051,1875,2829,1017,1812,3687,1319,2280,3300,1265,2035,3661,1328,2258,3712,1370,2299,3300,1260,2040,2849,947,1834,2726,839,1776
1314100002A,520,418,102,555,455,100,504,415,89,613,453,146,579,447,132,612,463,140,621,470,146,580,448,132,565,461,102,506,382,119
13175000003,2518,853,1665,2575,842,1714,2459,805,1654,3057,1086,1920,2752,1069,1683,3059,1104,1909,3087,1142,1912,2754,1070,1684,2677,850,1767,2593,682,1825
13175000021,1567,722,845,1629,741,886,1500,680,820,1952,875,1032,1718,875,843,1934,917,991,1987,931,1040,1716,861,855,1747,782,933,1614,629,934
1314100004A,540,431,109,580,471,107,520,419,101,670,540,124,627,517,110,666,536,119,677,561,115,627,516,111,577,472,104,527,407,116
13175000005,2339,575,1764,2400,564,1822,2316,556,1760,2837,739,2055,2619,706,1913,2815,755,2039,2863,756,2090,2620,704,1916,2411,551,1810,2294,467,1777
13175000014,241,112,129,250,114,136,228,101,127,285,117,163,259,114,145,283,117,164,286,124,161,258,112,146,244,120,123,220,86,130
13175000007,603,274,329,633,283,349,579,258,321,722,321,391,654,311,343,721,323,390,732,329,397,657,310,347,624,290,329,586,247,330
1312100010E,502,486,16,523,509,13,479,460,19,597,557,29,572,557,15,600,570,24,602,569,31,571,556,15,562,545,8,527,471,45
131210ML072,845,249,596,857,260,590,832,246,586,1170,389,757,1088,384,704,1145,376,744,1171,418,740,1087,370,717,796,220,546,769,170,569
1312100SS06,1048,467,581,1070,518,539,1044,491,553,1417,696,694,1327,652,675,1399,695,676,1417,776,625,1328,624,704,1032,465,523,1014,299,677
1312100012F,412,398,14,427,417,8,394,385,9,524,486,27,462,451,11,527,490,25,531,496,29,461,451,10,456,437,10,412,361,34
1312100001C,601,572,29,612,593,14,578,561,17,768,699,43,729,706,23,776,714,34,779,717,49,729,701,28,612,580,19,574,506,44
130990000CS,621,154,467,636,158,477,611,141,470,820,172,636,741,185,556,804,171,610,833,191,641,739,185,554,744,184,545,711,175,509
1309900000U,451,80,371,457,78,378,443,76,367,527,98,420,477,95,382,517,95,407,531,109,419,479,98,381,501,96,397,482,87,380
1324300718B,194,185,9,203,198,3,176,163,13,236,215,18,227,218,9,237,219,12,237,225,11,226,217,9,245,238,5,220,195,24
130990000CU,710,237,473,719,240,479,694,226,468,849,299,541,752,279,473,830,291,515,858,316,535,754,281,473,817,264,540,769,238,517
13115000055,1596,369,1227,1638,353,1262,1564,356,1208,2397,543,1779,1981,509,1472,2367,562,1747,2419,562,1822,1981,494,1487,1895,381,1443,1796,340,1355
13115000140,1479,624,855,1532,683,827,1471,635,836,1951,826,1071,1718,760,958,1929,822,1052,1957,883,1036,1716,750,966,1582,670,856,1521,513,953
13115000076,1891,762,1129,1946,784,1136,1856,738,1118,2549,1063,1424,2257,1024,1233,2513,1061,1382,2569,1114,1421,2258,1013,1245,2240,826,1332,2121,707,1329
13115000001,1718,409,1309,1748,411,1320,1697,404,1293,2453,618,1766,2176,584,1592,2437,627,1761,2483,683,1769,2172,579,1593,2002,448,1486,1920,359,1490
13101001058,1105,130,975,1143,126,1008,1071,118,953,1418,162,1232,1186,128,1058,1381,152,1190,1441,167,1256,1187,130,1057,1176,156,1007,1065,146,874
1306500000D,157,42,115,168,42,126,155,39,116,232,51,180,208,50,158,224,47,173,238,54,184,208,51,157,176,58,115,155,43,108
13115000050,959,270,689,985,266,710,941,259,682,1481,446,995,1234,395,839,1463,434,996,1491,450,1029,1236,395,841,1255,381,824,1195,340,801
13115000020,795,193,602,817,180,628,766,168,598,1126,233,862,980,228,752,1119,238,846,1140,242,883,980,226,754,958,223,709,921,187,691
13115000135,1353,293,1060,1383,274,1095,1327,274,1053,1920,404,1461,1595,374,1221,1904,414,1438,1940,403,1511,1595,373,1222,1591,303,1239,1511,281,1161
13115000110,637,501,136,654,516,133,595,467,128,836,589,210,733,581,152,839,605,206,855,638,205,731,574,157,681,497,157,619,394,197
13039000014,1988,500,1488,2019,515,1488,1964,503,1461,2499,640,1794,2332,626,1706,2458,619,1779,2527,708,1786,2334,638,1696,2097,527,1516,1987,407,1490
13039000002,923,255,668,940,263,671,895,238,657,1227,330,876,1107,308,799,1198,314,864,1242,347,886,1108,309,799,955,273,670,890,233,628
13115000065,1847,426,1421,1874,417,1429,1818,420,1398,2390,541,1786,2055,506,1549,2377,558,1770,2405,566,1801,2055,499,1556,2140,483,1594,2048,414,1553
13115000025,663,121,542,672,109,555,645,118,527,863,137,707,779,136,643,860,136,712,868,140,721,783,133,650,739,120,591,701,108,565
13115000090,2004,935,1069,2043,970,1038,1966,920,1046,2609,1218,1324,2326,1177,1149,2595,1224,1288,2630,1280,1302,2323,1152,1171,2271,1018,1164,2192,821,1285
131210AP01D,528,301,227,539,315,213,523,302,221,681,376,286,634,371,263,679,372,291,689,392,278,634,368,266,544,293,222,516,229,256
131210AP01A,3094,1443,1651,3137,1528,1572,3064,1450,1614,4100,2038,2004,3843,1998,1845,4021,1994,1930,4109,2195,1864,3847,1962,1885,3171,1425,1647,3075,1034,1926
1312100007M,1157,731,426,1177,778,378,1150,751,399,1487,987,470,1292,867,425,1469,964,461,1511,1039,452,1294,857,437,1299,777,438,1250,614,573
1312100007F,1995,1100,895,2035,1178,827,1998,1127,871,2863,1604,1209,2629,1512,1117,2808,1562,1177,2879,1790,1054,2634,1481,1153,1984,1103,790,1974,786,1118
131210EP04A,2580,2505,75,2618,2570,43,2485,2427,58,3121,2945,119,2766,2714,52,3118,2972,98,3133,2991,120,2764,2701,63,2861,2756,78,2701,2444,197
131210CP012,819,644,175,844,689,141,807,652,155,929,752,155,908,763,145,942,770,160,943,786,143,907,760,147,782,590,163,745,491,227
131210CP01B,223,140,83,226,149,71,215,136,79,254,174,71,260,199,61,257,187,66,258,188,64,258,190,68,239,157,73,230,140,85
131210EP02C,246,192,54,251,203,45,242,197,45,311,257,43,303,258,45,315,262,41,314,261,48,303,254,49,210,185,19,195,160,28
13039000009,2998,1036,1962,3042,1042,1967,2948,1005,1943,4458,1491,2783,3727,1360,2367,4389,1459,2746,4529,1604,2825,3724,1367,2357,3196,983,2075,3005,849,1957
13039000007,1162,617,545,1198,634,553,1103,576,527,1561,758,727,1290,687,603,1519,738,697,1589,804,747,1289,684,605,1309,650,627,1203,560,588
13039000001,524,166,358,534,162,366,511,147,364,675,181,480,626,180,446,666,173,472,689,192,490,625,180,445,605,177,415,538,139,378
1322300001C,9567,2842,6725,9717,2888,6762,9417,2752,6665,15015,4586,10067,13587,4454,9133,14885,4582,9968,15177,4810,10174,13591,4391,9200,10337,2454,7537,9918,2034,7382
1322300004B,8374,2655,5719,8514,2599,5837,8270,2547,5723,11139,3805,7012,9735,3605,6130,11100,3877,6958,11268,3951,7157,9738,3573,6165,9267,2756,6210,8918,2386,6089
1322300011B,5385,1390,3995,5456,1362,4039,5280,1335,3945,7149,1888,5029,6136,1769,4367,7106,1907,4996,7212,1958,5133,6133,1745,4388,5701,1303,4227,5448,1175,3977
13115000040,963,119,844,986,100,878,951,108,843,1321,146,1149,1141,145,996,1304,164,1119,1322,150,1154,1140,138,1002,1123,119,977,1067,116,920
13295000871,2815,578,2237,2891,537,2304,2734,550,2184,3958,765,3049,3217,694,2523,3913,745,3010,4026,792,3167,3217,693,2524,3207,601,2490,2942,541,2219
13295000869,1142,166,976,1166,151,1005,1111,162,949,1542,233,1272,1315,200,1115,1519,210,1267,1564,241,1306,1315,206,1109,1281,180,1066,1170,171,955
13295000960,819,107,712,837,96,730,791,104,687,1147,137,979,987,124,863,1148,135,970,1169,138,1013,986,125,861,924,99,793,831,103,689
132050000CT,257,22,235,261,15,246,247,16,231,311,28,283,281,23,258,313,27,282,316,28,288,281,24,257,268,21,245,259,26,233
13055001083,147,65,82,156,61,95,143,65,78,189,66,119,160,65,95,186,69,114,195,62,131,157,62,95,162,53,106,149,48,93
13053FTBEN1,0,0,0,0,0,0,0,0,0,0,0,0,0,0,0,0,0,0,0,0,0,0,0,0,0,0,0,0,0,0
13053000001,287,134,153,302,137,164,280,127,153,425,176,235,361,163,198,393,163,223,436,186,242,363,165,198,379,159,211,344,139,190
13053FTBEN3,445,204,241,459,205,250,434,195,239,646,265,354,550,250,300,661,276,357,663,279,367,550,252,298,582,249,310,535,213,295
13053FTBEN2,336,152,184,344,152,189,326,145,181,475,195,261,410,188,222,480,201,260,483,202,271,409,189,220,429,186,230,391,156,215
13215000112,3197,2739,458,3306,2854,434,2992,2555,437,4388,3388,856,3769,3175,594,4360,3396,837,4471,3537,864,3761,3163,598,3954,3200,687,3533,2608,781
13055001382,91,13,78,95,12,83,90,12,78,115,16,97,112,13,99,114,17,95,116,15,100,113,13,100,107,15,89,94,23,68
13055000925,2518,668,1850,2595,675,1900,2490,665,1825,3497,837,2560,2823,733,2090,3414,822,2481,3537,845,2643,2824,736,2088,2925,759,2099,2716,675,1940
13115000105,1677,792,885,1718,827,877,1627,751,876,2131,993,1078,1956,951,1005,2121,988,1091,2146,1037,1088,1959,932,1027,1802,844,906,1724,688,976
13039000012,1201,421,780,1223,424,791,1190,414,776,1557,516,1003,1372,482,890,1533,487,987,1580,546,1013,1374,480,894,1264,437,779,1177,372,732
131210EP03B,946,895,51,970,932,36,918,871,47,1081,1006,63,1032,988,44,1087,1013,61,1088,1020,61,1032,984,48,773,723,37,729,634,73
1312100001R,462,439,23,489,479,8,435,420,15,511,459,33,434,428,6,517,477,23,517,468,37,434,426,8,578,564,7,506,464,33
1312100001G,1062,992,70,1097,1031,50,1051,983,68,1251,1136,84,1201,1127,74,1261,1134,89,1263,1159,87,1201,1123,78,1478,1290,125,1435,1114,236
1312100SC13,1615,1535,80,1634,1561,71,1571,1504,67,2006,1856,109,1956,1859,97,2025,1889,101,2030,1904,115,1957,1855,102,1577,1479,85,1500,1341,129
131210UC02A,4204,4042,162,4287,4162,115,4057,3922,135,5414,5046,248,5188,5024,164,5425,5108,233,5477,5140,300,5189,5017,172,4099,3879,167,3841,3456,286
1312100011B,2980,2883,97,3079,3023,50,2876,2799,77,3361,3218,99,3231,3176,55,3392,3267,86,3403,3278,112,3229,3171,58,3139,3038,64,2980,2675,224
1312100PA01,1293,993,300,1326,1017,304,1256,960,296,1818,1366,405,1683,1337,346,1804,1371,399,1830,1393,411,1681,1336,345,1500,1077,390,1409,951,406
131210CH04A,435,210,225,444,217,224,431,205,226,670,317,340,640,324,316,669,323,332,673,345,321,641,316,325,437,191,230,411,150,251
131210SC07A,3640,3350,290,3695,3403,284,3532,3241,291,4501,4032,386,4227,3902,325,4527,4070,389,4537,4088,413,4228,3890,338,3448,3056,349,3306,2804,433
131210FA01B,2918,2619,299,2959,2663,287,2842,2559,283,3587,3169,352,3757,3435,322,3599,3202,344,3631,3246,361,3757,3419,338,2634,2266,321,2506,2038,403
131210CH04B,3,2,1,3,2,1,3,2,1,4,3,1,4,3,1,3,2,1,4,3,1,4,3,1,3,2,1,3,2,1
1312100012M,1144,1113,31,1168,1149,16,1100,1079,21,1380,1288,48,1249,1225,24,1390,1321,44,1397,1312,69,1246,1221,25,1285,1243,30,1194,1084,91
1312100009E,1364,1249,115,1416,1340,67,1341,1247,94,1639,1474,128,1533,1431,102,1640,1485,117,1658,1514,123,1529,1421,108,1306,1222,49,1234,1060,124
1312100009K,1784,1700,84,1847,1800,45,1709,1645,64,2182,2002,103,2047,1990,57,2183,2021,101,2201,2051,119,2046,1984,62,2008,1919,59,1833,1616,166
1312100012K,1194,1118,76,1235,1188,44,1139,1084,55,1626,1476,93,1537,1460,77,1625,1476,99,1641,1512,105,1532,1446,86,1400,1299,65,1321,1128,135
1312100004K,1208,1148,60,1261,1224,34,1162,1112,50,1328,1254,45,1272,1235,37,1335,1261,46,1352,1273,67,1270,1233,37,1193,1138,34,1131,984,102
131210EP02B,960,828,132,973,845,122,937,812,125,1144,963,161,1115,957,158,1149,959,163,1149,982,154,1116,960,156,743,658,67,701,564,104
13277000006,716,74,642,727,67,654,693,66,627,886,102,774,803,91,712,873,108,758,888,111,771,802,91,711,733,79,645,701,73,614
13277000002,1521,221,1300,1561,209,1343,1498,192,1306,1796,281,1486,1644,272,1372,1775,284,1465,1802,304,1480,1647,274,1373,1547,210,1306,1481,162,1277
13277000012,1725,487,1238,1763,502,1241,1673,460,1213,2031,637,1349,1830,627,1203,2025,655,1332,2064,701,1344,1830,626,1204,1921,537,1346,1808,418,1327
13277000003,868,112,756,891,114,773,838,104,734,1046,153,867,901,138,763,1045,155,872,1057,162,882,901,136,765,903,104,784,867,86,754
13017000001,2012,1020,992,2071,1057,1006,1911,945,966,2421,1135,1249,2148,1118,1030,2399,1140,1206,2451,1182,1249,2141,1112,1029,2232,1114,1090,2016,909,1060
13017000002,3388,939,2449,3476,926,2533,3301,867,2434,4056,1149,2828,3578,1075,2503,4045,1164,2802,4109,1210,2861,3572,1070,2502,3699,987,2649,3447,830,2529
13021000HO4,1035,486,549,1058,495,546,1021,493,528,1224,608,584,1110,583,527,1218,608,581,1224,625,577,1112,576,536,1084,448,590,1032,369,607
13021000VV1,1833,1238,595,1890,1297,565,1806,1237,569,2188,1439,684,1997,1413,584,2172,1442,666,2216,1509,670,1991,1395,596,1909,1233,581,1828,1021,716
13021000RU2,2051,711,1340,2083,683,1382,1993,675,1318,2460,854,1546,2240,814,1426,2446,863,1549,2479,863,1590,2240,819,1421,2069,641,1378,1954,561,1331
13021000GF5,2322,2067,255,2371,2123,237,2202,1983,219,2626,2249,316,2355,2129,226,2631,2275,312,2659,2328,301,2349,2115,234,2519,2195,286,2311,1900,349
13021000GF4,880,780,100,909,824,84,839,746,93,943,781,141,815,736,79,954,800,138,972,826,139,811,730,81,1005,892,103,894,732,149
13021000HO5,868,459,409,897,462,425,838,432,406,1442,868,532,1270,816,454,1447,894,518,1466,917,535,1267,809,458,966,459,460,921,404,479
13295000881,1209,186,1023,1245,180,1052,1189,186,1003,1670,268,1358,1366,234,1132,1648,244,1343,1693,286,1382,1369,236,1133,1370,196,1132,1251,171,1022
13295001818,2267,341,1926,2332,337,1975,2214,341,1873,3127,492,2547,2564,439,2125,3063,454,2511,3172,538,2599,2568,442,2126,2574,367,2125,2360,318,1926
13295001809,626,124,502,644,117,522,603,115,488,758,143,594,652,127,525,746,142,587,768,151,605,651,127,524,688,122,540,634,108,488
13295001812,2691,656,2035,2760,638,2082,2596,617,1979,3844,936,2764,3140,825,2315,3784,897,2755,3908,987,2864,3143,834,2309,3246,701,2447,2950,622,2180
13189000136,1064,800,264,1104,842,259,998,738,260,1220,868,318,1036,791,245,1215,877,303,1236,925,299,1034,785,249,1194,910,276,1031,724,291
13295000944,2285,326,1959,2330,301,2009,2212,319,1893,3085,455,2555,2636,393,2243,3031,413,2531,3119,479,2603,2637,402,2235,2553,357,2132,2335,337,1912
13295000943,367,46,321,370,39,328,354,46,308,509,54,439,440,50,390,498,52,442,511,54,452,440,51,389,409,40,353,372,46,308
13295001893,1257,295,962,1288,271,1003,1206,284,922,1867,405,1399,1516,353,1163,1837,369,1394,1891,418,1448,1519,358,1161,1521,307,1164,1350,256,1012
1312100009C,1460,1412,48,1518,1489,26,1392,1352,40,1675,1574,61,1575,1542,33,1684,1594,59,1689,1601,67,1574,1540,34,1609,1552,33,1495,1336,124
1312100003M,431,316,115,451,351,84,436,333,103,555,435,101,647,549,98,553,439,97,553,455,88,644,538,106,462,337,87,448,276,128
1306500000H,1615,429,1186,1693,442,1245,1569,388,1181,2037,537,1457,1807,508,1299,1964,538,1391,2094,620,1464,1805,504,1301,1827,566,1234,1574,396,1120
13245000112,389,247,142,401,254,139,377,236,141,525,308,200,471,303,168,527,312,198,544,336,202,472,307,165,465,268,176,418,207,185
13021000EM3,1783,1292,491,1814,1315,488,1730,1269,461,2118,1493,570,1902,1421,481,2134,1543,558,2156,1563,570,1901,1418,483,1831,1289,490,1729,1101,558
13311000071,222,47,175,224,46,175,219,46,173,315,66,237,271,65,206,313,70,235,317,69,245,270,66,204,229,48,173,223,42,173
13253000001,831,279,552,840,274,565,809,268,541,869,210,646,812,196,616,849,204,628,879,215,659,812,195,617,813,229,573,731,191,521
13311000081,1234,149,1085,1255,124,1112,1219,135,1084,1659,183,1439,1482,189,1293,1663,174,1455,1665,181,1464,1481,186,1295,1323,153,1128,1273,149,1053
13253000004,627,121,506,641,117,521,619,114,505,771,148,612,696,145,551,747,132,597,777,155,619,696,147,549,719,144,565,627,126,484
13021000EM5,1379,1092,287,1406,1119,281,1326,1063,263,1638,1232,368,1536,1221,315,1642,1273,347,1659,1264,379,1535,1221,314,1465,1125,318,1363,989,336
13021000EM4,1217,1153,64,1243,1182,56,1179,1122,57,1380,1264,99,1234,1177,57,1397,1296,89,1413,1309,95,1227,1173,54,1310,1234,63,1213,1095,99
13033000007,255,142,113,262,146,114,238,127,111,302,168,129,275,159,116,296,172,119,305,181,122,274,154,120,276,152,117,259,121,127
13021000HO3,5348,2244,3104,5431,2289,3094,5261,2204,3057,4661,2137,2447,4235,2014,2221,4650,2147,2427,4705,2237,2413,4243,2001,2242,5455,2182,3114,5273,1797,3309
13033000014,1460,1073,387,1516,1115,396,1406,1013,393,1763,1239,500,1593,1168,425,1740,1249,468,1787,1296,482,1592,1166,426,1713,1287,404,1581,1081,457
13031000003,1308,430,878,1351,459,884,1283,411,872,1641,550,1054,1480,523,957,1639,559,1055,1668,575,1079,1481,524,957,1349,464,863,1258,376,845
13031000012,914,244,670,942,252,684,902,239,663,1152,305,825,1006,276,730,1145,310,816,1162,310,842,1007,278,729,1000,284,700,953,226,704
13031000010,1693,504,1189,1718,511,1185,1672,497,1175,2398,715,1608,2089,678,1411,2375,705,1609,2426,757,1620,2091,673,1418,1753,460,1234,1696,379,1258
13277000004,906,122,784,928,118,807,902,107,795,1058,158,890,973,146,827,1046,149,884,1065,158,899,973,145,828,953,129,814,905,96,793
13277000001,1675,542,1133,1714,563,1140,1630,534,1096,2108,748,1302,1858,715,1143,2099,777,1276,2141,818,1291,1852,702,1150,1795,601,1155,1684,462,1177
13277000007,401,85,316,411,88,320,393,80,313,536,115,406,470,110,360,534,123,399,543,129,403,470,105,365,429,89,329,399,69,316
13277000009,1919,482,1437,1965,486,1470,1879,455,1424,2334,653,1630,2088,621,1467,2319,646,1622,2358,688,1638,2087,621,1466,1978,481,1458,1886,415,1423
13123000008,698,109,589,714,100,601,684,98,586,858,136,701,809,133,676,858,128,717,860,136,715,809,130,679,699,106,576,655,87,524
13279000043,801,69,732,837,53,782,790,49,741,983,74,895,877,66,811,965,67,878,992,72,908,877,62,815,802,71,718,738,61,659
1312100010A,1571,1525,46,1620,1592,25,1490,1449,41,1799,1712,52,1738,1704,34,1800,1713,60,1810,1724,72,1739,1697,42,1767,1713,29,1643,1481,130
131210006L1,663,479,184,677,517,150,662,490,172,802,578,215,815,596,219,788,574,202,800,628,162,815,583,232,670,497,145,672,395,259
1312100006D,5967,4625,1342,6046,4848,1126,5932,4679,1253,7327,5644,1570,6838,5418,1420,7260,5607,1496,7346,5955,1304,6839,5344,1495,5968,4561,1152,5916,3702,1939
13021000WA1,1709,579,1130,1747,566,1174,1665,561,1104,1976,658,1295,1809,660,1149,1966,669,1279,1991,675,1300,1809,647,1162,1717,554,1131,1614,491,1086
13207000011,442,205,237,459,213,242,426,198,228,543,241,293,492,237,255,545,246,292,552,246,306,492,236,256,447,208,235,405,167,229
13021000RU1,3584,1433,2151,3651,1428,2210,3502,1392,2110,4329,1760,2511,3943,1677,2266,4328,1779,2494,4371,1784,2559,3944,1665,2279,3669,1315,2297,3521,1178,2267
13021000EM2,2052,1945,107,2108,2012,91,1963,1865,98,2319,2101,173,2122,2025,97,2326,2152,145,2353,2169,157,2116,2008,108,2120,1999,100,1968,1746,193
13039000005,997,195,802,1013,191,808,988,198,790,1382,281,1053,1250,266,984,1358,261,1044,1399,299,1075,1251,274,977,1169,230,910,1118,218,834
13039000013,1294,413,881,1317,422,873,1283,418,865,1974,596,1275,1638,515,1123,1940,569,1280,1991,639,1308,1637,521,1116,1442,425,964,1334,362,894
131210SC212,1910,1810,100,1943,1859,80,1856,1763,93,2723,2529,150,2557,2459,98,2726,2552,136,2745,2537,176,2554,2444,110,1887,1744,112,1788,1593,144
131210FA01C,398,380,18,399,383,16,384,366,18,478,442,28,454,437,17,478,442,27,486,445,32,453,434,19,384,358,20,366,328,29
13189000132,955,86,869,969,76,885,948,86,862,1166,119,1030,1053,117,936,1158,115,1029,1174,138,1025,1051,115,936,989,101,871,929,76,818
13189000134,1146,676,470,1168,685,479,1098,628,470,1332,786,529,1184,739,445,1331,790,520,1347,813,511,1188,729,459,1216,722,477,1120,602,493
13189000131,606,481,125,617,498,118,572,455,117,743,578,154,715,568,147,735,572,154,747,583,157,713,569,144,669,527,134,596,439,144
13031000008,316,41,275,323,39,281,312,41,271,356,57,294,339,52,287,355,55,293,360,60,298,338,51,287,315,46,267,304,38,257
13031000009,462,163,299,481,170,306,455,153,302,629,210,406,554,204,350,630,208,404,638,217,411,554,207,347,516,191,312,484,154,314
131210ML06A,1003,655,348,1015,666,338,982,643,339,1374,888,447,1216,854,362,1370,898,429,1391,931,442,1214,844,370,1092,682,364,1037,549,421
131210AP12D,0,0,0,0,0,0,0,0,0,0,0,0,0,0,0,0,0,0,0,0,0,0,0,0,0,0,0,0,0,0
131210AP12B,429,289,140,435,292,140,426,286,140,611,395,199,515,347,168,603,384,199,628,414,205,517,352,165,395,260,121,364,214,134
1312100008L,2650,1753,897,2695,1882,765,2642,1815,827,3274,2132,1064,3002,2043,959,3211,2115,998,3295,2310,914,3003,1999,1004,2621,1688,751,2565,1311,1106
1312100010B,2392,2322,70,2454,2414,32,2341,2282,59,2673,2557,72,2648,2591,57,2696,2603,67,2707,2592,96,2648,2585,63,2602,2514,56,2474,2226,190
131210AP07A,2062,960,1102,2100,995,1069,2032,953,1079,2853,1371,1402,2612,1345,1267,2831,1377,1366,2879,1468,1374,2611,1319,1292,2175,965,1094,2089,777,1178
1312100004M,284,274,10,290,282,7,271,264,7,344,316,13,327,320,7,347,327,11,346,328,15,324,317,7,330,319,8,296,260,24
1312100012L,229,221,8,238,236,2,225,220,5,281,258,14,277,269,8,286,265,13,287,268,18,277,269,8,257,252,5,228,206,18
1312100002D,2612,2278,334,2655,2411,220,2568,2293,275,3685,3053,553,3457,2970,487,3648,3032,538,3724,3200,478,3454,2935,519,2529,2177,239,2444,1826,475
131210EP02A,858,801,57,886,845,38,823,774,49,1094,1002,65,1049,1004,45,1102,1017,62,1114,1042,70,1047,998,49,1266,1117,117,1180,954,174
130810CORDE,4446,2178,2268,4645,2365,2262,4282,2056,2226,5140,2495,2559,4512,2402,2110,5076,2536,2452,5193,2649,2488,4508,2381,2127,5005,2582,2343,4546,2020,2413
1324500804H,1568,734,834,1601,734,857,1534,705,829,1901,882,970,1769,900,869,1888,883,974,1913,893,993,1768,896,872,1711,762,924,1589,674,876
13245000608,813,305,508,833,295,527,806,299,507,1029,409,595,927,383,544,1026,408,586,1044,427,598,926,385,541,861,287,549,817,243,541
13277000011,1189,951,238,1258,1037,216,1102,878,224,1411,1096,287,1282,1070,212,1412,1123,258,1461,1174,272,1276,1057,219,1358,1116,223,1183,862,287
13137000006,2282,338,1944,2325,307,1997,2266,318,1948,3027,441,2516,2700,395,2305,3000,430,2530,3048,453,2572,2699,391,2308,2442,320,2061,2324,300,1927
13137000007,1012,205,807,1026,188,830,989,191,798,1251,239,986,1192,237,955,1254,242,994,1264,250,1006,1188,233,955,1017,174,815,967,153,771
132050000CN,1048,823,225,1084,878,204,974,768,206,1236,953,268,1110,907,203,1220,939,262,1250,1000,248,1105,903,202,1164,944,212,1067,794,260
13021000HA2,2346,1312,1034,2379,1328,1034,2284,1275,1009,2829,1580,1191,2467,1462,1005,2816,1574,1194,2855,1606,1215,2462,1457,1005,2362,1176,1125,2257,1067,1096
13033000011,529,256,273,536,249,284,513,235,278,689,306,372,623,296,327,691,317,365,699,315,378,622,297,325,573,281,279,530,247,265
13021000GF2,729,669,60,748,693,52,682,624,58,883,756,95,791,731,60,887,783,89,901,795,98,778,717,61,851,773,68,780,657,104
13245000106,410,307,103,426,313,106,395,281,114,498,352,129,413,316,97,501,360,123,518,384,125,415,314,101,456,332,118,395,279,106
1300900MONT,2352,988,1364,2409,1008,1377,2272,937,1335,2756,1130,1564,2548,1116,1432,2730,1139,1546,2774,1162,1584,2548,1107,1441,2393,1013,1315,2247,872,1311
13009000318,2292,623,1669,2338,606,1720,2257,600,1657,2709,779,1882,2500,761,1739,2684,764,1871,2725,810,1891,2498,754,1744,2289,615,1624,2183,510,1617
13019001767,290,44,246,299,39,259,278,36,242,361,57,299,318,54,264,325,41,279,365,62,302,316,52,264,315,49,263,289,38,244
13019001157,2853,456,2397,2920,430,2472,2772,407,2365,3534,555,2907,3067,513,2554,3542,573,2903,3582,606,2952,3071,522,2549,3084,493,2532,2902,414,2386
13019001148,133,20,113,134,20,114,131,20,111,163,24,139,146,24,122,145,16,129,165,26,139,146,24,122,142,23,119,134,20,113
13009000319,1138,533,605,1175,538,626,1113,510,603,1338,579,735,1264,595,669,1328,579,718,1354,604,731,1263,591,672,1178,539,608,1107,453,619
13277000005,733,53,680,748,54,690,726,47,679,846,86,752,760,76,684,837,82,745,850,90,756,762,76,686,745,76,658,727,60,655
1322300007B,3069,1080,1989,3115,1066,2015,3017,1047,1970,4082,1436,2528,3483,1342,2141,4054,1453,2508,4132,1478,2588,3483,1333,2150,3353,999,2235,3205,888,2126
1322300005B,5253,2100,3153,5348,2108,3177,5154,2006,3148,7811,3076,4463,6654,2907,3747,7781,3144,4430,7902,3163,4603,6647,2878,3769,5715,1834,3707,5407,1619,3507
1322300008B,5338,2985,2353,5434,3015,2379,5214,2884,2330,7798,4099,3509,6946,3873,3073,7749,4089,3473,7899,4217,3598,6952,3866,3086,5636,2364,3132,5347,2070,3018
13137000003,2674,366,2308,2718,358,2345,2618,345,2273,3624,502,3027,3166,480,2686,3601,490,3045,3657,522,3098,3175,469,2706,2830,375,2384,2704,333,2254
13079000002,1015,460,555,1046,464,580,958,412,546,1217,507,682,1150,511,639,1211,516,674,1240,535,691,1147,507,640,1079,507,548,1000,408,555
1300700000E,232,118,114,238,118,119,216,104,112,287,147,136,261,131,130,285,145,137,289,148,141,261,134,127,261,133,124,232,107,119
13245000207,1080,962,118,1120,1009,107,1013,911,102,1352,1150,170,1217,1104,113,1352,1180,149,1383,1221,151,1213,1099,114,1341,1181,151,1190,978,191
13079000005,988,137,851,1002,106,893,967,123,844,1251,175,1041,1111,164,947,1244,190,1034,1270,186,1071,1110,161,949,1059,110,927,1000,97,868
1323900000M,68,33,35,74,35,38,65,31,34,66,31,35,62,28,34,65,28,36,69,30,39,62,28,34,86,35,50,77,29,44
13279000039,838,83,755,870,84,782,834,76,758,1053,111,932,964,100,864,1046,106,923,1062,109,946,965,102,863,826,92,721,785,84,677
131210SS07C,426,212,214,435,218,211,420,212,208,532,270,249,487,254,233,525,278,231,539,299,230,487,250,237,498,246,234,478,174,288
131210ML021,1349,328,1021,1364,350,1003,1349,326,1023,1775,505,1237,1687,498,1189,1743,504,1201,1770,571,1176,1687,471,1216,1303,300,938,1276,208,1008
13245000303,955,228,727,985,227,750,956,226,730,1150,305,826,1142,307,835,1146,320,802,1158,359,779,1142,309,833,1035,273,725,1029,198,798
13245000703,2281,1242,1039,2325,1254,1040,2235,1201,1034,2860,1572,1208,2453,1430,1023,2841,1574,1188,2883,1647,1189,2455,1422,1033,2596,1321,1160,2480,1183,1176
13245000801,272,87,185,278,79,196,271,79,192,357,109,243,316,103,213,352,108,240,363,114,248,315,101,214,296,94,198,268,80,184
13245000803,21,19,2,22,22,0,19,19,0,111,76,32,86,65,21,112,72,32,111,77,32,86,63,23,23,15,8,22,14,7
1324500801B,274,73,201,281,62,216,268,66,202,365,89,272,303,81,222,363,95,267,369,92,276,305,80,225,291,75,214,276,60,204
13245000210,804,707,97,834,725,100,775,674,101,966,798,141,869,761,108,955,793,139,980,823,149,867,757,110,945,819,111,880,693,156
13245000503,1953,1656,297,2011,1715,284,1862,1578,284,2408,1976,371,2145,1860,285,2414,2012,364,2451,2061,363,2144,1848,296,2227,1856,340,2046,1608,396
13011000007,463,68,395,475,57,413,459,60,399,623,79,538,521,68,453,617,75,527,625,80,538,519,63,456,475,57,410,455,61,366
13009000322,927,276,651,952,264,678,896,266,630,1102,307,768,1011,313,698,1094,308,755,1114,320,784,1011,312,699,972,273,682,893,243,627
1300900321W,1528,1172,356,1601,1258,338,1460,1126,334,1819,1357,411,1707,1379,328,1794,1377,385,1843,1421,400,1704,1369,335,1727,1337,366,1572,1127,411
13189000135,1773,557,1216,1818,563,1247,1730,521,1209,2165,674,1454,1940,656,1284,2140,684,1416,2181,718,1442,1940,649,1291,1945,610,1306,1794,488,1253
1318900133A,695,210,485,706,208,496,669,195,474,844,245,583,750,225,525,843,254,576,851,257,590,753,228,525,698,220,466,651,191,446
131210SS07A,664,297,367,679,312,359,656,299,357,994,463,521,934,454,480,992,466,505,1006,527,471,935,439,496,655,265,361,647,175,450
1312100011K,1073,1040,33,1102,1074,23,1034,1001,33,1213,1141,46,1164,1137,27,1210,1148,35,1224,1158,53,1163,1130,33,1124,1079,27,1053,950,87
131210SC14B,42,34,8,45,38,7,39,30,9,59,45,10,56,47,9,59,47,10,60,46,14,56,47,9,154,147,5,148,134,11
1312100010D,1755,1686,69,1838,1816,19,1668,1621,47,2217,2063,94,1955,1930,25,2232,2113,78,2262,2117,121,1948,1924,24,2126,2057,53,1907,1682,179
1312100010P,639,613,26,667,653,12,617,594,23,748,699,28,730,720,10,752,717,22,755,720,31,729,715,14,743,715,17,696,629,51
131210005A2,1957,1764,193,1993,1838,133,1950,1775,175,2416,2123,247,2356,2149,207,2392,2104,226,2428,2185,217,2354,2123,231,1684,1502,121,1644,1309,226
1312100RW03,2687,1490,1197,2739,1545,1152,2644,1473,1171,3410,1916,1393,3125,1822,1303,3370,1892,1370,3432,2040,1348,3129,1804,1325,2786,1446,1190,2709,1153,1360
13107000053,3575,1329,2246,3701,1380,2308,3470,1260,2210,4530,1666,2792,4005,1571,2434,4447,1685,2670,4604,1786,2790,4001,1555,2446,3870,1484,2345,3557,1192,2272
13169000001,1740,424,1316,1784,417,1358,1721,420,1301,2078,481,1559,1856,473,1383,2055,494,1529,2097,510,1572,1853,473,1380,1740,404,1300,1676,363,1270
13169000011,1073,367,706,1089,379,705,1046,355,691,1257,418,816,1117,408,709,1251,429,803,1278,443,826,1118,411,707,1152,419,707,1115,361,718
13169000003,1388,484,904,1418,476,931,1348,458,890,1802,591,1167,1544,562,982,1799,602,1161,1822,604,1204,1544,563,981,1501,473,995,1413,421,953
13245000309,1849,1635,214,1863,1667,180,1800,1597,203,2449,2086,313,2234,2000,234,2435,2100,290,2468,2135,307,2236,2003,233,1714,1469,212,1624,1320,271
13139000029,1805,390,1415,1825,384,1415,1763,370,1393,2433,549,1811,2171,566,1605,2417,551,1803,2446,585,1825,2174,541,1633,1953,331,1548,1882,286,1484
1310300001B,1453,223,1230,1503,214,1274,1430,208,1222,2101,343,1695,1895,309,1586,2099,340,1701,2130,350,1753,1894,315,1579,1576,225,1320,1484,181,1241
13139000002,1370,639,731,1402,650,729,1346,614,732,2206,926,1196,1814,861,953,2202,922,1205,2250,988,1221,1818,854,964,1268,497,711,1188,428,694
13139000021,1943,683,1260,1995,697,1268,1921,659,1262,2742,939,1700,2512,937,1575,2724,916,1739,2762,1018,1691,2512,916,1596,2010,625,1310,1960,488,1374
13179000001,668,544,124,691,568,123,650,531,119,789,620,159,749,614,135,777,625,144,797,629,161,745,609,136,703,556,140,641,455,179
13179000007,1154,532,622,1180,536,634,1130,522,608,1778,859,862,1459,761,698,1769,869,848,1808,884,902,1456,756,700,1200,495,675,1119,431,645
13179000003,2296,1271,1025,2359,1315,1032,2234,1234,1000,3023,1596,1367,2759,1544,1215,2995,1592,1344,3044,1616,1390,2754,1535,1219,2315,1226,1041,2143,1023,1038
13179000006,1578,456,1122,1606,434,1161,1538,432,1106,2166,623,1495,1934,597,1337,2151,608,1488,2193,633,1536,1935,593,1342,1662,400,1220,1606,336,1205
13179000011,1981,1267,714,2000,1267,716,1934,1229,705,2862,1792,1005,2489,1657,832,2846,1769,1003,2899,1818,1034,2489,1655,834,2072,1247,767,1979,1065,846
13085000003,4655,666,3989,4739,645,4049,4604,618,3986,6717,1052,5484,5979,1012,4967,6675,1040,5495,6785,1133,5559,5981,995,4986,4763,609,3981,4585,532,3777
13085000002,5025,535,4490,5116,492,4576,4919,490,4429,7069,775,6090,6315,778,5537,7023,777,6127,7134,849,6205,6316,765,5551,5306,476,4685,5044,420,4313
13069000005,918,194,724,962,199,759,877,170,707,1237,272,933,1076,244,832,1208,277,909,1261,288,963,1076,240,836,1029,225,797,934,208,694
13069000002,1146,208,938,1185,208,971,1107,188,919,1370,259,1089,1206,243,963,1326,256,1046,1374,264,1104,1204,242,962,1256,230,1008,1137,206,896
13155001529,2724,764,1960,2794,774,2011,2658,699,1959,2347,775,1527,2051,718,1333,2318,764,1519,2364,807,1544,2053,713,1340,2218,715,1465,2063,602,1412
13215000101,2395,1786,609,2466,1867,588,2249,1664,585,2924,2112,751,2678,2045,633,2930,2175,710,2968,2228,716,2682,2030,652,2744,2049,622,2542,1696,755
13215000103,2804,2639,165,2866,2724,138,2607,2458,149,3325,3036,246,3138,2955,183,3335,3068,229,3370,3124,230,3135,2948,187,3065,2852,179,2826,2494,281
13215000113,2975,2825,150,3051,2937,105,2777,2655,122,3660,3375,214,3425,3280,145,3654,3382,212,3707,3465,212,3418,3269,149,3138,2941,142,2892,2545,270
13179000004,1171,930,241,1191,956,226,1151,918,233,1766,1285,426,1529,1210,319,1752,1297,403,1787,1320,436,1530,1209,321,1234,913,283,1174,783,341
13179000009,1169,863,306,1176,872,295,1130,836,294,1554,1072,420,1352,1005,347,1565,1090,424,1582,1110,440,1351,1007,344,1257,870,338,1207,778,379
13245000604,890,615,275,909,632,269,871,612,259,1042,702,309,942,671,271,1035,710,308,1049,724,313,944,664,280,952,643,282,905,562,310
13245000102,661,505,156,684,513,161,640,480,160,633,444,161,569,435,134,639,462,156,651,483,160,566,429,137,731,520,189,665,421,207
13245000502,2094,1938,156,2139,1991,139,2017,1864,153,2539,2232,252,2301,2118,183,2531,2263,220,2569,2294,249,2300,2113,187,2322,2117,171,2135,1839,253
13245000504,901,636,265,935,650,280,879,611,268,1256,888,339,1109,843,266,1249,895,322,1265,909,336,1107,837,270,1038,706,309,955,617,306
13245000402,1333,1202,131,1354,1237,116,1272,1157,115,1703,1443,202,1451,1320,131,1704,1474,191,1729,1504,191,1447,1315,132,1574,1392,149,1434,1201,186
13207000008,1189,244,945,1215,226,981,1162,230,932,1605,316,1248,1439,315,1124,1597,313,1243,1623,332,1274,1438,310,1128,1156,240,876,1100,200,856
13245000807,703,535,168,717,544,169,681,514,167,932,669,232,808,625,183,921,664,226,941,698,232,809,617,192,761,544,197,695,473,200
13245000111,631,516,115,641,528,109,600,488,112,884,673,187,751,602,149,880,679,182,896,704,184,751,605,146,768,614,126,715,529,155
13013000003,1519,323,1196,1546,310,1221,1482,301,1181,2179,476,1616,1839,445,1394,2192,492,1616,2206,503,1662,1836,434,1402,1729,337,1318,1662,282,1276
13013000014,658,131,527,661,129,523,645,123,522,875,206,647,724,191,533,857,196,635,887,215,654,721,185,536,733,124,577,694,106,545
13211000006,1712,324,1388,1735,316,1408,1677,309,1368,2112,386,1687,1980,392,1588,2105,400,1670,2122,421,1682,1979,380,1599,1686,327,1330,1624,279,1280
13157002000,6241,1163,5078,6361,1110,5189,6125,1097,5028,8619,1590,6809,7480,1484,5996,8581,1613,6809,8694,1663,6915,7480,1464,6016,6622,1177,5265,6349,1062,5003
13011000004,401,36,365,409,32,375,395,38,357,509,41,454,423,34,389,509,47,453,516,42,471,425,36,389,415,29,375,401,35,347
13011000001,783,84,699,812,82,725,785,80,705,1008,98,884,866,99,767,997,100,879,1016,101,903,868,96,772,839,84,738,808,67,711
13157001000,8290,1488,6802,8429,1478,6872,8145,1435,6710,11681,2307,9045,10146,2202,7944,11604,2299,9049,11757,2429,9157,10141,2145,7996,8412,1394,6708,8097,1173,6537
13211000007,1628,360,1268,1668,346,1309,1606,340,1266,2082,453,1591,1894,433,1461,2071,460,1582,2099,475,1602,1894,431,1463,1698,376,1276,1642,334,1254
13211000004,1745,436,1309,1772,445,1311,1711,426,1285,2167,571,1558,2037,567,1470,2154,593,1535,2183,628,1543,2039,559,1480,1849,461,1345,1788,387,1338
13211000005,476,66,410,485,65,417,474,69,405,603,88,508,559,82,477,598,88,504,603,94,502,559,84,475,486,63,412,466,59,392
13155000901,541,42,499,552,36,516,537,37,500,1269,113,1139,1086,79,1007,1250,102,1129,1274,104,1160,1083,78,1005,1029,72,941,978,75,869
13013000005,2590,686,1904,2643,690,1923,2553,684,1869,3717,1037,2580,3289,1000,2289,3674,1040,2545,3742,1086,2613,3282,977,2305,2749,645,2009,2635,574,1940
130550P-870,260,41,219,267,37,224,253,42,211,351,52,292,294,43,251,349,53,285,359,51,305,294,44,250,323,48,272,304,54,238
13055000870,1596,262,1334,1646,238,1398,1577,265,1312,2390,389,1929,1914,339,1575,2313,384,1850,2413,368,2007,1911,335,1576,1931,306,1589,1818,338,1410
13055000962,304,37,267,309,28,281,298,30,268,378,38,336,346,31,315,377,37,334,385,37,348,345,28,317,330,30,295,305,31,259
130810LISTO,484,31,453,502,20,481,477,20,457,607,31,571,563,29,534,602,23,570,616,29,584,564,28,536,553,34,499,521,36,469
1310300004A,1902,407,1495,1933,404,1507,1856,388,1468,2570,594,1908,2242,546,1696,2525,595,1873,2585,596,1933,2242,544,1698,1849,353,1432,1782,296,1416
1310300001D,1121,150,971,1138,133,994,1095,137,958,1432,196,1203,1293,182,1111,1430,193,1202,1452,202,1230,1292,184,1108,1164,122,1006,1113,108,961
1310300005B,2024,673,1351,2050,667,1352,1974,639,1335,2693,958,1671,2392,900,1492,2672,937,1671,2713,970,1707,2390,904,1486,2166,648,1457,2062,561,1439
1310300005C,965,269,696,974,261,705,938,252,686,1224,368,826,1138,360,778,1217,361,823,1234,368,845,1139,354,785,995,219,741,969,197,738
13139000022,1263,1150,113,1318,1219,96,1177,1071,106,1643,1334,267,1456,1278,178,1655,1376,251,1686,1400,269,1455,1272,183,1321,1189,109,1205,1025,152
13139000012,1801,437,1364,1846,431,1395,1771,421,1350,2486,573,1838,2134,539,1595,2483,587,1832,2518,600,1870,2130,527,1603,1956,376,1503,1871,341,1409
13139000026,651,82,569,662,78,582,643,80,563,890,134,738,753,109,644,884,124,748,893,130,755,753,108,645,706,78,614,673,84,571
13139000005,2338,535,1803,2378,509,1835,2299,506,1793,3254,770,2391,2886,730,2156,3240,752,2404,3278,801,2424,2889,710,2179,2418,445,1869,2306,396,1767
13139000006,1800,509,1291,1828,486,1313,1760,471,1289,2455,678,1682,2112,642,1470,2442,662,1697,2476,693,1732,2108,624,1484,1966,476,1429,1879,415,1371
13139000024,1308,524,784,1352,552,781,1290,515,775,1731,710,971,1555,669,886,1721,691,972,1742,753,952,1557,668,889,1461,546,839,1397,411,899
13215000118,3226,1310,1916,3269,1274,1945,3127,1235,1892,4027,1697,2235,3645,1557,2088,4005,1668,2233,4041,1785,2190,3648,1547,2101,3436,1236,2067,3286,1005,2139
13215000117,2835,1420,1415,2888,1428,1437,2746,1352,1394,3554,1814,1660,3147,1679,1468,3523,1788,1660,3581,1865,1670,3142,1670,1472,3112,1395,1609,2931,1193,1628
13215000109,1851,490,1361,1884,493,1378,1806,472,1334,2171,607,1535,2100,626,1474,2173,613,1517,2193,722,1453,2101,615,1486,1976,516,1402,1876,369,1466
13215000125,1052,765,287,1076,786,277,1002,732,270,1383,966,368,1229,909,320,1372,963,367,1413,1014,382,1230,906,324,1220,848,328,1098,678,367
13215000119,2765,1024,1741,2807,965,1803,2671,938,1733,3609,1403,2109,3108,1272,1836,3581,1383,2104,3629,1434,2146,3107,1273,1834,3167,973,2079,2980,851,1971
13215000124,1898,815,1083,1943,790,1120,1835,757,1078,2499,1136,1302,2151,1045,1106,2493,1130,1287,2552,1183,1320,2150,1030,1120,2187,827,1268,2038,679,1253
13215000104,1297,478,819,1326,462,844,1250,438,812,1774,700,1013,1516,640,876,1768,715,1005,1786,723,1031,1519,640,879,1451,485,914,1346,394,877
13107001502,205,37,168,221,46,174,207,41,166,279,49,226,248,53,195,272,54,215,283,53,226,248,53,195,221,56,164,198,44,149
13139000007,3059,656,2403,3102,656,2418,2986,617,2369,4183,947,3139,3782,922,2860,4178,953,3129,4236,1025,3154,3782,907,2875,3387,647,2645,3261,553,2533
13139000004,2344,541,1803,2392,518,1832,2308,500,1808,3046,687,2283,2694,644,2050,3029,689,2278,3062,720,2300,2697,627,2070,2579,534,1949,2486,476,1869
13139000019,2515,484,2031,2545,458,2060,2491,462,2029,3230,646,2480,2822,609,2213,3226,620,2532,3242,690,2514,2826,596,2230,2759,468,2214,2647,393,2099
13139000025,708,227,481,726,230,482,693,217,476,923,335,562,820,328,492,922,326,571,933,362,547,819,325,494,852,269,535,828,222,553
13139000015,1697,182,1515,1730,167,1550,1689,166,1523,2213,240,1925,2027,239,1788,2207,222,1953,2217,259,1924,2027,230,1797,1730,161,1530,1681,148,1459
13139000013,1730,239,1491,1751,234,1509,1688,232,1456,2418,345,2003,2068,316,1752,2411,322,2049,2438,353,2068,2069,315,1754,1864,220,1604,1782,224,1484
13139000023,1765,944,821,1814,966,818,1716,900,816,2490,1218,1171,1933,1044,889,2482,1213,1175,2533,1264,1217,1934,1037,897,2123,950,1063,2007,803,1056
1310300005A,1535,293,1242,1557,280,1263,1495,285,1210,2008,443,1514,1805,430,1375,1984,417,1509,2028,445,1551,1803,428,1375,1623,283,1296,1537,244,1231
131210SC01C,1485,1438,47,1511,1475,35,1433,1398,35,1652,1582,57,1608,1565,43,1663,1591,57,1670,1599,60,1609,1561,48,1666,1602,49,1606,1461,107
131210SC08B,1957,1884,73,2006,1949,48,1884,1821,63,2567,2399,107,2411,2344,67,2574,2433,98,2586,2442,124,2411,2335,76,2016,1915,63,1908,1714,143
131210UC01D,2,2,0,2,2,0,2,2,0,0,0,0,0,0,0,0,0,0,0,0,0,0,0,0,0,0,0,0,0,0
131210SC17C,656,631,25,668,651,17,629,606,23,783,725,42,741,717,24,785,736,38,785,732,45,738,713,25,684,647,28,643,572,62
1312100008G,1632,933,699,1661,977,669,1612,929,683,2016,1164,807,1861,1119,742,1996,1162,780,2033,1265,737,1862,1102,760,1665,932,673,1606,692,844
1312100005C,63,59,4,67,62,3,63,59,4,45,40,5,31,29,2,45,40,4,44,38,5,31,29,2,66,63,3,66,57,4
1312100005K,1304,1211,93,1325,1246,68,1291,1211,80,1230,1072,113,1042,961,81,1218,1055,110,1238,1097,119,1042,958,84,1395,1255,85,1349,1120,152
1312100003C,645,621,24,671,658,12,623,611,12,755,704,27,738,730,8,765,723,22,766,728,27,736,728,8,762,738,14,697,625,57
131210ML05C,2581,1224,1357,2610,1263,1324,2547,1219,1328,3352,1603,1696,3106,1536,1570,3324,1580,1670,3388,1714,1644,3109,1510,1599,2780,1247,1417,2679,976,1595
1312100006R,1184,895,289,1203,963,230,1178,926,252,1360,1017,316,1298,1011,287,1357,1023,304,1366,1092,261,1299,1003,296,1136,885,211,1130,720,371
13121003P1A,1923,1660,263,1964,1742,195,1917,1680,237,2452,2064,328,2173,1906,267,2416,2008,313,2471,2118,313,2175,1884,291,1951,1592,243,1908,1371,378
13013000016,2904,981,1923,2955,983,1933,2829,926,1903,4571,1578,2839,3770,1439,2331,4509,1568,2801,4618,1623,2888,3765,1425,2340,3133,935,2047,2986,760,2034
13013000008,1728,363,1365,1749,349,1374,1681,355,1326,2332,501,1743,2026,489,1537,2329,508,1746,2357,527,1790,2022,483,1539,1851,328,1444,1762,301,1352
13013000015,1856,316,1540,1893,307,1572,1837,300,1537,2510,493,1952,2215,471,1744,2495,503,1921,2531,521,1973,2216,464,1752,1945,295,1604,1857,255,1491
13033000002,1173,401,772,1195,383,802,1145,379,766,1586,481,1080,1410,448,962,1584,496,1061,1599,503,1086,1408,448,960,1231,385,826,1176,369,778
13033000012,256,116,140,263,124,138,252,114,138,315,140,171,279,125,154,311,132,172,316,143,173,279,127,152,268,138,128,250,120,129
13193000002,740,441,299,788,479,307,705,409,296,857,494,347,781,469,312,847,494,340,868,511,353,778,462,316,789,487,287,723,398,307
13193000001,810,352,458,835,357,475,790,336,454,929,393,520,857,378,479,922,390,523,950,409,535,852,370,482,895,397,490,803,302,477
13193000004,954,646,308,996,670,325,921,606,315,1081,694,366,1006,700,306,1070,711,346,1098,740,352,1006,703,303,987,658,321,897,515,368
13117000019,3679,1392,2287,3729,1436,2252,3640,1349,2291,5354,2110,3134,4877,2027,2850,5274,2075,3050,5393,2284,3051,4878,1980,2898,3834,1278,2440,3681,938,2593
1312100JC01,3176,1855,1321,3229,1951,1241,3134,1864,1270,4504,2780,1650,4188,2675,1513,4427,2719,1595,4534,2910,1593,4192,2664,1528,3331,1875,1336,3230,1475,1617
13117000021,8023,2638,5385,8156,2765,5279,7970,2594,5376,10931,3979,6707,9871,3898,5973,10800,3919,6564,11013,4326,6531,9874,3819,6055,8562,2471,5737,8297,1759,6125
1312100JC02,1456,797,659,1478,814,651,1438,792,646,2204,1252,915,1998,1193,805,2165,1223,899,2238,1317,904,2001,1183,818,1465,727,703,1378,546,776
13117000001,9726,3389,6337,9846,3462,6246,9652,3293,6359,14656,5774,8582,13166,5464,7702,14478,5640,8445,14800,6161,8451,13184,5388,7796,10924,3378,7068,10632,2509,7621
13157004000,4102,903,3199,4181,849,3289,4022,854,3168,5483,1219,4147,4806,1180,3626,5464,1235,4135,5520,1266,4181,4803,1165,3638,4268,841,3309,4096,745,3173
13227000004,611,71,540,623,61,556,596,63,533,849,99,736,770,92,678,839,102,726,859,101,755,772,88,684,617,67,538,590,64,499
13207000006,284,101,183,297,105,187,279,95,184,325,110,211,310,103,207,322,108,208,330,113,214,308,102,206,277,93,178,263,74,178
13245000706,2074,781,1293,2108,787,1294,2040,756,1284,2445,920,1458,2173,854,1319,2444,928,1449,2472,972,1451,2173,840,1333,2217,737,1402,2143,622,1417
13245000310,2511,2005,506,2552,2042,492,2447,1950,497,3541,2686,777,3231,2589,642,3536,2695,763,3581,2729,799,3232,2591,641,2488,1843,578,2356,1662,617
13073000076,1125,401,724,1143,402,719,1099,389,710,1379,500,847,1230,462,768,1370,501,837,1391,532,832,1231,460,771,1207,388,770,1131,342,734
13245000104,1365,1279,86,1405,1324,73,1309,1225,84,1631,1461,132,1487,1410,77,1635,1500,106,1666,1540,109,1483,1406,77,1556,1444,93,1384,1202,152
13245000107,1098,557,541,1132,579,539,1084,543,541,1282,667,592,1216,660,556,1272,657,584,1295,697,578,1217,658,559,1127,534,561,1092,437,611
13245000306,2012,1303,709,2048,1326,704,1966,1263,703,2550,1622,869,2250,1516,734,2551,1634,855,2591,1681,867,2253,1513,740,2205,1275,861,2058,1107,871
13207000003,1719,319,1400,1757,307,1440,1703,302,1401,1985,358,1604,1924,368,1556,1968,347,1590,1997,389,1592,1925,365,1560,1733,314,1386,1691,241,1414
13245000802,1541,549,992,1566,522,1031,1501,522,979,2069,702,1324,1772,644,1128,2064,709,1306,2097,729,1344,1770,641,1129,1662,513,1117,1551,472,1033
13245000202,1884,1324,560,1934,1364,563,1789,1244,545,2510,1712,716,2183,1579,604,2503,1743,709,2551,1791,728,2183,1575,608,2292,1557,686,2109,1328,707
13071000010,367,131,236,382,133,244,360,121,239,431,138,286,382,129,253,425,135,284,437,140,294,383,127,256,406,149,251,366,115,244
13071000012,427,47,380,434,38,393,420,43,377,567,51,503,493,48,445,562,58,490,571,55,512,492,49,443,455,51,399,427,51,366
13071000013,275,16,259,281,14,267,265,14,251,318,27,291,294,25,269,314,25,288,320,27,291,295,21,274,289,23,265,277,12,263
13071000017,856,132,724,873,116,754,824,111,713,1050,171,869,922,156,766,1044,169,862,1064,170,888,921,153,768,891,131,745,836,101,710
131290849-A,2752,528,2224,2824,498,2300,2702,502,2200,3754,700,2974,3116,635,2481,3698,706,2909,3800,731,3045,3119,626,2493,3063,557,2443,2857,477,2280
131290849-B,4312,1203,3109,4409,1182,3169,4233,1143,3090,6158,1650,4349,5234,1580,3654,6076,1669,4227,6243,1739,4414,5228,1541,3687,4705,1164,3391,4424,938,3271
13129000980,760,105,655,779,92,679,749,103,646,1019,134,857,841,120,721,998,137,841,1028,137,878,842,122,720,843,120,700,790,120,635
13129000874,1065,138,927,1091,117,962,1050,122,928,1360,141,1174,1209,145,1064,1351,154,1166,1380,148,1215,1210,149,1061,1101,105,967,1039,111,866
131450000WH,883,252,631,891,208,676,861,199,662,1093,270,791,1082,318,764,1089,274,794,1099,283,798,1082,311,771,927,228,680,877,193,648
13069000001,8057,2718,5339,8340,2828,5475,7729,2528,5201,9923,3289,6436,8709,3128,5581,9785,3319,6281,10086,3485,6510,8704,3116,5588,9320,3173,5975,8570,2670,5674
13139000031,1805,479,1326,1823,479,1326,1773,459,1314,2823,785,1982,2638,777,1861,2783,761,1965,2829,842,1957,2638,750,1888,1557,364,1153,1510,293,1144
13139000028,5048,1127,3921,5149,1137,3954,5005,1090,3915,6931,1634,5146,6303,1614,4689,6916,1674,5118,6984,1834,5056,6303,1566,4737,5334,1108,4065,5125,851,4017
13139000014,1993,191,1802,2040,176,1847,1983,188,1795,2732,249,2425,2435,253,2182,2734,252,2455,2747,281,2428,2433,234,2199,2034,166,1819,1981,160,1747
13139000020,2632,514,2118,2676,515,2131,2617,497,2120,3168,669,2424,2985,700,2285,3179,649,2480,3185,761,2369,2985,676,2309,2797,541,2147,2738,389,2221
1310300003D,1562,428,1134,1598,442,1144,1514,414,1100,2225,600,1570,1955,565,1390,2190,583,1550,2244,608,1606,1956,565,1391,1600,427,1124,1511,322,1140
13055001216,114,18,96,116,15,101,112,17,95,131,19,109,109,17,92,127,17,107,132,19,113,109,16,93,122,16,106,121,18,101
13085000001,1710,392,1318,1726,382,1328,1691,376,1315,2138,462,1643,2093,484,1609,2155,477,1659,2162,504,1634,2092,470,1622,1635,363,1234,1577,281,1224
133130000ES,714,248,466,746,249,491,687,227,460,978,337,614,821,287,534,953,320,595,994,357,623,822,282,540,838,277,535,735,229,458
1331300005A,718,528,190,757,564,189,684,508,176,1109,734,337,889,669,220,1072,704,311,1130,771,342,885,665,220,862,604,231,755,481,224
1331300006A,516,371,145,546,403,140,500,366,134,815,531,251,647,456,191,803,519,240,832,562,258,645,448,197,684,474,185,596,371,188
13019001329,309,56,253,320,49,266,302,51,251,419,71,334,354,67,287,432,75,336,423,73,344,353,65,288,333,51,273,311,44,252
13019001144,645,112,533,657,102,550,630,105,525,864,140,694,734,137,597,833,131,688,867,143,718,731,130,601,687,109,565,649,90,527
1322300010C,4124,1456,2668,4195,1455,2686,4030,1396,2634,5367,1920,3317,4690,1828,2862,5312,1924,3266,5396,1954,3382,4692,1817,2875,4544,1259,3147,4351,1150,3008
130810ARABI,447,77,370,457,78,378,442,73,369,569,104,459,491,96,395,563,107,450,572,112,459,491,96,395,479,81,392,456,70,376
132410RABUN,7416,1513,5903,7578,1428,6063,7329,1450,5879,9472,1825,7392,8401,1835,6566,9386,1804,7382,9568,1984,7474,8407,1789,6618,7950,1444,6287,7563,1256,5977
13117000029,8654,2765,5889,8796,2846,5820,8610,2719,5891,11856,4288,7277,10682,4105,6577,11760,4252,7175,11985,4594,7227,10687,4021,6666,9029,2462,6180,8739,1916,6353
13117000025,5501,1886,3615,5590,1974,3527,5458,1828,3630,7683,2954,4583,6588,2743,3845,7562,2861,4515,7742,3160,4495,6592,2709,3883,5757,1805,3736,5529,1368,3928
13117000007,1794,451,1343,1836,469,1343,1775,440,1335,2838,812,1922,2486,762,1724,2825,819,1926,2871,870,1951,2494,745,1749,2037,472,1488,1943,374,1440
13117000016,6788,1624,5164,6883,1615,5158,6719,1590,5129,9601,2499,6798,8598,2396,6202,9516,2518,6743,9690,2712,6813,8609,2347,6262,7191,1415,5464,6979,1171,5349
13117000027,5794,1054,4740,5883,1037,4758,5761,1017,4744,8887,1864,6751,7816,1776,6040,8808,1858,6717,8926,2031,6738,7814,1733,6081,5820,860,4729,5634,689,4621
13117000015,5019,963,4056,5111,953,4079,4993,918,4075,7441,1712,5517,6771,1681,5090,7391,1685,5505,7490,1834,5550,6772,1636,5136,5107,779,4097,4890,645,3901
13071000011,655,88,567,669,86,581,639,80,559,721,99,610,659,98,561,716,102,601,730,107,613,656,99,557,667,86,573,618,71,537
13295001161,486,78,408,503,85,411,480,78,402,682,124,538,611,114,497,680,119,539,686,135,541,611,114,497,548,100,429,507,98,380
13295001800,156,25,131,158,26,131,156,26,130,217,40,173,198,38,160,204,31,170,219,43,173,198,38,160,173,32,137,163,31,123
13295001808,270,54,216,276,51,223,265,52,213,324,67,250,279,56,223,305,56,237,328,70,254,279,56,223,298,54,233,280,51,212
13295001898,1222,262,960,1250,262,973,1191,258,933,1701,357,1289,1354,319,1035,1698,336,1304,1717,378,1313,1354,319,1035,1409,275,1079,1296,249,976
13295001501,1842,387,1455,1882,394,1463,1789,382,1407,2549,528,1944,2041,474,1567,2525,500,1945,2588,574,1976,2043,479,1564,2114,414,1623,1942,363,1467
13055000940,539,98,441,554,98,452,533,102,431,715,119,578,628,117,511,697,125,552,720,114,598,628,116,512,562,96,455,540,98,420
13055XC-968,546,109,437,558,95,459,539,101,438,758,123,618,645,114,531,741,116,606,758,116,637,645,112,533,591,98,478,567,124,422
13147000003,978,164,814,1002,151,840,977,157,820,1371,253,1094,1210,226,984,1371,240,1103,1400,272,1118,1211,230,981,1072,207,843,1021,175,802
1311100TOCC,1830,356,1474,1870,342,1511,1799,340,1459,2454,427,1957,2212,455,1757,2435,444,1942,2495,471,2004,2215,448,1767,1969,350,1565,1842,288,1476
13285000008,2177,384,1793,2208,326,1870,2125,315,1810,2826,499,2282,2522,467,2055,2793,495,2252,2844,515,2308,2526,464,2062,2346,348,1958,2239,326,1833
13219000011,1847,673,1174,1882,699,1164,1827,666,1161,2119,799,1283,2021,790,1231,2101,811,1249,2113,857,1217,2018,777,1241,1835,639,1105,1814,500,1243
13219000009,1669,457,1212,1695,467,1205,1657,453,1204,1949,534,1359,1765,513,1252,1943,546,1353,1947,571,1348,1767,502,1265,1670,420,1155,1629,345,1204
13285000003,2115,1323,792,2177,1366,797,2057,1267,790,2747,1662,1037,2345,1518,827,2730,1684,995,2764,1709,1025,2344,1512,832,2291,1270,974,2152,1134,945
13219000004,469,130,339,486,132,349,462,128,334,596,162,421,527,164,363,591,165,410,600,174,421,527,163,364,468,125,327,450,100,329
13219000013,1216,449,767,1235,457,754,1200,449,751,1494,559,893,1398,561,837,1492,566,883,1496,604,857,1398,550,848,1221,447,696,1238,359,796
13285000004,1066,992,74,1107,1058,48,991,930,61,1233,1090,117,1104,1040,64,1225,1110,97,1261,1153,94,1096,1031,65,1225,1146,64,1077,943,114
13285000016,1522,605,917,1541,626,908,1492,584,908,1830,747,1054,1647,726,921,1818,772,1021,1848,791,1042,1648,713,935,1666,631,997,1585,510,1023
13285000011,1878,487,1391,1914,474,1427,1842,438,1404,2460,642,1781,2151,616,1535,2423,634,1745,2473,657,1789,2150,610,1540,2141,503,1600,2018,427,1538
13285000005,975,665,310,1021,693,322,913,606,307,1262,801,442,1083,730,353,1243,789,430,1271,814,441,1083,728,355,1186,779,396,1068,661,384
13233000006,2973,716,2257,3031,708,2302,2880,686,2194,4174,958,3104,3526,904,2622,4123,973,3068,4208,989,3178,3527,898,2629,3341,772,2506,3121,668,2328
13233000001,1616,268,1348,1656,252,1394,1556,238,1318,2309,381,1887,1977,359,1618,2263,374,1847,2332,386,1926,1978,359,1619,1789,262,1493,1695,264,1369
13285000002,1616,1142,474,1674,1199,462,1548,1087,461,2031,1340,649,1735,1253,482,2021,1355,610,2063,1404,635,1731,1248,483,1970,1347,572,1776,1108,608
13213001013,1164,166,998,1213,148,1055,1137,146,991,1689,231,1410,1400,207,1193,1626,218,1365,1709,238,1453,1401,209,1192,1327,175,1123,1189,194,962
13163001460,370,126,244,388,132,252,342,111,231,450,167,281,406,154,252,449,160,283,455,172,280,406,153,253,410,146,257,383,122,257
13163000082,2212,1252,960,2303,1321,974,2100,1161,939,2593,1463,1100,2382,1420,962,2551,1472,1049,2625,1534,1078,2383,1408,975,2418,1441,961,2128,1145,958
13147000002,3655,1088,2567,3780,1090,2658,3577,1041,2536,4679,1347,3230,4207,1356,2851,4576,1264,3228,4754,1451,3258,4206,1361,2845,3911,1235,2596,3534,1036,2372
13117000010,11306,3096,8210,11444,3180,8100,11260,3082,8178,15700,4663,10603,14316,4565,9751,15526,4691,10456,15803,5074,10490,14324,4465,9859,11944,2805,8559,11571,2184,8725
1306300RD08,1627,1478,149,1654,1515,135,1579,1437,142,1921,1709,181,1864,1701,163,1922,1707,169,1939,1722,205,1865,1700,165,1654,1474,162,1560,1304,225
1300900CTY1,641,471,170,664,501,158,620,460,160,766,571,182,670,542,128,759,579,156,771,583,179,666,537,129,679,524,131,635,456,161
13179000013,224,154,70,224,158,62,219,156,63,546,301,205,347,222,125,539,308,198,559,317,221,347,223,124,379,194,160,364,175,164
133130000DG,1720,488,1232,1759,474,1266,1664,455,1209,2254,648,1534,2026,632,1394,2221,625,1514,2276,698,1542,2029,637,1392,1941,500,1372,1798,443,1274
1331300004A,1535,499,1036,1565,523,1022,1497,488,1009,1879,654,1185,1740,641,1099,1858,621,1170,1902,710,1169,1739,640,1099,1688,531,1096,1606,447,1079
13167001201,1415,560,855,1491,592,890,1354,510,844,1732,702,981,1504,634,870,1721,710,981,1765,754,992,1503,633,870,1606,691,900,1429,525,870
13167001820,201,72,129,214,79,135,200,70,130,238,90,146,215,82,133,227,82,145,248,98,150,215,82,133,226,88,138,205,72,131
13167001405,184,72,112,193,76,117,178,67,111,230,96,128,201,87,114,207,85,122,233,101,132,201,87,114,213,94,119,184,68,114
1300900CTY3,593,481,112,617,504,108,571,461,110,683,527,142,566,470,96,676,519,139,687,547,134,565,467,98,686,534,124,629,457,148
1300700000M,168,66,102,174,60,112,163,60,103,200,65,135,191,64,127,199,68,130,206,69,137,192,64,128,209,74,133,196,64,130
13213001895,1800,311,1489,1842,297,1536,1743,288,1455,2524,468,1999,2174,414,1760,2460,430,1951,2553,471,2059,2172,412,1760,2068,325,1693,1864,298,1490
13213000824,2969,488,2481,3061,449,2577,2897,458,2439,4109,685,3308,3494,635,2859,3990,612,3255,4175,704,3412,3496,634,2862,3375,544,2761,3015,489,2393
13063000LJ3,3590,3076,514,3649,3147,490,3456,2973,483,5028,4247,665,4745,4222,523,5060,4324,640,5090,4352,700,4738,4205,533,3324,2696,572,3123,2404,644
1306300JB06,1669,894,775,1711,915,778,1647,868,779,1980,1068,881,1901,1067,834,1974,1067,876,1996,1100,873,1904,1069,835,1725,845,843,1659,720,899
1306300JB11,2132,1726,406,2185,1758,415,2089,1681,408,2585,2023,504,2433,2006,427,2591,2065,472,2606,2060,525,2433,1994,439,2198,1663,491,2069,1444,555
13285000006,1612,598,1014,1649,589,1048,1564,574,990,2342,728,1562,2092,728,1364,2307,734,1532,2366,751,1590,2090,728,1362,1748,627,1092,1638,531,1040
13219000010,2913,836,2077,2959,878,2038,2895,864,2031,3491,1101,2318,3291,1089,2202,3451,1116,2267,3493,1211,2217,3294,1068,2226,2783,821,1822,2757,636,2010
13285000012,1121,445,676,1152,451,696,1106,422,684,1510,620,865,1315,585,730,1495,626,842,1521,639,863,1317,582,735,1228,451,756,1158,405,718
13233000007,1039,127,912,1060,101,952,1017,113,904,1422,162,1222,1224,143,1081,1421,167,1227,1430,165,1251,1224,144,1080,1157,129,1004,1099,137,905
13255000013,1333,186,1147,1362,158,1190,1305,169,1136,1691,247,1406,1463,232,1231,1684,256,1408,1704,249,1445,1464,226,1238,1473,171,1261,1404,166,1171
13255000010,1133,407,726,1158,415,734,1112,388,724,1439,523,896,1275,492,783,1439,529,895,1459,537,910,1275,488,787,1134,359,750,1064,309,713
13255000006,950,754,196,995,806,181,904,716,188,1238,928,278,1086,858,228,1234,942,278,1255,952,292,1080,849,231,1075,839,221,958,671,260
13255000002,777,704,73,814,750,59,733,661,72,955,826,103,848,786,62,963,849,103,967,844,116,849,785,64,938,855,72,832,687,128
13167001746,194,20,174,195,17,178,186,18,168,235,24,208,216,24,192,225,17,208,241,25,216,216,24,192,203,25,177,185,19,161
13167001266,277,31,246,283,28,254,275,31,244,341,38,298,310,35,275,348,43,298,342,36,306,309,35,274,293,39,250,276,33,236
13073000134,1494,484,1010,1506,505,989,1457,481,976,1564,529,1010,1437,514,923,1548,522,999,1576,559,1003,1438,512,926,1466,471,957,1400,377,971
13073000075,1463,511,952,1471,504,958,1438,496,942,1793,653,1089,1604,614,990,1789,639,1093,1817,675,1106,1606,612,994,1556,457,1039,1502,403,1042
13073000074,1070,422,648,1091,422,653,1041,409,632,1407,582,785,1229,547,682,1399,567,789,1416,598,799,1229,543,686,1205,415,729,1142,355,726
13073000085,679,162,517,686,155,527,661,154,507,887,234,630,767,211,556,871,222,635,890,244,632,768,210,558,773,156,596,720,133,553
1306300RD02,1627,1550,77,1648,1587,59,1569,1505,64,1899,1751,111,1751,1685,66,1898,1761,100,1916,1772,124,1751,1691,60,1680,1580,77,1569,1403,125
13113000014,2291,655,1636,2331,680,1626,2286,652,1634,2930,918,1960,2778,900,1878,2902,913,1926,2939,999,1900,2778,879,1899,2492,617,1787,2434,480,1863
13113000033,1251,387,864,1272,389,865,1251,388,863,1513,456,1018,1403,457,946,1499,460,1004,1526,487,1016,1402,455,947,1382,380,949,1327,296,954
13113000008,1983,1168,815,2017,1194,811,1958,1147,811,2358,1395,925,2232,1385,847,2346,1400,905,2360,1415,920,2231,1374,857,2058,1088,919,2022,980,975
13113000027,1940,653,1287,1965,661,1273,1933,656,1277,2528,921,1553,2406,953,1453,2500,930,1515,2520,970,1519,2407,930,1477,2007,608,1333,1967,527,1348
13045000642,2977,1474,1503,3040,1511,1498,2890,1419,1471,4243,2097,2011,3634,2006,1628,4219,2129,2001,4293,2139,2070,3637,1990,1647,3184,1402,1675,3005,1212,1648
13097001258,3346,1762,1584,3405,1801,1573,3250,1697,1553,4546,2485,1940,4175,2478,1697,4558,2523,1934,4614,2574,1972,4177,2466,1711,3584,1695,1773,3455,1501,1806
13045000649,1907,400,1507,1934,368,1543,1859,372,1487,2658,489,2093,2235,461,1774,2650,493,2086,2698,506,2154,2235,455,1780,2117,375,1674,2015,365,1553
13045000641,2497,783,1714,2533,748,1754,2448,762,1686,3402,1002,2277,2839,976,1863,3394,1035,2271,3439,1030,2358,2839,968,1871,2668,703,1898,2527,624,1774
132470000BT,2184,815,1369,2238,811,1411,2152,780,1372,2715,1091,1567,2463,1030,1433,2707,1097,1555,2737,1099,1600,2463,1021,1442,2368,761,1542,2269,680,1495
13211000002,1438,300,1138,1458,297,1149,1415,295,1120,1821,374,1410,1690,377,1313,1812,382,1404,1832,395,1412,1692,373,1319,1349,298,1022,1295,234,1015
13219000003,946,217,729,974,215,752,937,211,726,1162,258,878,1084,275,809,1147,263,859,1166,280,874,1082,259,823,922,204,685,908,157,716
13285000010,2150,496,1654,2181,478,1690,2103,453,1650,2778,612,2127,2452,615,1837,2741,604,2095,2789,629,2133,2453,603,1850,2335,469,1799,2215,430,1697
13293005610,4055,1753,2302,4200,1808,2363,3928,1631,2297,5076,2099,2871,4407,2036,2371,5073,2204,2774,5129,2236,2846,4405,2017,2388,4379,1837,2465,4092,1507,2460
13293000561,312,137,175,319,138,179,298,124,174,386,161,221,338,158,180,378,159,211,390,169,218,337,155,182,331,140,188,309,116,187
13293000589,281,234,47,287,247,39,266,227,39,306,262,41,291,257,34,309,259,46,312,266,44,290,255,35,276,240,32,255,210,43
13117000003,5665,1114,4551,5745,1069,4575,5627,1052,4575,7414,1587,5586,6642,1531,5111,7355,1593,5559,7485,1706,5644,6642,1501,5141,6138,1012,4869,5961,805,4770
13219000001,1522,527,995,1547,551,985,1515,535,980,1666,623,997,1556,625,931,1660,625,981,1672,673,961,1559,614,945,1516,497,947,1502,411,1010
130450714A3,1883,748,1135,1914,759,1127,1846,718,1128,2385,979,1353,2146,925,1221,2364,965,1338,2398,1035,1327,2143,912,1231,1951,741,1138,1884,587,1217
13045000640,1456,303,1153,1475,287,1173,1439,289,1150,1895,395,1460,1679,381,1298,1893,406,1454,1918,415,1484,1678,377,1301,1516,298,1178,1465,257,1134
132470000OT,2749,2326,423,2795,2388,398,2671,2261,410,3637,3029,527,3235,2853,382,3624,3049,520,3688,3107,553,3236,2851,385,3006,2424,513,2872,2220,564
13217000012,2681,736,1945,2719,718,1988,2626,694,1932,3188,906,2238,2986,921,2065,3182,908,2215,3212,943,2244,2988,916,2072,2791,654,2072,2697,601,1997
132470000FI,3599,3016,583,3648,3071,555,3508,2954,554,4262,3595,582,3964,3494,470,4288,3653,559,4314,3672,609,3960,3488,472,3498,2717,698,3346,2502,748
132470000CO,1708,1312,396,1741,1349,384,1659,1269,390,2167,1670,452,1961,1587,374,2166,1689,430,2190,1714,453,1959,1580,379,1748,1269,439,1658,1136,464
13113000026,1803,862,941,1845,870,947,1786,843,943,2362,1134,1174,2188,1124,1064,2334,1136,1147,2388,1188,1166,2188,1117,1071,1908,785,1051,1843,661,1099
13113000029,1585,1006,579,1615,1033,570,1533,970,563,1956,1257,657,1791,1222,569,1947,1256,643,1978,1299,664,1792,1222,570,1743,985,714,1650,839,739
131450000HA,1625,619,1006,1653,556,1086,1575,510,1065,2078,693,1330,1852,663,1189,2066,689,1330,2090,718,1342,1852,660,1192,1535,509,987,1436,422,954
131450000CA,1822,472,1350,1857,409,1429,1771,374,1397,2274,545,1687,2093,518,1575,2274,542,1694,2304,580,1696,2091,508,1583,1883,379,1454,1793,302,1441
13129000856,918,149,769,944,140,798,914,145,769,1259,185,1034,1109,173,936,1254,194,1028,1263,194,1058,1109,171,938,979,138,817,946,122,777
13215000102,1993,1921,72,2062,2007,52,1855,1791,64,2328,2159,129,2096,2018,78,2317,2171,115,2370,2227,122,2091,2005,86,2201,2095,80,1957,1747,174
13215000116,3428,3016,412,3493,3096,383,3214,2837,377,4405,3757,565,4001,3568,433,4437,3822,549,4488,3896,553,3999,3567,432,3768,3213,483,3446,2784,583
13215000126,1589,1062,527,1618,1065,541,1525,1005,520,1984,1319,618,1786,1246,540,1995,1342,620,2022,1365,641,1785,1245,540,1757,1088,625,1642,949,641
13215000107,1519,702,817,1554,691,848,1446,655,791,2125,956,1112,1759,870,889,2109,964,1091,2143,1000,1118,1761,874,887,1841,764,1012,1684,656,947
13227000010,1750,347,1403,1791,342,1433,1748,340,1408,2071,434,1587,1930,437,1493,2067,436,1594,2096,474,1586,1934,429,1505,1820,340,1434,1765,307,1382
13227000007,932,113,819,956,99,849,916,113,803,1218,120,1059,1082,119,963,1200,135,1043,1227,131,1086,1083,116,967,1056,104,933,1003,100,852
13171001713,1669,386,1283,1700,373,1305,1621,351,1270,2021,437,1536,1784,419,1365,2014,452,1525,2031,466,1546,1783,410,1373,1785,403,1344,1706,375,1275
130450714A1,1700,1129,571,1750,1170,563,1639,1086,553,2247,1358,797,1846,1226,620,2242,1394,779,2277,1429,802,1845,1218,627,1951,1228,665,1838,1069,683
13045001496,695,181,514,707,178,525,676,167,509,964,218,720,852,200,652,960,224,711,971,227,738,852,197,655,698,181,504,662,165,467
130450714BN,771,269,502,785,269,509,758,259,499,965,310,633,868,326,542,966,333,614,984,337,638,869,324,545,801,268,508,756,233,487
13113000004,1140,649,491,1161,663,488,1128,635,493,1499,875,579,1359,853,506,1494,893,563,1509,915,568,1362,851,511,1283,634,611,1220,533,623
13113000002,1627,212,1415,1654,206,1430,1612,205,1407,2136,314,1789,2031,304,1727,2106,316,1751,2155,343,1793,2031,300,1731,1724,194,1468,1680,163,1442
13255000019,1571,446,1125,1597,443,1147,1532,423,1109,1867,524,1308,1724,537,1187,1866,540,1308,1890,540,1336,1724,531,1193,1697,408,1250,1608,369,1161
13255000005,1627,928,699,1673,952,704,1571,890,681,2058,1142,861,1851,1120,731,2042,1170,836,2078,1187,873,1850,1106,744,1926,993,875,1801,855,882
13045001483,2104,464,1640,2142,461,1659,2072,451,1621,2725,594,2063,2383,558,1825,2705,609,2040,2745,617,2095,2382,540,1842,2135,419,1647,2087,366,1627
13255000001,757,659,98,802,715,78,726,632,94,995,830,133,851,769,82,1004,844,136,1017,859,152,853,768,85,850,741,101,739,591,126
13113000003,2246,1972,274,2283,2035,241,2194,1944,250,2536,2178,316,2468,2193,275,2541,2204,301,2560,2211,323,2468,2181,287,2225,1903,286,2126,1734,347
13045001533,1042,152,890,1067,136,920,1029,138,891,1355,179,1163,1238,160,1078,1344,187,1138,1365,188,1168,1240,159,1081,1072,165,882,1004,140,819
13057000026,4362,1561,2801,4412,1592,2763,4317,1529,2788,5912,2120,3655,5241,2027,3214,5862,2176,3553,5987,2310,3584,5243,1986,3257,4449,1458,2791,4359,1148,2976
13057000042,1850,434,1416,1887,432,1425,1833,410,1423,2379,570,1724,2094,538,1556,2366,596,1705,2409,613,1756,2093,519,1574,2025,387,1531,1934,338,1468
13057000002,2947,743,2204,2983,757,2170,2922,725,2197,3942,1023,2812,3526,971,2555,3906,1007,2780,3967,1099,2796,3529,958,2571,2953,618,2184,2878,501,2173
13057000004,2220,326,1894,2259,317,1916,2203,328,1875,3056,463,2496,2681,472,2209,3015,492,2448,3090,489,2549,2682,465,2217,2299,279,1941,2227,228,1881
13057000039,3024,535,2489,3069,526,2499,2989,531,2458,4056,811,3141,3649,798,2851,3999,811,3095,4088,863,3167,3652,774,2878,3291,502,2654,3173,446,2538
131450000U9,1014,223,791,1030,153,866,999,143,856,1304,203,1079,1212,195,1017,1292,199,1072,1302,210,1082,1211,193,1018,993,150,823,948,128,791
13073000031,1124,670,454,1140,676,450,1091,648,443,1657,1003,606,1479,977,502,1651,993,610,1692,1053,611,1479,977,502,1182,600,536,1107,528,523
13045001006,636,51,585,649,35,611,628,38,590,862,68,775,726,59,667,847,64,767,861,68,787,726,56,670,667,51,602,631,48,551
130450714BW,1354,303,1051,1381,322,1044,1336,311,1025,1666,397,1229,1517,397,1120,1651,409,1207,1677,437,1216,1519,384,1135,1431,310,1070,1395,257,1063
132470000LA,970,678,292,986,691,287,952,658,294,1208,836,340,1071,775,296,1219,838,349,1228,855,351,1071,773,298,1039,670,326,1008,627,342
132470000MA,1787,871,916,1813,881,923,1759,849,910,2202,1193,951,2025,1162,863,2186,1196,939,2223,1226,962,2025,1153,872,1869,776,1038,1823,708,1049
13113000034,2406,636,1770,2447,661,1751,2374,624,1750,3429,978,2375,3164,990,2174,3377,966,2331,3435,1068,2320,3165,966,2199,2477,643,1711,2411,486,1799
13057000018,3405,619,2786,3456,630,2766,3384,632,2752,4648,897,3646,4182,895,3287,4636,927,3610,4690,1016,3596,4183,868,3315,3501,525,2851,3405,430,2778
13057000010,3710,1116,2594,3772,1104,2619,3640,1053,2587,5688,1770,3776,5184,1727,3457,5654,1807,3728,5778,1894,3814,5184,1707,3477,3514,1004,2389,3333,813,2357
13057000013,2309,437,1872,2356,416,1910,2286,411,1875,3695,748,2832,3296,751,2545,3658,767,2794,3728,790,2864,3295,729,2566,2246,317,1842,2144,266,1768
13057000022,1421,360,1061,1445,343,1080,1403,336,1067,2206,563,1542,1848,534,1314,2169,556,1517,2218,579,1579,1848,525,1323,1591,292,1224,1533,275,1154
13171001714,2285,453,1832,2325,407,1899,2201,393,1808,2911,505,2353,2599,492,2107,2896,524,2328,2922,527,2368,2601,490,2111,2322,404,1881,2231,381,1757
1305103-10C,1325,1160,165,1353,1176,172,1262,1096,166,1595,1351,215,1468,1288,180,1591,1353,213,1609,1369,220,1469,1287,182,1454,1227,200,1365,1067,271
1305107-08C,1149,215,934,1184,198,975,1116,203,913,1752,365,1343,1562,369,1193,1744,357,1343,1775,368,1388,1563,377,1186,1386,227,1108,1304,192,1053
1305107-12C,2843,1532,1311,2870,1557,1283,2796,1517,1279,4983,2516,2341,4404,2348,2056,4963,2489,2345,5057,2600,2370,4404,2333,2071,3242,1518,1635,3118,1298,1711
1305107-11C,2003,1291,712,2036,1344,669,1970,1296,674,3965,2443,1388,3249,2186,1063,3954,2404,1402,4011,2480,1448,3249,2179,1070,2014,1058,848,1944,941,904
1305104-08C,1757,480,1277,1799,477,1301,1738,467,1271,2183,634,1520,2084,603,1481,2170,608,1526,2201,669,1497,2087,589,1498,1859,473,1326,1809,344,1402
1305104-06C,1432,415,1017,1457,425,1012,1401,415,986,1780,523,1228,1649,499,1150,1761,499,1226,1785,531,1226,1648,493,1155,1466,383,1023,1410,321,1036
1305102-11C,836,698,138,862,737,119,807,678,129,997,816,164,905,769,136,992,815,155,1014,839,163,906,767,139,950,768,153,886,635,213
1305102-05C,1028,932,96,1048,963,76,997,909,88,1267,1098,132,1208,1093,115,1263,1088,137,1280,1123,135,1206,1088,118,1096,953,108,1049,833,149
1305105-06C,1012,878,134,1036,908,123,973,840,133,1248,1019,184,1129,980,149,1261,1038,184,1274,1054,197,1128,976,152,1202,1010,165,1112,878,197
1305107-10C,1782,1152,630,1820,1175,615,1749,1135,614,2574,1631,860,2235,1508,727,2567,1624,860,2605,1649,898,2235,1506,729,1890,1073,727,1798,928,775
1305108-05C,539,516,23,549,536,10,500,481,19,679,620,38,625,613,12,672,637,22,687,639,36,623,610,13,667,642,17,608,527,64
1305108-06C,460,438,22,482,468,14,442,423,19,531,490,24,502,492,10,532,502,16,542,509,26,497,488,9,471,456,8,427,366,48
1305108-12C,469,388,81,480,403,74,452,382,70,654,528,112,575,496,79,643,515,117,652,526,114,574,498,76,554,434,104,508,360,125
1305107-14C,3417,2368,1049,3472,2422,1028,3350,2327,1023,5003,3269,1615,4496,3115,1381,4981,3269,1597,5073,3374,1629,4494,3110,1384,3743,2351,1278,3547,2050,1375
1305102-09C,1610,1407,203,1642,1462,167,1542,1353,189,1998,1696,252,1891,1662,229,1994,1711,238,2025,1742,256,1893,1656,237,1810,1553,202,1706,1330,305
1305101-12C,1365,378,987,1400,400,990,1362,374,988,1627,484,1127,1593,477,1116,1619,476,1123,1640,544,1080,1595,473,1122,1449,417,978,1427,289,1107
131310000SH,349,38,311,356,37,317,344,36,308,432,55,370,389,47,342,420,46,366,435,55,376,390,49,341,386,44,337,353,40,304
13087000513,3057,1135,1922,3144,1156,1975,2976,1064,1912,3922,1524,2341,3452,1344,2108,3880,1501,2285,3983,1601,2345,3452,1343,2109,3568,1363,2165,3308,1140,2090
13171001711,1237,860,377,1279,910,361,1173,814,359,1497,980,481,1287,921,366,1486,1003,457,1514,1013,482,1282,913,369,1367,939,410,1245,779,435
1317101712A,874,178,696,884,169,713,851,167,684,1195,203,966,1051,192,859,1189,217,951,1198,207,975,1051,187,864,878,147,713,841,141,668
131310000WL,1306,183,1123,1334,164,1163,1302,176,1126,1684,263,1393,1519,233,1286,1662,258,1373,1697,284,1406,1518,231,1287,1478,215,1243,1395,203,1149
1313100000L,184,33,151,186,30,156,181,26,155,240,41,196,225,43,182,240,45,194,243,46,196,225,43,182,193,27,165,180,23,153
13215000110,2095,1975,120,2172,2078,90,1953,1841,112,2732,2476,198,2452,2336,116,2740,2505,181,2798,2589,188,2457,2336,121,2578,2420,126,2314,2025,245
13227000008,1164,232,932,1195,234,944,1147,228,919,1571,337,1192,1284,299,985,1560,323,1206,1593,337,1240,1284,298,986,1314,246,1024,1253,200,984
13057000044,3991,1454,2537,4034,1451,2514,3936,1402,2534,5535,2055,3290,4874,1981,2893,5490,2100,3227,5578,2179,3295,4876,1951,2925,4375,1286,2842,4258,1063,2890
13057000012,3561,1335,2226,3611,1366,2179,3520,1317,2203,5133,1955,3010,4522,1886,2636,5078,1965,2952,5176,2124,2954,4521,1847,2674,3496,1177,2138,3380,955,2163
1305107-09C,1163,662,501,1177,658,506,1136,643,493,1684,955,696,1478,868,610,1685,955,694,1702,974,702,1475,864,611,1287,613,622,1224,527,636
1305106-11C,2095,1489,606,2133,1526,591,2047,1447,600,3128,2089,956,2702,1947,755,3108,2076,946,3148,2099,999,2702,1943,759,2218,1347,783,2094,1170,825
1305102-07C,1348,1140,208,1388,1179,188,1281,1093,188,1571,1299,234,1478,1273,205,1567,1301,227,1589,1347,220,1476,1275,201,1527,1278,197,1460,1110,291
1305107-03C,595,183,412,605,169,428,578,179,399,760,238,500,678,224,454,759,228,502,768,244,510,678,226,452,755,208,519,682,181,459
1305107-04C,1373,1051,322,1390,1061,309,1342,1025,317,1916,1449,420,1659,1343,316,1919,1463,415,1927,1464,441,1659,1341,318,1807,1181,575,1718,1042,603
1305107-01C,689,305,384,709,304,400,676,285,391,904,401,474,842,394,448,893,406,464,914,408,496,844,397,447,790,318,460,742,266,449
1305108-13C,301,90,211,305,90,209,290,89,201,405,131,254,338,117,221,411,141,255,417,140,268,338,115,223,405,131,258,375,113,248
1305108-03C,351,126,225,356,123,232,346,122,224,466,159,297,417,155,262,470,159,303,473,164,304,418,157,261,416,134,275,391,109,268
1305101-16C,1648,445,1203,1677,430,1224,1606,424,1182,2089,568,1491,1979,542,1437,2082,540,1498,2110,589,1497,1983,544,1439,1836,448,1329,1759,361,1339
1305108-01C,312,245,67,320,263,56,304,246,58,325,252,66,294,246,48,325,249,63,337,267,64,293,243,50,359,277,70,331,225,86
1305104-04C,1433,425,1008,1461,425,1024,1422,428,994,1838,578,1221,1756,577,1179,1825,586,1199,1853,608,1222,1760,583,1177,1553,423,1076,1495,355,1072
1305104-05C,1455,456,999,1475,459,991,1420,456,964,1742,577,1111,1634,556,1078,1724,570,1107,1762,601,1125,1636,556,1080,1554,437,1052,1505,356,1091
1305104-15C,1350,420,930,1377,438,931,1331,408,923,1559,504,1042,1551,514,1037,1570,515,1047,1572,571,990,1556,511,1045,1402,434,940,1367,300,1045
1305104-12C,1687,466,1221,1704,482,1201,1665,452,1213,1972,554,1401,1942,567,1375,1972,565,1383,1990,619,1355,1941,548,1393,1780,520,1215,1721,358,1324
1305103-01C,264,142,122,266,146,114,262,143,119,298,165,126,289,167,122,301,167,127,302,176,122,290,168,122,305,168,123,295,135,142
1305108-07C,286,271,15,294,281,13,268,252,16,336,315,15,313,300,13,336,310,17,338,320,17,314,301,13,330,312,12,297,259,36
13073000030,1602,837,765,1627,850,761,1584,833,751,2236,1116,1048,1898,1030,868,2222,1101,1047,2252,1149,1064,1900,1037,863,1770,812,883,1693,708,899
13135000012,2633,1982,651,2676,2011,636,2550,1908,642,3594,2557,967,3104,2379,725,3490,2472,905,3639,2589,1008,3099,2359,740,2911,2100,709,2746,1793,804
13135000068,2169,1133,1036,2193,1178,988,2128,1120,1008,2762,1565,1147,2554,1514,1040,2715,1533,1120,2770,1606,1123,2555,1504,1051,2307,1107,1111,2232,920,1217
13135000133,2530,1020,1510,2569,1027,1521,2466,990,1476,3476,1485,1882,3046,1411,1635,3406,1458,1852,3494,1533,1919,3046,1405,1641,2686,897,1683,2574,767,1659
13135000077,2705,1792,913,2753,1826,896,2669,1751,918,3849,2531,1226,3375,2336,1039,3751,2476,1182,3869,2609,1217,3375,2321,1054,2905,1765,1034,2768,1486,1146
13135000057,2402,1503,899,2428,1539,849,2354,1502,852,3283,2014,1174,2890,1895,995,3217,1976,1144,3319,2076,1204,2892,1880,1012,2390,1393,876,2262,1199,906
13135000047,1808,701,1107,1836,712,1095,1789,685,1104,2353,1062,1237,2200,1064,1136,2327,1042,1222,2367,1133,1209,2202,1048,1154,1936,644,1217,1886,494,1305
13135000089,1860,794,1066,1890,814,1041,1832,786,1046,2657,1183,1378,2317,1140,1177,2610,1174,1355,2663,1238,1373,2317,1120,1197,1871,671,1099,1803,558,1138
13135000024,2115,907,1208,2137,928,1185,2069,899,1170,3008,1317,1599,2596,1229,1367,2956,1326,1541,3034,1389,1598,2600,1219,1381,2138,804,1249,2033,683,1232
13135000100,2525,1174,1351,2559,1220,1301,2492,1169,1323,3586,1736,1761,3164,1641,1523,3492,1679,1707,3602,1818,1725,3163,1617,1546,2562,1078,1350,2511,888,1476
13135000106,2784,1326,1458,2841,1374,1428,2774,1329,1445,4056,2063,1893,3629,1975,1654,3934,2018,1834,4104,2190,1859,3630,1944,1686,2847,1221,1510,2719,924,1638
13135000028,3248,1387,1861,3293,1406,1838,3175,1347,1828,4457,2066,2289,4059,1978,2081,4394,2016,2273,4482,2139,2277,4059,1942,2117,3364,1302,1934,3189,1091,1973
13135000038,1080,774,306,1107,808,281,1041,750,291,1519,1026,444,1346,990,356,1470,1005,426,1544,1065,452,1345,977,368,1021,698,295,954,591,308
130890000JB,1701,1453,248,1768,1518,234,1626,1380,246,2160,1716,393,2026,1718,308,2144,1696,383,2202,1753,427,2022,1704,318,1807,1499,258,1694,1303,319
130890000CK,2647,2384,263,2724,2495,207,2536,2315,221,3371,2896,383,3040,2768,272,3353,2860,371,3400,2952,408,3029,2754,275,2821,2507,254,2618,2167,349
130890000IA,1209,966,243,1244,1002,241,1161,935,226,1633,1282,328,1510,1243,267,1635,1280,319,1652,1307,332,1509,1235,274,1261,970,260,1201,865,293
130890000MN,1121,1049,72,1165,1101,61,1061,991,70,1523,1352,147,1392,1289,103,1517,1356,131,1532,1370,152,1392,1286,106,1285,1189,74,1185,1009,134
130890000GD,2037,1249,788,2061,1310,730,2016,1272,744,2857,1859,949,2557,1724,833,2825,1833,928,2877,1939,893,2557,1695,862,2101,1209,790,2050,977,971
130890000DF,1904,1125,779,1940,1179,725,1891,1145,746,2220,1400,775,2056,1339,717,2188,1393,752,2233,1497,705,2057,1330,727,2048,1167,786,2004,935,987
13057000024,4214,1304,2910,4291,1312,2907,4159,1269,2890,5944,1850,3883,5033,1739,3294,5866,1872,3812,5995,1996,3871,5036,1716,3320,4681,1236,3207,4499,1019,3207
13073000060,1284,376,908,1299,389,902,1270,372,898,1636,539,1060,1469,503,966,1628,527,1053,1654,570,1068,1469,508,961,1408,399,972,1340,338,950
13073000070,974,237,737,994,230,753,965,222,743,1185,314,850,1037,285,752,1181,298,849,1194,329,851,1038,285,753,1118,257,822,1060,214,801
13073000080,1037,259,778,1051,270,772,1026,258,768,1203,310,869,1100,314,786,1206,311,864,1218,346,855,1100,315,785,1166,275,859,1124,225,865
13073000107,1149,368,781,1159,380,770,1119,354,765,1673,615,1038,1632,597,1035,1659,573,1053,1684,654,1012,1631,601,1030,1126,389,706,1079,296,752
13073000109,1874,508,1366,1896,529,1354,1849,486,1363,2296,687,1579,2205,666,1539,2275,650,1591,2304,736,1543,2207,664,1543,1925,526,1354,1873,417,1408
133130000TR,804,86,718,819,86,725,767,86,681,1041,141,876,953,119,834,1024,122,885,1049,132,900,955,126,829,887,104,760,820,96,689
1331300002A,1681,495,1186,1713,494,1198,1658,479,1179,2149,643,1460,1933,602,1331,2107,591,1442,2157,678,1450,1936,602,1334,1838,503,1259,1733,396,1258
133130000WS,1455,290,1165,1488,294,1181,1434,285,1149,1941,413,1471,1732,382,1350,1894,385,1450,1958,442,1500,1732,388,1344,1659,313,1289,1541,277,1186
13135000035,1984,1006,978,2013,1035,956,1948,989,959,2790,1569,1149,2565,1568,997,2753,1552,1130,2821,1629,1162,2571,1560,1011,2078,925,1088,2007,774,1120
13135000053,2036,1438,598,2076,1458,601,1955,1370,585,2482,1725,692,2267,1710,557,2437,1729,662,2511,1779,710,2269,1696,573,2055,1312,689,1937,1172,685
13135000044,2156,1638,518,2197,1678,503,2091,1588,503,2734,2047,621,2527,2011,516,2678,2021,592,2749,2082,642,2525,2006,519,2325,1635,626,2194,1454,636
13135000153,1239,724,515,1261,730,513,1204,709,495,1608,958,593,1416,912,504,1590,965,572,1630,994,609,1419,899,520,1282,652,563,1204,545,579
13135000078,2296,1224,1072,2325,1260,1043,2249,1192,1057,2873,1645,1150,2615,1617,998,2811,1625,1131,2904,1697,1166,2622,1610,1012,2323,1111,1158,2212,923,1197
13135000055,2356,995,1361,2401,994,1374,2314,954,1360,3265,1389,1769,2850,1306,1544,3214,1382,1728,3296,1439,1796,2849,1294,1555,2339,837,1410,2221,715,1377
13135000025,2686,1197,1489,2716,1205,1471,2654,1198,1456,3981,1765,2069,3530,1741,1789,3914,1777,2012,4015,1854,2087,3531,1736,1795,2845,1048,1653,2727,908,1643
130890000CW,2308,1591,717,2345,1663,657,2294,1602,692,2680,1856,779,2585,1868,717,2674,1882,744,2699,1961,699,2587,1837,750,2349,1567,665,2306,1278,917
130890000DC,2591,1877,714,2648,1941,665,2545,1845,700,3344,2358,896,3051,2267,784,3318,2325,884,3382,2466,866,3048,2247,801,2755,1905,726,2637,1590,893
130890000CE,1192,777,415,1216,796,391,1171,768,403,1639,1061,526,1478,1013,465,1623,1043,524,1652,1124,495,1479,1003,476,1057,633,360,1032,512,443
130890000WK,1300,1252,48,1318,1281,29,1251,1218,33,1525,1442,47,1416,1387,29,1535,1464,48,1533,1461,62,1417,1386,31,1406,1331,43,1362,1222,84
130890000WJ,1779,1299,480,1810,1358,428,1764,1312,452,2137,1573,521,2000,1528,472,2125,1541,524,2152,1626,496,2003,1519,484,1652,1134,442,1602,943,574
130890000HI,913,705,208,918,722,180,899,708,191,1276,1006,236,1175,958,217,1271,996,242,1281,1049,214,1176,954,222,1102,839,211,1086,696,323
130890000EA,2670,2374,296,2730,2487,213,2615,2358,257,2996,2627,295,2873,2612,261,3002,2665,274,3011,2696,261,2870,2593,277,2580,2295,195,2489,2017,365
130890000MP,1087,1036,51,1115,1077,26,1065,1024,41,1269,1190,54,1216,1173,43,1275,1194,49,1281,1214,53,1216,1169,47,1096,1034,29,1037,916,82
130890000TA,1555,1482,73,1591,1529,53,1519,1455,64,1877,1758,81,1843,1773,70,1879,1754,91,1890,1777,96,1838,1761,77,1488,1403,56,1406,1222,119
130890000MD,1343,1285,58,1384,1336,45,1314,1257,57,1660,1539,85,1607,1537,70,1659,1541,80,1670,1573,77,1604,1527,77,1277,1211,41,1194,1045,102
130890000CQ,1594,1501,93,1637,1570,60,1552,1476,76,1983,1809,129,1901,1796,105,1985,1802,122,2002,1845,136,1898,1789,109,1629,1518,67,1521,1307,146
130890000BI,2239,1185,1054,2280,1285,957,2236,1216,1020,2789,1484,1247,2589,1444,1145,2724,1459,1205,2793,1631,1112,2590,1399,1191,2300,1167,991,2268,840,1315
130890000SE,3027,1520,1507,3066,1634,1372,3006,1546,1460,3721,1935,1707,3440,1890,1550,3680,1965,1627,3747,2173,1522,3436,1852,1584,3041,1567,1334,3017,1158,1744
130890000SF,1261,658,603,1295,707,567,1253,662,591,1673,907,731,1555,868,687,1633,888,697,1669,990,650,1554,853,701,1276,666,516,1246,501,678
130890000SI,1018,942,76,1032,951,74,982,906,76,1344,1189,131,1187,1096,91,1349,1202,114,1359,1208,131,1184,1088,96,1165,1048,88,1105,933,118
130890000SD,1390,1038,352,1418,1052,358,1362,1003,359,1556,1137,379,1523,1150,373,1570,1169,379,1579,1185,384,1525,1138,387,1484,1045,409,1424,894,484
13251000007,538,251,287,555,257,298,520,232,288,615,284,326,538,255,283,608,277,321,617,286,327,535,251,284,566,265,295,521,221,293
130890000FL,1175,1133,42,1206,1188,16,1132,1108,24,1441,1366,43,1378,1352,26,1458,1392,42,1462,1391,55,1379,1349,30,1236,1194,26,1170,1073,65
13135000059,1754,1483,271,1764,1501,246,1710,1460,250,2320,1882,369,2048,1739,309,2289,1864,359,2342,1922,383,2049,1734,315,1802,1412,318,1710,1248,354
13083000974,897,228,669,922,206,702,877,218,659,1230,271,922,1049,250,799,1197,243,900,1247,283,946,1054,258,796,1075,226,815,977,204,721
13083000960,1314,182,1132,1376,184,1174,1307,192,1115,1901,299,1560,1579,249,1330,1839,278,1509,1928,300,1599,1579,249,1330,1613,210,1348,1457,186,1175
13135000052,1510,724,786,1536,739,766,1476,723,753,1902,956,882,1719,914,805,1869,951,856,1915,1008,876,1720,913,807,1561,695,794,1501,574,839
13117000004,3766,601,3165,3812,562,3206,3731,561,3170,5116,835,4141,4623,829,3794,5069,847,4113,5131,888,4147,4627,796,3831,4117,541,3451,3990,441,3320
13113000007,1337,803,534,1365,819,537,1331,789,542,1704,1053,610,1593,1037,556,1710,1058,620,1720,1070,628,1589,1029,560,1387,731,612,1338,657,625
13113000010,2919,1727,1192,2959,1781,1154,2883,1719,1164,3596,2191,1330,3417,2185,1232,3588,2226,1296,3630,2252,1338,3420,2171,1249,2933,1623,1237,2826,1401,1338
13045000713,1751,252,1499,1777,235,1521,1728,241,1487,2213,302,1861,1990,293,1697,2199,321,1839,2228,334,1865,1986,278,1708,1827,253,1523,1775,221,1481
13045001111,1515,366,1149,1559,353,1187,1489,344,1145,1974,470,1453,1747,463,1284,1967,484,1444,1995,493,1483,1747,447,1300,1655,368,1246,1530,304,1156
13113000016,2134,652,1482,2167,705,1441,2123,658,1465,2638,894,1698,2545,905,1640,2607,901,1644,2655,1007,1620,2549,899,1650,2336,714,1549,2279,535,1668
13211000001,1805,1012,793,1874,1086,773,1735,976,759,2151,1147,958,2010,1149,861,2135,1166,936,2171,1205,936,2010,1141,869,1815,1026,744,1720,821,848
13135000101,1220,731,489,1227,749,461,1186,708,478,1494,935,537,1360,881,479,1472,919,527,1495,955,528,1361,877,484,1241,711,462,1207,592,547
13135000103,1546,1172,374,1578,1187,374,1507,1140,367,2082,1472,545,1816,1387,429,2030,1450,518,2102,1514,551,1816,1388,428,1630,1174,397,1533,1006,442
13135000064,1907,1413,494,1936,1443,478,1851,1378,473,2355,1759,532,2213,1728,485,2330,1754,527,2374,1807,537,2214,1727,487,1916,1337,534,1828,1194,567
13073000110,655,243,412,669,243,416,633,228,405,834,303,506,713,284,429,838,303,502,847,321,507,713,283,430,792,269,491,728,232,468
13073000090,1134,348,786,1157,331,811,1108,329,779,1439,453,951,1251,413,838,1426,444,952,1444,464,963,1250,410,840,1263,343,880,1178,286,835
13077000014,2545,505,2040,2584,489,2068,2510,473,2037,3618,734,2804,3194,695,2499,3581,749,2762,3621,764,2807,3195,689,2506,2603,498,2016,2498,401,1943
13077000028,3758,2028,1730,3834,2078,1716,3685,1996,1689,6042,2463,3434,5035,2232,2803,5991,2478,3388,6113,2596,3428,5034,2200,2834,4317,2100,2030,4108,1831,2075
13077000006,2780,523,2257,2814,488,2272,2724,499,2225,3538,696,2760,3118,651,2467,3508,716,2720,3560,713,2795,3119,637,2482,2997,520,2350,2884,436,2287
13291000001,1403,273,1130,1441,241,1185,1387,247,1140,1853,337,1467,1655,337,1318,1852,348,1476,1885,355,1518,1656,333,1323,1545,252,1264,1477,222,1205
13291000007,956,220,736,971,194,764,935,200,735,1214,247,936,1132,254,878,1207,251,938,1223,260,950,1132,252,880,956,187,753,912,171,702
13281000833,2065,363,1702,2126,310,1798,2038,328,1710,2753,459,2239,2525,445,2080,2731,459,2230,2778,473,2281,2526,436,2090,2268,346,1881,2144,358,1708
13281000990,2035,387,1648,2089,353,1715,2019,364,1655,2664,483,2133,2445,461,1984,2658,498,2123,2696,523,2162,2448,457,1991,2214,394,1775,2082,370,1648
1311100MORG,1154,215,939,1177,192,968,1128,206,922,1533,252,1254,1423,251,1172,1524,262,1248,1542,267,1265,1425,247,1178,1222,225,985,1155,199,910
13147000008,784,193,591,814,199,612,757,166,591,1058,251,792,928,240,688,1042,245,775,1077,269,802,930,240,690,845,237,599,748,178,537
13147000007,861,112,749,889,99,783,856,101,755,1244,180,1043,1111,184,927,1236,175,1037,1260,187,1059,1110,184,926,918,132,764,853,130,694
1311100FLIN,1578,240,1338,1635,219,1405,1538,232,1306,2114,288,1776,1889,274,1615,2084,263,1776,2137,299,1824,1889,272,1617,1810,287,1483,1686,279,1342
1311100HOTH,683,126,557,700,114,578,669,112,557,935,155,764,863,159,704,932,153,768,953,168,780,862,155,707,732,108,611,684,106,551
1311100MOBI,592,108,484,606,92,511,581,97,484,837,119,697,751,117,634,825,116,695,839,124,711,750,113,637,680,93,573,637,101,509
13105000315,592,116,476,606,113,487,573,102,471,753,141,604,661,134,527,745,137,597,763,154,604,661,131,530,639,126,503,603,125,460
13291000011,859,139,720,874,132,735,850,134,716,1105,189,898,1016,177,839,1104,187,901,1117,199,908,1015,178,837,849,122,713,799,119,654
13291000004,1202,212,990,1221,179,1027,1192,198,994,1663,241,1369,1528,245,1283,1660,252,1382,1681,267,1399,1529,247,1282,1212,189,996,1141,162,933
13291000008,1241,195,1046,1264,165,1088,1220,175,1045,1693,248,1399,1540,253,1287,1691,271,1407,1718,277,1430,1539,253,1286,1289,179,1086,1231,185,996
13299000300,2112,418,1694,2156,413,1732,2061,397,1664,2691,575,2060,2375,580,1795,2627,573,2001,2736,630,2087,2380,585,1795,2322,408,1881,2135,355,1708
13259000005,936,528,408,1021,594,423,893,498,395,1118,631,466,1025,633,392,1085,641,428,1143,681,456,1024,632,392,1152,673,458,979,498,456
13211000003,556,119,437,566,120,440,542,109,433,691,132,547,655,129,526,690,133,546,697,137,553,654,129,525,557,112,430,533,102,406
130890000SA,2211,1406,805,2250,1499,722,2207,1439,768,2520,1657,824,2480,1695,785,2507,1667,802,2546,1801,710,2487,1655,832,2229,1391,741,2221,1120,1020
130890000CJ,1929,1499,430,1965,1552,386,1909,1503,406,2368,1844,497,2254,1841,413,2360,1844,479,2393,1918,455,2253,1821,432,1943,1429,428,1894,1226,583
130890000MG,1572,1221,351,1589,1248,317,1557,1227,330,1789,1401,346,1774,1430,344,1788,1430,316,1805,1471,308,1773,1418,355,1615,1199,331,1572,1032,451
130890000SB,1770,1437,333,1796,1482,292,1752,1436,316,2106,1709,349,2050,1716,334,2100,1712,339,2132,1783,313,2051,1702,349,1687,1308,301,1663,1112,457
130890000CI,2494,2059,435,2550,2163,358,2499,2090,409,2790,2317,427,2741,2347,394,2771,2327,408,2795,2404,363,2740,2328,412,2421,2000,330,2412,1737,575
130890000CV,2394,1965,429,2431,2052,338,2386,2004,382,2727,2265,427,2682,2288,394,2713,2272,398,2738,2370,332,2683,2262,421,2413,1965,351,2364,1649,610
130890000YA,1173,1127,46,1188,1146,38,1140,1095,45,1348,1269,49,1301,1261,40,1358,1280,52,1362,1289,57,1299,1255,44,1197,1145,35,1143,1049,68
130890000MO,1404,1275,129,1446,1324,111,1374,1253,121,1685,1524,124,1610,1506,104,1688,1534,119,1711,1553,133,1609,1492,117,1512,1349,118,1411,1163,182
13135000072,2376,2147,229,2413,2200,202,2260,2058,202,3245,2687,445,2634,2376,258,3172,2676,406,3281,2766,474,2634,2368,266,2557,2197,294,2380,1942,355
130890000OV,2581,2528,53,2635,2610,23,2482,2439,43,2928,2788,81,2811,2766,45,2929,2811,75,2952,2849,88,2808,2761,47,2650,2580,43,2506,2327,115
130890000HH,2194,2140,54,2229,2194,27,2117,2075,42,2636,2531,70,2540,2498,42,2655,2563,61,2654,2537,91,2540,2493,47,2270,2198,40,2176,2024,101
130890000AG,2128,1063,1065,2161,1162,973,2100,1082,1018,2490,1318,1133,2425,1339,1086,2468,1309,1102,2493,1469,987,2424,1281,1143,2097,1088,898,2074,766,1220
130890000SL,765,720,45,786,738,47,740,693,47,967,876,64,878,832,46,971,893,59,982,904,71,878,831,47,824,769,47,787,703,71
130890000WD,1680,1598,82,1702,1622,74,1608,1527,81,1931,1775,117,1761,1684,77,1936,1800,114,1944,1805,124,1760,1675,85,1416,1339,62,1357,1232,96
130890000SW,1896,1839,57,1926,1878,44,1845,1791,54,2362,2240,92,2165,2114,51,2375,2263,84,2400,2285,102,2167,2106,61,1918,1816,83,1839,1673,127
130890000LD,721,659,62,741,691,49,696,647,49,910,813,72,847,792,55,913,829,66,917,828,74,846,790,56,687,625,52,643,556,72
130890000FE,2093,2019,74,2136,2085,46,2049,1992,57,2356,2244,77,2280,2216,64,2373,2256,83,2380,2283,77,2279,2218,61,2177,2085,71,2075,1871,156
130890000GB,941,863,78,963,888,72,906,831,75,1128,993,113,1078,983,95,1127,985,109,1134,999,123,1077,980,97,911,808,75,866,726,113
130890000BL,1190,1138,52,1206,1163,42,1157,1110,47,1340,1270,55,1287,1244,43,1341,1276,44,1354,1289,57,1287,1240,47,1176,1112,53,1129,1009,90
13011000006,919,119,800,941,100,829,906,109,797,1274,153,1089,1076,155,921,1270,150,1095,1284,166,1107,1074,153,921,951,103,821,912,109,759
13095000008,1695,1603,92,1739,1662,77,1605,1517,88,1887,1756,118,1808,1731,77,1888,1776,100,1917,1805,103,1804,1729,75,1857,1754,84,1748,1565,163
13095000006,1415,644,771,1434,631,793,1384,611,773,1602,757,819,1479,711,768,1598,741,834,1612,775,816,1479,712,767,1508,615,851,1462,530,899
13095000014,584,549,35,606,581,23,537,505,32,689,628,49,625,603,22,691,640,35,697,656,32,624,602,22,661,629,26,598,516,70
13011000010,793,80,713,809,69,730,786,70,716,1060,101,937,891,82,809,1057,98,938,1071,108,957,892,85,807,842,80,746,816,82,704
13259000002,746,415,331,798,459,337,719,399,320,835,484,337,778,484,294,821,481,327,847,501,345,778,483,295,903,549,347,771,402,351
13297000425,1662,660,1002,1725,687,1025,1636,629,1007,2308,878,1355,1987,827,1160,2294,900,1340,2334,922,1388,1984,816,1168,1796,694,1059,1666,580,1021
13165000005,553,161,392,569,169,398,528,153,375,728,233,492,637,226,411,719,237,478,735,245,488,640,230,410,600,195,400,568,170,384
13149000EPH,707,85,622,725,73,649,702,77,625,933,79,840,839,79,760,915,86,820,941,82,852,839,75,764,735,85,631,689,87,571
1313100000R,296,75,221,307,78,229,294,73,221,363,102,257,335,100,235,356,93,256,365,103,261,334,99,235,337,93,241,296,84,204
13095000001,1273,591,682,1302,593,698,1233,560,673,1580,735,808,1460,734,726,1567,752,794,1598,776,804,1462,737,725,1430,637,765,1358,553,770
13095000015,553,439,114,571,467,102,515,409,106,636,486,135,600,491,109,642,488,129,645,512,125,601,494,107,681,550,120,605,449,142
13105000190,374,91,283,383,81,302,368,79,289,468,109,352,417,90,327,457,105,348,472,122,347,418,93,325,439,98,335,394,73,306
13095000012,634,614,20,650,642,4,583,571,12,641,605,30,639,628,11,639,607,20,648,623,21,636,620,16,826,807,12,734,664,63
13095000007,2253,1757,496,2289,1813,471,2158,1692,466,2536,1983,525,2320,1874,446,2539,2006,495,2563,2043,502,2318,1863,455,2314,1731,556,2192,1557,606
13095000016,305,280,25,315,301,13,287,270,17,274,243,21,234,223,11,270,241,21,274,257,16,233,222,11,396,371,19,357,308,43
13095000013,579,555,24,607,596,11,540,521,19,697,630,53,617,595,22,701,649,44,712,663,42,615,593,22,655,644,8,594,538,50
13095000003,1191,598,593,1208,595,606,1149,565,584,1414,736,659,1272,693,579,1415,741,644,1432,759,655,1271,694,577,1303,597,688,1242,522,701
130890000NB,1087,915,172,1112,946,143,1085,930,155,1457,1214,208,1326,1165,161,1446,1203,199,1481,1271,194,1327,1153,174,1080,871,158,1032,767,220
130890000AE,2227,1612,615,2266,1678,545,2201,1624,577,2525,1881,586,2478,1895,583,2523,1930,557,2549,1970,538,2476,1872,604,2240,1562,544,2224,1355,773
130890000ME,2042,1683,359,2080,1724,316,2020,1675,345,2470,1975,423,2354,1978,376,2459,1969,406,2491,2025,423,2360,1974,386,1959,1584,283,1890,1363,382
13077000017,1692,1137,555,1735,1172,549,1624,1082,542,2427,1512,837,2067,1403,664,2418,1529,820,2471,1559,868,2061,1395,666,1879,1214,583,1764,1059,610
13077000005,1659,968,691,1713,1021,671,1605,943,662,2168,1264,849,1990,1248,742,2157,1261,839,2188,1317,846,1989,1236,753,1803,1043,696,1716,879,766
13077000002,1616,290,1326,1640,274,1344,1590,272,1318,2195,387,1762,1971,383,1588,2192,401,1757,2212,421,1770,1975,380,1595,1569,255,1276,1507,211,1233
13199000007,1398,573,825,1425,567,845,1360,542,818,1849,666,1151,1696,668,1028,1847,686,1132,1875,686,1184,1695,659,1036,1521,638,853,1461,556,850
13297000419,1916,551,1365,1961,551,1392,1891,535,1356,2545,714,1747,2265,693,1572,2537,747,1732,2574,757,1781,2264,686,1578,2095,580,1436,2004,503,1422
13297000454,865,147,718,886,143,739,852,141,711,1205,178,1006,1100,174,926,1198,179,1005,1218,182,1026,1102,172,930,752,115,619,709,100,574
13297000422,2541,434,2107,2583,412,2156,2511,410,2101,3281,662,2544,2976,628,2348,3266,674,2525,3301,703,2564,2982,626,2356,2795,374,2353,2682,347,2219
13165000001,537,320,217,556,333,219,520,314,206,617,354,246,574,345,229,607,363,232,627,376,242,573,347,226,584,337,237,531,282,238
1329900200A,1342,403,939,1362,407,944,1319,396,923,1650,541,1064,1437,507,930,1629,536,1053,1666,574,1062,1438,513,925,1504,461,997,1423,384,975
13299000400,1976,232,1744,2024,231,1782,1940,225,1715,2560,356,2173,2250,309,1941,2514,323,2141,2591,364,2211,2253,311,1942,2139,248,1861,1996,220,1719
1329900200B,356,221,135,361,223,136,343,208,135,492,275,208,409,270,139,476,274,187,504,290,207,407,270,137,461,262,193,400,215,176
13299000100,1801,1476,325,1845,1536,304,1691,1387,304,2416,1832,509,2057,1733,324,2408,1897,459,2492,2001,479,2042,1714,328,2181,1740,417,1919,1418,439
13011000005,240,19,221,245,16,228,238,13,225,279,17,258,237,17,220,277,20,255,278,20,258,237,17,220,249,21,224,236,19,201
13095000011,480,464,16,494,487,5,447,437,10,508,484,18,477,471,6,513,491,17,514,494,16,475,470,5,512,500,10,486,439,42
13095000027,962,410,552,971,403,563,931,384,547,1091,465,607,1022,449,573,1080,458,609,1088,472,606,1022,444,578,1043,389,623,1013,341,646
1305105-05C,1372,1332,40,1426,1405,18,1304,1276,28,1639,1551,61,1537,1506,31,1642,1575,48,1656,1593,54,1535,1503,32,1480,1444,22,1338,1214,103
132210000LX,2620,754,1866,2704,753,1925,2565,716,1849,3274,935,2254,2943,900,2043,3227,956,2199,3303,980,2291,2945,889,2056,2825,809,1940,2705,710,1883
132210000CR,1760,563,1197,1797,563,1214,1719,529,1190,2193,675,1439,1920,654,1266,2164,686,1428,2208,710,1467,1923,652,1271,1813,539,1214,1715,478,1159
1330500003A,1304,249,1055,1330,254,1064,1273,249,1024,1774,409,1342,1509,364,1145,1746,400,1319,1797,408,1379,1509,364,1145,1413,275,1107,1330,229,1056
1303500BCCC,8661,2438,6223,8863,2451,6358,8508,2310,6198,11673,3129,8329,10209,3026,7183,11609,3228,8187,11771,3274,8406,10209,3004,7205,9477,2566,6717,8833,2167,6320
13087001342,311,75,236,318,72,245,304,64,240,410,101,306,336,80,256,405,91,302,413,98,315,335,80,255,341,77,262,303,66,224
13061000005,311,134,177,324,141,180,302,122,180,401,174,226,370,165,205,384,164,213,405,182,223,371,165,206,340,147,192,305,118,178
13061000004,231,130,101,248,138,108,222,123,99,284,154,124,273,160,113,291,159,124,289,167,120,273,160,113,265,150,114,239,118,116
13095000028,535,523,12,539,531,6,512,497,15,404,378,19,174,169,5,401,378,15,406,392,12,174,167,7,678,656,11,656,617,18
13297000420,2091,1150,941,2149,1194,942,2006,1087,919,2812,1456,1274,2461,1399,1062,2798,1478,1265,2850,1510,1309,2462,1390,1072,2243,1224,970,2058,1027,948
13297000415,2880,508,2372,2931,511,2389,2826,498,2328,3899,722,3091,3512,700,2812,3889,736,3084,3920,763,3113,3514,681,2833,3047,527,2429,2934,446,2362
13297000503,771,91,680,781,86,694,756,81,675,922,107,799,835,109,726,912,113,788,929,107,816,834,108,726,737,89,634,710,89,593
13165000003,570,134,436,576,127,447,551,121,430,704,159,536,643,153,490,696,154,527,715,162,548,643,153,490,613,156,450,574,130,434
13165000004,590,76,514,607,76,529,587,74,513,701,107,584,660,105,555,695,110,577,711,114,591,661,104,557,634,91,537,591,80,494
13299000304,556,85,471,571,79,486,540,71,469,786,116,657,666,90,576,766,105,644,798,113,679,666,91,575,629,90,522,561,75,459
1305104-14C,1291,403,888,1308,430,864,1268,397,871,1492,491,992,1480,490,990,1502,497,995,1511,554,948,1481,481,1000,1304,405,871,1273,309,939
13297000421,2073,594,1479,2111,589,1504,2029,573,1456,2645,782,1777,2299,746,1553,2614,789,1752,2665,830,1797,2300,734,1566,2280,551,1646,2159,470,1589
13297000418,2426,711,1715,2485,723,1747,2348,659,1689,3297,912,2313,2975,899,2076,3281,914,2307,3315,928,2347,2976,890,2086,2640,716,1873,2458,593,1795
13087000514,1551,796,755,1604,823,770,1496,745,751,2089,1030,995,1802,956,846,2056,1031,967,2128,1099,1009,1802,957,845,1821,921,868,1644,793,798
13087001361,633,151,482,645,149,495,612,139,473,755,190,559,677,175,502,750,184,555,763,200,558,678,181,497,660,154,497,604,132,447
1313100000H,470,144,326,478,150,326,454,140,314,616,197,414,559,172,387,598,174,407,623,201,418,560,175,385,532,171,352,480,155,306
13087001613,476,98,378,494,103,390,467,94,373,612,132,472,527,109,418,604,117,475,619,122,492,528,110,418,559,132,424,520,113,388
13297000426,1275,230,1045,1299,219,1072,1263,214,1049,1597,298,1278,1490,280,1210,1587,296,1272,1603,313,1276,1492,280,1212,1332,223,1081,1274,181,1039
13297001663,2747,448,2299,2785,428,2341,2719,414,2305,3739,704,2962,3369,666,2703,3682,695,2930,3747,738,2969,3372,659,2713,3026,410,2522,2913,374,2406
13299000407,286,14,272,296,16,280,280,16,264,357,17,339,337,18,319,357,18,337,358,17,339,337,19,318,325,18,300,292,19,262
13299000409,561,39,522,570,35,534,547,39,508,707,54,641,619,48,571,696,50,634,713,52,658,617,48,569,615,50,554,566,37,504
1304700WEST,2711,615,2096,2768,635,2103,2639,608,2031,3848,860,2877,3285,779,2506,3819,824,2879,3917,902,2958,3281,777,2504,3080,658,2334,2734,548,2039
1304700GRAY,2226,441,1785,2258,438,1789,2174,445,1729,3105,616,2398,2639,550,2089,3053,575,2397,3148,658,2439,2639,559,2080,2499,442,1950,2306,424,1752
133130000VA,2834,532,2302,2884,530,2326,2757,515,2242,3763,810,2868,3314,736,2578,3677,749,2838,3797,836,2913,3318,742,2576,3185,580,2515,2987,489,2356
133130000TH,1847,358,1489,1891,343,1532,1787,329,1458,2625,528,2020,2276,486,1790,2561,487,1998,2656,546,2072,2276,491,1785,2192,383,1748,2025,363,1550
13095000018,1018,937,81,1037,969,68,969,885,84,1095,965,114,1010,937,73,1108,985,107,1113,989,117,1009,934,75,1220,1105,102,1136,949,167
13105000193,731,215,516,749,211,535,707,195,512,858,217,636,793,204,589,849,217,623,869,237,630,793,204,589,785,226,553,731,185,529
13063000MO6,1498,1266,232,1539,1308,226,1444,1225,219,1924,1554,322,1751,1509,242,1922,1562,310,1947,1597,335,1749,1509,240,1494,1215,243,1420,1119,259
13063000FP6,605,419,186,629,427,196,596,410,186,821,509,293,721,495,226,821,509,271,831,519,303,722,492,230,683,460,209,632,403,207
13287000002,976,124,852,1003,110,891,954,109,845,1172,156,1006,1077,142,935,1167,149,999,1187,148,1035,1075,140,935,1058,126,916,1017,124,868
13287000003,276,39,237,280,28,252,275,29,246,333,43,283,294,38,256,331,44,280,336,45,289,294,37,257,301,39,259,285,33,243
13163000081,1631,847,784,1695,893,796,1561,797,764,1898,997,872,1727,966,761,1885,989,863,1922,1028,882,1729,962,767,1730,946,760,1568,764,775
13151000032,3084,2480,604,3126,2534,581,2990,2400,590,3980,3156,761,3691,3034,657,3974,3191,734,4014,3201,782,3690,3025,665,2695,1929,717,2551,1707,767
13151000033,3291,2833,458,3359,2929,411,3178,2744,434,3965,3301,594,3676,3209,467,3973,3325,568,4015,3374,609,3674,3198,476,3331,2784,489,3118,2429,597
13151000054,2291,1709,582,2332,1731,580,2207,1639,568,2772,2023,666,2386,1837,549,2769,2051,657,2802,2080,688,2388,1834,554,2465,1678,723,2333,1484,749
13213000872,984,133,851,1018,111,900,961,121,840,1366,170,1174,1167,130,1037,1316,147,1146,1395,157,1227,1168,132,1036,1153,151,979,1027,151,819
13233000004,1422,246,1176,1455,223,1217,1386,217,1169,1875,279,1550,1647,256,1391,1852,276,1537,1895,294,1584,1648,259,1389,1605,241,1338,1512,241,1224
13095000009,836,375,461,863,374,484,814,343,471,995,450,532,915,417,498,988,437,539,1007,450,549,916,417,499,921,391,521,858,344,498
13095000010,1575,1539,36,1626,1607,18,1450,1415,35,1804,1709,68,1652,1636,16,1785,1710,52,1823,1762,49,1652,1631,21,1830,1791,29,1676,1557,107
1305105-11C,1351,1038,313,1368,1052,303,1304,1011,293,1722,1289,383,1536,1197,339,1722,1306,387,1752,1332,398,1537,1196,341,1488,1107,347,1416,955,411
1305101-17C,1991,570,1421,2023,569,1421,1969,570,1399,2518,792,1680,2416,776,1640,2525,783,1684,2561,860,1666,2414,760,1654,2165,628,1449,2101,453,1567
1305103-12C,953,506,447,985,509,456,934,493,441,1163,627,506,1082,603,479,1154,613,507,1175,629,528,1080,597,483,1042,552,449,979,473,461
1305108-02C,841,701,140,857,719,124,826,687,139,1003,800,171,953,786,167,992,778,175,1018,827,172,950,781,169,907,728,143,878,628,182
1305107-05C,577,344,233,591,347,232,568,336,232,744,435,297,626,376,250,741,436,296,753,433,311,625,373,252,624,330,273,608,299,289
13105000191,499,84,415,513,85,423,487,79,408,615,135,476,545,113,432,605,134,462,616,144,469,545,114,431,533,105,421,489,87,391
13095000025,1355,481,874,1375,482,890,1314,462,852,1496,559,924,1458,552,906,1495,566,914,1503,583,914,1458,552,906,1345,473,855,1294,411,859
13095000021,548,424,124,555,432,121,531,413,118,659,469,183,583,440,143,660,480,171,672,485,185,582,442,140,584,426,151,551,373,170
1331500003A,528,53,475,544,55,487,515,51,464,633,75,554,569,75,494,633,77,547,640,76,563,570,75,495,556,69,479,520,56,455
13105000189,2076,954,1122,2132,994,1130,1991,905,1086,2576,1202,1329,2195,1083,1112,2563,1183,1329,2611,1263,1326,2194,1087,1107,2339,1145,1149,2109,918,1131
13105000197,928,333,595,949,339,605,916,324,592,1196,428,741,1033,369,664,1180,418,746,1208,441,756,1033,372,661,1031,381,628,969,336,595
1330500002A,1097,172,925,1134,168,959,1083,159,924,1372,177,1176,1211,170,1041,1348,182,1150,1392,195,1190,1211,171,1040,1106,161,933,1030,138,862
1330500005B,674,130,544,688,122,558,663,128,535,836,191,621,744,181,563,819,180,624,843,189,643,743,181,562,692,142,535,646,113,507
1305108-10C,855,835,20,880,867,11,808,798,10,997,957,23,918,910,8,1001,970,17,1010,989,14,917,909,8,1006,989,10,925,819,94
1305104-11C,1053,431,622,1071,430,632,1042,430,612,1262,477,772,1209,486,723,1257,470,768,1271,489,772,1210,477,733,1164,446,692,1109,373,697
1305107-07C,2895,1290,1605,2947,1301,1617,2841,1249,1592,4879,2187,2571,4250,2002,2248,4860,2155,2586,4939,2243,2623,4254,2008,2246,3415,1278,2031,3268,1079,2067
1305104-13C,1782,470,1312,1825,516,1299,1755,468,1287,2123,644,1468,2119,648,1471,2120,643,1457,2133,739,1375,2123,637,1486,1861,524,1301,1826,335,1476
1305103-11C,672,551,121,686,561,123,633,518,115,870,693,158,807,665,142,870,706,151,881,707,162,806,664,142,780,609,152,721,511,184
1305103-02C,916,558,358,937,584,337,889,548,341,1111,655,437,1076,664,412,1104,651,420,1132,709,410,1074,663,411,1020,614,361,990,460,489
1305102-02C,663,525,138,684,550,128,648,520,128,876,685,171,851,695,156,875,681,166,895,713,161,849,689,160,808,634,149,751,509,208
13297000414,855,97,758,871,86,780,851,83,768,1028,130,882,976,128,848,1023,132,882,1038,131,896,976,121,855,849,77,757,824,80,723
1305101-01C,2142,1226,916,2184,1284,868,2132,1234,898,2563,1543,973,2460,1516,944,2541,1500,986,2581,1597,952,2463,1506,957,2331,1285,917,2269,1038,1102
1313100000W,626,142,484,632,144,485,601,131,470,816,187,618,725,173,552,801,181,607,835,194,638,725,173,552,731,179,541,668,160,483
13087000694,985,644,341,1015,674,337,953,618,335,1243,764,461,1134,728,406,1223,744,448,1266,795,462,1132,724,408,1146,749,386,1051,660,358
13037000005,385,277,108,395,286,107,365,268,97,467,343,118,440,343,97,462,338,117,471,348,121,438,339,99,417,307,107,392,265,122
1331500002A,238,96,142,242,103,139,225,91,134,377,98,272,313,95,218,377,112,260,383,109,272,312,94,218,270,112,155,247,92,149
1331500005A,669,130,539,682,128,553,652,119,533,696,132,550,627,152,475,692,147,535,706,149,554,625,148,477,723,145,572,696,119,560
13037000004,356,205,151,360,210,149,340,196,144,391,225,164,384,237,147,393,226,162,396,234,161,387,238,149,389,228,159,370,202,166
13037000002,415,123,292,424,124,299,410,121,289,493,138,348,459,135,324,485,139,341,496,144,350,459,136,323,438,130,304,425,108,305
13301000001,1259,659,600,1308,695,606,1207,617,590,1508,808,667,1418,804,614,1558,856,663,1529,849,668,1415,798,617,1353,763,568,1235,635,568
13301000004,289,152,137,298,160,138,279,145,134,348,187,156,327,184,143,340,191,148,352,195,156,327,183,144,302,172,128,283,149,129
13301000002,194,102,92,200,105,94,189,97,92,236,129,104,225,129,96,216,115,98,237,129,106,226,129,97,210,117,91,194,100,91
13301000003,238,123,115,251,134,117,232,119,113,283,155,126,271,152,119,263,141,122,289,162,126,270,151,119,256,145,110,235,122,111
13301000006,59,30,29,59,30,29,58,30,28,66,35,31,64,35,29,51,24,27,71,39,32,65,35,30,61,33,28,58,30,28
13301000005,143,76,67,145,76,69,140,73,67,173,93,77,162,91,71,156,82,74,173,95,78,163,91,72,151,84,66,143,74,66
13215000106,3177,1226,1951,3223,1200,1986,3085,1156,1929,4504,1751,2639,3950,1638,2312,4488,1762,2621,4560,1841,2640,3953,1637,2316,3513,1230,2172,3314,1026,2140
13215000105,1842,657,1185,1870,625,1235,1776,592,1184,2262,873,1334,2028,837,1191,2264,885,1319,2288,908,1346,2025,834,1191,2019,629,1330,1907,516,1299
13227000002,1041,164,877,1057,156,887,1019,161,858,1523,230,1257,1339,227,1112,1504,224,1247,1532,241,1259,1339,218,1121,1113,158,913,1073,128,867
13069000004,1326,310,1016,1371,321,1046,1272,289,983,1566,365,1177,1416,364,1052,1524,360,1154,1589,378,1200,1416,361,1055,1504,371,1105,1368,322,1000
13299000408,298,24,274,307,22,285,299,24,275,373,19,354,356,23,333,366,19,343,379,19,359,358,22,336,320,24,287,295,19,262
13043001685,1883,569,1314,1941,576,1356,1825,529,1296,2289,643,1614,2060,594,1466,2287,644,1600,2324,664,1644,2060,597,1463,2055,623,1382,1931,516,1360
13297000423,2421,384,2037,2454,369,2072,2365,357,2008,3239,579,2570,2848,559,2289,3215,593,2556,3260,605,2616,2850,550,2300,2678,364,2238,2569,315,2152
13299000406,918,76,842,935,68,862,906,69,837,1182,106,1058,1032,92,940,1159,102,1037,1188,104,1067,1033,93,940,1026,84,927,954,73,849
13077000007,2505,644,1861,2533,647,1844,2455,616,1839,3395,878,2433,3083,854,2229,3381,893,2430,3420,951,2423,3086,846,2240,2653,586,1941,2574,506,1942
13077000004,526,106,420,533,99,427,521,99,422,639,117,506,558,106,452,633,115,506,641,119,514,558,106,452,573,94,456,543,84,440
13191000271,1125,396,729,1149,397,744,1108,376,732,1475,510,934,1301,479,822,1446,507,909,1493,528,943,1295,471,824,1291,409,844,1198,344,802
13127005923,1349,842,507,1386,871,502,1313,830,483,1799,1110,627,1558,1006,552,1757,1086,598,1831,1160,639,1560,1004,556,1482,911,513,1348,733,542
13127001713,2335,519,1816,2374,527,1830,2271,511,1760,3008,707,2250,2753,690,2063,2946,661,2214,3037,736,2280,2757,697,2060,2424,465,1916,2221,366,1782
13127001943,1408,214,1194,1438,208,1218,1376,195,1181,1789,311,1427,1592,279,1313,1759,298,1411,1813,334,1462,1596,285,1311,1530,195,1302,1402,168,1181
13127003713,1703,536,1167,1727,528,1188,1653,517,1136,2544,804,1671,2099,707,1392,2503,768,1642,2587,835,1725,2103,715,1388,1903,546,1313,1715,465,1194
13127001933,1555,447,1108,1572,445,1106,1530,435,1095,2055,580,1428,1843,559,1284,2017,557,1402,2072,615,1427,1843,552,1291,1612,381,1190,1479,308,1102
13199000012,397,146,251,405,131,270,389,129,260,529,172,348,498,163,335,525,173,346,532,173,357,498,165,333,440,152,284,420,128,281
13227000012,1381,185,1196,1419,165,1243,1361,176,1185,1748,241,1458,1549,218,1331,1738,235,1472,1757,238,1499,1545,206,1339,1457,169,1259,1391,162,1158
13217000005,1593,835,758,1617,853,754,1564,829,735,2044,1058,937,1843,1037,806,2023,1051,917,2054,1085,946,1844,1026,818,1608,803,762,1544,704,774
13087001805,1125,510,615,1154,525,626,1098,486,612,1473,655,791,1262,581,681,1469,662,777,1503,695,797,1260,581,679,1285,586,686,1168,496,627
13077000018,6869,2105,4764,6991,2167,4741,6783,2086,4697,8942,3638,5079,7432,3291,4141,8907,3688,5017,9031,3836,5057,7437,3253,4184,7380,2043,5098,7136,1673,5137
13077000003,1146,189,957,1170,187,969,1126,181,945,1541,240,1272,1414,251,1163,1530,248,1259,1555,263,1276,1416,251,1165,1240,172,1040,1181,149,979
130890000BJ,2343,2251,92,2376,2309,61,2266,2193,73,2753,2611,98,2683,2615,68,2768,2643,87,2784,2660,107,2678,2605,73,2416,2300,80,2328,2150,126
13097000733,1535,990,545,1557,1008,530,1508,973,535,1932,1307,570,1730,1247,483,1921,1330,554,1944,1336,579,1728,1226,502,1637,975,616,1568,860,645
13097001275,3251,2689,562,3299,2770,513,3175,2652,523,3995,3271,646,3708,3187,521,4017,3316,646,4043,3331,674,3708,3180,528,3394,2638,644,3264,2429,728
13097000784,2434,1739,695,2469,1776,674,2383,1717,666,3118,2296,750,2973,2299,674,3121,2329,754,3148,2347,770,2974,2294,680,2501,1609,818,2419,1478,836
13043001736,1561,388,1173,1598,387,1204,1533,367,1166,2081,590,1463,1858,537,1321,2035,573,1430,2107,605,1489,1855,537,1318,1708,403,1282,1617,339,1228
13297000416,1452,229,1223,1481,214,1258,1431,199,1232,1935,280,1612,1700,269,1431,1922,296,1593,1942,295,1629,1700,264,1436,1566,191,1341,1501,180,1261
13297000502,1205,120,1085,1231,109,1114,1184,106,1078,1583,161,1389,1438,159,1279,1578,164,1387,1591,155,1412,1438,153,1285,1228,99,1105,1189,87,1059
13299000404,240,22,218,242,19,220,237,22,215,290,25,262,261,25,236,281,23,254,288,24,263,261,23,238,249,30,215,240,26,199
13191001312,35,25,10,39,30,9,35,25,10,41,30,9,36,29,7,42,31,10,42,32,10,36,30,6,49,39,10,43,32,11
13127001923,1735,496,1239,1764,481,1273,1701,477,1224,2372,634,1685,2108,606,1502,2330,606,1654,2414,665,1725,2106,610,1496,1802,467,1312,1644,404,1175
13217000002,2129,1634,495,2197,1708,477,2054,1577,477,2552,1886,604,2277,1786,491,2544,1902,590,2581,1951,605,2269,1771,498,2214,1687,488,2073,1472,535
13217000024,2529,2213,316,2582,2258,315,2446,2138,308,3126,2695,370,2891,2592,299,3119,2703,364,3163,2743,399,2892,2590,302,2504,2109,367,2362,1929,386
13191001771,1357,550,807,1400,574,820,1311,524,787,1677,612,1034,1500,595,905,1647,624,995,1706,654,1041,1502,592,910,1536,582,925,1418,494,879
13127004933,1155,656,499,1190,679,505,1104,623,481,1625,890,688,1391,840,551,1595,884,665,1643,943,688,1385,833,552,1357,761,569,1223,633,539
13127005933,1288,1179,109,1324,1216,105,1195,1091,104,1726,1461,199,1388,1268,120,1706,1476,183,1761,1546,190,1386,1266,120,1527,1373,133,1327,1099,183
13127005943,481,333,148,494,348,143,456,313,143,648,437,189,546,388,158,646,432,194,663,464,195,548,387,161,575,378,190,514,313,175
13127004913,1452,462,990,1493,472,1012,1405,448,957,1983,674,1263,1712,589,1123,1956,662,1239,2012,694,1289,1715,594,1121,1679,499,1129,1558,437,1061
1305102-04C,1363,1267,96,1420,1341,73,1296,1211,85,1774,1597,132,1702,1591,111,1775,1607,116,1799,1647,129,1696,1583,113,1632,1537,64,1508,1253,188
13197000808,220,30,190,224,23,199,209,21,188,256,39,208,227,45,182,254,42,207,257,46,207,228,45,183,244,49,189,228,38,183
13029000001,1221,399,822,1262,409,846,1195,376,819,1684,547,1089,1430,494,936,1648,542,1076,1710,567,1111,1430,492,938,2145,601,1502,2002,456,1490
13029000002,1092,213,879,1113,199,905,1068,208,860,1603,299,1268,1371,265,1106,1581,296,1246,1619,302,1300,1370,260,1110,1083,284,767,1027,242,743
13149000FRA,1124,308,816,1148,291,847,1100,290,810,1465,326,1103,1269,328,941,1448,319,1093,1490,331,1139,1268,321,947,1178,305,848,1101,262,801
13149000SOU,328,72,256,348,78,269,320,66,254,473,101,361,396,95,301,469,105,358,481,105,375,396,93,303,371,96,273,347,77,255
13135000152,2906,1319,1587,2946,1348,1563,2851,1286,1565,3686,1728,1857,3295,1663,1632,3618,1722,1821,3687,1793,1836,3295,1650,1645,3133,1233,1782,2967,1027,1805
13135000073,1317,715,602,1333,724,593,1287,698,589,1641,919,683,1516,888,628,1624,944,642,1647,972,649,1518,875,643,1326,673,592,1299,570,668
13135000105,2162,912,1250,2203,931,1222,2139,903,1236,2968,1309,1555,2596,1246,1350,2916,1277,1528,3000,1379,1568,2598,1233,1365,2386,873,1381,2307,719,1428
13135000010,1425,551,874,1450,566,870,1397,537,860,1733,725,950,1607,753,854,1704,743,912,1747,762,949,1608,739,869,1511,521,935,1427,451,916
13135000039,3806,1202,2604,3859,1231,2576,3758,1190,2568,5471,1944,3401,4965,1834,3131,5397,1959,3320,5509,2054,3387,4964,1807,3157,3855,1028,2675,3717,847,2691
132890000DB,772,178,594,797,162,627,738,156,582,970,197,744,849,180,669,966,192,761,977,190,781,849,181,668,871,200,660,806,170,612
1328900JV/W,930,588,342,967,611,354,875,544,331,1097,671,411,981,650,331,1076,672,394,1118,710,401,980,644,336,1061,698,354,974,589,366
132890000GI,991,600,391,1010,606,399,944,563,381,1162,668,469,1078,645,433,1157,670,469,1180,687,484,1072,636,436,1075,631,434,981,533,419
13087001325,404,78,326,407,77,326,390,72,318,502,117,380,447,100,347,493,104,373,504,115,388,446,101,345,458,87,362,409,82,314
13149000COO,278,34,244,285,29,256,279,31,248,422,35,381,372,46,326,421,44,369,425,37,384,372,44,328,296,33,256,280,38,232
13095000005,2134,1201,933,2165,1203,947,2082,1159,923,2446,1404,1012,2290,1371,919,2446,1401,1005,2476,1433,1020,2288,1372,916,2245,1186,1019,2160,1062,1061
1305101-10C,768,216,552,788,218,554,763,205,558,940,279,643,896,275,621,929,271,636,943,300,626,895,261,634,794,199,568,756,147,579
1305108-15C,658,604,54,671,624,44,627,570,57,816,735,73,758,704,54,812,726,72,823,745,78,758,701,57,764,693,66,704,605,95
13131000C04,1217,971,246,1257,1016,235,1149,910,239,1551,1214,321,1355,1105,250,1537,1199,307,1574,1269,298,1354,1103,251,1382,1096,269,1242,943,268
130890000CF,2029,1898,131,2072,1943,120,1962,1830,132,2492,2281,159,2385,2236,149,2501,2310,161,2518,2320,181,2383,2228,155,1865,1705,133,1771,1555,181
130890000BC,1810,1384,426,1858,1455,376,1801,1413,388,2240,1705,489,2159,1671,488,2237,1692,481,2264,1784,447,2163,1668,495,1882,1373,409,1851,1157,578
13135000058,1574,1248,326,1611,1297,299,1530,1227,303,2178,1633,483,1864,1505,359,2122,1614,451,2206,1694,489,1864,1505,359,1736,1327,350,1606,1156,363
13199000001,292,49,243,298,36,261,288,35,253,358,45,309,312,40,272,354,48,300,358,48,307,312,40,272,312,43,262,305,46,253
13199000005,1070,557,513,1093,571,520,1025,523,502,1344,634,684,1254,633,621,1328,650,660,1350,667,676,1254,625,629,1188,607,561,1105,490,575
13217000004,2548,1142,1406,2593,1144,1432,2502,1101,1401,3357,1602,1687,3060,1570,1490,3347,1611,1666,3389,1653,1685,3058,1554,1504,2550,1034,1437,2459,918,1447
13217000001,816,533,283,844,557,281,779,503,276,1055,624,400,945,624,321,1038,626,388,1065,644,400,944,623,321,882,553,312,828,501,308
13217000014,1302,288,1014,1336,276,1053,1295,273,1022,1628,388,1202,1464,377,1087,1628,397,1197,1644,401,1227,1462,368,1094,1359,268,1064,1288,233,1008
13217000010,3406,1797,1609,3470,1809,1632,3288,1722,1566,4349,2325,1909,3949,2276,1673,4341,2358,1899,4382,2374,1954,3947,2261,1686,3586,1619,1884,3420,1483,1809
13217000023,1431,1257,174,1460,1288,161,1392,1224,168,1800,1544,224,1662,1486,176,1798,1556,210,1818,1573,233,1659,1477,182,1391,1155,217,1317,1054,238
13217000018,1795,823,972,1817,829,974,1750,790,960,2417,1087,1273,2118,1045,1073,2392,1087,1257,2432,1105,1297,2120,1046,1074,1968,814,1116,1876,732,1057
13073000064,2071,776,1295,2096,808,1256,2034,777,1257,2730,1107,1559,2524,1076,1448,2705,1081,1554,2747,1171,1526,2522,1084,1438,2170,765,1331,2061,642,1342
13073000061,1910,470,1440,1928,469,1427,1894,459,1435,2695,722,1916,2504,714,1790,2672,701,1900,2710,793,1871,2507,714,1793,1870,389,1396,1783,300,1395
130890000KA,1423,1372,51,1476,1436,32,1376,1328,48,1737,1607,86,1654,1601,53,1749,1646,78,1756,1659,80,1653,1597,56,1566,1497,44,1432,1279,97
130890000FC,1137,1099,38,1159,1139,17,1088,1070,18,1308,1238,47,1230,1204,26,1319,1260,43,1330,1276,45,1230,1198,32,1167,1128,24,1105,1004,85
1311100FAIR,600,125,475,609,122,482,586,120,466,896,168,715,801,162,639,891,160,720,908,169,726,801,162,639,651,107,532,614,99,479
13217000025,1597,274,1323,1627,260,1354,1583,267,1316,1916,317,1559,1797,326,1471,1896,326,1540,1931,340,1560,1796,324,1472,1638,267,1331,1588,228,1300
13135000003,2679,1509,1170,2718,1530,1155,2623,1485,1138,3406,1932,1392,3002,1853,1149,3338,1922,1329,3417,1976,1391,3008,1842,1166,2780,1368,1303,2646,1175,1344
13135000027,2715,1133,1582,2763,1177,1554,2687,1131,1556,3518,1599,1838,3148,1474,1674,3437,1572,1782,3541,1622,1883,3149,1459,1690,2971,1097,1767,2835,917,1787
13135000016,2684,1839,845,2735,1878,837,2616,1800,816,3496,2380,1026,3204,2343,861,3424,2347,1005,3514,2428,1056,3201,2324,877,2751,1754,926,2603,1505,998
130890000TH,1684,1148,536,1719,1179,516,1666,1127,539,2633,1599,967,2499,1603,896,2611,1596,941,2650,1663,938,2497,1569,928,1750,1121,546,1699,915,697
13097001276,1505,854,651,1526,879,634,1468,842,626,1853,1066,739,1666,1046,620,1859,1108,719,1872,1107,749,1665,1038,627,1604,819,733,1541,773,709
13097000738,1214,513,701,1225,516,697,1191,500,691,1511,731,733,1334,694,640,1498,727,728,1524,749,751,1333,689,644,1290,466,789,1236,423,756
13097001270,1721,1559,162,1745,1601,136,1690,1536,154,2135,1852,233,1863,1685,178,2131,1853,239,2157,1889,253,1862,1682,180,1821,1612,180,1734,1489,197
13097001273,2013,1149,864,2049,1152,876,1966,1106,860,2509,1436,1020,2247,1339,908,2523,1453,1016,2542,1466,1040,2247,1337,910,2215,1086,1061,2139,991,1048
13097001271,2502,543,1959,2539,528,1983,2486,537,1949,3064,742,2264,2763,737,2026,3061,748,2258,3080,754,2282,2762,728,2034,2701,514,2120,2642,436,2089
13077000025,1429,440,989,1456,464,981,1392,423,969,1756,570,1129,1604,573,1031,1746,583,1134,1755,602,1119,1603,560,1043,1564,473,1031,1500,393,1041
13127002953,516,211,305,531,217,309,515,216,299,617,262,343,627,275,352,604,251,339,624,277,343,629,274,355,481,200,270,456,161,277
1305104-10C,973,364,609,987,366,611,956,354,602,1150,435,694,1075,446,629,1146,439,681,1162,471,674,1076,445,631,1047,362,653,1010,294,677
1305103-08C,671,467,204,682,476,200,637,443,194,790,557,218,726,525,201,782,559,208,792,565,217,727,525,202,693,462,217,665,391,248
13083001038,447,87,360,469,79,382,442,81,361,650,120,505,582,105,477,638,116,503,662,121,533,584,107,477,554,94,445,486,84,372
13083001214,694,142,552,713,143,564,683,136,547,925,194,707,835,186,649,905,168,705,938,198,729,840,190,650,757,140,590,700,126,531
13083001222,908,99,809,947,91,848,889,91,798,1316,120,1152,1127,102,1025,1283,104,1135,1339,108,1216,1131,105,1026,1115,119,967,963,130,778
13077000009,1391,462,929,1409,445,950,1377,440,937,1751,502,1201,1510,516,994,1751,531,1178,1768,524,1219,1512,512,1000,1520,457,1018,1441,411,964
13077000001,3209,729,2480,3243,740,2464,3151,708,2443,4627,1095,3424,4170,1068,3102,4600,1120,3396,4668,1183,3423,4172,1046,3126,3439,716,2597,3316,623,2538
13127003733,1593,418,1175,1617,435,1169,1563,414,1149,2003,541,1395,1782,509,1273,1968,532,1364,2030,579,1412,1782,510,1272,1706,396,1256,1559,311,1189
13197000807,1197,701,496,1243,712,525,1132,644,488,1467,826,611,1334,791,543,1460,828,605,1483,863,602,1337,794,543,1302,789,495,1197,666,511
13197000539,100,57,43,102,59,43,96,54,42,122,69,51,117,69,48,114,67,47,123,72,51,117,69,48,111,69,42,97,54,43
13197000034,159,94,65,161,94,67,146,82,64,190,106,80,174,105,69,176,103,73,190,111,77,174,105,69,171,104,65,157,87,67
13135000082,2427,1710,717,2466,1761,675,2382,1685,697,3362,2291,960,3015,2206,809,3268,2270,914,3379,2372,965,3014,2191,823,2548,1665,782,2437,1423,863
13135000040,2751,1473,1278,2781,1526,1216,2709,1469,1240,3488,1901,1512,3312,1912,1400,3413,1888,1456,3507,1980,1485,3318,1884,1434,2621,1342,1165,2547,1116,1318
130890000EF,2174,1422,752,2213,1471,710,2142,1420,722,2516,1658,811,2366,1634,732,2519,1673,796,2522,1723,759,2367,1613,754,2206,1484,630,2162,1265,784
130890000WI,808,580,228,831,589,229,806,582,224,926,638,261,847,622,225,924,643,261,924,665,248,847,613,234,815,524,260,810,457,298
130890000MH,1987,994,993,2013,1035,942,1969,1003,966,2315,1257,1014,2235,1281,954,2305,1248,1003,2327,1333,963,2235,1258,977,1988,1037,850,1980,849,1038
132350ANNEX,3467,1002,2465,3622,1079,2527,3365,953,2412,4005,1139,2787,3681,1138,2543,3979,1183,2742,4059,1217,2805,3682,1118,2564,3599,1104,2437,3374,871,2415
13291000010,1359,205,1154,1396,174,1211,1338,183,1155,1835,258,1538,1695,244,1451,1836,255,1556,1864,270,1583,1698,240,1458,1482,211,1244,1393,182,1157
13291000002,1196,208,988,1230,182,1033,1187,189,998,1599,256,1315,1467,250,1217,1591,250,1313,1612,274,1333,1468,250,1218,1223,190,1013,1161,186,930
13291000006,713,137,576,731,124,601,703,130,573,884,160,708,841,169,672,884,164,708,887,180,697,841,163,678,760,133,619,707,121,558
13281001468,1852,425,1427,1887,394,1474,1824,399,1425,2451,505,1903,2246,504,1742,2440,519,1899,2484,550,1924,2244,497,1747,2232,466,1707,2104,432,1590
13291000003,990,184,806,1012,169,831,978,181,797,1224,247,957,1151,236,915,1223,245,964,1230,258,962,1155,234,921,1043,190,825,1002,187,775
13217000009,2309,1705,604,2356,1744,594,2245,1661,584,2940,2051,811,2642,1998,644,2927,2096,780,2966,2094,837,2642,1991,651,2413,1649,722,2306,1508,718
1305102-06C,279,227,52,291,246,42,271,227,44,395,324,58,364,311,53,397,319,67,407,335,65,364,312,52,292,245,37,279,209,59
1305105-03C,479,463,16,497,489,7,447,432,15,564,528,21,528,509,19,570,532,22,577,550,22,527,506,21,536,517,11,487,434,47
1305102-12C,782,687,95,810,712,90,752,657,95,954,797,121,875,771,104,951,799,115,972,823,123,874,766,108,793,657,96,765,564,135
130890000BR,2224,2034,190,2277,2127,121,2192,2030,162,2479,2249,182,2420,2244,176,2480,2243,175,2495,2302,170,2417,2235,182,1934,1725,133,1875,1513,248
130890000MB,2391,2233,158,2449,2298,131,2325,2178,147,2842,2623,167,2764,2630,134,2848,2643,146,2883,2685,164,2763,2612,151,2240,2038,131,2159,1802,239
1330500004B,891,292,599,917,302,605,876,287,589,1148,417,704,1033,398,635,1146,409,704,1156,430,712,1032,399,633,939,353,567,854,271,557
1330500002D,535,97,438,541,92,446,522,92,430,691,129,544,593,113,480,683,125,544,706,131,567,594,111,483,580,84,481,537,71,453
13215000115,3099,2628,471,3165,2715,433,2906,2491,415,3934,3167,694,3406,2913,493,3943,3202,651,3997,3286,664,3402,2909,493,3317,2721,535,3055,2350,616
1305101-06C,1269,515,754,1303,523,759,1255,510,745,1571,670,865,1500,652,848,1553,681,846,1587,704,854,1505,652,853,1409,563,793,1362,388,919
13063000FP3,1086,893,193,1121,923,193,1045,855,190,1328,1035,254,1231,1037,194,1344,1026,250,1358,1069,275,1230,1033,197,1120,880,222,1018,752,235
1306300RD10,1128,1091,37,1152,1128,21,1078,1047,31,1383,1281,61,1198,1165,33,1395,1307,55,1402,1329,59,1191,1156,35,1213,1157,44,1108,1011,70
1306300JB16,1129,1011,118,1146,1035,106,1082,978,104,1334,1117,180,1224,1087,137,1343,1129,174,1357,1133,203,1225,1088,137,1065,912,127,995,813,146
1306300JB17,2230,2091,139,2265,2139,116,2128,2009,119,2706,2411,227,2520,2373,147,2710,2433,213,2736,2462,248,2520,2367,153,2371,2161,165,2207,1905,241
13097000731,1884,900,984,1916,907,996,1856,878,978,2337,1167,1104,2101,1132,969,2329,1187,1098,2352,1197,1131,2105,1128,977,2034,861,1119,1947,786,1080
1309700736N,2349,1684,665,2378,1701,650,2302,1657,645,2880,2072,740,2702,2058,644,2886,2095,739,2896,2098,767,2702,2045,657,2474,1589,807,2372,1452,828
13227000011,1085,184,901,1104,173,923,1071,178,893,1382,223,1124,1247,225,1022,1380,230,1125,1388,231,1136,1246,223,1023,1170,167,970,1130,150,928
13063000MO5,3015,2602,413,3069,2666,388,2928,2542,386,3579,3036,461,3311,2928,383,3576,3047,461,3612,3089,488,3314,2926,388,2939,2455,431,2771,2182,505
1306300JB08,1594,1500,94,1616,1537,78,1534,1453,81,1931,1724,164,1704,1610,94,1938,1751,143,1953,1761,178,1703,1608,95,1708,1569,115,1603,1403,147
130890000RL,2374,2209,165,2412,2255,154,2305,2143,162,2864,2602,216,2700,2522,178,2859,2617,209,2879,2636,231,2696,2517,179,2093,1897,159,1958,1702,212
130890000CM,971,939,32,1001,977,23,940,910,30,1142,1082,40,1074,1051,23,1147,1089,34,1164,1102,57,1072,1047,25,993,949,28,941,852,66
13135000115,2465,1692,773,2511,1724,760,2375,1626,749,3326,2138,1103,2915,2028,887,3253,2086,1076,3367,2161,1171,2914,2010,904,2482,1594,821,2307,1344,872
13135000097,2855,1542,1313,2912,1575,1291,2803,1500,1303,3902,2119,1677,3503,2083,1420,3811,2081,1624,3945,2190,1682,3503,2050,1453,3133,1479,1506,3028,1254,1610
13135000045,1924,1258,666,1964,1276,676,1884,1231,653,2327,1535,739,2107,1447,660,2289,1507,733,2338,1567,754,2110,1444,666,2020,1235,729,1940,1090,780
13135000136,2220,978,1242,2256,984,1238,2186,961,1225,3041,1397,1529,2608,1317,1291,2982,1371,1529,3056,1442,1566,2608,1309,1299,2391,910,1372,2288,784,1370
130890000CL,866,834,32,896,869,26,835,803,32,1038,975,47,1015,984,31,1043,977,51,1055,1000,48,1011,977,34,972,919,39,921,826,74
130890000CR,781,760,21,800,781,15,751,731,20,936,865,46,876,853,23,942,892,32,940,884,51,874,847,27,852,824,23,793,710,67
13135000029,1024,387,637,1039,380,628,1008,388,620,1184,497,641,1087,492,595,1158,497,625,1195,531,639,1087,479,608,1128,371,679,1109,289,742
13135000048,1886,923,963,1910,924,953,1847,905,942,2467,1265,1149,2321,1262,1059,2396,1239,1083,2489,1312,1145,2321,1248,1073,1966,867,1018,1886,721,1053
13135000095,2497,1991,506,2543,2037,484,2401,1918,483,3735,2797,832,3156,2551,605,3581,2720,757,3787,2872,868,3154,2554,600,2522,1864,580,2371,1618,652
13135000150,1027,828,199,1045,845,190,993,805,188,1458,1076,316,1252,1011,241,1405,1042,308,1460,1116,318,1253,1012,241,1164,880,248,1085,779,245
13135000042,1657,682,975,1684,697,959,1633,687,946,2190,951,1164,1888,901,987,2131,953,1116,2198,982,1174,1889,894,995,1795,624,1064,1739,525,1079
13135000001,3659,1803,1856,3718,1842,1835,3588,1766,1822,5245,2741,2373,4698,2635,2063,5148,2686,2341,5267,2782,2405,4698,2621,2077,3652,1470,2026,3491,1293,2011
13135000154,1978,688,1290,2007,699,1284,1945,668,1277,2707,1100,1544,2412,1040,1372,2649,1071,1507,2715,1147,1531,2412,1028,1384,2074,616,1372,1985,516,1366
130890000AF,1126,1062,64,1158,1110,45,1080,1030,50,1381,1250,90,1315,1258,57,1387,1266,86,1398,1280,97,1314,1251,63,1192,1110,61,1117,982,96
130890000SQ,802,651,151,824,665,151,773,620,153,981,777,180,909,756,153,987,801,168,993,801,183,906,743,163,823,636,161,774,564,176
1306700SN4A,3742,2048,1694,3802,2131,1610,3723,2062,1661,4742,2628,2001,4501,2637,1864,4713,2651,1940,4761,2815,1853,4499,2595,1904,4075,2070,1769,4020,1685,2122
1306700BR02,2367,1529,838,2396,1556,813,2325,1499,826,2916,1926,922,2662,1832,830,2896,1918,925,2926,1970,929,2666,1815,851,2452,1448,922,2368,1245,1017
1306700OK01,2350,1350,1000,2382,1405,929,2320,1363,957,3048,1773,1200,2862,1753,1109,3043,1776,1197,3064,1891,1130,2860,1718,1142,2510,1349,1060,2494,1128,1248
1306700NP01,2482,1512,970,2532,1531,956,2452,1485,967,3161,1898,1151,2874,1831,1043,3151,1903,1148,3186,1973,1138,2875,1811,1064,2629,1418,1075,2542,1254,1124
1306700KE2A,2083,987,1096,2120,1005,1087,2069,986,1083,2742,1307,1353,2371,1249,1122,2722,1310,1311,2766,1384,1338,2371,1231,1140,2346,951,1278,2279,825,1322
1306700MS02,1594,672,922,1610,672,904,1572,661,911,2109,898,1117,1852,876,976,2102,918,1102,2121,943,1119,1851,859,992,1744,643,1022,1706,544,1052
13097000729,2545,2229,316,2598,2295,288,2484,2180,304,3452,2877,470,3147,2806,341,3462,2952,447,3492,2960,497,3152,2799,353,2444,2044,342,2325,1847,409
130890000AB,1669,762,907,1713,860,819,1665,783,882,1999,946,1008,1922,938,984,1960,954,951,2004,1075,890,1926,904,1022,1723,787,811,1687,560,1043
130890000SR,1221,1166,55,1256,1210,44,1177,1128,49,1456,1357,62,1418,1375,43,1465,1385,62,1472,1395,69,1414,1369,45,1254,1190,52,1187,1056,105
13135000088,2283,1775,508,2321,1798,506,2221,1716,505,2949,2277,592,2707,2200,507,2886,2230,598,2971,2311,620,2713,2209,504,2429,1781,578,2276,1560,615
13135000075,3020,2457,563,3065,2514,524,2932,2386,546,3721,3005,648,3526,2982,544,3645,2966,622,3747,3055,664,3529,2970,559,3028,2305,646,2903,2091,689
13135000054,2805,1042,1763,2847,1064,1750,2772,1041,1731,3878,1499,2244,3393,1436,1957,3804,1501,2188,3889,1595,2225,3394,1409,1985,3033,986,1914,2897,801,1934
13135000032,1774,886,888,1801,908,865,1752,876,876,2237,1232,932,2010,1202,808,2171,1205,902,2237,1293,895,2014,1193,821,1848,837,930,1802,693,1031
13135000011,1145,773,372,1171,798,363,1111,749,362,1569,1004,524,1397,964,433,1510,987,487,1578,1033,529,1400,959,441,1274,839,383,1183,715,393
130890000OB,958,745,213,986,752,217,905,695,210,1283,909,354,1141,858,283,1263,869,341,1303,913,377,1139,860,279,984,703,239,904,589,264
130890000PF,2026,1728,298,2053,1766,270,1958,1679,279,2489,2036,384,2182,1851,331,2479,2007,393,2504,2068,394,2180,1845,335,2040,1659,327,1949,1459,404
130890000DB,720,504,216,733,509,206,702,498,204,836,575,237,776,560,216,831,579,229,841,589,240,777,555,222,734,490,203,709,425,248
130890000DA,1415,1073,342,1463,1100,340,1364,1032,332,1875,1371,454,1691,1294,397,1856,1355,443,1896,1398,473,1695,1293,402,1560,1101,391,1456,895,463
13267000008,1390,407,983,1447,410,1029,1352,372,980,1721,487,1206,1569,472,1097,1692,484,1184,1745,512,1221,1570,471,1099,1507,459,1027,1409,364,1032
13267000007,1390,246,1144,1425,221,1199,1363,225,1138,1788,351,1398,1596,322,1274,1754,339,1366,1798,365,1405,1597,321,1276,1470,235,1203,1414,208,1172
13267000003,809,189,620,843,175,662,784,164,620,998,220,758,923,222,701,987,224,753,1013,227,783,923,222,701,855,192,656,802,134,646
132610C1-27,1474,1127,347,1511,1163,340,1423,1071,352,1723,1325,373,1548,1247,301,1716,1336,349,1738,1357,369,1551,1248,303,1617,1216,376,1540,1069,448
1326100E-27,1192,527,665,1218,534,682,1170,495,675,1337,591,732,1275,580,695,1338,599,719,1347,614,727,1274,573,701,1200,501,674,1163,451,692
132610C3-27,1462,1187,275,1523,1249,269,1427,1149,278,1720,1383,311,1577,1322,255,1718,1391,285,1750,1438,298,1572,1318,254,1550,1277,256,1460,1109,318
13195000HUL,2278,737,1541,2327,713,1591,2219,695,1524,2963,942,1945,2647,902,1745,2929,945,1923,2982,990,1950,2647,893,1754,2264,669,1519,2168,583,1503
1314100002B,298,258,40,311,275,36,286,252,34,358,310,46,339,300,39,353,305,44,363,315,48,339,301,38,305,270,32,278,231,42
1330500001C,1026,125,901,1044,106,931,1011,108,903,1259,168,1077,1136,153,983,1246,157,1078,1270,168,1092,1136,150,986,1073,110,946,1018,110,885
130890000JA,1316,957,359,1336,1025,297,1317,984,333,1396,1028,351,1357,1018,339,1391,1050,322,1413,1122,269,1360,995,365,1146,854,238,1131,683,412
130890000EG,1914,1460,454,1944,1542,372,1911,1506,405,2497,1942,506,2422,1938,484,2484,1931,489,2509,2031,436,2426,1910,516,2114,1575,428,2099,1265,745
13135000050,1235,930,305,1257,963,285,1197,911,286,1598,1124,426,1366,1022,344,1547,1096,407,1608,1154,434,1367,1021,346,1335,988,310,1249,852,347
13135000020,1252,1024,228,1269,1046,204,1210,997,213,1643,1242,348,1400,1174,226,1604,1236,311,1657,1283,362,1402,1170,232,1289,992,239,1223,880,260
13217000020,2423,1792,631,2464,1827,625,2334,1720,614,3205,2404,749,2980,2344,636,3215,2421,749,3244,2416,805,2980,2344,636,2429,1662,726,2314,1514,744
13127002713,2468,636,1832,2503,666,1812,2457,651,1806,3047,872,2125,2973,858,2115,2990,826,2096,3077,967,2088,2978,858,2120,2439,612,1755,2335,461,1794
13127002923,1838,426,1412,1878,449,1414,1830,441,1389,2371,614,1733,2284,612,1672,2326,574,1705,2389,697,1666,2292,607,1685,1856,450,1366,1756,311,1399
13217000006,1947,523,1424,1972,515,1440,1899,503,1396,2525,666,1811,2252,643,1609,2516,672,1807,2546,676,1845,2251,636,1615,2059,500,1512,1982,465,1442
13267000009,592,77,515,609,60,546,582,58,524,715,91,612,632,81,551,693,86,592,719,93,620,632,83,549,651,84,558,617,76,529
13261000029,279,59,220,283,65,218,268,58,210,358,95,260,300,73,227,356,88,263,361,87,268,301,75,226,291,71,218,270,66,198
13261000017,381,193,188,390,189,198,360,173,187,441,210,225,412,199,213,435,208,216,449,216,227,411,198,213,430,199,226,410,183,223
13261000015,1051,379,672,1079,383,693,1022,349,673,1185,401,769,1109,399,710,1167,396,760,1195,416,770,1112,396,716,1095,394,680,1027,341,668
132710000MI,530,64,466,541,52,489,523,61,462,624,67,555,559,76,483,617,75,539,632,73,558,556,72,484,541,62,474,505,58,440
132710000LU,573,259,314,598,266,331,553,243,310,720,329,381,639,293,346,708,327,370,726,334,386,638,290,348,632,283,348,589,259,322
13195000COM,784,232,552,810,234,569,763,220,543,1079,358,695,958,332,626,1066,368,680,1091,364,716,958,328,630,825,240,562,791,210,553
13195000DAN,1671,254,1417,1720,233,1473,1643,241,1402,2140,352,1739,1897,331,1566,2115,343,1734,2166,354,1784,1892,333,1559,1820,257,1516,1722,231,1438
13195000PIT,1206,263,943,1224,230,981,1183,229,954,1438,284,1122,1305,255,1050,1432,286,1124,1450,292,1135,1306,255,1051,1258,231,993,1225,205,967
13143000010,943,150,793,958,120,829,922,130,792,1275,166,1084,1142,162,980,1257,161,1066,1283,168,1104,1141,161,980,1011,151,837,964,148,779
13143000002,3341,546,2795,3387,511,2852,3269,508,2761,4579,726,3731,3799,664,3135,4531,743,3686,4610,760,3798,3800,655,3145,3624,558,2969,3470,479,2849
13159000363,326,78,248,334,76,256,317,75,242,448,90,352,399,90,309,433,86,345,449,93,353,398,88,310,348,76,268,339,71,256
13159000290,650,154,496,669,152,512,637,148,489,899,175,706,801,172,629,911,189,708,906,186,711,803,171,632,710,153,544,683,143,510
132710000HE,527,175,352,555,166,387,504,150,354,652,203,427,574,205,369,639,213,417,658,216,438,576,206,370,603,195,401,543,166,367
13309000001,1146,376,770,1180,363,813,1107,358,749,1350,420,905,1205,408,797,1329,426,880,1368,452,906,1207,406,801,1245,398,831,1127,338,761
1306700BG01,1404,650,754,1427,659,746,1395,651,744,1594,721,822,1384,635,749,1590,702,832,1604,747,827,1384,632,752,1552,630,840,1523,549,872
1306700KE3A,3078,1992,1086,3124,2014,1079,3033,1949,1084,4270,2576,1543,3620,2368,1252,4236,2578,1521,4310,2667,1557,3621,2353,1268,3387,1946,1277,3265,1701,1359
1306700KE1A,1235,630,605,1252,647,591,1220,616,604,1652,846,743,1402,777,625,1647,845,726,1668,876,750,1404,769,635,1433,660,696,1387,550,731
1330500005A,1083,291,792,1112,269,833,1073,262,811,1327,363,931,1187,352,835,1313,358,931,1345,362,965,1187,362,825,1180,275,869,1109,239,831
1330500002C,649,43,606,661,35,620,635,36,599,866,74,771,773,58,715,858,64,777,877,73,795,774,59,715,674,46,624,647,48,584
13143000003,1220,153,1067,1248,144,1096,1197,149,1048,1620,179,1401,1431,173,1258,1614,192,1386,1649,183,1452,1432,172,1260,1343,169,1154,1268,153,1059
1331700003A,572,395,177,597,411,184,548,372,176,664,462,194,620,439,181,664,462,193,682,484,192,620,441,179,624,431,181,580,379,187
13317000001,873,536,337,921,572,347,859,526,333,1039,627,392,971,610,361,1043,636,393,1073,675,388,967,604,363,925,562,357,846,453,371
1331700002A,825,163,662,842,148,685,804,145,659,926,201,708,845,189,656,915,200,699,938,218,711,844,191,653,866,164,686,818,131,661
1304700FT-O,1951,474,1477,1981,466,1489,1916,470,1446,2684,669,1922,2299,611,1688,2648,639,1922,2723,701,1989,2301,613,1688,2332,486,1765,2113,414,1590
1304700POPS,2242,386,1856,2279,390,1865,2217,383,1834,3021,562,2374,2605,508,2097,2971,524,2352,3057,582,2432,2604,510,2094,2594,384,2122,2406,327,1955
1304700RING,4031,889,3142,4113,900,3164,3950,889,3061,5419,1247,4010,4700,1153,3547,5360,1157,4032,5490,1327,4081,4695,1154,3541,4459,883,3413,4139,728,3168
1306700DI01,2771,2185,586,2816,2228,551,2705,2132,573,3829,2732,960,3160,2384,776,3813,2749,947,3876,2832,975,3160,2366,794,2843,2101,634,2762,1878,698
1306700MR1A,1811,1304,507,1836,1342,465,1780,1291,489,2365,1561,719,2048,1438,610,2357,1557,703,2387,1624,706,2048,1427,621,1803,1197,499,1758,1042,570
1306700SN3A,3822,2439,1383,3860,2533,1265,3765,2455,1310,5134,3213,1773,4645,3072,1573,5084,3205,1734,5170,3388,1681,4651,3028,1623,3848,2255,1374,3800,1886,1637
1306700SN2A,2899,2223,676,2954,2287,633,2868,2219,649,3678,2702,855,3244,2520,724,3655,2670,863,3707,2791,849,3245,2494,751,3145,2206,786,3062,1947,938
1306700SN5A,2217,1538,679,2245,1586,625,2168,1524,644,2849,1910,842,2575,1854,721,2833,1907,825,2873,2006,811,2573,1825,748,2141,1369,686,2072,1156,783
1306700OR03,2457,1809,648,2504,1858,622,2388,1761,627,3142,2198,834,2762,2063,699,3136,2203,833,3191,2275,868,2760,2050,710,2819,1862,858,2719,1651,912
1306700OR02,3134,2330,804,3180,2378,768,3066,2303,763,3817,2746,959,3475,2636,839,3817,2767,949,3857,2812,989,3473,2633,840,3280,2309,861,3154,2009,999
1306700OR01,1149,431,718,1161,438,706,1137,422,715,1351,538,769,1284,526,758,1342,537,764,1353,567,767,1286,522,764,1206,389,762,1173,314,806
1306700LI01,2757,2105,652,2784,2168,588,2732,2112,620,3736,2842,812,3551,2804,747,3735,2874,784,3769,2942,769,3551,2774,777,2788,1969,723,2716,1689,911
1306700SN7A,4409,2981,1428,4461,3091,1314,4355,2962,1393,5181,3566,1511,4964,3610,1354,5186,3604,1466,5225,3785,1367,4964,3539,1425,4528,2854,1468,4460,2370,1871
1306700NJ01,2911,2208,703,2949,2305,609,2884,2224,660,3491,2596,815,3207,2489,718,3501,2621,806,3530,2706,781,3205,2458,747,3000,2127,716,2940,1788,981
1306700MR6B,1862,996,866,1878,1036,822,1831,986,845,2288,1204,1015,2121,1186,935,2268,1218,983,2304,1283,970,2121,1158,963,1931,933,918,1895,749,1065
1306700EL04,1618,978,640,1652,1013,614,1604,976,628,2050,1242,734,1857,1203,654,2036,1256,706,2069,1317,715,1861,1186,675,1728,924,704,1691,765,806
1306700MR6A,1206,935,271,1217,954,250,1190,920,270,1556,1134,367,1307,1024,283,1555,1146,358,1575,1184,374,1306,1021,285,1299,919,313,1281,842,358
1306700HT01,2760,1100,1660,2801,1164,1585,2747,1116,1631,3541,1515,1947,3337,1515,1822,3512,1497,1922,3576,1640,1858,3342,1494,1848,3058,1149,1713,3015,840,2004
1306700FO04,2012,1408,604,2061,1434,601,1968,1361,607,2683,1773,812,2283,1611,672,2661,1775,806,2719,1825,856,2279,1599,680,2328,1538,724,2199,1324,764
1306700FO02,2729,1984,745,2789,2032,727,2668,1956,712,3509,2507,911,3132,2343,789,3489,2520,901,3539,2551,956,3133,2339,794,2680,1886,713,2565,1670,768
13127004923,1523,902,621,1553,923,614,1454,854,600,1983,1149,775,1758,1072,686,1963,1142,752,2010,1193,787,1757,1075,682,1696,966,689,1527,807,658
13199000013,302,73,229,310,59,250,296,58,238,379,64,306,335,61,274,370,63,301,383,68,311,334,59,275,335,66,266,315,48,253
13199000002,852,308,544,875,280,587,828,261,567,1178,399,750,1013,374,639,1167,415,727,1192,422,761,1014,369,645,948,299,624,900,264,601
13191001515,1108,697,411,1142,722,416,1055,661,394,1363,832,499,1244,815,429,1340,819,494,1385,868,501,1237,807,430,1215,799,406,1126,647,447
13217000013,2766,2232,534,2819,2278,526,2679,2151,528,3582,2843,670,3319,2774,545,3590,2886,665,3613,2872,710,3317,2760,557,2724,2068,617,2587,1879,642
13217000017,1378,422,956,1401,414,977,1344,405,939,1791,566,1189,1587,532,1055,1783,572,1178,1810,586,1204,1586,530,1056,1475,417,1009,1428,385,989
1330500004A,517,409,108,535,437,97,485,383,102,652,482,152,595,470,125,653,491,148,663,500,156,596,472,124,540,429,99,472,326,130
13159000297,1014,139,875,1026,125,897,998,131,867,1391,163,1195,1212,159,1053,1368,164,1186,1400,167,1219,1209,151,1058,1031,139,868,998,132,816
13159000296,1155,139,1016,1170,123,1040,1135,129,1006,1592,165,1394,1381,157,1224,1586,174,1379,1607,169,1423,1383,152,1231,1165,133,1007,1125,136,936
1306700MR7A,1453,1210,243,1476,1222,236,1422,1186,236,1830,1414,341,1543,1280,263,1827,1446,332,1852,1461,359,1546,1281,265,1553,1224,277,1491,1109,285
1306700MR5A,1517,1086,431,1545,1126,406,1481,1057,424,2073,1401,602,1905,1339,566,2067,1412,591,2102,1479,589,1902,1316,586,1742,1298,383,1661,1080,483
1306700PF01,1982,983,999,2020,995,988,1962,965,997,2555,1231,1233,2301,1203,1098,2520,1212,1223,2562,1287,1213,2306,1190,1116,2179,962,1099,2141,777,1213
1306700HY01,2524,831,1693,2552,841,1670,2507,825,1682,3259,1159,2038,2999,1124,1875,3238,1138,2005,3276,1215,2012,2998,1097,1901,2678,784,1781,2623,642,1832
1306700VA01,2056,634,1422,2077,633,1420,2049,638,1411,2548,814,1647,2337,801,1536,2531,824,1634,2566,877,1630,2337,781,1556,2240,599,1541,2207,471,1626
1306700NC01,1268,612,656,1288,617,651,1264,607,657,1675,844,772,1532,835,697,1669,837,786,1692,863,795,1530,821,709,1391,570,754,1355,498,792
1306700BK01,2502,1446,1056,2546,1487,1014,2483,1430,1053,3340,1928,1307,2943,1823,1120,3311,1934,1282,3368,1984,1319,2941,1797,1144,2888,1473,1262,2785,1249,1374
1306700AC1C,2516,1618,898,2559,1648,874,2482,1594,888,3459,2183,1164,2968,2036,932,3433,2181,1137,3491,2249,1183,2968,2024,944,2755,1557,1066,2664,1385,1116
1306700MT01,2729,1073,1656,2754,1129,1579,2712,1095,1617,3451,1443,1935,3328,1457,1871,3418,1447,1881,3450,1626,1760,3335,1422,1913,3000,1177,1671,2975,754,2068
1306700GT01,2345,1039,1306,2377,1034,1291,2315,1015,1300,2991,1299,1588,2709,1293,1416,2976,1290,1570,3010,1359,1578,2714,1272,1442,2588,962,1473,2543,833,1522
1306700AU1A,2333,1924,409,2368,1968,396,2277,1872,405,3326,2650,599,3022,2553,469,3305,2659,587,3357,2696,644,3022,2547,475,2607,2016,538,2447,1805,554
1306700CL01,1005,632,373,1027,639,380,974,606,368,1232,742,456,1130,717,413,1234,757,447,1258,764,478,1131,717,414,1130,662,443,1095,603,451
1306700CL02,2925,2119,806,2970,2149,800,2872,2087,785,3634,2551,995,3341,2459,882,3626,2571,976,3669,2598,1030,3341,2452,889,3107,2063,977,2980,1841,1024
1306700MA01,2686,1860,826,2729,1897,810,2645,1829,816,3539,2435,1007,3282,2388,894,3531,2444,1003,3573,2483,1039,3280,2364,916,2851,1795,976,2731,1580,1000
1306700MA02,1489,1064,425,1515,1077,427,1443,1022,421,1952,1378,525,1761,1318,443,1945,1379,513,1969,1416,534,1760,1319,441,1488,953,506,1404,844,510
1305103-04C,747,695,52,767,724,39,718,670,48,858,775,68,809,763,46,852,786,56,871,798,63,811,768,43,824,772,44,753,638,100
1305103-03C,458,403,55,475,425,47,432,381,51,599,517,69,548,488,60,604,534,64,609,537,64,549,488,61,537,472,58,493,403,75
1306700SF01,2293,930,1363,2333,969,1339,2285,913,1372,2837,1176,1598,2712,1182,1530,2819,1196,1564,2836,1294,1487,2710,1155,1555,2435,920,1403,2429,715,1613
1306700BF03,3462,1547,1915,3514,1567,1873,3434,1548,1886,4342,1959,2221,3896,1909,1987,4324,1977,2185,4374,2051,2214,3898,1888,2010,3697,1362,2110,3652,1161,2187
1304700LAKE,1503,333,1170,1531,324,1185,1458,316,1142,2144,467,1584,1739,408,1331,2109,437,1576,2175,485,1654,1739,416,1323,1862,372,1421,1634,341,1193
13297000417,2600,681,1919,2644,646,1975,2543,661,1882,3575,952,2514,3089,900,2189,3558,978,2492,3602,993,2559,3085,894,2191,2968,536,2350,2812,470,2191
13297000427,2206,841,1365,2249,851,1383,2162,822,1340,3012,1327,1627,2763,1313,1450,2994,1348,1594,3042,1382,1633,2763,1303,1460,2123,696,1382,2022,601,1348
13297000559,1196,164,1032,1216,160,1046,1171,149,1022,1673,225,1411,1562,230,1332,1654,232,1399,1679,239,1425,1561,225,1336,1143,149,964,1107,131,927
1304700WOOD,1638,263,1375,1669,263,1386,1599,263,1336,2253,372,1810,1963,345,1618,2211,343,1804,2275,393,1852,1962,344,1618,1848,271,1520,1693,242,1372
1306300JB04,935,778,157,960,819,138,901,759,142,1186,934,210,1087,918,169,1179,956,199,1197,974,208,1086,913,173,1005,811,172,919,702,184
1306300JB03,2128,1789,339,2165,1816,341,2070,1729,341,2624,2145,432,2411,2072,339,2626,2170,404,2654,2178,460,2411,2067,344,2224,1795,386,2088,1598,432
13267000005,1266,404,862,1311,414,890,1235,377,858,1592,505,1058,1393,483,910,1570,490,1052,1615,532,1073,1392,475,917,1356,453,878,1271,353,883
13267000004,164,55,109,166,48,118,155,46,109,197,50,141,179,51,128,189,50,134,198,51,145,179,51,128,168,43,124,157,35,115
132710000JA,372,100,272,390,96,293,366,88,278,438,96,329,400,92,308,426,91,330,447,95,351,401,91,310,423,116,307,388,99,285
13309000002,715,192,523,751,192,559,702,184,518,904,237,657,803,226,577,899,239,651,917,237,677,802,221,581,857,248,590,777,207,543
13159000295,2213,825,1388,2269,831,1426,2171,770,1401,2701,906,1744,2492,912,1580,2697,925,1723,2721,949,1754,2488,902,1586,2288,860,1382,2168,726,1371
13159000293,255,97,158,260,97,162,248,88,160,303,104,194,282,105,177,301,105,194,305,108,196,283,104,179,261,100,157,247,83,157
13159000289,214,80,134,217,80,137,211,76,135,258,87,166,236,88,148,241,80,161,256,89,166,236,86,150,220,83,134,212,71,134
1305108-08C,755,733,22,794,785,7,719,698,21,889,846,29,847,829,18,899,859,23,910,867,36,844,822,22,863,841,15,780,687,79
1305104-07C,1864,611,1253,1901,619,1262,1835,595,1240,2478,853,1569,2282,829,1453,2455,840,1555,2503,907,1568,2280,828,1452,2113,629,1396,2039,505,1452
13143000012,1484,229,1255,1514,187,1315,1462,210,1252,2006,287,1671,1730,281,1449,1983,300,1638,2035,300,1715,1732,284,1448,1705,258,1395,1591,268,1239
13321000011,335,26,309,342,21,318,333,24,309,410,26,377,371,22,349,406,30,370,412,29,383,369,22,347,342,27,314,329,27,295
13201000001,2216,485,1731,2315,502,1803,2152,442,1710,2781,687,2047,2454,651,1803,2643,635,1940,2835,749,2066,2450,650,1800,2544,623,1891,2272,503,1709
13293001577,210,47,163,210,44,166,204,42,162,261,55,204,228,51,177,233,45,188,260,55,205,228,51,177,215,44,170,204,36,164
13293000555,2768,622,2146,2835,601,2219,2715,573,2142,3453,709,2693,3006,674,2332,3433,744,2631,3483,743,2717,3005,670,2335,2918,599,2281,2771,516,2165
13293001610,786,172,614,804,171,628,773,160,613,981,200,762,851,193,658,991,216,768,990,208,774,852,192,660,838,170,651,792,145,619
13293001336,1040,235,805,1057,222,830,1011,209,802,1294,267,1009,1133,258,875,1279,273,994,1304,274,1021,1129,253,876,1091,222,854,1030,191,812
1306700CH03,2663,1178,1485,2691,1197,1454,2633,1179,1454,3271,1552,1644,3104,1561,1543,3266,1563,1635,3280,1638,1592,3104,1527,1577,2772,1116,1505,2774,937,1686
1306700OR04,2571,1858,713,2608,1908,684,2519,1815,704,3209,2248,893,2954,2195,759,3215,2280,865,3250,2325,895,2953,2180,773,2573,1776,725,2482,1573,804
1306700KP02,2570,1018,1552,2617,1039,1549,2549,1004,1545,3220,1345,1812,2980,1318,1662,3209,1361,1775,3266,1436,1772,2977,1298,1679,2736,983,1649,2679,787,1757
1306700LA01,2373,892,1481,2398,935,1425,2354,914,1440,2987,1219,1694,2773,1199,1574,2972,1231,1661,2997,1316,1613,2777,1169,1608,2577,844,1609,2537,649,1752
1306700RS01,970,894,76,983,915,65,944,870,74,1118,973,113,985,913,72,1120,996,101,1130,997,119,986,905,81,1019,910,85,973,831,111
1306700HL01,3633,3015,618,3688,3087,577,3580,2991,589,4505,3722,678,4194,3637,557,4523,3763,655,4566,3817,705,4192,3616,576,3489,2761,647,3368,2485,755
1306700VG03,2567,1642,925,2602,1710,867,2522,1626,896,3239,2092,1088,2982,1997,985,3237,2114,1060,3270,2236,1002,2985,1966,1019,2719,1605,992,2668,1319,1248
1306700SW02,1460,1157,303,1481,1165,302,1420,1107,313,1955,1472,431,1746,1389,357,1959,1510,413,1989,1517,444,1746,1377,369,1567,1145,383,1479,990,425
133130000PG,2449,607,1842,2519,601,1895,2361,564,1797,3264,864,2311,2807,741,2066,3220,823,2300,3316,911,2376,2810,743,2067,2816,693,2039,2621,600,1898
1306700BT02,2425,2292,133,2458,2350,100,2331,2213,118,3062,2761,225,2731,2600,131,3075,2805,215,3091,2816,244,2730,2595,135,2633,2457,141,2488,2220,190
13143000004,508,58,450,518,43,469,501,57,444,702,59,621,606,63,543,693,66,616,704,62,637,606,62,544,522,52,459,503,68,412
13267000001,409,68,341,421,65,352,399,64,335,532,100,421,463,90,373,520,91,416,539,99,436,463,95,368,427,78,343,384,65,307
132610C2-27,1705,738,967,1735,750,973,1669,718,951,2077,933,1104,1889,886,1003,2071,951,1091,2092,975,1091,1889,882,1007,1870,774,1051,1832,692,1096
1306700HR01,1991,572,1419,2015,572,1401,1972,567,1405,2513,776,1677,2322,771,1551,2507,791,1657,2528,816,1665,2327,743,1584,1974,494,1413,1938,400,1453
1306700EP01,1383,744,639,1400,762,618,1361,737,624,1878,1038,785,1677,1003,674,1866,1048,763,1886,1077,782,1671,979,692,1492,732,691,1454,608,768
1306700EL02,1542,649,893,1570,660,884,1539,646,893,1893,815,1035,1726,805,921,1876,816,1007,1912,864,1022,1727,787,940,1649,617,964,1601,504,1013
1306700CK01,2751,1646,1105,2782,1685,1052,2701,1628,1073,3845,2380,1336,3203,2086,1117,3824,2366,1340,3883,2467,1349,3205,2069,1136,2946,1479,1291,2879,1296,1378
1306700PE01,2701,2257,444,2750,2309,429,2629,2196,433,3291,2622,585,3019,2542,477,3301,2641,582,3340,2673,629,3020,2531,489,2862,2291,501,2742,2060,582
1306700SM01,2221,1012,1209,2245,1049,1165,2211,1016,1195,2821,1355,1402,2672,1361,1311,2820,1363,1390,2851,1481,1334,2672,1318,1354,2361,979,1272,2305,740,1420
1306700EL01,1738,1171,567,1759,1222,519,1708,1162,546,2473,1698,712,2104,1531,573,2443,1677,703,2481,1721,722,2104,1516,588,2013,1243,689,1929,1053,765
1306700MR5B,1135,888,247,1149,901,228,1111,875,236,1639,1234,363,1392,1125,267,1638,1228,364,1654,1240,385,1392,1126,266,1270,923,294,1217,819,330
1306700MR4B,1258,605,653,1274,637,616,1233,600,633,1544,770,732,1454,783,671,1532,769,706,1549,831,683,1456,766,690,1315,615,627,1281,475,726
1306700CH02,1934,735,1199,1964,757,1170,1924,739,1185,2494,992,1435,2359,1021,1338,2486,1001,1414,2515,1062,1408,2354,998,1356,2091,703,1299,2076,562,1415
1306700MR4A,1426,375,1051,1449,389,1038,1416,362,1054,1691,483,1168,1662,512,1150,1682,508,1137,1687,568,1080,1662,477,1185,1451,372,1009,1455,245,1127
1306700KP01,1272,364,908,1281,358,900,1261,371,890,1596,504,1047,1477,479,998,1583,516,1034,1597,546,1023,1474,461,1013,1345,336,943,1337,265,989
1306700DO01,1434,553,881,1449,563,856,1423,548,875,1767,735,983,1674,739,935,1760,742,973,1772,810,921,1677,723,954,1550,554,931,1521,414,1026
1306700PT01,1627,701,926,1650,717,912,1603,685,918,2117,929,1119,1919,915,1004,2105,937,1096,2128,966,1111,1919,898,1021,1829,648,1089,1802,540,1125
1306700BG02,1927,859,1068,1954,892,1039,1902,864,1038,2475,1173,1248,2292,1141,1151,2443,1138,1244,2498,1229,1231,2293,1122,1171,2098,805,1186,2059,650,1312
131210SS07B,401,229,172,403,239,159,391,225,166,564,345,208,530,339,191,565,345,201,569,370,195,531,332,199,360,180,152,353,135,192
13321000001,1354,827,527,1410,893,516,1280,768,512,1652,1006,615,1500,970,530,1646,1001,607,1676,1045,616,1500,978,522,1483,905,562,1389,758,606
13195000HAR,363,35,328,373,25,345,358,27,331,481,33,439,436,36,400,474,35,427,486,34,445,436,32,404,368,35,326,349,33,303
1306700NS01,1504,639,865,1530,648,851,1486,626,860,1847,801,971,1671,793,878,1831,813,960,1856,843,969,1671,775,896,1659,579,991,1607,507,1011
1306700MS01,1870,471,1399,1887,461,1399,1854,461,1393,2689,682,1932,2483,668,1815,2691,691,1920,2712,726,1940,2483,657,1826,2008,436,1507,1956,381,1475
1306700AC1A,3058,1481,1577,3100,1498,1565,3025,1458,1567,4032,1957,1958,3597,1914,1683,3998,1995,1892,4067,2055,1963,3598,1890,1708,3433,1408,1862,3339,1257,1901
1306700AC1B,2640,1196,1444,2690,1197,1458,2606,1163,1443,3623,1617,1896,3148,1514,1634,3618,1608,1906,3678,1682,1941,3148,1501,1647,2889,1156,1615,2769,979,1623
1306700WL01,1924,752,1172,1945,794,1124,1906,765,1141,2389,983,1356,2275,980,1295,2367,1007,1311,2394,1079,1270,2274,951,1323,2119,752,1257,2110,570,1431
1306700PO01,2406,897,1509,2439,915,1487,2400,892,1508,2996,1179,1748,2868,1156,1712,2970,1143,1735,3016,1289,1680,2868,1133,1735,2612,850,1631,2587,656,1808
13195000COB,1828,482,1346,1875,492,1369,1777,467,1310,2387,680,1657,2099,643,1456,2363,682,1640,2399,702,1664,2100,634,1466,1875,465,1363,1797,412,1323
13039000004,346,52,294,351,45,300,335,48,287,460,67,372,374,59,315,454,76,359,472,74,384,372,62,310,417,70,336,382,60,301
1322300012C,3451,526,2925,3505,499,2976,3399,514,2885,4900,872,3918,4196,831,3365,4842,876,3872,4938,910,3984,4197,814,3383,3538,531,2919,3336,467,2722
1322300003C,4323,1341,2982,4402,1343,3011,4251,1274,2977,6015,2159,3690,5287,2047,3240,5949,2168,3643,6064,2205,3774,5285,2032,3253,3984,971,2893,3822,841,2788
13245000208,1187,999,188,1225,1046,174,1142,961,181,1417,1137,247,1255,1076,179,1412,1160,229,1449,1192,241,1256,1072,184,1391,1134,229,1263,971,246
13245000804,1025,609,416,1047,616,424,1006,592,414,1370,781,557,1183,699,484,1370,794,544,1384,808,567,1184,705,479,1078,597,446,1008,532,442
13169000008,112,22,90,116,24,91,108,23,85,146,30,111,129,23,106,145,29,113,146,30,115,129,22,107,119,30,86,109,20,86
13195000FOR,305,106,199,309,104,202,299,105,194,402,132,258,343,117,226,401,125,263,407,130,273,344,113,231,356,112,233,347,103,228
13195000COL,367,55,312,378,51,326,363,52,311,462,55,396,429,58,371,466,59,400,466,57,403,429,58,371,384,46,322,368,49,298
13195000MIL,947,141,806,971,121,843,933,123,810,1238,169,1049,1117,158,959,1228,164,1046,1255,178,1060,1117,159,958,986,126,839,940,109,787
13169000005,1108,351,757,1141,368,771,1080,339,741,1363,423,910,1241,416,825,1361,431,905,1374,445,921,1242,412,830,1148,384,742,1087,327,709
13245000605,1761,1160,601,1802,1175,619,1709,1115,594,2262,1445,759,1990,1345,645,2261,1462,744,2294,1508,755,1987,1349,638,2035,1268,724,1907,1133,726
13169000010,1824,1130,694,1864,1153,702,1791,1124,667,2249,1324,878,2039,1288,751,2230,1340,852,2264,1377,868,2038,1285,753,1872,1127,710,1763,1001,720
1312100RW05,1188,776,412,1206,791,402,1161,756,405,1846,1169,617,1659,1096,563,1808,1149,600,1865,1222,615,1658,1085,573,1209,713,424,1158,613,467
1312100AP03,304,234,70,309,235,68,293,226,67,420,312,93,360,275,85,418,308,97,425,321,100,359,275,84,401,294,95,390,268,99
131210AP02B,261,129,132,263,136,125,253,130,123,483,260,212,437,250,187,464,260,193,489,280,203,438,245,193,238,109,122,223,81,140
131210AP022,1390,718,672,1417,747,656,1367,703,664,1770,938,790,1697,959,738,1741,935,764,1796,1000,778,1696,945,751,1460,706,677,1384,575,729
13027001712,325,79,246,334,86,246,312,74,238,430,114,308,388,111,277,420,113,301,438,122,314,387,107,280,339,85,249,307,63,232
1307500000L,714,152,562,730,148,580,689,134,555,880,171,691,798,171,627,876,171,692,890,180,702,800,172,628,748,165,568,726,145,561
13093000005,984,486,498,1012,502,506,932,451,481,1076,514,542,1002,515,487,1060,512,533,1087,532,547,1001,518,483,1033,521,501,958,410,524
13093000008,348,106,242,358,102,255,337,95,242,386,90,286,358,91,267,375,90,281,386,100,282,356,90,266,356,103,248,334,78,249
1306700KP03,2608,702,1906,2640,694,1912,2600,684,1916,3233,950,2230,3057,951,2106,3221,955,2203,3247,1005,2187,3061,934,2127,2766,633,2035,2730,527,2070
1306700SM03,2527,1417,1110,2574,1450,1070,2474,1391,1083,3142,1787,1273,2790,1648,1142,3139,1776,1258,3166,1859,1249,2787,1617,1170,2721,1376,1213,2664,1141,1347
1306700WG02,2780,1483,1297,2802,1469,1284,2715,1446,1269,3508,1803,1598,3130,1727,1403,3481,1794,1572,3534,1859,1605,3130,1710,1420,2940,1364,1417,2880,1181,1516
1306700MR3A,3567,2142,1425,3621,2211,1356,3508,2127,1381,4575,2710,1733,4205,2611,1594,4556,2746,1692,4613,2854,1696,4205,2579,1626,3781,2103,1501,3672,1732,1746
1306700CO01,2498,1994,504,2555,2035,505,2418,1922,496,3299,2563,662,2935,2384,551,3295,2565,662,3333,2611,694,2937,2376,561,2712,2010,627,2570,1810,669
1306700CA01,2959,2200,759,3003,2280,683,2943,2217,726,3897,2779,984,3272,2463,809,3858,2758,960,3923,2860,986,3274,2456,818,3090,2149,785,3038,1890,928
1306700SO02,2920,1331,1589,2946,1390,1507,2904,1346,1558,3640,1765,1800,3427,1732,1695,3615,1757,1760,3663,1963,1632,3422,1693,1729,3005,1364,1491,3001,1046,1797
1306700MR2A,1488,561,927,1502,562,911,1467,543,924,1728,706,975,1645,722,923,1736,728,965,1737,755,943,1641,688,953,1578,539,948,1576,410,1076
1306700MR4C,1899,669,1230,1918,687,1196,1889,669,1220,2275,872,1362,2164,875,1289,2273,891,1343,2278,950,1294,2161,849,1312,1948,652,1235,1927,529,1311
1306700PM02,2150,564,1586,2166,587,1557,2137,567,1570,2628,749,1825,2510,770,1740,2613,772,1793,2633,857,1747,2510,730,1780,2181,505,1600,2173,359,1739
1306700LM02,2672,743,1929,2699,761,1919,2651,734,1917,3560,1118,2377,3193,1013,2180,3514,1128,2312,3580,1227,2305,3192,994,2198,2927,685,2116,2872,549,2182
1306700VG02,3446,2215,1231,3489,2298,1150,3417,2221,1196,4444,2821,1512,4037,2656,1381,4420,2810,1489,4477,2962,1441,4036,2619,1417,3654,2243,1227,3581,1843,1534
1306700SN1A,1884,1448,436,1917,1497,395,1845,1441,404,2503,1873,559,2186,1709,477,2484,1854,546,2522,1931,554,2187,1700,487,2108,1536,471,2067,1349,579
1305900008C,1980,1424,556,2017,1471,526,1955,1414,541,2529,1759,691,2245,1666,579,2504,1735,687,2530,1805,675,2245,1650,595,2122,1412,590,2110,1229,747
1305900001C,1528,988,540,1549,1027,511,1507,1001,506,1833,1207,595,1687,1156,531,1826,1204,576,1837,1244,561,1691,1150,541,1486,905,500,1473,774,609
1305900004B,2558,1801,757,2599,1896,652,2543,1831,712,2760,1877,810,2363,1690,673,2733,1846,807,2767,1972,735,2365,1673,692,2858,1972,713,2868,1668,996
1305900002B,2182,1940,242,2266,2038,209,2116,1884,232,2657,2241,344,2386,2171,215,2636,2235,325,2694,2331,327,2382,2163,219,2351,2036,218,2192,1729,345
132830ANNEX,1183,109,1074,1226,111,1114,1190,111,1079,1418,132,1270,1323,169,1154,1395,125,1247,1440,133,1300,1320,167,1153,1323,146,1165,1197,121,1046
1328300SOPE,1308,638,670,1388,695,686,1302,644,658,1605,761,808,1390,682,708,1570,764,777,1637,819,801,1386,680,706,1380,716,644,1193,505,654
1328900SG/T,500,263,237,526,278,248,479,245,234,598,300,288,530,276,254,590,301,279,607,306,294,531,271,260,555,304,245,510,240,264
1304900004A,463,33,430,473,37,435,455,35,420,586,49,527,536,46,490,564,44,504,595,54,535,536,49,487,500,42,450,453,39,389
1304900004H,419,46,373,426,34,389,409,40,369,595,63,522,524,52,472,582,60,506,605,64,538,526,54,472,488,59,423,436,56,361
13263000006,281,110,171,285,106,175,272,102,170,340,140,193,325,131,194,341,139,195,345,144,200,326,131,195,293,121,166,261,100,147
130910YONKE,142,18,124,145,11,134,120,13,107,182,22,158,154,15,139,180,22,151,184,24,158,154,15,139,147,17,127,114,9,98
1331500004A,656,87,569,667,78,588,638,78,560,754,94,646,670,77,593,744,98,633,762,99,658,671,79,592,693,99,591,658,84,558
1331500002B,378,152,226,391,154,235,362,141,221,448,174,262,411,184,227,450,181,262,460,194,264,409,183,226,410,165,240,371,123,234
130750000EP,255,227,28,266,248,18,238,214,24,274,242,23,267,257,10,278,253,19,282,260,17,264,252,12,281,261,14,246,195,43
13263000001,367,211,156,380,212,163,348,187,161,439,245,184,425,247,178,444,249,188,447,256,189,424,248,176,404,230,171,382,207,168
13093000010,322,160,162,336,166,169,312,148,164,347,169,174,328,178,150,344,172,171,356,179,174,329,180,149,340,175,161,303,135,163
1300100005A,604,88,516,634,77,555,590,79,511,792,115,660,673,107,566,800,103,677,820,118,697,674,108,566,610,68,530,564,54,492
13303000091,629,215,414,656,227,427,614,214,400,740,245,479,681,239,442,743,247,483,755,252,494,679,234,445,663,231,423,606,191,402
1322900004A,716,100,616,726,104,620,696,96,600,945,118,817,822,115,707,928,123,786,955,131,821,822,118,704,747,115,623,691,88,589
13229000002,1613,173,1440,1637,155,1474,1566,163,1403,2177,214,1919,1924,198,1726,2146,197,1883,2209,226,1969,1924,199,1725,1774,188,1556,1645,178,1406
13319000007,458,215,243,478,219,258,436,198,238,547,225,309,500,222,278,544,227,311,556,233,317,496,216,280,485,228,255,452,189,249
13209000006,218,18,200,230,14,213,224,13,211,260,15,244,242,14,228,256,16,239,263,16,247,242,14,228,224,16,207,215,16,189
1315300CGTC,2801,1020,1781,2845,1016,1800,2741,997,1744,3646,1318,2250,3351,1308,2043,3613,1334,2211,3663,1374,2236,3351,1302,2049,2771,855,1820,2628,727,1795
13071000020,493,74,419,514,81,431,484,67,417,571,85,470,504,78,426,566,87,470,576,93,480,504,77,427,521,82,431,491,66,411
13033000004,257,147,110,261,152,109,239,134,105,309,189,113,281,177,104,304,184,115,307,189,116,284,179,105,280,180,97,257,151,102
13115000085,400,115,285,407,107,293,393,106,287,561,148,401,465,134,331,546,139,393,561,146,405,464,130,334,503,128,351,470,102,339
13115000030,2776,630,2146,2830,596,2215,2721,585,2136,3772,793,2913,3333,750,2583,3731,793,2867,3796,795,2964,3334,735,2599,3134,613,2444,2980,559,2321
13115000045,524,84,440,534,63,466,510,69,441,719,84,615,637,78,559,713,80,616,724,83,631,638,78,560,580,76,491,546,86,438
1322300002B,3406,534,2872,3452,515,2903,3350,516,2834,4775,828,3830,4195,793,3402,4750,846,3800,4815,871,3881,4194,775,3419,3812,698,3001,3649,577,2887
1322300009C,5488,2516,2972,5557,2530,2991,5364,2421,2943,6965,3293,3501,6135,3140,2995,6951,3336,3463,7015,3373,3561,6134,3122,3012,6050,2350,3532,5824,2056,3500
13115000015,1281,188,1093,1304,157,1135,1243,160,1083,1768,230,1504,1518,208,1310,1762,221,1506,1781,223,1543,1517,207,1310,1421,185,1196,1355,165,1123
13115000125,353,83,270,357,81,273,342,83,259,538,103,422,445,97,348,533,114,410,548,107,436,445,93,352,421,96,310,390,83,294
13275000118,1198,423,775,1221,436,778,1172,406,766,1610,599,964,1385,551,834,1586,594,948,1636,638,979,1387,557,830,1377,469,874,1286,392,865
13275000103,1860,579,1281,1901,584,1307,1795,540,1255,2558,792,1712,2257,729,1528,2506,791,1668,2584,847,1713,2255,740,1515,2051,652,1361,1917,554,1316
13303001350,480,205,275,506,212,292,476,200,276,570,230,331,541,242,299,563,236,320,575,246,327,539,238,301,507,218,284,465,182,275
13175000011,939,178,761,968,174,790,927,176,751,1172,243,913,1054,224,830,1169,250,907,1178,244,926,1055,223,832,1003,205,784,957,178,757
13229000001,1786,335,1451,1817,335,1476,1713,294,1419,2361,439,1889,2124,416,1708,2328,432,1862,2391,478,1898,2123,416,1707,1891,375,1491,1724,297,1381
13175000013,1117,151,966,1141,128,1004,1092,142,950,1358,183,1159,1221,176,1045,1340,191,1135,1363,188,1167,1221,174,1047,1133,150,975,1093,139,936
13175000019,542,91,451,554,81,473,530,88,442,685,111,563,604,99,505,673,109,554,692,104,583,604,97,507,571,87,475,550,78,462
1314100004B,246,164,82,252,173,78,237,160,77,287,188,96,276,191,85,286,193,91,287,192,93,275,191,84,266,177,85,245,154,84
1314100003C,182,80,102,183,80,103,170,74,96,216,86,128,205,84,121,215,85,128,219,88,130,205,83,122,170,77,89,162,65,93
13275000104,522,126,396,542,127,413,497,115,382,722,156,551,606,126,480,690,144,527,730,162,561,606,130,476,561,136,403,484,108,353
13275000102,919,424,495,944,439,501,881,392,489,1148,517,604,1009,487,522,1132,522,588,1168,552,606,1012,485,527,1058,501,552,944,421,499
13303001253,392,122,270,404,125,278,380,117,263,425,138,278,405,151,254,424,140,282,433,149,281,403,150,253,427,135,285,395,122,269
13015000001,3261,583,2678,3330,552,2745,3284,588,2696,4753,880,3734,3986,843,3143,4707,913,3663,4800,908,3819,3981,826,3155,3502,565,2838,3310,496,2625
13071000007,741,134,607,761,131,624,717,123,594,940,195,726,849,186,663,936,197,720,956,202,746,849,189,660,787,147,627,743,120,603
13071000014,918,125,793,942,117,822,906,116,790,1162,165,971,1012,145,867,1159,170,966,1172,187,971,1012,142,870,957,139,805,906,110,780
13177000002,564,232,332,585,245,334,529,209,320,670,267,392,630,266,364,668,260,400,679,270,407,632,267,365,626,268,350,583,221,346
13015000008,2719,635,2084,2763,606,2120,2731,615,2116,3736,830,2790,3197,772,2425,3707,842,2770,3771,851,2851,3195,754,2441,3064,601,2362,2925,560,2207
13045001152,1045,128,917,1055,103,946,1028,107,921,1352,146,1188,1223,143,1080,1345,161,1169,1361,163,1188,1223,141,1082,1081,128,930,1038,122,879
13045001542,1354,230,1124,1388,218,1159,1337,222,1115,1728,294,1389,1553,284,1269,1712,297,1378,1740,309,1401,1555,282,1273,1395,191,1158,1339,193,1080
13045001122,2186,628,1558,2227,605,1592,2145,591,1554,2829,746,2006,2457,702,1755,2822,757,2014,2851,765,2053,2459,692,1767,2275,578,1634,2168,536,1531
13045001240,1244,217,1027,1268,196,1055,1231,203,1028,1746,269,1441,1496,266,1230,1734,269,1424,1760,293,1452,1495,265,1230,1246,212,994,1180,204,923
13255000016,2157,1483,674,2238,1555,678,2074,1399,675,2576,1714,812,2340,1675,665,2573,1724,805,2622,1755,849,2335,1672,663,2382,1598,741,2174,1364,754
13255000012,1188,213,975,1210,196,1006,1176,204,972,1589,280,1279,1434,263,1171,1585,283,1266,1608,279,1306,1432,262,1170,1385,221,1134,1318,207,1051
13113000032,1202,346,856,1229,366,838,1200,352,848,1527,513,972,1455,500,955,1531,506,987,1548,554,967,1456,492,964,1391,370,941,1337,280,973
13161000401,510,105,405,536,106,428,512,103,409,647,152,485,558,122,436,630,128,487,658,152,503,558,123,435,572,106,454,524,106,400
1312100002A,2908,2281,627,2942,2391,518,2894,2295,599,4119,3143,893,3790,2992,798,4057,3078,870,4145,3329,754,3792,2962,830,2402,1814,455,2340,1496,701
131210004X1,920,886,34,946,926,16,887,848,39,1095,1015,54,1056,1021,35,1094,1022,41,1101,1035,61,1052,1015,37,971,923,28,909,803,82
1312100001S,793,746,47,820,797,21,762,731,31,986,913,54,928,897,31,986,914,45,994,928,56,928,892,36,836,801,25,783,685,80
13183000007,369,96,273,384,87,294,376,90,286,491,118,357,414,110,304,481,121,350,499,119,372,417,112,305,388,93,288,365,83,271
13021000VV3,1484,1372,112,1539,1433,96,1426,1314,112,1735,1534,159,1607,1493,114,1745,1577,144,1773,1601,153,1603,1485,118,1629,1485,126,1469,1261,175
13303000094,497,217,280,522,220,298,492,200,292,595,237,338,552,237,315,593,247,335,610,254,354,553,239,314,577,267,306,533,236,292
1312100012A,2647,2487,160,2731,2614,101,2554,2414,140,3248,2967,195,3160,3018,142,3255,2984,177,3280,3034,199,3158,3008,150,2565,2389,111,2456,2109,235
13319000006,534,78,456,544,60,481,524,72,452,643,95,537,548,85,463,638,97,526,648,89,549,548,84,464,550,55,490,519,52,453
13319000002,294,25,269,299,23,275,294,24,270,350,38,306,304,37,267,347,35,307,353,36,315,304,38,266,275,15,256,257,18,236
13209000004,334,27,307,344,24,320,335,23,312,403,38,360,377,32,345,400,29,362,408,35,369,377,33,344,345,33,307,318,24,289
1312100004J,311,302,9,317,311,6,309,302,7,191,174,10,146,143,3,195,180,10,196,183,9,146,143,3,421,412,5,403,370,15
13243000566,242,82,160,250,79,169,229,71,158,257,78,178,246,74,172,251,76,174,257,77,179,246,75,171,257,84,171,234,66,166
13243000954,166,107,59,172,110,62,162,103,59,183,125,57,170,119,51,185,123,61,189,125,63,170,120,50,167,112,55,151,91,58
13243000131,144,67,77,149,70,78,138,63,75,172,74,96,169,78,91,169,73,93,172,80,90,169,78,91,154,62,89,146,53,91
13011000012,401,52,349,403,39,356,394,43,351,494,54,432,438,54,384,489,51,425,495,53,438,439,54,385,399,48,343,389,46,327
13105000201,915,179,736,934,174,758,907,172,735,1206,232,954,1082,238,844,1193,226,952,1215,248,962,1083,241,842,997,211,768,920,194,696
13105000202,265,59,206,270,53,214,261,54,207,327,73,251,290,73,217,319,69,243,325,77,243,289,68,221,289,66,213,274,64,203
1315300HCTC,3241,1588,1653,3302,1582,1679,3161,1545,1616,3956,1937,1882,3360,1792,1568,3934,1954,1873,3992,2021,1908,3356,1792,1564,3414,1432,1848,3235,1220,1871
1315300TWPK,2749,1107,1642,2778,1102,1644,2674,1056,1618,3224,1284,1848,2921,1269,1652,3236,1320,1843,3255,1328,1868,2924,1268,1656,2963,1060,1797,2799,914,1778
1305900004A,996,757,239,1024,799,208,982,760,222,1314,929,338,1091,843,248,1312,930,343,1315,967,319,1091,839,252,1069,726,263,1051,627,347
131210005A1,1692,1520,172,1727,1582,128,1677,1517,160,2216,1938,228,2099,1901,198,2189,1910,225,2212,1973,208,2099,1886,213,1695,1465,147,1659,1290,237
1312100003D,390,367,23,401,387,12,376,358,18,458,411,29,418,404,14,452,418,23,463,433,29,415,400,15,407,391,10,371,340,24
131210EP02E,613,582,31,624,598,25,590,562,28,757,678,50,717,682,35,755,679,47,763,697,52,718,681,37,616,541,58,582,468,87
1312100011P,970,947,23,1018,1002,12,937,919,18,1120,1060,32,1021,1003,18,1115,1057,31,1135,1088,39,1019,1003,16,1045,1013,18,965,850,89
1312100011N,1323,1278,45,1353,1326,25,1275,1244,31,1505,1414,59,1441,1408,33,1519,1446,47,1522,1440,70,1438,1400,38,1434,1389,30,1358,1232,99
1312100SS16,1506,620,886,1525,681,819,1503,642,861,1749,779,946,1727,790,937,1751,784,938,1770,905,833,1727,767,960,1564,655,834,1565,388,1136
131210SS09A,2166,898,1268,2204,974,1204,2150,910,1240,2592,1130,1421,2534,1121,1413,2571,1162,1378,2607,1300,1273,2541,1102,1439,2183,969,1122,2166,662,1446
1312100008A,1914,877,1037,1945,942,975,1894,898,996,2400,1184,1176,2288,1159,1129,2373,1179,1152,2402,1306,1070,2294,1131,1163,1954,931,944,1942,662,1216
1312100RW02,2611,1218,1393,2667,1274,1346,2591,1194,1397,3310,1565,1663,3105,1557,1548,3256,1554,1603,3330,1737,1523,3108,1503,1605,2855,1232,1450,2794,907,1714
1312100RW04,1332,652,680,1348,667,650,1333,644,689,1546,809,697,1492,824,668,1533,812,678,1553,883,650,1491,809,682,1359,599,674,1327,472,783
131210EP03A,2447,2310,137,2514,2400,106,2392,2274,118,2863,2637,171,2728,2610,118,2861,2661,148,2886,2683,179,2728,2601,127,2785,2598,137,2631,2282,273
131210UC032,182,153,29,186,156,28,177,147,30,267,223,39,246,212,34,268,226,37,270,230,37,246,211,35,91,77,13,91,71,20
13015000002,1901,499,1402,1945,474,1440,1908,482,1426,2697,672,1926,2278,643,1635,2680,681,1909,2724,696,1997,2280,638,1642,2107,428,1605,1985,393,1458
1304900003B,230,15,215,231,11,219,224,14,210,347,25,318,282,18,264,339,21,311,355,21,332,284,20,264,290,17,272,255,22,224
13029000005,1426,559,867,1449,568,864,1404,559,845,2045,858,1118,1693,791,902,2025,838,1100,2072,888,1137,1694,795,899,1339,378,905,1280,307,914
1309900000A,559,300,259,573,304,265,534,273,261,663,354,302,600,341,259,650,342,292,666,369,294,600,344,256,648,352,293,628,312,306
1324300718A,1090,684,406,1137,721,409,1040,638,402,1323,699,605,1316,757,559,1336,724,591,1338,730,602,1314,754,560,1172,734,426,1031,571,439
13243000334,482,296,186,495,305,189,455,275,180,555,256,294,530,263,267,571,274,286,562,270,291,530,262,268,491,314,175,449,254,188
13243000998,76,9,67,81,9,72,79,9,70,64,28,36,58,29,29,52,20,32,65,30,35,57,28,29,86,12,74,80,10,70
13031000015,2331,1424,907,2379,1487,860,2291,1418,873,2752,1666,980,2068,1301,767,2730,1611,978,2786,1721,990,2073,1302,771,3279,1940,1106,3225,1717,1265
1315300HAFS,1077,243,834,1098,240,855,1056,231,825,1373,282,1074,1300,279,1021,1362,291,1057,1389,299,1083,1295,275,1020,1078,253,810,1019,217,763
13151000031,3800,2263,1537,3871,2294,1553,3680,2173,1507,4869,2922,1828,4283,2744,1539,4873,2958,1814,4910,2956,1887,4285,2744,1541,3947,2058,1771,3721,1828,1750
13033000009,507,202,305,530,200,330,493,188,305,641,244,391,571,228,343,639,262,369,653,257,392,573,226,347,583,238,337,534,209,317
13021000HA1,1689,1508,181,1725,1541,176,1598,1424,174,1898,1635,230,1715,1549,166,1905,1656,216,1929,1676,232,1713,1546,167,1798,1555,230,1667,1341,303
13021000HA3,3713,2705,1008,3776,2749,1013,3574,2608,966,4470,3217,1179,3992,3002,990,4477,3236,1170,4516,3284,1201,3991,2994,997,3857,2675,1108,3630,2397,1154
13021000VV6,1802,896,906,1842,923,899,1757,870,887,2130,1088,969,1961,1061,900,2123,1099,970,2156,1180,937,1959,1042,917,1867,833,944,1793,670,1063
13275000106,651,119,532,663,120,541,633,116,517,907,167,725,800,153,647,890,165,703,916,182,730,799,152,647,766,126,629,703,108,568
1312100CH02,194,74,120,202,79,121,192,71,121,248,97,147,240,98,142,248,99,144,250,96,151,240,98,142,222,93,126,207,80,119
1312100SC04,604,411,193,616,418,195,584,392,192,736,512,210,693,513,180,738,526,199,742,527,208,693,510,183,628,395,222,603,357,227
131210AP12C,988,434,554,1001,459,539,989,451,538,1751,719,996,1649,700,949,1725,720,969,1761,792,955,1648,686,962,858,353,472,836,272,525
131210AP01B,510,269,241,515,271,234,499,267,232,896,460,411,809,430,379,884,452,404,907,486,400,809,431,378,480,247,203,456,203,222
131210SC30B,516,503,13,530,519,10,504,491,13,596,556,20,559,551,8,601,573,20,603,575,22,562,553,9,591,570,10,559,506,33
131210SC14A,414,396,18,429,427,2,411,400,11,508,476,21,467,462,5,505,474,19,512,474,32,466,460,6,399,381,13,384,350,26
13123000005,1544,275,1269,1573,254,1308,1528,260,1268,2131,373,1702,1968,379,1589,2120,395,1681,2167,392,1748,1966,376,1590,1499,225,1235,1399,220,1109
13123000004,625,89,536,644,77,557,620,83,537,844,117,703,723,100,623,826,108,702,857,119,726,724,99,625,649,82,555,600,86,490
13123000011,702,87,615,719,76,642,690,79,611,944,125,799,832,129,703,939,122,798,956,138,811,832,128,704,751,78,647,706,83,588
13275000113,178,42,136,180,45,134,173,40,133,209,61,145,187,51,136,202,54,142,207,58,149,188,52,136,195,55,138,180,47,128
13303000099,373,104,269,379,96,281,368,104,264,424,112,307,397,109,288,422,113,301,427,111,312,399,107,292,374,101,271,357,94,256
13151000048,2868,762,2106,2902,754,2126,2810,731,2079,3642,1099,2470,3243,1065,2178,3622,1116,2432,3674,1150,2486,3235,1047,2188,2935,638,2227,2788,548,2132
13183000003,454,227,227,472,236,232,441,218,223,655,330,311,553,301,252,652,321,314,666,329,328,549,296,253,495,245,235,450,191,245
131210SS08D,834,540,294,846,562,276,822,534,288,1036,678,334,963,651,312,1034,684,323,1043,717,310,962,648,314,747,431,280,736,360,331
131210FA01A,2082,1865,217,2123,1906,207,2006,1800,206,2515,2185,273,2326,2110,216,2527,2214,267,2541,2223,300,2325,2100,225,2241,1925,277,2139,1728,350
131210SC07C,10,10,0,10,10,0,10,10,0,13,10,2,8,7,1,13,10,2,13,11,1,8,7,1,16,15,1,15,13,2
131210SC05A,400,389,11,409,405,4,387,381,6,476,454,11,449,442,7,480,467,7,478,459,16,449,442,7,446,424,9,423,385,23
1306500000F,146,19,127,150,18,131,136,15,121,189,21,165,156,18,138,183,16,163,192,22,169,156,18,138,173,15,157,143,16,119
13151000058,2005,505,1500,2046,508,1517,1969,488,1481,2649,748,1852,2295,753,1542,2631,739,1828,2671,784,1855,2293,747,1546,2128,485,1595,2022,423,1528
13151000062,1315,426,889,1328,427,891,1299,421,878,1644,656,951,1543,684,859,1641,679,943,1655,684,956,1542,677,865,1318,311,981,1268,273,940
13151000029,5147,3378,1769,5208,3424,1752,5030,3306,1724,6737,4586,2023,5983,4320,1663,6741,4625,1986,6803,4665,2064,5986,4300,1686,4950,2768,2055,4682,2444,2064
13151000044,2145,1454,691,2172,1490,663,2088,1428,660,2508,1701,753,2360,1681,679,2517,1724,750,2542,1733,773,2358,1676,682,2126,1301,784,2008,1148,815
13193000005,737,577,160,779,627,152,704,543,161,825,620,191,774,616,158,818,628,180,837,653,183,772,610,162,774,632,138,686,487,192
13193000003,797,497,300,819,519,297,763,466,297,901,526,363,858,522,336,896,532,354,909,544,360,855,519,336,842,531,304,776,427,334
13115000080,767,138,629,794,126,659,765,127,638,1187,207,940,979,184,795,1176,218,940,1201,216,977,978,185,793,978,168,789,906,170,695
13115000075,1983,894,1089,2023,898,1109,1936,858,1078,3184,1382,1707,2628,1261,1367,3161,1404,1664,3231,1476,1704,2624,1253,1371,2473,1005,1384,2310,823,1391
13311000051,2370,399,1971,2417,376,2022,2345,376,1969,3112,514,2524,2772,490,2282,3092,494,2550,3135,544,2549,2773,479,2294,2538,384,2084,2423,307,1989
13311000011,1406,262,1144,1426,236,1171,1396,252,1144,1790,339,1401,1611,334,1277,1775,329,1410,1796,359,1412,1611,329,1282,1447,232,1179,1402,214,1098
13311000061,1021,307,714,1033,287,735,1012,291,721,1235,329,879,1186,358,828,1227,332,868,1241,365,866,1189,347,842,1038,257,744,1007,235,724
13311000041,1665,180,1485,1681,150,1517,1630,165,1465,2238,244,1938,1990,236,1754,2237,248,1955,2260,253,1977,1988,231,1757,1747,183,1519,1679,170,1432
1300700000N,582,244,338,612,247,363,568,223,345,695,293,394,661,296,365,691,296,388,702,293,406,660,295,365,665,306,353,621,255,350
13295001053,177,26,151,180,25,155,167,24,143,238,33,202,214,28,186,219,27,190,246,37,207,214,29,185,185,26,156,168,25,137
13295000953,587,94,493,605,92,507,569,87,482,805,120,663,727,110,617,802,116,659,813,127,678,727,112,615,622,98,511,570,89,452
1312100002B,1248,1095,153,1264,1135,120,1222,1077,145,1425,1218,164,1249,1125,124,1417,1222,152,1431,1242,168,1247,1114,133,1258,1048,178,1220,918,238
1312100003I,545,452,93,563,483,64,550,464,86,658,545,99,514,439,75,633,500,93,664,559,89,514,429,85,863,657,123,868,547,253
1312100SC27,1226,1194,32,1255,1232,22,1169,1145,24,1397,1326,46,1343,1315,28,1404,1338,49,1414,1342,62,1344,1308,36,1327,1276,40,1259,1152,81
131210SC211,832,794,38,839,810,27,803,771,32,1280,1196,58,1167,1123,44,1278,1217,53,1283,1212,62,1166,1121,45,782,744,30,754,686,56
1312100003L,217,208,9,228,222,4,208,199,9,222,204,12,231,222,9,219,205,11,224,206,16,230,220,10,216,204,10,194,172,18
131210SC05D,1418,1367,51,1426,1384,36,1373,1330,43,1907,1817,62,1909,1856,53,1910,1821,66,1918,1829,80,1908,1855,53,1274,1149,105,1219,1062,134
131210SS13A,1057,540,517,1069,561,486,1048,532,516,1521,784,708,1425,764,661,1501,781,681,1530,855,653,1426,748,678,998,487,462,996,375,566
1312100009A,2104,1558,546,2149,1664,448,2052,1555,497,2752,2015,668,2558,1953,605,2706,1973,648,2756,2098,595,2558,1924,634,2107,1504,465,2081,1264,690
1312100SC10,649,628,21,661,648,10,618,602,16,810,757,37,759,744,15,813,765,30,822,768,49,759,741,18,825,784,27,782,700,58
1312100004L,840,799,41,863,836,21,817,784,33,981,902,49,940,905,35,980,905,46,995,929,60,938,901,37,792,740,28,758,657,54
1312100004T,557,537,20,583,573,8,536,524,12,686,645,23,649,629,20,688,647,24,690,643,40,649,625,24,555,540,9,501,458,33
1312100003A,662,641,21,690,677,10,621,605,16,810,755,38,776,754,22,814,779,27,825,777,41,773,751,22,790,763,22,736,646,75
1312100RW12,4148,1602,2546,4218,1692,2449,4116,1614,2502,5170,2210,2859,4946,2209,2737,5117,2203,2786,5185,2447,2667,4945,2153,2792,4374,1627,2555,4276,1213,2854
131210SS11A,2172,1274,898,2214,1324,850,2158,1270,888,2769,1691,1009,2519,1572,947,2734,1701,973,2768,1785,936,2519,1552,967,2421,1383,914,2380,1099,1150
131210SS08A,748,511,237,754,528,219,731,505,226,1303,892,385,1174,850,324,1290,879,380,1318,911,381,1173,831,342,807,502,266,767,399,340
13139000027,2377,284,2093,2432,259,2140,2364,266,2098,3031,359,2620,2797,356,2441,3031,349,2648,3042,407,2602,2801,347,2454,2487,257,2158,2395,211,2064
1310300003A,746,142,604,765,149,614,731,140,591,1018,178,819,907,174,733,1006,169,817,1032,184,840,907,174,733,749,162,569,698,136,545
1310300003C,1040,198,842,1059,208,841,1010,183,827,1447,328,1094,1255,288,967,1425,320,1078,1460,334,1109,1258,290,968,1070,226,824,1021,177,815
1310300002B,1619,378,1241,1649,372,1259,1577,352,1225,2087,539,1484,1842,510,1332,2068,537,1469,2106,549,1522,1846,507,1339,1755,356,1335,1663,319,1273
1310300002C,2310,589,1721,2355,582,1742,2249,553,1696,3365,934,2334,2977,865,2112,3323,895,2327,3396,931,2418,2982,869,2113,2159,463,1643,2099,381,1628
132050000BV,382,70,312,392,62,330,362,53,309,465,80,379,436,69,367,461,79,381,470,82,385,437,69,368,402,71,327,375,58,311
132050000PE,1631,790,841,1664,795,858,1549,728,821,2142,1034,1079,1836,937,899,2122,1038,1056,2170,1080,1080,1829,931,898,1814,907,879,1679,759,885
132050000HF,211,44,167,217,42,175,203,33,170,252,37,213,233,41,192,253,38,211,253,40,213,234,39,195,229,49,178,221,42,173
13169000006,842,236,606,857,230,623,824,222,602,1018,270,736,929,262,667,1022,278,732,1023,276,742,929,256,673,894,254,626,844,209,606
13245000709,353,161,192,357,166,187,345,162,183,403,195,199,379,192,187,406,194,198,412,211,194,380,194,186,341,160,169,330,138,181
13207000005,477,104,373,481,95,384,468,91,377,559,128,421,535,120,415,559,128,421,561,130,428,534,117,417,472,104,356,452,86,355
13245000507,479,368,111,483,376,104,463,359,104,640,471,152,570,443,127,637,467,150,646,487,147,568,445,123,479,318,136,444,269,153
1312100JC08,1836,924,912,1865,955,865,1814,907,907,2301,1185,1052,2128,1143,985,2259,1177,1004,2308,1267,1013,2130,1134,996,1946,872,964,1871,663,1109
1312100SS26,1790,1452,338,1817,1495,305,1726,1415,311,2194,1720,370,1873,1579,294,2179,1726,364,2214,1791,382,1872,1575,297,1902,1478,332,1822,1277,431
1312100008J,2176,1082,1094,2217,1224,955,2176,1133,1043,2643,1389,1207,2484,1367,1117,2597,1410,1132,2632,1630,955,2493,1299,1194,2022,1049,855,2072,668,1329
131210SC09C,825,804,21,841,820,20,794,770,24,1052,990,42,1000,967,33,1048,992,39,1064,998,54,995,959,36,886,836,37,836,738,73
1312100012S,915,883,32,957,936,18,873,847,26,1029,977,31,983,961,22,1029,982,23,1045,996,40,982,962,20,939,908,19,865,764,73
1312100001E,2360,2041,319,2405,2137,238,2336,2047,289,2730,2369,317,2683,2375,308,2731,2361,312,2759,2435,287,2679,2339,340,1881,1642,158,1821,1412,299
13245000603,1764,866,898,1806,876,908,1724,828,896,2227,1130,1043,2005,1072,933,2215,1138,1014,2249,1180,1037,2000,1066,934,1977,882,1049,1905,765,1076
13245000109,549,448,101,569,469,92,533,430,103,627,487,103,555,466,89,618,482,104,631,515,98,555,456,99,578,442,105,550,378,142
1312100002E,1404,1240,164,1423,1289,119,1392,1265,127,1615,1421,174,1546,1398,148,1609,1416,163,1622,1463,143,1544,1377,167,1429,1215,154,1399,1045,269
131210RW22A,2446,1511,935,2480,1545,900,2388,1467,921,3159,1934,1138,2849,1852,997,3135,1927,1107,3190,2040,1100,2850,1838,1012,2484,1401,940,2390,1171,1082
131210EP01B,1486,1372,114,1511,1413,90,1444,1344,100,1716,1540,124,1588,1489,99,1725,1559,139,1728,1566,144,1586,1488,98,1583,1401,144,1494,1224,210
1312100011R,641,620,21,671,661,8,611,592,19,844,794,29,787,778,9,841,793,26,854,809,37,783,774,9,791,768,16,708,639,54
1312100011J,997,959,38,1038,1013,23,967,938,29,1114,1038,45,1073,1049,24,1114,1064,34,1141,1093,38,1069,1043,26,1052,1016,30,962,879,68
1312100002S,418,384,34,427,397,24,417,389,28,495,443,41,452,414,38,493,430,42,502,450,43,452,412,40,437,394,30,416,344,43
131210ML06B,1699,1044,655,1723,1095,604,1661,1037,624,2215,1382,780,2011,1333,678,2179,1350,757,2225,1426,771,2010,1325,685,1827,1028,707,1752,823,828
131210AP07B,1119,495,624,1133,530,591,1099,482,617,1519,700,796,1430,696,734,1494,705,757,1525,763,751,1430,672,758,1107,460,601,1074,329,699
1312100JC06,1526,659,867,1553,689,845,1513,657,856,2034,996,1005,1917,957,960,2003,969,987,2055,1079,953,1920,944,976,1768,703,1011,1707,505,1133
13311000021,489,69,420,499,62,431,490,65,425,644,81,552,604,87,517,641,79,547,655,89,559,607,85,522,498,60,425,484,56,397
13311000111,960,81,879,976,72,896,956,81,875,1276,104,1139,1124,102,1022,1269,110,1138,1278,112,1152,1124,99,1025,1035,83,927,1006,93,870
13311000091,634,99,535,655,91,557,625,91,534,906,148,733,833,152,681,893,155,729,911,158,743,835,145,690,669,97,550,642,101,523
1312100006I,1949,1638,311,1976,1719,232,1926,1660,266,2536,2112,360,2206,1935,271,2503,2078,349,2547,2168,335,2205,1922,283,1789,1467,238,1748,1264,394
131210EP01A,1413,1260,153,1452,1309,135,1364,1229,135,1632,1436,148,1526,1408,118,1628,1436,148,1640,1453,167,1524,1401,123,1292,1141,119,1213,994,169
131210SC19A,126,121,5,128,125,3,122,119,3,142,133,8,135,129,6,142,134,7,142,134,7,135,129,6,117,113,3,114,99,10
131210SC09A,813,779,34,836,814,21,776,753,23,979,915,42,892,866,26,994,943,36,998,943,46,892,859,33,972,916,44,917,813,80
131210AP12A,364,236,128,374,243,126,355,228,127,505,304,188,432,282,150,505,308,173,511,320,185,431,282,149,413,257,141,384,203,153
1323900000G,817,366,451,866,375,484,775,328,447,1019,439,565,950,436,514,1012,444,552,1037,467,565,949,435,514,958,426,525,835,353,457
13039000010,621,283,338,633,290,336,609,273,336,961,376,524,729,321,408,945,359,517,978,387,555,729,324,405,844,346,450,792,302,422
13039000006,1252,339,913,1282,335,930,1236,317,919,1856,460,1325,1508,398,1110,1817,437,1296,1891,497,1355,1507,401,1106,1500,363,1090,1379,335,973
1307500000S,461,281,180,472,303,167,430,269,161,556,323,222,491,317,174,549,322,220,562,342,214,491,313,178,494,295,194,456,244,198
13107001560,921,321,600,954,334,616,888,302,586,1130,385,737,999,348,651,1106,381,706,1139,400,730,999,345,654,904,322,571,837,253,560
13207000009,2500,1429,1071,2568,1487,1066,2390,1337,1053,3059,1661,1341,2757,1607,1150,3042,1700,1292,3097,1732,1334,2754,1597,1157,2568,1486,1044,2395,1239,1090
13207000007,575,116,459,589,109,475,563,113,450,692,133,551,637,126,511,694,134,551,702,135,558,637,125,512,607,113,483,573,91,471
13245000808,1314,608,706,1337,611,722,1291,596,695,1682,823,830,1532,792,740,1676,823,829,1699,832,843,1533,795,738,1398,586,784,1323,518,779
13013000001,1615,371,1244,1644,340,1285,1577,347,1230,2311,538,1692,1970,496,1474,2273,545,1664,2328,560,1728,1970,487,1483,1777,365,1339,1685,329,1248
13013000013,1312,363,949,1337,354,957,1275,353,922,1782,616,1105,1487,566,921,1707,589,1079,1786,625,1133,1485,560,925,1388,329,978,1326,294,956
13245000404,963,852,111,978,872,100,924,816,108,1168,991,145,1024,914,110,1176,1018,140,1182,1030,142,1022,911,111,1049,910,118,961,771,168
13245000607,1002,949,53,1025,974,43,961,916,45,1222,1109,86,1134,1070,64,1229,1133,77,1235,1145,80,1134,1066,68,1109,1045,48,1040,930,86
13245000114,358,312,46,370,334,35,336,298,38,445,375,57,396,355,41,442,383,52,443,385,56,395,353,42,457,406,48,407,337,64
13245000203,452,443,9,474,467,5,428,420,8,528,496,21,484,477,7,528,501,18,543,526,11,483,475,8,562,551,10,472,432,31
13169000004,969,166,803,983,147,831,948,156,792,1143,188,929,1020,179,841,1132,189,924,1157,190,960,1020,178,842,936,147,770,895,123,751
13245000103,652,626,26,679,655,20,618,594,24,765,706,33,659,646,13,758,714,32,780,752,26,658,643,15,756,735,16,675,610,54
13013000006,1159,327,832,1177,310,858,1123,288,835,1518,528,944,1276,485,791,1504,525,935,1536,539,967,1275,480,795,1229,278,908,1181,235,886
13013000007,1655,528,1127,1688,531,1127,1612,504,1108,2254,633,1565,1993,607,1386,2244,633,1551,2269,657,1585,1995,595,1400,1594,490,1048,1534,423,1029
1310300003B,882,298,584,910,308,596,857,289,568,1144,391,728,1034,368,666,1135,400,716,1152,414,722,1034,364,670,901,336,541,846,262,551
13013000010,1366,639,727,1398,654,733,1329,615,714,2227,772,1382,1857,711,1146,2252,783,1394,2246,787,1414,1858,705,1153,1392,577,761,1317,491,746
13107000050,404,34,370,421,30,387,391,31,360,489,38,446,438,30,408,476,42,432,493,34,456,441,29,412,377,21,352,356,25,318
13107000057,285,64,221,300,67,230,280,60,220,365,78,285,335,84,251,362,82,275,373,86,287,336,85,251,321,90,230,301,75,219
130650000AG,178,27,151,180,27,153,172,26,146,258,42,212,209,30,179,250,39,202,259,39,220,210,32,178,204,40,162,185,33,147
13107001333,407,79,328,422,80,340,401,78,323,499,96,397,467,92,375,487,100,382,504,101,399,466,91,375,423,83,336,384,68,310
1300900CTY6,1371,646,725,1400,660,733,1329,634,695,1664,821,803,1516,797,719,1652,824,794,1674,859,793,1518,799,719,1459,669,757,1387,567,769
130810JAMES,816,75,741,823,64,756,807,65,742,940,98,838,891,96,795,934,96,831,943,108,832,891,97,794,828,79,736,805,67,714
1300900CTY2,421,275,146,437,302,132,413,276,137,483,312,153,426,305,121,477,310,152,490,331,153,422,300,122,502,303,178,458,243,191
13107001429,304,61,243,313,60,248,288,61,227,374,75,294,336,67,269,367,77,287,377,77,294,337,67,270,319,53,261,298,47,242
1310300004B,966,299,667,980,304,663,938,286,652,1258,409,825,1131,397,734,1257,401,827,1275,419,847,1131,398,733,965,306,636,904,252,622
1300900MERI,1793,645,1148,1823,658,1154,1755,641,1114,2204,789,1359,2068,797,1271,2195,800,1355,2223,831,1366,2064,790,1274,1717,604,1063,1628,507,1066
13031000005,1020,169,851,1047,154,885,997,164,833,1431,239,1166,1288,219,1069,1416,237,1158,1440,236,1193,1286,215,1071,1084,196,855,1042,168,826
13013000012,1440,297,1143,1465,291,1150,1400,280,1120,1886,412,1398,1590,386,1204,1847,409,1384,1909,440,1436,1591,378,1213,1630,287,1272,1562,269,1191
1310300001A,1053,191,862,1062,178,878,1036,185,851,1482,312,1122,1320,284,1036,1469,305,1126,1497,317,1168,1320,287,1033,988,149,811,954,133,788
13183000001,606,250,356,635,252,379,580,229,351,847,331,496,722,307,415,837,336,480,864,336,516,720,300,420,715,307,390,648,227,395
133070000P1,534,209,325,555,220,334,522,201,321,694,317,371,630,277,353,696,317,366,701,323,375,629,278,351,562,237,318,532,195,329
133070000P3,135,54,81,139,57,82,133,52,81,175,78,95,161,71,90,176,83,92,177,81,96,162,72,90,141,59,79,134,50,81
133070000G3,119,48,71,126,52,74,116,45,71,154,70,84,142,62,80,146,67,79,159,71,88,142,62,80,127,56,71,116,44,72
133070000W2,273,109,164,280,111,169,267,104,163,349,161,186,323,142,181,341,160,180,353,164,189,321,142,179,286,121,162,269,98,167
13297000250,2127,324,1803,2157,318,1825,2092,313,1779,2856,482,2318,2573,462,2111,2842,479,2314,2873,499,2348,2570,459,2111,2300,312,1937,2197,288,1788
13013000002,2114,430,1684,2142,407,1711,2079,409,1670,2750,499,2188,2444,481,1963,2720,501,2159,2780,530,2210,2443,468,1975,2259,423,1775,2185,364,1705
13139000011,2199,1123,1076,2257,1170,1076,2145,1084,1061,3475,1635,1732,2784,1475,1309,3446,1614,1741,3518,1688,1787,2783,1469,1314,2418,1138,1208,2236,981,1143
13277000008,703,152,551,733,152,578,695,133,562,841,179,653,768,176,592,837,192,633,851,207,640,767,179,588,731,162,554,687,130,533
132210000BV,1950,546,1404,1984,531,1429,1909,526,1383,2590,713,1807,2355,705,1650,2579,723,1805,2620,746,1835,2354,696,1658,2017,483,1471,1969,441,1460
13253000005,617,73,544,635,56,572,606,61,545,843,99,733,775,87,688,827,89,723,853,97,752,776,91,685,720,83,625,630,81,520
13253000002,595,196,399,613,197,414,581,190,391,740,232,495,665,232,433,722,226,476,751,257,492,663,233,430,732,232,490,651,187,444
1330500001A,785,78,707,811,63,745,768,67,701,988,90,882,902,88,814,966,85,873,997,89,906,902,86,816,815,72,731,756,64,673
1330500003B,625,56,569,639,53,584,616,54,562,813,79,718,735,70,665,803,71,718,820,78,737,736,75,661,646,54,580,597,45,535
13217000019,2536,1391,1145,2590,1415,1162,2476,1348,1128,3228,1804,1349,2878,1715,1163,3218,1815,1339,3261,1835,1395,2879,1709,1170,2794,1365,1357,2653,1229,1339
13217000008,1315,775,540,1341,776,543,1283,742,541,1753,966,725,1462,894,568,1728,966,712,1760,980,759,1461,887,574,1423,743,629,1361,683,609
13127002943,2851,830,2021,2911,866,2012,2822,834,1988,3419,1008,2347,3321,1006,2315,3373,963,2325,3440,1090,2312,3326,1001,2325,2873,860,1926,2719,609,2013
13199000010,799,410,389,830,403,420,761,363,398,960,440,499,871,416,455,951,437,497,973,459,513,871,417,454,845,420,418,769,334,416
13147000006,748,132,616,767,118,646,736,117,619,989,166,816,864,158,706,979,155,802,1005,180,816,864,161,703,790,144,637,739,139,575
13233000003,3011,972,2039,3081,943,2110,2890,876,2014,4114,1265,2736,3577,1204,2373,4069,1313,2666,4171,1333,2796,3576,1188,2388,3466,1055,2330,3256,894,2237
13233000005,1653,245,1408,1699,216,1474,1619,221,1398,2191,307,1842,1908,285,1623,2153,311,1809,2200,304,1888,1908,285,1623,1840,246,1553,1744,253,1423
13233000002,856,160,696,879,145,728,839,141,698,1150,185,941,991,174,817,1137,193,921,1163,187,966,990,172,818,972,162,790,924,156,733
13219000012,2960,940,2020,3018,974,2005,2949,944,2005,3668,1226,2355,3410,1238,2172,3619,1240,2313,3660,1338,2268,3410,1204,2206,2934,925,1883,2886,730,2023
13285000001,2250,480,1770,2278,482,1768,2226,462,1764,2733,630,2052,2507,641,1866,2710,653,2004,2750,707,1997,2507,621,1886,2464,585,1801,2413,468,1862
1310300004C,1387,203,1184,1403,186,1192,1355,191,1164,1948,330,1560,1673,308,1365,1928,313,1559,1962,313,1602,1673,317,1356,1457,190,1213,1381,162,1138
1312100008M,1326,476,850,1352,552,786,1318,488,830,1795,688,1087,1756,712,1044,1774,704,1050,1802,839,942,1760,663,1097,1294,558,693,1310,341,937
13219000005,1320,368,952,1344,381,952,1312,375,937,1631,464,1128,1529,473,1056,1609,468,1110,1632,519,1088,1529,459,1070,1314,319,931,1297,249,991
131450000SK,555,201,354,575,199,371,551,192,359,686,241,437,642,244,398,678,246,426,690,255,429,641,239,402,586,207,361,545,172,355
13291000005,361,75,286,376,63,309,362,68,294,464,87,366,438,84,354,469,92,371,476,93,381,438,81,357,417,86,316,399,71,308
13231000003,831,95,736,841,89,747,811,92,719,1018,108,894,916,98,818,1009,109,887,1018,103,907,918,97,821,866,90,766,830,76,731
1306300RD11,1006,941,65,1025,974,49,990,934,56,1180,1092,69,1159,1100,59,1179,1093,63,1182,1101,71,1157,1095,62,1058,990,60,1006,883,104
1306300JB13,1156,991,165,1176,1019,153,1116,969,147,1429,1208,199,1341,1184,157,1430,1206,196,1444,1219,216,1339,1180,159,1149,950,182,1078,850,195
13057000035,1502,236,1266,1521,218,1284,1479,231,1248,2031,319,1664,1881,301,1580,2017,317,1654,2044,324,1696,1880,301,1579,1562,204,1305,1501,169,1256
13129001064,385,93,292,395,83,305,387,83,304,491,87,393,450,85,365,481,89,386,499,93,403,449,87,362,403,80,315,375,78,282
13069000006,534,32,502,550,22,523,514,24,490,645,38,603,577,37,540,634,43,581,651,36,611,578,36,542,604,45,552,550,45,487
13057000006,2867,1226,1641,2910,1241,1623,2839,1224,1615,4128,1746,2243,3634,1672,1962,4096,1737,2216,4166,1816,2262,3637,1650,1987,3103,1068,1853,2995,922,1824
13057000040,1737,428,1309,1760,407,1331,1719,413,1306,2295,553,1657,2052,563,1489,2277,578,1636,2320,599,1677,2049,548,1501,1909,366,1441,1827,320,1366
13057000036,4319,1045,3274,4385,1054,3263,4277,1033,3244,6044,1567,4273,5370,1508,3862,5989,1570,4241,6087,1663,4326,5370,1468,3902,4579,939,3464,4386,777,3377
13057000034,1939,473,1466,1968,483,1448,1919,475,1444,2508,631,1819,2221,600,1621,2490,630,1786,2532,708,1786,2223,591,1632,2057,428,1550,2009,340,1577
13215FTBEN1,0,0,0,0,0,0,0,0,0,0,0,0,0,0,0,0,0,0,0,0,0,0,0,0,0,0,0,0,0,0
13227000001,2057,366,1691,2085,338,1731,2042,333,1709,2650,515,2080,2495,544,1951,2643,542,2055,2671,583,2061,2498,528,1970,2126,365,1725,2058,292,1677
1331700004B,526,206,320,553,208,343,500,180,320,670,245,418,608,233,375,654,236,406,676,252,417,607,232,375,585,229,351,519,188,326
1331700003B,397,143,254,411,142,264,390,131,259,472,155,307,426,148,278,462,153,303,472,155,311,425,145,280,421,143,269,389,120,258
1331700002B,394,95,299,410,96,311,392,96,296,458,125,327,423,120,303,452,127,321,462,132,328,421,118,303,383,95,285,351,72,272
13045000501,2044,801,1243,2076,805,1248,1992,762,1230,2675,1043,1549,2264,977,1287,2661,1054,1541,2701,1066,1585,2269,966,1303,2210,812,1324,2098,692,1308
130450714A4,1237,578,659,1253,608,640,1218,577,641,1277,549,704,1083,463,620,1271,548,690,1288,596,667,1085,454,631,1651,896,701,1606,757,776
132470000SP,2743,2054,689,2789,2092,678,2669,1990,679,3355,2554,735,3143,2495,648,3364,2552,750,3385,2600,759,3141,2490,651,2299,1626,622,2213,1500,643
13057000019,3737,969,2768,3801,993,2756,3695,955,2740,5882,1676,4039,5046,1568,3478,5791,1706,3959,5916,1813,4012,5047,1547,3500,3587,819,2600,3482,619,2691
13057000008,2876,584,2292,2927,603,2293,2874,600,2274,3660,876,2698,3386,885,2501,3650,877,2678,3693,958,2674,3387,860,2527,2989,557,2307,2912,432,2330
13057000030,1893,232,1661,1941,210,1708,1877,219,1658,2587,307,2213,2296,286,2010,2581,318,2216,2616,332,2237,2295,281,2014,1996,227,1708,1901,199,1614
13063000PH1,1833,1643,190,1864,1679,177,1788,1597,191,2045,1795,208,1989,1818,171,2058,1818,206,2062,1817,228,1989,1817,172,1802,1555,218,1711,1405,266
1306300JB07,1692,1367,325,1729,1407,315,1649,1338,311,1997,1586,376,1844,1540,304,1993,1597,352,2014,1618,379,1843,1531,312,1766,1394,329,1671,1252,373
1306300RD03,1726,1636,90,1753,1663,83,1684,1589,95,2170,1993,133,2029,1929,100,2187,2011,128,2197,2033,145,2033,1931,102,1790,1687,87,1676,1492,150
13231000002,1055,107,948,1075,91,973,1043,99,944,1382,107,1259,1264,106,1158,1366,109,1245,1398,113,1277,1266,107,1159,1118,97,1001,1071,89,943
13063000MO2,935,634,301,972,647,320,905,611,294,1254,799,420,1143,789,354,1251,788,420,1267,789,468,1143,788,355,1038,678,338,971,577,343
1306300JB10,1321,1194,127,1352,1224,122,1258,1135,123,1611,1391,184,1434,1308,126,1609,1396,175,1630,1397,209,1434,1301,133,1410,1230,158,1305,1072,187
1306300JB01,2368,2185,183,2405,2240,154,2288,2109,179,2822,2539,226,2607,2455,152,2842,2559,225,2856,2569,252,2607,2448,159,2424,2176,207,2283,1937,280
13057000014,493,50,443,507,39,464,492,44,448,678,61,608,613,55,558,677,62,606,686,64,616,616,54,562,482,46,424,461,50,391
131450000GM,982,427,555,1004,375,623,947,336,611,1186,430,731,1116,432,684,1179,434,729,1194,452,730,1114,423,691,1028,369,638,961,306,624
131450000WA,1613,581,1032,1651,553,1085,1582,516,1066,2116,691,1396,1884,644,1240,2099,700,1359,2140,731,1392,1884,638,1246,1767,609,1112,1649,506,1068
13129001056,2873,432,2441,2924,369,2537,2837,389,2448,3747,479,3186,3199,438,2761,3699,502,3132,3781,497,3246,3200,431,2769,3106,388,2625,2948,400,2433
13129000973,1454,249,1205,1485,236,1236,1440,242,1198,2038,320,1674,1755,294,1461,2009,323,1634,2056,332,1703,1755,295,1460,1583,256,1283,1476,237,1171
13129001063,528,54,474,549,43,504,525,46,479,726,80,632,654,80,574,721,78,628,735,84,644,653,81,572,558,63,488,524,55,447
1306300OAK1,1181,1145,36,1200,1167,29,1139,1100,39,1411,1311,58,1293,1268,25,1411,1326,61,1422,1332,76,1295,1266,29,1140,1089,36,1067,975,62
13063000FP2,1170,1007,163,1200,1034,160,1125,969,156,1463,1175,255,1319,1134,185,1463,1166,244,1484,1195,271,1316,1128,188,1163,955,184,1095,845,213
13155001753,210,45,165,216,41,174,209,43,166,528,94,429,480,88,392,525,91,429,530,97,430,480,86,394,418,104,310,390,85,300
131450000EL,2620,769,1851,2653,679,1953,2566,668,1898,3368,976,2324,3142,926,2216,3337,960,2331,3380,1018,2326,3143,926,2217,2780,701,2022,2662,595,1988
13255000011,1428,445,983,1457,447,1000,1411,422,989,1823,613,1177,1676,592,1084,1806,592,1184,1829,615,1195,1674,589,1085,1456,425,998,1393,377,974
13255000021,2869,1068,1801,2917,1043,1840,2834,1013,1821,3700,1379,2252,3564,1437,2127,3723,1445,2226,3758,1498,2234,3565,1417,2148,2707,931,1720,2534,772,1694
132470000MI,2043,1586,457,2070,1620,434,1967,1533,434,2620,2018,537,2358,1922,436,2615,2048,530,2642,2054,557,2356,1917,439,2105,1530,526,2025,1426,547
132470000RO,2567,1789,778,2623,1844,768,2511,1754,757,3159,2307,796,2950,2234,716,3164,2318,790,3201,2339,834,2953,2224,729,2633,1713,867,2521,1544,918
13255000007,1054,208,846,1076,199,863,1039,194,845,1306,302,972,1199,301,898,1293,314,951,1314,327,964,1202,298,904,1152,227,883,1109,187,862
13255000008,1086,275,811,1113,271,836,1062,262,800,1306,341,942,1186,344,842,1309,360,925,1317,362,939,1187,343,844,1159,267,867,1089,219,842
1306300RD01,1349,1239,110,1377,1272,100,1305,1206,99,1558,1414,111,1495,1406,89,1571,1422,105,1573,1440,124,1493,1400,93,1367,1241,107,1290,1110,150
13215FTBEN5,0,0,0,0,0,0,0,0,0,0,0,0,0,0,0,0,0,0,0,0,0,0,0,0,0,0,0,0,0,0
13215000108,3906,1150,2756,3954,1115,2810,3784,1068,2716,4949,1581,3286,4554,1499,3055,4934,1573,3254,4980,1676,3243,4555,1484,3071,4169,1129,2934,3970,924,2913
13069000003,199,59,140,207,52,155,185,44,141,250,58,186,235,66,169,245,62,177,253,60,190,234,63,171,202,50,151,179,43,132
133130000AN,866,422,444,909,446,455,837,409,428,1292,592,668,1062,519,543,1280,587,645,1324,618,694,1063,522,541,1044,471,541,913,370,492
133130000TI,353,54,299,364,50,312,345,48,297,509,83,408,447,73,374,502,82,406,512,76,429,447,71,376,428,65,355,382,64,299
133130000GL,1104,400,704,1141,410,720,1062,372,690,1613,583,984,1356,497,859,1570,544,967,1634,616,1004,1357,502,855,1310,466,810,1192,387,736
1305106-10C,2271,1210,1061,2307,1251,1039,2213,1205,1008,2941,1529,1356,2701,1452,1249,2934,1513,1360,2984,1557,1367,2700,1446,1254,2477,1202,1193,2342,1015,1247
1305101-05C,1329,805,524,1351,816,512,1310,791,519,1555,925,593,1450,896,554,1538,906,593,1576,949,595,1450,896,554,1383,735,559,1343,618,634
1305105-02C,335,301,34,344,313,30,319,289,30,400,347,46,374,339,35,400,344,47,411,350,51,373,334,39,402,360,34,363,294,54
13113000035,2003,1072,931,2035,1079,934,1976,1040,936,2532,1398,1092,2384,1408,976,2523,1397,1081,2557,1451,1082,2386,1384,1002,2095,1028,1004,2013,861,1061
13199000011,705,243,462,730,210,514,682,206,476,822,266,543,753,261,492,814,264,537,832,279,546,753,259,494,793,252,520,736,202,518
13127003743,1743,482,1261,1766,494,1261,1709,480,1229,2261,681,1527,2013,649,1364,2214,653,1501,2284,725,1530,2014,650,1364,1839,475,1328,1724,404,1260
13097001260,3017,711,2306,3061,698,2333,2983,701,2282,3913,1016,2812,3529,986,2543,3892,1033,2792,3937,1051,2838,3530,970,2560,3143,637,2411,3044,580,2342
133130000UT,521,67,454,543,71,467,503,71,432,788,110,659,712,95,617,768,94,650,794,104,683,713,97,616,581,67,501,516,66,430
133130000CA,820,137,683,849,134,711,800,137,663,1215,249,931,1030,205,825,1186,229,931,1228,240,980,1029,209,820,953,142,789,837,138,660
1331300001A,916,466,450,953,483,457,882,438,444,1327,640,645,1079,559,520,1313,629,639,1359,689,651,1080,562,518,1112,494,569,1028,429,540
131810001-B,428,244,184,440,256,181,415,234,181,496,292,202,454,272,182,507,296,201,514,309,204,455,274,181,484,299,181,452,254,189
13181000002,1021,250,771,1039,249,783,987,227,760,1183,282,880,1082,272,810,1162,277,864,1198,301,885,1082,270,812,1057,260,780,999,220,759
131810003-B,648,286,362,664,295,366,627,271,356,735,299,419,671,294,377,725,302,414,745,310,430,669,287,382,654,288,355,605,252,344
131810001-A,320,95,225,333,94,236,319,89,230,433,123,304,392,118,274,433,127,300,435,130,303,392,116,276,339,110,223,320,97,214
13095000019,375,266,109,383,270,110,364,257,107,410,288,117,403,288,115,411,289,118,414,290,119,403,288,115,465,309,149,434,274,150
13011000002,493,71,422,506,76,429,490,71,419,628,111,504,546,98,448,622,98,519,637,103,528,546,90,456,508,67,433,496,59,417
13095000020,1550,822,728,1582,839,736,1485,774,711,1766,890,847,1612,861,751,1758,897,841,1778,909,856,1612,861,751,1606,813,774,1495,725,733
13095000024,826,763,63,851,796,55,768,713,55,924,840,74,895,845,50,917,835,70,938,871,63,891,840,51,928,853,69,848,726,112
13011000009,399,39,360,404,39,364,390,38,352,482,50,418,414,56,358,477,57,414,488,53,432,414,52,362,422,48,368,405,43,344
13011000003,201,17,184,211,15,196,203,16,187,294,27,263,258,26,232,291,26,260,295,29,266,258,26,232,206,17,188,194,12,177
13105000196,267,70,197,275,71,200,263,68,195,352,78,267,324,78,246,347,78,266,355,83,271,324,80,244,303,93,204,286,81,189
13095000023,1082,740,342,1121,751,362,1033,679,354,1321,849,450,1207,837,370,1324,853,450,1343,878,457,1204,836,368,1188,777,396,1125,691,422
13095000022,1173,1022,151,1206,1065,138,1110,966,144,1396,1176,200,1206,1058,148,1395,1188,181,1413,1223,183,1208,1058,150,1374,1204,158,1271,1031,223
132470000FS,2275,1745,530,2326,1798,515,2239,1725,514,2759,2146,571,2520,2037,483,2751,2151,563,2787,2198,571,2514,2029,485,2425,1739,641,2324,1546,717
132470000LO,2536,1403,1133,2569,1437,1117,2493,1388,1105,3007,1772,1200,2834,1735,1099,2997,1769,1187,3019,1798,1200,2833,1730,1103,2654,1354,1239,2562,1241,1244
13255000004,1776,390,1386,1802,395,1376,1754,383,1371,2111,534,1532,1927,526,1401,2097,540,1504,2120,575,1516,1933,517,1416,1823,372,1374,1762,277,1400
13061000003,187,140,47,195,151,44,183,139,44,238,177,59,223,173,50,241,177,61,242,187,55,223,174,49,220,171,46,198,143,54
13061000002,204,131,73,212,138,73,202,131,71,245,160,79,208,140,68,253,166,83,249,165,82,208,141,67,231,153,77,210,129,76
130890000HB,2039,1497,542,2066,1540,500,2006,1485,521,2684,1953,670,2499,1888,611,2663,1958,649,2698,2034,624,2498,1866,632,2089,1486,523,2032,1287,636
130890000LA,2548,1585,963,2599,1656,918,2548,1604,944,2624,1647,923,2553,1657,896,2610,1658,902,2633,1765,819,2558,1623,935,2581,1589,881,2575,1296,1158
13135000139,2597,2050,547,2648,2109,512,2514,1990,524,3577,2636,845,3126,2482,644,3454,2558,805,3617,2690,892,3134,2493,641,2803,2107,614,2605,1842,677
13135000013,1950,528,1422,1977,578,1378,1931,533,1398,2486,790,1639,2291,788,1503,2440,798,1589,2501,891,1570,2292,764,1528,2084,497,1509,2023,399,1544
130890000SH,1501,854,647,1517,865,638,1485,840,645,1740,1033,672,1655,1024,631,1740,1042,669,1752,1058,672,1660,1021,639,1538,813,679,1531,687,767
130890000HG,1261,747,514,1287,767,509,1255,748,507,1428,873,526,1402,890,512,1436,885,518,1453,910,516,1403,882,521,1329,721,558,1309,611,650
130890000FK,1169,1131,38,1199,1169,27,1129,1097,32,1344,1271,55,1298,1270,28,1360,1281,59,1374,1292,71,1296,1263,33,1192,1152,30,1145,1044,71
130890000CG,1907,1844,63,1949,1910,36,1845,1797,48,2243,2122,75,2157,2112,45,2243,2144,66,2260,2161,79,2156,2107,49,1985,1913,49,1900,1727,129
130890000MI,2049,1996,53,2089,2065,19,1972,1936,36,2513,2383,86,2346,2305,41,2527,2407,82,2537,2424,96,2343,2301,42,2098,2033,37,1985,1843,103
130890000MF,1486,1451,35,1506,1478,27,1413,1382,31,1724,1645,55,1667,1636,31,1736,1670,46,1750,1673,63,1666,1631,35,1430,1376,39,1367,1268,76
130890000MV,1314,1264,50,1343,1305,37,1269,1229,40,1471,1383,64,1409,1364,45,1485,1395,69,1490,1404,75,1408,1355,53,1389,1330,47,1332,1214,93
130890000FJ,1129,1096,33,1165,1145,16,1086,1060,26,1349,1275,40,1272,1250,22,1355,1295,34,1364,1300,56,1272,1249,23,1150,1099,26,1078,955,86
13135000085,2389,1167,1222,2418,1175,1211,2341,1127,1214,3157,1632,1426,2796,1543,1253,3086,1599,1405,3173,1692,1429,2798,1522,1276,2613,1072,1423,2495,906,1444
13135000151,1613,622,991,1632,615,994,1590,610,980,2246,1031,1162,2044,986,1058,2208,1031,1126,2252,1069,1160,2044,979,1065,1602,468,1076,1535,420,1047
13135000018,1575,1084,491,1608,1109,485,1535,1057,478,2085,1356,669,1788,1248,540,2036,1326,642,2103,1392,691,1790,1248,542,1809,1161,593,1695,984,626
13135000108,1693,975,718,1722,978,730,1638,926,712,2263,1379,819,2037,1321,716,2222,1380,796,2292,1425,839,2037,1318,719,1814,865,892,1727,747,875
13135000145,3240,2103,1137,3282,2128,1132,3162,2036,1126,4573,3126,1326,4203,3072,1131,4492,3122,1292,4590,3215,1332,4201,3056,1145,3051,1640,1325,2904,1450,1356
13135000015,1624,880,744,1666,899,751,1570,845,725,2243,1258,917,2051,1240,811,2199,1244,897,2279,1313,941,2054,1230,824,2013,1052,891,1892,908,900
130890000LH,1640,1601,39,1667,1644,20,1577,1541,36,2027,1918,58,1870,1836,34,2046,1949,62,2060,1955,80,1871,1834,37,1659,1606,33,1569,1456,73
130890000SC,1419,1287,132,1453,1335,105,1380,1266,114,1811,1594,164,1743,1616,127,1828,1633,161,1840,1647,171,1740,1604,136,1384,1154,166,1326,994,238
1311100NOON,552,102,450,569,101,463,551,96,455,654,128,519,632,127,505,661,127,530,663,138,524,632,124,508,539,94,443,518,79,422
13147000004,584,227,357,599,230,365,563,208,355,835,319,503,739,307,432,815,321,486,849,345,499,738,304,434,707,306,385,640,255,365
13077000020,1180,302,878,1201,303,871,1162,300,862,1512,427,1047,1376,438,938,1517,438,1040,1532,478,1028,1380,423,957,1242,306,878,1207,231,895
13077000022,2623,813,1810,2650,821,1800,2559,785,1774,3521,1135,2291,3210,1117,2093,3499,1161,2255,3560,1225,2282,3211,1102,2109,2671,748,1824,2556,621,1825
13157003000,7820,1312,6508,7925,1237,6597,7700,1243,6457,11595,2146,9160,10147,2059,8088,11503,2194,9083,11693,2283,9239,10150,2011,8139,7805,1079,6500,7543,926,6249
1306300JB09,552,447,105,564,458,104,534,433,101,770,614,130,684,567,117,780,616,137,788,622,154,682,567,115,617,472,132,571,418,133
13063000EW1,3685,3470,215,3738,3542,186,3586,3379,207,4442,4078,279,4252,4048,204,4469,4136,254,4496,4173,288,4250,4046,204,3452,3174,219,3299,2920,321
133130000CO,710,128,582,730,124,599,707,124,583,1013,170,819,872,158,714,1006,165,819,1030,177,844,875,158,717,804,140,647,760,127,596
13213001291,1349,175,1174,1392,158,1224,1318,160,1158,1955,239,1671,1724,205,1519,1920,207,1661,1996,227,1757,1725,210,1515,1626,214,1368,1430,221,1168
1306300JB18,1555,1383,172,1580,1407,168,1501,1339,162,1867,1590,237,1706,1527,179,1866,1599,228,1886,1621,253,1704,1523,181,1593,1345,207,1496,1202,246
1306300RD04,1800,1629,171,1845,1693,144,1737,1589,148,2266,1985,219,2086,1920,166,2279,2029,203,2305,2058,225,2080,1906,174,1964,1750,193,1810,1515,253
13231000001,894,178,716,917,187,728,881,166,715,1132,237,886,1017,212,805,1118,237,868,1133,246,881,1016,213,803,886,183,690,844,153,665
1306300OAK3,1699,1639,60,1737,1687,46,1634,1584,50,2129,1974,109,1907,1841,66,2142,1997,94,2148,2013,118,1904,1834,70,1784,1689,67,1680,1515,130
13045000682,1112,166,946,1131,147,977,1088,146,942,1457,212,1211,1287,203,1084,1447,215,1213,1461,204,1239,1287,200,1087,1183,150,1007,1127,154,926
13163000083,1072,740,332,1123,790,329,1041,728,313,1218,831,367,1116,784,332,1198,823,361,1232,854,371,1116,783,333,1177,849,318,1045,701,326
13063000FP5,1476,1225,251,1500,1257,232,1421,1183,238,1876,1481,356,1592,1360,232,1861,1466,334,1903,1507,383,1590,1354,236,1562,1263,265,1442,1106,293
13213000874,1077,120,957,1122,110,1004,1057,114,943,1514,174,1315,1340,157,1183,1471,152,1296,1530,164,1358,1341,161,1180,1247,134,1084,1109,140,922
13231000008,1291,302,989,1308,287,1012,1265,273,992,1631,336,1260,1460,329,1131,1627,341,1251,1642,355,1268,1458,324,1134,1360,310,1016,1294,258,983
13231000006,702,87,615,713,82,625,695,83,612,879,99,763,776,105,671,876,110,756,882,104,771,778,105,673,738,88,635,713,79,613
13113000030,2074,968,1106,2105,969,1116,2044,943,1101,2489,1228,1215,2332,1223,1109,2483,1250,1187,2515,1290,1189,2332,1220,1112,2166,883,1215,2073,775,1225
13097000730,2543,1645,898,2597,1696,877,2478,1611,867,3274,2157,1010,2927,2097,830,3269,2226,979,3309,2249,1014,2930,2089,841,2777,1618,1076,2683,1477,1111
13097000737,2190,1594,596,2224,1615,598,2123,1533,590,2753,2033,651,2497,1935,562,2753,2054,633,2780,2065,677,2493,1922,571,2215,1469,690,2144,1338,733
13097000740,1627,890,737,1650,913,721,1596,878,718,1882,1119,735,1772,1095,677,1871,1117,709,1892,1143,729,1769,1088,681,1665,823,804,1621,709,874
13135000049,1109,616,493,1132,613,499,1077,594,483,1404,810,551,1271,793,478,1373,802,533,1409,837,548,1273,792,481,1184,588,537,1141,502,565
13135000122,3110,2497,613,3165,2568,580,3041,2438,603,4006,3214,708,3710,3089,621,3938,3179,683,4027,3274,718,3710,3069,641,3187,2433,678,3019,2205,713
13135000086,1189,904,285,1209,921,281,1150,872,278,1485,1043,393,1284,984,300,1465,1042,369,1515,1076,421,1284,982,302,1270,917,308,1187,802,324
130890000CA,1097,1048,49,1128,1089,37,1058,1016,42,1331,1247,58,1271,1238,33,1347,1281,50,1351,1280,61,1272,1233,39,1199,1146,37,1129,1013,86
130890000OK,2093,1857,236,2142,1940,178,2089,1883,206,2293,2035,215,2245,2046,199,2295,2042,207,2303,2109,166,2246,2017,229,2149,1872,192,2104,1642,353
130890000PG,1745,1523,222,1778,1578,182,1712,1512,200,2864,2523,304,2666,2393,273,2839,2514,281,2940,2640,276,2666,2388,278,1700,1474,174,1640,1245,332
130890000LE,2211,1819,392,2245,1903,310,2211,1847,364,2439,2026,377,2354,2010,344,2430,2008,360,2443,2100,310,2354,1984,370,2193,1790,305,2187,1539,535
13287000001,1925,1003,922,1991,1062,919,1776,898,878,2236,1146,1045,2041,1130,911,2219,1153,1015,2269,1217,1025,2041,1128,913,2035,1081,920,1843,874,928
130890000IB,835,728,107,866,763,98,804,694,110,1229,992,204,1090,953,137,1214,972,192,1241,1005,215,1086,950,136,893,744,120,830,637,149
13061000001,207,71,136,207,74,131,202,71,131,248,83,159,236,89,147,240,84,146,249,89,157,236,88,148,215,76,137,205,66,136
1306700PS1A,2738,1899,839,2768,1926,821,2679,1852,827,3601,2495,1001,3359,2488,871,3602,2531,998,3635,2599,991,3362,2491,871,2679,1654,938,2601,1468,1014
1306700PS3A,2119,1546,573,2151,1552,574,2060,1496,564,2715,1945,703,2509,1903,606,2713,1965,692,2736,1972,731,2503,1900,603,2130,1450,624,2040,1302,648
1306700KE4A,2228,1118,1110,2261,1135,1088,2210,1102,1108,2671,1318,1274,2371,1269,1102,2679,1336,1255,2699,1396,1251,2370,1261,1109,2506,1107,1265,2423,932,1339
1306700KE5A,3164,1700,1464,3207,1749,1417,3127,1687,1440,4475,2404,1954,4034,2309,1725,4435,2400,1910,4508,2509,1936,4032,2274,1758,3509,1620,1694,3389,1342,1847
1306700SI01,1238,503,735,1257,542,703,1235,516,719,1502,687,779,1427,688,739,1485,678,776,1516,756,738,1431,670,761,1363,537,768,1350,399,899
1306700FP01,2218,930,1288,2253,993,1224,2195,941,1254,2849,1280,1485,2672,1252,1420,2821,1255,1480,2848,1374,1436,2675,1219,1456,2402,986,1281,2380,743,1501
13227000005,342,32,310,354,24,326,335,34,301,484,44,423,414,43,371,476,38,426,486,38,442,410,40,370,377,24,343,364,27,315
13227000009,1439,165,1274,1466,143,1307,1418,155,1263,1881,223,1608,1605,193,1412,1874,224,1611,1905,224,1654,1608,188,1420,1574,174,1358,1496,156,1269
1306700SO03,1800,671,1129,1823,722,1089,1800,683,1117,2300,967,1300,2171,928,1243,2281,956,1284,2323,1089,1213,2170,896,1274,2037,723,1228,2017,524,1403
1306700ME01,2139,1256,883,2167,1265,886,2097,1230,867,2665,1587,1030,2493,1575,918,2655,1595,1015,2683,1621,1044,2491,1568,923,2198,1133,1015,2094,999,1017
1306700PS2A,1852,1483,369,1878,1519,352,1788,1438,350,2290,1755,459,2082,1700,382,2291,1779,441,2318,1814,468,2082,1698,384,1952,1469,421,1863,1310,488
13073000040,945,210,735,960,198,755,927,189,738,1225,269,940,1126,260,866,1214,262,940,1235,277,947,1126,258,868,898,208,673,837,166,644
13073000051,653,65,588,662,67,589,638,66,572,821,90,718,769,93,676,820,93,718,824,99,720,769,93,676,655,68,576,626,64,543
13265000172,165,102,63,180,110,69,161,95,66,180,106,72,171,104,67,181,110,68,189,114,71,170,105,65,194,114,80,168,87,80
132710000SC,199,42,157,205,37,166,188,36,152,245,46,192,208,46,162,238,52,183,253,54,199,208,46,162,208,45,158,200,34,159
13267000010,412,150,262,425,144,277,391,131,260,548,174,360,460,152,308,532,171,339,556,182,370,460,154,306,452,137,307,407,119,276
13321000004,496,81,415,502,81,419,476,71,405,575,111,457,532,99,433,568,108,452,577,113,462,532,101,431,512,91,418,488,92,385
13163000076,265,118,147,269,116,151,259,116,143,306,110,189,285,110,175,306,117,185,305,116,186,284,111,173,230,104,124,210,82,120
13163001593,240,38,202,255,36,219,237,35,202,280,45,232,262,48,214,275,46,224,285,51,234,261,49,212,248,34,209,226,32,188
13297001675,701,93,608,713,85,624,688,86,602,1004,121,871,939,133,806,999,122,866,1013,132,874,939,131,808,729,103,612,690,93,583
13215000114,2203,2034,169,2243,2090,149,2077,1918,159,2782,2508,236,2560,2379,181,2784,2506,231,2811,2567,227,2560,2378,182,2382,2169,179,2191,1893,247
13135000156,2562,1723,839,2616,1769,830,2488,1653,835,3241,2232,932,2993,2179,814,3192,2218,921,3259,2274,960,2987,2168,819,2603,1577,954,2463,1386,987
13135000134,2614,1739,875,2657,1765,863,2569,1698,871,3390,2303,994,3156,2305,851,3316,2256,987,3413,2354,1003,3159,2292,867,2630,1575,990,2476,1374,1022
13135000036,1898,934,964,1920,956,938,1874,927,947,2368,1230,1066,2157,1186,971,2312,1209,1049,2373,1287,1041,2156,1160,996,1959,869,1010,1920,698,1117
1313100000B,456,67,389,460,62,396,447,68,379,618,110,500,536,91,445,611,103,499,619,104,513,537,90,447,500,79,416,471,70,389
13217000015,991,124,867,1010,110,894,984,113,871,1222,140,1068,1093,131,962,1209,145,1046,1222,145,1066,1091,122,969,1010,114,877,975,115,833
13217000016,509,94,415,518,96,422,492,85,407,614,112,491,575,106,469,610,108,488,616,109,494,574,107,467,546,105,425,523,88,417
13199000008,806,305,501,821,299,520,787,289,498,1091,368,704,1031,366,665,1087,379,699,1106,377,723,1031,364,667,874,322,535,810,269,519
1306700DL01,2062,1039,1023,2092,1076,986,2040,1032,1008,2495,1315,1124,2298,1291,1007,2491,1325,1105,2510,1385,1071,2301,1264,1037,2154,976,1060,2128,811,1197
1306700MT03,2132,898,1234,2161,955,1168,2127,920,1207,2665,1223,1393,2522,1192,1330,2634,1226,1364,2681,1344,1299,2526,1161,1365,2219,961,1184,2173,642,1459
13321000006,599,125,474,613,125,481,586,119,467,739,153,567,656,155,501,733,149,573,743,152,585,658,155,503,666,135,523,637,126,498
132710000MC,1290,552,738,1343,574,759,1263,522,741,1576,694,867,1465,641,824,1561,694,851,1617,715,893,1466,643,823,1388,612,762,1281,504,754
13063000LC1,1262,1105,157,1301,1154,146,1228,1079,149,1667,1398,219,1537,1363,174,1673,1412,208,1704,1443,248,1538,1366,172,1361,1178,154,1264,1040,186
13135000155,2142,1095,1047,2162,1134,985,2122,1113,1009,2948,1590,1282,2675,1520,1155,2866,1547,1235,2959,1676,1233,2676,1506,1170,2197,985,1103,2111,790,1230
13135000140,2395,739,1656,2424,778,1607,2389,770,1619,3111,1093,1955,2935,1073,1862,3065,1095,1909,3123,1203,1876,2939,1046,1893,2444,724,1634,2394,534,1768
13073000010,1731,218,1513,1762,205,1541,1722,207,1515,2142,290,1817,1953,266,1687,2122,271,1815,2153,302,1827,1953,262,1691,1792,183,1561,1713,157,1509
13127005913,1122,659,463,1147,688,453,1087,642,445,1400,817,542,1204,730,474,1379,794,530,1424,855,551,1203,726,477,1237,722,487,1125,599,489
1306700RM01,2136,875,1261,2171,916,1223,2126,877,1249,2702,1135,1503,2499,1136,1363,2679,1141,1459,2721,1234,1441,2498,1105,1393,2348,854,1383,2309,661,1514
130890000FB,1710,1311,399,1740,1390,328,1697,1328,369,1876,1447,414,1860,1470,390,1866,1463,384,1889,1523,340,1861,1447,414,1715,1329,322,1691,1123,515
130890000EE,2999,2600,399,3048,2727,290,2996,2650,346,3436,3030,357,3370,3009,361,3443,3029,343,3462,3123,300,3375,2988,387,2982,2588,279,2952,2260,558
13135000146,3656,1835,1821,3684,1860,1800,3571,1788,1783,5267,2946,2213,4811,2819,1992,5201,2911,2184,5310,3025,2229,4810,2820,1990,3493,1296,2090,3372,1147,2062
13135000023,906,723,183,939,743,182,882,709,173,1257,910,300,1099,877,222,1226,904,278,1277,935,327,1102,880,222,958,729,190,888,642,200
13135000070,2244,957,1287,2281,992,1252,2200,954,1246,2963,1371,1508,2670,1320,1350,2910,1347,1491,2980,1443,1478,2668,1293,1375,2472,933,1419,2390,739,1519
13135000091,2686,1376,1310,2733,1415,1289,2626,1350,1276,3421,1857,1483,3109,1821,1288,3374,1845,1447,3455,1922,1481,3108,1807,1301,2889,1262,1547,2782,1067,1594
13135000060,2160,1694,466,2208,1743,440,2066,1627,439,2746,2047,613,2356,1878,478,2673,2033,570,2771,2110,624,2356,1875,481,2380,1761,550,2214,1526,581
13135000144,3270,2622,648,3326,2685,610,3106,2498,608,4757,3553,1062,4113,3382,731,4671,3556,1022,4811,3642,1111,4114,3379,735,3161,2372,696,2924,2039,752
13135000019,1362,801,561,1391,828,552,1343,793,550,1776,1065,669,1598,1015,583,1754,1055,657,1800,1092,682,1599,1014,585,1484,818,611,1421,694,656
13135000081,2332,1359,973,2369,1379,955,2269,1328,941,2984,1780,1120,2743,1743,1000,2923,1756,1107,3009,1840,1126,2739,1730,1009,2492,1343,1075,2400,1193,1115
13083001885,365,53,312,376,48,323,364,51,313,468,67,390,430,55,375,460,52,392,480,60,414,431,58,373,406,45,348,374,48,300
13293000470,265,67,198,272,66,204,256,62,194,328,80,244,297,77,220,329,76,244,331,80,249,297,77,220,279,70,206,260,58,195
13293000588,576,151,425,584,146,435,563,141,422,699,167,523,633,164,469,698,170,519,706,170,534,632,163,469,607,153,445,569,132,418
13143000013,566,70,496,584,54,523,561,66,495,783,82,687,692,67,625,772,74,685,791,79,708,692,64,628,620,75,529,599,88,474
13321000015,839,87,752,863,79,782,824,67,757,1009,124,873,913,129,784,995,123,859,1015,126,879,911,124,787,912,94,806,882,90,771
13321000014,391,70,321,396,63,332,378,59,319,493,86,395,426,81,345,490,87,397,498,83,415,426,78,348,431,64,358,395,70,318
13321000008,132,44,88,139,51,87,128,42,86,151,47,103,130,36,94,151,46,104,152,47,104,130,36,94,137,45,91,136,46,87
13135000031,1698,726,972,1739,758,949,1675,733,942,2280,1005,1193,2024,975,1049,2231,994,1171,2281,1058,1192,2023,953,1070,1911,706,1107,1835,594,1130
130890000RE,1542,1410,132,1581,1457,119,1500,1374,126,1894,1701,150,1759,1643,116,1889,1701,142,1907,1730,164,1761,1642,119,1711,1528,138,1608,1360,186
130890000SP,1368,1245,123,1399,1267,125,1318,1190,128,1693,1474,176,1577,1432,145,1694,1480,168,1709,1502,184,1575,1427,148,1410,1219,155,1324,1079,188
130890000EC,1011,626,385,1027,637,367,999,629,370,1370,874,464,1294,877,417,1366,862,443,1377,917,434,1296,872,424,1132,651,419,1116,549,495
130890000TF,2463,1468,995,2528,1518,974,2454,1474,980,2133,1453,643,2031,1442,589,2138,1465,630,2152,1521,609,2036,1430,606,2391,1290,967,2348,1095,1100
130890000LV,1002,591,411,1019,612,385,989,590,399,1129,683,426,1094,683,411,1119,678,413,1126,719,391,1092,676,416,1028,559,432,1017,435,530
130890000ML,1789,1724,65,1849,1794,45,1735,1665,70,2064,1931,86,2011,1950,61,2084,1958,82,2083,1959,102,2009,1944,65,1861,1753,66,1757,1536,148
130890000GC,1945,1837,108,1984,1908,64,1879,1793,86,2291,2135,104,2186,2097,89,2295,2127,102,2324,2181,115,2187,2091,96,1916,1760,99,1792,1505,194
130890000LB,1414,1026,388,1429,1067,342,1407,1055,352,1726,1223,472,1678,1209,469,1723,1243,451,1729,1275,432,1675,1202,473,1466,1014,394,1438,820,545
130890000ER,910,769,141,938,813,116,915,784,131,1335,1155,164,1243,1088,155,1314,1116,168,1359,1206,148,1245,1088,157,817,674,124,793,553,207
130890000CX,1864,1081,783,1896,1151,707,1845,1093,752,2512,1524,930,2357,1498,859,2477,1527,885,2520,1652,831,2358,1454,904,1774,970,687,1733,773,865
13135000041,3329,2304,1025,3385,2341,1016,3267,2247,1020,4186,2945,1145,3852,2864,988,4115,2907,1141,4223,2998,1179,3856,2860,996,3330,2069,1189,3149,1857,1180
13321000002,775,160,615,802,153,642,764,141,623,939,209,708,823,196,627,925,207,702,943,225,709,823,196,627,851,162,664,810,146,648
13131000C05,1332,540,792,1355,548,805,1295,504,791,1712,694,991,1470,613,857,1680,691,960,1734,740,985,1469,608,861,1487,615,846,1378,542,796
13149000ENO,525,66,459,536,53,478,515,59,456,723,80,625,619,77,542,709,83,609,735,83,644,618,74,544,569,84,471,530,74,426
13057000020,2058,306,1752,2096,285,1774,2042,285,1757,2760,417,2276,2370,368,2002,2741,425,2257,2788,438,2308,2370,362,2008,2200,280,1836,2111,219,1767
13321000005,384,43,341,387,38,347,376,37,339,421,41,373,388,45,343,415,46,366,421,45,375,389,44,345,388,47,337,371,47,319
13135000127,1127,755,372,1150,777,365,1108,750,358,1525,1016,462,1377,1002,375,1499,1026,440,1535,1054,467,1374,993,381,1189,728,401,1122,628,431
130890000HF,1941,1417,524,1952,1437,481,1886,1378,508,2447,1748,625,2232,1668,564,2436,1762,607,2463,1819,595,2232,1644,588,1917,1311,503,1854,1114,632
130890000WG,1915,1806,109,1963,1867,89,1844,1750,94,2237,2062,134,2126,2030,96,2254,2107,123,2272,2113,140,2122,2019,103,1961,1802,123,1846,1630,166
130890000PB,2027,1450,577,2069,1506,536,2008,1452,556,2465,1758,641,2235,1665,570,2438,1719,641,2481,1803,653,2237,1651,586,2104,1422,591,2028,1166,755
1306700LM01,2377,885,1492,2401,888,1487,2357,866,1491,2998,1173,1765,2820,1211,1609,2982,1194,1727,3010,1259,1711,2819,1193,1626,2389,739,1569,2339,600,1637
1306700MC01,2321,1705,616,2348,1726,605,2278,1664,614,2937,2132,736,2766,2118,648,2947,2153,729,2972,2183,759,2769,2104,665,2289,1511,723,2199,1368,746
1306700SN6A,3843,2192,1651,3903,2279,1570,3793,2174,1619,4578,2623,1840,4245,2558,1687,4558,2642,1798,4609,2808,1706,4244,2514,1730,4083,2201,1665,4043,1818,2000
130890000WF,1525,1313,212,1555,1382,158,1520,1349,171,1602,1389,188,1593,1403,190,1603,1401,182,1616,1441,154,1591,1397,194,1502,1316,138,1484,1135,292
130890000AI,2193,1912,281,2232,1978,226,2173,1909,264,2566,2213,303,2488,2203,285,2560,2196,302,2591,2268,285,2492,2193,299,2110,1789,256,2079,1607,358
130890000GA,1615,1402,213,1647,1451,176,1612,1420,192,1972,1693,237,1897,1677,220,1973,1682,245,1997,1744,225,1899,1674,225,1486,1260,179,1446,1091,293
130890000RH,2002,1952,50,2045,2008,33,1928,1891,37,2375,2245,82,2274,2222,52,2381,2267,72,2410,2296,89,2271,2216,55,2140,2056,57,2044,1882,121
130890000HC,1990,1281,709,2033,1335,662,1963,1283,680,2376,1541,776,2250,1527,723,2363,1552,741,2399,1671,687,2255,1504,751,2072,1313,665,2011,1057,873
13135000080,3716,2313,1403,3783,2334,1413,3608,2214,1394,4823,3029,1708,4427,2969,1458,4732,2989,1669,4849,3086,1710,4425,2952,1473,3782,2116,1562,3577,1843,1600
13143000007,162,13,149,165,10,155,159,9,150,220,13,204,195,11,184,218,14,201,221,12,209,195,10,185,168,13,153,153,10,136
1313100000M,767,172,595,778,165,610,750,159,591,990,223,755,878,197,681,970,200,747,1004,231,766,880,202,678,858,178,667,786,156,596
13057000041,1677,372,1305,1706,363,1321,1667,350,1317,2235,476,1705,2118,479,1639,2216,490,1687,2253,524,1709,2120,469,1651,1665,353,1260,1612,278,1236
13227000003,457,52,405,468,49,417,450,53,397,559,55,488,525,62,463,539,60,470,566,59,491,526,62,464,467,47,404,443,45,376
13251000010,584,374,210,610,392,215,559,348,211,779,500,269,705,465,240,770,503,255,789,519,264,704,458,246,694,434,247,646,360,273
13251000001,662,290,372,680,291,387,640,272,368,812,359,444,719,331,388,800,362,426,821,375,435,719,329,390,747,320,415,691,276,402
13057000032,2251,588,1663,2304,605,1654,2253,585,1668,2811,822,1904,2554,789,1765,2777,828,1865,2840,887,1895,2554,763,1791,2633,586,1922,2544,458,1933
13057000007,2507,686,1821,2541,698,1792,2488,670,1818,3213,962,2174,2902,927,1975,3184,973,2129,3228,1044,2125,2904,897,2007,2753,701,1949,2697,524,2050
13251000011,227,55,172,238,47,190,227,45,182,287,72,212,266,73,193,285,74,207,294,84,209,266,71,195,228,53,168,219,42,170
13251000004,643,315,328,663,328,333,620,297,323,779,394,379,735,377,358,773,390,372,792,400,384,733,376,357,700,364,322,650,300,334
13251000002,286,96,190,300,101,199,270,83,187,358,123,234,317,124,193,352,119,229,363,129,232,316,124,192,300,99,197,288,84,195
13077000019,1582,577,1005,1603,585,1001,1552,552,1000,2023,734,1229,1849,729,1120,1999,746,1209,2041,791,1221,1851,719,1132,1614,537,1027,1550,446,1054
13077000010,1319,211,1108,1347,209,1131,1295,202,1093,1803,304,1452,1575,296,1279,1785,314,1420,1813,322,1465,1575,289,1286,1416,217,1166,1352,187,1099
13077000026,3152,681,2471,3204,657,2522,3130,666,2464,3865,852,2921,3526,828,2698,3824,866,2877,3898,904,2945,3528,825,2703,3472,661,2678,3390,552,2669
13251000003,578,213,365,596,220,374,562,200,362,753,252,492,666,222,444,747,247,490,761,253,506,665,221,444,620,233,384,585,196,377
130910JAYBI,128,43,85,132,42,90,125,45,80,147,43,102,144,53,91,149,47,101,148,46,102,144,53,91,141,52,89,113,42,67
130910CLARK,61,3,58,62,2,60,57,2,55,71,4,66,69,2,67,73,3,68,73,3,70,69,2,67,59,5,54,51,2,49
130910PONDT,468,113,355,492,112,379,465,106,359,502,107,390,482,115,367,504,106,392,516,116,398,482,115,367,482,116,361,445,93,342
130910CHAUN,246,66,180,260,57,203,244,52,192,304,56,245,266,53,213,300,59,240,308,58,248,266,54,212,263,57,200,241,48,190
130910VILUL,127,7,120,133,5,128,125,5,120,141,7,132,130,5,125,142,9,133,144,10,133,131,6,125,126,4,121,115,4,109
13209000003,832,160,672,852,158,690,833,157,676,986,204,766,848,192,656,973,213,742,995,217,769,848,191,657,862,157,690,814,130,654
13319000003,134,28,106,138,27,109,134,30,104,155,32,122,148,31,117,155,33,121,157,31,125,149,31,118,124,22,99,119,17,101
13015000006,2225,425,1800,2255,395,1827,2230,408,1822,2918,556,2282,2530,511,2019,2896,561,2262,2928,568,2312,2533,507,2026,2266,372,1823,2154,327,1685
1305900005A,1964,1363,601,2007,1389,600,1932,1322,610,2331,1585,685,2174,1546,628,2332,1602,678,2349,1652,664,2174,1531,643,1927,1260,580,1906,1112,703
1305900001B,1966,1305,661,2009,1334,655,1938,1286,652,2500,1614,819,2318,1582,736,2489,1636,798,2524,1682,804,2316,1574,742,2040,1266,702,1964,1109,749
1305900008A,1806,1280,526,1839,1306,514,1777,1272,505,2177,1483,638,1991,1462,529,2170,1491,618,2197,1550,604,1990,1458,532,1865,1238,536,1855,1099,646
1305900003A,1177,1045,132,1235,1120,107,1151,1022,129,1484,1254,190,1307,1187,120,1488,1252,183,1504,1304,177,1310,1185,125,1234,1056,130,1135,878,208
1305900007B,1938,1177,761,1984,1220,733,1925,1179,746,2199,1315,824,2012,1258,754,2202,1334,814,2223,1402,774,2017,1242,775,2038,1226,705,2006,1009,901
13015000012,1199,138,1061,1223,119,1088,1207,126,1081,1571,188,1334,1399,166,1233,1564,190,1337,1583,189,1369,1397,164,1233,1252,131,1084,1180,115,1003
1314100003A,189,157,32,200,170,30,178,149,29,222,178,40,200,171,29,228,186,39,234,197,37,201,172,29,208,176,32,188,137,49
13161000502,278,58,220,304,61,239,281,57,224,347,70,269,309,63,246,336,70,261,351,66,280,310,62,248,288,64,219,263,51,201
130750000NL,725,100,625,737,92,645,718,91,627,883,109,752,782,104,678,868,111,738,885,113,761,782,105,677,779,105,665,753,97,639
13021000HO2,2555,775,1780,2589,783,1793,2510,759,1751,2671,899,1739,2519,868,1651,2666,886,1743,2698,929,1734,2523,874,1649,2683,851,1771,2633,684,1892
1312100RW21,2132,768,1364,2164,839,1285,2108,785,1323,2637,1094,1490,2515,1103,1412,2616,1093,1460,2647,1186,1420,2517,1063,1454,2258,819,1327,2222,640,1488
1312100JC12,1720,562,1158,1746,589,1143,1705,555,1150,2249,826,1391,2173,830,1343,2223,822,1346,2261,907,1328,2173,799,1374,1797,579,1177,1742,423,1263
131210SS08C,386,268,118,391,269,118,378,261,117,503,340,151,461,320,141,490,320,154,504,345,152,463,320,143,384,230,133,371,185,166
131210SS29A,1560,896,664,1591,936,632,1554,894,660,2052,1220,789,1887,1178,709,2045,1229,763,2068,1315,728,1885,1158,727,1731,965,680,1695,760,860
1322900003B,765,55,710,770,50,719,740,53,687,1009,69,926,900,72,828,994,75,902,1021,80,935,901,72,829,840,71,754,777,61,695
13003000004,386,236,150,417,251,164,369,226,143,543,293,238,456,291,165,526,278,232,564,329,229,454,291,163,448,275,164,387,219,154
13183000004,757,326,431,784,333,438,753,319,434,1163,521,597,922,460,462,1156,511,595,1179,526,627,920,461,459,785,289,460,737,256,444
13029000007,2424,646,1778,2460,650,1772,2393,645,1748,3256,948,2226,2993,897,2096,3214,908,2206,3265,1017,2205,2994,892,2102,853,281,530,798,225,520
13237000104,1805,858,947,1845,887,953,1757,807,950,2312,1101,1180,2074,1051,1023,2288,1132,1137,2321,1135,1168,2075,1048,1027,2004,993,987,1890,811,1014
13263000003,246,159,87,260,169,90,230,147,83,303,193,107,269,170,99,309,185,120,324,203,120,270,169,101,320,207,106,285,164,113
13151000049,2118,1483,635,2147,1521,609,2050,1438,612,2600,1827,697,2271,1691,580,2595,1865,680,2619,1891,702,2267,1685,582,2232,1416,743,2065,1228,755
13151000045,2092,948,1144,2130,967,1143,2063,936,1127,2532,1181,1283,2270,1138,1132,2533,1209,1273,2552,1213,1299,2273,1131,1142,2191,857,1274,2094,750,1247
13273000006,179,71,108,183,75,108,173,70,103,212,91,116,199,84,115,208,89,117,211,91,118,199,86,113,192,83,106,186,77,105
13071000018,619,64,555,635,61,570,608,56,552,772,97,662,695,82,613,766,92,663,778,96,676,694,82,612,636,62,559,613,56,543
13275000112,384,111,273,408,126,282,375,108,267,495,125,366,459,133,326,488,121,354,503,133,368,458,129,329,466,140,317,418,120,282
1322900004B,349,17,332,361,19,341,346,17,329,355,19,335,321,18,303,350,21,323,362,25,337,321,19,302,301,26,273,277,21,246
13151000036,2290,646,1644,2321,643,1655,2245,632,1613,2895,943,1889,2568,909,1659,2880,932,1877,2918,969,1898,2568,901,1667,2224,495,1660,2130,435,1585
13123000013,1078,208,870,1106,187,907,1056,185,871,1368,249,1093,1280,255,1025,1362,253,1095,1386,270,1102,1281,252,1029,1170,207,951,1112,181,879
132250000P1,845,206,639,860,206,652,830,202,628,1028,277,729,941,274,667,1021,278,723,1035,284,743,941,272,669,876,194,665,842,167,644
13123000012,841,150,691,861,139,712,831,142,689,1119,189,897,1034,199,835,1116,189,905,1138,205,917,1033,193,840,902,152,728,860,148,672
1305900005B,1740,1225,515,1783,1258,504,1706,1197,509,2143,1466,609,1989,1437,552,2138,1475,610,2163,1538,600,1989,1431,558,1766,1198,500,1707,1042,566
13031000016,544,79,465,555,74,477,532,73,459,749,111,615,650,92,558,735,103,605,755,112,630,649,92,557,570,74,488,547,58,471
13175000008,291,54,237,296,53,242,288,54,234,316,67,242,296,63,233,315,66,248,320,69,249,295,61,234,275,54,213,264,46,216
131210ML01B,94,33,61,96,38,57,92,33,59,128,45,82,125,45,80,117,39,78,130,49,80,126,44,82,59,19,37,55,17,36
131210AP04A,1160,460,700,1176,459,689,1135,439,696,1441,601,811,1395,631,764,1435,615,797,1448,656,762,1393,608,785,1225,437,729,1183,302,837
1312100001J,1150,1094,56,1181,1148,29,1098,1052,46,1363,1238,83,1245,1206,39,1370,1261,68,1377,1287,72,1245,1201,44,1235,1159,41,1165,1035,83
1312100ML03,2539,743,1796,2570,788,1751,2529,750,1779,3256,1038,2160,3112,1059,2053,3210,1023,2105,3262,1178,2048,3114,1004,2110,2685,755,1799,2631,537,1992
13039000003,1052,412,640,1077,423,644,1009,388,621,1378,520,825,1187,470,717,1345,498,814,1396,540,842,1187,472,715,1178,453,703,1059,387,620
1322300006C,2564,583,1981,2611,579,2009,2526,566,1960,3532,793,2621,2910,746,2164,3507,822,2596,3567,814,2690,2909,737,2172,2705,506,2123,2584,469,1971
1312100002K,928,795,133,945,829,107,923,802,121,1064,887,145,1027,898,129,1047,872,143,1073,924,135,1024,884,140,996,819,120,977,681,228
1312100010K,826,789,37,852,832,13,808,781,27,1017,950,45,967,939,28,1017,961,44,1032,972,47,967,936,31,885,842,32,834,740,73
1312100001I,0,0,0,0,0,0,0,0,0,1,0,1,0,0,0,1,0,1,1,0,1,0,0,0,0,0,0,0,0,0
132050000CS,1995,960,1035,2031,960,1067,1881,854,1027,2359,1117,1205,2090,1035,1055,2344,1115,1204,2375,1171,1197,2090,1029,1061,2105,990,1087,1974,841,1109
13055001484,499,93,406,503,81,417,481,84,397,653,104,520,553,100,453,633,114,495,666,108,537,553,95,458,551,94,445,512,97,393
13039000008,924,350,574,937,345,580,905,336,569,1261,458,744,1027,403,624,1230,444,721,1277,485,763,1029,406,623,1120,376,700,1043,325,647
1312100007J,1712,1037,675,1745,1129,582,1697,1067,630,2277,1402,832,2135,1358,777,2244,1402,794,2272,1537,707,2140,1317,823,1882,1129,612,1875,831,940
1312100008H,1827,750,1077,1862,847,993,1814,778,1036,2101,901,1176,2027,918,1109,2086,930,1135,2082,1099,971,2028,879,1149,1754,849,831,1783,513,1239
1312100009F,2486,1383,1103,2520,1469,1012,2467,1398,1069,2967,1750,1164,2832,1727,1105,2921,1764,1098,2987,1917,1029,2832,1686,1146,2635,1489,969,2609,1088,1366
131210SC01D,162,160,2,162,162,0,158,158,0,182,169,5,165,164,1,184,172,8,186,175,10,165,164,1,8,8,0,9,8,1
1312100003E,886,836,50,912,889,20,853,823,30,1091,1007,54,956,923,33,1107,1034,55,1110,1024,71,955,921,34,941,885,40,862,769,74
131210CP084,1,1,0,1,1,0,1,1,0,0,0,0,0,0,0,0,0,0,0,0,0,0,0,0,0,0,0,0,0,0
1312100009G,2238,1702,536,2280,1809,428,2224,1723,501,2808,2095,643,2538,1980,558,2773,2071,625,2818,2228,538,2538,1944,594,1999,1480,399,1990,1205,661
1312100RW10,2319,911,1408,2370,979,1353,2306,926,1380,2979,1180,1727,2815,1184,1631,2933,1173,1681,3001,1347,1599,2814,1145,1669,2419,935,1361,2377,648,1606
13033000005,573,227,346,580,219,361,559,209,350,677,261,402,605,251,354,671,266,396,687,271,412,601,246,355,609,240,363,580,222,348
131210SC05E,426,362,64,432,364,67,414,352,62,475,397,72,433,373,60,474,400,69,476,399,74,433,372,61,386,351,30,372,326,40
1312100004I,540,497,43,560,517,37,526,485,41,838,745,71,815,753,62,809,724,71,849,769,71,817,752,65,575,504,52,543,435,75
1312100001B,2678,2393,285,2731,2474,217,2670,2418,252,3305,2903,329,3210,2909,301,3284,2907,303,3327,2984,301,3213,2887,326,2672,2304,243,2583,1977,436
13021000HO1,2720,1130,1590,2770,1143,1612,2681,1087,1594,2697,904,1762,2543,860,1683,2691,917,1741,2718,985,1712,2547,845,1702,2842,1129,1643,2756,961,1719
1312100009B,168,165,3,174,172,2,155,151,4,181,172,6,174,172,2,180,174,4,184,175,7,174,172,2,205,197,6,194,174,14
131210SC08F,361,345,16,365,355,10,349,337,12,432,415,11,386,377,9,436,419,13,438,420,14,385,378,7,386,361,19,372,332,32
1312100003N,904,853,51,934,899,27,865,828,37,924,848,48,835,794,41,919,850,45,933,870,48,832,786,46,943,881,35,879,743,88
13311000031,357,96,261,357,82,269,346,86,260,411,102,301,380,103,277,412,104,303,421,112,307,380,99,281,355,78,264,333,66,246
13079000003,965,167,798,985,143,824,944,158,786,1231,181,1022,1064,186,878,1226,195,1001,1243,184,1043,1063,184,879,1060,154,875,1007,140,831
13033000015,1841,793,1048,1868,782,1072,1792,747,1045,2293,955,1303,2023,876,1147,2264,970,1262,2314,1007,1281,2024,880,1144,1992,843,1120,1865,701,1119
13311000101,897,131,766,916,121,782,892,131,761,1130,163,929,1037,156,881,1124,169,928,1137,169,948,1035,156,879,904,99,768,867,108,707
13033000013,186,89,97,192,93,99,181,82,99,210,103,103,201,105,96,205,94,106,212,105,105,201,105,96,196,101,95,184,82,98
13031000006,893,127,766,911,114,792,874,112,762,1194,202,968,1085,196,889,1188,192,969,1202,203,987,1087,191,896,893,104,766,860,100,740
13277000010,927,619,308,974,680,291,870,582,288,1182,748,418,1041,712,329,1185,764,404,1203,780,408,1040,714,326,1082,763,312,972,599,354
1312100001A,2317,2069,248,2357,2158,177,2294,2073,221,2850,2524,271,2685,2453,232,2811,2477,261,2851,2579,247,2682,2430,252,2168,1898,173,2122,1680,317
131210ML011,1651,624,1027,1679,671,984,1639,629,1010,2337,958,1336,2166,899,1267,2295,941,1290,2356,1080,1238,2168,872,1296,1703,629,987,1652,441,1123
131210AP021,1923,881,1042,1954,932,995,1902,869,1033,2573,1196,1313,2447,1183,1264,2545,1182,1277,2595,1291,1266,2450,1160,1290,2007,879,1010,1977,685,1160
13021000HA4,1438,509,929,1463,499,954,1421,499,922,3731,1574,2092,3451,1510,1941,3717,1560,2086,3760,1615,2108,3452,1509,1943,1469,444,1002,1414,415,971
13019000518,680,170,510,696,171,523,641,150,491,823,197,614,747,203,544,813,198,605,833,206,622,745,200,545,735,196,529,676,171,486
132050000LS,689,130,559,699,120,577,663,112,551,864,171,681,764,163,601,860,175,674,872,166,704,762,158,604,747,140,599,694,137,541
1312100004G,298,286,12,311,306,5,282,272,10,406,381,10,383,374,9,407,382,15,411,388,19,383,376,7,321,306,8,298,274,15
130650000AB,67,9,58,67,5,62,63,5,58,81,9,69,75,10,65,79,9,69,81,12,68,75,10,65,67,7,59,61,5,55
1307900001A,281,123,158,290,125,161,268,114,154,327,133,189,285,125,160,326,135,184,330,138,190,285,122,163,292,135,154,279,114,157
13079000004,980,114,866,1000,101,891,975,113,862,1286,163,1095,1134,138,996,1283,167,1094,1297,161,1125,1134,139,995,1048,126,906,991,112,842
1312100SS05,1344,630,714,1368,685,663,1332,635,697,1579,789,771,1527,790,737,1570,798,739,1580,864,692,1529,767,762,1375,652,657,1373,465,857
13245000702,1155,406,749,1173,397,758,1137,400,737,1401,504,849,1193,467,726,1393,511,841,1413,530,852,1193,464,729,1258,406,798,1209,357,793
13245000805,409,281,128,411,281,128,391,271,120,544,368,166,494,346,148,543,375,158,548,379,166,494,344,150,413,271,135,391,232,147
13189000139,580,217,363,590,210,377,562,197,365,718,252,450,633,245,388,715,255,452,719,261,449,633,247,386,664,240,410,630,206,413
1318900133B,1122,241,881,1143,236,894,1092,231,861,1395,307,1046,1212,281,931,1390,310,1051,1408,327,1058,1212,279,933,1179,253,905,1094,210,853
1312100006J,1858,1430,428,1898,1528,335,1855,1471,384,2238,1765,423,2179,1792,387,2222,1773,399,2253,1894,329,2182,1758,424,1883,1488,303,1862,1189,587
131210SS09B,2407,1022,1385,2445,1123,1287,2388,1053,1335,2952,1366,1551,2869,1334,1535,2908,1360,1511,2969,1545,1399,2876,1289,1587,2485,1122,1266,2482,698,1712
1312100SS31,922,509,413,934,534,388,906,513,393,1289,728,534,1227,708,519,1286,753,512,1299,777,504,1228,698,530,737,382,333,710,268,416
131210CP04A,2,1,1,1,1,0,2,1,1,4,2,2,4,3,1,3,3,0,4,2,2,4,3,1,0,0,0,0,0,0
13207000012,845,140,705,862,131,720,827,130,697,987,170,799,860,141,719,980,170,793,993,168,810,860,141,719,868,140,706,818,121,671
13021000VV5,1420,572,848,1454,579,855,1409,568,841,1750,783,927,1609,772,837,1737,781,916,1761,818,913,1612,766,846,1529,557,912,1465,446,967
13215000122,732,527,205,753,551,196,711,515,196,915,632,253,821,599,222,899,618,245,926,668,238,819,589,230,820,579,208,769,472,249
13179000014,1176,889,287,1195,905,282,1145,864,281,1623,1195,388,1382,1076,306,1604,1165,388,1635,1218,395,1381,1073,308,1238,888,333,1172,750,382
13179000012,816,658,158,835,681,151,797,639,158,1051,795,223,907,748,159,1041,795,213,1070,826,218,903,739,164,970,739,202,910,626,248
13179000002,880,440,440,892,440,439,858,431,427,1164,609,516,1050,581,469,1148,603,504,1193,657,522,1050,575,475,969,477,468,912,388,489
13179000010,1703,1331,372,1731,1350,364,1665,1313,352,2426,1744,585,2056,1615,441,2425,1777,565,2474,1820,612,2057,1613,444,1828,1348,428,1729,1176,490
13245000204,839,410,429,854,418,426,819,401,418,1086,536,511,964,499,465,1076,535,501,1101,563,510,964,502,462,925,432,453,873,363,449
13107001748,449,56,393,464,50,412,433,55,378,560,66,479,488,69,419,552,72,470,566,74,489,488,72,416,471,68,401,437,57,369
13107001208,462,24,438,470,19,451,455,24,431,577,30,544,528,28,500,564,27,530,581,29,549,527,26,501,491,22,466,460,22,428
131210SC18C,1336,1265,71,1349,1301,46,1297,1247,50,1569,1495,60,1528,1486,42,1559,1491,53,1584,1507,72,1530,1485,45,1330,1276,40,1281,1181,82
131210SC23C,1272,1241,31,1300,1271,25,1201,1173,28,1529,1458,49,1413,1376,37,1539,1463,44,1542,1467,68,1413,1375,38,1286,1235,38,1206,1114,70
1312100009D,815,786,29,857,840,16,771,746,25,1000,933,41,939,923,16,1005,950,32,1006,949,48,939,917,22,939,910,19,849,761,71
13013000011,1803,563,1240,1835,557,1243,1768,539,1229,2386,824,1482,1965,750,1215,2361,819,1469,2404,844,1507,1970,745,1225,1843,466,1277,1765,416,1227
13245000405,2396,2205,191,2438,2263,168,2333,2154,179,3108,2793,262,2916,2696,220,3108,2828,243,3142,2863,259,2912,2689,223,2466,2228,200,2306,1977,288
13245000406,1954,1806,148,1984,1851,124,1876,1744,132,2385,2135,213,2229,2065,164,2390,2150,199,2417,2184,210,2232,2067,165,1968,1761,174,1849,1597,214
13245000509,1188,1049,139,1204,1060,137,1139,1012,127,1427,1196,188,1273,1126,147,1445,1213,199,1454,1248,197,1272,1123,149,1285,1091,175,1195,973,201
13207000001,1525,300,1225,1564,290,1255,1499,284,1215,1777,355,1385,1669,344,1325,1768,361,1382,1792,384,1391,1668,347,1321,1574,308,1210,1520,252,1213
13227000006,822,134,688,844,117,715,808,125,683,1033,157,848,904,153,751,1016,149,849,1036,151,866,904,152,752,893,118,750,847,108,694
13139000030,2471,631,1840,2503,626,1848,2418,602,1816,3332,858,2373,2834,807,2027,3311,874,2349,3341,900,2390,2834,800,2034,2735,543,2085,2635,468,2006
13139000003,1186,487,699,1204,476,712,1153,454,699,1681,676,945,1341,583,758,1673,670,946,1693,689,976,1343,580,763,1237,388,799,1175,347,758
1310300001C,740,161,579,756,145,599,731,154,577,1010,220,766,904,197,707,1003,213,761,1015,210,782,903,192,711,801,139,638,758,116,609
13107000058,289,108,181,298,109,186,275,98,177,385,124,248,343,118,225,378,121,250,396,127,266,343,115,228,314,143,168,277,117,153
13115000130,1765,272,1493,1786,238,1526,1727,252,1475,2536,381,2088,2152,361,1791,2516,392,2053,2561,397,2138,2153,359,1794,2034,262,1706,1914,243,1590
13117000006,3766,699,3067,3828,673,3084,3745,659,3086,5124,1019,3938,4580,954,3626,5092,1006,3957,5162,1083,3988,4581,926,3655,3906,590,3159,3776,465,3078
13147000005,1734,299,1435,1771,291,1466,1700,288,1412,2356,421,1899,2142,376,1766,2335,382,1923,2382,453,1912,2146,389,1757,1837,324,1462,1693,267,1358
13285000009,1115,393,722,1136,386,741,1085,364,721,1167,386,760,1028,368,660,1180,401,748,1177,399,765,1028,366,662,1183,391,771,1127,367,730
13219000006,1396,339,1057,1415,347,1052,1383,331,1052,1685,428,1213,1570,436,1134,1675,437,1202,1690,483,1177,1571,424,1147,1341,320,965,1310,252,1008
13285000015,850,451,399,876,470,398,833,442,391,1113,580,506,1006,563,443,1104,593,499,1123,605,511,1007,563,444,946,463,461,867,407,425
13219000008,2107,384,1723,2125,389,1709,2089,381,1708,2947,600,2300,2831,612,2219,2917,589,2276,2953,652,2260,2828,595,2233,1910,361,1478,1874,290,1514
13163000077,386,117,269,401,121,279,380,110,270,457,132,319,418,126,292,453,135,314,462,137,322,418,127,291,403,128,272,376,103,260
1306300RD06,1322,1142,180,1350,1181,162,1276,1112,164,1581,1329,220,1399,1229,170,1599,1356,203,1614,1357,235,1399,1222,177,1441,1222,197,1350,1087,209
13073000017,2286,808,1478,2320,823,1472,2251,789,1462,3051,1094,1879,2759,1101,1658,3033,1102,1845,3053,1148,1834,2761,1086,1675,2562,859,1583,2431,745,1574
13163000085,320,150,170,333,155,177,307,136,171,352,168,179,330,159,171,345,157,184,356,169,184,329,159,170,338,173,162,308,142,156
13167000055,541,37,504,554,26,527,537,36,501,641,58,580,572,46,526,637,56,574,650,52,594,572,47,525,591,47,538,548,37,493
13255000009,1001,153,848,1032,135,884,995,143,852,1309,205,1075,1143,199,944,1302,211,1071,1325,206,1106,1143,196,947,1103,151,927,1026,141,818
13167001301,537,123,414,553,130,423,525,116,409,617,150,460,558,139,419,596,145,444,621,156,460,557,136,421,550,152,397,510,134,368
13073000034,1378,793,585,1398,803,584,1340,762,578,1947,1108,776,1687,1056,631,1946,1114,767,1975,1160,780,1687,1053,634,1387,700,636,1300,618,614
13073000018,2090,1003,1087,2106,1025,1057,2031,987,1044,3304,1649,1527,2858,1574,1284,3270,1675,1481,3338,1748,1501,2861,1570,1291,1374,496,808,1286,429,794
13063000MO1,1451,1311,140,1477,1345,127,1388,1264,124,1670,1454,171,1558,1424,134,1668,1452,159,1697,1478,202,1558,1420,138,1481,1324,128,1394,1186,173
13117000005,3530,775,2755,3567,784,2743,3494,760,2734,4804,1185,3478,4201,1128,3073,4763,1187,3451,4844,1266,3489,4204,1110,3094,3580,666,2772,3461,528,2727
13113000015,1618,320,1298,1663,319,1322,1622,315,1307,2069,439,1583,1961,438,1523,2049,445,1565,2079,476,1583,1964,431,1533,1778,313,1412,1739,235,1434
13113000024,1051,531,520,1075,533,532,1040,522,518,1205,619,557,1147,623,524,1205,625,556,1222,643,567,1146,623,523,1129,491,599,1086,457,589
13113000005,1195,628,567,1223,628,575,1174,606,568,1715,965,706,1580,941,639,1717,974,703,1740,984,732,1580,932,648,1149,489,628,1104,421,616
13045000650,1603,531,1072,1638,535,1080,1553,507,1046,2321,761,1496,1945,741,1204,2293,767,1470,2333,774,1527,1947,730,1217,1778,530,1182,1694,472,1136
13045001540,2300,594,1706,2341,590,1735,2273,568,1705,2929,740,2124,2708,732,1976,2922,752,2111,2959,782,2151,2710,719,1991,2431,632,1740,2341,535,1690
13129001055,939,149,790,962,131,820,921,139,782,1318,193,1101,1115,174,941,1304,181,1091,1326,197,1118,1117,175,942,1031,131,872,961,137,779
13057000011,2156,906,1250,2198,898,1255,2125,889,1236,3052,1237,1712,2636,1140,1496,3023,1242,1681,3091,1316,1723,2639,1129,1510,2258,750,1384,2191,645,1380
13057000003,2055,339,1716,2078,331,1718,2033,337,1696,2903,523,2305,2721,540,2181,2874,524,2286,2921,580,2302,2721,515,2206,2015,268,1661,1967,224,1615
131450000VP,440,171,269,452,139,312,426,132,294,591,166,418,547,169,378,585,169,410,603,179,422,546,167,379,474,152,316,449,120,317
1305105-08C,908,653,255,926,667,255,887,640,247,1111,792,285,1026,753,273,1117,801,295,1137,817,304,1027,756,271,997,662,303,944,605,308
1313100000S,409,40,369,419,34,381,407,34,373,534,62,465,459,51,408,520,57,453,538,62,473,459,52,407,461,40,411,434,41,375
13215000121,1674,847,827,1695,857,819,1620,820,800,2123,1075,996,1880,1032,848,2117,1106,957,2145,1129,994,1879,1020,859,1803,820,924,1726,701,950
1305103-14C,1242,958,284,1261,993,261,1194,937,257,1521,1167,329,1433,1122,311,1517,1168,328,1536,1186,344,1434,1124,310,1374,1063,277,1307,921,358
13135000098,1654,929,725,1681,945,709,1633,923,710,2225,1273,880,1976,1196,780,2166,1246,839,2239,1325,877,1981,1188,793,1853,908,843,1756,769,887
130890000MS,1577,746,831,1608,810,770,1554,749,805,1907,967,901,1830,986,844,1895,998,860,1921,1084,802,1833,961,872,1617,758,786,1601,537,995
130890000DI,1860,711,1149,1892,802,1058,1854,743,1111,2221,965,1214,2158,994,1164,2200,990,1172,2226,1129,1071,2157,948,1209,1915,786,1046,1894,484,1350
130890000AH,2258,1231,1027,2325,1311,968,2244,1231,1013,2776,1573,1153,2602,1532,1070,2734,1566,1118,2796,1715,1048,2604,1495,1109,2479,1418,956,2357,1035,1206
13073000020,2131,682,1449,2165,671,1480,2065,626,1439,2896,848,1956,2557,833,1724,2856,851,1948,2925,899,1978,2557,830,1727,2219,671,1498,2076,575,1436
13073000025,1160,158,1002,1177,148,1018,1135,140,995,1528,271,1212,1370,267,1103,1550,285,1218,1548,296,1224,1374,267,1107,1213,154,1034,1153,126,989
13073000100,1271,422,849,1297,420,865,1241,405,836,1633,579,1014,1464,548,916,1606,547,1021,1641,608,1009,1466,550,916,1457,425,974,1392,358,982
13073000062,2730,842,1888,2761,849,1876,2690,832,1858,3633,1226,2337,3380,1191,2189,3604,1187,2319,3653,1269,2324,3377,1182,2195,2654,744,1817,2546,621,1830
13073000105,1113,255,858,1129,256,866,1099,248,851,1373,356,1002,1317,352,965,1377,339,1007,1390,380,998,1319,347,972,1200,290,887,1145,216,904
133130000MC,871,113,758,899,113,777,852,107,745,1225,170,1023,1095,158,937,1199,147,1013,1240,164,1061,1096,157,939,994,118,848,906,120,732
13135000131,2601,1029,1572,2636,1066,1539,2594,1051,1543,3412,1441,1898,3176,1435,1741,3347,1423,1850,3423,1541,1832,3173,1400,1773,2652,934,1601,2599,717,1756
130890000CP,1589,1505,84,1611,1546,60,1530,1462,68,1827,1710,79,1748,1681,67,1835,1723,84,1846,1738,91,1744,1671,73,1679,1572,78,1614,1436,144
130890000BB,3046,2700,346,3107,2845,232,3018,2729,289,3613,3243,308,3531,3238,293,3617,3235,300,3641,3341,256,3524,3202,322,2957,2579,236,2898,2255,473
130890000RK,1470,1425,45,1492,1452,36,1423,1380,43,1711,1604,73,1619,1566,53,1726,1629,69,1731,1620,93,1619,1564,55,1509,1428,63,1427,1279,105
13251000006,546,94,452,560,85,474,535,86,449,701,102,591,638,93,545,694,96,585,712,102,606,639,92,547,552,75,470,524,71,444
130890000BD,1263,754,509,1295,800,478,1266,751,515,1499,925,541,1472,958,514,1484,945,507,1507,1004,479,1472,927,545,1254,709,487,1258,588,621
1311100MINE,1005,157,848,1029,133,890,981,133,848,1381,207,1150,1271,206,1065,1365,214,1135,1396,213,1172,1274,194,1080,1077,143,922,1017,140,831
1311100HEMP,718,127,591,741,117,614,708,119,589,968,170,778,888,172,716,964,171,772,984,181,791,889,165,724,765,122,630,707,116,561
13113000018,2287,929,1358,2314,955,1331,2262,926,1336,3750,1646,2005,3434,1593,1841,3716,1647,1953,3787,1731,1991,3436,1564,1872,2270,899,1284,2168,715,1341
13113000009,1923,600,1323,1962,618,1308,1914,605,1309,2389,742,1559,2274,774,1500,2363,765,1522,2400,824,1528,2274,746,1528,2013,550,1387,1988,435,1455
13113000019,1109,318,791,1134,346,766,1100,329,771,1385,442,911,1320,458,862,1363,438,886,1393,488,886,1320,444,876,1227,338,845,1181,271,857
13113000022,1317,273,1044,1329,275,1035,1313,269,1044,1511,331,1146,1479,353,1126,1500,342,1131,1522,387,1114,1479,335,1144,1435,278,1097,1400,202,1140
13135000092,1799,803,996,1819,827,964,1777,802,975,2173,1091,1032,2057,1099,958,2138,1070,1020,2172,1155,995,2058,1073,985,1927,802,1030,1901,640,1136
13073000136,1270,404,866,1293,408,866,1254,391,863,1654,584,1013,1501,566,935,1632,575,1010,1667,618,1018,1499,558,941,1474,420,988,1404,359,974
13073000063,879,266,613,890,275,607,875,270,605,1070,353,695,972,325,647,1076,363,698,1078,378,683,973,330,643,919,267,624,901,219,648
13073000033,1535,866,669,1549,865,657,1493,842,651,2481,1365,1023,2136,1290,846,2457,1346,1021,2507,1423,1021,2135,1281,854,1477,713,695,1400,612,703
13291000009,1326,249,1077,1348,229,1114,1306,233,1073,1843,346,1469,1710,331,1379,1844,349,1480,1866,368,1489,1711,339,1372,1267,224,1022,1210,214,962
1311100SKEN,212,42,170,217,38,177,210,35,175,268,51,206,251,49,202,269,50,216,270,59,211,251,46,205,218,50,165,211,51,153
130890000SJ,1263,1178,85,1299,1227,67,1204,1131,73,1572,1411,123,1397,1321,76,1577,1437,112,1596,1445,133,1398,1319,79,1351,1249,87,1254,1091,128
130890000SV,1996,1875,121,2026,1920,99,1954,1847,107,2377,2193,140,2285,2170,115,2380,2204,139,2397,2219,159,2283,2169,114,2029,1877,118,1940,1719,171
130890000HA,1730,1520,210,1781,1580,190,1659,1455,204,2316,1948,323,2153,1912,241,2301,1945,302,2343,1947,374,2156,1903,253,1882,1653,197,1749,1430,254
130890000DE,1093,983,110,1124,1009,111,1052,939,113,1387,1184,166,1362,1229,133,1393,1201,164,1404,1215,178,1362,1226,136,1145,993,133,1066,856,171
130890000AA,1585,1433,152,1629,1480,145,1539,1400,139,1910,1682,189,1791,1640,151,1911,1689,184,1931,1718,201,1794,1640,154,1774,1577,171,1699,1438,223
130890000PE,432,394,38,435,390,37,426,385,41,480,425,44,464,414,50,478,427,43,478,425,49,464,414,50,422,359,48,421,338,63
130890000WB,1843,1791,52,1891,1851,33,1799,1755,44,2094,1996,71,2016,1978,38,2105,2028,53,2115,2029,73,2017,1972,45,1958,1885,51,1879,1709,126
13149000CEN,991,150,841,1013,130,875,980,136,844,1312,181,1103,1183,176,1007,1285,187,1080,1319,186,1122,1182,173,1009,1057,140,891,1003,141,814
13165000002,538,276,262,564,299,264,521,267,254,650,341,297,600,340,260,649,359,278,667,369,292,599,339,260,621,344,271,557,272,276
1305102-03C,725,631,94,746,656,77,703,613,90,838,686,126,799,680,119,826,663,121,847,707,115,799,680,119,811,675,108,758,565,154
1305103-05C,940,721,219,973,748,207,903,686,217,1189,871,272,1100,847,253,1189,874,273,1205,884,300,1099,846,253,1038,733,257,992,632,306
13095000026,620,583,37,646,613,32,580,545,35,673,621,45,638,607,31,676,622,49,688,637,44,637,606,31,693,654,33,641,575,58
13095000017,1056,1012,44,1096,1077,16,975,937,38,1122,1061,47,1050,1038,12,1124,1067,41,1141,1101,32,1047,1030,17,1275,1255,12,1145,1062,77
13087001277,355,42,313,365,36,328,350,34,316,443,50,391,410,48,362,439,55,380,448,55,392,413,50,363,432,55,370,404,47,347
1304700BLCK,881,141,740,905,124,763,863,135,728,1303,205,1055,1146,178,968,1280,186,1053,1315,208,1088,1145,181,964,1028,143,854,923,131,732
1304700BOYN,3229,594,2635,3278,594,2644,3183,598,2585,4523,937,3441,3906,853,3053,4457,883,3447,4567,996,3501,3908,855,3053,3657,660,2886,3429,562,2705
13161000302,419,28,391,435,17,418,419,19,400,517,26,478,477,30,447,503,26,466,520,24,493,478,31,447,456,30,423,419,33,371
1305106-09C,1889,1040,849,1923,1064,836,1839,1028,811,2262,1252,947,2046,1146,900,2255,1211,959,2281,1267,979,2041,1148,893,2224,1193,937,2127,1022,979
1305101-09C,331,184,147,338,189,146,320,178,142,441,250,182,372,222,150,441,252,178,451,265,181,372,222,150,387,217,160,369,185,166
1305107-06C,1517,745,772,1548,752,772,1471,728,743,2078,1044,979,1794,949,845,2072,1037,968,2098,1057,1003,1797,954,843,1618,667,900,1516,566,880
13037000003,248,199,49,256,205,50,239,189,50,303,230,69,266,218,48,300,228,69,308,243,64,266,219,47,290,240,48,254,187,59
13077000013,1456,278,1178,1489,267,1207,1438,260,1178,1915,376,1495,1711,364,1347,1903,386,1487,1933,394,1524,1713,361,1352,1502,234,1219,1438,203,1166
13077000021,2794,792,2002,2825,803,1970,2750,779,1971,3500,1027,2376,3070,961,2109,3468,1043,2342,3535,1086,2379,3069,940,2129,3046,754,2170,2923,635,2138
13077000027,1007,199,808,1027,198,819,997,192,805,1376,311,1038,1238,286,952,1367,319,1021,1382,327,1038,1235,278,957,1109,206,869,1050,181,822
13097000785,2361,2028,333,2386,2064,315,2298,1974,324,2898,2472,370,2734,2427,307,2892,2474,370,2908,2496,384,2734,2429,305,2394,1963,392,2286,1810,416
13191001480,329,109,220,340,106,233,317,94,223,413,118,290,351,110,241,408,118,282,424,116,308,352,110,242,410,116,293,388,98,283
13135000147,3049,1902,1147,3103,1944,1131,2968,1850,1118,4063,2575,1390,3666,2478,1188,3990,2560,1349,4102,2639,1408,3667,2468,1199,3237,1797,1343,3055,1560,1355
13135000102,1786,633,1153,1817,654,1144,1755,623,1132,2358,901,1394,2117,858,1259,2311,909,1351,2371,957,1391,2112,840,1272,1920,581,1282,1850,485,1273
1312500MITC,289,41,248,299,39,259,285,36,249,346,47,292,307,37,270,337,50,284,347,48,298,306,38,268,318,53,262,289,43,243
1305101-13C,775,307,468,805,316,481,767,298,469,1005,404,579,936,376,560,1005,406,579,1017,414,589,937,375,562,809,294,476,764,246,483
1305103-13C,1296,855,441,1309,861,438,1256,823,433,1372,820,523,1162,671,491,1363,825,518,1384,845,525,1163,671,492,1779,1289,455,1703,1153,493
13135000099,1540,950,590,1553,963,568,1511,940,571,2082,1243,778,1820,1149,671,2020,1204,737,2103,1256,802,1824,1150,674,1646,919,652,1554,771,673
13135000087,1624,1087,537,1658,1097,536,1597,1062,535,2170,1355,746,1929,1296,633,2125,1351,700,2207,1419,751,1930,1288,642,1666,1008,586,1555,826,622
13217000003,2696,2085,611,2761,2129,622,2634,2023,611,3459,2671,725,3214,2608,606,3447,2681,713,3496,2705,763,3213,2607,606,2718,1963,706,2582,1780,730
13135000128,1540,803,737,1569,829,705,1518,814,704,2019,1094,854,1800,1045,755,1964,1076,828,2029,1143,850,1805,1048,757,1698,816,794,1634,662,873
13135000112,2005,879,1126,2046,900,1117,1973,867,1106,2478,1213,1209,2341,1218,1123,2445,1225,1174,2477,1275,1169,2343,1205,1138,2107,836,1202,2055,686,1260
130890000ST,2191,2058,133,2224,2108,114,2135,2008,127,2585,2404,146,2453,2338,115,2592,2420,137,2599,2431,154,2453,2332,121,2199,2034,126,2112,1885,173
13097000734,1421,594,827,1453,593,842,1397,563,834,1823,783,1000,1609,754,855,1819,799,969,1839,802,1008,1609,737,872,1526,553,928,1469,493,902
13097001274,995,476,519,1016,483,514,977,468,509,1274,648,572,1125,635,490,1275,673,569,1292,679,581,1126,625,501,1120,436,633,1078,407,619
13199000003,544,431,113,562,444,113,499,393,106,656,504,142,618,494,124,656,510,137,670,519,146,619,493,126,603,478,116,545,394,139
130890000PA,1049,963,86,1080,1006,69,1015,942,73,1336,1186,111,1266,1169,97,1347,1200,119,1356,1218,121,1265,1163,102,1095,987,80,1046,872,128
1305101-08C,995,430,565,1009,423,579,973,412,561,1207,553,634,1136,538,598,1199,555,626,1225,587,628,1136,532,604,1074,437,599,1036,336,660
13083001889,650,119,531,659,133,515,647,126,521,842,182,635,736,164,572,835,176,629,840,191,629,739,164,575,722,131,538,718,102,571
13127002933,2916,818,2098,2980,833,2111,2875,819,2056,3523,1016,2455,3362,998,2364,3461,979,2404,3563,1122,2399,3360,993,2367,3033,856,2094,2882,620,2166
130890000MK,1444,1130,314,1473,1155,298,1405,1095,310,1820,1390,388,1688,1360,328,1810,1401,363,1835,1444,371,1686,1353,333,1562,1063,423,1524,917,525
130890000RD,1246,859,387,1277,875,373,1246,856,390,1464,972,449,1406,989,417,1441,984,420,1474,1028,424,1407,980,427,1033,679,300,1010,574,364
130890000RA,2134,2046,88,2194,2125,67,2079,2007,72,2403,2268,104,2343,2276,67,2410,2281,99,2430,2302,118,2343,2272,71,2269,2169,76,2152,1943,163
1305105-10C,1627,1538,89,1678,1617,53,1544,1479,65,2006,1859,106,1872,1807,65,2012,1873,94,2038,1910,102,1864,1801,63,1826,1744,65,1673,1470,167
130890000FG,1957,1905,52,1976,1938,35,1904,1864,40,2198,2078,83,2066,2012,54,2201,2100,79,2208,2098,95,2065,2005,60,1835,1750,59,1763,1621,110
130890000RF,1598,1538,60,1618,1571,41,1558,1504,54,1909,1812,66,1769,1719,50,1913,1817,67,1924,1819,92,1768,1717,51,1604,1510,73,1526,1407,94
130890000RI,2415,2315,100,2458,2367,80,2371,2285,86,2860,2691,127,2771,2672,99,2867,2707,126,2877,2715,144,2769,2667,102,2279,2151,98,2191,1970,165
1306300RD05,1477,1360,117,1507,1396,99,1423,1321,102,1707,1507,156,1599,1479,120,1709,1535,138,1731,1552,163,1598,1476,122,1551,1416,108,1469,1264,166
13063000PH2,1813,1390,423,1843,1407,429,1756,1333,423,2348,1837,467,2254,1840,414,2346,1839,468,2361,1852,490,2253,1838,415,1691,1207,456,1604,1083,483
13063000LJ5,1597,1461,136,1613,1496,114,1548,1424,124,1978,1776,162,1867,1738,129,1979,1787,160,1990,1800,179,1867,1734,133,1544,1367,147,1463,1244,183
13097000732,1512,1329,183,1526,1343,177,1474,1298,176,1963,1662,264,1811,1606,205,1979,1694,257,1994,1699,279,1809,1597,212,1629,1403,200,1567,1306,220
13097000735,1967,810,1157,1994,801,1162,1933,787,1146,2473,1074,1315,2140,1044,1096,2482,1110,1313,2500,1116,1342,2136,1026,1110,2206,746,1368,2117,694,1300
1309700736S,3733,2476,1257,3783,2534,1233,3654,2435,1219,4620,3199,1346,4253,3088,1165,4612,3190,1334,4665,3250,1370,4248,3076,1172,3813,2337,1396,3681,2098,1460
13063000LJ2,1524,1355,169,1564,1397,160,1475,1310,165,2038,1735,242,1841,1672,169,2035,1757,232,2056,1771,266,1841,1671,170,1643,1421,197,1538,1257,233
130890000BH,1567,1036,531,1592,1048,519,1534,1025,509,1921,1309,560,1818,1294,524,1927,1315,547,1956,1361,565,1818,1285,533,1597,956,575,1530,829,617
130890000BF,1618,1103,515,1646,1120,506,1587,1070,517,1953,1344,567,1839,1327,512,1948,1353,550,1964,1387,549,1843,1317,526,1687,1066,558,1636,936,623
130890000MT,2116,1939,177,2186,2040,112,2098,1946,152,2495,2254,181,2415,2246,169,2473,2228,170,2508,2304,161,2415,2224,191,1929,1728,114,1840,1480,233
130890000PN,831,785,46,860,828,27,818,781,37,1223,1131,69,1169,1115,54,1227,1131,69,1237,1154,71,1169,1107,62,923,859,38,877,740,88
130890000CS,2292,2218,74,2331,2275,52,2210,2149,61,2692,2534,105,2584,2524,60,2709,2587,92,2720,2586,105,2583,2520,63,2337,2239,75,2226,2026,149
130890000MC,2100,2057,43,2133,2106,23,2016,1980,36,2464,2333,72,2312,2276,36,2470,2365,65,2479,2377,81,2310,2264,46,2214,2146,48,2079,1922,107
13135000030,1615,1045,570,1644,1060,575,1579,1009,570,2090,1369,661,1927,1345,582,2049,1364,652,2098,1398,671,1925,1330,595,1679,964,678,1599,853,690
13135000069,2074,1267,807,2107,1291,789,2023,1229,794,2567,1531,960,2380,1527,853,2511,1512,928,2587,1592,953,2382,1502,880,2107,1104,906,2041,967,959
13135000066,1527,1209,318,1556,1239,302,1500,1186,314,1945,1441,455,1719,1344,375,1901,1419,434,1967,1461,480,1714,1336,378,1749,1340,350,1641,1157,387
130890000LC,1703,1249,454,1730,1288,416,1673,1226,447,2148,1544,557,1979,1475,504,2140,1570,515,2166,1626,514,1984,1463,521,1820,1274,455,1767,1065,607
130890000NC,1169,1040,129,1194,1071,116,1113,993,120,1391,1216,148,1346,1234,112,1396,1222,142,1413,1242,158,1343,1223,120,1220,1075,121,1162,951,171
1306700SA01,1873,902,971,1899,910,959,1867,890,977,2349,1136,1125,2168,1104,1064,2328,1135,1112,2362,1192,1117,2168,1083,1085,2009,851,1053,1972,685,1160
130890000SG,1155,1109,46,1183,1152,25,1115,1084,31,1324,1252,47,1286,1250,36,1339,1262,52,1342,1269,63,1284,1245,39,1158,1092,45,1093,978,86
130890000MA,1797,1698,99,1820,1745,74,1739,1650,89,2074,1900,135,1941,1855,86,2082,1919,132,2089,1928,143,1944,1855,89,1841,1733,87,1743,1557,154
130890000SS,1188,1140,48,1209,1172,32,1146,1109,37,1362,1278,60,1319,1271,48,1373,1293,60,1375,1300,62,1318,1264,54,1252,1192,47,1188,1074,89
13135000096,1719,763,956,1743,776,935,1671,746,925,2303,1097,1147,2057,1026,1031,2231,1042,1120,2326,1146,1137,2058,1011,1047,1798,761,971,1743,600,1042
1326100W-27,1199,467,732,1231,464,759,1182,454,728,1431,550,860,1315,548,767,1430,564,841,1450,576,860,1315,545,770,1293,496,782,1243,453,766
13143000008,399,44,355,404,33,368,394,32,362,531,38,489,470,31,439,534,40,488,539,36,500,471,30,441,441,46,386,417,53,344
13195000ILA,871,131,740,904,118,779,879,118,761,1168,158,968,1048,143,905,1165,163,976,1183,168,1001,1048,142,906,974,137,812,930,116,779
1304700CHAM,1560,251,1309,1588,241,1336,1529,241,1288,2008,338,1624,1844,314,1530,1973,307,1613,2026,351,1641,1842,315,1527,1665,258,1365,1529,218,1252
13175000012,779,140,639,798,137,658,764,134,630,927,163,753,842,161,681,915,163,741,931,169,761,843,158,685,796,152,628,764,122,628
1304700CAKT,1357,204,1153,1388,215,1157,1340,209,1131,1866,326,1476,1651,286,1365,1833,291,1475,1900,329,1532,1650,285,1365,1504,214,1246,1384,186,1130
13199000009,238,70,168,241,64,177,230,63,167,299,70,218,279,70,209,298,78,214,297,75,217,279,69,210,258,66,182,242,54,180
13265000601,681,411,270,741,458,281,648,380,268,722,415,294,676,410,266,703,411,281,739,447,289,675,408,267,703,431,269,630,356,261
1306700VG01,1688,1090,598,1707,1127,562,1674,1098,576,2329,1536,733,2142,1422,720,2314,1534,719,2338,1598,700,2145,1409,736,1511,861,585,1483,701,705
1306700TM01,2879,2033,846,2913,2057,818,2827,1981,846,3544,2365,1066,3138,2198,940,3531,2348,1057,3569,2477,1030,3136,2168,968,3029,1999,873,2954,1742,1019
1306700PP01,2032,835,1197,2052,864,1147,2004,836,1168,2567,1100,1405,2413,1104,1309,2543,1120,1363,2575,1173,1349,2413,1081,1332,2224,800,1317,2172,642,1415
13231000005,1624,189,1435,1647,174,1465,1606,176,1430,2039,218,1786,1862,218,1644,2026,237,1766,2055,243,1799,1865,212,1653,1689,178,1483,1632,164,1401
1326100O-26,655,328,327,668,317,347,629,300,329,769,369,394,701,350,351,771,376,387,781,379,397,701,349,352,699,339,349,660,295,352
1306700MD01,2546,1047,1499,2582,1072,1471,2551,1040,1511,3361,1463,1825,3228,1483,1745,3343,1478,1772,3382,1598,1722,3229,1454,1775,2826,1039,1614,2818,766,1879
13143000006,392,36,356,401,21,375,391,39,352,536,50,467,485,43,442,531,51,476,540,46,493,485,43,442,441,40,389,428,39,362
1331300003A,1214,386,828,1241,405,826,1192,374,818,1547,515,1001,1461,515,946,1525,498,977,1560,559,974,1459,519,940,1291,399,849,1228,321,857
13143000011,346,34,312,362,18,339,341,25,316,471,44,416,407,36,371,459,35,414,474,38,434,407,36,371,353,23,323,334,31,292
13321000009,411,124,287,410,116,292,392,108,284,480,133,338,464,144,320,475,141,331,484,143,337,463,143,320,433,127,300,413,116,288
13321000010,344,20,324,358,15,341,345,14,331,403,26,372,366,25,341,400,28,368,409,28,380,366,23,343,361,22,339,347,22,320
13321000012,689,103,586,708,95,608,671,95,576,822,140,668,725,128,597,822,141,673,830,134,689,726,124,602,763,110,639,735,123,597
13261000028,628,206,422,651,214,435,620,197,423,684,219,460,668,228,440,677,216,459,686,219,465,666,226,440,664,218,438,639,188,443
1306700RW02,2471,1008,1463,2490,1062,1385,2460,1015,1445,3098,1343,1694,2988,1357,1631,3091,1378,1651,3117,1518,1545,2995,1325,1670,2639,1043,1453,2633,701,1844
13321000007,253,23,230,258,19,237,247,20,227,315,34,277,279,27,252,309,29,273,316,30,284,279,27,252,282,26,252,277,26,244
1306700VG04,2301,964,1337,2329,1029,1272,2297,974,1323,2661,1204,1423,2543,1169,1374,2633,1207,1385,2675,1350,1296,2549,1132,1417,2387,1018,1273,2391,731,1556
1306700OR05,2421,1376,1045,2455,1411,1022,2393,1379,1014,3072,1770,1233,2888,1771,1117,3070,1776,1212,3090,1835,1217,2889,1748,1141,2523,1281,1133,2480,1101,1260
13207000010,963,164,799,980,152,818,940,165,775,1271,216,1028,1122,201,921,1267,223,1028,1290,212,1069,1125,192,933,966,153,790,911,152,716
130750000RB,759,87,672,768,78,686,746,82,664,925,126,783,805,113,692,913,120,782,933,127,799,805,113,692,812,99,703,782,89,671
13027001650,1124,226,898,1151,228,917,1093,215,878,1452,312,1114,1272,271,1001,1432,300,1099,1469,313,1141,1274,275,999,1252,233,997,1139,192,906
1306700MA03,1780,1005,775,1801,1000,772,1743,966,777,2157,1213,887,2002,1174,828,2155,1219,876,2167,1247,890,2003,1160,843,1828,910,833,1790,797,883
1306700MA04,1044,524,520,1057,522,517,1029,499,530,1275,674,575,1184,664,520,1273,674,567,1282,710,549,1186,644,542,979,428,488,979,349,566
1306700BF02,1776,810,966,1809,831,942,1770,813,957,2296,1080,1139,2099,1039,1060,2265,1066,1111,2305,1127,1127,2098,1028,1070,1962,797,1043,1917,668,1124
1306700SW01,1909,1145,764,1944,1154,770,1890,1117,773,2323,1413,863,2184,1412,772,2309,1401,850,2346,1439,867,2187,1413,774,2093,1148,895,1994,1027,889
1304900005R,176,10,166,177,11,166,167,9,158,210,22,187,201,20,181,205,18,183,215,20,194,201,20,181,181,12,167,160,13,144
13037000001,454,258,196,464,259,205,429,230,199,518,275,234,483,273,210,516,278,223,523,291,227,480,270,210,491,274,212,458,245,210
13029000009,1023,404,619,1036,402,623,1002,400,602,1602,635,910,1285,551,734,1588,616,913,1613,635,937,1287,556,731,1341,327,959,1281,267,954
130910EMPIR,262,32,230,269,21,245,260,25,235,321,27,283,285,24,261,318,29,284,323,29,289,285,26,259,257,23,229,246,24,218
1314100001A,565,286,279,581,295,283,550,284,266,771,358,396,715,340,375,780,368,403,787,379,405,715,339,376,568,290,271,540,260,266
13175000018,1406,412,994,1443,411,1021,1366,378,988,1657,488,1146,1528,456,1072,1651,479,1148,1680,503,1165,1529,459,1070,1464,437,1007,1403,366,1006
13071000009,146,44,102,152,42,109,137,39,98,187,47,139,172,48,124,180,45,134,188,51,137,172,49,123,145,38,104,131,25,101
13033000016,297,169,128,303,171,131,284,157,127,397,230,165,371,221,150,390,229,158,403,237,165,370,222,148,361,209,149,336,188,143
13175000010,466,64,402,473,52,418,452,61,391,556,76,471,500,75,425,544,76,457,559,78,479,501,75,426,479,68,407,471,62,402
1314100004C,100,76,24,103,79,24,92,69,23,109,81,28,107,81,26,110,83,25,112,84,26,107,81,26,107,80,25,100,72,27
1331500001A,265,206,59,289,227,62,259,201,58,322,232,85,261,184,77,322,225,90,330,235,92,261,184,77,321,262,59,283,195,80
13177000010,2823,600,2223,2882,580,2284,2757,550,2207,3462,694,2706,3123,684,2439,3446,698,2687,3502,725,2749,3120,677,2443,3056,554,2433,2932,535,2325
13151000043,2601,1142,1459,2632,1167,1436,2534,1115,1419,3182,1544,1573,2951,1529,1422,3168,1565,1550,3201,1589,1579,2950,1511,1439,2681,1045,1582,2554,920,1539
13151000042,2590,1501,1089,2638,1494,1122,2543,1453,1090,3289,1922,1297,2961,1849,1112,3286,1938,1284,3317,1958,1324,2962,1843,1119,2643,1251,1320,2481,1143,1241
13151000027,2717,641,2076,2751,616,2114,2665,604,2061,3626,914,2627,3087,854,2233,3585,901,2611,3629,926,2666,3088,844,2244,2823,493,2247,2671,438,2107
1312100011C,1975,1931,44,2001,1977,22,1907,1877,30,2149,2070,46,2091,2061,30,2150,2084,42,2164,2095,53,2091,2059,32,1934,1883,33,1886,1714,132
1312100007A,3991,2173,1818,4077,2310,1719,3972,2180,1792,5395,3070,2226,4919,2904,2015,5341,3069,2158,5437,3341,2030,4921,2832,2089,4084,2123,1752,4000,1570,2265
13021000HO7,1772,621,1151,1803,612,1175,1752,609,1143,2301,826,1434,2150,816,1334,2288,811,1432,2303,851,1421,2149,801,1348,1819,568,1182,1749,474,1216
13105000199,332,46,286,342,40,298,325,41,284,431,54,372,393,52,341,427,57,360,435,55,371,393,55,338,354,36,313,324,43,270
1312100010M,1364,1301,63,1408,1377,24,1320,1276,44,1607,1513,54,1543,1497,46,1610,1508,65,1622,1531,70,1540,1494,46,1284,1233,31,1202,1057,108
1312100007N,984,802,182,1016,851,154,973,804,169,1269,1022,215,1107,936,171,1270,1011,223,1292,1055,222,1106,926,180,1014,776,185,957,674,230
1305900007A,1795,1092,703,1827,1131,681,1775,1093,682,2153,1299,810,1946,1235,711,2131,1300,788,2167,1363,775,1948,1214,734,1841,1072,687,1822,867,862
1305900006C,2002,1153,849,2040,1182,833,1998,1152,846,2337,1334,950,2112,1265,847,2330,1323,948,2361,1416,901,2118,1255,863,2085,1116,855,2056,953,1000
13275000116,252,40,212,253,39,213,244,37,207,306,50,254,286,45,241,296,45,246,310,58,251,286,43,243,273,44,226,249,38,209
13123000002,934,127,807,961,115,838,918,117,801,1220,153,1042,1103,156,947,1223,164,1048,1235,170,1055,1104,154,950,1004,124,864,941,127,771
13275000101,369,71,298,377,77,300,356,66,290,480,90,379,448,94,354,466,91,361,486,103,380,446,94,352,433,98,330,396,79,308
1312100001D,302,285,17,307,292,15,301,287,14,468,422,40,441,414,27,461,418,38,472,435,34,440,409,31,297,268,23,281,230,36
131210SC05B,2156,2076,80,2184,2123,56,2087,2018,69,2534,2408,89,2464,2398,66,2534,2432,81,2552,2443,93,2461,2384,77,2117,2018,67,2026,1875,118
13031000007,650,127,523,667,125,537,628,119,509,909,162,729,813,168,645,905,160,725,921,169,740,814,169,645,685,150,522,645,111,510
13033000001,230,104,126,240,108,131,222,97,125,269,104,159,252,108,144,268,111,156,272,113,158,251,104,147,262,120,140,244,103,138
13115000010,674,118,556,692,103,583,673,109,564,946,149,775,868,152,716,933,165,757,952,155,791,866,147,719,798,122,654,760,116,620
1300700000H,166,85,81,173,89,84,163,83,80,230,115,114,210,105,105,218,105,106,234,111,120,209,108,101,200,105,92,183,88,93
13295001851,767,218,549,773,236,527,745,220,525,945,278,635,888,275,613,916,256,639,936,321,593,888,270,618,834,246,540,831,171,628
1312100008K,693,380,313,699,417,262,686,385,301,839,508,309,757,471,286,831,524,281,836,570,247,756,446,310,721,397,260,724,288,399
1312100012D,487,470,17,497,489,8,461,449,12,611,564,33,576,553,23,621,581,31,625,586,30,574,554,20,599,579,11,553,503,33
131210004X2,351,338,13,364,357,5,335,319,16,418,381,23,377,358,19,418,379,23,420,380,30,376,357,19,337,318,8,308,264,28
1312100004D,686,650,36,713,692,20,661,638,23,848,783,43,819,790,29,852,794,37,857,812,33,820,788,32,731,710,17,675,605,53
1312100JC15,507,301,206,520,309,193,506,308,198,700,421,256,627,388,239,691,412,247,706,430,266,627,388,239,525,294,202,501,257,206
1312100AP14,1985,941,1044,2022,986,1004,1971,933,1038,2597,1322,1220,2452,1300,1152,2556,1311,1178,2616,1419,1161,2455,1284,1171,2148,942,1078,2122,691,1325
131210UC031,1165,960,205,1195,987,206,1121,916,205,1470,1183,252,1366,1144,222,1483,1211,247,1499,1218,264,1362,1133,229,1320,1015,280,1241,901,312
131210UC035,5,4,1,5,4,1,4,3,1,5,4,1,5,4,1,3,3,0,6,5,1,5,4,1,5,4,1,4,3,1
132050000BA,631,288,343,640,289,348,612,273,339,732,323,396,647,304,343,732,327,395,739,331,400,646,301,345,645,294,342,607,248,343
132050000SC,235,60,175,240,59,180,229,54,175,273,61,210,238,58,180,270,64,205,277,63,214,238,59,179,253,52,198,240,47,186
132050000PC,107,12,95,109,14,95,104,12,92,127,15,110,122,19,103,126,17,108,129,21,107,121,18,103,122,14,107,117,13,101
1312100CH01,159,117,42,161,120,41,155,115,40,206,143,57,191,143,48,209,152,56,211,147,60,191,143,48,182,116,60,172,110,56
131210003P2,7,7,0,7,7,0,7,7,0,7,7,0,8,8,0,7,7,0,7,7,0,8,8,0,22,21,1,21,18,3
13245000301,1692,573,1119,1712,582,1108,1676,560,1116,1928,699,1203,1837,680,1157,1914,702,1176,1945,761,1154,1837,666,1171,1785,553,1157,1769,439,1283
131210008F1,1588,515,1073,1619,593,1006,1580,553,1027,1869,664,1183,1837,698,1139,1860,698,1139,1868,891,956,1844,626,1218,1579,612,879,1591,314,1242
131210SC18A,322,315,7,328,323,5,308,300,8,388,363,15,342,334,8,396,381,11,396,380,13,342,334,8,321,305,11,303,273,24
131210012H1,300,274,26,309,295,14,280,261,19,379,344,21,315,299,16,385,351,23,384,346,32,313,296,17,582,560,15,537,474,48
1312100SC15,4148,3989,159,4209,4085,117,4013,3884,129,4793,4535,190,4585,4458,127,4830,4588,183,4832,4595,216,4584,4449,135,4137,3905,168,3955,3587,281
1312100003F,1103,928,175,1112,957,146,1075,909,166,1498,1208,254,1392,1172,220,1486,1192,239,1503,1253,242,1393,1160,233,1179,933,174,1137,806,250
131210SC11B,864,833,31,876,856,18,823,796,27,1007,952,42,995,970,25,1015,957,42,1018,959,51,995,969,26,966,930,24,898,805,75
1312100006F,1712,1381,331,1753,1476,259,1704,1407,297,2056,1624,382,1974,1633,341,2044,1635,356,2066,1726,306,1974,1606,368,1843,1455,281,1798,1184,511
13115000035,249,48,201,254,36,217,249,43,206,333,53,274,304,52,252,335,61,270,337,55,280,304,51,253,284,40,237,266,40,214
1307500000M,527,87,440,532,76,452,521,80,441,636,114,512,578,108,470,632,107,511,645,119,521,578,110,468,549,93,446,519,77,422
13207000013,605,138,467,623,137,480,583,135,448,804,196,586,698,181,517,791,193,582,811,200,600,699,179,520,624,168,439,585,127,430
13207000004,460,134,326,471,124,338,441,118,323,567,151,399,499,147,352,568,162,393,573,152,415,501,146,355,428,107,315,408,97,296
13245000307,1006,346,660,1027,364,650,987,346,641,1202,439,735,1112,408,704,1197,446,719,1199,472,702,1109,403,706,1078,392,655,1028,297,693
1307900001B,576,332,244,611,363,246,559,329,230,714,402,301,627,378,249,708,411,291,722,411,308,626,373,253,624,389,225,572,322,241
13019001819,320,22,298,330,19,309,318,22,296,387,36,340,348,31,317,396,40,346,389,32,352,345,31,314,344,24,312,332,22,293
13019001427,324,22,302,324,15,309,318,21,297,386,37,342,347,32,315,367,33,332,391,35,354,346,32,314,342,25,313,329,25,291
13031000001,430,119,311,444,124,317,424,116,308,536,150,376,484,144,340,530,145,372,538,150,385,484,142,342,422,124,291,381,95,273
13191000022,1316,338,978,1338,332,996,1298,326,972,1633,396,1201,1516,389,1127,1611,384,1194,1646,414,1213,1516,389,1127,1402,358,1009,1341,290,998
13139000016,3024,563,2461,3085,542,2515,2992,535,2457,4226,759,3357,3656,725,2931,4215,758,3394,4258,799,3391,3659,708,2951,3331,514,2724,3205,452,2575
13219000002,1226,356,870,1249,348,885,1220,347,873,1664,472,1153,1550,485,1065,1648,465,1152,1676,518,1135,1550,473,1077,1211,333,837,1188,269,863
13139000010,2916,839,2077,2972,856,2083,2846,795,2051,3894,1127,2651,3336,1003,2333,3860,1097,2665,3930,1178,2695,3335,1001,2334,3127,797,2228,2992,652,2179
131210011E2,485,472,13,495,485,10,464,454,10,602,569,18,570,563,7,605,576,19,608,581,24,568,560,8,509,496,6,475,411,45
131210012E1,559,522,37,590,569,20,535,510,25,719,637,58,670,637,33,725,647,61,738,671,64,667,633,34,608,574,26,560,492,58
131210SS19B,1204,821,383,1224,853,360,1173,809,364,1677,1161,473,1458,1031,427,1671,1151,459,1693,1222,443,1460,1020,440,1311,909,334,1262,735,470
1312100SS22,1568,892,676,1608,939,648,1541,878,663,1766,1022,704,1635,958,677,1761,1016,696,1792,1082,691,1636,953,683,1693,983,655,1613,775,778
131210002L2,770,624,146,782,657,115,763,637,126,1532,1242,269,1431,1220,211,1496,1213,248,1546,1314,222,1430,1208,222,733,575,130,702,456,197
13285000007,1905,385,1520,1937,342,1577,1873,342,1531,2419,423,1951,2155,413,1742,2399,439,1926,2426,443,1958,2151,410,1741,2113,399,1660,2003,334,1583
13129001235,623,105,518,638,84,548,618,90,528,894,107,761,782,101,681,888,115,757,910,116,790,782,101,681,665,95,552,624,92,488
13057000037,3646,1023,2623,3717,1043,2615,3611,1023,2588,5071,1477,3433,4464,1415,3049,5028,1486,3384,5113,1599,3429,4461,1395,3066,4031,913,2912,3899,757,2897
13117000008,5081,1151,3930,5154,1184,3895,5061,1139,3922,6377,1698,4511,5922,1711,4211,6351,1718,4454,6438,1870,4445,5923,1653,4270,5634,1173,4226,5483,925,4262
13215FTBEN4,0,0,0,0,0,0,0,0,0,0,0,0,0,0,0,0,0,0,0,0,0,0,0,0,0,0,0,0,0,0
13215FTBEN3,0,0,0,0,0,0,0,0,0,0,0,0,0,0,0,0,0,0,0,0,0,0,0,0,0,0,0,0,0,0
13077000012,1628,365,1263,1653,352,1288,1598,334,1264,2169,494,1612,1909,482,1427,2138,510,1580,2185,516,1644,1910,471,1439,1807,387,1360,1720,334,1303
13117000002,3831,2020,1811,3886,2070,1761,3781,1999,1782,4440,2233,2096,3958,2101,1857,4392,2190,2073,4486,2325,2085,3953,2092,1861,3794,1745,1856,3665,1444,1999
13063000FP1,1265,1033,232,1294,1057,222,1223,996,227,1547,1202,287,1394,1162,232,1552,1193,288,1565,1227,314,1392,1163,229,1318,1014,267,1222,868,305
1306300JB02,2127,2026,101,2175,2087,81,2068,1983,85,2545,2331,167,2385,2289,96,2553,2355,140,2565,2385,155,2383,2286,97,2167,2024,108,2024,1790,193
13063000FP4,782,537,245,804,551,249,757,518,239,1003,649,326,902,619,283,993,646,303,1018,655,347,904,625,279,877,573,282,818,496,284
13255000020,1263,225,1038,1291,206,1068,1233,204,1029,1478,221,1228,1324,220,1104,1483,231,1223,1499,238,1252,1324,220,1104,1324,219,1085,1248,188,1008
1305106-03C,1509,869,640,1542,895,637,1467,842,625,1960,1131,794,1804,1087,717,1930,1123,761,1967,1170,772,1806,1079,727,1572,871,647,1475,744,676
13113000001,1777,1234,543,1818,1274,532,1745,1216,529,2077,1451,592,2000,1456,544,2066,1447,580,2101,1490,598,1999,1446,553,1899,1215,628,1809,1075,686
130450714A5,1328,564,764,1354,557,767,1312,547,765,1749,693,994,1544,665,879,1747,717,969,1775,739,994,1541,650,891,1359,539,734,1307,467,747
13127003723,974,282,692,1000,290,706,945,270,675,1295,370,891,1115,340,775,1274,359,876,1310,382,908,1112,339,773,1061,262,774,981,230,708
133130000NI,1270,189,1081,1301,181,1112,1248,179,1069,1702,270,1393,1495,263,1232,1668,242,1384,1723,278,1430,1497,259,1238,1422,222,1164,1289,207,1027
13095000002,1630,989,641,1648,993,646,1569,942,627,1915,1170,700,1702,1091,611,1918,1188,691,1943,1202,718,1702,1089,613,1732,972,720,1642,883,701
13177000007,861,171,690,868,164,698,835,157,678,1239,317,906,1124,292,832,1225,312,892,1248,314,920,1123,292,831,823,115,691,787,105,667
13045000715,878,182,696,890,182,701,862,166,696,1109,237,840,1043,253,790,1100,253,828,1120,254,847,1043,241,802,910,191,705,875,155,676
13095000004,2501,1173,1328,2530,1198,1328,2439,1131,1308,2910,1473,1405,2746,1432,1314,2912,1470,1401,2933,1526,1389,2750,1431,1319,2730,1213,1462,2624,1083,1488
13177000006,2545,661,1884,2570,655,1897,2490,636,1854,3112,900,2155,2915,885,2030,3089,902,2138,3129,946,2157,2915,888,2027,2591,635,1907,2503,556,1896
13113000011,959,334,625,974,334,626,938,319,619,1261,452,783,1185,449,736,1242,451,753,1266,471,775,1183,448,735,1056,316,687,1010,271,676
13255000017,927,333,594,947,330,612,901,316,585,1148,393,725,1022,382,640,1140,408,708,1161,397,755,1021,376,645,1035,347,672,965,296,628
13135000007,2941,1595,1346,2971,1637,1278,2874,1571,1303,3836,2190,1548,3487,2126,1361,3750,2163,1491,3848,2301,1479,3483,2097,1386,2916,1469,1309,2792,1201,1464
13231000004,922,149,773,940,143,789,910,141,769,1161,171,965,1067,175,892,1155,180,953,1172,181,980,1067,173,894,970,176,770,931,168,716
1306300RD09,1332,1211,121,1360,1241,114,1280,1165,115,1535,1326,187,1456,1315,141,1546,1344,175,1556,1355,194,1456,1315,141,1400,1231,147,1295,1078,187
13113000012,861,252,609,873,266,592,855,254,601,1079,370,671,1032,370,662,1074,371,662,1093,424,647,1032,368,664,955,277,634,927,219,664
13113000006,1058,642,416,1080,652,415,1038,632,406,1309,816,465,1221,800,421,1303,810,470,1325,825,478,1219,797,422,1082,562,493,1047,501,506
13063000MO3,2149,1825,324,2202,1891,305,2084,1781,303,2792,2196,520,2559,2155,404,2771,2167,507,2826,2243,557,2557,2162,395,2211,1833,338,2081,1635,399
13135000135,1745,681,1064,1777,700,1050,1729,678,1051,2414,986,1371,2113,934,1179,2361,947,1342,2425,1014,1383,2114,934,1180,1887,619,1183,1823,524,1206
13135000148,1026,491,535,1047,498,540,1007,479,528,1289,647,601,1184,630,554,1269,644,585,1297,652,626,1184,624,560,1111,468,587,1070,377,633
1305105-07C,837,640,197,849,645,193,812,618,194,1049,769,243,925,705,220,1041,773,243,1068,791,261,924,701,223,934,689,215,899,625,232
13073000026,1193,465,728,1213,470,731,1166,441,725,1776,690,1018,1520,634,886,1753,694,1002,1792,731,1008,1519,628,891,1182,407,711,1108,338,716
13073000065,1478,410,1068,1501,420,1065,1459,406,1053,1859,543,1269,1677,531,1146,1846,542,1272,1869,570,1268,1677,528,1149,1573,396,1109,1505,329,1115
13135000111,1608,872,736,1635,893,722,1584,858,726,2073,1103,910,1922,1076,846,2029,1098,889,2098,1167,894,1921,1069,852,1621,784,779,1569,656,842
130890000TG,1110,498,612,1125,526,579,1098,501,597,1296,619,646,1222,631,591,1295,624,631,1298,674,609,1223,606,617,1145,482,588,1120,340,708
13073000132,1402,383,1019,1418,384,1025,1385,379,1006,1901,552,1309,1731,510,1221,1889,532,1312,1911,578,1304,1734,519,1215,1776,423,1301,1715,341,1316
13073000135,1314,310,1004,1327,323,987,1292,315,977,1661,463,1175,1530,441,1089,1653,459,1162,1665,499,1138,1533,437,1096,1411,324,1016,1375,270,1055
13321000003,483,84,399,496,81,415,479,78,401,593,110,480,521,102,419,589,106,478,599,112,485,523,104,419,531,93,436,496,90,397
1306300RD12,1572,1471,101,1604,1509,91,1503,1405,98,1873,1686,147,1747,1632,115,1873,1699,140,1890,1694,175,1750,1634,116,1661,1526,115,1522,1324,162
1313100000D,300,104,196,307,113,193,292,98,194,357,113,239,334,107,227,351,116,230,362,119,242,333,106,227,327,118,202,302,109,189
1306700MR2B,2547,1484,1063,2573,1528,1017,2505,1462,1043,3095,1833,1184,2856,1739,1117,3098,1867,1161,3122,1920,1145,2853,1710,1143,2673,1495,1071,2621,1275,1226
13135000061,1376,646,730,1398,643,738,1349,613,736,1672,842,793,1531,825,706,1633,834,770,1672,860,793,1533,811,722,1512,633,821,1418,529,820
13135000094,1603,580,1023,1623,591,1013,1576,560,1016,1987,797,1139,1825,781,1044,1965,796,1123,1990,831,1128,1826,768,1058,1759,506,1196,1701,418,1216
130890000RG,1661,1548,113,1694,1597,86,1572,1467,105,1916,1742,123,1845,1750,95,1920,1761,123,1938,1780,138,1843,1737,106,1706,1561,108,1611,1391,169
13135000014,2260,970,1290,2289,986,1269,2193,938,1255,2766,1310,1388,2567,1303,1264,2727,1316,1341,2768,1396,1321,2568,1270,1298,2334,889,1324,2279,729,1405
13135000143,2679,1601,1078,2730,1658,1038,2606,1548,1058,3475,2143,1268,3208,2100,1108,3403,2103,1234,3493,2201,1258,3216,2079,1137,2895,1601,1189,2753,1336,1319
130890000KE,1339,1256,83,1366,1303,54,1300,1234,66,1494,1359,101,1455,1370,85,1502,1371,97,1507,1387,105,1454,1357,97,1278,1193,46,1225,1051,123
13135000005,1738,793,945,1765,783,963,1701,755,946,2135,991,1100,1941,973,968,2112,997,1068,2139,1041,1062,1941,953,988,1828,755,1011,1769,641,1056
131810004-B,801,134,667,818,125,689,797,135,662,974,177,777,918,174,744,964,180,766,979,185,785,916,176,740,844,142,682,797,118,656
131810003-A,296,110,186,309,110,197,286,100,186,360,126,225,323,120,203,353,126,222,362,128,232,323,120,203,331,118,209,314,102,201
13195000POC,619,82,537,630,74,549,598,76,522,821,113,677,724,101,623,817,118,677,833,115,704,722,101,621,676,88,571,632,93,513
13135000114,2147,1264,883,2170,1288,836,2083,1229,854,2826,1619,1112,2531,1522,1009,2773,1622,1059,2834,1711,1069,2533,1503,1030,2206,1250,859,2121,1021,986
13135000113,802,516,286,826,536,283,772,494,278,1095,660,402,1004,664,340,1072,657,387,1104,665,420,1006,666,340,879,548,295,807,461,305
13135000083,2296,1242,1054,2333,1267,1030,2239,1205,1034,3048,1634,1326,2669,1513,1156,2996,1577,1317,3065,1658,1355,2668,1508,1160,2477,1165,1165,2337,983,1206
1306700LM03,3421,1171,2250,3473,1199,2224,3389,1160,2229,4347,1611,2640,4104,1641,2463,4357,1630,2644,4390,1735,2588,4104,1615,2489,3567,1081,2345,3507,887,2450
1306700BW01,1612,806,806,1634,824,776,1595,813,782,2051,1069,914,1871,1031,840,2029,1060,902,2063,1113,908,1872,1030,842,1746,769,876,1689,636,934
1313100000P,490,154,336,501,163,337,472,147,325,667,204,450,544,170,374,660,196,442,678,211,462,544,168,376,529,158,363,481,145,322
13057000023,2675,839,1836,2721,852,1810,2638,850,1788,3681,1213,2332,3200,1140,2060,3661,1192,2327,3727,1268,2380,3199,1126,2073,3004,758,2060,2882,692,1976
13077000024,435,303,132,439,299,136,409,279,130,528,336,177,478,334,144,529,350,169,539,343,189,479,333,146,480,317,149,450,267,167
13251000009,474,105,369,499,104,393,471,103,368,621,146,469,564,144,420,600,133,461,625,145,475,564,144,420,555,120,420,534,105,413
130910MILAN,199,38,161,215,34,179,201,37,164,229,43,185,218,41,177,227,42,183,231,41,189,217,42,175,214,43,170,179,30,143
130910MCCRA,219,31,188,227,30,196,212,29,183,229,37,191,211,33,178,225,36,187,230,39,190,211,34,177,212,31,176,198,30,164
13269000001,601,491,110,622,509,107,565,459,106,671,523,130,635,550,85,671,545,115,681,555,119,632,546,86,659,549,99,579,445,129
13273000004,283,113,170,291,111,180,277,100,177,318,111,202,299,109,190,317,109,206,321,114,206,299,111,188,302,116,183,286,90,192
13071000021,136,12,124,145,10,135,133,8,125,173,14,158,158,18,140,173,15,158,176,17,159,158,18,140,146,17,128,134,15,116
13151000050,3084,1776,1308,3142,1827,1294,3030,1756,1274,3582,2119,1400,3362,2107,1255,3590,2143,1371,3630,2191,1414,3366,2098,1268,3328,1698,1528,3126,1501,1498
13275000119,725,659,66,756,695,61,699,637,62,870,769,90,816,752,64,859,764,74,888,811,71,814,749,65,845,770,69,748,650,88
1312100SS01,3205,1252,1953,3251,1320,1893,3180,1256,1924,3880,1599,2213,3717,1586,2131,3848,1635,2154,3896,1807,2038,3723,1538,2185,3342,1305,1900,3307,893,2298
1312100RW20,1767,781,986,1792,815,943,1739,774,965,2189,1039,1108,2059,1034,1025,2168,1058,1067,2193,1119,1045,2060,1015,1045,2000,869,1039,1972,670,1201
131210010H1,235,229,6,238,237,1,225,223,2,278,266,7,249,247,2,281,274,4,281,269,8,249,247,2,220,214,3,209,188,14
1312100RW13,2423,1139,1284,2465,1187,1232,2396,1136,1260,2968,1445,1447,2775,1431,1344,2923,1456,1385,2969,1583,1329,2774,1402,1372,2505,1061,1286,2469,829,1503
13161000501,785,124,661,819,112,705,792,115,677,949,126,801,872,122,750,940,130,789,959,127,821,872,128,744,850,113,724,795,114,662
1322900004D,187,6,181,191,4,187,187,4,183,227,3,221,207,1,206,221,5,216,228,4,224,207,1,206,194,4,189,181,4,175
13039000011,1475,638,837,1495,636,832,1454,634,820,2100,793,1206,1703,732,971,2065,791,1172,2128,845,1222,1705,738,967,1773,620,1075,1650,548,990
1312100AP06,1281,476,805,1303,514,762,1272,477,795,1597,619,948,1481,630,851,1565,619,905,1603,695,888,1483,606,877,1302,485,735,1279,329,893
1312100RW17,1736,1055,681,1765,1079,642,1703,1048,655,2154,1298,774,1982,1227,755,2128,1277,770,2169,1351,765,1981,1208,773,1742,972,660,1708,787,788
1312100JC19,2485,1229,1256,2522,1277,1190,2446,1225,1221,3191,1696,1421,3009,1637,1372,3166,1685,1390,3215,1794,1362,3011,1613,1398,2633,1251,1239,2560,976,1441
131210RW22B,0,0,0,0,0,0,0,0,0,0,0,0,0,0,0,0,0,0,0,0,0,0,0,0,0,0,0,0,0,0
131210SC29B,0,0,0,0,0,0,0,0,0,0,0,0,0,0,0,0,0,0,0,0,0,0,0,0,0,0,0,0,0,0
13115000115,514,75,439,522,63,456,516,66,450,632,76,547,573,80,493,624,86,531,634,87,541,572,79,493,538,61,464,514,58,442
13055000968,529,108,421,549,94,452,522,111,411,656,111,530,570,106,464,648,109,524,663,109,551,570,108,462,561,93,451,533,108,414
1312100008P,907,732,175,924,768,147,903,736,167,1142,895,212,1028,842,186,1128,894,199,1149,946,186,1027,824,203,851,633,168,836,532,246
1312100006Q,294,270,24,295,271,22,289,264,25,345,315,23,295,277,18,343,312,23,348,324,22,295,276,19,288,243,35,283,222,50
131210SC16B,15,15,0,15,15,0,15,14,1,17,16,1,8,7,1,17,16,1,17,16,1,8,7,1,0,0,0,0,0,0
1312100SC20,1650,1600,50,1664,1631,26,1612,1577,35,2032,1957,53,1951,1905,46,2031,1956,56,2033,1964,55,1950,1904,46,1548,1480,48,1493,1372,96
131210UC01A,1690,1613,77,1714,1653,58,1604,1537,67,1967,1824,92,1784,1725,59,1981,1838,100,1997,1859,120,1783,1722,61,1819,1698,81,1684,1519,120
131210SC08E,307,301,6,314,312,2,293,291,2,438,420,7,415,410,5,437,422,10,439,413,17,414,408,6,281,274,1,268,257,8
131210012E2,0,0,0,0,0,0,0,0,0,0,0,0,0,0,0,0,0,0,0,0,0,0,0,0,0,0,0,0,0,0
131210CP083,25,25,0,25,25,0,23,23,0,37,34,3,37,36,1,35,33,2,37,36,0,37,36,1,85,83,1,78,71,4
13189000137,667,109,558,677,109,568,659,101,558,787,139,634,709,130,579,780,144,625,792,146,638,711,132,579,714,116,587,664,109,542
131210SC16A,3161,3075,86,3201,3136,58,3081,3008,73,3696,3573,91,3545,3482,63,3713,3596,90,3725,3600,108,3543,3474,69,2960,2873,63,2834,2627,160
13245000705,1450,620,830,1465,632,821,1422,616,806,1668,711,929,1558,670,888,1663,717,923,1678,732,928,1555,664,891,1583,624,909,1527,539,949
13253000003,488,402,86,498,417,77,454,374,80,615,498,111,552,484,68,598,478,103,624,530,89,551,481,70,598,501,92,533,427,101
13033000006,201,117,84,208,123,84,195,113,82,259,141,111,228,121,107,259,135,118,263,141,119,227,121,106,224,127,92,211,115,92
1312100CH03,244,92,152,250,87,162,240,87,153,308,96,203,299,98,201,307,100,200,309,98,208,300,97,203,261,90,163,246,78,155
131210SC23B,281,269,12,283,276,7,270,261,9,347,315,22,315,307,8,353,325,19,358,334,22,315,306,9,303,294,8,289,266,17
1312100009I,476,455,21,499,486,12,455,440,15,601,548,34,579,554,25,608,556,34,605,563,35,581,551,30,533,518,10,486,417,56
1312100007H,1385,710,675,1418,794,613,1377,736,641,1648,921,698,1578,910,668,1638,944,669,1658,1025,621,1577,881,696,1415,775,589,1421,530,837
13033000003,406,224,182,420,225,194,389,207,182,465,227,229,434,226,208,466,239,224,477,242,232,435,225,210,440,247,191,399,209,183
13245000701,1567,566,1001,1610,573,1010,1546,554,992,1822,665,1120,1698,637,1061,1812,668,1106,1829,710,1087,1699,627,1072,1678,566,1049,1638,464,1114
13245000105,358,338,20,373,359,14,348,333,15,540,488,37,514,490,24,540,496,34,550,511,34,515,492,23,400,384,12,355,314,34
131210SS02A,745,432,313,753,438,303,733,431,302,906,519,367,858,522,336,912,537,354,915,564,331,860,514,346,773,414,316,762,303,405
1312100SS17,2191,1037,1154,2222,1085,1109,2150,1019,1131,2728,1353,1333,2568,1303,1265,2705,1371,1281,2748,1471,1253,2570,1276,1294,2342,1089,1169,2316,812,1390
1312100SS20,1138,744,394,1156,765,375,1113,727,386,1520,1020,471,1360,947,413,1503,1003,457,1531,1059,449,1362,944,418,1180,742,393,1124,589,491
1312100005D,90,86,4,93,87,5,89,85,4,93,88,4,73,66,7,92,83,3,93,85,6,73,67,6,128,117,8,126,108,12
13245000304,248,100,148,252,104,143,245,94,151,275,95,171,264,100,164,272,100,162,275,112,158,264,102,162,279,100,165,274,86,172
13139000017,2138,365,1773,2177,365,1787,2116,351,1765,2900,554,2261,2490,520,1970,2893,553,2278,2919,598,2273,2491,498,1993,2283,361,1849,2187,296,1769
13139000008,2220,377,1843,2255,349,1866,2173,342,1831,3011,537,2383,2628,495,2133,3001,531,2406,3036,572,2419,2629,482,2147,2343,327,1949,2239,276,1814
13245000201,625,598,27,645,628,15,592,570,22,784,721,41,696,679,17,776,729,36,793,749,34,695,678,17,747,721,22,679,601,65
13139000018,2069,398,1671,2102,390,1690,2042,386,1656,2613,505,2054,2434,502,1932,2605,499,2057,2631,549,2054,2435,497,1938,2162,371,1734,2068,304,1670
13139000001,3360,935,2425,3412,938,2442,3289,888,2401,4205,1169,2940,3877,1166,2711,4208,1184,2951,4241,1287,2913,3882,1144,2738,3217,840,2279,3079,691,2247
1312100003T,699,668,31,714,696,15,673,643,30,828,755,44,764,738,26,828,763,43,836,781,44,760,730,30,767,718,32,733,631,66
1300700000A,87,22,65,96,21,75,82,17,65,122,28,94,117,29,88,121,31,89,124,31,93,117,29,88,105,32,73,91,17,71
1306300RD07,1052,928,124,1074,958,114,1008,883,125,1336,1107,196,1168,1011,157,1335,1120,176,1352,1122,213,1168,1011,157,1046,901,134,964,771,153
13113000021,1227,442,785,1249,453,773,1205,430,775,1530,585,898,1400,583,817,1513,582,880,1541,623,884,1396,571,825,1368,493,810,1319,394,848
13113000031,2363,779,1584,2397,814,1542,2357,789,1568,2824,1032,1727,2680,999,1681,2780,1007,1707,2828,1105,1677,2678,975,1703,2561,789,1655,2501,600,1779
130450714A6,848,285,563,862,283,557,829,272,557,1133,389,717,990,372,618,1128,390,708,1140,407,708,987,364,623,889,321,535,869,257,569
1317101712C,395,64,331,402,66,334,391,62,329,465,70,378,444,80,364,468,87,374,473,80,389,443,78,365,414,75,329,392,75,298
13057000009,3051,672,2379,3110,708,2370,3033,680,2353,4134,1037,2995,3637,979,2658,4108,1036,2978,4171,1123,2996,3638,953,2685,3430,707,2597,3308,538,2624
13009001714,568,232,336,583,224,356,552,216,336,699,271,407,628,268,360,691,273,402,709,275,426,625,267,358,613,219,386,577,201,357
13057000033,375,50,325,388,47,337,370,51,319,518,65,439,489,68,421,515,64,441,528,69,454,488,69,419,434,43,376,418,44,350
13057000028,1930,474,1456,1962,466,1464,1913,458,1455,2434,606,1731,2229,612,1617,2404,589,1739,2454,653,1755,2229,600,1629,2098,432,1566,2040,358,1564
1305106-02C,1521,651,870,1561,664,874,1500,633,867,1792,748,1006,1708,733,975,1773,734,1003,1799,771,996,1710,731,979,1629,669,914,1563,527,993
13073000125,1237,467,770,1263,466,776,1219,446,773,1642,631,972,1444,588,856,1625,618,971,1658,649,984,1445,591,854,1412,486,876,1331,398,872
13135000022,1256,633,623,1281,632,626,1236,627,609,1653,813,793,1593,832,761,1643,829,782,1649,889,741,1593,808,785,1287,623,613,1248,481,687
13135000138,2675,1245,1430,2721,1290,1408,2630,1216,1414,3802,1888,1866,3442,1757,1685,3634,1750,1825,3833,1986,1825,3443,1753,1690,2783,1216,1508,2670,912,1690
13135000009,3135,1002,2133,3184,1009,2134,3084,990,2094,4475,1467,2893,3957,1395,2562,4417,1455,2831,4494,1562,2851,3960,1383,2577,3135,881,2146,3046,730,2172
13135000051,1072,920,152,1095,935,151,1044,890,154,1467,1156,262,1272,1088,184,1438,1157,235,1480,1200,265,1269,1088,181,1177,975,172,1095,843,204
130890000DH,1738,1402,336,1771,1485,269,1737,1429,308,1727,1362,338,1664,1355,309,1719,1376,318,1734,1431,285,1666,1339,327,1913,1566,279,1876,1306,508
130890000RN,1213,1076,137,1237,1115,105,1201,1067,134,1392,1234,134,1348,1228,120,1375,1228,122,1398,1275,105,1352,1212,140,1221,1071,99,1205,948,200
1311100COLW,696,130,566,708,111,588,679,120,559,864,147,708,810,152,658,858,150,697,865,150,711,809,149,660,697,122,562,663,116,515
13045001371,803,165,638,817,143,667,788,150,638,1078,183,874,919,166,753,1072,190,864,1085,188,886,918,164,754,830,149,655,786,143,603
132470000BA,2882,1712,1170,2921,1740,1161,2838,1678,1160,3483,2163,1254,3228,2116,1112,3470,2183,1233,3512,2204,1274,3229,2109,1120,3150,1659,1396,3066,1517,1459
13135000046,1121,416,705,1143,428,695,1094,414,680,1429,642,749,1331,625,706,1395,633,729,1433,660,755,1332,620,712,1244,400,785,1195,323,809
13135000117,1803,1490,313,1829,1517,293,1729,1429,300,2473,1895,494,2076,1740,336,2404,1858,481,2490,1948,514,2077,1734,343,2000,1533,392,1846,1307,447
13077000011,1898,382,1516,1920,364,1532,1860,352,1508,2348,484,1812,2104,466,1638,2340,475,1813,2374,494,1848,2104,467,1637,1998,379,1557,1885,343,1450
13077000008,3298,719,2579,3341,724,2577,3259,711,2548,4294,963,3229,3921,930,2991,4266,982,3188,4334,1025,3258,3923,910,3013,3483,655,2712,3373,547,2680
130890000SU,1944,1860,84,1979,1910,64,1878,1812,66,2168,2025,97,2089,2018,71,2180,2062,86,2187,2064,106,2090,2016,74,2003,1896,89,1892,1708,141
130890000RJ,1139,1047,92,1161,1077,81,1102,1011,91,1292,1163,100,1266,1169,97,1290,1169,101,1302,1182,112,1266,1172,94,1175,1047,107,1098,918,144
130890000KD,2994,2907,87,3033,2972,54,2890,2824,66,3612,3451,112,3516,3442,74,3613,3466,94,3631,3499,116,3515,3436,79,2878,2784,63,2767,2561,163
130890000FM,1630,1490,140,1670,1532,133,1562,1428,134,1871,1653,182,1763,1624,139,1868,1674,160,1889,1683,193,1764,1620,144,1717,1531,161,1627,1386,199
13299000405,342,24,318,347,18,329,331,21,310,475,21,448,410,15,395,469,23,440,479,23,454,410,15,395,388,25,359,359,30,320
1305103-15C,483,237,246,491,242,240,469,232,237,643,338,292,611,329,282,640,345,284,647,361,278,610,329,281,531,253,265,511,207,292
13231000007,1085,129,956,1102,111,983,1071,116,955,1407,154,1232,1270,148,1122,1399,153,1223,1420,160,1244,1270,141,1129,1054,118,917,1012,114,861
13199000006,705,352,353,719,350,363,683,334,349,905,406,488,819,395,424,903,414,479,912,409,492,821,397,424,721,368,344,677,333,322
13097000739,2560,1519,1041,2577,1541,1017,2516,1505,1011,3059,1940,1058,2883,1943,940,3069,1963,1055,3103,2009,1056,2883,1928,955,2686,1404,1200,2600,1250,1280
13097001272,3202,1226,1976,3241,1240,1965,3166,1214,1952,3908,1663,2146,3532,1609,1923,3892,1671,2143,3932,1702,2182,3532,1599,1933,3468,1155,2217,3366,1015,2221
13135000129,3009,915,2094,3053,942,2071,2962,905,2057,4259,1475,2667,3795,1450,2345,4185,1470,2619,4274,1560,2641,3795,1424,2371,2996,769,2119,2888,613,2112
1330500001B,706,55,651,719,39,678,695,48,647,907,76,816,794,54,740,892,68,814,912,64,845,792,58,734,728,40,681,682,51,613
13073000120,1155,270,885,1177,278,883,1146,266,880,1384,351,1001,1283,344,939,1382,344,1004,1404,378,1007,1283,348,935,1301,284,964,1243,224,964
13073000108,1178,332,846,1194,345,830,1161,330,831,1412,432,943,1323,430,893,1411,437,936,1428,475,931,1323,424,899,1313,345,920,1278,275,945
13073000130,1496,437,1059,1517,435,1067,1477,433,1044,1806,544,1231,1628,506,1122,1790,537,1216,1822,570,1232,1629,503,1126,1645,411,1170,1567,343,1165
130890000MZ,1414,1373,41,1442,1418,23,1350,1317,33,1769,1666,61,1617,1579,38,1780,1695,57,1789,1700,70,1616,1578,38,1507,1450,40,1431,1326,70
1305107-15C,1079,721,358,1096,720,358,1054,698,356,1538,965,529,1367,911,456,1533,962,532,1550,974,546,1367,914,453,396,258,127,372,226,132
130890000WC,2392,2175,217,2444,2255,158,2352,2147,205,2950,2611,271,2844,2606,238,2943,2594,274,2963,2680,236,2846,2587,259,2299,2021,171,2245,1812,279
13135000142,2149,1016,1133,2186,1060,1088,2129,1020,1109,2952,1478,1412,2623,1403,1220,2861,1427,1370,2966,1550,1375,2620,1382,1238,2351,1056,1172,2267,863,1280
13135000120,695,450,245,712,461,242,668,435,233,895,538,325,796,529,267,873,524,306,899,561,321,794,520,274,720,416,285,689,349,299
13135000004,866,449,417,875,456,402,858,440,418,1252,653,548,1080,601,479,1226,660,531,1255,680,549,1082,583,499,951,437,468,914,364,502
130890000FA,2152,2097,55,2197,2156,38,2070,2018,52,2790,2645,88,2540,2484,56,2794,2665,86,2815,2692,103,2542,2488,54,2345,2253,62,2218,2057,123
130890000WN,2199,2061,138,2223,2110,108,2136,2021,115,2546,2363,143,2456,2347,109,2554,2383,137,2567,2394,162,2455,2336,119,2240,2079,128,2155,1904,210
130890000WA,1557,1501,56,1591,1557,32,1496,1445,51,1893,1781,70,1790,1739,51,1897,1795,68,1922,1825,82,1784,1725,59,1608,1543,39,1507,1320,140
13135000124,1321,958,363,1345,981,349,1286,937,349,1743,1191,506,1557,1138,419,1705,1177,496,1756,1231,502,1554,1138,416,1416,936,433,1345,831,457
130890000AD,1882,716,1166,1909,793,1090,1856,733,1123,2203,949,1225,2112,945,1167,2181,978,1170,2212,1077,1104,2112,911,1201,1941,786,1065,1926,496,1364
13195000PAO,173,24,149,178,23,154,168,23,145,219,27,191,200,26,174,218,28,187,219,27,191,200,26,174,168,19,145,164,20,136
1306700GM01,1898,833,1065,1921,844,1046,1898,853,1045,2330,1023,1245,2202,1011,1191,2330,1020,1236,2353,1105,1211,2201,985,1216,1970,761,1119,1907,579,1233
1306700RW01,3661,1471,2190,3700,1517,2131,3646,1471,2175,4555,1952,2511,4365,1954,2411,4534,1966,2477,4589,2141,2387,4367,1894,2473,4013,1534,2293,3989,1134,2692
1306700PR01,1556,643,913,1575,637,907,1529,619,910,2029,843,1114,1829,821,1008,2016,827,1111,2054,859,1138,1827,805,1022,1732,588,1043,1713,522,1089
1306300JB15,1109,988,121,1121,1014,103,1078,963,115,1292,1116,134,1134,1027,107,1303,1129,138,1314,1154,144,1135,1025,110,1212,1052,129,1137,938,155
1306300OAK4,1751,1682,69,1787,1732,48,1684,1620,64,2164,1997,116,2072,1999,73,2170,2006,116,2184,2031,137,2072,1997,75,1726,1639,59,1622,1448,120
1305107-13C,1592,570,1022,1610,567,1030,1567,546,1021,2070,750,1288,1998,730,1268,2062,726,1301,2091,775,1289,1998,728,1270,1716,547,1123,1660,449,1175
1305106-08C,1006,746,260,1032,769,251,976,728,248,1220,867,315,1112,837,275,1229,878,313,1254,906,332,1112,830,282,1156,802,315,1109,685,367
1331700004A,628,199,429,643,197,444,610,174,436,716,242,464,644,217,427,715,237,471,726,244,476,645,218,427,673,224,443,628,182,432
1306700EL05,1918,861,1057,1954,887,1035,1898,860,1038,2293,1076,1155,2158,1070,1088,2264,1086,1121,2303,1168,1103,2160,1050,1110,2055,861,1075,2017,694,1194
1306700LM04,1751,600,1151,1768,614,1136,1737,602,1135,2120,763,1318,1986,751,1235,2105,766,1301,2134,794,1313,1986,736,1250,1868,560,1239,1832,441,1294
131210SS15A,1174,1003,171,1196,1031,155,1160,996,164,1512,1237,234,1312,1143,169,1514,1248,226,1529,1273,238,1309,1136,173,1243,974,198,1194,882,237
1300900CTY4,249,147,102,258,156,97,246,148,98,287,166,113,232,144,88,286,168,104,288,169,113,232,141,91,314,167,127,298,135,146
1305900006B,2286,1409,877,2329,1435,865,2219,1364,855,2704,1694,941,2463,1634,829,2709,1689,950,2732,1763,922,2464,1617,847,2296,1389,833,2217,1206,924
1305900006D,1068,795,273,1087,808,259,1066,791,275,1250,911,307,1153,881,272,1231,901,302,1254,938,298,1152,875,277,1031,702,275,1026,640,329
13021000WA2,2039,773,1266,2076,762,1304,1989,737,1252,2453,882,1527,2207,856,1351,2440,876,1536,2473,877,1573,2205,855,1350,2079,706,1333,1978,632,1294
13197000339,503,58,445,512,40,467,487,44,443,670,73,583,592,69,523,665,71,577,674,67,600,592,66,526,577,69,499,542,72,458
13197000948,263,33,230,271,31,238,254,25,229,309,47,255,284,39,245,304,48,249,311,47,262,284,39,245,305,33,268,293,27,259
131210CP06A,201,197,4,207,203,3,190,185,5,236,216,15,211,206,5,231,215,13,234,214,14,212,207,5,227,213,12,204,181,21
131210CP07B,2,2,0,2,2,0,2,2,0,4,2,2,3,3,0,4,2,2,4,3,1,3,3,0,0,0,0,0,0,0
131210EP02D,185,176,9,191,186,5,186,176,10,245,234,10,248,244,4,245,235,7,246,233,12,248,244,4,149,133,14,143,117,21
1309900000B,1704,1014,690,1750,1060,686,1661,973,688,2246,1309,897,1979,1272,707,2168,1265,825,2299,1452,833,1978,1274,704,2075,1272,777,1914,1065,803
13151000047,2780,2321,459,2824,2391,428,2694,2261,433,3164,2632,481,3031,2617,414,3173,2658,461,3191,2685,491,3030,2601,429,2752,2222,483,2582,1982,532
13177000009,1820,553,1267,1847,541,1293,1782,513,1269,2274,753,1480,2010,690,1320,2264,744,1474,2296,777,1495,2010,685,1325,1929,494,1397,1843,444,1357
1312100JC14,1602,658,944,1626,704,910,1588,656,932,2091,946,1117,1979,923,1056,2068,947,1085,2103,1042,1040,1980,900,1080,1768,708,1000,1735,497,1199
13243000947,51,4,47,54,4,49,51,5,46,62,30,32,60,30,30,50,23,27,63,31,32,60,30,30,82,12,70,71,10,61
13031000002,1277,298,979,1303,294,1001,1252,277,975,1532,388,1125,1398,357,1041,1518,376,1114,1535,397,1126,1399,355,1044,1276,304,944,1243,240,970
13123000003,831,115,716,850,95,745,821,106,715,1195,157,1000,1063,162,901,1195,155,1011,1213,164,1036,1064,162,902,920,115,787,850,126,672
13021000HO6,1348,585,763,1372,577,777,1322,573,749,1615,706,884,1433,642,791,1618,704,890,1632,736,878,1433,635,798,1399,526,814,1337,441,854
131210010H2,995,957,38,1030,1014,14,937,911,26,1111,1033,39,1107,1081,26,1127,1064,38,1139,1083,50,1102,1075,27,1149,1095,31,1052,929,102
1312100004S,1063,1023,40,1111,1090,19,1034,1000,34,1242,1160,56,1213,1189,24,1252,1167,47,1260,1198,48,1210,1184,26,1157,1119,23,1069,962,87
1312100010C,1121,1086,35,1163,1149,10,1086,1061,25,1184,1116,34,1129,1117,12,1196,1137,34,1216,1153,52,1128,1110,18,1283,1259,15,1193,1096,78
13243000934,245,25,220,248,22,226,240,24,216,189,101,88,191,110,81,171,91,80,191,103,88,190,108,82,243,30,206,227,25,196
13033000008,171,66,105,173,65,107,170,67,103,196,80,112,174,67,107,192,76,112,199,81,116,173,68,105,172,72,94,160,66,90
1312100007B,2077,742,1335,2096,815,1256,2059,755,1304,2475,941,1497,2449,973,1476,2448,974,1436,2463,1154,1280,2450,909,1541,2149,899,1149,2153,516,1572
131210CP011,601,472,129,617,487,121,586,449,137,764,596,148,726,591,135,763,608,141,771,610,143,728,587,141,678,529,126,655,455,169
13139000009,2611,677,1934,2654,674,1943,2581,663,1918,3423,940,2384,2938,887,2051,3418,946,2396,3458,1005,2398,2940,874,2066,2806,653,2065,2656,538,1997
13245000707,1056,640,416,1063,638,416,1020,617,403,1364,831,493,1169,760,409,1350,834,486,1378,858,506,1169,753,416,1168,634,490,1111,557,506
13207000014,297,64,233,298,53,245,289,55,234,332,52,277,311,50,261,333,59,269,337,61,276,311,51,260,277,52,224,270,50,215
13207000002,769,101,668,779,93,676,757,91,666,932,124,790,870,124,746,915,123,779,943,136,796,868,125,743,698,92,592,686,74,588
131210SC08H,3,3,0,3,3,0,2,2,0,0,0,0,0,0,0,0,0,0,0,0,0,0,0,0,1,1,0,1,1,0
131210SC17B,4,3,1,4,3,1,4,3,1,5,4,1,0,0,0,5,4,1,5,4,1,0,0,0,0,0,0,0,0,0
131210002F1,1979,1693,286,2028,1782,216,1982,1721,261,2387,2001,331,2217,1927,290,2363,1970,312,2409,2092,280,2216,1908,308,2027,1704,216,1977,1433,416
1312100004V,1169,1135,34,1206,1192,12,1114,1096,18,1360,1266,50,1265,1238,27,1360,1278,54,1371,1288,69,1263,1237,26,1238,1201,20,1148,1036,81
1312100JC10,1474,884,590,1503,916,565,1450,880,570,1976,1194,718,1779,1149,630,1944,1182,698,1998,1246,725,1777,1144,633,1488,800,619,1435,631,717
1312100008C,963,289,674,982,327,642,958,293,665,1207,400,795,1210,422,788,1199,412,764,1202,506,691,1214,396,818,980,328,607,976,181,764
13245000601,1618,1221,397,1652,1252,390,1540,1161,379,2224,1614,530,1944,1503,441,2212,1652,517,2251,1693,523,1943,1498,445,1777,1259,478,1658,1113,491
131210JC13B,175,36,139,179,40,135,174,35,139,232,63,167,224,65,159,230,70,156,235,76,156,225,59,166,200,38,153,196,27,166
131210AP09A,2637,1313,1324,2680,1366,1275,2597,1317,1280,3447,1795,1573,3203,1760,1443,3409,1770,1539,3486,1933,1508,3212,1732,1480,2825,1324,1366,2769,1019,1617
1312100AP05,2928,1205,1723,2974,1267,1675,2896,1198,1698,3792,1761,1980,3627,1728,1899,3757,1742,1942,3820,1926,1856,3628,1704,1924,3177,1274,1792,3102,937,2076
131210JC04A,2640,1362,1278,2686,1449,1183,2613,1377,1236,3568,1944,1547,3385,1974,1411,3499,1916,1487,3592,2119,1432,3388,1912,1476,2944,1411,1382,2899,1054,1703
131210002L1,3904,3175,729,3971,3347,567,3891,3242,649,4978,4012,875,4614,3825,789,4903,3920,846,5015,4164,783,4623,3790,833,3715,2965,552,3617,2509,880
1312100008E,1835,701,1134,1858,766,1070,1820,724,1096,2174,903,1249,2107,918,1189,2170,928,1208,2185,1085,1079,2108,861,1247,1892,842,966,1909,531,1330
13245000401,1263,1188,75,1281,1219,58,1228,1159,69,1517,1376,109,1386,1322,64,1517,1392,94,1527,1424,94,1386,1318,68,1316,1234,67,1240,1113,107
13019001642,553,66,487,572,55,512,541,52,489,713,87,617,623,84,539,712,84,621,728,86,636,626,85,541,602,77,516,560,71,469
13013000009,1942,402,1540,1976,386,1571,1904,375,1529,2603,559,1948,2252,539,1713,2575,559,1949,2627,587,1994,2256,537,1719,2116,417,1634,2037,345,1599
13297000424,1938,305,1633,1974,298,1664,1917,300,1617,2583,476,2059,2329,445,1884,2565,471,2035,2599,498,2064,2327,441,1886,2145,262,1817,2050,228,1723
1312100004F,906,827,79,934,867,62,890,820,70,1261,1113,119,1120,1041,79,1267,1138,102,1275,1145,114,1120,1033,87,958,853,77,915,761,122
1312100RW06,1887,949,938,1909,994,884,1852,941,911,2299,1257,1000,2170,1222,948,2273,1236,969,2312,1335,934,2173,1212,961,1961,936,921,1926,733,1058
131210ML04B,827,244,583,838,255,576,824,245,579,1146,430,703,1087,409,678,1135,425,685,1151,462,678,1087,404,683,857,250,571,849,170,644
13129001054,786,87,699,804,71,728,768,74,694,1002,106,876,890,104,786,991,108,860,1012,116,891,888,102,786,842,84,738,798,87,663
130810CONEY,611,47,564,623,50,568,606,50,556,712,81,627,681,79,602,710,87,621,715,88,624,681,79,602,647,61,579,634,52,574
131210SS29B,2,1,1,1,1,0,2,1,1,2,1,1,2,1,1,1,1,0,2,1,1,2,1,1,2,1,1,2,1,1
13057000038,2532,453,2079,2568,474,2068,2505,450,2055,3439,649,2706,3240,640,2600,3403,675,2671,3453,712,2693,3238,607,2631,2602,436,2062,2529,298,2100
13057000029,2037,559,1478,2065,551,1480,2000,541,1459,2628,754,1804,2344,695,1649,2613,734,1794,2660,770,1847,2346,693,1653,2175,458,1624,2106,406,1564
13215000127,4236,1939,2297,4282,1945,2310,4082,1837,2245,5550,2587,2837,5166,2554,2612,5518,2618,2806,5607,2692,2837,5167,2545,2622,4463,1834,2505,4185,1548,2524
1317101712B,753,273,480,767,270,493,712,243,469,899,316,566,821,324,497,890,320,558,901,322,570,823,317,506,820,302,513,767,252,496
13097001259,1030,585,445,1045,600,442,1011,575,436,1275,731,517,1158,706,452,1275,749,508,1288,743,529,1160,703,457,1080,555,503,1043,526,496
131810004-A,362,56,306,366,59,304,358,54,304,412,72,332,380,67,313,417,66,344,417,72,340,380,68,312,393,56,329,377,55,308
13011000013,352,30,322,362,19,339,349,26,323,419,27,382,353,29,324,420,28,385,428,32,393,353,29,324,375,30,341,348,31,303
13105000192,227,41,186,235,33,200,225,34,191,293,48,243,280,48,232,296,47,244,302,55,247,281,48,233,261,52,205,246,48,190
13011000008,322,23,299,327,21,304,314,23,291,423,34,381,354,28,326,424,33,385,424,33,387,354,24,330,334,21,309,320,17,290
132470000HC,1495,707,788,1520,716,794,1473,678,795,1737,934,761,1646,941,705,1732,943,750,1750,968,762,1647,934,713,1557,625,883,1508,549,884
132470000HI,1951,1227,724,1980,1249,719,1899,1194,705,2446,1598,805,2271,1567,704,2434,1598,798,2462,1611,835,2270,1564,706,2017,1176,799,1938,1107,773
130890000ND,1040,691,349,1060,715,327,1038,706,332,1255,861,369,1215,879,336,1245,870,344,1260,909,323,1223,866,357,1073,690,319,1041,555,432
130890000MJ,1044,894,150,1060,926,121,1026,892,134,1235,1041,174,1085,956,129,1237,1029,178,1248,1067,168,1087,952,135,1154,967,142,1111,867,189
13113000025,1093,334,759,1105,337,758,1085,330,755,1284,440,821,1200,431,769,1276,446,808,1296,478,803,1198,421,777,1225,359,837,1212,288,870
13063000LJ1,2121,1847,274,2161,1895,255,2042,1788,254,2600,2214,334,2477,2210,267,2606,2257,303,2625,2249,352,2476,2205,271,2132,1777,314,1996,1574,370
13135000006,2080,1218,862,2116,1248,841,2026,1178,848,2739,1591,1075,2474,1561,913,2678,1577,1030,2759,1622,1101,2474,1547,927,2254,1215,940,2137,1037,996
13135000062,1661,617,1044,1679,667,989,1652,640,1012,2031,815,1167,1942,809,1133,1999,824,1140,2025,898,1089,1944,788,1156,1769,622,1040,1759,461,1224
13135000141,1688,590,1098,1712,593,1096,1675,570,1105,2218,842,1317,2013,804,1209,2174,799,1318,2239,891,1316,2014,801,1213,1842,610,1136,1755,482,1165
13135000125,1308,449,859,1325,483,824,1306,457,849,1626,636,956,1571,668,903,1605,652,909,1623,722,873,1571,639,932,1418,481,861,1419,327,1016
13057000043,2028,760,1268,2064,774,1234,1994,759,1235,2656,1008,1561,2408,995,1413,2617,987,1525,2684,1078,1553,2409,978,1431,2362,819,1411,2308,663,1496
13057000015,1779,562,1217,1807,574,1208,1766,544,1222,2352,775,1510,2113,756,1357,2331,785,1478,2369,836,1488,2113,732,1381,1992,490,1407,1941,401,1419
13135000037,1016,817,199,1030,835,182,980,792,188,1303,984,264,1100,891,209,1284,991,255,1314,1017,277,1098,882,216,1016,770,200,948,661,215
130890000SN,1148,849,299,1169,869,285,1149,858,291,1324,986,312,1288,990,298,1329,1004,297,1338,1029,299,1288,980,308,1137,790,298,1122,660,399
13215FTBEN2,0,0,0,0,0,0,0,0,0,0,0,0,0,0,0,0,0,0,0,0,0,0,0,0,0,0,0,0,0,0
13251000008,225,127,98,230,123,107,213,112,101,280,148,131,256,141,115,277,148,125,286,154,128,260,143,117,247,134,111,231,120,109
13077000015,1329,624,705,1351,612,731,1288,570,718,1716,748,919,1489,693,796,1712,757,919,1738,769,949,1485,683,802,1428,571,812,1343,522,763
13077000023,2340,465,1875,2369,444,1892,2305,441,1864,2916,629,2213,2688,631,2057,2903,646,2188,2935,689,2188,2686,616,2070,2549,441,1982,2473,364,1988
13319000011,294,86,208,298,81,214,276,81,195,344,97,239,321,99,222,342,99,238,348,98,247,320,99,221,302,93,202,277,70,200
13319000004,121,26,95,123,21,102,116,23,93,138,28,109,139,27,112,137,27,110,137,27,110,140,27,113,118,21,95,114,21,91
13071000022,260,17,243,264,14,249,253,14,239,360,26,328,320,21,299,354,26,322,362,31,328,320,19,301,278,22,254,268,23,236
13027000659,400,64,336,411,57,353,386,55,331,499,85,408,444,69,375,483,79,398,509,86,421,443,67,376,455,58,389,411,53,344
1314100001B,346,288,58,360,311,48,331,278,53,367,295,67,343,289,54,364,296,63,377,315,60,341,286,55,377,321,47,346,277,64
13115000060,821,95,726,839,87,749,806,89,717,1085,117,954,960,107,853,1072,114,941,1097,120,971,960,101,859,914,90,810,868,99,737
132050000HI,114,15,99,118,11,107,115,12,103,110,13,97,112,13,99,109,8,98,112,13,99,112,15,97,116,11,105,114,12,101
131210SC09B,1061,1025,36,1083,1064,17,1027,1008,19,1249,1187,38,1157,1133,24,1255,1197,34,1259,1202,46,1155,1129,26,1090,1038,33,1020,909,84
13123000007,922,161,761,934,146,777,909,150,759,1160,198,935,1096,194,902,1146,200,931,1167,221,937,1095,193,902,900,136,738,847,119,682
1312100004A,538,520,18,559,554,3,520,512,8,608,572,22,576,566,10,608,579,15,609,580,20,575,567,8,516,493,11,482,425,37
1300900CTY5,798,624,174,820,655,158,756,594,162,924,681,218,836,674,162,918,674,218,933,711,212,836,674,162,909,643,227,838,551,255
131210ML04A,1157,444,713,1174,483,676,1140,448,692,1436,540,878,1362,513,849,1428,537,859,1443,579,848,1362,507,855,1232,433,738,1197,324,829
131210RW07B,208,158,50,212,156,52,199,148,51,281,200,72,226,169,57,276,198,68,286,203,74,226,169,57,244,170,63,235,147,75
13245000809,511,489,22,517,494,22,495,468,27,624,572,40,599,565,34,623,573,44,635,586,45,598,563,35,547,508,30,508,455,38
1310300002A,1652,321,1331,1679,312,1346,1634,305,1329,2275,484,1713,2056,454,1602,2243,483,1691,2289,510,1723,2057,455,1602,1588,249,1288,1519,202,1254
13219000007,799,170,629,815,177,630,791,169,622,1070,239,810,1005,235,770,1056,239,792,1070,282,772,1009,234,775,806,170,594,788,125,637
13073000032,920,321,599,933,313,614,903,300,603,1213,447,730,1107,420,687,1206,454,723,1223,469,733,1108,420,688,975,256,701,911,223,659
13073000137,1434,377,1057,1448,393,1046,1405,376,1029,1734,520,1199,1652,527,1125,1734,503,1203,1766,565,1186,1653,525,1128,1508,414,1063,1446,313,1103
132470000ST,1978,1121,857,2013,1142,853,1942,1103,839,2412,1460,883,2157,1386,771,2404,1461,888,2426,1473,929,2157,1385,772,2579,1382,1128,2510,1277,1140
13135000026,2434,1475,959,2477,1504,948,2394,1440,954,3468,2059,1336,2952,1853,1099,3403,2029,1289,3487,2110,1326,2954,1846,1108,2647,1351,1177,2509,1142,1231
130890000PI,987,956,31,1007,982,24,943,914,29,1169,1092,53,1059,1030,29,1169,1101,46,1180,1114,51,1057,1025,32,1001,952,27,949,854,67
13151000026,1957,289,1668,2004,262,1723,1922,266,1656,2553,427,2073,2151,404,1747,2537,425,2066,2573,423,2112,2153,399,1754,2165,265,1842,2052,227,1735
1305103-09C,443,183,260,452,183,264,435,179,256,521,224,285,508,225,283,521,215,286,530,222,296,509,225,284,456,171,273,444,143,283
1305106-01C,935,617,318,964,628,326,907,595,312,1170,739,384,1043,702,341,1175,744,384,1180,754,402,1044,699,345,1018,586,375,960,505,405
13237000106,774,132,642,795,107,682,774,105,669,1010,164,823,922,154,768,1012,159,836,1013,160,843,924,153,771,774,105,653,735,101,603
13135000021,1428,1099,329,1460,1129,307,1371,1064,307,1980,1414,503,1746,1344,402,1917,1386,471,1996,1447,532,1745,1339,406,1557,1125,365,1453,987,389
13135000121,2110,1091,1019,2137,1123,978,2079,1081,998,2669,1454,1152,2509,1432,1077,2608,1415,1126,2674,1509,1130,2512,1414,1098,2164,1029,1016,2108,831,1146
130890000CU,763,672,91,775,698,63,751,670,81,1323,1141,152,1253,1121,132,1318,1141,147,1325,1157,143,1254,1113,141,846,746,73,809,636,135
130890000CT,293,283,10,304,295,7,292,283,9,232,210,14,186,179,7,233,217,11,236,220,12,186,177,9,375,349,19,358,303,34
130890000SM,2182,2120,62,2210,2159,46,2119,2064,55,2542,2417,85,2448,2386,62,2544,2426,86,2552,2436,95,2447,2385,62,2201,2110,68,2131,1954,131
1305104-02C,1290,485,805,1323,496,805,1266,484,782,1689,652,1002,1558,600,958,1678,633,1006,1717,647,1044,1558,602,956,1413,485,871,1351,393,882
130890000BG,1896,1230,666,1947,1249,672,1888,1221,667,2332,1459,824,2238,1432,806,2314,1478,788,2348,1573,745,2242,1407,835,1977,1201,689,1931,994,828
13063000MO9,712,613,99,731,631,97,687,590,97,857,700,127,792,693,99,860,701,128,870,718,139,793,689,104,749,614,114,689,535,125
130890000SK,2595,2490,105,2640,2560,78,2545,2451,94,2999,2835,124,2874,2783,91,3021,2854,123,3025,2853,156,2874,2776,98,2614,2473,117,2503,2245,204
13135000119,1610,691,919,1639,708,904,1584,682,902,1971,930,989,1855,934,921,1935,920,961,1970,963,984,1859,927,932,1713,663,986,1677,558,1027
130890000CB,1075,1041,34,1102,1073,26,1037,1009,28,1257,1171,55,1199,1150,49,1255,1178,57,1269,1191,64,1197,1148,49,1124,1085,31,1083,990,72
13135000063,1806,607,1199,1832,669,1135,1803,641,1162,2260,835,1385,2202,843,1359,2223,832,1346,2252,950,1265,2203,805,1398,1849,650,1124,1842,467,1304
130890000RM,1412,1336,76,1441,1370,68,1374,1299,75,1614,1498,84,1581,1514,67,1628,1521,81,1638,1535,86,1582,1511,71,1471,1377,70,1382,1222,127
13135000090,1728,1071,657,1763,1102,633,1674,1029,645,2176,1332,770,1909,1259,650,2127,1304,754,2183,1368,774,1912,1256,656,1890,1077,722,1791,904,788
130890000RC,1716,1666,50,1745,1710,31,1642,1603,39,2017,1916,69,1908,1862,46,2028,1940,62,2034,1942,83,1907,1862,45,1791,1709,57,1711,1554,117
130890000PC,1331,1280,51,1353,1303,45,1301,1254,47,1539,1453,60,1501,1449,52,1549,1466,57,1547,1469,73,1501,1445,56,1478,1387,62,1406,1276,103
1306700PM01,2238,682,1556,2264,728,1516,2230,714,1516,2844,970,1820,2636,932,1704,2817,961,1795,2850,1037,1772,2637,907,1730,2386,682,1602,2345,509,1742
1306700CR01,2102,814,1288,2124,835,1270,2082,783,1299,2690,1088,1554,2616,1138,1478,2665,1095,1503,2701,1215,1446,2617,1109,1508,2334,812,1412,2301,563,1627
1306300OAK2,782,741,41,797,762,30,749,713,36,958,869,63,877,842,35,956,875,58,972,885,78,877,841,36,751,694,41,689,613,54
133130000FI,1016,269,747,1042,275,763,978,253,725,1378,389,944,1187,328,859,1337,363,928,1399,395,983,1188,329,859,1169,315,825,1036,265,725
1306700DU01,2607,747,1860,2641,756,1853,2586,727,1859,3482,1088,2305,3230,1082,2148,3453,1089,2275,3515,1179,2283,3227,1054,2173,2880,720,2057,2833,576,2144
1306700EA02,2718,1147,1571,2754,1158,1552,2708,1142,1566,3352,1435,1825,3226,1462,1764,3347,1473,1785,3372,1601,1698,3227,1415,1812,2921,1117,1652,2930,834,1955
1306700EA01,2109,842,1267,2137,874,1235,2108,857,1251,2553,1062,1441,2463,1076,1387,2540,1086,1403,2569,1200,1335,2467,1059,1408,2162,835,1232,2146,597,1456
1306700MK01,1193,477,716,1209,471,719,1182,467,715,1437,568,832,1372,591,781,1437,594,812,1447,609,810,1372,579,793,1247,442,753,1237,356,816
1306700BR01,1452,933,519,1477,953,509,1427,918,509,1799,1098,635,1617,1075,542,1791,1127,618,1821,1152,641,1619,1069,550,1525,904,558,1449,803,565
1306700MT04,2068,802,1266,2106,861,1209,2069,830,1239,2438,997,1394,2355,999,1356,2417,993,1375,2441,1094,1305,2360,964,1396,2146,807,1236,2150,557,1497
1312100011M,1620,1568,52,1654,1629,23,1569,1539,30,1849,1765,57,1774,1736,38,1836,1745,56,1852,1770,70,1774,1734,40,1621,1574,29,1544,1404,102
1312100010J,453,441,12,465,458,2,431,426,5,498,463,22,472,457,15,504,470,22,509,479,24,471,457,14,456,437,13,430,382,36
1312100003S,349,337,12,355,348,5,327,318,9,425,402,13,390,382,8,423,403,14,428,408,20,389,378,11,351,338,7,325,287,30
1312100010G,787,770,17,810,793,11,757,737,20,883,832,33,850,832,18,882,838,32,888,844,38,848,824,24,842,819,21,802,702,82
1312100008D,754,234,520,765,273,490,744,244,500,887,296,578,881,307,574,886,305,572,889,363,517,879,284,595,752,283,436,765,172,568
1312100010F,566,542,24,588,574,14,543,528,15,665,633,24,633,616,17,669,638,21,677,638,31,633,612,21,625,600,18,574,513,54
13033000010,166,109,57,174,114,58,160,102,58,189,121,67,179,119,60,185,120,63,191,128,63,178,118,60,171,111,59,150,84,62
131210RW11B,0,0,0,0,0,0,0,0,0,0,0,0,0,0,0,0,0,0,0,0,0,0,0,0,0,0,0,0,0,0
131210UC01E,206,203,3,206,202,4,203,200,3,393,373,15,371,368,3,392,377,11,395,374,19,371,365,6,73,69,2,73,64,5
1312100007E,1329,873,456,1354,917,421,1323,877,446,1708,1110,561,1602,1088,514,1696,1123,529,1724,1192,510,1598,1067,531,1392,900,431,1351,708,581
13169000009,1649,421,1228,1678,411,1252,1626,410,1216,2010,504,1461,1855,497,1358,2002,524,1455,2010,545,1441,1855,492,1363,1652,392,1214,1600,335,1228
13245000108,289,259,30,299,271,24,278,251,27,328,271,49,299,267,32,326,277,42,334,287,40,299,266,33,319,282,28,294,245,42
1312100SS12,1691,796,895,1727,853,855,1688,808,880,2249,1146,1066,2118,1108,1010,2227,1158,1029,2264,1302,942,2116,1095,1021,1843,896,837,1820,622,1145
131210CP07E,39,38,1,41,41,0,38,37,1,42,39,1,39,39,0,42,39,1,42,41,1,39,39,0,39,37,1,36,32,3
13245000810,246,100,146,249,100,147,241,97,144,310,134,171,287,124,163,312,137,171,313,135,173,286,124,162,238,80,150,227,74,138
13245000806,660,239,421,674,240,426,627,225,402,824,319,484,748,297,451,816,307,497,833,329,495,747,297,450,735,244,480,678,201,450
13013000004,1272,300,972,1296,302,981,1251,296,955,1675,394,1236,1380,361,1019,1651,382,1214,1695,409,1250,1380,353,1027,1463,284,1117,1392,247,1056
13285000013,1043,281,762,1062,278,781,1009,249,760,1358,351,977,1164,328,836,1349,355,973,1373,362,992,1161,325,836,1182,304,849,1099,261,793
131210008N1,577,192,385,585,224,349,572,208,364,671,262,403,670,278,392,664,276,382,671,338,318,670,250,420,577,232,313,584,133,445
131210SC29A,1506,1458,48,1540,1508,31,1432,1395,37,1846,1734,71,1720,1689,31,1854,1758,68,1866,1776,74,1716,1683,33,1707,1635,51,1593,1442,114
1312100CH05,254,78,176,260,68,188,251,68,183,330,89,231,330,96,234,325,88,229,333,90,240,330,94,236,293,59,221,283,53,216
13057000027,3019,574,2445,3055,568,2440,2990,553,2437,3931,813,3027,3673,800,2873,3911,830,2987,3953,889,3016,3678,785,2893,3060,523,2437,2988,435,2402
1306300JB14,2596,1816,780,2631,1848,760,2533,1777,756,2973,2102,818,2816,2089,727,2963,2110,799,3007,2149,829,2819,2080,739,2691,1781,857,2523,1551,914
13113000023,689,543,146,698,556,135,668,532,136,786,618,158,757,605,152,784,615,152,791,625,155,757,606,151,691,519,156,669,462,184
13255000014,912,239,673,933,242,681,898,239,659,1175,353,789,1013,321,692,1170,355,792,1193,364,817,1012,323,689,981,233,715,941,203,700
13113000028,1415,811,604,1431,823,598,1399,796,603,1689,1016,648,1609,1010,599,1687,1010,642,1694,1038,643,1609,1000,609,1453,777,636,1412,683,685
13063000MO8,1679,1553,126,1711,1597,112,1632,1513,119,2063,1857,165,1960,1846,114,2079,1881,153,2085,1888,173,1962,1841,121,1622,1473,115,1550,1339,174
13135000126,1853,709,1144,1873,741,1106,1839,701,1138,2312,934,1339,2202,923,1279,2273,961,1283,2305,1041,1228,2203,903,1300,1972,719,1160,1944,545,1320
13213001039,1408,235,1173,1443,216,1216,1368,215,1153,1994,329,1616,1695,280,1415,1948,290,1599,2031,341,1677,1696,278,1418,1628,257,1333,1482,248,1168
13135000067,2734,1403,1331,2775,1452,1305,2676,1376,1300,3868,2052,1736,3367,1878,1489,3775,2019,1666,3908,2112,1754,3365,1862,1503,2947,1333,1522,2797,1091,1585
130890000NF,974,629,345,994,666,306,960,634,326,1213,820,362,1127,787,340,1201,815,359,1218,851,345,1127,768,359,1049,675,322,1004,535,409
130890000KC,809,779,30,829,801,24,785,759,26,937,894,34,931,902,29,940,903,31,943,897,41,931,900,31,858,809,37,809,730,70
1306700DC01,1916,814,1102,1946,828,1080,1913,810,1103,2383,1044,1287,2274,1049,1225,2372,1060,1258,2392,1149,1209,2279,1022,1257,2074,823,1148,2043,594,1345
13135000071,2157,1652,505,2190,1680,489,2069,1586,483,2756,2040,656,2513,1974,539,2718,2022,631,2792,2077,681,2515,1972,543,2315,1635,607,2169,1423,666
13057000005,2453,707,1746,2506,714,1753,2437,701,1736,3163,953,2123,2857,915,1942,3129,927,2109,3196,981,2158,2858,892,1966,2683,664,1899,2604,548,1899
130890000SO,1943,1879,64,1969,1924,44,1872,1815,57,2251,2136,83,2126,2073,53,2249,2146,75,2266,2156,95,2125,2068,57,2000,1921,51,1915,1762,106
1306700FY01,1592,521,1071,1601,524,1051,1577,518,1059,2025,692,1283,1828,651,1177,2015,688,1280,2045,732,1287,1827,644,1183,1704,516,1115,1663,422,1154
13251000005,320,77,243,332,77,253,317,74,243,377,83,289,355,86,269,368,85,280,382,86,293,354,85,269,337,95,233,312,78,230
13251000012,142,96,46,151,106,45,141,96,45,185,126,57,164,116,48,183,124,58,186,128,57,162,114,48,153,108,43,139,89,49
130910JONES,278,43,235,292,35,256,278,38,240,320,47,266,277,47,230,318,43,268,323,45,275,276,47,229,296,33,256,273,37,233
131210ML012,330,98,232,338,107,227,326,101,225,425,147,271,418,150,268,430,153,269,429,157,266,417,145,272,347,103,232,333,74,251
1312100RW19,1412,508,904,1431,556,847,1402,524,878,1769,713,1017,1698,715,983,1738,729,972,1781,801,950,1699,691,1008,1503,569,858,1483,410,1010
13245000506,205,152,53,211,156,55,194,142,52,232,160,68,191,132,59,231,164,63,232,162,69,191,131,60,205,136,69,192,120,70
131210RW07A,658,562,96,676,577,87,634,543,91,905,726,141,772,668,104,907,730,134,914,754,145,773,668,105,683,532,111,644,468,119
13245000308,286,161,125,290,170,119,279,162,117,388,226,152,316,202,114,382,210,151,395,235,152,315,202,113,344,181,153,321,147,158
13073000016,844,200,644,854,201,652,824,185,639,1003,264,718,929,258,671,1001,247,732,1012,275,726,931,258,673,905,207,672,875,178,661
1306300JB12,1413,1320,93,1432,1350,81,1352,1266,86,1705,1553,119,1554,1462,92,1702,1552,118,1731,1575,142,1554,1465,89,1456,1331,109,1373,1189,139
13063000MO7,901,745,156,917,760,152,876,720,156,1153,918,208,1013,845,168,1147,922,203,1162,928,218,1014,847,167,944,762,164,896,687,175
13057000001,1831,593,1238,1850,600,1216,1807,595,1212,2478,881,1523,2128,769,1359,2466,880,1517,2502,943,1512,2128,755,1373,1881,491,1285,1852,414,1313
13057000016,2972,1082,1890,3016,1069,1894,2942,1042,1900,3958,1522,2282,3409,1436,1973,3928,1539,2254,4008,1607,2313,3412,1417,1995,3304,964,2144,3207,814,2182
130890000MU,1645,830,815,1677,903,745,1645,866,779,2058,1119,893,1975,1126,849,2046,1146,852,2074,1256,783,1973,1099,874,1694,851,736,1707,589,1003
13135000033,1294,589,705,1316,600,693,1274,576,698,1570,733,803,1435,712,723,1542,715,782,1580,767,789,1436,700,736,1374,598,716,1350,502,786
130890000MR,1733,1655,78,1772,1711,58,1685,1620,65,1943,1828,91,1873,1809,64,1953,1853,75,1953,1852,90,1869,1801,68,1808,1694,83,1727,1511,176
13135000043,986,814,172,1000,835,157,938,779,159,1362,1018,318,1201,958,243,1324,986,303,1374,1023,342,1201,952,249,992,803,163,941,711,181
13011000011,939,100,839,949,80,863,925,91,834,1235,107,1099,1071,114,957,1231,116,1100,1248,113,1120,1071,111,960,935,79,838,903,92,760
13199000004,188,77,111,193,78,115,184,74,110,229,87,141,216,84,132,228,88,134,231,93,138,216,85,131,191,76,114,180,58,116
130890000CH,1393,986,407,1412,1015,373,1353,970,383,1691,1222,437,1553,1172,381,1658,1199,418,1698,1262,420,1550,1156,394,1409,934,417,1381,794,518
13073000050,465,266,199,473,274,195,440,244,196,553,280,271,516,267,249,548,276,264,556,284,268,516,266,250,478,286,188,421,229,188
13135000076,2129,1573,556,2154,1613,529,2079,1539,540,2677,1995,627,2519,1945,574,2616,1952,622,2686,2008,648,2515,1932,583,2274,1570,653,2164,1397,683
130890000GF,1005,933,72,1030,965,62,960,892,68,1222,1106,91,1139,1074,65,1229,1114,94,1237,1122,101,1139,1068,71,1040,969,56,974,865,85
1306700EL03,1800,730,1070,1826,742,1053,1781,738,1043,2255,962,1242,2092,947,1145,2241,953,1228,2280,1014,1226,2093,917,1176,1954,724,1139,1909,583,1227
133130000LT,653,73,580,668,70,594,635,67,568,870,103,756,794,95,699,849,96,736,876,111,758,795,96,699,700,76,610,648,77,554
13143000005,854,100,754,867,71,787,833,78,755,1147,103,1020,985,78,907,1134,87,1026,1153,90,1050,985,77,908,913,78,821,859,90,733
1312100007D,2350,1325,1025,2407,1431,937,2322,1344,978,3249,1877,1326,2938,1712,1226,3200,1839,1285,3269,2020,1211,2939,1696,1243,2424,1289,992,2382,934,1331
131210SS15B,883,610,273,902,624,266,868,594,274,1118,726,351,1004,706,298,1111,725,349,1126,756,344,1005,693,312,954,608,308,918,508,348
1312100007C,2437,1292,1145,2486,1373,1078,2420,1298,1122,3197,1771,1389,2980,1703,1277,3172,1754,1352,3237,1945,1266,2980,1683,1297,2545,1306,1151,2495,969,1457
13169000002,1495,354,1141,1511,333,1174,1455,326,1129,1776,458,1287,1607,426,1181,1757,452,1288,1795,468,1316,1604,425,1179,1512,331,1155,1449,322,1084
1312100006B,1218,971,247,1233,1031,188,1218,981,237,1461,1168,272,1344,1115,229,1437,1149,252,1470,1231,224,1348,1088,260,1278,1012,197,1265,800,384
131210SC23A,1701,1657,44,1727,1700,26,1618,1576,42,2176,2054,73,2071,2037,34,2180,2078,63,2192,2085,90,2070,2029,41,1791,1716,54,1672,1545,100
13245000101,528,266,262,535,276,249,517,263,254,650,341,297,592,317,275,649,332,297,657,355,294,592,316,276,541,262,253,526,222,281
13245000115,178,94,84,180,94,86,168,87,81,260,145,107,217,125,92,259,145,112,262,146,108,217,127,90,204,101,99,194,87,100
1300900321E,535,417,118,563,461,102,507,404,103,654,496,139,502,411,91,661,521,126,672,520,140,500,410,90,652,532,111,598,466,120
131450000MG,1838,372,1466,1873,294,1564,1815,295,1520,2282,406,1836,2093,388,1705,2277,400,1841,2293,424,1842,2096,388,1708,1975,317,1617,1912,268,1564
1305108-11C,809,795,14,832,826,5,765,751,14,948,914,26,891,883,8,954,927,14,961,938,17,888,875,13,945,929,6,855,780,60
130890000PR,1366,1329,37,1398,1379,18,1313,1284,29,1828,1746,54,1735,1706,29,1837,1763,45,1854,1791,52,1734,1703,31,1362,1321,27,1275,1186,69
13135000118,995,507,488,1022,522,489,982,498,484,1351,728,585,1245,689,556,1338,713,581,1368,746,604,1244,673,571,1039,467,523,1006,379,578
13143000009,174,9,165,177,7,170,168,7,161,246,17,225,217,17,200,243,16,222,249,18,231,217,16,201,183,12,170,172,17,154
13057000021,2106,560,1546,2141,556,1550,2077,526,1551,2546,685,1803,2375,675,1700,2520,688,1777,2565,735,1799,2375,659,1716,2314,498,1722,2252,377,1754
13321000016,155,59,96,162,64,98,148,54,94,208,81,123,188,75,113,205,81,118,210,83,127,187,74,113,188,72,113,178,60,111
13135000104,3397,2772,625,3455,2837,603,3296,2685,611,4091,3294,710,3822,3178,644,4050,3294,690,4142,3370,747,3821,3173,648,3432,2650,713,3246,2357,791
130890000VB,670,539,131,682,545,125,669,546,123,802,632,158,763,624,139,789,615,156,806,643,152,762,621,141,657,471,149,637,419,183
13135000084,1482,1104,378,1508,1128,369,1425,1066,359,2028,1413,558,1793,1353,440,1964,1393,525,2040,1457,563,1792,1348,444,1643,1162,429,1537,1000,469
13177000008,1426,349,1077,1443,349,1087,1397,339,1058,1773,457,1295,1490,423,1067,1759,447,1276,1788,461,1308,1487,418,1069,1573,321,1213,1501,299,1161
1305900008B,1224,861,363,1246,888,342,1211,860,351,1550,1067,448,1402,1021,381,1541,1071,427,1549,1098,431,1403,1012,391,1302,866,372,1266,774,430
1312100JC16,1685,828,857,1724,867,828,1663,825,838,2099,1050,995,1947,1030,917,2078,1049,966,2111,1108,976,1949,1021,928,1811,802,907,1773,623,1060
131210RW11A,1661,862,799,1689,911,755,1643,864,779,2064,1060,952,1922,1029,893,2052,1052,945,2080,1154,900,1922,1016,906,1754,830,819,1736,642,978
1312100006N,1067,659,408,1083,715,356,1058,673,385,1187,722,443,1130,721,409,1181,731,420,1180,808,351,1129,694,435,1202,794,342,1199,594,560
1312100011G,817,781,36,850,832,16,770,738,32,987,901,54,948,928,20,1006,947,43,1016,957,51,946,918,28,1005,972,19,903,785,92
131210AP09B,527,314,213,531,321,208,519,308,211,701,433,253,664,432,232,695,430,247,706,453,238,664,430,234,544,300,224,526,254,248
1312100RW08,1422,522,900,1448,529,891,1410,508,902,1840,709,1095,1725,712,1013,1829,721,1056,1857,823,1008,1727,681,1046,1565,527,960,1545,365,1109
13179000005,279,209,70,288,214,72,269,200,69,343,247,92,319,245,74,341,248,87,348,251,92,317,243,74,290,203,79,262,161,91
131210012H2,1150,1109,41,1185,1166,18,1105,1076,29,1427,1348,47,1369,1342,27,1426,1361,41,1443,1389,43,1368,1336,32,1149,1104,30,1052,927,95
1312100002C,1170,1055,115,1205,1108,89,1156,1052,104,1310,1138,135,1197,1091,106,1310,1119,152,1324,1175,138,1195,1082,113,1259,1121,90,1199,947,176
13113000013,2379,534,1845,2406,542,1841,2348,517,1831,2555,603,1901,2482,574,1908,2513,584,1884,2572,653,1885,2486,581,1905,2503,525,1902,2450,408,1930
131450000L9,1639,407,1232,1658,341,1298,1593,338,1255,2024,426,1559,1864,415,1449,2017,427,1559,2037,458,1556,1859,413,1446,1716,346,1327,1645,284,1277
13215000120,4238,1822,2416,4306,1847,2427,4082,1724,2358,5643,2477,3040,5157,2377,2780,5609,2474,2999,5697,2605,3024,5155,2361,2794,4577,1838,2566,4306,1517,2624
130510XFTPU,0,0,0,0,0,0,0,0,0,0,0,0,0,0,0,0,0,0,0,0,0,0,0,0,0,0,0,0,0,0
130890000PH,846,799,47,860,816,43,810,765,45,984,914,59,948,899,49,986,918,57,997,928,62,948,895,53,899,830,51,852,762,76
13217000007,1626,426,1200,1647,408,1223,1594,399,1195,2027,565,1417,1823,539,1284,2021,564,1418,2034,564,1441,1824,528,1296,1721,394,1283,1673,350,1262
13135000149,1555,745,810,1579,773,786,1533,741,792,1929,978,895,1793,973,820,1893,964,865,1942,1033,877,1798,962,836,1704,731,895,1653,592,988
130890000KG,1555,801,754,1571,842,706,1546,801,745,1842,960,837,1770,975,795,1818,973,805,1845,1079,734,1772,952,820,1566,789,679,1554,583,875
13135000034,1051,674,377,1074,686,373,1032,656,376,1459,867,543,1264,833,431,1407,852,514,1465,873,564,1267,833,434,1077,628,410,1014,545,411
13135000065,885,598,287,895,607,271,849,585,264,1208,749,430,1061,714,347,1180,741,408,1225,768,447,1063,710,353,950,587,325,881,500,340
130890000BM,2388,2301,87,2461,2388,64,2295,2226,69,2804,2638,128,2715,2626,89,2823,2656,124,2853,2698,138,2712,2622,90,2515,2411,81,2379,2161,162
1306700DV01,1322,547,775,1336,556,757,1315,543,772,1697,776,879,1545,737,808,1689,767,872,1704,807,857,1547,722,825,1380,502,805,1365,396,874
1306700BT01,1270,1184,86,1285,1216,66,1235,1161,74,1465,1342,94,1377,1309,68,1474,1364,84,1488,1377,101,1378,1305,73,1295,1197,74,1245,1099,114
1306700SO01,1577,622,955,1583,631,924,1571,625,946,1828,755,1044,1764,766,998,1834,777,1023,1842,835,970,1767,747,1020,1644,585,978,1633,428,1120
1312100SS04,2024,1293,731,2056,1346,684,1995,1280,715,2696,1710,920,2458,1620,838,2681,1714,893,2730,1799,895,2459,1597,862,2013,1225,675,1955,963,857
132470000SM,2580,1854,726,2623,1896,706,2536,1830,706,3094,2275,755,2891,2221,670,3091,2320,728,3122,2326,763,2893,2215,678,2709,1834,821,2623,1643,906
131210CP04B,14,11,3,14,13,1,12,10,2,19,15,2,17,15,2,19,15,4,19,16,3,16,15,1,25,23,2,26,25,1
1312100CP02,536,461,75,550,477,68,521,451,70,673,580,75,623,552,71,674,575,79,679,586,80,623,551,72,544,445,73,513,382,106
1312100006E,1418,1137,281,1438,1178,244,1412,1121,291,1616,1248,329,1505,1229,276,1606,1233,323,1628,1337,269,1506,1215,291,1522,1216,253,1486,984,414
1312100011H,342,325,17,355,343,12,335,318,17,393,361,20,376,360,16,399,376,17,403,372,26,377,362,15,363,347,12,337,302,27
1312100009M,1565,1207,358,1607,1284,298,1568,1222,346,1922,1515,348,1814,1518,296,1900,1513,337,1904,1591,279,1815,1485,330,1395,993,288,1388,827,460
131210CP08A,172,165,7,174,172,2,160,153,7,182,166,10,142,140,2,179,163,6,184,177,6,141,137,4,216,209,4,205,191,9
131210002F2,446,389,57,458,412,41,444,392,52,502,421,72,459,396,63,491,412,67,504,432,65,460,398,62,486,420,47,463,338,95
13245000302,486,357,129,497,374,121,462,334,128,612,446,144,516,389,127,608,446,147,613,470,135,513,388,125,542,400,130,499,339,151
1312100004B,897,874,23,920,904,13,874,857,17,787,736,34,701,676,25,791,748,33,798,758,33,700,675,25,975,941,23,929,867,29
131210SC01B,1282,1244,38,1295,1269,23,1244,1212,32,1611,1544,47,1563,1523,40,1610,1551,39,1613,1557,49,1564,1521,43,1145,1096,37,1093,996,70
131210UC01C,0,0,0,0,0,0,0,0,0,0,0,0,0,0,0,0,0,0,0,0,0,0,0,0,0,0,0,0,0,0
1312100001F,437,422,15,450,439,9,418,405,13,519,478,23,478,463,15,524,491,23,521,481,34,478,461,17,470,443,16,449,409,27
131450000PV,680,160,520,689,115,571,661,112,549,852,145,691,765,122,643,845,141,691,859,149,704,764,120,644,737,119,599,708,99,581
13057000031,1194,376,818,1223,377,829,1167,361,806,1556,492,1018,1346,467,879,1524,501,982,1562,513,1021,1346,455,891,1316,362,889,1268,314,866
130450714A2,813,355,458,826,374,444,797,352,445,1030,426,573,939,418,521,1027,433,570,1045,440,590,940,414,526,923,371,517,900,330,536
130890000KB,1773,666,1107,1807,740,1038,1757,697,1060,2128,937,1164,2075,951,1124,2125,959,1127,2136,1043,1067,2082,929,1153,1845,724,1042,1814,491,1260
130890000BE,1426,860,566,1457,921,517,1412,867,545,1797,1071,688,1606,1003,603,1760,1060,650,1805,1160,615,1607,967,640,1480,872,515,1458,682,689
13073000131,866,168,698,884,167,708,851,162,689,1046,220,811,976,205,771,1053,217,809,1061,238,808,977,209,768,941,193,720,895,147,714
13073000111,1034,336,698,1041,335,686,1012,328,684,1360,486,832,1164,449,715,1358,490,816,1372,512,825,1164,449,715,1219,349,812,1178,282,839
1306700FR01,2026,561,1465,2043,572,1451,2007,563,1444,2550,786,1720,2392,795,1597,2532,794,1674,2564,866,1664,2395,780,1615,2204,559,1563,2159,447,1628
13135000107,845,388,457,859,405,442,828,388,440,1121,565,534,1013,554,459,1098,550,521,1119,589,521,1017,547,470,900,382,488,870,321,510
13135000109,1095,487,608,1110,502,587,1080,477,603,1415,685,696,1296,690,606,1386,667,679,1412,729,666,1297,675,622,1116,461,605,1083,378,645
13135000110,1032,758,274,1058,786,264,999,726,273,1380,946,390,1209,896,313,1352,948,365,1395,974,400,1209,891,318,1151,789,310,1061,676,327
130890000OA,1591,1033,558,1615,1081,505,1583,1030,553,1871,1243,593,1823,1239,584,1858,1248,579,1890,1341,525,1821,1219,602,1625,1007,537,1605,838,706
1312100002W,391,334,57,398,347,47,388,329,59,655,538,101,584,502,82,645,526,102,655,544,104,583,495,88,296,219,52,287,182,75
1312100003B,173,164,9,181,174,7,166,158,8,229,195,17,197,195,2,235,213,16,232,213,16,196,193,3,207,203,2,192,172,15
1312100009H,632,559,73,643,576,56,628,559,69,713,602,87,624,548,76,703,587,85,713,624,75,623,542,81,578,466,85,565,406,124
13107000052,148,104,44,152,103,48,145,98,47,180,113,65,169,109,60,180,112,67,185,117,65,168,109,59,134,93,41,117,74,42
13073000015,1943,647,1296,1982,658,1300,1916,636,1280,2876,1078,1725,2574,1005,1569,2855,1046,1730,2894,1116,1721,2576,1008,1568,2255,648,1511,2151,547,1523
13073000115,1010,383,627,1027,385,631,993,383,610,1309,509,764,1151,501,650,1298,506,750,1323,528,767,1151,502,649,1070,349,676,1004,302,648
13113000036,1253,476,777,1287,471,796,1260,468,792,1476,571,866,1374,565,809,1471,595,848,1491,596,870,1377,567,810,1339,423,854,1289,366,853
130890000DG,1456,631,825,1480,697,755,1454,665,789,1757,829,900,1729,869,860,1737,853,849,1757,936,794,1728,834,894,1500,664,768,1488,426,1007
13281001581,31,8,23,31,8,23,29,6,23,21,4,17,19,4,15,19,2,17,22,4,18,19,4,15,26,4,21,25,4,19
13135000116,1692,1313,379,1727,1321,389,1635,1261,374,2490,1708,726,2119,1576,543,2389,1644,687,2516,1719,766,2121,1577,544,1862,1380,439,1734,1178,471
1306700MB01,1183,379,804,1196,400,779,1184,378,806,1389,485,879,1341,483,858,1382,493,857,1397,538,833,1342,467,875,1258,394,798,1241,280,913
1326100N-26,265,38,227,267,32,235,260,34,226,297,38,255,285,37,248,299,43,252,301,41,260,285,37,248,265,35,226,247,29,214
1306700KL01,1281,504,777,1297,500,759,1268,500,768,1578,668,850,1443,645,798,1558,659,837,1587,690,853,1447,632,815,1382,454,828,1351,365,876
13245000501,1715,1522,193,1743,1563,172,1630,1450,180,2102,1774,274,1897,1701,196,2105,1821,251,2141,1861,269,1893,1694,199,1872,1626,224,1733,1438,260
1312100001P,515,491,24,540,530,10,496,481,15,627,593,23,586,576,10,629,602,18,638,603,28,585,573,12,605,577,17,562,501,45
1312100SS14,959,341,618,976,372,586,955,349,606,1172,404,755,1156,415,741,1162,426,727,1177,500,665,1160,402,758,1022,390,578,1019,261,724
1312100JC18,1943,820,1123,1964,866,1073,1918,822,1096,2321,1048,1237,2210,1054,1156,2297,1047,1206,2331,1146,1151,2213,1021,1192,1991,791,1100,1977,606,1296
1312100006G,364,295,69,369,311,52,361,302,59,425,333,81,401,337,64,421,338,75,429,355,65,400,328,72,373,307,53,372,259,96
131210ML05B,245,81,164,248,81,166,242,74,168,268,128,136,249,123,126,272,126,134,270,137,131,248,120,128,273,84,185,269,59,204
1312100010R,331,323,8,347,344,3,317,311,6,404,375,14,382,374,8,407,388,11,412,385,22,380,372,8,380,367,8,353,319,24
1312100005B,844,797,47,892,858,30,817,783,34,1109,1022,67,1015,979,36,1114,1034,59,1131,1055,68,1012,975,37,944,852,55,869,714,92
1312100JC05,1365,740,625,1385,763,592,1341,731,610,1766,976,746,1629,975,654,1743,993,710,1783,1054,700,1627,954,673,1468,736,651,1403,561,767
131210AP01C,1482,684,798,1494,703,779,1459,680,779,1888,887,960,1781,884,897,1875,910,915,1894,978,879,1786,873,913,1570,655,831,1533,485,968
13135000074,859,751,108,876,770,98,828,731,97,1130,920,174,1002,889,113,1109,926,158,1141,939,192,1000,884,116,920,762,128,868,678,144
1305106-05C,978,635,343,994,639,344,950,622,328,1241,785,423,1116,744,372,1246,799,415,1258,790,436,1116,747,369,1042,617,387,999,530,419
130890000CD,2339,2270,69,2368,2317,48,2253,2196,57,2654,2519,86,2485,2440,45,2648,2514,71,2662,2532,96,2482,2431,51,2576,2451,92,2470,2269,157
131210006L2,480,321,159,483,338,140,476,324,152,576,375,192,556,371,185,574,377,178,578,410,159,555,352,203,485,338,132,486,249,220
131210JC13A,1429,458,971,1454,491,950,1421,457,964,1840,676,1139,1757,663,1094,1816,684,1096,1848,768,1067,1757,642,1115,1521,449,1011,1486,304,1124
131210ML071,72,24,48,73,23,50,73,22,51,160,53,103,150,53,97,164,56,104,161,58,101,149,51,98,80,32,45,75,20,53
1305105-01C,493,379,114,505,387,112,464,356,108,613,438,151,588,448,140,612,456,148,621,456,155,587,450,137,539,396,133,501,336,144
130890000MQ,1891,747,1144,1921,831,1068,1880,794,1086,2260,1001,1215,2218,1038,1180,2242,1023,1167,2265,1124,1108,2216,994,1222,1901,769,1048,1885,487,1329
13135000017,1500,1197,303,1520,1214,293,1447,1149,298,2035,1502,483,1753,1422,331,1967,1459,441,2056,1521,516,1753,1414,339,1659,1237,364,1552,1107,383
1305108-09C,610,589,21,645,636,9,572,557,15,695,658,20,644,630,14,690,664,17,706,672,23,642,631,11,727,701,11,646,562,59
13135000056,1319,725,594,1338,731,580,1284,705,579,1600,829,713,1432,826,606,1568,846,674,1598,887,680,1435,809,626,1409,691,625,1360,592,679
1305106-06C,708,351,357,741,358,371,701,349,352,924,459,424,841,444,397,912,463,425,934,474,442,839,440,399,782,360,398,743,302,395
13199000014,141,14,127,145,8,136,139,7,132,160,13,147,146,10,136,163,11,152,163,11,151,145,10,135,159,16,141,156,17,133
1306700TR01,1686,674,1012,1711,709,964,1683,666,1017,2072,910,1130,2007,918,1089,2051,923,1087,2075,1016,1025,2009,885,1124,1858,768,1002,1859,503,1282
131210CP06B,0,0,0,0,0,0,0,0,0,0,0,0,0,0,0,0,0,0,0,0,0,0,0,0,0,0,0,0,0,0
1312100003G,348,337,11,359,351,6,338,329,9,289,267,11,263,255,8,289,270,9,289,272,14,264,254,10,314,302,6,293,251,25
131210ML023,1009,262,747,1027,295,725,1010,279,731,1440,458,952,1382,448,934,1428,462,923,1449,530,895,1385,430,955,1031,266,716,1005,165,808
131210SC17A,42,42,0,42,41,0,42,42,0,44,39,2,46,45,1,43,42,1,44,43,1,46,45,1,35,35,0,33,29,1
131210CP081,76,71,5,77,72,4,72,68,4,110,98,8,84,83,1,114,106,4,114,106,7,84,84,0,139,133,4,136,125,9
13135000137,2829,1230,1599,2862,1254,1573,2779,1217,1562,3741,1678,1947,3247,1610,1637,3674,1663,1895,3758,1765,1922,3251,1590,1661,3098,1148,1802,2973,965,1851
13135000008,2867,907,1960,2903,921,1945,2824,903,1921,3771,1339,2363,3426,1325,2101,3705,1344,2294,3782,1428,2315,3423,1287,2136,3031,814,2109,2929,665,2128
1312100SC02,650,613,37,661,633,27,637,606,31,724,699,21,720,699,21,734,710,20,728,702,22,721,700,21,654,625,20,631,568,51
1312100012G,403,377,26,427,412,15,383,366,17,444,414,26,460,446,14,449,418,19,456,431,25,461,446,15,460,424,27,410,342,57
13063000MO4,905,711,194,928,723,199,876,683,193,1149,879,245,1051,839,212,1148,879,247,1166,892,260,1051,837,214,996,731,235,928,644,242
1305101-14C,1085,383,702,1103,381,707,1068,371,697,1279,481,779,1187,443,744,1274,466,784,1292,488,785,1186,440,746,1157,391,734,1112,305,766
13135000130,2804,991,1813,2842,1049,1760,2759,985,1774,3820,1523,2224,3461,1419,2042,3730,1473,2168,3830,1627,2150,3459,1400,2059,2968,948,1894,2876,731,2001
130890000TC,892,859,33,926,904,22,849,818,31,1018,948,39,968,940,28,1026,969,42,1033,984,43,965,938,27,965,923,30,893,794,80
130890000CO,1251,792,459,1268,831,421,1237,799,438,1613,1039,533,1487,990,497,1594,1038,513,1627,1107,479,1490,981,509,1355,783,483,1328,608,639
130890000CC,699,678,21,725,712,9,672,655,17,742,707,28,697,684,13,756,718,25,765,730,28,695,678,17,768,746,8,733,657,42
1306700AD01,1611,735,876,1628,749,853,1595,736,859,1937,937,949,1834,939,895,1936,922,948,1956,990,930,1835,937,898,1664,683,901,1632,543,996
13113000017,848,276,572,863,273,567,842,272,570,1057,376,654,983,375,608,1051,383,640,1069,412,640,982,357,625,982,266,661,958,222,693
131210CP05B,75,69,6,76,75,1,73,68,5,78,71,5,63,60,3,77,72,4,77,72,5,63,60,3,59,57,1,58,48,8
13135000123,1361,1107,254,1389,1154,227,1306,1076,230,1761,1364,349,1498,1240,258,1725,1331,328,1777,1393,371,1499,1234,265,1550,1221,289,1421,1064,298
1312100012I,386,375,11,412,408,4,360,353,7,508,466,21,438,431,7,506,466,23,519,491,22,435,428,7,436,425,7,388,346,33
131210011E1,618,596,22,632,617,13,602,582,20,725,670,41,652,639,13,728,689,27,730,688,37,650,633,17,645,617,16,611,560,34
131210JC03A,378,189,189,384,207,169,365,194,171,486,267,212,443,257,186,478,264,200,486,283,198,445,253,192,412,196,199,406,157,226
1312100004W,806,797,9,819,814,3,795,790,5,227,221,3,135,135,0,223,220,0,228,225,2,134,133,1,724,705,9,692,650,17
131210CP07A,166,161,5,173,170,3,156,153,3,195,177,10,178,174,4,200,186,9,200,187,9,179,173,6,304,290,7,274,244,18
131210CP07D,34,33,1,34,34,0,31,31,0,40,36,2,37,36,1,38,38,0,41,38,2,36,35,1,61,59,1,56,50,4
131210ML07A,468,141,327,471,155,312,460,146,314,652,216,425,625,215,410,645,211,422,655,235,411,627,208,419,490,139,330,474,98,358
131210SC08D,312,306,6,314,310,4,295,292,3,362,350,8,337,331,6,361,351,4,361,345,11,337,330,7,329,316,7,310,291,13
131210UC033,0,0,0,0,0,0,0,0,0,0,0,0,0,0,0,0,0,0,0,0,0,0,0,0,0,0,0,0,0,0
131210SS13B,617,301,316,628,337,288,613,312,301,923,509,394,867,481,386,911,506,382,923,541,368,869,466,403,564,303,237,548,223,302
131210SS11D,246,88,158,251,107,141,244,102,142,322,157,158,298,152,146,317,158,154,325,172,145,299,147,152,248,103,130,243,65,169
1312100001H,365,347,18,379,363,15,351,335,16,420,387,18,381,374,7,421,396,12,425,405,16,382,374,8,408,378,20,388,330,44
131210008N2,905,472,433,921,510,399,891,471,420,1202,667,513,1119,643,476,1197,692,485,1219,756,452,1121,628,493,924,500,402,897,353,517
13055000961,84,14,70,86,11,74,83,15,68,105,12,89,82,8,74,104,11,89,106,10,94,82,8,74,87,5,77,85,8,69
1306300JB05,1047,823,224,1075,846,227,1017,795,222,1318,1010,282,1245,976,269,1317,1012,277,1342,1023,306,1244,974,270,1129,825,271,1047,721,296
130890000MW,1110,897,213,1127,918,200,1102,898,204,1427,1116,282,1313,1060,253,1427,1115,279,1431,1152,260,1312,1051,261,1134,750,343,1119,654,422
1312100SS03,1007,548,459,1022,577,432,992,536,456,1226,685,523,1152,685,467,1222,693,497,1234,741,473,1152,670,482,983,492,430,981,353,564
130890000WL,1000,503,497,1018,521,476,988,505,483,1198,603,568,1153,615,538,1201,624,555,1203,652,532,1153,607,546,1055,512,486,1039,399,587
1306700ML01,2062,683,1379,2089,694,1356,2059,684,1375,2615,920,1629,2379,887,1492,2595,927,1603,2635,991,1593,2380,869,1511,2244,645,1504,2205,533,1548
1312100RW16,1258,546,712,1274,556,701,1236,522,714,1682,732,918,1573,738,835,1654,751,871,1685,804,856,1573,708,865,1361,560,747,1334,434,851
131210SS11B,687,478,209,704,504,187,678,477,201,891,638,238,790,574,216,885,626,232,900,655,235,792,569,223,755,489,224,736,393,293
1312100003H,348,337,11,367,356,6,333,323,10,418,385,18,403,393,10,423,393,17,423,388,33,400,390,10,405,384,9,372,320,40
131210SC08C,50,50,0,53,53,0,51,51,0,70,68,2,63,63,0,71,71,0,71,71,0,63,63,0,57,56,0,57,55,2
1312100004C,53,50,3,54,54,0,51,50,1,52,52,0,54,54,0,52,49,1,52,51,1,54,54,0,64,64,0,56,50,4
13135000132,1828,922,906,1856,945,884,1788,896,892,2489,1294,1146,2181,1206,975,2444,1269,1118,2505,1327,1139,2182,1197,985,2019,883,1052,1936,749,1097
13135000093,2587,1131,1456,2608,1133,1425,2535,1117,1418,3219,1544,1576,2905,1512,1393,3173,1536,1556,3226,1647,1533,2903,1471,1432,2748,1022,1581,2709,825,1728
13135000002,2214,1770,444,2251,1805,434,2159,1724,435,2728,2142,515,2525,2077,448,2676,2128,509,2738,2179,533,2527,2074,453,2305,1705,539,2199,1553,570
131210SC01A,24,22,2,25,22,3,22,21,1,53,48,4,29,27,2,53,50,3,53,50,3,29,27,2,4,4,0,3,3,0
13135000079,1639,770,869,1652,775,856,1609,754,855,2130,1076,979,1964,1066,898,2092,1059,967,2134,1138,970,1967,1064,903,1661,627,932,1625,507,1023
131210SS19A,1653,1235,418,1679,1274,383,1616,1221,395,2048,1470,504,1867,1422,445,2012,1465,483,2064,1530,494,1868,1416,452,1775,1251,447,1720,1070,555
131210AP04B,285,122,163,290,132,153,286,130,156,401,174,216,370,171,199,394,165,216,403,193,205,370,168,202,318,137,165,311,98,194
13113000020,658,214,444,667,216,431,648,211,437,786,260,489,727,261,466,781,261,477,788,273,483,730,256,474,713,219,456,692,169,471
131210SS02B,745,554,191,755,571,174,714,538,176,920,658,236,797,600,197,915,646,234,929,684,231,801,601,200,779,539,197,739,426,268
131210ML04C,65,20,45,66,19,47,65,18,47,85,31,52,80,30,50,80,30,50,86,34,50,80,29,51,71,18,52,69,13,53
13245000708,199,59,140,201,62,136,191,54,137,234,69,161,223,70,153,234,72,162,234,73,161,223,71,152,208,49,150,194,36,152
131210SS11C,140,113,27,145,122,23,139,114,25,198,160,31,172,145,27,195,151,35,199,161,33,171,143,28,156,117,33,144,92,37
1312100005F,136,125,11,136,129,6,135,127,8,141,124,12,119,113,6,142,124,11,143,130,13,119,112,7,80,71,7,79,66,10
131210CP07F,51,50,1,54,54,0,46,45,1,65,60,2,57,56,1,65,62,1,64,61,3,57,54,3,53,51,1,49,44,3
131210SC18B,454,436,18,461,447,13,441,423,18,678,645,23,670,656,14,682,653,22,681,654,24,670,654,16,446,428,13,428,395,27
13063000LJ4,2258,2053,205,2278,2086,187,2176,1976,200,2674,2382,248,2565,2364,201,2689,2414,225,2710,2429,253,2560,2358,202,2282,2023,232,2144,1827,285
131210CP053,0,0,0,0,0,0,0,0,0,0,0,0,0,0,0,0,0,0,0,0,0,0,0,0,0,0,0,0,0,0
131210SC11A,797,776,21,812,795,16,782,765,17,999,950,32,946,927,19,1005,958,26,1009,960,44,947,926,21,859,828,23,821,768,40
131210CP052,0,0,0,0,0,0,0,0,0,0,0,0,0,0,0,0,0,0,0,0,0,0,0,0,0,0,0,0,0,0
1312100010I,255,249,6,258,253,5,253,248,5,269,256,11,266,258,8,270,259,11,274,264,10,266,258,8,257,242,10,240,218,20
131210JC03B,936,562,374,950,584,355,917,551,366,1235,734,459,1127,739,388,1213,744,433,1243,777,445,1125,730,395,960,549,373,904,424,437
13245000305,353,68,285,359,78,279,353,71,282,385,79,296,378,78,300,387,89,289,382,101,276,381,81,300,341,64,267,349,50,298
131210SS18A,450,224,226,452,228,220,446,218,228,545,267,270,527,262,265,541,274,258,551,297,247,528,256,272,488,226,247,484,136,333
1312100005J,407,366,41,414,369,41,404,364,40,480,420,50,424,383,41,478,416,47,482,422,48,423,379,44,418,350,47,401,308,69
131210JC04B,152,81,71,155,84,65,147,82,65,228,138,86,220,143,77,223,139,77,230,149,80,220,139,81,174,91,74,167,68,87
13121003P1B,0,0,0,0,0,0,0,0,0,0,0,0,0,0,0,0,0,0,0,0,0,0,0,0,0,0,0,0,0,0
131210008F2,0,0,0,0,0,0,0,0,0,0,0,0,0,0,0,0,0,0,0,0,0,0,0,0,0,0,0,0,0,0
131210ML022,146,34,112,148,37,106,145,39,106,331,94,232,315,93,222,330,99,226,334,108,221,315,88,227,156,35,104,151,22,123
1312100AP10,667,252,415,680,277,387,661,256,405,823,297,501,765,285,480,819,302,496,833,343,476,768,275,493,708,249,421,698,171,487
131210SS18B,158,78,80,160,81,76,153,74,79,195,92,101,201,106,95,193,96,95,200,100,99,201,105,96,183,78,98,183,57,122
131210UC01B,206,199,7,210,206,4,197,192,5,230,215,9,174,173,1,230,212,8,231,216,13,173,171,2,212,204,3,207,193,9
131210SC21A,0,0,0,0,0,0,0,0,0,0,0,0,0,0,0,0,0,0,0,0,0,0,0,0,0,0,0,0,0,0
131210UC02B,19,15,4,19,14,5,18,13,5,20,15,4,19,16,3,20,15,5,20,15,5,19,16,3,16,10,6,16,8,8
131210ML024,70,10,60,70,11,59,68,10,58,106,34,70,102,33,69,103,34,68,105,38,65,103,32,71,76,16,57,73,11,57
131210ML05A,27,9,18,27,8,19,27,8,19,45,21,23,41,20,21,40,20,20,45,23,22,40,19,21,32,18,14,29,14,14
131210SC30A,92,91,1,96,95,1,89,86,3,118,112,5,122,119,3,119,115,2,122,114,7,122,118,4,95,91,2,88,76,11
131210SC08G,8,8,0,8,8,0,8,8,0,3,3,0,4,4,0,3,3,0,3,3,0,4,4,0,1,1,0,1,1,0
131210AP01E,0,0,0,0,0,0,0,0,0,0,0,0,0,0,0,0,0,0,0,0,0,0,0,0,0,0,0,0,0,0
131210CP07C,47,44,3,47,46,1,43,42,1,73,69,2,69,69,0,73,68,2,73,71,1,69,68,1,4,4,0,3,3,0
131210SC07B,0,0,0,0,0,0,0,0,0,0,0,0,0,0,0,0,0,0,0,0,0,0,0,0,0,0,0,0,0,0
131210SC08A,0,0,0,0,0,0,0,0,0,0,0,0,0,0,0,0,0,0,0,0,0,0,0,0,0,0,0,0,0,0
