GEOID20,Tot_2016_sen,D_2016_sen,R_2016_sen,Tot_2016_pres,D_2016_pres,R_2016_pres,Tot_2018_ag,D_2018_ag,R_2018_ag,Tot_2018_sen,D_2018_sen,R_2018_sen,Tot_2018_gov,D_2018_gov,R_2018_gov,Tot_2020_pres,D_2020_pres,R_2020_pres
39061031AKJ,587,378,174,609,478,110,379,296,83,382,305,77,384,284,85,494,400,83
39061031ABK,785,324,436,768,446,274,679,403,276,680,429,251,692,395,271,849,537,303
39061031BKQ,910,460,402,923,554,328,727,493,234,729,509,220,733,478,240,1002,698,294
39061031BLU,848,431,387,852,530,295,728,489,239,718,500,218,729,477,230,871,582,280
39061031AYG,1006,550,421,1014,679,273,913,638,275,921,667,254,925,638,266,1136,822,290
39061031AOO,831,301,492,852,353,444,668,343,325,672,362,310,677,309,334,885,454,415
39061031BQN,536,356,144,557,404,112,414,345,69,420,361,59,418,340,60,640,551,77
39061031AHE,794,552,184,807,627,129,670,567,103,675,586,89,671,555,97,802,649,135
39167084ABR,545,161,361,559,95,423,416,112,304,428,133,295,423,109,306,597,123,467
39061031BNQ,851,231,596,847,332,483,786,340,446,785,370,415,789,346,432,925,424,488
39061031BKN,805,408,363,816,503,291,663,426,237,664,454,210,671,417,237,870,572,288
39061031ABE,478,216,253,489,293,160,403,257,146,412,278,134,410,253,150,554,359,180
39061031AFB,185,85,95,186,115,62,156,99,57,159,109,50,159,99,55,671,472,185
39061031BQM,814,380,410,824,517,261,714,463,251,722,505,217,729,464,241,782,557,212
39061031AJP,462,396,48,478,455,15,329,312,17,329,318,11,329,311,11,458,433,21
39061031AVB,656,232,394,666,311,311,540,304,236,536,309,227,544,280,246,750,411,327
39061031AFA,824,440,348,845,598,200,862,638,224,870,671,199,874,626,225,1016,777,218
39061031AFD,750,521,190,759,627,88,746,642,104,746,655,91,742,618,100,974,857,101
39061031AWL,559,200,335,563,232,303,422,197,225,419,225,194,426,181,224,550,258,282
39061031BDM,575,194,354,552,308,211,472,258,214,483,283,200,482,249,215,602,361,230
39061031BHE,932,188,707,951,261,632,717,232,485,722,264,458,732,217,488,1001,329,660
39061031BOM,975,731,200,998,847,115,791,703,88,790,712,78,791,677,90,1030,879,125
39061031AKY,737,238,450,754,304,411,524,219,305,533,252,281,530,199,310,727,291,424
39061031AFC,792,546,203,802,658,101,652,558,94,655,575,80,659,553,95,886,757,118
39061031AJA,927,620,263,949,729,178,772,627,145,779,663,116,783,622,136,974,793,160
39061031AVJ,707,253,424,724,315,367,592,301,291,594,319,275,601,285,294,795,386,399
39061031AJN,968,737,161,977,800,109,956,868,88,957,882,75,960,849,88,1140,1029,95
39061031BOI,857,128,698,864,155,670,713,171,542,704,188,516,713,152,530,1107,267,825
39061031ABB,186,43,132,194,59,119,145,55,90,145,58,87,147,50,88,223,65,155
39061031AUG,589,297,255,599,341,228,483,324,159,482,336,146,484,312,157,646,427,210
39061031AKL,610,398,189,635,509,89,581,475,106,592,495,97,589,462,117,823,684,126
39061031AMU,776,456,294,773,549,183,710,522,188,709,539,170,720,506,199,816,609,195
39061031ACI,840,376,431,853,532,251,802,539,263,806,574,232,812,517,269,1222,821,380
39061031BEB,730,191,493,740,257,451,552,226,326,547,246,301,555,212,322,777,306,462
39061031BDZ,746,187,518,763,224,499,578,237,341,577,258,319,574,210,338,835,313,508
39061031AXW,462,276,164,467,322,124,374,264,110,381,273,108,380,255,117,496,363,127
39061031ASP,855,253,561,855,317,500,701,331,370,704,349,355,710,321,372,1109,518,572
39061031AMC,505,370,108,526,438,71,404,354,50,406,366,40,405,338,56,567,484,76
39061031BMW,882,314,544,882,430,409,690,365,325,695,395,300,690,363,314,875,533,331
39061031BHG,813,162,602,838,238,543,618,218,400,623,253,370,631,198,405,869,293,564
39061031BHV,903,168,698,934,227,650,707,226,481,700,262,438,712,199,484,985,312,652
39061031AAF,416,227,168,424,277,121,379,274,105,375,279,96,378,262,107,463,346,111
39077039ABE,637,154,446,653,203,419,517,191,326,520,227,293,517,170,328,745,235,503
39077039ACK,339,55,259,354,63,276,278,50,228,277,73,204,283,50,217,391,52,333
39077039ABP,335,65,250,344,65,262,248,62,186,248,76,172,255,67,175,374,68,298
39013007ACL,455,157,275,457,144,298,383,153,230,385,184,201,391,151,232,481,151,321
39013007AAB,414,181,194,425,171,231,267,151,116,269,176,93,266,132,129,427,157,268
39077039ACF,564,123,412,586,135,418,456,156,300,462,189,273,474,147,293,633,135,488
39077039ACI,526,155,324,533,186,316,399,181,218,404,217,187,409,177,217,562,189,369
39061031AFM,721,616,65,753,717,22,571,554,17,574,559,15,574,545,18,697,661,30
39061031BMO,1061,302,691,1078,414,602,876,406,470,882,436,446,885,378,468,1077,474,586
39061031AGN,533,447,65,557,522,23,328,303,25,330,309,21,322,291,24,409,373,27
39061031BOF,532,94,433,509,227,256,501,206,295,501,219,282,508,203,297,558,278,269
39061031ARG,774,211,521,787,293,418,610,278,332,612,303,309,616,255,337,830,406,406
39061031ARE,653,182,436,669,240,375,533,254,279,535,278,257,540,256,270,719,333,377
39061031AQZ,699,225,437,705,290,362,551,278,273,547,295,252,551,251,276,758,386,357
39061031AKX,841,210,586,857,284,537,717,270,447,718,289,429,726,230,471,932,322,590
39061031BAS,825,186,623,817,312,455,714,279,435,713,316,397,722,268,432,907,422,466
39005003ACO,573,119,409,595,115,453,433,122,311,438,145,293,440,112,309,690,136,546
39013007ADK,447,131,288,458,96,349,338,136,202,341,166,175,341,134,204,474,103,368
39013007ADW,146,69,72,151,69,82,128,77,51,128,85,43,132,66,62,169,72,94
39013007ADI,642,253,335,652,207,413,476,249,227,479,270,209,477,223,241,681,202,469
39127064AAY,654,202,417,658,225,398,501,194,307,516,244,272,522,205,298,736,235,492
39127064AAQ,310,91,197,307,86,206,202,79,123,209,97,112,213,78,123,302,71,227
39127064AAR,434,95,314,440,83,344,337,73,264,347,107,240,346,81,251,486,81,396
39129065ABD,619,112,488,629,127,477,481,127,354,481,163,318,478,115,352,683,128,549
39077039ACM,756,198,494,786,223,510,603,234,369,608,287,321,614,230,346,876,247,616
39005003ABI,736,164,519,754,183,531,596,179,417,601,219,382,608,165,412,848,201,636
39005003ACH,397,66,315,405,60,329,334,58,276,329,70,259,336,54,274,487,94,389
39005003ACB,221,59,143,226,62,154,167,54,113,165,66,99,166,50,105,236,65,167
39077039ABT,509,109,378,509,146,336,408,159,249,411,193,218,414,160,234,560,162,392
39077039ABU,715,129,536,722,149,550,570,153,417,570,197,373,570,152,397,796,167,612
39077039AAD,710,210,444,721,250,421,498,209,289,505,255,250,511,218,263,782,274,492
39077039ABA,350,122,209,368,132,207,228,97,131,227,108,119,230,92,134,387,120,260
39013007ACN,629,146,459,626,150,465,598,184,414,595,234,361,604,173,425,645,151,489
39013007ABG,161,35,114,163,32,128,125,30,95,121,36,85,122,27,93,194,34,160
39013007ADD,269,68,184,278,64,205,200,77,123,198,87,111,200,67,129,261,59,200
39083042AAY,416,95,306,412,97,298,337,86,251,345,106,239,342,87,252,470,118,349
39059030ABE,666,160,473,674,190,456,520,190,330,519,223,296,528,187,326,746,192,540
39059030ABR,244,56,169,245,72,156,196,70,126,197,87,110,202,76,112,275,65,206
39059030ACR,720,130,564,722,132,574,545,121,424,549,180,369,552,128,406,765,130,630
39059030AAX,454,116,318,458,152,290,384,155,229,383,187,196,389,154,220,533,196,327
39059030ABS,454,98,326,470,105,343,362,99,263,363,136,227,369,102,251,492,120,367
39059030AAA,473,167,278,485,208,249,366,186,180,368,205,163,369,182,171,516,233,272
39059030ABU,480,87,369,488,93,373,391,95,296,390,121,269,391,82,298,523,76,441
39129065AAQ,262,51,198,268,68,191,229,67,162,226,87,139,228,69,153,278,69,206
39127064ABM,259,99,135,261,114,136,176,84,92,178,97,81,178,87,85,265,93,167
39127064ABN,402,142,238,410,143,244,274,109,165,278,138,140,283,113,157,446,136,303
39127064AAM,509,104,381,504,98,381,404,96,308,416,124,292,419,109,297,591,101,485
39129065ABJ,532,126,377,537,118,395,430,112,318,432,150,282,436,131,291,608,137,465
39127064ABK,332,88,228,338,93,240,257,84,173,262,112,150,264,92,157,355,101,252
39057029AHW,562,103,437,562,133,413,468,108,360,466,147,319,471,106,354,616,135,469
39057029ACO,500,128,356,505,182,284,466,196,270,474,238,236,479,187,281,579,277,287
39057029AFG,677,135,513,678,203,446,548,172,376,548,227,321,553,165,366,703,219,475
39057029AHJ,621,529,41,626,576,20,552,508,44,557,522,35,557,499,48,573,528,41
39167084ABP,693,191,475,720,155,540,520,135,385,529,175,354,524,141,364,755,165,579
39129065AAI,780,228,516,781,266,481,582,198,384,581,261,320,588,213,361,883,269,602
39129065AAR,669,177,458,671,229,414,585,215,370,584,282,302,590,204,366,781,232,536
39129065AAS,509,105,369,509,110,380,408,103,305,410,123,287,413,120,288,573,112,457
39129065ABM,439,102,324,449,124,308,403,124,279,401,164,237,407,122,275,478,140,331
39059030ACK,424,118,280,430,139,277,312,131,181,313,152,161,318,122,189,505,119,380
39075038AAX,807,78,707,800,96,682,651,81,570,654,104,550,654,83,562,950,99,846
39129065AAW,686,202,450,693,202,456,495,162,333,500,203,297,499,168,322,749,190,549
39057029AFS,591,173,410,579,235,332,506,191,315,506,236,270,511,173,326,590,239,345
39057029AIP,574,81,470,579,120,440,494,117,377,495,167,328,498,116,368,647,153,483
39057029AFN,341,127,187,349,158,174,237,109,128,239,120,119,242,110,117,331,131,195
39057029AGZ,409,37,357,398,57,325,378,56,322,372,79,293,382,52,328,432,64,363
39083042AAO,954,162,751,960,184,738,752,178,574,757,227,530,748,177,543,1027,223,796
39083042ABO,478,86,367,476,103,344,392,93,299,394,114,280,391,81,296,539,110,422
39129065ABI,448,102,330,453,99,344,353,98,255,357,117,240,357,104,244,502,93,403
39129065ABZ,235,45,182,235,58,166,189,49,140,190,65,125,193,56,133,256,57,197
39083042ABL,571,124,420,581,146,413,443,139,304,447,154,293,442,129,297,684,157,514
39083042ACB,616,133,473,624,120,481,534,124,410,536,148,388,536,137,386,734,167,557
39081041ADW,610,251,324,622,231,363,475,245,230,489,265,224,490,213,263,686,243,428
39121061AAL,275,56,206,292,57,223,205,51,154,209,71,138,212,58,143,279,45,228
39121061AAJ,231,53,162,240,45,184,184,42,142,191,62,129,191,51,130,271,45,226
39059030ABM,362,108,221,372,120,228,264,121,143,268,134,134,267,105,149,403,122,273
39059030ABG,493,96,383,506,125,359,407,122,285,409,155,254,414,118,282,589,162,419
39121061AAS,440,96,326,462,97,341,347,94,253,356,131,225,355,106,239,486,101,383
39121061AAC,667,127,512,687,129,538,507,147,360,523,188,335,521,157,349,730,125,603
39097049AAG,1143,201,887,1134,246,843,963,211,752,957,263,694,972,221,735,1273,289,968
39127064ABE,636,183,412,635,192,408,475,160,315,492,225,267,493,172,300,676,195,473
39077039AAL,698,156,508,712,207,467,587,196,391,592,235,357,604,198,383,790,278,504
39077039ABJ,616,98,481,625,154,441,508,138,370,520,192,328,520,135,366,684,173,507
39063032ACL,428,70,340,428,83,334,342,77,265,352,112,240,354,81,258,442,86,350
39063032ABV,644,123,473,653,139,470,480,150,330,486,179,307,491,141,335,675,166,500
39063032ABH,353,124,204,362,124,203,247,113,134,254,127,127,253,116,126,384,131,240
39063032AAP,639,151,448,647,199,415,484,172,312,479,206,273,495,167,312,687,236,441
39063032ACB,753,166,550,766,194,517,535,173,362,539,215,324,550,169,354,827,272,540
39103052AFW,686,225,438,702,295,379,608,285,323,623,304,319,629,283,330,828,380,430
39009005ABM,583,314,227,600,333,233,505,304,201,513,351,162,520,325,179,635,382,249
39009005AAA,795,542,183,835,638,138,597,504,93,616,536,80,625,506,93,702,576,110
39009005ABU,434,206,189,447,199,225,340,186,154,348,212,136,348,188,140,458,207,240
39009005ABT,417,222,177,418,250,156,365,230,135,383,264,119,379,241,125,488,291,189
39009005ACC,694,322,333,721,294,390,539,314,225,555,345,210,555,322,216,804,312,483
39009005ACE,554,298,222,592,282,283,399,250,149,412,290,122,410,259,133,606,270,326
39009005ABB,363,192,136,376,168,171,284,169,115,287,180,107,290,165,107,415,205,199
39077039ACC,502,150,317,526,174,328,379,141,238,379,163,216,378,141,220,564,163,382
39097049AAO,774,172,560,784,208,535,584,177,407,581,223,358,585,191,364,864,227,622
39097049AAJ,764,168,564,767,225,500,687,222,465,690,263,427,693,231,453,1200,444,735
39097049AAH,677,155,492,675,190,440,513,179,334,506,204,302,513,191,310,710,236,461
39097049AAK,383,51,315,389,55,321,334,50,284,331,63,268,332,50,269,470,68,393
39103052AEE,758,186,518,777,232,511,558,193,365,574,247,327,575,184,357,872,270,586
39063032ACI,752,97,622,745,109,597,596,110,486,606,157,449,612,111,485,799,144,642
39063032AAL,568,127,417,585,211,354,446,182,264,446,224,222,453,161,281,601,229,358
39063032ACR,786,172,568,788,179,557,610,162,448,625,238,387,629,161,441,862,218,632
39063032ACO,532,63,445,539,79,439,442,85,357,435,105,330,443,82,351,586,99,477
39063032ABY,567,115,437,559,152,378,462,142,320,471,181,290,475,138,327,613,200,407
39063032ABR,596,86,482,604,94,476,464,76,388,471,125,346,477,80,383,623,90,521
39063032ABI,481,133,310,485,149,285,324,131,193,328,153,175,333,132,187,496,203,279
39013007ADF,414,125,266,418,100,302,365,131,234,366,162,204,374,116,248,463,110,347
39013007ACP,378,120,229,381,90,277,291,111,180,292,128,164,291,95,185,395,84,305
39013007ABN,691,203,456,701,184,487,573,239,334,574,279,295,575,216,350,754,171,576
39097049AAL,457,109,324,463,151,295,364,112,252,363,149,214,367,127,238,479,147,329
39097049AAM,771,153,582,769,179,566,579,131,448,579,171,408,583,142,423,862,188,662
39059030AAJ,339,110,221,351,132,189,269,126,143,276,155,121,274,118,146,416,139,273
39083042AAS,589,84,472,591,99,469,477,99,378,481,117,364,475,93,367,687,107,570
39129065AAF,595,141,427,598,173,390,457,128,329,454,171,283,461,134,313,883,234,630
39129065AAC,736,197,518,729,234,470,647,189,458,651,270,381,654,210,433,798,280,511
39129065AAB,488,163,310,496,192,288,404,167,237,403,205,198,410,182,219,557,204,349
39129065AAE,640,220,389,654,242,386,488,203,285,489,227,262,491,207,272,613,192,411
39119060ACO,538,90,426,548,124,405,445,118,327,442,161,281,455,125,320,620,118,493
39119060ACM,272,33,235,278,41,228,226,47,179,224,61,163,230,46,180,284,48,232
39119060ACL,830,141,670,849,200,621,667,161,506,673,212,461,679,148,516,977,230,734
39119060AAX,173,28,137,175,29,137,128,23,105,128,29,99,127,21,100,202,30,170
39119060ABZ,191,38,145,191,35,143,150,30,120,151,46,105,152,28,122,223,39,183
39119060AAT,654,236,395,661,282,342,528,238,290,534,292,242,544,238,289,710,296,394
39119060ACI,586,142,417,593,165,406,459,147,312,462,186,276,465,146,310,627,161,463
39119060ABN,636,124,481,658,159,463,495,136,359,497,185,312,501,130,350,717,149,559
39119060ACN,418,67,335,422,74,325,324,55,269,324,95,229,327,64,254,478,64,409
39119060ABX,603,107,464,614,120,468,453,103,350,456,140,316,458,103,344,667,111,542
39119060AAI,519,221,263,538,256,251,382,210,172,385,227,158,381,199,170,582,262,306
39083042AAE,463,131,286,467,153,285,346,130,216,356,141,215,349,124,201,514,150,353
39083042AAU,505,118,351,518,135,357,370,111,259,371,137,234,377,107,257,568,149,410
39083042ABQ,692,105,544,695,103,556,538,91,447,551,128,423,541,92,439,769,114,642
39115058AAL,468,165,269,471,183,266,377,161,216,385,185,200,385,162,209,504,180,313
39115058AAP,584,141,423,604,175,391,463,131,332,485,199,286,494,130,359,627,163,452
39115058AAS,315,97,208,316,94,198,254,76,178,259,106,153,265,89,173,350,92,258
39115058AAU,823,209,576,852,204,611,669,219,450,687,272,415,701,214,460,948,225,711
39059030ABQ,462,81,356,471,82,361,387,101,286,385,115,270,388,94,283,539,93,442
39121061AAV,378,98,261,390,106,264,278,82,196,289,107,182,288,86,191,414,92,318
39059030ACE,739,161,550,762,193,546,580,183,397,579,211,368,586,177,394,880,211,660
39059030AAW,610,190,392,613,231,347,444,194,250,452,240,212,449,181,244,591,207,375
39135068ABQ,610,79,501,627,96,516,487,100,387,488,128,360,491,100,379,673,107,558
39135068AAL,854,164,657,859,204,635,704,187,517,707,227,480,710,182,496,1002,228,767
39135068AAP,1022,160,812,1033,191,797,748,169,579,761,216,545,755,164,555,1134,203,921
39135068ABH,262,35,209,262,42,203,185,46,139,187,71,116,187,43,135,270,46,223
39035018BWA,754,482,218,788,586,158,739,603,136,750,630,120,753,591,136,979,773,189
39035018ARI,375,329,21,408,395,7,286,269,17,293,282,11,297,268,18,354,335,16
39035018ANN,354,290,39,391,369,14,156,139,17,161,148,13,160,133,18,214,189,15
39035018ACA,476,310,135,480,355,109,351,273,78,351,286,65,360,265,85,432,319,104
39035018CTP,831,535,261,867,636,205,734,589,145,744,615,129,746,566,156,919,711,197
39035018CME,681,295,342,712,365,315,495,292,203,513,315,198,512,276,217,672,373,293
39035018AON,330,296,16,369,364,4,212,207,5,212,206,6,216,203,6,230,215,8
39035018AEI,652,292,311,672,353,294,554,310,244,555,335,220,554,301,233,766,425,332
39035018CDB,921,299,583,974,391,549,746,331,415,753,362,391,760,292,442,1032,432,593
39035018BTA,467,283,160,490,337,135,375,290,85,379,302,77,377,267,96,510,379,127
39035018BOO,598,394,174,619,452,143,511,405,106,525,428,97,520,397,110,693,554,134
39035018CHE,661,275,333,680,321,312,501,285,216,509,313,196,515,265,227,717,357,347
39035018AZU,300,197,76,361,284,69,151,105,46,157,113,44,158,110,43,295,170,120
39035018BDV,238,162,50,263,198,58,143,102,41,144,111,33,145,95,44,230,137,86
39035018CEJ,846,373,440,872,443,396,687,385,302,694,421,273,706,372,314,906,473,423
39035018BFJ,172,133,31,191,169,21,138,121,17,139,123,16,137,115,22,175,137,35
39035018ANR,196,141,34,229,196,29,112,94,18,114,96,18,113,90,21,172,140,30
39035018AKB,480,446,16,504,492,7,338,326,12,338,332,6,339,329,7,402,383,15
39035018AWE,552,414,110,566,450,103,479,398,81,485,420,65,486,381,99,652,531,118
39127064ABO,274,88,172,274,84,176,195,76,119,206,103,103,210,77,123,305,95,206
39091046ABD,830,112,693,841,136,681,674,127,547,680,184,496,675,128,521,902,159,728
39091046ABV,588,92,464,595,145,429,486,127,359,493,180,313,491,129,339,670,149,517
39035018BBN,481,218,244,500,268,212,422,273,149,428,285,143,424,243,169,559,304,246
39035018AWX,448,391,34,485,445,30,330,307,23,330,312,18,329,298,23,437,385,46
39035018BVF,771,226,507,808,287,483,668,287,381,674,319,355,680,266,397,851,324,517
39035018BMW,367,338,13,383,372,7,254,227,27,254,244,10,257,233,15,293,282,7
39035018AEK,434,181,219,448,233,188,351,235,116,352,247,105,356,229,122,482,276,202
39035018CSO,876,395,452,898,519,355,811,493,318,806,506,300,811,459,338,976,584,380
39035018BKQ,878,618,235,875,721,126,796,661,135,805,685,120,801,652,142,901,750,141
39035018CQW,865,790,49,887,845,31,720,693,27,727,705,22,719,680,26,846,805,34
39035018AIZ,574,523,31,596,585,5,443,428,15,449,443,6,453,433,14,527,512,12
39035018AOR,286,258,14,319,307,9,199,188,11,201,195,6,203,191,8,257,240,13
39035018AZW,433,328,79,474,416,45,345,301,44,346,314,32,342,293,38,421,353,62
39035018AYX,433,222,191,437,295,125,463,336,127,471,355,116,470,332,123,831,604,218
39035018AJH,327,296,10,351,344,3,258,246,12,256,245,11,262,243,12,275,265,9
39035018CLI,606,257,305,629,284,319,485,245,240,493,274,219,495,238,238,757,337,414
39035018BDE,604,271,279,625,328,258,502,296,206,505,328,177,507,286,198,683,358,317
39035018CCO,615,218,369,641,267,329,493,246,247,495,263,232,503,229,264,703,318,367
39035018BCI,357,228,105,397,292,91,238,180,58,246,191,55,247,176,59,359,236,116
39035018CGO,508,183,305,526,251,240,441,241,200,437,245,192,447,231,192,551,287,249
39035018AGA,682,267,357,720,326,363,582,315,267,599,360,239,596,294,281,772,353,410
39035018BAC,217,156,38,233,179,44,186,156,30,186,163,23,188,153,26,312,237,70
39035018BMQ,546,502,20,587,573,9,355,341,14,366,359,7,369,355,10,433,421,9
39035018CPH,702,293,385,718,390,288,637,378,259,643,420,223,643,377,255,786,495,284
39035018CSV,921,496,385,946,621,296,804,573,231,805,575,230,809,520,267,1041,731,302
39035018CGB,680,284,348,734,345,355,500,298,202,503,319,184,508,284,205,999,523,456
39035018CKF,701,251,421,731,296,403,563,298,265,574,322,252,573,280,289,765,349,407
39075038AAW,458,27,418,433,35,380,379,34,345,392,43,349,389,30,350,587,53,533
39075038AAP,536,32,487,528,36,487,479,33,446,492,40,452,494,29,459,829,39,785
39035018CUQ,867,284,542,883,361,489,756,336,420,778,382,396,775,330,423,971,418,547
39035018AFI,838,252,547,859,343,478,696,329,367,697,359,338,703,317,368,895,393,498
39035018AYN,348,246,73,389,322,57,258,216,42,273,238,35,272,214,50,363,283,77
39035018CBA,634,304,310,648,371,261,561,354,207,565,372,193,564,337,217,733,411,313
39091046ABI,525,102,391,530,97,407,423,95,328,425,123,302,426,99,316,541,88,445
39091046ABZ,617,107,473,619,130,467,481,105,376,483,130,353,484,116,348,713,136,570
39103052AEL,883,211,616,906,261,603,700,261,439,715,309,406,726,256,442,991,297,681
39103052ADO,663,190,434,677,244,410,548,223,325,576,272,304,579,222,338,811,289,508
39063032ACX,454,122,307,467,130,301,353,134,219,356,163,193,361,133,212,464,177,275
39045023AAP,840,216,594,830,262,541,681,219,462,696,292,404,703,240,451,903,334,565
39045023AFF,417,258,134,419,292,106,297,216,81,305,234,71,311,223,77,658,454,195
39045023AEL,651,361,257,667,425,207,505,351,154,524,399,125,532,368,138,760,522,211
39045023AEK,757,460,266,772,532,208,595,452,143,616,487,129,614,460,142,896,690,192
39045023ADV,635,186,424,638,261,339,550,231,319,559,287,272,563,252,297,697,350,340
39045023ABT,933,218,678,949,250,641,766,223,543,775,277,498,784,236,528,1040,307,715
39045023ACF,837,161,637,849,213,598,650,184,466,671,237,434,676,198,460,939,236,689
39045023ABM,808,180,598,822,185,594,661,178,483,674,228,446,685,192,471,906,199,692
39045023ACA,757,211,505,776,255,495,688,282,406,697,312,385,709,288,399,1080,428,637
39103052AEI,329,110,196,337,124,197,269,131,138,284,154,130,277,126,139,404,169,233
39103052AFD,973,266,661,983,342,600,840,317,523,859,344,515,865,316,521,1158,404,746
39103052AFG,564,151,378,560,191,347,467,196,271,479,207,272,483,183,281,741,300,432
39103052ACG,682,238,408,691,295,364,601,297,304,608,313,295,618,294,312,921,426,490
39103052ADU,1115,271,793,1131,335,767,967,334,633,1000,375,625,1008,329,651,1290,394,887
39035018BUW,605,171,426,612,269,322,523,245,278,536,293,243,538,245,283,680,346,333
39035018CHA,758,277,436,804,356,402,649,319,330,655,355,300,659,310,328,818,395,407
39035018AZF,669,436,201,693,547,107,614,499,115,623,526,97,622,514,99,771,633,126
39035018AZJ,418,249,128,452,312,122,303,223,80,305,237,68,301,203,86,425,273,139
39035018DCS,314,298,8,331,321,7,297,285,12,300,291,9,301,277,15,375,353,20
39035018ABH,915,651,234,964,825,119,769,672,97,774,679,95,776,652,117,1057,880,170
39035018ANT,376,331,20,411,403,6,164,157,7,168,165,3,170,158,6,214,195,18
39035018CZX,862,306,497,887,361,485,720,370,350,724,406,318,729,354,355,972,454,510
39035018AMQ,405,380,14,444,435,3,327,315,12,328,321,7,324,305,10,361,340,18
39061031BIT,1060,177,841,1068,278,736,887,245,642,889,293,596,897,225,651,1122,340,760
39061031BKY,1068,505,524,1086,590,441,962,605,357,962,631,331,964,580,353,1252,762,464
39061031AWT,637,242,359,651,295,317,475,248,227,481,259,222,480,235,225,666,350,306
39061031BKW,541,180,340,543,258,247,482,269,213,482,290,192,489,259,216,570,342,220
39061031BNM,238,72,144,240,96,127,191,94,97,193,101,92,190,94,85,245,133,108
39119060ABV,419,94,309,420,95,303,305,93,212,310,117,193,313,106,202,440,122,310
39075038AAY,740,143,549,739,156,547,591,150,441,594,183,411,598,140,438,843,191,643
39075038AAD,981,147,789,1011,159,791,775,145,630,784,187,597,790,128,631,1112,186,914
39075038AAH,399,101,278,400,98,274,281,94,187,281,101,180,285,94,177,449,100,342
39033017ACD,778,124,602,790,131,639,616,128,488,632,200,432,636,142,472,833,137,689
39075038AAR,720,85,599,727,111,589,588,94,494,593,115,478,599,90,488,845,107,729
39075038AAT,440,74,335,447,82,335,347,80,267,349,102,247,348,70,266,503,73,419
39075038AAM,790,136,611,791,159,603,660,157,503,670,171,499,671,138,524,932,176,747
39033017ACR,467,72,371,469,80,372,350,75,275,364,111,253,363,90,263,497,88,395
39075038AAC,319,18,287,293,13,270,250,16,234,251,24,227,256,12,237,436,28,407
39053027AAA,377,109,252,378,100,267,300,108,192,304,137,167,309,116,183,358,106,247
39053027AAI,410,118,275,425,81,330,291,79,212,295,104,191,299,83,210,445,86,357
39119060ACQ,777,192,548,797,249,509,560,195,365,562,244,318,569,191,361,865,232,621
39119060ABS,577,99,453,576,123,435,475,108,367,475,152,323,481,109,349,639,119,511
39119060ABQ,466,93,348,471,106,341,378,95,283,379,128,251,382,97,272,506,112,384
39119060ACJ,547,91,434,559,105,427,426,95,331,429,154,275,430,112,307,606,124,469
39063032ABX,587,81,478,599,117,451,455,88,367,462,123,339,468,84,366,611,121,482
39063032ABE,384,86,276,396,101,275,279,99,180,285,115,170,288,96,182,436,133,287
39103052AEF,611,155,427,632,172,422,530,188,342,544,208,336,546,178,350,951,327,613
39061031AIG,711,634,46,743,719,17,499,469,30,500,483,17,496,449,35,708,668,36
39061031AOR,878,434,400,894,512,342,709,449,260,716,481,235,717,440,261,931,560,354
39061031ATA,562,145,406,553,235,290,509,216,293,509,249,260,512,219,282,644,291,346
39061031BFO,770,142,607,770,224,512,653,215,438,667,237,430,667,201,451,803,301,488
39061031ACE,835,619,167,855,736,96,700,607,93,703,626,77,702,593,88,918,771,137
39061031BQI,612,380,176,635,459,130,668,553,115,678,568,110,683,540,112,819,666,139
39061031AHO,627,388,181,653,469,135,381,315,66,387,331,56,385,310,61,445,333,100
39061031ATS,812,247,546,810,358,408,747,348,399,754,365,389,754,350,392,903,472,414
39033017AAK,498,119,340,503,142,331,356,119,237,359,142,217,358,111,231,555,149,393
39033017ACK,930,165,724,942,189,717,687,171,516,711,237,474,715,174,529,981,208,760
39091046ABE,546,48,467,543,68,454,409,55,354,411,79,332,409,52,339,584,81,497
39091046ABU,476,50,404,471,72,393,386,78,308,388,96,292,386,67,306,486,75,407
39091046AAV,733,93,616,731,129,565,567,128,439,569,168,401,574,117,431,805,143,648
39033017AAV,453,102,309,460,122,315,314,111,203,328,137,191,325,109,200,548,141,396
39033017ABK,476,153,281,486,167,292,341,132,209,348,158,190,346,122,205,572,156,404
39033017ABC,757,204,524,769,222,505,578,194,384,602,242,360,600,203,383,857,248,597
39009005ABO,254,142,97,268,146,108,204,122,82,211,143,68,210,121,79,265,145,113
39009005ABS,302,144,143,320,141,161,258,135,123,268,155,113,262,136,109,331,143,181
39009005ABK,336,219,106,343,236,86,302,225,77,315,244,71,314,232,66,344,260,78
39009005AAV,405,278,100,420,312,82,283,230,53,291,249,42,293,227,49,337,295,39
39009005ABP,757,460,262,774,488,254,705,481,224,720,525,195,718,496,205,846,558,268
39009005ACP,762,340,382,797,321,443,629,308,321,638,356,282,644,342,279,865,336,523
39009005ABX,1023,397,584,1047,393,609,907,393,514,923,484,439,927,424,476,1124,437,670
39063032ACN,460,56,387,457,55,381,381,54,327,387,93,294,389,57,320,538,75,457
39103052ADL,834,201,594,842,239,577,677,253,424,688,289,399,695,251,425,962,327,627
39103052ADB,691,209,446,719,249,440,544,228,316,564,265,299,567,224,322,756,296,457
39119060ACH,504,120,356,525,138,359,392,148,244,396,178,218,397,139,239,591,156,428
39119060ACG,217,45,158,221,53,157,146,50,96,145,56,89,144,45,95,232,46,178
39119060ACK,542,86,429,544,111,408,445,118,327,443,145,298,445,101,335,600,121,467
39119060AAJ,443,234,166,463,313,124,353,257,96,359,276,83,359,247,96,487,318,161
39135068ABT,593,84,477,590,121,444,456,102,354,456,133,323,468,100,353,598,104,481
39135068ABL,482,78,385,485,84,385,398,89,309,405,113,292,400,94,287,514,97,413
39135068AAI,299,41,247,304,67,227,262,61,201,263,81,182,268,54,204,342,54,286
39135068AAN,721,111,570,753,142,572,552,120,432,556,157,399,557,121,403,807,138,658
39053027ABD,434,122,289,432,116,300,349,113,236,352,146,206,353,116,234,466,125,335
39053027ABA,361,109,242,389,56,325,267,49,218,273,79,194,275,53,213,415,59,353
39053027ABJ,341,97,227,350,74,264,279,83,196,283,102,181,287,93,192,378,89,282
39045023AEF,829,168,619,842,207,598,637,180,457,646,237,409,662,196,441,857,195,640
39167084ABS,477,165,295,474,120,338,389,111,278,395,148,247,398,105,285,539,130,400
39167084AAU,400,196,182,412,186,203,328,162,166,333,194,139,341,162,167,467,222,232
39167084AAA,640,216,391,654,170,447,540,175,365,537,214,323,549,167,367,761,213,534
39167084ABW,383,99,268,392,66,318,283,62,221,291,80,211,301,57,236,429,64,362
39033017ABY,867,122,703,877,147,683,630,156,474,653,200,453,652,152,481,925,165,749
39033017ABS,502,76,407,509,85,397,406,81,325,413,121,292,411,83,314,529,112,408
39033017AAF,634,134,458,633,167,434,494,143,351,497,178,319,495,120,346,674,153,511
39033017AAW,396,110,252,401,131,253,273,104,169,290,127,163,286,108,164,449,121,320
39009005ABZ,573,249,292,590,251,316,454,237,217,464,266,198,466,246,210,631,268,351
39009005ABN,781,417,323,784,446,300,680,418,262,697,471,226,702,423,259,880,515,348
39009005ABJ,941,499,404,943,545,347,806,472,334,829,554,275,824,488,318,1004,638,353
39009005ACL,517,274,210,520,287,197,453,278,175,470,314,156,469,276,168,565,273,285
39009005ABG,508,247,237,517,261,225,460,252,208,476,287,189,477,275,187,572,291,272
39009005AAK,372,187,161,442,258,144,196,149,47,201,156,45,202,151,47,165,130,32
39009005ABY,696,330,327,732,322,373,625,311,314,639,348,291,643,321,299,801,360,431
39009005ACM,546,265,245,557,254,268,475,253,222,490,309,181,493,280,195,616,253,356
39119060AAF,479,194,238,495,257,204,344,203,141,344,224,120,346,187,138,520,273,235
39119060AAA,459,152,272,464,200,237,312,152,160,312,173,139,313,148,152,496,216,272
39091046ABL,885,134,711,891,179,676,716,154,562,719,221,498,717,145,538,996,198,788
39053027AAZ,561,167,364,556,110,427,414,117,297,416,143,273,416,118,292,616,115,498
39053027ABF,435,163,255,442,126,291,311,114,197,317,156,161,318,113,198,477,156,314
39053027ABG,518,137,359,525,94,415,404,96,308,412,125,287,414,96,312,632,116,509
39101051AAR,249,67,164,252,73,168,179,65,114,179,77,102,183,62,113,275,70,199
39033017ABI,405,121,256,406,115,267,271,96,175,272,109,163,275,102,155,444,120,317
39033017ACJ,815,174,612,828,198,596,654,166,488,668,218,450,674,170,488,903,208,686
39091046ABJ,392,53,313,401,53,336,298,54,244,300,75,225,301,53,239,428,48,370
39127064AAP,429,116,294,430,112,300,340,92,248,350,121,229,353,96,242,507,102,398
39033017ACF,676,75,558,685,74,579,525,92,433,532,146,386,540,91,426,727,98,618
39097049AAT,1022,178,792,1024,224,764,770,176,594,759,239,520,770,191,550,1085,202,871
39083042AAQ,733,155,543,732,168,535,566,153,413,574,184,390,569,145,412,843,162,675
39083042AAC,601,136,432,594,167,389,456,144,312,462,172,290,460,138,302,645,203,426
39083042AAJ,582,155,393,586,186,371,429,150,279,429,190,239,434,156,263,621,212,401
39129065AAY,794,212,541,801,228,536,596,226,370,602,259,343,605,218,366,969,272,679
39129065ABT,768,154,587,778,154,594,638,146,492,643,201,442,641,153,465,979,191,777
39083042AAT,313,62,238,309,83,215,246,68,178,253,79,174,248,66,178,316,91,221
39083042AAK,542,186,327,541,200,308,412,189,223,416,219,197,412,195,204,580,241,322
39057029AAW,634,202,406,637,275,322,578,272,306,577,300,277,581,249,313,656,339,306
39129065ABG,603,125,442,617,132,449,492,135,357,495,174,321,498,150,344,715,155,554
39083042ABF,470,64,381,467,55,399,370,49,321,377,78,299,368,49,306,527,54,466
39061031ABG,852,340,470,866,437,371,784,447,337,787,480,307,792,446,319,944,576,348
39061031ABJ,808,308,469,810,402,351,720,410,310,731,438,293,731,402,308,879,508,358
39061031BJT,1133,333,782,1099,606,419,1069,585,484,1082,655,427,1100,597,486,1222,769,432
39061031BAE,565,151,400,560,209,332,496,209,287,491,221,270,498,204,282,627,306,311
39061031ARS,768,548,178,781,633,133,555,473,82,559,482,77,556,466,81,684,544,135
39061031BLY,991,539,417,1021,628,367,873,593,280,877,606,271,882,564,300,1085,719,353
39061031BNV,889,240,620,892,326,533,760,304,456,763,323,440,768,283,464,999,436,541
39061031BIB,852,122,710,845,181,644,711,183,528,713,215,498,731,165,543,899,231,656
39061031BJH,833,130,663,843,170,636,645,180,465,643,209,434,647,162,467,1078,269,792
39061031BMM,880,238,598,883,310,527,755,310,445,757,348,409,763,293,440,976,412,540
39061031BGO,700,212,458,701,277,380,603,267,336,602,300,302,606,262,331,769,377,377
39061031AIY,830,510,289,831,624,147,757,579,178,761,608,153,770,582,172,884,695,179
39061031AFI,759,650,86,791,742,39,615,581,34,622,591,31,619,577,31,775,722,46
39119060AAY,318,54,253,322,76,238,238,75,163,238,94,144,240,74,164,363,80,283
39119060AAU,573,176,378,582,219,324,454,159,295,461,214,247,459,156,287,697,252,432
39167084AAY,420,182,209,442,170,256,312,144,168,313,175,138,317,125,176,459,172,278
39167084ABZ,426,146,257,432,113,303,342,114,228,345,137,208,351,109,230,484,137,337
39167084AAO,596,276,295,606,247,320,452,236,216,466,271,195,467,228,221,606,300,293
39053027AAT,218,82,125,218,46,155,153,45,108,151,53,98,154,47,103,226,40,182
39053027AAL,694,196,465,697,152,524,505,142,363,500,175,325,516,152,355,715,187,520
39035018BHP,524,293,177,544,342,186,359,244,115,372,261,111,367,228,121,515,325,184
39103052ABA,739,239,454,760,301,434,627,287,340,638,326,312,646,288,344,843,335,500
39103052AEM,803,189,577,825,244,551,686,242,444,708,267,441,709,229,466,993,301,682
39063032AAO,839,163,649,835,228,577,680,207,473,674,268,406,695,198,478,851,280,558
39005003AAV,303,92,190,313,101,194,212,82,130,212,93,119,211,75,124,385,112,260
39005003ACJ,445,68,346,456,81,349,323,81,242,322,102,220,326,69,248,505,106,390
39005003ABG,926,153,712,949,151,748,712,164,548,725,214,511,728,176,523,998,170,807
39005003AAH,772,202,510,790,242,491,554,211,343,550,229,321,562,201,345,777,253,505
39005003ACI,748,135,559,784,167,585,554,140,414,559,170,389,557,125,416,830,164,647
39005003ACF,630,116,475,647,126,486,484,131,353,484,150,334,494,122,354,672,135,525
39005003ABT,892,172,675,920,181,704,707,185,522,701,209,492,713,170,509,990,206,768
39005003AAJ,699,168,500,701,195,462,516,172,344,522,200,322,524,172,342,739,233,494
39005003ABN,791,173,579,809,215,545,639,203,436,643,247,396,648,199,432,876,229,626
39135068AAW,432,68,349,431,111,310,335,91,244,340,125,215,339,93,228,420,104,308
39135068AAE,379,86,272,381,103,260,249,80,169,256,110,146,258,80,164,391,94,281
39135068AAD,620,117,469,630,150,452,487,131,356,496,180,316,496,129,339,695,167,510
39135068AAC,333,63,260,332,80,242,269,65,204,277,83,194,274,63,194,362,82,275
39135068AAJ,276,41,224,283,55,221,218,45,173,222,67,155,229,41,177,304,57,244
39063032ABN,669,219,418,682,258,380,546,244,302,557,286,271,556,244,290,707,307,388
39103052ADW,868,209,630,881,283,572,715,263,452,734,289,445,735,240,478,1034,327,698
39063032ABU,528,99,411,539,108,404,441,109,332,440,147,293,451,114,323,593,132,449
39103052AEN,1019,249,721,1042,343,672,848,318,530,872,375,497,874,306,546,1210,381,814
39103052ADR,475,141,289,481,143,300,314,132,182,323,164,159,325,124,181,518,142,372
39063032ACY,330,117,190,345,147,174,223,100,123,225,114,111,227,95,118,370,155,209
39119060ABC,356,97,239,363,115,227,248,90,158,252,111,141,250,89,156,359,84,266
39057029AGX,446,58,365,447,85,349,379,73,306,383,95,288,383,66,308,456,80,375
39057029ACP,589,128,427,597,175,388,507,182,325,501,199,302,510,168,320,659,245,399
39035018AHF,733,287,384,774,360,375,569,308,261,576,343,233,578,289,262,814,361,444
39035018AHI,720,308,353,750,370,335,560,316,244,574,374,200,575,314,231,804,376,419
39001001AAA,634,80,532,648,96,532,525,116,409,535,129,406,538,119,404,731,118,605
39139070ACX,698,149,525,696,172,503,626,174,452,626,198,428,632,164,452,765,204,553
39139070AAE,964,308,609,961,353,581,850,334,516,859,392,467,861,333,506,1138,386,739
39139070AAL,769,217,503,780,244,503,650,263,387,666,307,359,667,251,383,850,341,500
39139070AAU,391,234,129,397,244,134,274,192,82,275,205,70,278,187,84,396,209,181
39139070AAX,347,225,96,355,252,89,235,188,47,237,195,42,238,182,46,341,233,101
39139070AAP,706,275,383,706,317,339,586,301,285,591,335,256,591,293,276,751,352,383
39139070AAZ,775,307,405,779,308,429,520,258,262,531,294,237,530,242,264,879,324,539
39139070ACZ,641,141,473,652,153,470,528,134,394,538,165,373,541,131,393,713,152,547
39139070ADF,931,167,713,954,168,753,747,176,571,757,223,534,763,174,576,1044,198,840
39139070ADG,417,62,329,423,74,333,337,86,251,342,101,241,344,78,248,472,82,383
39139070AAM,423,202,177,434,220,175,306,179,127,308,197,111,308,178,120,430,219,202
39119060ACB,204,28,165,208,28,173,157,29,128,154,38,116,157,24,129,198,24,171
39035018BIM,548,336,186,571,400,141,445,334,111,447,347,100,453,318,119,612,434,175
39035018AWW,563,454,69,591,532,50,432,387,45,430,398,32,432,377,43,529,466,60
39035018AOQ,238,193,36,269,237,29,148,128,20,148,129,19,151,124,25,247,191,48
39035018DEA,304,187,92,345,262,75,183,135,48,186,143,43,184,135,47,314,198,111
39035018CFD,761,227,482,803,289,469,636,291,345,650,323,327,656,278,352,840,329,500
39035018AIQ,652,594,30,685,669,13,511,499,12,513,507,6,513,496,15,637,609,25
39035018ARF,251,197,46,275,225,38,218,183,35,224,190,34,221,175,38,316,229,80
39035018CUG,494,391,73,521,449,58,436,395,41,434,395,39,437,380,47,538,470,66
39035018CWK,814,271,510,822,354,432,697,328,369,707,364,343,711,322,375,954,415,533
39035018DDY,526,472,32,565,550,10,411,397,14,412,409,3,419,400,8,504,484,14
39035018CEB,805,307,446,835,406,399,714,411,303,733,447,286,731,404,310,933,501,424
39035018AYV,690,345,331,699,457,193,492,352,140,493,377,116,497,341,136,705,483,215
39035018DBJ,1006,327,641,1067,464,548,867,431,436,876,482,394,886,423,446,1499,746,735
39035018BNY,545,461,63,572,522,44,436,396,40,439,404,35,439,392,43,530,475,55
39035018AIA,587,530,32,620,605,8,481,473,8,487,482,5,493,476,9,559,535,20
39035018CTM,784,505,234,795,604,158,698,559,139,705,588,117,708,546,150,867,702,161
39139070ABO,813,149,618,828,140,662,628,141,487,635,189,446,637,127,492,938,142,791
39139070AAY,415,288,104,420,308,101,290,210,80,291,228,63,292,207,74,412,244,160
39139070ADA,694,169,501,692,188,475,608,195,413,611,234,377,618,188,406,729,226,490
39139070ABX,756,205,489,767,183,545,528,170,358,540,197,343,535,170,346,859,169,679
39139070ADE,925,165,697,940,173,734,766,172,594,768,207,561,776,167,580,970,196,763
39139070AAW,447,169,235,456,180,253,280,141,139,287,156,131,285,130,142,482,165,307
39139070ABN,489,95,358,497,77,397,373,87,286,377,108,269,377,82,277,544,70,457
39091046ABW,388,44,326,394,57,323,318,49,269,316,81,235,318,52,257,417,60,354
39045023ABP,602,136,433,611,155,428,469,122,347,482,159,323,485,123,350,656,149,499
39045023AFA,440,131,287,449,151,277,385,126,259,393,162,231,394,127,256,746,206,528
39045023AFB,536,164,346,548,184,337,476,156,320,485,198,287,490,155,319,671,245,414
39045023ADM,692,204,471,701,259,421,636,259,377,648,301,347,650,276,367,1007,427,570
39045023ADL,893,251,613,895,323,540,788,277,511,795,325,470,799,285,504,968,381,574
39045023AAW,527,186,299,534,213,296,357,130,227,359,182,177,362,140,198,607,215,379
39135068ABI,169,30,132,171,50,114,118,37,81,121,45,76,119,40,74,187,52,133
39135068ABF,425,91,319,421,107,295,301,87,214,294,116,178,301,87,194,464,125,332
39135068AAA,430,86,329,432,117,292,366,104,262,378,144,234,378,108,260,480,140,332
39135068ABM,435,80,325,439,100,322,296,84,212,299,105,194,298,79,200,453,91,351
39063032ABB,585,125,431,580,163,390,488,155,333,502,207,295,503,140,348,625,211,405
39103052AFC,613,159,432,613,215,372,526,209,317,546,235,311,549,197,345,750,289,449
39103052AGF,644,165,449,649,222,396,571,216,355,586,245,341,590,210,366,880,291,577
39103052AFY,739,208,506,743,282,428,624,262,362,637,296,341,644,247,383,869,356,497
39103052ACU,854,282,538,890,347,508,688,320,368,716,355,361,715,316,369,1020,418,580
39035018ABN,513,359,143,568,492,74,532,462,70,529,461,68,529,415,107,557,459,92
39035018BZD,623,314,282,649,403,222,554,374,180,559,398,161,563,354,201,688,465,213
39035018AZK,471,344,107,489,394,70,397,337,60,405,358,47,403,338,55,491,417,69
39035018CMY,738,348,370,763,502,239,683,487,196,693,514,179,690,463,218,907,647,256
39081041ADT,812,336,423,837,298,507,609,323,286,620,349,271,611,283,317,893,299,584
39081041ACK,102,31,60,103,23,77,88,37,51,88,43,45,90,20,63,114,28,84
39081041ADI,543,158,346,552,127,407,405,144,261,418,162,256,418,121,280,576,112,458
39081041AAN,392,127,245,397,144,240,166,88,78,170,99,71,169,77,82,209,110,98
39081041ADM,426,157,232,446,154,269,297,142,155,298,146,152,303,116,175,435,132,293
39035018BAE,286,199,66,355,301,44,191,162,29,192,168,24,193,148,35,308,253,53
39035018DEM,918,840,52,960,925,25,784,757,27,791,776,15,795,759,28,968,935,27
39035018BEC,334,221,87,392,315,63,286,230,56,295,248,47,296,234,55,438,328,105
39113057AWC,672,147,505,681,208,453,604,216,388,611,261,350,615,199,404,711,265,438
39113057AHC,478,349,115,491,408,77,312,249,63,319,268,51,321,251,62,451,351,92
39113057AGR,456,359,79,466,415,40,304,258,46,314,274,40,311,263,37,422,357,56
39113057AAP,899,270,610,908,397,464,754,320,434,764,403,361,773,315,442,1118,542,564
39113057ASU,1046,167,837,1070,258,775,891,260,631,899,296,603,898,242,638,1116,319,788
39113057ATG,601,88,494,616,114,487,487,92,395,487,117,370,491,93,385,647,120,520
39113057AOY,808,328,454,800,446,305,722,439,283,735,479,256,739,444,284,840,540,286
39113057AXF,972,459,460,988,561,386,799,492,307,807,533,274,809,478,299,1091,645,430
39113057AUM,508,148,330,527,171,338,335,131,204,345,153,192,345,119,212,523,161,352
39081041ADA,426,135,267,436,116,306,358,148,210,365,162,203,364,121,233,462,110,343
39045023AAX,492,149,306,506,165,308,368,145,223,380,189,191,379,141,219,578,210,355
39119060ACC,777,168,587,790,214,543,593,188,405,594,222,372,599,183,406,863,247,608
39009005ACJ,539,143,366,560,146,399,442,143,299,456,169,287,457,151,299,603,146,450
39009005AAU,457,341,98,463,383,58,411,353,58,424,378,46,426,362,52,454,391,58
39139070AAG,577,212,332,576,237,307,481,213,268,487,250,237,486,224,253,638,287,340
39101051ABU,345,78,235,348,78,254,275,72,203,282,101,181,284,77,192,386,76,303
39101051ABD,353,153,173,374,164,180,239,130,109,245,141,104,241,121,106,416,159,245
39101051ACP,264,64,183,260,68,179,198,59,139,202,79,123,195,68,117,275,70,201
39035018APP,301,276,13,313,302,7,216,208,8,218,210,8,222,206,12,259,244,10
39117059AAY,510,77,405,511,90,404,413,99,314,418,132,286,424,104,307,591,112,469
39045023AAB,659,184,440,668,209,425,500,177,323,505,232,273,514,181,312,648,206,433
39045023AAC,688,189,463,685,224,431,546,190,356,552,252,300,553,199,343,745,245,485
39089045AEY,759,177,540,778,206,524,600,192,408,611,231,380,614,198,399,884,252,612
39089045AEV,863,325,501,889,384,452,649,319,330,653,354,299,658,311,331,1052,515,517
39089045AAP,618,192,378,615,216,361,421,190,231,433,211,222,428,181,234,681,231,426
39089045AAQ,804,302,445,811,330,433,584,275,309,600,350,250,593,293,271,1028,390,618
39071036AAF,622,172,414,634,221,389,399,159,240,402,177,225,401,148,238,626,177,441
39071036ABJ,971,149,785,977,144,797,737,145,592,735,176,559,744,143,577,1039,152,878
39167084ABG,133,34,90,148,14,131,77,11,66,79,20,59,81,11,68,140,17,123
39163082AAA,129,32,87,136,31,95,91,35,56,95,44,51,94,36,57,137,38,97
39163082AAL,329,84,230,337,75,243,256,79,177,260,92,168,257,89,160,352,76,273
39139070ABL,383,67,292,389,76,293,286,53,233,291,81,210,295,57,223,438,72,360
39017009AMF,813,201,564,841,254,538,616,225,391,628,257,371,625,224,374,950,348,586
39089045AAX,1193,390,759,1187,489,657,1090,452,638,1110,519,591,1107,457,621,1481,629,835
39089045ADW,753,178,541,755,186,538,604,155,449,615,203,412,610,160,435,829,199,615
39089045AFH,996,260,670,1009,273,671,785,257,528,798,345,453,808,275,507,1165,339,809
39089045AFF,1066,233,775,1079,297,734,929,282,647,941,348,593,943,280,633,1229,336,868
39089045ADP,959,171,743,969,208,731,820,189,631,834,251,583,842,215,611,1052,245,797
39089045AFR,791,372,393,795,429,329,661,404,257,682,443,239,677,409,247,947,597,337
39089045ACJ,978,189,749,976,214,726,856,180,676,867,268,599,880,215,634,1101,239,846
39089045ABU,501,165,305,515,190,303,368,158,210,377,191,186,374,157,207,572,233,328
39017009AHH,1060,192,826,1087,267,772,857,249,608,869,278,591,874,233,612,1190,304,875
39173087ADC,756,230,502,754,295,416,622,259,363,635,307,328,634,264,354,811,330,471
39173087AEJ,584,141,401,602,176,389,448,151,297,450,200,250,457,137,294,642,181,450
39173087AEK,528,139,366,545,148,372,400,124,276,401,167,234,404,122,275,580,150,421
39173087ABT,702,216,433,706,252,393,582,247,335,589,337,252,594,251,315,758,305,439
39173087ADM,633,136,461,638,158,432,494,152,342,501,215,286,510,143,347,683,168,504
39173087ADN,238,69,153,242,98,121,178,76,102,183,102,81,183,70,103,243,109,122
39069035AAS,446,171,251,455,202,227,350,141,209,357,187,170,361,141,201,490,190,290
39069035AAO,672,156,476,677,192,443,527,181,346,540,235,305,539,167,348,713,233,471
39003002AES,739,90,618,742,102,615,616,98,518,622,147,475,623,92,517,821,107,705
39003002ABP,266,120,119,276,159,110,180,103,77,184,117,67,183,102,73,245,137,105
39003002AGN,647,80,545,655,100,536,547,97,450,548,131,417,544,98,427,693,109,574
39069035AAQ,570,115,426,581,135,409,435,122,313,445,165,280,455,110,327,608,138,461
39069035AAP,524,72,434,526,101,404,423,104,319,422,147,275,426,79,336,570,121,441
39061031BJB,572,87,453,593,128,448,383,95,288,382,116,266,385,90,280,595,137,451
39061031BEH,820,91,698,831,148,640,693,130,563,696,182,514,705,121,569,857,188,657
39061031BOH,817,118,658,841,169,642,645,154,491,644,175,469,644,135,485,958,184,760
39061031BOJ,610,96,485,630,117,488,469,121,348,465,124,341,470,102,351,674,131,534
39061031ATE,857,213,617,847,345,461,755,290,465,749,334,415,766,275,466,921,444,462
39061031BBV,882,291,551,903,352,495,654,308,346,657,337,320,666,274,366,967,430,516
39173087AAZ,759,309,426,779,352,380,593,326,267,590,365,225,598,318,256,865,470,379
39173087ADI,759,211,512,771,277,452,585,240,345,591,301,290,599,221,351,831,301,510
39017009AAK,580,257,295,590,312,241,417,253,164,434,267,167,432,249,167,601,380,208
39017009AAF,536,322,183,569,370,160,431,318,113,446,334,112,445,310,107,705,482,213
39017009ACJ,690,154,512,700,223,456,502,156,346,516,191,325,502,153,327,699,202,486
39057029AFO,199,140,46,202,165,33,159,131,28,159,130,29,159,123,30,227,184,39
39057029AGK,543,101,420,544,133,382,475,121,354,479,175,304,482,126,349,552,176,364
39057029AEC,1069,583,429,1099,676,344,829,513,316,832,539,293,836,487,308,1094,629,437
39057029AHA,628,32,571,585,44,500,336,37,299,334,49,285,341,23,305,324,44,262
39057029ADG,440,124,288,453,190,242,199,84,115,199,96,103,199,81,106,470,214,248
39057029ADL,484,163,283,496,202,258,262,124,138,261,140,121,262,109,136,498,222,256
39005003AAU,637,132,478,647,196,424,548,180,368,559,224,335,561,169,376,716,240,470
39163082AAQ,313,90,202,329,88,226,237,75,162,245,97,148,245,85,155,357,75,276
39163082AAF,226,72,137,227,75,144,168,62,106,175,67,108,170,57,110,275,68,205
39163082AAD,182,51,123,182,51,119,135,44,91,136,50,86,134,44,83,196,41,154
39013007ADB,899,248,620,911,227,647,722,254,468,720,307,413,720,212,499,1062,238,818
39091046AAX,702,111,553,698,146,519,546,142,404,556,183,373,552,152,371,718,177,532
39057029AAP,866,219,619,845,283,519,734,255,479,734,315,419,742,240,482,930,361,556
39057029AAJ,647,166,461,648,211,395,578,200,378,577,245,332,585,197,375,669,250,402
39049025AXW,757,335,407,750,413,294,731,390,341,731,456,275,736,411,316,831,524,292
39105053AAC,584,134,437,611,103,488,476,93,383,483,141,342,485,101,367,680,111,563
39105053AAD,602,127,457,625,103,496,466,84,382,482,130,352,486,93,387,677,119,550
39105053AAJ,508,125,359,530,92,417,428,114,314,435,150,285,435,128,295,603,122,472
39105053ABB,373,120,239,398,94,290,302,71,231,312,106,206,315,75,236,429,97,325
39105053AAI,328,88,223,339,70,248,279,84,195,284,115,169,287,88,191,378,81,292
39117059AAK,832,178,619,842,189,628,725,196,529,731,239,492,731,204,507,983,243,727
39117059AAE,574,113,436,568,132,408,447,128,319,446,167,279,448,131,302,635,150,467
39069035AAT,735,154,543,740,182,517,516,153,363,528,226,302,539,158,364,776,201,567
39003002AGL,416,57,340,416,62,336,293,56,237,291,86,205,294,51,231,436,72,355
39003002AGK,441,58,355,442,60,351,326,57,269,324,101,223,325,65,255,504,89,399
39003002AFP,436,83,327,448,99,322,341,104,237,336,134,202,347,100,231,481,121,343
39003002AEX,469,30,424,475,45,416,375,40,335,371,77,294,375,35,337,502,42,455
39003002AAG,220,43,162,222,38,167,153,48,105,154,63,91,153,39,109,237,47,180
39003002ACD,699,256,418,705,318,361,572,286,286,568,330,238,570,256,303,791,335,447
39003002AFB,521,112,380,522,133,365,380,114,266,384,153,231,383,104,270,526,122,401
39163082AAU,303,83,199,309,72,227,225,79,146,236,99,137,231,91,130,332,75,256
39061031BDX,955,112,806,982,163,782,776,154,622,768,168,600,786,132,627,1040,189,840
39061031ALU,407,233,145,415,283,118,290,194,96,291,204,87,293,193,93,401,277,118
39061031AMW,691,429,232,698,505,169,620,460,160,617,468,149,621,441,168,735,574,153
39061031ANF,955,636,279,956,770,162,779,636,143,787,660,127,789,621,149,994,829,158
39061031AYF,928,437,473,926,598,280,863,549,314,864,599,265,870,546,296,1025,714,303
39061031AKW,584,148,392,610,192,392,489,186,303,493,210,283,495,174,300,662,237,406
39061031BDL,454,173,255,445,236,188,348,226,122,350,238,112,355,215,131,481,287,189
39061031BDQ,8,1,6,8,1,6,4,0,4,4,0,4,4,0,4,9,3,6
39013007ABZ,401,113,254,412,110,286,304,114,190,312,147,165,310,103,198,443,106,334
39013007ABV,611,220,357,623,218,363,471,238,233,475,253,222,479,198,264,666,233,420
39013007ABQ,357,130,201,364,123,222,251,116,135,256,141,115,256,117,127,361,121,237
39013007ACF,594,179,393,607,172,413,472,200,272,474,238,236,481,174,302,650,191,453
39021011AAN,642,162,425,641,239,370,536,205,331,551,284,267,546,207,321,698,289,396
39095048ACI,660,225,411,677,293,334,540,263,277,535,279,256,548,258,271,693,329,352
39095048AHG,544,490,33,574,554,13,350,327,23,360,345,15,357,336,15,400,377,17
39095048AKM,635,558,47,656,609,35,475,442,33,484,459,25,487,444,38,491,448,38
39095048AAU,855,348,473,872,415,411,729,419,310,735,472,263,746,412,315,990,521,456
39095048AAT,1009,409,570,1029,479,486,642,350,292,644,399,245,654,350,285,925,493,409
39095048AEO,374,304,48,396,349,42,252,226,26,255,233,22,256,213,36,322,273,47
39095048AJE,499,238,214,513,277,188,396,258,138,401,285,116,402,256,128,509,307,183
39095048ASK,907,271,609,929,325,567,763,290,473,766,363,403,778,280,470,1022,331,672
39095048ATJ,418,157,244,424,175,221,320,157,163,325,188,137,329,156,162,423,152,264
39095048ATL,306,110,180,312,124,172,248,115,133,250,135,115,256,117,126,365,138,225
39095048ARB,631,301,304,647,353,258,479,291,188,488,326,162,491,283,191,657,377,277
39027014AAI,421,120,286,417,145,250,335,133,202,337,150,187,337,135,188,484,179,295
39027014AAU,877,127,715,889,137,725,680,139,541,680,160,520,686,130,533,975,150,807
39027014ABT,693,104,565,711,120,574,608,123,485,611,161,450,610,122,468,793,146,640
39027014ABX,244,39,194,255,44,205,208,44,164,208,63,145,206,35,167,271,44,223
39027014ABM,548,116,400,555,122,404,394,134,260,396,157,239,396,112,258,598,149,437
39027014ABI,326,58,249,330,55,267,247,70,177,247,71,176,248,55,180,366,67,289
39057029ADJ,729,150,551,742,214,492,687,228,459,688,269,419,691,224,441,1011,356,633
39101051ADF,633,119,491,638,145,459,558,149,409,563,197,366,566,162,391,679,170,505
39035018CAE,630,476,118,658,536,109,463,396,67,464,406,58,466,379,73,647,520,123
39035018CTX,676,303,344,692,396,269,572,368,204,590,394,196,590,353,225,705,476,221
39095048AMK,777,402,326,793,464,273,637,410,227,642,453,189,646,413,201,826,531,276
39095048AVL,1157,341,792,1162,468,646,1058,470,588,1066,560,506,1081,429,624,1367,607,752
39095048ARW,1078,344,713,1088,447,596,1056,487,569,1065,593,472,1074,477,579,1382,628,743
39095048AVE,1097,343,734,1112,413,656,945,408,537,948,448,500,958,388,557,1337,533,793
39027014ABY,658,97,540,667,107,540,560,119,441,559,144,415,561,113,434,757,141,606
39095048ANJ,493,330,119,507,382,92,310,236,74,311,250,61,312,238,63,433,317,108
39095048ANE,356,226,103,375,272,76,205,162,43,203,164,39,205,147,42,291,202,81
39095048ATY,727,274,429,742,354,345,616,337,279,617,375,242,626,326,285,781,425,340
39095048AAA,781,289,441,797,378,359,626,339,287,630,388,242,661,353,274,860,439,411
39117059AAL,763,138,583,787,167,585,629,148,481,633,182,451,639,144,470,848,150,683
39093047AEJ,668,407,214,681,448,206,521,373,148,536,407,129,534,378,143,736,475,247
39093047ADE,341,250,68,362,294,61,203,160,43,211,180,31,211,161,43,390,280,105
39093047AHL,861,791,30,869,836,20,586,572,14,593,582,11,593,566,14,482,468,11
39093047AKD,840,210,576,853,264,534,700,252,448,716,309,407,723,243,457,931,300,620
39099050ACO,650,545,62,667,616,40,440,407,33,451,423,28,449,412,27,586,514,65
39099050AJP,848,196,620,855,251,578,736,228,508,743,302,441,748,251,483,1014,340,660
39093047AEC,304,161,122,318,186,113,213,144,69,226,166,60,227,150,71,324,178,138
39093047ALH,901,301,567,933,390,493,909,462,447,933,530,403,946,469,462,1472,743,714
39093047AIN,956,285,632,968,357,577,877,382,495,908,460,448,924,380,510,1189,439,728
39093047AEX,550,400,111,568,436,96,341,267,74,356,289,67,352,271,72,512,354,149
39109055ADF,549,77,452,558,102,439,450,85,365,459,117,342,465,89,364,644,121,517
39109055ACT,555,64,468,558,94,439,410,72,338,416,103,313,424,76,332,582,101,471
39159080AAS,432,96,304,439,111,302,297,91,206,301,104,197,303,84,205,474,105,360
39095048AOX,725,307,383,744,387,307,559,342,217,561,377,184,575,356,200,737,442,281
39027014ABR,331,58,263,332,65,255,249,58,191,252,74,178,255,60,187,343,67,272
39027014ACB,516,82,422,517,107,395,438,99,339,446,125,321,446,92,338,551,116,425
39095048ADK,493,371,89,512,425,70,247,217,30,252,224,28,250,209,27,369,298,57
39095048ARI,579,278,287,589,319,242,510,310,200,512,330,182,517,297,204,605,341,261
39095048ASJ,568,162,380,583,199,354,457,185,272,463,222,241,461,194,249,638,216,410
39095048AHH,475,329,123,497,399,73,355,285,70,358,295,63,362,280,72,507,396,106
39163082AAH,281,92,168,286,76,192,189,57,132,190,91,99,191,63,124,300,64,232
39163082AAP,334,93,230,346,65,266,232,76,156,246,102,144,240,83,147,388,74,310
39163082AAN,155,54,89,158,48,106,118,41,77,118,48,70,117,42,70,154,36,117
39163082AAG,577,149,395,596,113,447,416,112,304,426,153,273,430,133,289,678,123,544
39013007AAA,578,217,316,594,193,377,420,213,207,426,240,186,433,186,238,600,191,403
39159080ABX,958,215,729,950,360,561,1014,375,639,1015,457,558,1023,400,611,1406,686,703
39159080ABA,971,189,756,987,255,695,877,237,640,880,288,592,886,238,621,1198,365,813
39159080AAW,704,106,568,704,135,525,613,116,497,610,143,467,615,126,475,765,170,588
39155078ACS,566,291,224,577,315,234,402,239,163,411,265,146,411,235,157,609,302,290
39155078AJB,780,238,505,779,249,495,625,253,372,632,312,320,628,274,341,860,286,554
39155078ADW,446,328,94,455,348,90,279,226,53,287,236,51,284,219,58,404,294,104
39155078AHK,650,256,353,661,288,344,502,249,253,507,286,221,506,251,246,678,294,373
39147074ACF,328,79,231,340,81,241,259,82,177,268,107,161,271,81,177,365,97,260
39053027ABC,468,127,320,470,109,343,353,103,250,356,131,225,356,115,232,498,124,364
39001001ABG,565,89,450,578,99,464,454,100,354,469,117,352,480,104,367,632,100,527
39001001ABC,501,133,344,509,150,344,350,119,231,361,143,218,368,117,236,557,145,406
39151076ACI,294,177,92,301,188,104,212,138,74,212,141,71,215,130,71,279,154,120
39151076AAC,454,155,269,458,190,249,304,154,150,308,167,141,309,159,132,489,202,275
39151076AKL,842,223,564,858,261,549,648,221,427,667,266,401,666,224,416,931,282,639
39151076AIL,639,175,433,654,227,405,536,210,326,543,244,299,550,215,319,739,307,426
39151076ANH,401,186,189,417,217,182,300,171,129,306,190,116,307,169,127,414,209,197
39151076AJP,547,114,403,554,136,390,441,147,294,449,182,267,455,141,298,602,152,449
39151076ANA,606,220,346,614,253,322,491,232,259,494,256,238,497,221,263,671,293,362
39151076ALY,621,177,396,635,197,397,472,190,282,480,226,254,475,195,262,693,206,464
39151076AOI,621,135,453,629,153,455,527,169,358,540,187,353,542,168,349,740,181,549
39095048AUZ,522,142,364,543,167,345,445,156,289,449,190,259,449,153,280,601,195,400
39095048AUY,574,169,382,590,225,333,503,199,304,504,241,263,508,203,293,698,275,415
39095048AUX,914,243,644,937,322,566,786,318,468,788,374,414,794,310,468,1136,428,688
39095048ADR,423,337,62,436,379,43,212,179,33,214,188,26,214,175,32,308,250,48
39095048AHD,384,341,23,397,376,9,278,271,7,284,276,8,281,264,11,310,294,14
39095048ABK,790,312,446,809,343,423,665,368,297,676,421,255,679,343,312,892,402,475
39095048ABM,1047,375,637,1080,442,587,825,390,435,827,447,380,835,370,433,1099,444,642
39095048ABO,990,438,509,1024,517,470,826,481,345,826,549,277,835,464,346,1008,527,469
39095048AHX,627,344,242,652,411,203,497,348,149,504,380,124,506,330,143,626,409,200
39095048AOU,615,316,268,631,362,227,455,301,154,464,336,128,476,302,151,671,412,240
39095048AQH,687,330,333,709,361,303,533,333,200,551,374,177,559,326,217,751,393,347
39095048ACY,570,267,274,583,268,276,434,241,193,433,274,159,436,236,186,598,296,291
39095048ATC,778,346,395,798,402,362,662,360,302,667,395,272,668,344,307,912,464,442
39095048AHU,570,349,182,589,380,168,495,362,133,500,379,121,500,343,127,679,462,209
39095048AVZ,803,496,246,835,541,227,506,372,134,502,391,111,510,361,130,693,490,186
39095048ATS,744,280,441,755,374,361,619,334,285,628,368,260,629,325,294,817,444,367
39005003AAZ,460,121,302,478,128,317,329,120,209,325,136,189,333,104,207,548,130,413
39005003AAG,658,154,458,680,161,470,461,139,322,464,157,307,471,126,326,687,177,493
39139070AAO,682,272,372,678,277,373,551,250,301,568,307,261,566,266,288,739,306,414
39139070ACN,733,212,497,754,207,506,589,186,403,587,226,361,601,192,382,814,251,550
39095048ALB,372,347,14,389,381,4,247,242,5,247,245,2,247,235,6,269,255,9
39027014ABE,617,77,511,631,92,526,521,85,436,521,102,419,518,76,430,736,103,622
39027014ABA,584,66,496,585,72,491,417,63,354,415,78,337,413,57,341,658,85,559
39095048ARV,807,223,567,820,291,497,699,278,421,698,328,370,711,285,409,928,393,527
39095048AQI,718,330,334,762,406,315,546,316,230,562,374,188,559,313,212,785,417,349
39095048AJW,426,303,98,431,325,78,304,239,65,305,250,55,306,235,62,425,343,76
39159080AAG,677,179,466,683,206,441,640,206,434,639,259,380,640,209,410,1230,464,748
39159080ACA,763,170,555,766,238,495,689,213,476,691,274,417,695,219,449,633,231,395
39151076AOB,964,215,687,977,229,719,749,204,545,757,252,505,760,191,542,1091,217,859
39151076ABU,432,307,96,441,342,81,298,236,62,304,248,56,299,231,59,486,360,112
39151076AKU,905,283,583,898,332,530,731,313,418,743,341,402,744,295,423,1001,398,594
39155078AEX,398,82,297,402,83,299,309,77,232,312,98,214,319,76,231,450,87,356
39155078AKT,739,257,437,755,319,394,561,278,283,566,324,242,570,289,264,795,342,440
39095048ASP,743,298,388,763,334,373,518,287,231,524,325,199,528,282,214,806,426,371
39095048AMH,614,343,231,633,381,207,422,281,141,425,295,130,422,271,138,570,353,205
39095048AQP,703,278,387,727,337,344,584,322,262,587,362,225,595,314,259,776,357,400
39095048ACC,884,362,488,903,456,401,706,423,283,718,470,248,729,412,296,923,546,360
39095048ADI,572,307,203,602,385,173,343,234,109,344,263,81,346,236,94,457,273,179
39095048AUG,619,238,360,631,294,307,546,271,275,553,306,247,558,269,279,740,373,355
39095048ATP,911,338,552,929,444,448,772,396,376,780,445,335,786,394,365,1041,558,470
39095048AVV,778,249,507,798,311,442,745,344,401,745,406,339,748,330,402,1154,508,632
39095048AEP,398,290,88,406,323,66,306,259,47,308,272,36,311,248,51,401,333,65
39095048AQZ,736,441,260,766,495,223,543,413,130,548,435,113,558,424,111,691,488,191
39095048AET,627,532,70,644,585,41,442,400,42,446,408,38,448,398,45,522,475,45
39095048ASA,970,459,491,977,554,378,879,524,355,879,570,309,887,523,346,1078,694,366
39095048ASB,995,420,560,984,539,403,815,442,373,819,491,328,838,442,369,1049,644,388
39095048ASC,760,284,459,758,407,314,713,411,302,721,452,269,728,412,304,902,532,360
39095048AOM,386,207,155,402,231,149,244,154,90,249,164,85,250,153,86,384,214,163
39095048AAO,963,414,500,982,498,417,802,477,325,812,535,277,817,486,304,1053,601,429
39027014ACD,629,89,509,644,115,498,547,125,422,550,144,406,555,111,423,669,142,520
39005003ACV,661,127,508,688,131,527,515,143,372,523,164,359,529,134,381,744,149,583
39005003ABC,529,135,349,534,147,362,339,112,227,340,121,219,345,92,228,571,131,436
39151076ABD,557,457,68,569,487,60,366,330,36,370,339,31,368,311,42,491,403,84
39147074ACN,263,50,199,264,58,182,175,55,120,183,69,114,178,59,108,265,65,194
39147074ABJ,614,106,477,627,150,433,475,122,353,487,186,301,490,124,344,696,145,539
39165083ADD,836,119,683,864,179,640,719,169,550,742,189,553,745,169,554,960,218,730
39165083ADE,491,94,376,506,123,362,396,115,281,406,135,271,405,107,285,560,179,374
39165083AGV,442,56,374,446,86,337,393,84,309,410,97,313,406,74,326,500,111,380
39155078AII,893,463,379,921,516,374,720,436,284,729,503,226,723,449,254,983,538,436
39097049AAR,876,146,664,878,182,648,660,142,518,658,176,482,658,163,468,974,215,745
39013007ACH,605,204,371,615,178,411,459,216,243,470,261,209,470,204,261,646,184,453
39013007ACO,720,162,517,725,186,507,616,200,416,625,248,377,632,180,441,783,205,573
39159080AAJ,790,226,511,790,266,468,614,258,356,612,300,312,618,261,332,832,352,452
39099050ANH,676,197,448,694,200,469,560,185,375,559,225,334,568,206,350,529,158,364
39093047AKH,399,188,181,408,187,201,301,170,131,312,191,121,313,162,138,446,186,255
39109055AAD,476,111,331,483,151,307,288,106,182,292,129,163,295,97,184,530,152,370
39095048ADT,305,151,130,307,168,119,292,182,110,294,198,96,296,169,115,405,206,190
39027014ACC,570,84,458,575,112,439,430,98,332,428,121,307,433,94,332,643,128,507
39027014AAM,397,114,257,410,142,243,319,149,170,322,161,161,322,144,166,479,179,288
39139070ABF,486,105,354,503,111,365,407,120,287,420,169,251,428,125,285,533,131,395
39139070ABM,288,48,219,290,50,231,228,57,171,224,63,161,230,51,169,299,44,254
39139070ACI,616,97,485,632,103,513,516,107,409,518,132,386,521,98,412,696,117,574
39151076AHT,476,152,286,484,191,266,372,172,200,376,189,187,379,169,193,643,284,350
39101051ACY,469,93,365,467,115,334,423,105,318,428,134,294,430,117,305,484,123,353
39101051ACN,772,208,500,786,219,509,553,214,339,555,240,315,558,200,328,862,240,603
39101051AAD,385,139,219,394,136,233,273,114,159,279,122,157,275,99,160,416,128,275
39117059AAM,196,54,126,197,60,127,125,36,89,127,51,76,129,42,78,203,50,147
39117059AAQ,315,88,212,320,95,198,218,82,136,225,100,125,222,78,139,325,105,215
39071036AAY,337,45,283,345,42,291,235,45,190,233,48,185,239,45,183,369,57,310
39139070ACQ,478,106,347,476,109,345,383,116,267,388,139,249,386,114,261,506,119,382
39013007ACD,188,60,118,194,53,139,145,56,89,145,62,83,146,52,93,214,56,157
39013007ABI,694,245,417,706,238,442,535,252,283,537,296,241,538,232,298,737,261,470
39013007ADE,355,75,263,363,65,281,286,81,205,293,106,187,292,78,203,379,80,293
39139070ACR,898,169,680,913,186,697,744,178,566,757,217,540,762,168,570,984,215,761
39097049AAC,1077,273,740,1072,378,645,902,350,552,903,431,472,905,352,530,1218,449,745
39097049AAE,869,258,565,883,319,515,682,243,439,674,313,361,683,269,396,1046,402,622
39139070ACT,553,143,391,558,175,371,448,152,296,453,179,274,454,149,298,580,182,392
39079040ABE,498,141,338,508,136,349,400,118,282,404,153,251,413,124,279,555,152,399
39067034AAV,202,46,140,201,35,163,178,53,125,176,62,114,177,49,123,229,34,194
39029015AAA,360,126,206,385,137,227,259,103,156,265,113,152,261,101,153,445,138,302
39029015ACC,478,107,336,474,111,341,347,99,248,357,119,238,355,108,235,524,117,398
39099050AJS,310,105,179,327,126,191,253,95,158,260,122,138,260,95,155,331,121,208
39099050ASJ,450,346,72,461,391,58,286,248,38,297,262,35,295,254,40,365,298,65
39029015ADC,713,180,494,717,187,489,594,211,383,611,252,359,610,211,385,775,220,546
39029015ADQ,554,145,371,573,140,414,413,140,273,430,154,276,422,134,274,625,143,471
39029015ABV,437,196,212,453,194,237,312,147,165,323,170,153,322,150,163,475,183,282
39029015AEF,604,160,411,625,160,449,474,170,304,495,194,301,486,168,307,682,203,473
39029015AFH,323,112,190,345,96,235,244,91,153,250,107,143,247,89,153,364,95,261
39029015ADO,446,114,314,460,103,344,355,97,258,361,110,251,356,92,258,479,95,376
39049025BBR,558,205,334,560,288,247,517,257,260,513,305,208,525,290,223,632,357,271
39049025AZV,976,285,653,990,364,578,850,381,469,853,450,403,863,407,442,1189,550,616
39049025BAB,629,161,445,643,192,411,536,172,364,535,202,333,537,174,354,671,203,458
39049025AKO,459,208,208,473,231,204,288,162,126,290,180,110,291,160,117,483,251,222
39049025AQR,502,203,281,502,250,222,435,239,196,444,273,171,441,256,178,541,332,203
39049025ASJ,739,317,390,742,386,319,684,368,316,685,407,278,686,369,305,832,493,326
39049025ASI,557,205,335,553,245,282,507,239,268,510,275,235,516,246,252,607,312,286
39049025ADQ,812,579,152,832,649,100,788,698,90,800,728,72,800,694,74,868,757,96
39049025ADU,716,558,117,736,633,64,708,636,72,715,662,53,716,634,64,810,723,79
39049025ACQ,565,242,293,583,282,272,430,231,199,433,265,168,430,228,191,635,318,306
39049025AYW,649,172,439,680,211,439,448,165,283,455,201,254,453,155,289,707,225,472
39049025AHV,518,198,274,531,222,268,387,183,204,389,211,178,395,197,181,594,277,298
39049025AHF,355,252,88,366,286,65,299,242,57,304,262,42,303,244,55,401,333,62
39049025AGM,501,364,105,532,433,84,342,284,58,348,302,46,353,289,49,498,385,108
39139070ABH,454,109,316,459,110,319,352,125,227,359,154,205,359,121,219,485,142,330
39119060ABF,413,112,273,421,143,258,335,130,205,343,154,189,346,123,216,432,138,288
39119060ABB,757,150,586,765,176,560,611,176,435,616,232,384,623,191,415,873,217,646
39099050AOF,437,163,257,450,189,247,384,175,209,388,221,167,386,190,186,483,224,253
39099050ABP,445,201,225,461,217,233,360,196,164,369,242,127,369,218,141,469,219,243
39073037AAW,835,206,589,831,217,574,683,201,482,688,251,437,690,208,461,957,256,687
39073037ABD,367,144,203,367,125,222,280,123,157,284,146,138,285,126,143,394,126,260
39021011AAR,469,131,298,480,160,286,314,124,190,311,148,163,316,124,173,504,157,334
39021011AAH,764,158,585,755,235,490,655,195,460,655,255,400,660,192,450,795,271,517
39021011AAP,486,126,325,488,147,308,358,118,240,364,158,206,364,121,222,535,153,369
39171086ABE,381,74,276,391,89,274,283,72,211,289,118,171,291,74,202,411,104,304
39151076ALU,701,204,452,715,218,456,546,190,356,555,211,344,561,183,355,768,200,553
39151076AIG,765,215,522,785,290,461,642,278,364,642,305,337,645,271,357,853,368,473
39151076ALF,853,291,515,869,340,473,674,321,353,681,365,316,686,311,349,974,380,579
39151076ACD,714,480,189,720,517,176,499,366,133,510,381,129,510,355,133,701,445,250
39151076ADR,754,231,464,760,232,477,558,235,323,563,267,296,567,233,310,813,273,525
39151076ADN,428,142,259,437,143,261,322,144,178,326,167,159,328,145,173,545,196,340
39151076AFM,646,134,454,635,158,448,512,147,365,517,187,330,529,155,352,693,169,510
39151076AAX,491,274,185,489,296,166,373,237,136,371,248,123,373,227,131,543,320,210
39151076ACY,916,358,513,933,456,452,797,415,382,806,457,349,812,421,368,1027,506,500
39099050ASI,548,497,38,574,545,21,374,355,19,378,367,11,379,355,18,479,435,39
39099050ARC,396,329,48,415,365,40,319,289,30,325,300,25,319,282,25,380,329,47
39029015ACK,494,100,360,496,104,361,379,106,273,386,133,253,383,101,261,519,110,404
39029015AAF,387,158,206,392,156,217,283,140,143,287,153,134,280,131,130,403,161,231
39099050ASG,360,326,25,371,352,13,279,262,17,281,270,11,285,271,11,348,321,26
39099050AOQ,808,245,538,818,278,511,707,244,463,711,303,408,709,255,439,947,295,643
39099050AJN,619,181,410,638,216,399,513,197,316,522,243,279,524,214,297,711,240,465
39099050AQZ,828,371,435,844,418,394,719,398,321,732,470,262,741,445,282,867,445,413
39029015ACU,811,174,606,831,210,601,643,182,461,666,242,424,664,191,452,910,253,648
39099050APV,603,176,384,619,202,373,410,193,217,408,210,198,413,201,194,625,211,405
39099050ANQ,760,143,580,772,174,562,597,177,420,606,220,386,607,172,413,776,195,574
39099050ADD,425,332,69,440,377,50,311,261,50,305,271,34,312,268,42,408,325,78
39099050AKR,677,287,350,684,326,329,529,267,262,538,323,215,547,295,241,734,352,376
39089045ADI,1018,242,733,1026,304,687,843,257,586,860,332,528,856,276,544,1124,338,773
39089045ACB,694,250,392,703,279,378,536,250,286,542,289,253,541,252,266,780,325,438
39089045ADC,1203,831,308,1264,1026,190,825,669,156,833,700,133,840,676,144,858,685,156
39089045AET,942,334,559,975,391,531,773,335,438,788,403,385,786,365,405,1362,610,723
39089045ABC,918,313,561,922,334,537,714,287,427,722,343,379,720,288,404,1004,346,638
39173087AAG,552,311,202,566,353,156,408,295,113,413,314,99,417,277,113,545,389,140
39173087ACE,773,288,440,791,342,392,598,300,298,606,350,256,609,294,289,872,375,480
39173087ACJ,714,273,405,736,364,332,563,296,267,575,361,214,575,300,262,797,404,383
39173087ABV,360,99,247,369,134,214,295,124,171,295,140,155,301,122,170,388,143,235
39173087AEF,834,216,600,828,269,517,731,263,468,734,292,442,737,259,472,1038,402,631
39173087ADW,779,315,422,789,331,404,537,288,249,543,306,237,549,266,256,765,328,421
39173087ACL,735,221,462,752,264,440,594,239,355,597,303,294,607,232,342,807,289,501
39017009ABL,661,133,503,669,182,463,524,165,359,533,189,344,532,157,360,716,222,481
39119060ABU,532,113,394,546,102,423,432,106,326,436,141,295,437,113,308,624,108,507
39119060ABH,704,198,492,703,269,412,591,216,375,595,276,319,599,222,367,729,288,433
39119060ACE,759,125,608,760,159,568,616,155,461,618,211,407,624,146,462,877,186,686
39057029ADV,509,123,361,510,169,319,410,156,254,408,185,223,411,147,249,562,216,334
39057029ADN,620,159,425,630,189,399,464,152,312,466,192,274,467,152,297,722,254,457
39151076AJE,515,172,305,530,177,318,390,161,229,393,176,217,392,153,219,569,187,377
39151076ABS,489,402,57,505,442,51,332,302,30,334,298,36,337,300,28,439,362,70
39017009ADA,410,133,251,421,170,234,257,108,149,264,123,141,261,118,133,416,167,242
39057029AII,717,108,587,715,174,512,581,139,442,583,166,417,586,138,435,818,216,581
39057029AAI,652,172,465,654,232,394,594,203,391,592,249,343,599,193,393,711,280,424
39057029ADU,387,143,232,400,184,200,308,130,178,307,152,155,309,120,180,466,217,244
39037019AAN,832,130,653,843,163,643,646,146,500,658,209,449,668,142,498,887,170,704
39037019AAV,631,86,528,642,121,499,505,96,409,511,127,384,522,96,408,716,136,569
39171086AAK,487,72,390,496,114,355,393,84,309,396,132,264,400,77,313,518,102,401
39171086ABI,606,112,461,623,137,458,493,100,393,485,156,329,496,108,377,666,132,520
39171086ABM,720,114,573,732,134,564,572,117,455,570,191,379,592,101,476,800,147,647
39171086AAR,669,167,467,691,192,461,518,143,375,517,200,317,530,147,360,732,201,516
39171086AAN,696,125,519,713,142,524,547,135,412,542,197,345,549,128,401,801,171,614
39107054AAS,563,65,472,567,75,476,454,72,382,456,93,363,466,73,380,629,94,526
39107054ABS,656,63,578,663,60,591,501,52,449,499,75,424,507,47,451,715,60,647
39107054ABH,622,79,525,637,110,507,498,96,402,505,144,361,511,97,403,705,133,561
39039020AAS,447,158,263,468,182,250,324,133,191,327,160,167,333,139,180,481,197,281
39039020AAT,577,94,465,576,112,429,473,127,346,479,178,301,489,131,348,597,147,443
39039020AAL,632,228,376,643,276,324,485,222,263,488,262,226,488,221,253,688,278,405
39125063AAB,680,214,429,690,211,447,528,190,338,539,212,327,541,196,326,683,194,482
39125063ABG,337,72,246,345,52,277,240,45,195,241,59,182,243,48,186,366,50,308
39125063AAQ,741,220,486,750,179,544,559,150,409,575,181,394,572,163,399,768,182,572
39125063AAC,531,119,384,540,94,423,405,82,323,417,111,306,412,93,312,587,103,481
39125063AAF,845,237,548,875,174,651,650,167,483,665,203,462,665,164,471,930,183,740
39029015AEN,598,140,432,607,151,438,457,151,306,466,193,273,468,149,303,680,168,500
39029015AEQ,800,239,499,827,248,537,632,261,371,650,308,342,645,255,371,860,256,589
39049025BBV,460,137,307,474,168,283,394,142,252,395,182,213,395,152,233,501,199,295
39049025ARP,724,265,435,726,347,343,648,314,334,655,375,280,661,326,319,852,461,369
39049025BCJ,633,256,354,643,326,292,789,419,370,796,482,314,804,460,331,1311,759,528
39049025BNC,498,188,295,511,271,219,506,261,245,508,305,203,514,280,227,550,311,230
39151076AAO,419,143,254,420,157,241,336,148,188,342,184,158,345,139,198,444,189,251
39151076AGA,1005,283,658,1007,339,628,778,319,459,789,372,417,791,323,443,1106,352,740
39151076ACU,571,250,281,585,297,243,457,266,191,468,297,171,466,260,188,627,365,247
39095048AUE,570,205,349,584,275,292,504,271,233,507,295,212,516,258,245,674,359,311
39095048ANB,296,196,81,320,241,66,201,162,39,203,171,32,207,155,40,252,182,66
39095048ADG,261,178,66,271,203,54,163,129,34,163,135,28,171,121,35,256,190,62
39095048ANA,342,233,83,354,274,57,191,149,42,198,161,37,196,147,39,312,228,76
39095048AQR,525,238,271,534,259,248,396,210,186,397,244,153,402,213,174,547,265,272
39027014AAY,381,84,277,392,78,303,301,86,215,304,103,201,304,66,222,482,89,386
39095048APW,620,278,310,633,325,280,506,296,210,512,333,179,518,289,215,685,367,301
39015008ACJ,774,154,579,801,181,594,579,155,424,580,191,389,581,153,412,848,174,666
39015008AAJ,907,170,703,921,206,702,754,205,549,768,245,523,767,186,557,1185,243,935
39175088AAX,408,67,332,415,79,314,310,72,238,314,105,209,317,75,229,447,84,361
39079040AAX,255,77,165,251,59,184,194,52,142,197,80,117,201,59,135,284,65,216
39079040ABA,527,154,355,536,106,415,340,107,233,344,149,195,353,116,233,567,102,463
39067034AAS,863,240,585,868,222,610,716,293,423,720,338,382,722,249,453,975,245,722
39131066AAU,510,178,305,521,187,316,390,160,230,400,190,210,399,163,225,568,163,396
39079040ABB,359,82,258,358,68,280,246,58,188,260,85,175,259,63,190,412,79,327
39079040AAQ,509,173,307,522,157,339,347,118,229,355,147,208,363,126,229,562,159,396
39067034AAO,360,90,255,370,100,255,304,106,198,309,135,174,311,87,217,416,90,325
39095048ADW,570,310,228,592,327,231,414,256,158,427,277,150,433,250,153,566,313,247
39143072ACK,571,153,378,576,180,352,427,165,262,436,203,233,432,154,248,628,219,398
39143072ABV,481,98,365,485,133,329,423,111,312,424,162,262,428,119,294,504,146,350
39143072ABJ,445,153,256,454,191,212,347,179,168,350,216,134,348,176,147,490,232,236
39143072ACD,294,49,224,296,67,214,231,56,175,230,83,147,233,54,165,296,62,231
39151076AJU,708,171,484,712,194,497,562,196,366,568,232,336,571,190,359,759,223,530
39151076ABV,264,175,64,268,190,65,175,125,50,178,133,45,178,121,43,200,128,69
39169085ADI,1009,152,830,1004,183,779,819,156,663,834,194,640,831,162,654,1132,223,898
39169085ABX,967,178,743,980,203,738,757,206,551,769,249,520,770,208,531,1060,228,813
39169085ACC,862,226,590,882,241,604,692,230,462,693,268,425,698,229,452,946,265,674
39169085ABJ,747,260,450,749,319,389,609,305,304,621,330,291,623,310,298,826,391,417
39015008ACL,586,104,442,596,133,439,451,121,330,456,134,322,456,110,326,633,135,490
39069035AAK,825,225,551,839,251,517,644,230,414,653,297,356,658,219,411,927,275,634
39069035ABE,602,90,481,612,102,466,476,91,385,486,146,340,488,84,391,652,121,520
39069035AAL,743,155,560,755,193,506,529,157,372,531,238,293,544,157,366,758,178,573
39003002ABZ,447,369,51,473,433,30,313,296,17,318,304,14,313,284,25,439,386,49
39015008ACH,839,148,653,857,195,635,701,165,536,706,198,508,713,172,522,960,208,745
39003002ADT,528,65,437,529,78,434,410,74,336,416,125,291,416,70,336,564,68,487
39165083AAA,428,97,286,454,121,311,278,94,184,285,102,183,282,85,186,505,142,357
39165083ACP,727,142,550,768,149,587,558,139,419,577,168,409,570,132,414,885,188,679
39165083AHC,292,57,227,293,87,198,298,100,198,304,117,187,301,102,194,1026,388,621
39165083AGY,838,159,648,841,247,559,845,284,561,865,333,532,864,291,552,824,277,543
39155078AEW,907,274,575,936,331,563,710,323,387,717,368,349,716,316,380,941,323,607
39155078AHW,343,106,219,352,122,220,281,118,163,287,127,160,287,121,153,448,163,279
39155078AGL,595,177,397,606,188,394,489,190,299,492,223,269,500,212,276,662,188,467
39155078AIY,665,199,426,675,220,418,469,219,250,472,250,222,476,213,247,684,241,429
39147074ABO,402,76,302,413,104,287,319,103,216,326,151,175,324,98,217,450,110,329
39147074ABV,662,139,501,676,174,459,540,145,395,556,220,336,558,157,388,692,190,492
39165083AGH,675,137,512,674,188,462,594,188,406,597,205,392,599,182,399,772,265,495
39165083ACF,675,179,468,679,241,407,601,246,355,612,272,340,615,237,356,812,360,435
39155078AKI,539,227,289,548,243,295,424,203,221,430,238,192,432,222,201,593,253,333
39025013ADC,592,97,460,596,130,451,452,140,312,453,146,307,451,132,299,693,161,524
39025013AAP,708,164,500,720,223,457,568,204,364,566,228,338,574,177,361,776,267,494
39025013AGR,381,78,278,387,103,264,299,83,216,302,96,206,302,82,214,402,97,298
39025013ACI,317,52,259,311,84,218,324,92,232,324,98,226,323,90,226,489,135,351
39025013ABR,467,93,354,463,136,300,412,131,281,409,158,251,414,136,265,488,167,313
39037019AAH,452,84,328,462,106,332,297,89,208,301,121,180,301,85,204,508,130,369
39049025AWJ,804,294,483,790,369,378,717,337,380,725,400,325,722,353,355,853,481,357
39049025BLQ,395,252,114,407,298,78,344,297,47,347,303,44,348,295,42,357,306,45
39049025ADI,764,489,220,796,579,152,529,472,57,533,483,50,535,465,46,576,483,73
39025013AEI,563,83,457,572,115,436,426,111,315,427,126,301,432,97,313,596,125,457
39025013AFD,633,117,484,642,166,437,503,157,346,505,180,325,506,148,341,674,216,445
39007004ADG,293,73,203,301,71,221,225,69,156,233,95,138,230,64,160,345,81,261
39007004ACH,241,105,114,243,118,117,182,78,104,186,90,96,184,65,107,243,92,147
39151076AEP,546,166,333,562,199,338,398,161,237,399,196,203,402,154,222,623,209,407
39151076AGL,901,313,545,908,338,536,707,314,393,713,350,363,715,288,398,964,423,529
39151076ABX,653,350,260,666,350,279,412,255,157,419,272,147,419,248,153,627,317,295
39151076AMR,816,304,475,834,348,448,704,348,356,707,390,317,708,335,357,920,445,464
39151076ADL,1008,394,561,1010,463,508,802,415,387,805,437,368,810,421,369,1004,520,473
39151076AEX,602,185,375,612,262,313,500,233,267,506,269,237,507,219,264,837,340,482
39151076ANQ,655,143,457,674,153,482,495,138,357,498,171,327,505,157,331,771,157,602
39151076ACO,346,148,167,354,151,178,275,157,118,278,171,107,276,145,123,348,181,161
39151076AFU,807,267,478,805,282,490,620,269,351,623,297,326,632,269,334,918,296,605
39151076AHM,936,259,649,931,302,599,778,283,495,784,306,478,793,276,505,1002,359,636
39151076AIT,701,189,480,707,240,439,612,235,377,622,269,353,626,236,375,805,290,509
39151076AFT,476,157,288,484,163,304,366,155,211,367,174,193,371,138,209,501,151,344
39169085AAR,594,275,267,589,294,255,458,263,195,456,272,184,464,243,198,629,302,305
39037019ABD,439,117,294,454,130,303,279,87,192,283,111,172,281,89,178,461,118,334
39037019ABL,752,44,695,760,40,711,653,45,608,659,82,577,666,56,600,836,45,785
39037019AAT,548,54,477,550,64,462,426,57,369,428,75,353,424,55,359,583,77,502
39037019AAA,439,102,302,444,109,293,301,98,203,303,119,184,307,86,207,456,117,331
39037019ABH,930,84,814,934,117,796,727,123,604,727,182,545,732,131,588,965,154,801
39093047ADD,618,330,239,636,387,222,445,295,150,460,323,137,466,305,143,684,395,275
39093047AIG,649,201,402,671,230,388,539,241,298,562,296,266,565,249,290,810,315,480
39093047ABX,546,292,218,546,312,202,357,233,124,382,263,119,384,234,137,589,342,235
39093047AJZ,1073,280,743,1100,326,724,854,330,524,882,405,477,889,323,541,1194,367,810
39025013AFR,360,86,260,371,98,248,314,112,202,315,124,191,315,103,189,419,143,265
39025013ACK,818,189,591,812,278,494,731,269,462,727,279,448,738,259,453,900,353,532
39025013AGS,275,59,204,274,67,197,223,62,161,226,67,159,223,57,154,292,64,223
39025013AGU,700,116,548,704,136,551,518,134,384,523,144,379,521,124,379,776,157,603
39109055ACX,757,127,595,766,173,551,564,167,397,576,203,373,580,156,388,809,189,612
39093047AJY,844,236,562,867,287,530,603,269,334,627,324,303,626,253,342,1010,362,636
39093047AAI,605,225,348,624,278,311,487,248,239,498,296,202,502,251,236,701,330,367
39099050ADU,612,357,223,624,363,241,438,270,168,449,311,138,443,280,147,611,321,280
39099050ARM,636,378,217,650,419,198,423,296,127,431,319,112,431,300,119,611,416,183
39093047AJG,949,257,632,978,308,610,783,307,476,803,373,430,807,280,497,1092,361,721
39093047AAY,618,154,446,597,238,329,534,246,288,540,265,275,546,233,303,699,332,359
39093047AEO,353,201,133,368,240,111,252,178,74,263,197,66,264,189,69,376,246,126
39093047AHZ,892,352,487,923,393,479,722,375,347,743,417,326,743,366,351,1082,451,608
39155078AHC,646,243,382,658,287,351,548,260,288,550,305,245,557,259,288,758,324,429
39155078ADF,596,275,297,604,320,254,500,312,188,510,354,156,514,316,189,622,338,280
39147074ABE,520,151,331,518,171,295,382,157,225,389,209,180,390,153,222,574,227,329
39147074AAR,575,179,356,592,191,338,420,195,225,440,238,202,441,197,220,678,265,395
39147074AAS,307,109,176,307,132,143,200,97,103,202,108,94,207,97,101,323,137,175
39147074AAE,448,195,220,473,234,203,311,181,130,319,197,122,316,173,126,477,225,244
39153077AXB,770,312,431,768,437,298,638,342,296,651,376,275,649,340,297,831,499,317
39153077AUG,592,201,370,610,264,321,515,228,287,519,251,268,525,215,298,634,259,369
39153077AMW,690,276,388,705,376,308,579,340,239,592,369,223,587,345,235,785,471,304
39153077AQS,710,304,386,734,397,311,590,349,241,610,387,223,605,346,244,841,511,318
39153077AQP,733,314,383,759,379,336,560,308,252,571,339,232,573,297,257,807,446,338
39153077AYE,530,164,330,555,163,374,426,149,277,439,164,275,438,153,274,647,171,466
39163082AAM,257,107,136,266,107,150,233,107,126,243,127,116,234,112,115,298,108,187
39013007AAL,522,210,268,525,226,278,363,200,163,371,219,152,370,178,183,565,227,333
39013007AAH,668,265,361,688,265,398,490,254,236,493,285,208,494,227,254,717,301,409
39013007ACE,728,264,404,736,243,465,533,273,260,548,320,228,548,234,293,772,196,566
39049025AYL,649,281,344,646,327,282,522,293,229,526,330,196,530,299,213,695,398,285
39049025AWP,465,153,300,453,211,209,433,207,226,435,247,188,437,211,218,488,281,199
39049025BGV,811,332,437,823,413,362,641,359,282,642,401,241,648,363,268,852,473,359
39049025AMH,517,282,205,537,344,163,434,290,144,438,311,127,439,295,132,606,395,199
39049025ABY,524,311,167,554,376,156,409,297,112,410,324,86,411,288,102,714,532,168
39049025AFM,738,627,84,778,708,58,475,434,41,484,455,29,486,441,36,664,590,67
39049025AIW,650,513,103,676,595,64,505,445,60,519,481,38,519,467,46,664,596,63
39169085ACW,868,144,687,895,178,681,743,175,568,751,204,547,761,180,562,1009,203,793
39169085ACO,827,154,614,851,171,625,650,182,468,661,222,439,667,176,463,922,192,715
39169085ACH,815,230,516,826,295,475,648,278,370,662,324,338,669,275,360,915,352,546
39169085AAO,668,283,336,678,305,345,451,229,222,460,257,203,463,233,210,706,287,406
39169085ACN,499,110,339,514,128,352,370,135,235,375,153,222,373,133,227,585,133,445
39087044ACP,400,123,261,420,106,302,323,110,213,320,128,192,319,105,209,460,135,321
39087044ADC,319,96,207,327,80,240,243,67,176,243,83,160,249,75,167,348,68,279
39087044ACY,402,120,269,427,90,322,306,90,216,307,109,198,312,95,214,458,98,356
39087044AAT,254,90,156,263,78,180,203,77,126,207,92,115,208,81,123,256,90,163
39087044AAU,285,96,176,299,75,215,231,75,156,238,104,134,239,79,158,302,100,200
39087044ABC,356,149,185,371,98,259,282,120,162,286,138,148,289,125,154,381,93,284
39037019AAD,389,91,265,386,109,258,279,111,168,286,125,161,290,102,167,412,111,292
39109055AAJ,563,125,410,565,163,377,386,133,253,394,167,227,397,131,250,608,208,388
39109055ACQ,652,80,551,661,118,525,553,107,446,559,155,404,563,114,437,723,134,583
39109055ACI,610,57,529,622,105,497,453,89,364,462,119,343,460,85,360,650,108,537
39093047AGN,916,320,566,941,384,520,758,340,418,791,433,358,798,361,417,1189,513,657
39093047AKF,957,384,496,967,441,471,843,454,389,868,517,351,882,446,395,1073,501,551
39093047AJL,782,319,413,803,327,436,625,321,304,658,381,277,658,317,308,876,364,501
39109055ABI,373,76,278,379,116,243,261,75,186,277,101,176,283,85,194,432,139,285
39109055ABC,671,138,493,685,195,451,507,174,333,518,221,297,522,172,321,742,230,490
39109055ACG,841,112,703,851,149,663,716,144,572,725,200,525,728,154,558,904,194,704
39109055AAX,468,97,336,480,134,322,362,108,254,372,132,240,377,112,251,643,198,431
39049025AAD,890,493,387,886,635,219,812,563,249,814,627,187,818,592,215,918,693,217
39143072ABE,554,203,317,569,253,286,439,207,232,443,240,203,439,190,225,582,256,314
39019010AAA,664,130,488,688,149,509,525,139,386,533,169,364,529,140,371,724,148,562
39019010AAW,435,78,322,447,87,341,334,99,235,332,111,221,335,95,222,492,92,392
39019010ABD,407,73,307,417,82,313,334,99,235,337,119,218,338,91,237,462,119,341
39019010ABK,523,106,380,529,118,384,425,127,298,431,151,280,433,128,281,527,110,408
39099050AMX,616,193,407,634,231,394,531,222,309,539,270,269,539,236,295,683,258,423
39099050AAG,424,239,164,436,245,182,326,194,132,337,226,111,334,217,114,458,230,225
39029015ACN,566,89,453,570,104,441,452,113,339,451,151,300,460,128,319,612,140,466
39029015ACE,520,172,323,530,174,329,388,155,233,395,183,212,397,158,227,540,173,358
39099050ABF,198,106,81,202,118,82,148,85,63,150,98,52,152,92,56,201,106,92
39095048AST,440,123,305,449,169,266,411,174,237,419,207,212,431,181,227,522,215,299
39095048ABS,688,290,362,711,346,315,605,344,261,607,380,227,615,338,249,796,402,380
39095ZZZZZZ,0,0,0,0,0,0,0,0,0,0,0,0,0,0,0,0,0,0
39095048AOS,443,274,142,456,300,135,299,220,79,302,229,73,303,217,69,415,244,166
39095048ACV,602,276,289,619,291,277,458,256,202,465,288,177,468,256,194,656,323,319
39095048ALR,699,327,339,714,364,301,549,345,204,555,393,162,556,332,202,758,418,321
39095048AIJ,405,345,48,421,375,36,282,261,21,282,259,23,287,252,31,379,336,41
39093047AKE,409,88,291,422,115,279,321,103,218,329,127,202,330,103,211,481,118,358
39099050ARO,456,289,137,474,321,135,277,183,94,278,203,75,280,184,86,433,271,151
39099050AHR,561,277,251,571,290,257,415,235,180,421,275,146,420,243,166,573,303,265
39093047AJR,525,156,340,546,186,327,404,162,242,424,218,206,424,163,246,594,200,384
39143072ACA,485,108,346,490,137,324,373,137,236,375,156,219,373,128,219,507,145,355
39159080ABP,470,108,337,475,119,333,378,92,286,380,124,256,381,102,269,555,125,417
39159080ABO,369,78,276,378,95,268,325,85,240,327,108,219,330,89,233,424,120,297
39159080ABS,557,79,457,550,107,415,463,98,365,463,143,320,470,121,327,578,142,430
39099050AQI,464,355,81,490,401,83,294,240,54,302,251,51,301,240,55,402,298,98
39065033ABI,817,133,650,818,161,627,675,151,524,675,212,463,678,150,500,863,174,681
39065033AAA,618,152,419,630,177,415,430,156,274,436,194,242,438,165,259,718,188,516
39099050AKP,626,187,419,643,224,405,541,198,343,543,256,287,545,212,317,703,243,456
39099050AQT,646,403,208,645,433,202,521,369,152,534,405,129,530,383,137,650,435,203
39099050ASM,363,159,167,370,194,161,300,169,131,307,194,113,307,166,128,383,191,188
39099050AOP,427,155,249,429,153,258,352,136,216,360,165,195,362,143,207,469,175,288
39093047AJX,667,150,468,679,177,467,523,158,365,548,213,335,554,167,363,794,168,611
39095048AKE,577,367,186,584,393,155,487,368,119,483,389,94,491,357,115,623,473,137
39095048ABV,775,234,522,795,336,425,675,329,346,675,372,303,687,320,356,895,425,455
39095048AHI,438,375,38,476,434,22,313,289,24,318,300,18,321,283,29,403,365,33
39095048AMO,389,252,112,406,277,107,272,197,75,273,214,59,276,194,70,377,279,95
39095048AAL,422,162,245,430,199,208,696,377,319,709,428,281,706,375,311,939,476,452
39095048AAP,1437,574,786,1464,671,688,648,364,284,653,423,230,655,365,264,874,441,408
39027014AAS,704,112,567,712,154,529,646,173,473,643,197,446,647,168,467,772,182,579
39095048AUD,1028,348,646,1052,463,549,929,460,469,928,505,423,942,451,462,1266,638,612
39143072ABC,686,225,413,693,297,361,558,273,285,566,312,254,555,259,277,731,303,414
39049025BBT,100,28,67,101,37,58,77,29,48,77,36,41,80,29,43,108,51,53
39049025BMS,505,310,173,522,356,142,358,246,112,359,269,90,360,246,100,475,329,140
39049025ANN,916,609,273,955,701,204,738,579,159,746,614,132,753,583,154,1054,785,249
39049025BGI,620,467,127,636,533,87,549,474,75,552,495,57,553,481,61,679,569,107
39049025ARX,526,206,285,536,246,258,444,219,225,444,243,201,446,208,221,565,290,266
39049025ATI,782,179,584,785,248,509,656,198,458,656,255,401,667,252,408,841,268,562
39049025AMI,958,405,514,950,516,378,873,498,375,881,567,314,884,519,340,1093,679,403
39049025ABP,570,472,62,586,537,27,585,533,52,586,543,43,590,535,41,663,615,38
39049025AJN,702,444,215,719,496,186,537,401,136,541,419,122,540,404,124,761,568,177
39049025AJI,561,378,160,586,444,127,423,342,81,424,353,71,427,342,76,604,452,143
39049025ADR,734,530,159,739,601,92,700,590,110,701,620,81,709,607,88,823,705,108
39049025ACU,920,656,234,938,782,116,829,699,130,841,736,105,843,700,125,1054,870,171
39095048ASI,651,171,446,649,192,415,549,196,353,546,244,302,547,201,328,674,228,424
39095048ACS,957,449,480,983,476,456,715,383,332,727,444,283,737,383,327,938,453,468
39095048AJS,735,366,348,744,442,265,911,591,320,912,640,272,917,591,303,1075,695,370
39027014AAN,625,143,457,637,180,422,519,179,340,515,207,308,521,176,331,672,223,430
39041021AGG,241,55,178,243,75,159,201,73,128,199,71,128,200,66,129,235,79,155
39041021AGF,610,139,449,615,190,400,486,133,353,486,168,318,488,140,344,627,193,423
39041021ABJ,336,74,254,341,103,225,438,156,282,440,185,255,441,167,264,884,369,499
39095048AGE,502,410,72,520,463,36,361,337,24,365,348,17,364,330,27,428,381,42
39095048ALD,630,534,76,657,584,57,533,496,37,537,505,32,540,492,39,636,563,64
39095048AUB,674,249,401,683,322,322,572,300,272,571,336,235,581,280,281,823,404,404
39095048ALV,584,325,227,598,373,180,420,297,123,430,321,109,428,297,112,629,380,235
39095048APS,609,273,302,618,333,253,441,264,177,445,290,155,447,251,176,606,336,257
39095048AFL,584,314,245,590,339,213,441,299,142,448,337,111,449,289,138,601,384,206
39095048ADV,628,332,223,651,371,221,361,227,134,374,244,130,378,220,125,553,323,214
39041021AGO,344,156,172,351,188,144,331,181,150,333,200,133,339,190,137,407,238,162
39041021ADH,336,153,172,341,186,141,330,181,149,332,199,133,333,188,136,594,338,250
39041021AFW,719,280,414,745,374,333,545,307,238,546,330,216,549,303,236,885,503,365
39041021ABQ,825,178,618,843,226,578,765,190,575,764,264,500,771,211,535,969,302,658
39041021AEJ,929,289,606,934,432,449,897,397,500,901,498,403,911,435,461,1063,551,491
39107054AAZ,435,26,401,437,24,406,335,24,311,341,45,296,347,26,317,482,46,434
39015008ACV,572,123,417,583,178,390,426,167,259,437,186,251,440,153,273,581,169,407
39047024AAB,467,136,309,466,139,306,339,156,183,338,178,160,341,148,183,601,180,410
39141071ACE,293,94,183,305,97,191,232,95,137,235,108,127,236,96,133,300,81,212
39141071ACF,416,106,292,421,105,298,344,111,233,351,140,211,348,106,231,456,110,344
39141071ACR,404,138,252,412,154,248,332,145,187,341,167,174,339,142,191,448,152,292
39015008ACD,585,89,463,595,110,468,413,90,323,420,112,308,424,90,316,636,110,519
39099050AOW,289,156,119,298,172,122,234,141,93,239,163,76,238,147,85,294,158,133
39099050APL,470,117,331,483,108,361,375,112,263,381,141,240,382,121,248,503,122,375
39093047ADF,674,296,337,677,339,305,539,288,251,566,335,231,568,288,256,758,368,379
39093047AIT,693,215,447,707,255,420,600,257,343,609,305,304,613,244,353,829,291,530
39025013AGW,876,128,714,895,177,693,698,158,540,699,186,513,703,149,531,922,187,727
39131066AAK,409,148,241,428,121,296,282,104,178,286,110,176,290,109,171,402,82,318
39175088ABA,179,43,118,183,44,127,122,33,89,121,40,81,122,31,85,185,41,141
39175088ABF,423,47,357,431,53,347,336,63,273,337,105,232,348,70,265,441,68,370
39175088AAT,485,135,329,511,159,330,354,122,232,365,165,200,361,121,224,564,162,398
39079040AAY,565,153,387,583,153,407,413,131,282,425,185,240,429,150,265,655,149,498
39137069ABT,385,57,310,390,62,310,281,61,220,291,96,195,291,55,234,407,69,324
39137069ABW,863,216,601,883,253,579,616,182,434,619,250,369,620,179,419,950,262,665
39161081AAW,253,39,202,259,26,223,190,32,158,192,35,157,189,30,155,282,38,241
39145073ADR,424,104,298,429,84,334,292,75,217,299,90,209,295,83,204,447,60,382
39145073ABS,335,117,206,334,95,225,252,92,160,257,118,139,255,102,148,343,84,256
39153077AGZ,675,378,276,691,460,198,608,447,161,632,487,145,628,439,173,719,522,188
39123062ACC,521,166,313,533,182,317,408,166,242,412,204,208,411,162,226,606,198,403
39123062ACS,687,162,492,704,225,447,588,230,358,593,314,279,603,235,341,740,236,489
39147074ACR,612,146,427,626,171,414,470,150,320,490,200,290,485,151,315,686,164,514
39147074AAT,697,200,463,709,268,385,566,256,310,573,332,241,573,235,304,817,334,467
39147074ABZ,484,101,359,490,105,348,374,101,273,384,134,250,389,102,275,524,129,386
39147074ACH,337,67,254,329,71,232,251,60,191,256,104,152,257,65,179,356,81,271
39165083AEJ,639,105,503,645,144,472,598,164,434,605,192,413,608,165,421,944,295,639
39165083AHB,57,11,46,61,14,44,54,15,39,58,20,38,55,15,38,683,326,348
39165083AEG,382,85,271,392,97,279,298,98,200,300,103,197,303,87,197,603,190,402
39165083AFF,566,111,434,578,200,350,507,175,332,524,201,323,516,157,345,561,218,338
39003002AEB,489,72,397,498,81,396,402,80,322,402,105,297,405,73,319,569,100,456
39003002AEW,236,45,182,246,57,181,172,49,123,174,69,105,172,38,124,252,52,193
39067034ABF,555,167,360,571,129,425,456,165,291,461,194,267,458,150,302,606,131,463
39131066AAT,467,190,264,476,151,305,351,160,191,354,174,180,360,146,206,482,111,365
39175088ABH,277,47,215,283,45,221,215,51,164,220,69,151,221,52,159,300,51,242
39067034AAU,457,86,344,458,83,355,357,98,259,358,116,242,354,80,255,502,90,407
39109055ABU,778,108,648,779,159,595,647,155,492,650,193,457,654,143,487,842,172,656
39109055ABW,462,84,364,452,128,299,410,121,289,419,159,260,422,133,277,516,168,343
39109055ABN,420,99,307,425,134,260,336,118,218,344,142,202,348,113,224,465,152,306
39109055AAL,515,101,392,517,148,332,340,126,214,343,152,191,346,119,206,521,189,324
39093047ADZ,376,267,76,385,315,57,211,173,38,216,182,34,219,175,37,327,226,93
39145073ABX,321,105,203,318,90,219,261,84,177,262,110,152,264,89,170,352,79,265
39141071ABL,455,142,290,460,165,267,342,130,212,342,153,189,348,123,210,487,161,316
39043022ACO,317,107,184,325,128,185,268,131,137,269,147,122,262,126,114,361,133,226
39043ZZZZZZ,0,0,0,0,0,0,0,0,0,0,0,0,0,0,0,0,0,0
39055028ACY,446,117,311,456,138,298,384,114,270,391,135,256,388,101,269,517,127,383
39145073ACJ,287,97,184,296,74,208,215,80,135,222,112,110,221,90,121,311,88,219
39145073AEH,270,81,181,268,72,183,194,83,111,194,103,91,195,83,107,209,53,154
39145073ACK,342,107,226,337,88,241,268,73,195,274,99,175,278,71,201,387,87,294
39145073ACB,398,117,270,398,95,291,375,122,253,379,150,229,382,118,250,454,103,348
39145073AEI,505,187,297,503,158,328,351,134,217,354,158,196,358,137,215,573,158,407
39123062ACH,727,233,453,727,299,373,580,270,310,588,329,259,591,257,300,818,343,459
39067034AAB,258,75,172,259,63,189,215,89,126,216,122,94,221,77,140,270,73,190
39131066AAV,501,141,324,522,111,394,368,110,258,373,130,243,380,115,245,533,93,435
39131066AAO,428,136,281,426,117,286,306,112,194,309,127,182,316,111,193,466,94,371
39175088AAM,412,68,325,413,78,318,322,72,250,325,101,224,324,70,242,436,83,343
39079040AAE,524,140,366,539,147,362,394,137,257,406,183,223,403,135,252,574,148,417
39079040ABI,231,57,165,233,61,168,149,37,112,150,51,99,153,42,110,246,53,190
39067034ABB,600,138,427,609,118,474,485,142,343,487,177,310,488,121,351,638,112,520
39067034ABH,255,79,157,258,71,178,219,73,146,218,86,132,218,65,148,281,60,216
39025013AFE,664,132,500,661,187,439,556,171,385,556,189,367,559,167,366,768,240,514
39025013ACL,602,119,471,596,173,399,510,164,346,509,178,331,515,161,343,666,219,436
39025013AAZ,607,95,486,620,119,481,473,113,360,472,139,333,475,105,354,704,141,559
39025013AHD,519,96,404,525,120,389,383,98,285,387,109,278,387,97,269,549,111,425
39025013AGZ,504,76,407,508,97,394,427,103,324,431,118,313,427,96,315,583,138,441
39023012AAA,723,156,539,731,247,445,559,190,369,559,243,316,554,169,367,772,241,515
39041021ADR,761,173,552,770,213,508,701,186,515,699,252,447,705,219,465,944,281,653
39041021ADS,707,162,508,718,210,479,642,210,432,640,258,382,648,216,421,822,266,538
39041021ABW,456,171,270,461,215,225,456,219,237,455,245,210,458,220,230,535,299,230
39041021AFT,828,244,560,830,364,425,795,335,460,796,398,398,807,367,428,853,436,404
39041021AGQ,447,152,285,442,197,229,512,234,278,509,274,235,517,248,261,698,373,317
39041021AEL,276,79,192,279,121,145,254,103,151,257,124,133,255,116,138,574,260,311
39041021AAP,689,245,423,686,305,344,624,261,363,628,320,308,631,287,335,730,343,374
39041021ADM,614,115,473,633,144,453,548,146,402,551,182,369,554,155,393,745,208,528
39015008ACQ,698,153,519,706,162,516,530,159,371,540,196,344,538,155,355,712,150,549
39145073ABV,620,187,412,625,186,410,513,186,327,512,243,269,523,188,324,668,211,448
39145073ADF,574,158,392,572,133,410,411,129,282,412,155,257,419,140,276,594,135,453
39153077AIH,432,310,83,445,349,77,333,272,61,339,281,58,335,269,53,441,339,93
39153077ATN,678,250,375,699,268,395,540,253,287,559,267,292,565,255,291,738,303,423
39153077APZ,651,214,410,686,267,392,551,254,297,577,300,277,571,266,291,734,323,402
39153077AOC,477,157,280,489,167,303,383,168,215,399,196,203,399,175,207,516,195,314
39153077AUN,686,219,422,725,264,424,548,235,313,575,268,307,572,232,321,820,344,468
39051026AAS,967,261,655,983,245,667,697,232,465,699,299,400,703,223,460,1079,297,766
39051026AAQ,747,167,550,738,209,479,584,166,418,582,202,380,586,161,408,779,212,549
39153077AGY,750,477,238,764,536,203,652,495,157,672,527,145,667,496,155,837,623,200
39153077AYX,609,506,79,618,550,51,521,459,62,531,483,48,527,464,49,624,553,62
39153077AOO,733,255,442,749,317,396,627,299,328,628,326,302,635,285,325,812,402,398
39153077ACR,686,614,46,704,661,34,584,547,37,603,570,33,596,551,32,682,623,45
39153077ASI,583,233,320,605,270,302,456,268,188,472,292,180,469,256,195,685,357,315
39153077ATE,644,180,398,673,204,446,519,189,330,535,224,311,541,188,323,743,222,508
39153077AKA,567,202,328,587,238,330,500,249,251,514,272,242,516,258,239,640,279,352
39153077AQF,588,211,346,602,243,333,488,215,273,502,253,249,501,225,254,633,294,333
39153077AZT,531,267,223,551,317,212,429,293,136,438,307,131,436,279,138,551,315,223
39141071ACG,438,155,259,440,147,263,331,131,200,330,151,179,332,133,188,462,153,303
39141071ACO,376,109,249,384,114,259,310,98,212,314,122,192,312,92,208,442,125,314
39141071ACV,229,66,153,230,68,153,155,52,103,160,69,91,161,49,103,261,71,184
39113057AAO,742,208,507,735,295,413,628,244,384,627,302,325,632,240,383,773,315,448
39113057ADC,667,585,58,686,658,9,456,445,11,466,459,7,462,444,15,613,588,20
39113057AIE,888,749,101,898,821,45,762,705,57,771,732,39,769,704,55,882,823,51
39113057ALH,1027,340,634,1031,394,550,796,385,411,809,435,374,805,376,385,1101,515,554
39113057AVI,875,480,358,889,540,318,729,444,285,751,493,258,749,446,282,965,522,430
39113057ABG,583,335,203,594,376,166,530,385,145,536,416,120,541,386,131,600,446,147
39113057AHJ,568,517,34,578,560,6,406,387,19,419,411,8,418,388,23,489,471,14
39113057AVE,554,75,464,566,106,444,476,105,371,482,128,354,485,92,384,646,116,526
39113057AOB,912,211,664,927,250,626,679,221,458,688,277,411,690,225,443,948,290,637
39113057AXI,1092,248,802,1098,370,663,981,358,623,979,416,563,993,345,621,1192,503,679
39113057AYL,937,252,665,948,378,531,919,351,568,925,428,497,932,357,561,1381,630,736
39167084ACJ,936,339,555,966,225,709,730,236,494,750,286,464,750,236,495,1050,253,791
39061031BFJ,591,206,342,610,264,316,407,195,212,408,197,211,412,181,213,589,247,329
39061031ANT,778,399,344,800,469,300,605,375,230,530,340,190,616,361,232,818,503,301
39061031AWN,552,218,312,561,254,290,435,228,207,434,254,180,438,225,206,560,292,258
39061031ADP,718,375,326,720,497,197,641,456,185,649,487,162,652,457,185,796,598,194
39061031ASS,776,203,541,777,280,453,606,242,364,614,264,350,618,230,373,809,357,439
39023012ACT,564,419,118,576,470,91,394,326,68,406,362,44,397,329,57,534,427,99
39123062ABT,620,209,389,617,293,304,514,261,253,534,315,219,526,255,259,664,317,342
39141071ACS,441,120,301,449,110,327,355,94,261,361,128,233,363,96,256,531,112,412
39037019AAO,547,55,474,559,66,479,416,62,354,423,84,339,426,53,359,575,53,515
39037019AAR,873,133,699,900,177,690,655,150,505,660,201,459,666,138,500,978,163,801
39107054AAI,519,117,370,535,131,365,348,112,236,353,142,211,356,108,224,563,141,411
39107054ABC,827,77,738,844,97,708,648,104,544,657,156,501,670,105,550,925,125,790
39003002ABR,354,268,64,373,316,51,255,211,44,258,221,37,254,206,42,340,285,51
39167084AAG,804,237,526,821,219,574,644,201,443,663,245,418,663,177,462,901,255,639
39167084ABI,527,141,355,533,109,392,407,111,296,403,139,264,412,113,286,555,138,407
39167084ACN,518,149,342,536,95,417,408,110,298,421,139,282,424,104,309,600,106,487
39107054ABE,543,76,450,548,80,449,428,77,351,430,101,329,435,71,358,619,93,519
39107054AAG,456,119,316,465,122,313,306,110,196,310,139,171,310,110,183,541,149,379
39107054ABQ,647,92,516,651,95,521,507,108,399,515,138,377,517,100,386,724,112,604
39107054AAQ,580,89,460,584,114,444,434,103,331,434,145,289,440,90,325,641,125,507
39107054ABN,757,84,647,760,84,651,599,92,507,600,129,471,604,94,485,806,107,692
39107054AAY,564,24,529,578,23,546,446,33,413,450,47,403,455,22,423,627,33,588
39171086ABA,364,51,293,369,54,296,287,51,236,282,84,198,289,46,226,383,47,334
39171086AAC,703,184,472,710,238,414,521,204,317,520,257,263,531,183,321,783,265,496
39147074ACT,393,89,294,396,101,282,310,99,211,317,121,196,319,90,216,442,107,334
39147074AAN,558,215,315,581,249,284,415,198,217,428,235,193,430,199,213,583,251,311
39165083AAX,351,87,244,372,103,254,286,95,191,295,103,192,294,92,194,417,142,270
39165083ADI,733,147,558,730,248,450,645,239,406,653,269,384,664,235,418,818,332,477
39155078AKB,540,188,324,554,217,323,431,195,236,430,216,214,433,198,225,592,218,366
39155078AJM,652,151,458,656,182,443,510,177,333,519,215,304,518,178,326,739,209,523
39155078AJY,376,121,223,382,134,230,271,136,135,273,155,118,274,129,131,375,123,248
39155078ACA,667,335,276,672,345,293,495,298,197,506,345,161,503,298,180,692,346,331
39007004AAS,195,98,81,193,115,68,123,78,45,129,88,41,128,71,48,210,112,86
39025013ABP,652,73,545,659,106,532,497,86,411,497,104,393,497,82,404,723,109,607
39049025AHY,467,244,194,494,291,184,329,207,122,336,234,102,338,216,109,507,278,216
39049025BJO,815,290,489,828,383,388,688,331,357,690,399,291,696,337,339,898,497,385
39001001ABA,537,150,353,542,164,350,425,154,271,428,182,246,438,145,268,559,130,417
39151076ACC,583,284,245,594,328,233,382,233,149,384,251,133,386,223,140,566,295,262
39151076AJZ,807,227,518,806,250,518,605,235,370,613,276,337,616,217,369,856,255,588
39151076ACT,726,308,363,726,365,332,571,319,252,574,354,220,580,310,246,784,406,369
39151076AMI,689,191,473,690,257,402,589,230,359,595,263,332,595,226,359,734,324,406
39151076AGX,667,193,451,678,252,410,578,247,331,582,270,312,585,241,328,721,290,426
39151076AHN,824,259,530,830,309,495,674,290,384,686,320,366,688,289,378,931,355,566
39151076AER,606,221,342,602,233,336,464,237,227,467,252,215,467,220,232,659,245,404
39151076AMZ,1020,370,620,1041,440,566,882,418,464,896,465,431,892,407,465,1108,515,578
39151076ABY,302,157,113,302,161,118,193,115,78,194,127,67,196,111,74,321,160,151
39151076AOP,624,188,396,635,206,403,467,181,286,475,218,257,474,190,272,742,236,495
39151076ANI,415,165,223,421,170,217,351,166,185,356,184,172,355,167,179,486,236,244
39151076ADB,865,359,472,858,460,367,729,406,323,737,447,290,745,392,343,973,526,443
39151076ALH,561,162,362,563,193,353,432,182,250,441,211,230,438,166,249,570,205,359
39151076AOH,779,144,597,793,174,585,657,168,489,666,217,449,660,174,462,835,178,647
39151076ANP,733,139,541,756,152,586,585,156,429,588,178,410,593,146,424,786,147,630
39049025BIA,876,330,519,892,479,374,713,389,324,717,424,293,721,395,312,982,583,386
39049025AFF,591,499,61,641,596,34,412,380,32,415,394,21,415,383,29,568,501,57
39049025ACZ,465,398,39,494,455,25,366,339,27,370,352,18,368,339,22,516,466,39
39049025APR,579,258,298,569,315,216,499,282,217,499,312,187,504,284,200,623,370,236
39049025BCE,960,333,606,965,505,420,930,466,464,941,543,398,948,495,439,1166,698,454
39049025BGZ,530,249,257,549,313,203,415,246,169,419,279,140,422,245,165,613,376,225
39049025AZM,563,140,400,587,152,415,443,141,302,436,171,265,447,170,266,600,161,432
39049025ANZ,663,284,353,680,376,282,613,353,260,616,400,216,619,362,242,747,451,285
39049025ABZ,323,177,131,323,210,84,290,215,75,290,236,54,293,214,65,436,321,108
39049025BAO,453,146,295,459,196,244,408,176,232,413,198,215,415,189,209,488,216,258
39049025AVW,780,271,496,761,378,350,736,340,396,734,375,359,741,350,383,851,477,366
39049025AFJ,556,484,46,579,542,28,406,374,32,410,390,20,412,376,26,530,497,26
39049025AHA,973,549,373,997,701,242,521,407,114,524,425,99,524,399,109,737,561,164
39049025BMA,207,117,80,210,150,51,448,319,129,446,345,101,455,329,114,713,522,181
39049025AAX,541,450,58,561,502,49,401,356,45,403,367,36,404,352,43,550,472,66
39049025ABE,438,366,48,444,402,29,361,332,29,365,343,22,369,338,21,536,495,35
39049025AAS,799,488,297,803,589,169,869,662,207,866,721,145,884,685,175,1067,867,189
39049025AKG,696,573,85,718,646,52,553,496,57,564,523,41,568,505,54,723,656,62
39049025BBA,618,138,463,626,165,436,523,135,388,519,163,356,529,172,339,719,185,527
39143072ACE,638,168,439,636,197,389,523,187,336,524,259,265,528,199,306,709,212,482
39143072AAJ,367,94,239,377,120,227,289,109,180,296,138,158,294,116,158,473,136,324
39143072AAK,446,104,313,454,146,270,317,133,184,325,168,157,323,136,166,506,164,329
39143072ACM,645,154,449,660,208,412,532,178,354,538,242,296,537,170,336,686,210,465
39007004ADQ,496,124,342,506,139,348,391,131,260,400,164,236,398,137,246,535,140,382
39007004AEJ,386,146,211,394,181,196,334,171,163,342,195,147,339,179,148,436,213,216
39025013AHR,795,132,630,808,207,572,710,193,517,710,237,473,713,194,507,932,248,675
39113057AQQ,710,563,113,726,641,71,548,485,63,554,505,49,555,477,65,719,625,89
39113057AQX,839,536,273,848,624,201,640,469,171,651,502,149,647,466,165,811,596,205
39113057ATE,254,41,202,257,49,191,170,40,130,170,51,119,171,36,129,232,59,171
39113057AFP,373,320,43,379,358,9,220,208,12,229,219,10,223,201,22,291,275,14
39113057AIN,943,256,642,945,342,558,753,309,444,760,370,390,763,307,440,1014,416,585
39113057ADK,338,281,40,345,319,18,270,252,18,271,255,16,273,252,15,331,307,22
39113057ANZ,561,145,387,572,183,350,430,140,290,436,169,267,438,148,274,606,213,378
39073037AAN,500,128,345,507,116,370,396,114,282,398,148,250,406,112,280,577,134,436
39021011ABQ,629,96,499,625,112,493,474,103,371,482,139,343,480,100,362,687,120,559
39143072ADC,554,162,367,554,193,331,422,158,264,436,211,225,435,157,264,580,191,384
39107054AAT,575,87,465,586,92,475,454,91,363,451,111,340,453,85,356,608,121,480
39107054ABL,907,80,812,908,83,792,852,87,765,857,161,696,868,90,759,1024,84,924
39107054AAO,473,75,384,477,82,386,380,82,298,385,108,277,389,82,299,542,94,443
39107054AAW,699,111,567,698,135,546,588,120,468,594,166,428,595,124,459,782,150,628
39107054ABO,708,42,652,728,42,670,551,39,512,549,64,485,552,35,509,763,51,708
39107054AAK,282,52,221,290,40,236,221,45,176,225,61,164,226,44,178,319,51,265
39171086ABG,828,169,604,851,202,596,595,183,412,595,221,374,602,160,414,897,203,675
39171086AAV,995,172,764,1014,202,750,807,198,609,815,293,522,826,199,600,1105,243,843
39021011ABK,858,178,636,870,203,623,764,194,570,777,271,506,773,199,539,1053,250,785
39021011ABA,421,63,340,423,71,335,372,60,312,378,90,288,381,63,304,487,63,416
39039020ABQ,342,83,237,344,100,225,246,67,179,246,108,138,256,79,171,341,64,269
39039020ABO,348,87,249,363,104,237,294,95,199,296,139,157,304,95,192,403,123,271
39039020ABM,683,151,499,698,179,475,522,150,372,531,191,340,538,139,388,728,197,522
39039020AAU,311,62,235,316,60,248,243,56,187,248,76,172,249,59,188,350,71,276
39039020ABA,741,133,581,751,127,602,587,132,455,593,152,441,592,115,452,798,142,639
39039020AAY,341,104,205,351,90,231,243,85,158,241,99,142,246,86,154,359,92,250
39039020AAK,802,206,574,811,250,527,655,202,453,660,243,417,664,202,450,861,268,575
39011006AAJ,562,92,451,568,120,422,404,106,298,405,151,254,404,100,290,609,138,468
39021011ABT,478,111,337,480,113,355,392,101,291,401,144,257,390,109,265,529,120,400
39021011ABS,618,127,471,619,143,456,520,131,389,523,178,345,523,135,373,692,183,500
39123062ACU,687,212,436,692,277,374,557,247,310,577,327,250,575,242,298,761,297,447
39123062ACV,433,104,303,445,165,244,403,184,219,411,234,177,412,171,220,473,173,293
39043022ACI,698,163,493,718,193,488,538,179,359,542,226,316,544,179,338,808,207,588
39055028ABU,596,151,394,596,167,382,457,153,304,466,195,271,464,139,311,687,195,471
39043022ADM,671,202,445,674,278,379,564,255,309,568,296,272,570,254,301,706,302,399
39001001AAT,534,82,434,549,86,454,416,81,335,425,96,329,429,82,337,607,85,520
39145073ABQ,436,121,298,441,99,331,335,99,236,346,128,218,349,113,230,482,106,373
39145073ABU,507,149,344,511,110,386,363,113,250,372,142,230,374,122,237,548,129,411
39161081AAQ,225,72,141,235,81,147,178,70,108,175,80,95,181,66,112,239,74,158
39011006ABB,114,28,77,119,26,89,82,24,58,82,37,45,83,23,59,117,22,94
39011006ABA,832,72,730,833,108,688,657,119,538,654,159,495,652,104,533,855,147,697
39011006ABO,606,40,542,611,53,535,537,58,479,536,109,427,538,54,470,652,50,595
39011006AAO,434,43,370,441,55,370,364,58,306,366,104,262,363,56,299,456,58,395
39011006AAY,533,46,477,532,47,466,446,57,389,446,83,363,445,50,387,560,53,503
39011006AAZ,902,110,772,918,152,747,736,133,603,735,176,559,736,134,589,1023,176,838
39011006ABG,736,79,634,744,89,632,593,85,508,594,132,462,591,90,482,797,100,690
39011006AAK,365,61,279,367,77,267,255,77,178,255,94,161,255,68,174,408,92,312
39137069ABO,625,61,539,639,73,537,511,84,427,518,133,385,520,87,423,689,72,607
39137069AAQ,862,110,716,859,129,684,699,136,563,709,218,491,713,130,568,977,153,811
39161081ABM,459,99,332,462,79,355,363,85,278,364,106,258,362,80,264,498,81,413
39011006ABJ,858,142,672,866,195,638,760,197,563,766,273,493,760,184,545,999,248,740
39011006AAE,744,134,582,759,157,573,644,155,489,642,201,441,648,147,477,835,166,650
39137069AAN,999,148,801,1013,159,795,774,154,620,780,244,536,778,159,598,1054,158,884
39161081ABG,415,127,264,426,109,299,329,96,233,329,111,218,325,92,223,486,112,369
39011006AAN,681,99,552,692,122,544,486,111,375,485,167,318,486,101,366,807,179,623
39049025ASU,837,441,374,841,578,218,835,506,329,841,612,229,857,571,272,891,633,245
39049025BKY,612,448,111,632,510,79,442,386,56,443,399,44,450,379,51,498,442,49
39049025AYG,726,377,326,720,437,229,667,403,264,666,454,212,673,429,235,794,540,240
39049025ABT,305,184,112,310,232,62,325,243,82,325,260,65,328,248,72,560,451,107
39049025BNQ,448,269,166,456,339,90,474,356,118,479,383,96,479,364,106,673,521,142
39141071ACD,480,105,347,491,121,346,368,96,272,366,110,256,368,96,263,539,99,433
39141071AAH,370,151,202,377,172,181,289,151,138,286,176,110,290,144,137,393,192,198
39141071ABB,249,84,144,250,107,124,161,76,85,161,85,76,164,70,89,231,94,134
39141071ABR,321,91,217,334,87,240,238,65,173,243,81,162,242,66,171,370,90,278
39081041AAM,372,253,95,384,267,101,265,189,76,272,203,69,268,177,82,352,221,123
39081041ABA,684,235,401,693,212,453,527,225,302,541,274,267,533,211,308,735,233,493
39081041ABY,510,146,338,527,128,377,396,142,254,407,154,253,407,119,277,566,130,431
39169085ADD,633,115,482,644,124,481,508,127,381,504,160,344,513,135,360,712,137,566
39169085ADB,780,106,643,782,117,626,641,108,533,649,138,511,648,98,533,834,133,691
39085043AAV,1017,257,721,1046,345,671,843,330,513,847,377,470,853,327,510,1172,414,753
39085043ACT,462,216,217,479,255,200,380,221,159,388,236,152,388,212,163,535,292,236
39085043AIG,491,153,301,513,185,305,250,111,139,250,116,134,254,96,139,411,144,258
39085043AIT,736,221,466,778,283,456,821,332,489,830,393,437,831,331,477,1204,433,758
39145073ADI,303,105,190,306,83,219,210,80,130,217,96,121,220,81,134,382,114,267
39145073ADW,561,212,328,559,166,371,425,163,262,433,214,219,435,185,244,590,171,414
39145073ADZ,324,116,194,326,87,222,265,89,176,270,114,156,278,94,171,308,74,231
39145073AAQ,569,233,320,570,236,314,445,197,248,444,240,204,448,213,232,549,259,285
39019010ABE,610,159,413,625,185,406,495,181,314,498,205,293,495,175,308,669,191,466
39019010AAX,757,149,555,774,168,582,632,163,469,640,203,437,636,173,444,848,179,653
39019010ABJ,764,179,524,765,169,550,598,178,420,604,225,379,608,164,425,838,163,652
39141071ACL,421,142,262,434,151,270,334,139,195,340,150,190,340,131,194,476,132,336
39043022ACD,827,224,545,859,268,549,693,258,435,698,311,387,697,279,390,921,293,601
39093047AHV,1003,419,500,1031,438,535,789,422,367,811,478,333,812,424,357,1161,541,606
39109055ACM,725,83,606,734,120,580,588,117,471,595,147,448,600,112,471,773,135,627
39049025BBH,545,144,382,561,168,371,443,147,296,444,191,253,443,159,272,583,190,384
39049025AKF,424,350,53,451,409,36,312,277,35,313,290,23,317,289,23,433,377,47
39049025AHT,384,243,110,427,313,100,219,159,60,229,179,50,226,161,47,381,253,117
39049025AIV,550,478,42,565,524,30,440,399,41,443,418,25,445,406,30,617,549,59
39049025AFW,645,577,41,663,617,29,497,468,29,512,492,20,508,474,29,626,572,46
39049025AAV,721,444,254,727,568,131,670,522,148,674,552,122,677,524,140,811,671,131
39049025AYT,492,242,220,515,274,214,421,255,166,424,278,146,428,253,158,557,332,218
39049025ABV,900,525,352,903,677,183,825,628,197,823,685,138,833,637,184,992,786,189
39049025BFZ,876,339,507,897,454,374,750,398,352,759,451,308,762,403,345,1052,589,449
39049025AKB,643,455,151,659,540,95,564,449,115,562,486,76,570,461,94,645,534,99
39049025AFX,552,494,43,566,536,25,465,432,33,475,462,13,473,439,27,539,509,23
39049025ABJ,644,575,52,653,610,31,562,518,44,566,544,22,566,531,28,689,638,41
39023012ACH,741,522,182,739,600,110,576,484,92,580,501,79,571,462,86,746,611,127
39023012AEW,1106,281,789,1116,384,675,923,331,592,927,446,481,935,326,590,1248,438,790
39023012ADA,562,98,447,566,125,423,470,108,362,473,153,320,477,104,362,609,142,457
39023012AAB,731,181,512,739,247,462,561,193,368,569,246,323,574,183,370,811,244,554
39023012ADB,773,190,535,780,223,522,554,191,363,555,224,331,560,191,344,829,246,568
39041021ACH,678,143,518,692,171,492,622,155,467,627,220,407,635,176,442,771,230,533
39141071ABA,339,153,166,355,179,160,232,117,115,235,141,94,235,123,99,407,166,233
39141071ABV,515,153,331,520,150,350,358,116,242,360,152,208,363,120,228,546,120,421
39043022AEG,565,337,200,583,387,174,465,322,143,473,349,124,471,312,136,599,379,210
39043022ADA,610,163,413,626,172,420,471,168,303,482,222,260,483,175,290,676,201,465
39043022AAI,513,164,322,521,190,304,405,182,223,411,215,196,411,193,203,572,228,332
39043022AEB,683,380,248,696,422,242,546,353,193,549,386,163,554,357,173,755,458,274
39043022AEN,507,144,340,507,175,300,415,167,248,409,193,216,418,170,233,579,247,316
39043022ACR,433,131,269,439,150,269,362,165,197,366,194,172,365,176,167,502,179,317
39043022ACP,365,111,230,369,144,209,311,137,174,316,169,147,314,145,161,409,159,246
39043022ACF,596,159,396,603,203,374,475,203,272,479,245,234,482,203,265,663,226,429
39055028AAK,711,232,448,701,309,367,627,279,348,636,322,314,638,274,352,784,357,420
39055028AAD,866,221,593,876,288,548,746,308,438,752,345,407,753,292,439,1002,391,595
39099050AKH,790,360,398,805,389,381,666,347,319,662,402,260,673,358,295,843,448,380
39099050ABT,552,259,252,560,283,260,433,244,189,438,290,148,449,258,178,600,269,325
39099050ARY,565,451,85,587,517,58,429,369,60,440,406,34,438,377,53,595,532,56
39093047AIM,486,130,332,484,147,322,383,136,247,396,159,237,402,131,259,542,144,388
39093047AKL,639,200,408,648,256,361,529,256,273,540,295,245,542,249,276,757,319,428
39093047ABW,451,229,185,465,258,171,294,188,106,304,209,95,307,187,99,466,245,215
39093047AAE,690,251,409,711,316,364,558,276,282,575,326,249,576,265,287,763,318,435
39093047AIR,941,308,569,972,355,554,738,330,408,762,383,379,762,330,408,1067,414,641
39019010AAF,454,104,318,462,106,332,340,106,234,341,121,220,341,98,224,471,95,371
39019010AAG,467,99,330,481,116,340,379,125,254,377,135,242,381,105,254,532,123,398
39019010AAV,372,51,293,386,59,313,303,63,240,311,77,234,309,64,232,411,66,343
39041021ABT,601,95,497,594,183,384,537,141,396,538,170,368,538,146,388,766,286,471
39041021ACZ,763,280,466,767,411,322,886,457,429,889,540,349,906,481,405,968,570,385
39041021AEK,781,261,501,787,393,361,586,287,299,592,323,269,596,299,292,975,525,428
39041021AAS,724,332,353,727,393,275,663,374,289,665,446,219,671,406,242,811,510,283
39023012ADN,993,243,701,996,325,636,810,264,546,827,357,470,830,265,545,1058,323,720
39023012AFW,656,165,471,651,222,407,559,185,374,566,239,327,568,183,374,708,240,462
39023012ACO,518,170,323,521,217,273,366,165,201,373,191,182,372,147,210,551,209,328
39023012ACU,705,575,112,714,635,60,540,475,65,563,519,44,556,478,65,702,606,90
39023012ACC,790,208,548,797,278,482,652,242,410,655,309,346,663,237,406,852,309,533
39023012ABJ,654,262,362,653,320,307,484,246,238,486,298,188,488,256,220,671,310,352
39047024AAA,464,140,298,465,166,277,279,102,177,285,133,152,285,112,164,552,179,362
39015008AAW,527,92,413,542,98,433,437,95,342,443,111,332,448,88,340,602,111,485
39137069AAF,539,61,459,553,67,467,423,64,359,432,98,334,434,69,361,566,69,496
39137069ABA,626,92,514,634,90,524,471,95,376,477,139,338,474,91,369,673,83,582
39137069ABQ,979,103,857,982,102,846,738,102,636,757,182,575,755,98,643,1004,107,890
39109055ABH,1052,152,873,1065,240,774,851,215,636,869,273,596,879,233,618,1202,307,879
39109055ADH,424,91,325,426,118,294,726,252,474,745,291,454,748,258,472,1369,525,815
39093047AIE,763,247,470,762,272,455,582,257,325,607,299,308,611,267,317,838,291,534
39093047AAL,986,380,551,1010,443,517,798,441,357,821,510,311,832,435,374,1105,516,564
39093047AHJ,487,397,62,494,425,55,412,370,42,416,389,27,417,365,38,436,371,60
39093047AFE,695,377,252,706,437,238,499,359,140,523,397,126,523,364,147,753,448,289
39093047AHR,930,379,465,959,448,444,734,421,313,763,481,282,768,414,326,1087,523,546
39093047AHP,974,355,542,1004,436,511,746,392,354,782,456,326,787,400,357,1134,535,581
39109055ABP,651,128,489,653,174,442,485,156,329,489,206,283,493,163,310,686,230,438
39109055ABE,257,64,175,268,89,165,179,58,121,182,72,110,183,61,110,296,102,189
39157079ADW,204,43,150,204,37,158,158,51,107,160,62,98,157,54,100,239,50,187
39169085ACQ,627,109,498,634,122,492,475,117,358,488,126,362,483,111,352,692,134,550
39093047ADX,417,270,102,436,311,106,258,192,66,267,214,53,267,194,66,395,252,136
39109055ACZ,651,98,529,651,149,478,501,117,384,505,168,337,514,114,383,690,155,526
39109055ABG,452,135,290,453,166,253,333,161,172,345,187,158,351,163,172,468,189,262
39093047AIH,603,194,381,620,246,349,483,234,249,503,277,226,505,232,259,649,276,366
39093047AKM,706,244,424,726,317,381,663,347,316,686,402,284,688,331,331,1008,505,487
39099050AAN,514,352,133,531,382,139,419,313,106,424,336,88,424,323,99,523,367,147
39001001AAU,353,54,285,362,66,290,278,60,218,289,85,204,290,69,213,405,68,336
39001001ABE,563,80,467,579,75,490,443,70,373,457,111,346,462,83,366,649,74,569
39159080AAL,440,98,323,440,145,261,389,129,260,393,175,218,397,144,244,497,195,295
39159080ACC,548,153,380,548,219,305,737,302,435,737,357,380,747,319,414,762,341,414
39159080ABC,192,56,133,191,76,105,252,103,149,257,124,133,260,113,144,990,484,492
39159080ABB,299,77,205,309,103,189,263,96,167,266,100,166,266,97,161,567,247,314
39159080ABH,739,150,553,745,173,530,582,171,411,582,200,382,586,170,394,791,197,575
39123062ABO,569,219,320,584,253,294,419,199,220,423,224,199,420,190,219,610,253,344
39111056AAX,329,126,180,339,90,239,260,115,145,270,141,129,264,98,155,358,75,275
39169085ABU,836,168,611,848,190,623,605,159,446,619,197,422,623,165,442,989,199,777
39169085ABH,877,390,449,863,480,354,812,466,346,820,507,313,823,466,340,946,587,349
39169085ABN,1019,379,605,1007,461,500,897,427,470,917,475,442,918,424,478,1117,548,548
39169085ADG,765,168,566,770,195,538,618,201,417,635,229,406,641,199,420,846,221,612
39007004AEQ,322,100,212,330,102,211,270,105,165,279,127,152,276,115,149,333,113,216
39159080ABU,662,121,511,675,132,508,552,129,423,553,159,394,557,132,400,769,154,597
39159080AAK,694,204,439,696,264,381,511,202,309,514,231,283,517,197,293,731,273,435
39059030ABL,523,149,343,534,145,354,396,137,259,402,158,244,400,125,252,630,176,441
39111056AAN,488,171,289,508,132,357,396,157,239,398,166,232,394,131,250,517,112,402
39111056AAW,123,33,80,131,33,93,106,35,71,109,44,65,101,31,67,148,29,118
39071036ABR,568,79,462,574,82,470,410,87,323,407,102,305,419,79,319,598,95,496
39151076ACL,500,266,197,505,278,200,353,220,133,357,227,130,361,222,130,490,272,211
39151076ACK,465,227,215,473,259,190,297,194,103,299,206,93,302,197,93,405,241,152
39151076AJR,873,224,584,871,225,602,704,244,460,706,298,408,704,233,451,921,251,657
39151076AII,812,160,620,819,211,574,665,196,469,673,232,441,673,191,473,981,254,714
39151076AEV,476,139,301,477,186,263,390,169,221,392,186,206,396,158,228,492,208,272
39151076AHI,988,287,649,1001,350,593,823,351,472,824,373,451,831,327,486,1106,429,669
39169085ABP,803,149,597,811,174,596,622,162,460,640,192,448,649,155,477,825,188,626
39169085AAC,648,187,399,663,219,388,509,202,307,510,225,285,510,202,274,758,245,493
39159080AAP,657,130,499,664,152,489,513,122,391,516,171,345,517,121,380,707,134,559
39157079ACD,635,157,450,641,190,415,532,190,342,537,217,320,543,180,345,630,167,455
39157079AAO,467,172,264,474,206,241,395,173,222,399,209,190,401,178,216,455,208,242
39157079ACK,994,195,745,1002,203,764,788,226,562,801,268,533,790,215,540,1116,229,867
39157079ACN,625,166,428,634,191,424,469,180,289,472,215,257,469,178,264,672,202,460
39157079ACM,743,170,531,747,198,506,586,204,382,593,245,348,587,188,370,805,223,574
39157079AAN,355,134,197,367,139,205,284,144,140,286,158,128,291,136,138,387,158,219
39157079AAM,287,104,163,296,114,166,229,108,121,230,124,106,235,96,123,313,134,173
39121061AAD,314,61,241,331,49,269,264,63,201,269,84,185,270,63,196,352,50,301
39059030ABI,425,105,304,430,95,315,315,85,230,315,102,213,324,87,226,478,90,383
39059030ABH,384,68,304,395,73,301,312,70,242,311,83,228,318,63,246,444,87,351
39065033AAM,649,128,488,659,139,495,518,140,378,516,174,342,521,141,362,730,137,577
39065033AAX,910,149,718,921,174,706,761,163,598,767,228,539,769,154,589,1045,199,828
39099050ARX,578,452,90,600,507,65,427,369,58,437,394,43,437,384,49,562,484,70
39025013ABW,467,78,360,467,122,323,411,125,286,409,135,274,415,114,283,616,190,412
39025013AEM,685,93,568,693,106,560,530,114,416,540,131,409,533,116,401,733,112,617
39007004ABK,351,134,189,354,159,178,285,140,145,297,165,132,292,146,139,392,179,212
39007004ABI,444,147,265,448,170,258,373,152,221,390,187,203,383,156,209,489,173,310
39007004ABO,411,202,177,415,225,168,294,169,125,308,199,109,307,177,121,444,240,197
39007004ACI,526,218,271,519,255,237,387,220,167,399,249,150,398,211,174,561,275,279
39007004AAX,153,75,59,154,84,59,116,70,46,115,76,39,117,63,47,175,95,74
39007004AAU,502,237,228,509,248,227,354,190,164,373,245,128,370,193,149,513,230,271
39007004AEF,356,87,239,364,92,253,291,94,197,301,115,186,301,91,192,418,99,306
39007004AEZ,773,212,535,774,257,489,625,216,409,636,272,364,638,215,408,925,279,634
39007004AEH,317,97,203,317,94,203,260,91,169,265,104,161,262,89,163,339,108,226
39007004ADL,410,123,272,422,153,257,350,135,215,360,177,183,355,134,211,465,167,293
39007004ADI,314,85,212,321,100,201,248,94,154,256,122,134,258,107,144,358,104,245
39007004ABD,430,156,239,433,164,228,321,163,158,327,186,141,326,165,143,443,196,239
39159080AAN,539,80,432,542,101,408,452,114,338,459,140,319,460,116,328,624,152,461
39159080ABY,885,336,527,894,479,375,871,490,381,873,540,333,879,495,370,1157,710,435
39041021ABZ,619,175,427,629,249,362,615,221,394,617,279,338,622,233,372,701,304,389
39041021AGP,267,95,161,262,129,122,283,129,154,286,158,128,286,137,143,541,303,232
39041021ABC,501,178,301,488,235,231,521,238,283,528,293,235,531,256,264,510,265,240
39041021ABX,397,112,266,407,139,254,342,117,225,338,145,193,348,130,211,472,170,297
39041021AGI,521,152,342,522,198,288,415,170,245,411,207,204,418,178,231,617,273,328
39041021AAB,578,176,377,577,215,324,532,207,325,539,242,297,537,205,319,837,360,449
39041021ACM,647,137,487,652,170,460,560,146,414,562,182,380,569,169,383,718,199,509
39041021AFB,733,196,506,746,259,444,708,285,423,707,309,398,717,282,409,1334,584,730
39023012ADW,952,238,660,967,287,644,775,242,533,791,324,467,788,236,536,992,317,659
39023012AAQ,539,294,203,548,357,162,326,241,85,328,252,76,330,225,89,478,291,178
39073037AAU,432,131,276,444,109,321,338,100,238,349,131,218,352,107,235,545,124,415
39021011AAW,898,163,655,910,200,668,713,170,543,716,218,498,727,180,510,1078,234,831
39021011AAY,623,169,377,631,204,395,492,168,324,499,205,294,497,171,297,702,209,474
39151076ADC,301,133,148,308,148,141,235,144,91,239,151,88,240,139,88,368,216,140
39025013ADN,401,67,315,398,90,289,323,89,234,325,98,227,326,84,229,460,110,347
39169085ACU,793,134,618,806,174,603,642,139,503,655,172,483,664,144,495,888,177,700
39169085AAZ,784,271,481,789,347,413,695,305,390,705,346,359,708,307,385,856,414,428
39169085ADU,782,175,570,781,198,551,648,207,441,663,239,424,668,208,436,876,220,636
39153077AHO,621,340,238,635,379,228,476,325,151,488,364,124,491,327,142,695,435,245
39153077AZV,507,257,205,530,292,209,357,209,148,359,221,138,369,212,144,527,274,240
39153077BAY,654,152,489,632,235,377,543,212,331,557,243,314,552,214,332,724,323,396
39153077APR,599,240,334,619,289,309,509,260,249,536,296,240,530,264,254,664,333,328
39153077ARZ,632,223,361,652,278,346,491,239,252,507,266,241,498,233,250,731,324,397
39153077ANS,531,208,286,553,225,297,433,213,220,446,246,200,441,216,214,596,237,349
39153077AEN,668,255,369,699,307,363,544,291,253,559,322,237,553,291,252,743,358,377
39153077AYJ,450,318,87,464,371,72,360,297,63,370,320,50,372,306,54,530,413,109
39051026AAW,754,168,534,754,192,508,553,180,373,557,235,322,563,166,371,831,220,594
39051026AAX,661,192,434,670,213,425,539,204,335,542,253,289,546,209,315,695,256,430
39051026AAN,755,115,612,757,151,569,575,118,457,579,151,428,584,124,449,813,173,633
39051026ABC,837,290,498,850,339,462,658,274,384,665,312,353,667,260,387,899,342,547
39153077ABX,385,318,44,407,353,39,249,206,43,251,219,32,251,210,32,316,258,54
39153077AHL,537,333,162,549,375,154,443,335,108,449,347,102,453,326,111,588,410,171
39023012AFO,678,153,500,685,192,466,559,165,394,560,198,362,562,161,380,744,197,534
39169085ACS,664,149,476,670,163,484,523,148,375,533,176,357,533,145,372,741,166,563
39169085ADS,666,165,453,668,190,448,531,187,344,534,208,326,539,183,333,684,188,482
39169085AAU,745,247,450,760,307,416,599,270,329,621,306,315,618,269,336,853,401,437
39169085ADH,538,79,432,543,95,414,421,80,341,433,96,337,436,82,335,630,99,523
39169085AAG,545,152,367,546,196,324,452,170,282,461,183,278,466,170,282,620,220,388
39037019ABR,483,74,389,482,84,381,332,78,254,337,98,239,336,74,248,513,93,412
39107054AAU,502,108,363,502,92,387,357,94,263,360,118,242,364,95,255,521,106,409
39049025AKE,665,510,114,732,628,89,529,453,76,533,468,65,535,445,79,706,589,105
39049025BHK,819,266,525,831,323,479,688,289,399,684,331,353,691,313,358,1000,438,546
39049025ANG,739,255,474,731,342,365,697,312,385,700,388,312,702,333,359,794,425,360
39049025BBS,628,337,263,632,385,216,566,366,200,568,408,160,571,375,186,659,457,186
39049025AQM,677,279,385,677,371,290,630,331,299,640,378,262,647,354,283,739,466,269
39049025AGC,429,287,117,445,299,130,304,209,95,306,238,68,310,219,80,555,374,170
39049025AMQ,510,225,263,526,259,244,362,190,172,361,221,140,363,203,156,550,266,270
39017009AIT,968,233,692,987,348,604,762,302,460,780,340,440,776,298,457,1006,433,562
39173087ACA,865,305,521,887,361,496,696,328,368,699,388,311,703,334,349,987,380,593
39085043AGM,614,188,391,629,212,376,533,219,314,535,253,282,536,208,307,715,257,445
39085043AFT,421,97,318,430,128,288,382,139,243,379,148,231,381,135,242,489,183,304
39085043AFW,920,201,670,949,243,670,768,226,542,780,276,504,792,230,529,1054,274,759
39085043AGY,206,70,125,218,79,132,176,75,101,181,85,96,181,71,98,244,95,145
39149075ABV,970,104,846,986,130,838,781,125,656,783,174,609,789,144,623,1062,127,929
39149075ABX,881,79,780,879,119,740,703,122,581,709,176,533,707,126,565,986,142,837
39133067AFC,499,243,207,513,276,214,365,224,141,365,230,135,362,211,131,539,266,265
39133067AFS,626,179,388,656,205,416,457,188,269,458,209,249,457,179,249,715,226,477
39133067ABV,388,164,194,400,185,197,279,151,128,279,159,120,277,143,118,406,179,214
39085043AFR,1072,214,824,1096,335,737,958,300,658,962,367,595,973,267,690,1215,405,803
39085043AFJ,937,211,685,967,292,624,836,300,536,845,346,499,853,298,538,1100,395,693
39085043ACP,691,300,325,731,372,317,501,307,194,504,332,172,507,290,191,762,431,312
39085043ACQ,766,329,378,810,432,338,570,319,251,577,352,225,573,301,248,792,410,365
39085043AAF,486,191,258,509,198,288,371,186,185,371,207,164,373,165,198,564,222,330
39049025BAA,398,125,255,408,142,236,400,152,248,405,190,215,403,164,232,432,154,275
39049025AZO,602,136,438,618,164,428,529,156,373,533,186,347,533,171,349,724,201,516
39065033AAV,825,174,598,829,175,594,597,197,400,605,237,368,603,181,385,934,220,692
39007004ABR,320,121,179,333,137,184,286,135,151,292,169,123,296,141,146,369,184,179
39007004ADO,341,71,239,349,74,258,277,83,194,281,105,176,286,76,197,396,96,295
39065033ABL,283,53,219,284,58,221,229,55,174,229,69,160,229,58,161,316,66,246
39065033ABD,294,62,212,308,77,217,234,80,154,236,95,141,237,78,144,301,69,225
39029015ADS,415,94,283,431,89,321,296,79,217,308,99,209,298,82,204,517,90,419
39029015AFD,542,110,400,564,127,412,425,135,290,437,161,276,432,134,278,617,138,471
39029015AAB,423,180,198,444,196,230,299,152,147,306,175,131,307,140,153,459,192,258
39099050AQL,426,241,168,428,268,146,298,191,107,303,222,81,297,197,93,425,259,158
39099050AAJ,355,193,131,371,235,117,256,179,77,254,190,64,259,174,77,328,187,136
39029015AEY,405,91,282,417,100,295,311,98,213,313,128,185,312,93,206,442,91,348
39099050AKD,450,232,191,455,244,196,355,202,153,352,222,130,357,195,154,484,249,228
39099050AJJ,557,228,302,579,265,296,431,219,212,438,258,180,445,234,196,606,281,317
39017009AEE,618,150,442,620,174,419,479,173,306,481,192,289,479,166,298,670,205,459
39017009AID,632,109,486,648,139,493,443,102,341,464,110,354,460,91,347,681,108,564
39017009ACX,391,138,224,412,163,227,236,105,131,250,119,131,248,113,126,448,180,262
39017009ACM,395,74,308,408,107,288,313,88,225,332,110,222,332,94,229,409,117,288
39017009ALB,838,182,622,853,261,567,690,242,448,703,267,436,704,242,448,896,336,548
39017009AKX,750,151,563,762,231,492,614,208,406,626,229,397,624,203,402,824,308,505
39017009AJC,935,213,683,951,321,587,790,296,494,803,333,470,800,300,480,1022,419,587
39017009ACK,571,180,370,587,218,357,386,144,242,400,168,232,396,152,236,619,243,367
39149075ABO,508,48,445,516,51,444,448,58,390,445,94,351,446,80,341,591,69,513
39149075ABQ,689,90,580,693,120,536,487,98,389,498,140,358,500,112,367,719,118,588
39133067AAG,638,177,438,642,267,349,535,230,305,539,265,274,541,235,294,715,332,372
39099050ASA,437,369,49,453,397,48,280,236,44,295,260,35,281,240,37,363,302,58
39099050ACM,548,483,35,571,532,22,337,316,21,347,323,24,346,318,17,450,403,44
39099050APW,389,141,234,403,193,192,299,129,170,305,165,140,306,128,174,361,187,174
39099050ALQ,543,271,239,549,289,223,407,248,159,411,272,139,413,253,146,544,313,221
39029015ACP,413,100,292,439,101,317,366,94,272,381,115,266,379,104,264,491,108,371
39029015ADU,579,126,407,603,135,450,462,126,336,484,145,339,477,127,328,691,139,542
39029015ADW,966,243,685,985,284,672,781,249,532,810,313,497,805,260,522,1030,292,722
39029015ABN,800,254,494,818,307,473,621,261,360,639,302,337,635,267,350,885,330,539
39029015ADN,463,163,280,469,145,302,334,131,203,349,148,201,342,128,203,530,154,368
39049025BHH,946,430,461,970,492,414,723,412,311,728,464,264,731,432,282,1088,585,469
39049025BGN,597,268,302,603,323,248,434,246,188,438,269,169,438,258,168,599,351,231
39049025ADL,584,465,94,610,523,74,443,372,71,450,391,59,449,378,57,628,532,78
39087044ABL,398,174,199,420,156,249,292,116,176,291,140,151,294,109,180,409,139,266
39087044ABV,426,163,243,445,125,307,302,97,205,306,133,173,306,104,195,471,114,353
39087044ABQ,380,109,255,397,78,302,307,77,230,307,106,201,310,76,223,436,68,362
39113057ACD,688,268,388,709,345,339,510,252,258,509,276,233,516,243,254,753,390,340
39113057AYE,1017,306,673,1026,418,552,851,390,461,853,442,411,854,368,462,1147,577,551
39113057AOO,862,145,689,870,242,611,732,219,513,740,292,448,737,211,510,925,300,620
39113057ARX,1030,238,761,1034,318,681,859,272,587,878,359,519,878,271,586,1089,373,697
39113057ACA,503,134,338,515,195,301,370,135,235,366,180,186,372,142,215,539,200,330
39113057AQM,779,682,82,786,745,35,663,617,46,679,653,26,674,618,38,807,751,52
39113057AKK,1116,311,753,1121,383,688,931,358,573,948,427,521,939,347,563,1298,495,779
39113057AYH,1004,267,731,1006,384,592,884,350,534,896,407,489,896,347,535,1193,577,601
39073037AAG,866,264,566,875,300,547,680,262,418,686,327,359,692,260,415,934,293,631
39025013AFA,724,194,510,730,266,435,540,226,314,544,251,293,543,208,313,724,276,434
39007004ADN,421,142,254,419,151,256,346,143,203,353,177,176,355,142,206,488,172,307
39155078AAM,451,259,164,469,286,165,323,221,102,335,238,97,325,211,100,446,265,174
39015008ACF,560,89,450,583,103,454,421,93,328,430,123,307,433,87,335,643,98,535
39071036ABI,478,93,371,486,90,381,373,95,278,376,108,268,381,90,285,523,93,426
39071036AAV,633,98,495,651,107,515,438,84,354,440,93,347,444,66,358,676,96,572
39147074AAL,378,151,197,394,181,181,280,139,141,293,176,117,292,136,140,412,201,203
39165083ABH,679,149,501,700,222,439,560,194,366,569,226,343,572,202,354,758,287,456
39165083ADO,595,82,482,601,103,474,507,110,397,514,128,386,518,107,396,663,135,521
39165083AGI,694,131,537,718,172,504,594,161,433,604,178,426,603,149,429,824,241,567
39165083AHA,757,167,560,766,233,497,702,232,470,710,266,444,714,240,457,1131,416,694
39155078AJO,804,233,533,831,287,512,681,278,403,682,311,371,690,278,394,919,333,581
39161081ABB,403,67,310,412,74,322,356,82,274,357,106,251,358,77,271,475,100,364
39107054AAH,520,130,361,525,156,335,368,132,236,364,153,211,374,124,237,571,152,408
39137069AAB,674,84,570,705,100,572,538,85,453,547,158,389,547,86,442,720,103,608
39161081AAD,213,47,155,213,53,146,155,43,112,152,59,93,155,36,116,246,47,196
39071036ABG,850,179,642,857,205,624,641,180,461,642,212,430,647,172,448,925,191,730
39007004AAN,130,89,36,130,83,41,70,47,23,68,46,22,70,47,22,108,55,51
39007004AAQ,209,143,49,213,165,39,152,119,33,156,131,25,155,117,30,203,141,56
39007004ABS,600,232,312,608,255,298,432,195,237,435,238,197,441,205,206,630,260,355
39007004ACP,608,181,388,618,225,370,480,185,295,484,230,254,488,185,280,619,231,381
39157079ABW,367,63,293,384,73,293,296,72,224,300,91,209,302,76,222,415,75,336
39111056AAQ,500,158,315,520,99,397,356,141,215,359,165,194,337,109,219,533,108,421
39065033AAP,413,79,315,420,88,312,340,88,252,343,112,231,341,86,234,455,87,363
39065033AAS,654,110,513,678,146,492,523,134,389,523,181,342,531,145,363,729,154,565
39161081AAM,226,48,163,231,54,160,166,42,124,165,56,109,167,44,117,236,58,170
39049025BGQ,700,322,341,714,390,276,589,354,235,590,382,208,586,362,219,775,463,296
39049025AHK,620,569,29,645,617,18,440,418,22,442,433,9,446,426,15,616,576,30
39049025AXV,679,337,326,669,440,209,659,385,274,656,450,206,664,416,237,732,536,189
39049025AAT,911,528,357,910,659,206,826,626,200,829,685,144,843,658,168,1006,803,187
39049025AYF,565,297,255,569,359,175,554,361,193,560,395,165,562,383,171,605,442,158
39049025BJC,644,188,428,663,223,413,506,214,292,505,240,265,510,229,274,751,306,424
39049025AYU,554,328,199,576,369,180,390,254,136,396,275,121,396,252,131,575,371,195
39143072ACV,657,123,479,657,164,442,516,148,368,521,200,321,521,151,341,720,172,537
39143072AAT,345,150,168,357,165,162,261,139,122,260,154,106,255,126,117,391,198,182
39143072AAC,461,120,303,469,162,282,360,169,191,363,182,181,362,157,186,546,173,361
39157079AEG,597,156,394,610,160,428,464,158,306,469,182,287,464,151,290,678,152,521
39157079ABE,345,131,172,362,157,170,234,141,93,240,148,92,242,136,92,372,168,192
39113057ACO,344,232,82,347,270,60,296,242,54,303,265,38,304,237,58,345,283,55
39113057ARE,743,621,97,761,690,59,472,426,46,477,451,26,481,436,41,661,585,67
39113057ADQ,468,229,200,478,264,175,401,264,137,404,285,119,407,256,129,544,332,196
39113057AYZ,400,197,174,419,236,158,261,155,106,265,177,88,267,149,107,392,210,178
39113057AWT,629,109,509,638,163,447,529,132,397,535,182,353,537,133,390,624,167,451
39113057AAE,521,130,366,522,174,303,462,187,275,465,223,242,465,179,265,581,259,305
39113057AOF,1008,236,737,1019,325,652,859,315,544,871,362,509,869,297,541,1083,397,671
39113057AMB,730,251,448,741,335,376,649,322,327,662,377,285,664,318,326,866,435,416
39113057ABD,678,429,207,695,519,127,670,520,150,676,550,126,673,505,142,989,739,227
39113057AQZ,512,257,232,532,313,208,363,222,141,366,246,120,365,216,142,517,306,207
39113057ADJ,508,454,29,522,496,17,370,355,15,378,366,12,378,357,10,452,422,20
39085043ACV,581,289,249,606,342,232,452,289,163,457,319,138,456,278,167,702,404,282
39149075ABU,817,67,732,810,83,711,683,86,597,697,110,587,703,88,604,898,83,812
39133067ADU,640,172,416,655,200,421,525,218,307,536,240,296,532,210,292,721,212,496
39133067AET,382,124,236,402,127,259,295,120,175,295,128,167,300,123,168,437,126,305
39133067AEW,624,178,407,657,192,443,517,198,319,520,227,293,523,189,324,765,223,527
39085043AGO,711,204,487,736,294,424,930,402,528,942,469,473,940,377,530,856,372,479
39085043AHZ,752,253,469,776,314,440,617,269,348,610,301,309,612,259,332,843,339,500
39085043AGZ,811,258,525,831,283,508,676,269,407,680,310,370,684,269,399,917,307,604
39049025AXH,740,476,218,767,562,174,546,405,141,554,436,118,553,408,132,641,472,155
39049025ABW,817,501,293,818,613,159,738,552,186,751,610,141,753,583,164,1040,853,177
39085043AGD,651,206,399,653,227,386,519,219,300,529,256,273,523,204,297,747,293,442
39085043AHK,887,272,588,910,352,514,793,329,464,792,382,410,794,305,475,1067,442,619
39149075ACN,938,109,792,941,122,775,709,125,584,710,179,531,708,140,546,1020,142,862
39133067AEF,570,154,391,593,175,390,473,186,287,481,213,268,478,183,275,719,205,501
39133067ACB,566,217,319,580,252,293,491,271,220,496,298,198,499,254,222,587,301,274
39085043ABX,767,229,512,794,278,489,659,288,371,668,312,356,669,270,391,884,347,529
39143072ADE,692,156,494,699,191,476,560,180,380,566,226,340,572,176,372,773,213,544
39143072AAG,572,139,373,580,187,349,441,155,286,444,207,237,453,149,267,628,190,419
39143072AAU,360,160,168,365,189,151,266,158,108,266,168,98,262,148,102,388,192,188
39173087ADZ,735,311,360,750,360,332,541,292,249,549,349,200,553,286,240,774,388,360
39173087ADG,629,200,408,635,285,326,567,273,294,570,319,251,574,267,299,759,367,387
39173087ADD,425,136,267,429,163,240,323,131,192,319,148,171,318,125,179,462,196,256
39173087AAC,1218,702,456,1279,794,383,375,290,85,378,306,72,380,290,76,209,148,53
39173087ACG,800,281,474,827,331,455,643,303,340,651,356,295,652,296,329,985,400,570
39173087ACB,882,275,559,889,336,484,651,295,356,656,355,301,656,288,335,904,376,514
39173087ACY,598,167,407,609,199,371,487,177,310,495,233,262,491,172,300,652,226,418
39173087ACZ,205,55,140,206,63,132,171,58,113,167,70,97,173,56,110,213,62,148
39173087ABD,658,225,407,653,293,325,555,266,289,560,316,244,567,269,283,702,374,316
39017009AGL,881,250,598,916,355,521,659,294,365,681,314,367,676,299,360,987,441,533
39143072ABN,666,141,487,660,195,433,543,172,371,542,224,318,550,180,349,727,210,503
39157079ACG,488,148,313,492,159,308,390,143,247,393,176,217,394,147,227,497,127,363
39157079ABM,796,242,515,795,299,462,661,264,397,676,322,354,674,275,380,868,343,514
39157079AEP,683,167,475,705,184,482,571,218,353,570,253,317,578,196,355,764,187,566
39087044AAZ,305,68,231,317,45,263,251,53,198,249,75,174,265,53,208,298,30,267
39149075ACD,570,83,452,583,91,467,460,83,377,457,109,348,464,80,364,623,83,529
39133067AFZ,670,139,495,685,194,473,556,194,362,565,214,351,559,186,346,701,187,508
39133067AEJ,466,158,284,473,172,273,349,162,187,360,186,174,361,161,186,536,201,326
39151076ABL,593,267,282,591,283,271,419,239,180,420,259,161,422,235,167,599,303,279
39151076AGB,716,304,346,731,323,372,524,265,259,532,294,238,531,264,243,709,299,400
39151076AFR,864,256,550,868,272,559,644,266,378,654,328,326,661,271,348,887,271,605
39151076AGN,859,256,570,866,335,498,767,341,426,773,359,414,774,320,439,1009,400,598
39151076AAG,271,153,98,270,151,103,188,120,68,192,126,66,188,103,76,280,156,118
39093047ABY,651,331,271,670,382,248,460,302,158,476,330,146,481,300,162,795,444,337
39109055ABR,791,130,631,795,181,582,642,154,488,650,203,447,658,147,489,883,193,678
39093047AJV,999,278,650,1024,325,637,870,358,512,907,430,477,913,349,522,1117,363,728
39093047AJB,950,297,596,983,362,579,765,333,432,785,385,400,792,327,445,1126,441,675
39099050AAS,504,171,311,518,223,279,464,218,246,462,254,208,468,218,238,548,230,314
39099050ADW,339,211,113,355,227,114,219,158,61,220,165,55,222,158,61,314,192,118
39173087AAP,746,293,407,747,358,332,622,323,299,632,382,250,634,318,292,840,437,379
39173087ADP,659,208,411,669,239,377,473,206,267,474,257,217,478,206,254,681,260,415
39173087ABR,681,170,483,684,205,423,573,207,366,575,266,309,583,202,358,732,254,466
39173087ABZ,321,62,241,322,75,229,259,70,189,258,103,155,259,67,183,365,79,283
39017009AFD,904,442,416,954,609,292,319,222,97,323,236,87,319,206,91,122,88,32
39017009AEY,438,201,223,458,284,152,166,128,38,168,136,32,169,128,37,104,87,17
39017009AEF,484,148,313,495,186,279,365,158,207,371,172,199,372,153,202,561,224,321
39049025BLY,420,183,219,424,209,187,440,311,129,442,323,119,445,306,123,748,507,222
39049025BFU,784,346,414,804,400,354,716,359,357,727,405,322,732,369,341,1160,651,487
39049025AMF,430,234,154,435,272,132,299,210,89,302,227,75,303,222,77,467,295,165
39085043AAS,867,236,577,892,299,560,704,289,415,713,327,386,721,281,424,1035,382,641
39085043AGC,794,224,519,831,272,525,654,260,394,657,287,370,664,237,399,945,289,637
39131066AAF,272,96,162,271,87,175,189,79,110,190,94,96,190,67,114,263,76,186
39175088ABC,379,53,316,391,74,304,319,74,245,324,103,221,327,77,244,422,95,324
39155078ADN,369,308,51,376,331,38,244,222,22,252,235,17,247,218,24,316,247,66
39155078AIW,403,86,303,407,95,302,298,73,225,303,91,212,301,71,227,505,95,408
39155078AAE,639,338,268,655,384,253,525,346,179,534,393,141,538,355,174,662,401,255
39147074ACM,580,104,456,584,129,418,470,110,360,477,183,294,478,108,354,628,122,496
39021011ABB,603,117,464,607,128,464,527,119,408,532,170,362,532,126,390,667,132,528
39157079AAQ,405,144,225,409,154,224,283,142,141,283,150,133,287,128,144,409,144,254
39157079AAS,480,172,283,496,201,264,411,203,208,411,235,176,409,194,192,561,230,316
39157079AAF,760,199,537,768,252,482,669,251,418,671,311,360,680,257,404,816,324,480
39157079AAA,459,149,279,474,166,260,320,162,158,326,182,144,323,160,149,455,191,249
39157079ADG,804,252,502,814,226,545,599,253,346,622,288,334,604,241,344,1003,259,732
39157079ABU,446,164,251,459,184,247,315,158,157,323,178,145,321,153,152,520,178,326
39157079AEC,557,71,479,570,79,472,458,75,383,466,104,362,469,82,376,699,103,590
39151076AGP,889,251,590,902,310,557,730,271,459,729,314,415,732,252,455,923,348,562
39151076AJK,770,170,565,779,191,555,677,183,494,693,238,455,700,204,478,826,199,615
39151076AAA,271,123,123,279,138,128,174,90,84,176,95,81,173,92,75,326,146,166
39151076AJD,560,119,408,574,138,424,521,141,380,520,168,352,519,139,371,620,126,485
39151076ANY,813,169,596,829,206,590,649,220,429,665,243,422,665,199,441,906,216,680
39151076ANX,553,106,424,564,120,426,455,119,336,457,139,318,463,121,325,631,120,502
39151076AJY,718,167,513,735,177,525,559,166,393,564,192,372,571,167,379,800,183,609
39151076ADW,479,196,258,488,196,270,393,187,206,392,204,188,399,185,192,504,206,289
39151076AAY,309,205,84,317,216,85,198,145,53,199,157,42,201,145,48,310,205,97
39151076ACP,415,153,240,411,209,173,318,160,158,328,187,141,324,154,159,416,207,197
39151076ADE,335,238,76,343,254,76,213,178,35,221,191,30,218,178,35,335,236,92
39151076ADT,571,203,336,567,234,307,489,206,283,496,246,250,497,204,275,615,263,343
39087044AAL,148,90,50,150,86,58,114,73,41,116,85,31,116,73,40,143,83,60
39155078AHS,452,113,314,462,101,342,361,101,260,368,129,239,369,111,246,474,87,385
39155078AGN,495,242,228,509,259,239,383,230,153,392,251,141,390,235,144,545,275,263
39155078AAW,425,197,203,435,208,209,318,159,159,320,188,132,321,154,153,450,204,237
39155078AEE,491,403,62,508,440,49,337,303,34,350,320,30,344,303,36,441,373,64
39147074AAC,479,209,229,488,254,204,361,212,149,369,233,136,363,196,147,529,254,262
39147074AAZ,383,116,237,394,144,216,277,115,162,281,149,132,280,115,152,424,162,250
39147074ACG,662,178,441,679,207,416,497,175,322,508,212,296,510,173,312,753,210,535
39147074ABQ,395,72,308,398,109,273,307,92,215,316,133,183,316,96,211,435,132,300
39147074ABY,507,128,346,520,140,338,386,108,278,393,153,240,395,121,251,559,152,396
39165083ACX,525,75,416,539,101,415,443,111,332,451,132,319,452,105,334,596,118,473
39165083AAF,607,133,432,622,167,431,481,158,323,492,177,315,491,146,335,680,196,476
39155078AKS,673,235,418,687,287,383,567,246,321,572,286,286,580,265,309,751,319,426
39155078ABK,614,268,324,629,309,294,535,318,217,544,368,176,543,326,207,677,359,313
39157079AEJ,353,106,224,363,107,239,311,134,177,309,142,167,309,116,175,423,114,306
39157079ACA,606,155,407,620,169,407,560,205,355,567,263,304,570,211,333,683,165,505
39157079ABZ,344,95,222,350,103,226,302,126,176,296,139,157,300,111,177,395,107,284
39049025AWI,688,303,360,689,373,266,581,304,277,586,360,226,595,333,242,645,405,231
39049025AZK,884,310,527,912,366,504,655,306,349,656,345,311,659,322,327,1024,437,562
39133067AER,472,131,313,476,128,332,356,119,237,354,131,223,355,120,219,529,124,396
39133067AGI,373,150,197,390,182,192,282,146,136,285,164,121,285,135,136,437,176,258
39133067ADE,388,108,254,393,127,248,312,125,187,313,145,168,314,117,181,435,147,286
39073037ABE,206,102,92,204,82,115,150,82,68,150,92,58,150,81,63,197,77,117
39151076ANO,822,250,513,830,258,539,608,245,363,613,277,336,620,234,355,871,262,598
39143072AAL,743,203,501,748,251,455,642,265,377,650,332,318,649,255,368,862,270,578
39143072ABY,359,80,269,371,119,234,288,106,182,289,137,152,287,109,171,398,137,257
39143072ACC,489,125,333,499,159,322,406,140,266,400,166,234,407,131,269,520,155,358
39049025BID,556,454,72,594,523,56,460,409,51,466,427,39,465,408,46,672,582,78
39049025AQZ,537,206,316,543,263,243,504,251,253,508,291,217,517,273,234,586,342,237
39049025ABX,598,353,189,634,404,195,422,308,114,430,334,96,425,284,126,697,459,222
39049025BAQ,742,280,427,742,359,333,678,347,331,682,410,272,686,371,299,771,478,279
39049025ANH,906,381,492,938,511,379,872,510,362,878,580,298,879,532,327,1358,863,467
39049025BLG,743,334,392,743,439,273,665,372,293,676,436,240,679,410,249,800,489,297
39049025BGK,881,653,194,909,712,177,639,509,130,648,529,119,648,520,120,859,658,185
39071036AAB,709,214,451,713,255,425,506,188,318,507,211,296,508,200,296,732,236,492
39157079AEO,688,108,543,714,101,591,530,88,442,539,125,414,536,77,447,776,74,698
39157079ADZ,484,139,298,497,162,308,355,135,220,357,164,193,354,133,209,516,151,351
39157079ADP,375,127,222,380,117,235,272,105,167,278,126,152,275,104,159,413,112,296
39049025ABC,486,426,39,508,455,33,391,360,31,394,367,27,398,360,25,514,463,40
39049025ABB,509,400,73,529,454,53,397,364,33,406,380,26,405,365,31,603,523,69
39153077AJO,760,282,438,774,336,411,660,334,326,677,379,298,684,341,336,817,362,444
39153077AOR,730,255,459,738,337,377,643,313,330,658,353,305,655,299,341,812,409,390
39049025BHA,623,290,312,628,360,236,496,299,197,500,335,165,503,303,185,649,414,224
39049025AHB,749,443,280,764,558,154,694,501,193,692,533,159,703,506,168,832,639,176
39049025ALX,428,380,37,450,419,25,282,256,26,285,266,19,286,258,23,397,355,35
39049025AFG,687,626,42,717,686,18,527,507,20,534,518,16,536,504,19,698,654,36
39049025APY,582,364,186,599,430,143,523,361,162,521,391,130,522,373,140,609,466,133
39049025ALV,593,455,108,585,487,61,539,465,74,542,486,56,546,458,69,743,645,90
39049025API,478,391,60,494,424,47,326,286,40,330,294,36,333,290,37,442,382,52
39049025BAD,718,296,390,735,331,375,573,278,295,572,319,253,578,282,279,751,356,379
39049025ASH,625,265,336,633,332,262,512,288,224,516,323,193,518,299,205,695,429,255
39049025BFW,596,197,375,599,259,317,549,258,291,550,287,263,551,262,278,682,355,312
39049025BIR,944,539,350,971,622,304,775,511,264,777,554,223,785,527,230,1101,736,344
39049025BAF,340,94,235,354,109,224,269,88,181,269,117,152,274,95,172,384,119,256
39049025AZX,204,60,136,199,70,117,165,64,101,168,77,91,168,67,97,217,95,113
39049025BGY,904,378,489,911,461,388,709,399,310,717,440,277,720,405,300,1004,595,384
39049025AXY,772,430,309,764,499,204,759,505,254,760,555,205,764,537,218,837,617,204
39049025AKA,546,406,120,559,448,96,431,337,94,437,362,75,435,336,90,582,446,127
39049025BAC,649,155,450,648,177,443,462,141,321,458,182,276,460,160,284,666,218,443
39133067AGP,491,126,329,502,118,364,379,117,262,385,131,254,386,115,250,558,144,407
39085043ADF,631,220,382,647,283,346,552,283,269,556,320,236,562,269,281,720,330,382
39085043ACL,752,385,305,810,483,286,540,328,212,545,349,196,550,299,229,788,449,326
39085043AFN,654,229,404,679,299,359,550,274,276,547,312,235,552,247,290,771,347,416
39085043AGS,499,156,311,512,177,304,404,142,262,403,183,220,403,140,246,594,210,374
39133067AAP,562,375,159,578,442,117,523,413,110,525,436,89,525,409,96,638,519,111
39051026AAM,774,191,540,779,234,484,605,229,376,609,284,325,620,217,369,838,272,556
39051026AAC,458,75,357,469,93,353,352,100,252,354,116,238,358,87,259,505,93,405
39153077ASA,546,204,289,576,222,320,432,213,219,448,246,202,443,208,206,640,249,381
39153077ADQ,508,433,50,521,466,42,368,326,42,376,338,38,372,323,36,520,450,58
39153077AZX,509,308,154,531,327,162,376,268,108,381,281,100,379,266,97,530,348,169
39153077AHA,780,322,447,779,423,343,716,398,318,731,447,284,732,400,323,879,524,353
39153077AYK,380,225,137,399,254,115,169,128,41,174,141,33,174,136,31,174,129,40
39153077AJA,525,170,319,541,197,314,406,189,217,413,210,203,415,197,209,566,202,356
39153077ALW,608,256,318,621,290,304,497,269,228,515,293,222,502,262,228,669,343,318
39153077ASD,732,286,387,742,342,373,626,313,313,644,342,302,643,316,313,848,395,437
39153077ANO,502,160,303,536,184,324,436,176,260,459,207,252,450,183,243,579,190,379
39153077ASO,585,231,293,611,254,331,450,222,228,464,253,211,465,232,208,650,262,380
39153077BCQ,656,224,380,687,259,396,504,223,281,519,246,273,513,211,279,738,264,466
39051026AAL,360,55,293,368,66,287,282,60,222,284,88,196,285,60,220,399,78,317
39051026AAU,955,254,657,959,269,636,754,247,507,763,301,462,758,240,495,1022,283,724
39113057AOU,840,375,427,860,445,375,608,357,251,611,395,216,607,347,243,971,551,404
39113057AQI,802,533,244,815,614,178,652,499,153,663,538,125,661,497,147,787,586,186
39113057AJI,1090,381,654,1098,460,584,883,407,476,888,469,419,890,388,467,1174,534,618
39113057ARO,890,222,625,894,291,549,681,238,443,690,300,390,694,238,420,963,309,632
39113057ABH,323,197,98,324,220,75,288,224,64,291,238,53,291,219,63,396,289,98
39113057AKY,813,223,547,838,306,481,672,293,379,680,338,342,680,272,360,936,426,490
39113057ASW,879,161,688,879,230,618,748,231,517,749,293,456,755,210,529,946,278,648
39113057AAR,944,256,658,932,364,521,807,343,464,813,402,411,821,335,470,1000,489,497
39113057ATK,897,148,714,914,213,651,702,180,522,708,241,467,712,179,506,932,245,679
39113057ASE,931,244,634,958,298,591,696,268,428,705,322,383,711,258,420,971,347,603
39113057AWV,737,181,533,748,242,475,643,251,392,658,287,371,665,248,399,811,307,496
39113057AIT,636,189,420,650,252,380,519,219,300,528,270,258,526,223,285,658,277,364
39113057ABU,311,137,141,317,164,140,202,107,95,203,117,86,202,95,95,290,136,152
39113057ADS,659,295,321,667,337,293,476,271,205,480,302,178,483,262,200,666,371,281
39113057AJD,881,266,580,879,357,491,730,314,416,738,367,371,736,294,419,966,396,560
39113057AIF,772,694,55,787,757,19,558,539,19,569,554,15,569,534,26,730,691,27
39113057AHH,178,152,20,186,183,0,127,123,4,129,128,1,129,123,5,178,173,2
39111056ABC,166,55,101,170,42,126,146,52,94,152,73,79,145,44,100,189,36,153
39173087ADJ,616,270,299,638,316,269,404,242,162,407,267,140,410,240,156,769,416,338
39085043AEN,958,370,563,1006,474,507,835,438,397,845,470,375,851,414,415,1035,546,482
39047024ABC,356,73,279,363,76,279,282,57,225,285,92,193,292,68,217,392,87,302
39149075ABK,956,104,825,967,141,795,745,131,614,754,172,582,745,142,583,1037,162,863
39149075ABE,730,114,593,737,152,560,547,136,411,548,165,383,546,140,387,800,162,626
39133067ACI,762,350,371,785,417,337,613,373,240,619,396,223,619,360,241,844,464,367
39049025BBB,697,201,465,718,234,465,598,193,405,605,245,360,609,236,363,788,210,565
39049025ACW,282,242,25,294,261,18,222,203,19,222,205,17,226,195,17,401,347,46
39049025BJA,814,253,519,823,297,485,687,302,385,694,360,334,700,338,340,960,443,504
39049025BHI,542,286,226,562,326,195,483,311,172,481,330,151,485,320,152,754,484,254
39049025BBE,542,138,366,556,151,368,418,142,276,423,159,264,422,139,264,648,176,462
39049025AXT,701,504,174,709,544,145,550,411,139,553,439,114,557,418,128,670,512,148
39049025AHH,473,336,115,494,392,90,376,295,81,379,315,64,381,303,72,473,390,81
39049025ALQ,560,376,159,581,434,133,483,370,113,487,398,89,489,386,98,590,453,131
39049025ALF,619,299,299,624,351,247,529,305,224,536,334,202,536,312,204,646,408,230
39049025AXA,731,267,443,723,350,328,666,301,365,667,370,297,674,343,322,797,454,333
39049025AKN,710,238,429,726,229,473,501,184,317,504,220,284,507,201,294,743,259,471
39049025ASV,782,427,336,788,533,225,738,464,274,741,532,209,749,500,244,845,599,241
39049025AAU,778,492,250,786,589,153,708,553,155,710,596,114,711,562,134,832,667,153
39049025AFQ,539,438,69,567,505,53,376,318,58,382,335,47,384,319,52,478,404,66
39049025BAW,881,201,651,892,275,577,761,254,507,761,312,449,769,270,488,953,385,554
39049025BHX,960,348,577,972,467,462,963,496,467,967,570,397,974,511,454,1287,711,558
39049025BJV,731,200,503,749,281,432,680,269,411,679,314,365,686,304,370,920,372,529
39049025AZP,549,110,416,549,125,407,439,112,327,436,145,291,446,138,301,869,247,609
39049025ATK,795,155,619,820,195,595,667,189,478,667,237,430,671,217,441,694,217,473
39049025ADG,736,529,144,766,603,95,673,613,60,683,629,54,686,594,62,737,647,75
39049025AXF,591,226,352,586,277,274,550,262,288,552,315,237,555,280,264,622,328,280
39049025AWW,720,327,351,729,411,282,622,366,256,632,407,225,635,374,245,758,482,270
39049025ABI,484,410,45,509,461,35,407,383,24,410,390,20,411,385,25,489,446,39
39049025AHU,533,287,209,558,328,205,344,209,135,347,233,114,346,219,118,632,364,257
39049025BIL,883,405,439,896,468,376,753,404,349,758,459,299,762,415,329,965,555,393
39049025AWL,470,183,257,463,214,201,426,218,208,437,270,167,434,236,183,500,294,196
39049025BHN,387,189,177,393,236,131,315,201,114,317,221,96,319,209,98,453,320,122
39049025AQB,977,483,443,991,557,362,779,481,298,785,529,256,793,486,287,1132,764,353
39049025BAE,755,384,340,776,447,306,596,363,233,601,403,198,603,371,221,853,524,320
39049025AUR,867,370,467,881,467,379,738,385,353,742,464,278,747,404,335,936,541,385
39111056AAE,601,207,356,619,169,420,485,217,268,503,267,236,493,189,283,659,159,491
39047024AAY,393,87,291,393,87,298,315,76,239,315,97,218,315,75,235,447,104,338
39047024AAU,335,66,257,342,70,260,270,61,209,271,81,190,273,67,201,356,60,293
39047024AAE,225,68,142,232,73,146,173,52,121,174,69,105,174,57,114,282,77,201
39017009ADV,385,289,74,399,321,64,254,214,40,267,228,39,261,210,39,389,291,90
39017009ALP,922,271,610,944,342,557,697,302,395,716,326,390,723,296,396,1070,464,589
39017009AKK,1263,322,907,1287,396,829,982,336,646,1006,379,627,1005,339,644,1699,598,1085
39017009AIV,685,215,449,701,287,384,576,256,320,591,285,306,596,259,320,761,355,396
39017009ALU,666,122,524,662,191,445,582,192,390,592,228,364,589,189,384,740,269,462
39017009ACO,414,341,53,435,380,40,231,211,20,244,229,15,244,216,22,356,296,55
39017009ACT,542,315,196,561,361,179,361,249,112,374,274,100,373,253,108,517,320,185
39017009ADH,401,105,266,410,135,258,241,95,146,255,117,138,253,99,144,437,155,273
39049025BHB,522,257,253,530,331,174,435,265,170,434,307,127,441,279,151,675,466,200
39133067ACY,727,238,438,744,259,463,585,261,324,597,284,313,596,244,313,813,293,508
39133067AEA,650,205,409,681,229,421,550,245,305,555,276,279,560,253,292,756,279,468
39049025AJT,481,247,218,498,282,190,545,362,183,552,382,170,550,360,179,808,545,253
39049025BMN,631,327,284,654,369,252,382,257,125,382,274,108,384,260,115,583,398,177
39049025AEX,777,508,225,794,580,188,638,474,164,639,505,134,640,470,149,818,621,187
39049025AZA,488,176,278,512,199,289,338,143,195,344,177,167,345,147,190,540,183,350
39061031AVD,549,195,310,555,253,257,476,268,208,476,283,193,480,252,197,649,350,286
39061031ADD,780,683,62,806,777,17,619,586,33,621,596,25,627,578,39,823,767,49
39061031BLG,547,377,151,559,445,103,423,335,88,424,341,83,426,328,88,589,481,101
39061031ADV,971,339,606,960,515,390,875,471,404,869,503,366,886,466,402,1033,633,382
39049025AIR,602,336,227,610,366,204,476,315,161,475,345,130,476,318,145,632,397,224
39071036ABQ,858,157,659,865,142,696,597,120,477,602,151,451,604,119,467,942,127,808
39173087ADT,748,155,568,757,199,508,621,187,434,622,263,359,630,187,421,777,217,548
39017009AGZ,975,182,735,994,199,756,675,145,530,698,171,527,692,144,520,1065,225,826
39017009ACZ,713,325,351,729,409,297,549,331,218,564,357,207,553,331,210,892,545,328
39017009AIE,653,160,461,684,150,515,430,101,329,448,118,330,445,94,332,759,140,613
39017009AHA,964,156,765,993,201,770,746,174,572,770,192,578,759,170,568,1057,203,837
39017009AJM,893,284,574,898,376,468,709,343,366,729,380,349,731,333,383,964,455,491
39017009AGK,327,87,213,341,108,217,201,80,121,205,89,116,199,74,118,369,85,279
39173087ABC,608,177,399,622,237,317,486,230,256,487,271,216,496,225,248,670,334,322
39173087ADL,873,241,581,883,330,500,716,286,430,723,364,359,732,302,401,965,384,559
39173087ABW,328,58,251,333,75,233,254,71,183,258,90,168,260,65,183,356,77,272
39035018AQF,474,300,135,497,372,89,379,303,76,387,320,67,389,304,78,543,425,115
39113057AID,769,662,87,778,718,47,634,580,54,641,605,36,641,581,52,757,697,54
39113057AHO,863,268,540,871,343,480,687,332,355,695,370,325,698,311,357,940,409,517
39113057ACU,275,239,24,285,271,7,184,174,10,191,186,5,190,177,10,225,216,7
39113057AOX,698,300,366,700,381,269,597,357,240,600,380,220,604,352,234,727,465,248
39113057AKQ,621,243,342,627,307,284,522,284,238,519,321,198,524,285,222,656,369,271
39113057AVW,674,213,418,680,253,385,512,233,279,517,289,228,521,226,267,738,341,382
39113057AVV,683,181,469,706,240,422,470,192,278,474,225,249,480,195,264,719,264,444
39113057ANE,637,192,402,652,254,365,487,209,278,492,257,235,491,207,263,677,288,379
39113057ANB,687,213,434,682,286,351,556,241,315,561,284,277,558,226,308,764,369,385
39149075ABS,584,71,500,583,88,477,453,73,380,452,105,347,451,83,356,631,87,538
39133067AFG,553,220,292,574,249,308,451,232,219,450,254,196,454,225,209,647,284,356
39133067AEB,658,160,457,672,197,455,583,192,391,588,226,362,592,192,380,786,235,542
39133067AFO,474,179,266,497,233,232,396,205,191,401,226,175,402,202,180,543,250,288
39085043ACF,671,227,421,700,291,380,598,297,301,599,322,277,610,274,321,804,381,416
39085043ABA,576,197,345,589,260,294,455,232,223,461,271,190,457,224,220,626,309,314
39157079ADM,475,79,367,485,77,390,361,65,296,367,92,275,359,71,277,538,79,455
39035018AWU,653,442,166,687,511,158,565,459,106,570,460,110,571,441,120,714,550,156
39035018BDW,296,209,63,318,252,56,162,125,37,163,133,30,166,124,34,279,198,77
39035018BDX,460,308,111,490,402,69,400,351,49,402,352,50,404,338,44,556,441,110
39035018AGQ,702,278,357,760,342,364,548,318,230,561,345,216,561,302,227,727,344,371
39035018ALP,402,364,15,427,417,7,281,273,8,286,282,4,285,273,8,343,332,9
39035018CZS,584,152,427,580,255,291,512,228,284,512,241,271,516,208,303,638,336,295
39035018DAB,735,263,459,727,385,319,635,339,296,639,365,274,648,321,310,763,440,322
39035018BQH,539,359,149,561,418,130,423,326,97,436,354,82,437,333,95,555,433,115
39035018BGH,466,316,114,508,378,114,331,240,91,336,263,73,332,233,86,470,310,156
39035018DBU,471,176,286,472,266,191,437,246,191,437,250,187,440,227,205,558,322,232
39035018CPY,852,277,528,883,324,528,735,333,402,748,364,384,750,307,423,945,387,545
39035018DDZ,511,464,29,537,509,19,365,346,19,366,348,18,367,338,23,454,419,29
39035018ATJ,455,418,19,481,468,10,306,295,11,314,306,8,312,300,9,349,331,14
39035018AAA,801,340,418,808,445,327,701,401,300,707,437,270,710,391,308,885,523,358
39035018CCJ,825,353,423,849,431,384,688,385,303,697,421,276,699,377,301,918,461,443
39035018DDT,420,364,36,509,499,8,209,199,10,220,213,7,226,203,14,276,239,30
39035018ACR,596,530,37,628,597,21,430,406,24,436,421,15,429,404,19,591,556,29
39035018CEG,905,322,530,932,448,446,821,430,391,827,481,346,829,421,393,1009,528,472
39035018BUD,621,332,258,634,390,219,450,326,124,462,354,108,464,327,124,621,436,173
39035018BLS,712,586,106,735,659,67,633,571,62,643,593,50,643,575,58,727,651,73
39035018BAO,269,192,53,318,254,52,183,143,40,187,156,31,189,143,39,272,189,81
39035018BRM,737,269,450,745,382,336,704,387,317,705,410,295,714,379,322,854,482,365
39113057AOV,922,343,553,916,483,363,844,472,372,857,506,351,860,460,383,1050,645,384
39113057ADB,318,285,24,330,321,7,215,208,7,221,216,5,219,207,7,264,254,8
39113057AVR,705,120,544,704,157,523,542,131,411,556,167,389,549,136,397,763,166,587
39113057AFO,590,494,74,607,545,43,443,402,41,456,423,33,453,402,41,541,492,44
39113057AFH,545,477,52,573,548,11,411,396,15,421,410,11,418,396,15,536,504,26
39113057AXA,933,418,477,940,516,382,774,442,332,782,483,299,785,445,319,952,574,366
39113057ACT,392,288,84,428,365,40,300,263,37,305,275,30,305,259,37,384,334,42
39113057ATF,577,95,461,582,136,426,461,108,353,470,146,324,470,108,354,612,136,471
39043022ADY,730,427,265,738,479,242,530,341,189,535,364,171,530,329,179,732,459,262
39043022ACS,667,225,411,679,274,374,544,265,279,558,307,251,553,276,260,740,271,452
39043022ADW,459,172,265,466,180,265,392,187,205,399,201,198,401,192,197,552,190,357
39043022AAJ,727,202,500,732,251,443,615,246,369,616,292,324,618,261,343,778,309,460
39055028ABC,631,151,446,635,203,407,522,177,345,529,214,315,527,166,339,678,229,445
39055028AAW,810,192,582,828,240,540,698,253,445,716,287,429,707,243,443,875,290,569
39055028ACC,425,134,277,427,149,266,363,149,214,368,164,204,371,146,215,491,185,304
39055028ACX,534,151,347,540,175,339,437,172,265,440,208,232,439,167,253,638,227,396
39173087ADU,549,189,302,567,243,283,399,192,207,406,230,176,407,187,192,616,256,351
39173087ADE,717,253,422,729,292,390,543,267,276,548,316,232,550,266,267,796,343,432
39017009AGH,706,131,551,728,172,532,552,162,390,571,178,393,571,155,396,784,192,582
39017009ABY,535,170,339,552,192,332,414,188,226,420,199,221,423,186,225,581,247,321
39017009AFJ,754,123,607,768,145,600,555,135,420,576,158,418,576,137,417,827,206,608
39017009ACN,317,245,59,330,272,44,192,164,28,207,178,29,205,167,34,379,254,118
39035018BRX,664,287,356,701,368,312,611,373,238,615,394,221,623,367,242,782,453,322
39035018AWQ,572,445,95,600,508,81,484,424,60,487,434,53,489,410,62,606,521,82
39035018ARK,375,343,18,403,389,6,313,306,7,319,313,6,320,306,6,363,356,4
39035018BCO,499,204,246,506,252,230,421,249,172,423,266,157,424,237,179,552,295,253
39035018BQZ,584,422,135,606,499,89,474,402,72,476,410,66,479,394,75,657,547,106
39035018BHV,566,316,195,601,404,169,425,301,124,428,317,111,432,288,128,589,370,213
39157079ADA,993,197,755,1007,230,749,780,201,579,800,255,545,795,209,564,1051,232,800
39113057ANA,664,230,412,672,320,307,559,280,279,565,315,250,570,279,273,730,390,329
39113057APB,985,300,658,980,472,468,886,417,469,891,467,424,891,406,478,1087,602,476
39071036AAZ,456,101,331,461,98,351,310,90,220,312,94,218,316,81,227,492,101,387
39053027AAG,615,170,415,629,109,492,429,111,318,435,161,274,436,116,306,629,115,507
39053027AAF,322,88,219,333,58,260,276,74,202,280,100,180,284,77,198,429,102,325
39053027AAR,729,206,491,745,143,576,574,129,445,573,186,387,584,142,426,809,153,646
39157079ACI,780,171,561,800,163,598,585,173,412,592,205,387,597,162,417,807,184,615
39157079AAX,516,178,309,524,212,274,382,186,196,387,213,174,387,184,192,538,237,296
39157079ACS,543,171,345,549,177,344,415,160,255,424,198,226,414,157,243,545,181,357
39157079ADE,482,128,315,493,146,300,365,153,212,375,184,191,373,152,200,543,169,362
39157079AEM,453,139,293,462,135,294,384,159,225,396,182,214,387,151,219,508,153,349
39157079AEK,438,135,278,447,127,289,334,133,201,337,158,179,332,131,194,448,114,328
39157079AAJ,435,163,244,443,171,243,350,183,167,350,191,159,347,176,158,467,188,270
39157079ABG,241,87,137,240,98,121,153,86,67,156,95,61,155,83,64,244,104,134
39157079ADI,464,162,272,470,156,290,347,154,193,351,174,177,349,143,188,502,150,342
39071036AAQ,582,103,448,592,110,462,422,85,337,424,94,330,425,84,324,593,76,514
39085043ADK,768,307,402,805,357,409,619,335,284,627,375,252,631,317,288,855,427,416
39085043AIV,680,240,403,717,301,387,235,135,100,234,145,89,238,132,100,370,196,170
39085043ACX,307,109,181,320,134,175,545,269,276,552,295,257,552,261,283,948,440,498
39085043ABV,870,299,544,895,391,481,761,365,396,767,419,348,772,344,399,1002,447,550
39111056AAA,303,104,182,317,84,224,244,91,153,248,103,145,238,70,164,331,65,262
39111056AAM,222,90,120,219,50,162,161,70,91,163,91,72,157,64,88,239,66,172
39111056AAC,139,34,100,141,16,117,118,32,86,123,45,78,120,26,84,151,24,122
39111056ABB,222,77,129,220,56,156,167,68,99,170,83,87,165,60,104,226,52,171
39111056AAB,148,41,96,148,22,123,106,37,69,113,49,64,112,24,85,162,20,141
39173087AEH,873,287,556,880,363,471,643,298,345,652,352,300,655,300,343,1132,501,609
39085043AEQ,641,155,455,654,217,413,559,232,327,572,257,315,571,216,344,719,261,452
39149075ABF,808,70,715,814,78,718,662,79,583,661,131,530,661,87,557,893,94,787
39043022AAE,653,231,378,674,285,353,539,262,277,546,292,254,545,246,265,738,326,399
39043022ACG,598,179,382,607,214,369,550,242,308,562,279,283,558,239,289,641,220,412
39055028AAQ,357,90,242,357,109,227,297,108,189,299,128,171,302,95,196,412,134,272
39055028ACZ,566,159,391,573,189,368,481,190,291,481,220,261,479,177,290,636,209,420
39043022ADT,781,255,478,781,301,446,663,290,373,663,344,319,667,281,357,923,364,542
39055028ACS,705,208,468,708,265,409,616,267,349,620,294,326,621,260,343,766,305,446
39055028ABR,676,137,508,676,161,483,548,153,395,553,186,367,556,147,386,745,185,553
39055028ACH,441,134,256,447,142,281,360,151,209,361,171,190,363,146,193,497,145,347
39055028ACJ,536,115,388,549,146,378,457,135,322,464,170,294,466,139,311,597,177,415
39055028AAE,657,162,471,670,208,435,560,195,365,561,223,338,564,187,366,785,275,505
39017009AJK,685,186,463,696,240,416,512,200,312,522,215,307,517,194,301,841,327,497
39017009AIF,331,77,231,334,92,222,236,71,165,244,83,161,241,70,164,372,97,273
39017009ABJ,696,248,420,716,303,385,532,235,297,554,264,290,543,230,304,732,338,389
39017009ACU,585,137,409,618,190,388,413,161,252,419,186,233,417,137,260,675,261,402
39173087ACT,540,176,322,552,211,297,450,209,241,457,256,201,461,201,229,564,213,339
39173087ACU,907,246,597,915,292,560,706,278,428,710,346,364,723,248,432,1012,289,710
39173087ACW,363,106,234,369,127,224,279,125,154,280,157,123,280,114,151,372,116,251
39159080ABI,475,76,378,479,79,381,385,88,297,385,101,284,392,95,273,546,97,436
39159080AAY,668,145,491,672,191,456,543,154,389,553,195,358,552,163,373,748,212,521
39159080ABF,476,65,398,483,91,374,448,97,351,452,122,330,453,101,343,611,158,446
39159080AAX,499,98,382,508,114,366,442,113,329,442,137,305,446,116,320,567,153,403
39159080ABV,838,212,598,842,277,514,850,306,544,846,346,500,860,319,515,869,326,526
39159080ACB,329,85,232,331,109,203,318,115,203,315,130,185,320,118,193,738,283,444
39173087AAV,503,210,269,512,258,220,419,245,174,423,266,157,427,244,169,532,282,243
39017009ADT,302,90,192,309,101,196,201,83,118,205,87,118,205,79,117,361,119,230
39017009AHQ,674,314,337,671,357,290,608,345,263,624,371,253,625,344,270,751,408,338
39017009AFB,622,295,285,628,374,215,443,303,140,451,320,131,449,296,141,631,377,240
39017009AEZ,390,172,202,416,228,165,211,146,65,214,150,64,210,139,63,261,172,89
39017009AFE,491,200,266,534,276,226,219,143,76,221,155,66,223,138,73,142,91,48
39017009AGD,459,82,363,474,96,364,372,93,279,378,114,264,375,93,273,493,104,380
39017009AHO,620,179,420,625,232,376,521,222,299,534,236,298,535,219,300,675,265,405
39017009AEV,804,443,352,799,540,222,719,491,228,738,549,189,740,515,217,835,590,230
39017009ADN,529,154,339,539,201,309,345,156,189,357,170,187,354,160,182,558,216,326
39095048ADH,326,244,54,337,275,46,181,147,34,182,156,26,183,144,33,265,195,66
39095048AKQ,429,389,25,447,435,10,310,304,6,312,309,3,316,302,9,332,328,2
39095048AEW,370,275,75,389,318,58,245,198,47,247,207,40,249,203,38,333,263,64
39095048ANT,395,214,149,395,244,126,232,160,72,232,174,58,234,169,51,349,195,148
39095048AIY,520,262,232,553,302,218,377,233,144,378,250,128,386,226,138,551,294,251
39027014ABK,468,69,385,469,75,381,388,74,314,390,101,289,390,66,302,532,82,445
39167084ABY,149,35,107,161,19,140,116,23,93,120,36,84,118,21,97,171,20,150
39167084ABU,653,274,342,678,200,454,510,205,305,508,239,269,520,190,312,719,190,513
39095048ATO,865,322,511,892,374,474,766,369,397,766,399,367,774,373,386,961,407,538
39095048ATM,800,300,443,819,365,411,657,358,299,667,400,267,676,349,290,895,411,466
39095048AMN,370,163,199,375,185,170,317,167,150,323,189,134,326,176,138,413,219,185
39095048AQM,584,260,290,594,285,279,452,260,192,459,293,166,466,248,196,607,290,307
39095048AOW,559,238,286,575,291,251,455,254,201,461,294,167,468,252,195,604,325,266
39095048ARR,752,272,450,785,295,442,598,290,308,609,329,280,615,266,316,852,336,503
39095048ARS,798,324,428,816,315,455,631,311,320,639,354,285,635,309,309,884,324,550
39027014ABC,572,88,470,571,107,443,472,117,355,463,139,324,466,103,352,607,132,461
39027014AAQ,500,77,405,506,89,403,466,101,365,474,136,338,475,88,363,570,124,436
39095048AVT,1019,422,577,1022,530,453,863,501,362,870,556,314,876,506,356,1055,632,413
39095048APB,673,319,319,692,394,250,537,344,193,547,391,156,550,349,181,733,459,265
39095048ASR,809,312,470,845,363,429,760,339,421,764,403,361,771,335,403,999,471,509
39095048AOL,615,369,214,639,419,194,403,278,125,401,305,96,406,278,114,521,310,200
39167084ACG,607,180,413,617,167,422,497,160,337,506,200,306,511,158,344,659,226,424
39167084ABX,221,89,116,226,58,157,186,63,123,190,78,112,190,64,122,227,54,169
39013007AAE,380,149,204,384,155,202,287,143,144,294,182,112,293,135,145,398,161,233
39013007ACM,594,100,471,597,111,470,550,157,393,547,187,360,558,131,413,656,140,508
39167084ABV,142,48,92,151,23,127,97,27,70,100,32,68,101,22,76,151,16,132
39167084ACR,878,255,574,884,190,648,666,178,488,668,228,440,675,179,476,983,221,749
39061031AEK,694,264,402,683,405,234,561,346,215,560,376,184,569,340,213,716,462,242
39061031ACA,968,692,246,995,818,157,805,664,141,802,678,124,808,653,146,1037,852,163
39061031AMS,404,333,58,419,384,30,345,316,29,344,316,28,344,306,28,404,381,19
39061031BCK,345,141,193,349,158,180,274,153,121,273,157,116,278,147,123,378,191,182
39061031BDW,614,92,482,629,112,487,612,145,467,608,167,441,618,134,466,1045,227,801
39061031BEN,1000,162,790,1027,225,743,836,235,601,840,277,563,844,211,597,1062,303,736
39061031BOP,893,819,54,938,917,11,701,677,24,698,688,10,702,679,17,846,826,19
39061031AIF,675,563,87,706,645,45,614,580,34,610,591,19,620,583,27,744,697,43
39061031AAV,775,295,428,787,365,369,592,324,268,589,344,245,596,313,254,855,468,365
39061031BKL,849,196,624,845,290,507,691,272,419,687,294,393,693,255,419,923,379,528
39061031ATC,995,297,671,985,460,484,890,408,482,895,433,462,900,400,474,1042,553,471
39061031BHD,593,195,378,601,240,334,501,237,264,506,250,256,509,224,271,635,311,312
39061031BOE,930,199,714,902,383,474,866,362,504,863,408,455,875,353,505,1018,554,454
39061031ALS,322,230,71,342,280,53,226,177,49,224,182,42,227,176,43,329,244,76
39013007ACW,799,170,602,800,149,631,634,174,460,642,219,423,643,166,464,865,184,673
39013007ACQ,741,164,549,751,131,599,601,165,436,609,208,401,611,153,444,812,129,672
39061031BAU,953,128,783,957,174,741,833,178,655,835,197,638,842,169,643,1033,232,788
39061031AXD,804,201,582,812,312,460,710,275,435,720,326,394,721,276,428,864,379,462
39061031BHA,688,91,572,688,143,517,629,151,478,630,176,454,643,141,489,725,195,521
39095048ALQ,509,309,164,514,334,141,334,233,101,335,254,81,338,226,88,427,279,138
39095048AHY,394,232,136,403,259,121,303,216,87,304,232,72,306,214,83,408,275,125
39095048AER,356,280,53,367,314,40,208,179,29,213,190,23,216,181,27,298,239,50
39037019ABX,640,100,507,649,100,518,541,129,412,542,163,379,548,121,408,702,120,572
39037019ABY,718,84,620,725,100,598,615,94,521,632,159,473,638,93,526,816,123,682
39037019AAS,636,66,543,653,76,551,509,67,442,515,109,406,518,69,427,706,72,630
39081041ADK,335,109,194,345,87,246,222,81,141,226,97,129,224,73,147,346,77,262
39037019ABA,454,48,387,460,56,384,332,63,269,328,93,235,330,59,259,479,79,396
39013007ACS,338,68,256,343,65,264,259,80,179,260,97,163,260,60,198,383,66,316
39013007ADL,58,10,38,54,11,42,61,17,44,62,25,37,62,14,48,73,20,52
39081041AEH,597,184,373,617,142,441,432,172,260,445,210,235,442,146,288,612,144,459
39081041ACH,253,75,159,257,60,194,190,64,126,192,77,115,194,51,131,249,51,194
39081041AEE,592,141,423,613,117,473,497,145,352,493,181,312,500,121,370,639,110,524
39061031BMX,798,198,553,801,267,486,616,250,366,615,270,345,623,231,363,963,368,580
39061031AYS,711,281,417,714,430,253,616,347,269,611,380,231,622,345,269,767,486,269
39061031AYE,1075,435,610,1079,662,345,1010,624,386,1006,645,361,1016,589,391,1207,821,362
39081041ACZ,138,65,64,137,57,72,105,53,52,108,59,49,109,40,60,138,48,86
39081041ABI,218,69,140,222,51,163,180,59,121,185,71,114,185,55,125,216,48,165
39081041ABG,498,198,281,507,175,313,334,163,171,338,176,162,341,130,198,522,163,354
39081041ABE,576,192,348,595,183,371,418,182,236,423,202,221,423,152,253,615,195,406
39077039AAN,686,193,443,710,241,420,543,220,323,544,268,276,549,215,311,793,262,513
39077039ACO,654,185,423,659,198,438,489,185,304,496,219,277,500,177,310,739,196,532
39077039ABK,772,169,535,793,205,547,608,203,405,610,231,379,610,185,407,836,194,630
39077039ABX,446,93,313,456,116,326,361,108,253,358,145,213,359,105,235,498,131,360
39115058AAC,155,40,109,163,43,113,117,40,77,121,56,65,121,42,76,163,34,127
39115058AAI,792,184,575,802,196,577,591,178,413,605,235,370,613,186,404,817,181,630
39127064ABI,502,114,352,505,109,376,430,108,322,434,147,287,438,120,301,574,112,456
39083042ABT,374,77,274,375,92,264,258,89,169,260,110,150,257,88,157,405,101,296
39083042AAR,341,57,260,342,46,278,235,44,191,239,58,181,238,53,179,374,49,322
39059030ABK,460,114,323,474,125,331,351,128,223,347,143,204,351,120,225,535,130,400
39059030ABO,606,169,397,623,187,405,435,162,273,441,198,243,442,160,265,657,176,472
39059030ABC,702,133,549,720,179,523,572,164,408,570,209,361,578,165,396,764,186,560
39059030AAG,322,97,205,332,122,180,190,79,111,189,99,90,189,77,101,306,96,201
39081041ADC,253,97,138,262,92,162,207,107,100,212,123,89,211,85,117,271,91,175
39081041AEA,276,114,138,285,105,168,225,119,106,226,126,100,225,101,116,303,116,181
39115058AAF,706,240,432,719,218,480,547,197,350,568,266,302,577,204,360,769,233,523
39115058AAA,368,87,261,369,96,256,302,101,201,308,141,167,305,115,182,386,94,291
39167084ACP,818,242,547,847,183,638,638,165,473,657,231,426,661,174,475,903,190,698
39167084ACU,843,230,578,856,198,607,680,192,488,686,260,426,700,192,475,908,225,666
39129065ABL,718,171,529,718,183,499,656,198,458,658,256,402,674,211,436,831,200,624
39129065ACA,694,142,528,689,149,522,560,142,418,560,182,378,565,160,392,820,182,634
39129065ABN,581,143,412,598,145,434,522,132,390,520,190,330,536,151,368,666,141,522
39083042ABR,980,210,721,982,246,684,816,217,599,829,276,553,818,221,573,1115,311,788
39013007ABF,683,127,528,693,112,564,563,148,415,573,183,390,574,118,435,807,133,663
39049025ACA,237,163,61,246,184,50,154,127,27,156,128,28,154,122,21,274,212,55
39049025ABU,910,572,293,935,708,184,833,652,181,832,703,129,841,663,155,588,495,82
39049025BNK,94,60,31,97,74,18,86,68,18,87,73,14,87,69,16,654,509,139
39049025AGS,600,320,258,620,383,202,548,364,184,554,406,148,557,373,165,660,432,217
39049025AFD,509,285,183,523,337,159,426,292,134,428,320,108,430,286,124,567,385,173
39049025AFA,576,359,181,601,420,146,411,296,115,416,320,96,418,294,111,652,453,184
39049025AYY,532,191,315,545,227,283,438,211,227,443,251,192,444,223,206,587,274,305
39049025BIT,706,437,241,724,498,197,576,439,137,578,444,134,581,434,133,955,695,245
39049025AAA,714,418,277,724,512,181,609,430,179,616,467,149,627,450,157,753,581,165
39049025AOX,698,273,391,721,318,380,524,244,280,529,278,251,530,257,260,741,359,370
39049025BMP,467,358,85,471,394,68,266,217,49,269,232,37,269,227,37,395,317,76
39049025AJG,605,474,108,625,524,89,584,502,82,587,518,69,589,507,71,716,601,102
39167084ABF,802,256,516,818,191,593,589,158,431,601,210,391,596,158,420,826,182,628
39081041AAR,609,192,376,618,203,399,471,207,264,473,231,242,473,179,275,631,213,405
39081041ACT,237,123,102,241,118,118,185,112,73,187,126,61,187,103,79,263,105,157
39083042ABZ,448,71,351,445,77,342,348,65,283,347,86,261,349,65,268,460,78,375
39129065AAU,438,82,327,434,87,330,335,69,266,334,96,238,339,83,245,502,91,405
39063032ACD,519,74,419,522,91,418,379,88,291,384,119,265,387,87,288,575,109,457
39063032ACC,731,108,594,746,155,556,567,130,437,581,192,389,585,124,449,853,201,639
39103052ABG,819,297,455,851,387,419,646,325,321,671,379,292,676,311,337,1001,459,528
39103052ADD,667,155,477,668,196,453,502,180,322,510,217,293,520,168,336,742,215,522
39103052AFJ,781,201,540,799,258,508,646,235,411,665,270,395,671,240,409,914,335,569
39103052ADJ,882,197,640,901,244,612,713,225,488,740,279,461,740,237,486,1031,285,727
39069035ABC,547,100,424,550,112,403,419,109,310,429,154,275,434,113,307,557,116,431
39081041ADF,296,151,124,305,122,166,217,113,104,221,123,98,224,106,108,313,128,179
39063032AAQ,731,168,542,745,240,453,595,194,401,598,236,362,604,193,397,881,314,547
39109055AAW,646,148,465,651,201,415,511,170,341,521,219,302,519,160,336,701,246,438
39109055ACW,574,72,481,569,106,441,458,92,366,463,114,349,464,96,355,568,110,450
39109055ABJ,672,179,449,684,263,377,479,197,282,489,234,255,491,186,278,721,275,432
39099050ANE,429,172,233,433,169,250,335,163,172,340,183,157,339,174,161,442,168,269
39099050ALC,626,267,330,630,317,289,539,287,252,545,334,211,550,301,240,681,333,342
39099050AHH,429,195,214,437,203,215,307,157,150,309,175,134,314,171,127,472,203,258
39099050AJL,365,164,179,369,200,160,308,167,141,319,196,123,316,181,128,431,209,215
39099050AOZ,386,114,263,390,146,222,333,127,206,327,148,179,339,128,204,428,172,250
39099050ANV,686,219,422,715,233,449,557,214,343,560,255,305,560,235,306,710,228,470
39093047AFU,993,419,501,1026,458,512,808,458,350,841,516,325,853,481,353,1209,575,619
39093047ACM,664,255,357,674,318,315,564,320,244,590,382,208,591,329,238,725,418,299
39081041ACL,347,102,225,348,83,248,275,96,179,282,122,160,280,83,185,338,85,249
39021011ABH,804,165,599,810,212,548,725,215,510,729,279,450,735,223,466,892,209,656
39021011ABU,657,120,497,665,160,478,532,131,401,540,194,346,539,146,373,702,165,523
39121061ABA,266,65,193,269,59,198,214,71,143,221,82,139,216,72,135,311,79,231
39121061AAI,221,46,161,242,47,181,177,60,117,188,69,119,186,57,117,271,50,218
39107054ABU,495,21,470,489,25,452,396,26,370,400,49,351,405,25,375,517,28,486
39165083AAR,576,156,377,593,175,368,447,155,292,462,185,277,460,159,283,659,229,413
39165083AEO,613,88,493,625,117,487,498,118,380,512,136,376,502,111,379,694,162,524
39165083ADQ,623,85,512,645,126,498,574,137,437,595,153,442,588,122,446,727,143,571
39165083ABG,894,230,629,886,323,518,728,266,462,756,306,450,758,282,463,938,424,501
39165083AAW,503,114,367,516,173,323,394,151,243,405,178,227,403,146,239,546,218,312
39155078ACJ,533,312,190,553,376,156,385,282,103,387,307,80,388,279,98,552,368,181
39155078ABR,600,312,246,613,324,263,423,275,148,432,293,139,426,268,143,588,283,295
39155078AGV,756,263,473,768,306,441,653,284,369,664,333,331,656,287,363,843,337,503
39147074ABM,719,118,569,726,121,553,538,102,436,551,179,372,552,104,422,811,145,656
39077039ACH,492,102,364,510,109,378,364,125,239,370,151,219,376,108,253,553,104,444
39093047AAR,791,281,452,799,356,396,651,355,296,684,399,285,688,346,317,885,431,443
39109055ACC,678,107,551,695,142,519,580,130,450,587,185,402,595,128,457,729,171,549
39099050APN,695,206,463,724,273,430,583,220,363,593,292,301,599,258,333,811,328,474
39093047ADC,701,365,288,721,392,285,529,338,191,555,391,164,556,341,196,812,457,333
39063032ACK,615,139,449,621,171,423,427,124,303,438,174,264,443,120,308,685,160,511
39063032ABS,695,116,550,703,127,538,569,143,426,569,180,389,580,134,430,782,165,606
39103052ACY,712,189,491,737,265,449,587,237,350,604,277,327,607,237,362,835,294,532
39103052ACL,813,233,544,810,289,483,676,279,397,695,320,375,693,282,391,897,355,527
39063032ABC,608,144,433,611,182,391,455,158,297,457,181,276,460,145,306,707,233,465
39103052AFL,992,228,713,1004,292,671,833,289,544,846,326,520,844,274,546,1114,367,729
39103052ACM,826,259,544,835,346,452,686,291,395,702,319,383,700,270,419,921,394,517
39077039ACG,433,76,336,449,92,338,329,85,244,330,105,225,330,73,244,501,91,400
39059030ACF,171,50,110,176,52,117,120,43,77,124,51,73,123,36,80,187,39,147
39049025BBU,489,265,197,510,303,180,399,241,158,400,257,143,403,239,151,526,316,200
39049025ADV,755,558,124,769,644,65,707,630,77,710,655,55,712,624,64,777,681,78
39049025ATH,655,187,454,671,234,404,638,277,361,639,324,315,644,311,324,860,371,477
39049025ATV,767,288,469,774,405,318,691,343,348,698,412,286,707,388,307,844,511,324
39049025AZE,666,165,463,686,204,458,543,176,367,544,219,325,540,178,348,746,189,552
39059030ACG,486,90,378,491,91,379,373,94,279,377,127,250,382,95,278,520,80,437
39059030AAN,511,146,342,522,165,333,400,161,239,394,196,198,403,160,231,619,209,402
39121061AAB,553,109,424,583,109,458,464,132,332,474,173,301,473,129,334,613,108,502
39121061AAT,448,98,331,464,121,322,379,127,252,390,168,222,376,129,234,478,120,354
39103052AFP,756,161,549,770,199,526,592,195,397,603,223,380,606,197,390,959,259,687
39103052AEH,670,188,448,675,203,447,538,201,337,550,228,322,555,183,350,783,234,538
39063032ACH,992,164,801,1011,249,714,842,229,613,858,304,554,874,237,611,1177,351,813
39077039ACE,494,90,370,496,91,378,389,130,259,390,170,220,397,121,263,584,120,457
39097049AAN,958,256,650,969,321,617,773,267,506,777,345,432,783,272,488,1060,340,694
39049025BKX,614,258,336,625,331,257,494,305,189,500,327,173,501,296,192,671,406,257
39167084ACY,418,168,234,442,130,287,314,106,208,312,126,186,322,96,214,444,118,320
39077039ABC,280,91,171,287,97,167,168,74,94,171,89,82,171,75,89,306,106,194
39077039ABL,489,82,379,497,100,367,395,89,306,391,113,278,403,95,295,572,105,459
39077039AAA,609,177,384,624,211,371,450,211,239,450,228,222,453,197,229,733,235,484
39099050ANK,626,144,453,642,159,458,521,166,355,533,204,329,540,165,358,682,154,525
39035018CAR,730,643,60,768,703,50,567,529,38,573,540,33,578,528,36,736,672,60
39035018CQQ,906,676,216,910,803,83,837,724,113,842,748,94,847,723,113,980,882,94
39035018AIW,675,626,26,698,686,6,501,486,15,504,496,8,510,485,19,628,613,11
39035018BNJ,387,352,17,411,394,10,295,278,17,299,292,7,302,278,13,333,316,12
39035018BMI,898,810,66,914,860,44,756,709,47,760,722,38,766,700,54,871,817,51
39035018BQD,489,348,114,511,391,110,405,330,75,408,344,64,413,317,77,534,425,106
39035018AKH,430,404,13,456,449,4,329,317,12,332,325,7,331,320,5,394,383,10
39035018BHY,325,264,41,358,331,22,187,167,20,191,175,16,192,168,16,199,157,39
39035018AMC,303,268,21,336,311,19,214,197,17,218,200,18,218,189,20,247,218,29
39035018BZB,785,434,330,799,566,219,737,552,185,739,563,176,740,516,216,874,628,241
39135068ABG,570,82,472,576,117,441,431,102,329,432,135,297,433,90,325,624,118,499
39135068AAT,525,94,406,534,112,401,395,104,291,399,118,281,403,102,278,538,124,409
39135068AAR,381,32,330,389,51,321,274,43,231,277,66,211,276,33,237,395,47,346
39103052AAI,613,204,367,629,234,358,481,227,254,497,257,240,497,218,257,705,269,427
39009005ABI,89,49,34,88,47,29,79,49,30,82,62,20,83,50,27,94,52,42
39009005AAN,551,391,132,581,433,117,442,351,91,462,383,79,463,355,82,489,401,76
39009005ACR,614,380,205,689,437,211,270,218,52,280,231,49,286,225,48,13,7,6
39121061AAF,277,47,219,284,44,233,197,52,145,206,67,139,206,50,152,301,49,250
39059030ACP,526,102,411,531,117,404,406,100,306,405,127,278,407,91,305,609,135,465
39059030ACA,601,138,430,614,137,454,471,128,343,473,160,313,476,126,334,657,122,525
39035018APN,353,324,15,384,376,7,269,253,16,271,262,9,274,251,16,372,351,16
39035018AMS,368,341,14,405,394,6,284,272,12,286,279,7,289,275,9,331,316,9
39035018BHM,489,308,136,517,387,119,388,312,76,390,320,70,395,287,94,534,366,160
39035018CZN,896,289,576,913,406,472,798,376,422,803,403,400,815,349,447,1013,490,516
39035018CZC,828,314,475,847,424,394,757,410,347,760,439,321,759,393,350,945,529,410
39035018BIG,693,306,360,726,413,288,638,419,219,645,441,204,648,404,237,841,518,317
39035018BAJ,450,287,121,506,381,111,287,205,82,288,219,69,294,210,70,435,274,157
39035018CSI,799,471,297,823,590,212,667,476,191,676,503,173,681,464,202,846,604,235
39035018COW,784,316,440,792,447,313,724,442,282,721,465,256,732,418,300,859,539,311
39035018AOT,496,453,18,532,514,8,396,386,10,400,392,8,404,384,12,495,468,20
39035018CFQ,672,166,488,673,216,433,551,201,350,567,226,341,570,195,368,772,285,479
39035018BSP,702,600,71,738,673,50,554,512,42,555,526,29,552,501,42,692,636,51
39035018BZS,730,536,164,758,609,134,612,512,100,621,534,87,620,506,102,797,664,128
39053027AAO,333,86,230,342,77,258,273,84,189,273,101,172,278,88,184,409,114,291
39053027ABB,517,139,347,531,112,388,410,124,286,414,154,260,414,136,268,572,142,423
39081041AEB,465,117,323,476,93,357,383,133,250,390,153,237,389,117,263,496,113,382
39081041ADH,272,73,178,275,55,206,204,65,139,205,78,127,207,41,153,248,39,204
39081041AAU,562,174,359,565,169,375,396,169,227,408,193,215,404,155,233,593,175,404
39001001AAW,766,160,579,772,155,583,559,167,392,563,191,372,576,161,401,839,150,684
39035018CDT,920,349,505,943,466,436,792,433,359,805,481,324,815,431,362,1031,570,448
39035018BLK,633,447,161,650,493,133,465,368,97,467,358,109,471,341,121,629,442,179
39035018CYN,782,274,469,811,393,381,614,336,278,625,361,264,622,323,292,837,450,381
39035018CYY,535,177,342,538,247,275,512,258,254,515,271,244,518,241,267,674,359,310
39035018CYQ,875,310,533,891,433,423,773,411,362,773,438,335,781,387,381,1061,585,471
39035018CVX,966,333,597,988,422,528,836,423,413,859,466,393,854,404,434,1116,514,598
39035018CIT,640,246,336,681,310,329,554,320,234,566,358,208,572,298,246,761,335,411
39035018AKZ,423,365,31,466,439,20,270,252,18,277,262,15,278,251,19,314,282,28
39035018AJX,343,312,14,367,360,3,241,230,11,240,234,6,244,232,9,308,300,4
39035018ACJ,830,481,294,861,546,281,681,477,204,680,507,173,688,470,201,873,607,254
39035018ALJ,387,350,16,418,416,1,273,269,4,277,272,5,278,264,9,328,314,13
39035018CHU,830,339,441,875,408,418,685,387,298,698,439,259,703,373,305,891,429,446
39035018AJP,387,351,19,425,419,0,284,280,4,289,287,2,291,276,8,350,339,6
39035018CGN,412,157,230,426,209,190,340,191,149,346,207,139,343,181,149,474,247,221
39035018CVW,953,301,594,976,407,533,850,399,451,867,444,423,870,390,460,1240,548,683
39035018ABY,470,288,167,482,322,147,444,329,115,443,339,104,448,322,116,547,380,160
39035018CTI,670,574,77,676,611,60,592,546,46,598,562,36,600,538,53,712,641,63
39035018BMH,826,698,86,842,773,49,657,607,50,669,629,40,671,610,58,786,728,55
39035018BKI,895,605,259,892,726,141,846,718,128,846,728,118,848,702,137,942,798,140
39045023ACM,598,131,430,609,157,430,478,140,338,484,185,299,490,140,331,653,181,467
39045023ACL,578,136,419,582,161,397,485,151,334,493,189,304,495,152,335,641,166,471
39045023AAV,460,146,279,455,160,259,298,123,175,301,143,158,303,119,170,481,182,289
39045023ADI,576,151,381,588,161,396,463,164,299,473,204,269,477,158,299,692,197,487
39045023ACW,973,220,709,977,274,660,792,234,558,805,331,474,817,261,522,1128,325,788
39045023ACI,557,142,394,560,162,378,397,144,253,403,174,229,407,138,259,581,175,395
39167084ADC,752,222,502,777,186,549,597,161,436,609,227,382,614,162,440,809,210,585
39075038AAO,743,101,607,754,122,598,584,120,464,581,143,438,588,115,453,855,136,706
39075038AAF,850,194,602,866,228,578,656,206,450,657,263,394,659,207,431,972,256,694
39033017AAA,424,111,261,430,107,298,267,93,174,269,111,158,274,87,174,484,116,362
39033017AAE,640,178,413,656,192,418,431,176,255,444,210,234,442,175,248,686,188,480
39033017AAJ,462,118,323,474,149,296,375,131,244,386,171,215,390,139,247,514,156,353
39075038AAL,570,97,439,576,86,453,448,110,338,451,124,327,456,95,350,601,89,502
39045023AAR,886,216,642,879,262,593,763,224,539,763,306,457,773,244,515,887,301,571
39045023ADE,418,84,314,427,89,322,338,79,259,338,112,226,343,82,248,487,98,383
39045023AAL,667,193,452,656,234,384,525,191,334,531,242,289,530,183,331,718,270,437
39045023AAM,493,169,301,496,177,292,374,152,222,389,205,184,390,158,214,554,240,306
39091046AAA,555,112,414,548,167,348,362,117,245,368,150,218,368,118,231,562,175,376
39135068AAX,571,68,476,576,117,436,440,96,344,442,134,308,444,93,335,615,117,493
39135068AAS,474,78,369,477,74,389,339,71,268,347,79,268,345,54,269,508,69,435
39045023AEY,551,170,363,551,184,337,439,188,251,445,202,243,451,178,253,619,236,374
39045023ABR,589,160,405,597,168,400,446,132,314,469,183,286,475,152,304,635,166,455
39035018CPM,795,259,493,813,335,445,676,307,369,687,349,338,693,294,367,872,375,474
39035018CPT,791,278,470,830,336,451,718,365,353,724,387,337,731,331,380,908,410,486
39035018APD,451,358,66,473,429,28,323,288,35,329,301,28,326,284,38,414,370,39
39035018CBR,567,270,265,615,349,240,493,301,192,504,324,180,510,293,196,703,401,295
39035018DDR,295,210,68,327,255,54,206,171,35,207,176,31,208,169,31,301,238,59
39035018BQK,637,396,209,656,456,184,557,411,146,555,440,115,567,396,155,716,508,199
39035018AAH,778,333,423,777,448,309,714,410,304,717,444,273,722,404,308,908,535,369
39035018ACM,928,561,297,967,652,274,762,554,208,765,579,186,773,542,215,921,656,252
39035018BGL,411,268,111,452,332,108,277,210,67,283,217,66,283,200,71,425,274,147
39035018BOS,645,343,269,646,416,202,582,399,183,589,432,157,597,402,177,726,494,223
39035018CID,648,234,354,680,314,336,553,309,244,556,335,221,562,302,245,754,355,384
39035018BQC,568,481,58,588,517,60,403,360,43,405,369,36,408,359,45,517,444,65
39035018BGG,520,313,163,550,397,136,434,324,110,436,333,103,436,311,119,580,370,205
39035018BGI,554,356,165,602,426,157,385,285,100,392,299,93,394,282,97,583,396,178
39035018COF,817,232,568,786,365,385,711,356,355,706,385,321,717,329,376,895,493,392
39035018CSK,963,367,568,955,506,420,897,518,379,915,534,381,912,476,415,1129,686,428
39035018BLT,630,510,98,662,587,67,560,501,59,558,503,55,567,499,58,705,635,64
39035018BKH,912,652,233,921,763,131,818,700,118,827,729,98,830,699,118,994,851,134
39035018CRS,908,653,236,904,769,108,821,718,103,823,726,97,826,713,105,977,871,98
39035018APR,369,331,19,408,395,8,264,245,19,269,259,10,269,245,17,322,306,12
39035018AOF,306,226,59,335,268,59,211,183,28,211,185,26,213,169,39,292,223,65
39053027AAB,642,207,402,655,177,449,444,131,313,447,169,278,454,133,315,660,179,470
39053027AAV,366,80,274,388,45,333,286,40,246,289,54,235,298,49,244,388,39,343
39009005ABH,551,319,187,566,304,212,481,309,172,481,331,150,491,310,165,594,342,239
39123062AAA,626,236,342,650,311,295,484,267,217,489,306,183,486,263,206,637,317,313
39123062AAH,686,240,414,700,312,334,505,269,236,514,319,195,507,267,226,712,313,388
39009005AAJ,619,417,179,637,471,138,541,419,122,559,455,104,563,432,123,650,510,130
39009005ABL,621,367,233,641,417,185,555,388,167,571,416,155,572,404,153,662,465,191
39009005ABF,830,324,461,857,333,489,749,332,417,779,395,384,773,343,418,1011,404,589
39009005ACO,233,124,92,240,117,113,194,105,89,201,135,66,199,118,77,251,119,129
39091046ABT,481,65,389,481,85,378,331,65,266,331,97,234,330,58,256,527,81,439
39091046ABH,898,132,722,889,166,688,741,151,590,751,217,534,752,155,570,999,197,792
39091046AAZ,771,108,642,774,151,604,651,127,524,648,166,482,653,137,498,825,147,671
39053027AAU,213,41,167,221,31,187,161,32,129,163,48,115,163,39,122,211,30,181
39167084ACZ,918,249,625,950,224,677,720,218,502,741,278,463,739,209,516,1010,252,740
39167084AAT,542,248,263,548,222,284,431,227,204,438,260,178,443,220,208,596,303,277
39167084ACE,657,232,408,675,238,413,585,216,369,591,250,341,601,218,373,759,282,460
39091046ABX,475,93,352,473,109,349,379,117,262,378,144,234,380,112,251,556,134,408
39101051ACR,507,93,378,506,110,377,365,87,278,361,110,251,367,90,263,522,101,411
39035018BNF,434,397,18,460,445,10,297,283,14,299,289,10,296,269,22,383,366,14
39035018CBM,461,221,233,483,303,167,430,299,131,430,310,120,434,276,153,567,349,213
39035018AWM,399,342,41,418,384,29,307,276,31,308,280,28,304,265,28,371,330,35
39035018CAM,686,559,81,711,642,57,441,403,38,445,415,30,445,389,45,560,504,50
39035018CGQ,682,238,392,711,337,344,594,320,274,600,343,257,605,304,289,773,408,359
39035018AUV,274,253,11,296,292,2,214,206,8,218,214,4,216,207,7,243,237,3
39035018BWL,707,413,258,724,473,201,668,504,164,673,527,146,673,497,164,799,584,201
39035018DCU,295,80,194,310,107,196,237,91,146,236,121,115,243,90,148,307,100,204
39035018BZJ,610,299,290,620,378,214,549,387,162,555,406,149,556,380,165,696,472,211
39035018COP,778,278,476,792,400,370,693,405,288,699,423,276,706,382,313,873,505,360
39035018BLC,527,446,51,535,488,29,468,434,34,470,445,25,469,427,34,573,515,48
39035018AUE,328,307,13,346,340,6,223,214,9,226,224,2,226,218,5,287,271,15
39035018CXA,757,303,436,770,382,367,605,372,233,610,330,280,613,294,308,879,330,543
39035018AVK,507,466,25,552,539,5,375,356,19,383,380,3,392,368,17,394,384,7
39035018AKT,372,340,13,392,384,3,284,273,11,289,283,6,288,274,12,320,313,5
39035018BWK,710,481,188,745,560,137,657,547,110,665,569,96,668,539,111,923,732,179
39035018AXT,257,190,52,272,224,43,173,142,31,173,150,23,174,139,28,263,209,52
39035018BTU,800,459,283,823,533,261,632,434,198,638,479,159,645,426,201,859,599,249
39035018CJX,667,209,424,685,274,385,569,281,288,576,295,281,580,257,309,771,316,444
39035018COA,857,299,545,850,442,377,771,393,378,774,437,337,783,397,376,958,553,403
39035018ASB,266,242,14,296,290,5,172,166,6,179,176,3,181,172,6,247,239,7
39035018BFC,311,229,56,332,277,48,197,158,39,197,164,33,199,158,31,252,186,61
39035018CGE,676,218,427,715,295,390,548,264,284,556,274,282,557,242,296,764,311,445
39035018BTI,726,480,194,756,545,189,552,446,106,559,464,95,557,438,106,767,587,171
39035018AXY,389,269,89,410,304,86,267,217,50,271,227,44,267,213,48,386,308,72
39169085ABQ,946,194,691,959,216,704,728,194,534,745,234,511,748,182,533,1015,219,775
39169085ACM,552,132,369,563,128,403,407,122,285,417,152,265,419,127,264,615,157,447
39169085AAV,660,452,175,684,508,145,398,301,97,405,315,90,406,290,101,448,304,138
39001001AAK,625,173,428,630,194,414,412,146,266,424,174,250,430,145,264,637,150,478
39001001AAB,479,93,358,499,95,390,354,90,264,361,107,254,363,98,254,540,90,442
39123ZZZZZZ,0,0,0,0,0,0,0,0,0,0,0,0,0,0,0,0,0,0
39117059AAP,407,74,318,403,86,306,347,101,246,350,127,223,352,102,233,426,84,337
39045023ACK,563,113,418,579,120,431,503,108,395,514,163,351,518,128,377,688,132,539
39045023ABL,454,82,355,458,89,349,394,96,298,395,105,290,401,94,297,553,102,438
39045023ACG,988,195,758,1015,221,752,806,194,612,813,245,568,821,208,596,1120,251,858
39045023AAQ,569,185,358,572,197,345,462,171,291,471,223,248,476,187,275,848,285,548
39045023AAU,421,149,250,420,163,232,275,129,146,281,147,134,279,129,142,453,190,255
39117059AAR,403,127,258,402,132,238,303,119,184,306,139,167,309,112,184,413,123,279
39117059ABJ,693,146,505,694,169,497,547,146,401,546,179,367,547,162,363,808,177,623
39043022ACH,793,210,534,806,249,520,695,268,427,699,316,383,699,263,408,901,276,611
39043022ACK,762,160,570,767,218,521,616,205,411,613,240,373,617,215,387,900,295,593
39043022ADE,563,236,292,558,267,262,410,216,194,417,240,177,412,215,180,564,256,296
39043022ACT,410,150,241,424,171,236,343,150,193,345,190,155,343,162,159,461,178,274
39019010ABL,499,95,366,496,104,369,394,110,284,395,130,265,397,107,277,542,114,421
39045023AEV,490,225,243,497,272,207,380,226,154,388,252,136,391,234,145,704,438,263
39045023AEM,552,242,292,559,284,254,462,255,207,465,271,194,472,251,210,675,357,308
39045023AFE,587,272,291,590,325,246,455,273,182,460,300,160,463,278,175,588,369,212
39045023ABA,577,198,324,582,210,330,388,177,211,401,208,193,406,175,212,571,213,351
39045023AAZ,529,165,324,535,191,319,372,154,218,379,190,189,379,159,205,544,189,348
39005003AAQ,488,143,316,502,161,301,368,136,232,361,159,202,368,134,215,533,213,308
39005003ACA,390,68,302,398,65,321,319,72,247,322,86,236,324,72,240,410,76,331
39005003ACE,515,76,421,518,96,400,362,88,274,363,104,259,365,95,260,506,112,389
39005003ACP,452,111,301,476,120,331,371,127,244,369,148,221,377,117,249,591,127,458
39005003AAD,748,165,555,769,209,531,607,196,411,611,231,380,617,179,423,822,242,563
39117059ABH,592,159,400,603,154,419,467,132,335,466,167,299,469,135,319,639,157,472
39013007ADH,410,94,301,413,75,323,340,99,241,339,115,224,341,84,249,477,91,373
39013007ABL,524,217,286,530,184,330,400,199,201,398,219,179,405,178,212,547,193,348
39013007ACV,296,90,192,299,75,208,225,95,130,228,110,118,230,76,147,328,67,258
39013007ACK,605,128,454,614,155,445,570,178,392,576,229,347,581,165,411,634,159,470
39013007ACU,119,33,81,120,27,86,102,44,58,102,58,44,104,35,66,135,34,100
39035018BGQ,463,282,146,495,334,142,335,241,94,335,248,87,338,224,100,532,330,199
39117059AAI,399,85,289,406,99,294,307,82,225,311,102,209,318,79,221,463,102,350
39101051AAH,483,218,215,506,258,219,308,165,143,314,191,123,320,172,131,457,205,238
39101051ABN,676,196,438,685,235,407,533,210,323,546,248,298,542,208,319,721,255,450
39101051ACZ,416,102,279,427,118,289,350,114,236,357,138,219,362,117,233,464,119,340
39101051ADE,418,73,327,422,90,317,349,79,270,355,115,240,357,77,272,447,102,341
39045023AFC,743,167,546,748,196,520,587,173,414,596,226,370,600,181,405,895,268,613
39045023AAF,685,169,493,687,198,459,535,170,365,547,222,325,548,175,358,850,268,567
39045023AEG,689,157,491,698,164,490,517,125,392,525,166,359,526,123,378,754,150,592
39045023ADH,723,141,540,741,170,531,589,162,427,607,211,396,610,167,428,815,172,630
39045023AFG,613,238,350,620,284,306,504,261,243,519,289,230,523,272,240,1027,572,442
39045023AEW,874,371,475,877,431,402,744,419,325,769,463,306,769,431,314,1055,606,430
39045023ABU,939,217,688,947,261,655,792,232,560,801,281,520,807,240,554,1062,313,737
39101051ACA,564,95,436,561,107,423,420,100,320,423,117,306,419,98,306,562,113,442
39083042ACD,1017,227,737,1028,236,741,822,202,620,825,244,581,827,210,599,1151,263,877
39033017ACC,844,167,623,853,178,637,646,178,468,666,219,447,668,182,459,907,188,708
39033017ABF,379,93,257,392,107,257,255,88,167,261,103,158,260,79,164,439,111,314
39057029AAN,587,180,374,595,239,317,482,236,246,483,257,226,481,223,244,756,401,332
39057029AHU,490,51,420,488,71,398,418,58,360,419,97,322,423,65,349,494,80,406
39101051ABP,387,123,246,378,153,215,315,141,174,314,160,154,316,139,173,434,178,250
39101051ADI,656,114,487,657,114,513,510,108,402,515,152,363,511,122,366,735,118,601
39101051ACF,421,84,311,430,70,336,331,81,250,335,107,228,344,79,252,468,75,390
39117059ABC,734,155,535,742,163,533,587,145,442,600,192,408,601,164,415,846,188,642
39117059AAW,380,81,273,387,88,275,269,68,201,275,92,183,275,74,193,437,108,324
39061031BBS,761,95,644,769,146,602,604,128,476,607,155,452,617,114,481,723,171,550
39061031ANS,1007,652,323,1030,772,222,754,595,159,752,609,143,760,572,161,897,725,163
39061031AZB,957,248,676,957,362,548,783,300,483,776,346,430,791,294,468,1034,472,541
39061031AHQ,773,536,197,810,639,116,710,625,85,715,644,71,720,610,76,720,615,90
39061031BQJ,803,505,255,838,608,173,685,580,105,690,596,94,703,555,113,679,545,119
39061031AGE,736,417,299,746,523,181,763,540,223,761,569,192,768,540,207,921,694,213
39061031BNP,804,269,507,810,419,362,684,336,348,678,358,320,688,322,349,865,477,379
39061031ARO,633,536,78,652,584,53,513,470,43,521,479,42,517,461,40,640,558,71
39061031BFS,856,314,514,852,419,407,777,392,385,782,418,364,786,378,391,926,508,410
39061031BFR,719,237,456,721,315,373,699,324,375,705,354,351,702,324,362,847,439,397
39061031BFX,864,697,135,882,789,65,712,647,65,715,656,59,717,638,66,905,795,100
39061031AVI,674,265,365,684,327,309,478,271,207,474,290,184,476,260,192,740,424,304
39057029AGJ,570,266,258,601,322,230,356,221,135,356,234,122,357,203,129,479,264,194
39057029AFI,442,116,308,445,137,285,319,115,204,320,135,185,319,98,213,470,163,303
39057029AGY,523,65,444,508,94,405,467,83,384,471,105,366,473,70,396,566,116,444
39057029AIL,398,80,310,394,111,268,329,78,251,329,108,221,331,64,256,388,98,284
39157079ADN,552,147,373,552,149,380,381,119,262,390,147,243,388,122,255,590,142,437
39157079ACU,525,130,353,533,129,375,421,145,276,431,178,253,427,128,284,590,147,436
39157079ACT,512,151,322,519,140,347,388,141,247,391,182,209,391,141,236,534,153,374
39157079AAR,415,150,230,424,154,231,311,154,157,309,170,139,310,135,160,427,166,253
39057029AIA,680,108,560,678,151,506,597,143,454,601,198,403,603,143,451,714,176,525
39057029AFQ,327,174,139,330,200,115,248,150,98,247,158,89,250,141,100,331,183,137
39057029AGR,676,146,511,674,197,428,646,206,440,652,244,408,656,195,442,796,306,476
39083042ABX,500,76,396,506,97,387,401,85,316,402,115,287,402,85,305,568,106,455
39057029AHI,554,458,69,561,500,41,506,455,51,514,475,39,511,448,53,575,530,43
39057029AIF,893,172,692,871,247,575,771,237,534,763,291,472,782,238,521,1013,368,627
39057029AFA,369,108,245,375,147,212,252,95,157,253,110,143,251,88,150,385,145,232
39057029AIK,522,116,379,525,142,365,437,132,305,434,170,264,443,121,307,511,144,357
39057029AIX,1432,402,983,1440,539,825,1385,537,848,1394,628,766,1407,538,837,1950,854,1060
39101051ACD,259,63,176,266,76,175,203,63,140,203,79,124,205,65,134,275,72,193
39005003ACT,797,141,600,812,133,634,634,138,496,638,187,451,645,133,489,882,180,693
39057029AIM,218,121,86,221,137,72,201,125,76,200,141,59,205,121,80,224,131,91
39057029ADX,367,150,191,366,180,155,266,139,127,268,163,105,267,134,122,355,174,176
39057029AHV,352,62,269,356,76,270,285,66,219,286,97,189,288,57,223,395,72,319
39057029AAV,487,111,350,488,152,308,432,153,279,432,187,245,435,142,274,531,172,344
39057029AGL,440,100,323,435,131,285,365,111,254,370,147,223,372,110,254,476,151,318
39157079AEE,397,60,324,396,65,316,310,61,249,312,89,223,312,62,244,440,76,355
39061031AAE,521,169,347,513,219,270,466,218,248,468,235,233,471,218,247,558,272,278
39061031AKT,307,253,24,327,311,11,217,210,7,218,212,6,218,199,14,267,235,21
39061031AAK,357,138,204,357,181,150,297,168,129,298,183,115,301,159,129,374,253,113
39061031BQO,685,257,403,693,330,312,583,313,270,589,344,245,586,297,266,845,439,388
39061031BCE,704,225,430,727,297,392,523,255,268,530,268,262,532,246,262,734,351,370
39061031ANW,990,481,458,999,562,388,765,467,298,766,483,283,765,445,292,1024,604,402
39061031AGG,618,477,107,645,568,49,611,548,63,619,567,52,619,542,58,891,805,75
39061031AIA,596,522,45,629,618,8,402,388,14,402,395,7,403,380,16,547,518,16
39061031AZG,976,266,669,975,345,560,836,343,493,834,370,464,843,335,482,1079,469,596
39007004AEG,407,101,274,417,101,294,304,105,199,311,134,177,313,108,192,448,114,329
39025013AIC,448,92,344,449,128,304,380,108,272,383,122,261,385,106,269,496,165,323
39079040ABO,565,112,434,571,101,456,431,99,332,443,145,298,445,115,326,618,118,495
39079040ABM,360,89,245,368,74,280,267,64,203,270,93,177,275,65,202,418,66,344
39007004AEX,601,158,397,610,180,402,470,160,310,480,208,272,484,157,300,624,181,439
39025013ADE,558,77,454,562,103,439,426,89,337,426,95,331,427,86,330,592,108,478
39079040AAO,293,91,184,296,89,200,192,72,120,200,82,118,201,75,121,330,95,230
39067034AAX,634,151,443,651,147,470,508,175,333,513,204,309,512,141,343,670,148,508
39131066AAL,518,189,297,536,189,329,386,153,233,391,173,218,395,148,237,559,157,396
39079040AAM,474,133,315,473,138,307,335,106,229,343,136,207,348,121,216,468,126,336
39079040AAA,787,168,591,801,196,572,624,178,446,637,252,385,651,202,443,873,236,631
39079040ABD,648,201,424,658,192,440,483,146,337,491,206,285,496,161,323,715,198,509
39079040AAL,326,86,219,326,78,237,212,55,157,212,78,134,213,54,155,363,77,283
39101051ABW,249,67,161,252,69,167,193,66,127,197,84,113,194,74,111,279,57,217
39101051ACU,575,105,448,583,128,438,526,117,409,533,163,370,540,134,393,661,159,486
39105053AAX,466,160,289,482,133,326,368,121,247,373,156,217,373,140,225,589,178,408
39105053AAA,589,185,380,615,163,419,475,162,313,495,206,289,489,168,312,649,181,463
39069035ABF,920,227,645,934,236,653,707,231,476,710,278,432,719,224,449,1018,238,771
39069035ABD,339,40,286,346,51,281,274,53,221,276,91,185,285,54,224,388,78,306
39003002AAK,422,167,223,440,202,204,259,138,121,261,159,102,261,132,120,388,176,195
39003002AAX,305,149,134,323,199,111,220,142,78,220,148,72,217,121,88,350,199,146
39003002AED,489,76,400,493,91,380,368,78,290,370,114,256,372,79,286,473,99,364
39113057AVJ,573,505,53,584,564,17,460,431,29,470,453,17,466,429,30,528,502,21
39113057ALK,996,316,629,1013,400,537,740,358,382,745,408,337,750,332,369,1044,475,540
39113057ARL,683,180,480,692,214,444,595,223,372,600,269,331,605,216,371,849,328,508
39113057ATO,984,139,817,995,180,796,841,182,659,844,231,613,857,183,649,1084,207,868
39113057AXO,963,264,682,974,357,571,868,326,542,876,385,491,873,316,538,1064,459,598
39113057APN,432,104,301,450,121,314,293,86,207,290,109,181,295,84,199,444,116,323
39113057ATA,531,180,322,537,225,291,410,163,247,415,197,218,410,159,235,578,248,318
39113057ATB,620,136,460,627,183,416,533,167,366,530,224,306,529,160,356,650,220,426
39113057AGI,565,505,44,580,549,20,376,354,22,384,362,22,384,351,27,484,441,37
39003002ADA,415,121,267,433,155,260,309,125,184,308,143,165,307,120,178,434,153,276
39003002AAP,672,221,419,691,267,393,556,239,317,552,292,260,555,220,319,688,277,402
39003002AAE,494,103,360,495,119,350,330,100,230,339,133,206,334,96,229,544,135,400
39003002AEY,417,41,360,417,47,356,340,46,294,341,86,255,341,45,286,446,57,382
39003002AFF,535,92,425,535,114,391,424,93,331,425,135,290,431,90,326,556,106,433
39003002AFV,579,106,456,588,114,450,475,110,365,479,153,326,483,114,355,604,139,458
39003002AFC,381,124,233,396,130,252,310,119,191,306,134,172,309,106,193,435,130,302
39003002AFG,553,82,457,556,105,427,441,90,351,442,120,322,446,92,349,567,129,434
39073037AAX,358,82,257,373,93,261,274,84,190,279,108,171,278,87,189,418,87,323
39073037ABA,447,131,292,461,129,301,385,141,244,395,172,223,397,153,234,514,116,391
39139070AAS,494,251,210,507,267,219,386,229,157,392,241,151,392,227,149,526,258,253
39139070ABJ,648,155,454,651,168,455,516,168,348,529,220,309,530,167,345,690,186,493
39139070ACO,915,204,663,915,253,633,776,262,514,791,329,462,793,260,510,1063,349,699
39139070AAI,367,176,173,372,169,179,249,140,109,248,161,87,250,137,102,417,207,206
39139070AAH,505,194,277,510,209,275,417,190,227,419,223,196,422,199,205,579,256,310
39139070ADH,1021,226,740,1041,208,801,787,211,576,804,242,562,806,214,574,1158,231,918
39139070AAA,759,186,552,770,225,518,662,208,454,665,243,422,670,218,443,797,272,517
39015008AAH,452,69,361,467,83,373,326,73,253,331,88,243,335,69,250,478,76,398
39015008ACG,678,125,534,694,157,511,439,123,316,443,156,287,446,116,310,708,146,552
39015008ACN,544,72,447,558,113,431,412,104,308,424,121,303,415,96,312,612,115,493
39097049AAW,635,116,494,629,135,461,511,120,391,511,154,357,514,128,370,711,146,557
39097049AAV,654,148,460,654,152,477,493,132,361,494,149,345,498,135,339,776,180,584
39011006AAP,854,78,748,862,117,708,661,96,565,660,184,476,663,97,547,995,147,836
39011006AAS,357,60,275,363,80,267,230,54,176,233,81,152,233,45,177,345,63,277
39011006AAU,497,39,451,491,54,427,406,55,351,407,92,315,405,58,340,519,65,446
39011006ABD,1008,98,882,1011,126,854,847,131,716,846,219,627,850,130,691,1075,147,915
39137069ABM,614,101,483,623,133,467,456,114,342,457,172,285,463,119,333,664,154,489
39137069ABZ,590,69,510,597,67,506,480,73,407,481,125,356,486,69,413,676,79,588
39137069AAT,633,73,544,642,70,538,511,78,433,513,133,380,519,72,438,633,80,549
39011006ABF,717,80,613,722,93,616,612,92,520,616,158,458,615,89,507,759,106,649
39011006AAF,497,105,358,511,115,371,415,138,277,417,167,250,420,126,263,635,145,476
39137069AAG,1138,145,955,1142,166,931,929,155,774,938,243,695,941,151,772,1248,176,1059
39161081AAB,267,49,202,267,44,210,197,47,150,197,63,134,200,43,152,303,61,238
39011006ABH,850,114,711,849,134,679,789,151,638,792,219,573,797,141,631,934,159,760
39147074ACA,377,74,284,397,94,270,315,102,213,330,151,179,332,89,224,422,101,312
39113057ARI,855,165,646,872,229,600,601,185,416,620,245,375,623,181,412,892,266,615
39113057ALI,996,271,691,1015,382,581,872,355,517,880,433,447,888,340,519,1032,452,570
39113057AAC,1020,322,659,1019,438,519,853,386,467,864,443,421,864,374,462,1043,484,539
39113057APZ,699,261,408,714,312,358,522,234,288,520,257,263,524,221,290,705,303,389
39145073ABK,362,113,226,366,102,245,254,100,154,258,119,139,260,102,151,352,95,251
39145073ADD,625,209,401,623,181,425,498,177,321,507,227,280,508,186,316,715,200,512
39165083ACB,802,263,505,819,344,436,589,272,317,611,304,307,610,270,321,865,419,431
39155078AKN,438,207,195,449,216,211,343,189,154,349,221,128,345,204,137,504,237,254
39155078AES,520,174,329,516,178,318,395,168,227,403,214,189,400,181,214,517,183,328
39155078ABS,640,281,311,657,321,297,484,294,190,492,326,166,489,279,187,697,347,343
39155078AAB,568,296,238,581,329,234,462,295,167,465,319,146,471,304,158,596,337,252
39147074ACU,434,67,351,443,83,345,331,80,251,335,119,216,340,60,268,468,87,378
39165083AFB,787,169,595,797,240,532,663,231,432,683,258,425,681,221,445,917,332,572
39165083AAL,470,115,332,495,153,309,393,135,258,410,153,257,404,132,256,556,179,369
39165083AEL,672,110,525,686,131,530,545,111,434,559,135,424,558,111,425,750,133,608
39165083ADZ,575,80,478,595,113,459,484,102,382,502,117,385,495,100,386,586,110,469
39105053AAN,390,92,276,405,75,314,315,75,240,319,108,211,317,86,221,443,78,358
39113057ACW,520,381,103,540,462,51,399,350,49,405,367,38,408,342,52,482,419,51
39113057AUH,640,406,196,655,479,158,483,361,122,484,391,93,491,350,120,635,494,129
39113057AHP,809,253,500,830,326,440,644,327,317,647,371,276,651,314,308,869,393,455
39173087ABI,696,313,334,715,340,305,495,299,196,495,340,155,498,307,177,718,369,324
39017009AHS,657,127,504,671,139,500,543,138,405,550,160,390,551,137,383,750,157,581
39017009AGJ,205,54,139,219,72,141,138,50,88,144,61,83,144,51,91,263,80,183
39105053AAE,551,196,327,576,182,370,517,183,334,525,234,291,531,209,303,672,212,442
39173087ABJ,684,240,421,699,315,347,554,271,283,561,315,246,563,265,280,712,340,366
39017009ADX,329,85,226,349,119,218,235,87,148,237,105,132,237,90,138,400,118,278
39015008AAY,593,71,481,608,107,484,438,98,340,445,111,334,445,96,336,678,110,562
39015008AAM,394,58,324,408,66,324,312,72,240,319,94,225,322,66,234,452,75,369
39113057ADA,578,508,48,596,567,16,384,353,31,394,374,20,395,360,29,479,446,27
39113057ASG,588,170,393,604,181,388,414,130,284,413,161,252,417,142,252,556,182,366
39113057ADY,799,311,443,805,411,356,723,401,322,727,450,277,737,401,318,857,488,347
39113057ACL,497,315,153,497,352,120,349,244,105,350,257,93,350,229,110,436,322,105
39113057AOA,653,139,483,666,174,473,458,150,308,463,180,283,466,134,308,705,203,484
39113057AUZ,507,94,403,501,112,370,411,94,317,409,135,274,417,98,298,565,116,437
39105053AAW,124,43,73,127,39,82,114,41,73,117,56,61,115,44,69,145,42,102
39087044ACA,219,60,147,222,51,162,155,51,104,157,63,94,158,48,106,265,77,186
39165083ACW,657,143,485,669,169,476,593,177,416,604,200,404,604,170,423,770,237,519
39165083AEM,929,119,773,954,155,761,812,159,653,825,187,638,824,150,655,1084,222,851
39107054AAM,608,44,549,624,59,547,483,52,431,489,91,398,494,54,428,664,74,585
39003002AGD,525,87,412,538,105,413,431,98,333,438,131,307,435,88,329,606,115,485
39069035AAH,766,221,493,783,277,450,552,198,354,570,276,294,573,196,359,791,267,510
39139070AAD,929,276,621,932,339,564,816,323,493,830,389,441,832,311,497,1028,399,620
39139070ACK,535,142,355,537,133,381,420,132,288,424,160,264,427,124,289,578,134,440
39139070ABS,639,131,481,632,111,504,500,104,396,507,137,370,511,116,382,722,120,594
39113057APY,913,328,551,910,349,517,663,293,370,670,332,338,675,283,364,1015,453,541
39113057ATZ,693,193,447,706,229,446,484,178,306,481,215,266,486,167,300,666,192,463
39113057AFQ,651,553,79,669,621,37,480,454,26,488,466,22,491,448,33,608,568,38
39155078AAF,600,298,276,614,334,261,465,291,174,473,322,151,473,288,167,605,317,278
39155078ADD,697,330,314,707,390,289,514,318,196,527,354,173,527,324,188,700,382,312
39155078AKE,543,234,280,566,252,297,422,218,204,422,242,180,433,234,186,575,244,327
39165083AEI,557,124,412,564,171,364,447,128,319,459,145,314,453,123,314,610,203,402
39165083ADH,434,65,350,431,114,295,409,114,295,415,132,283,411,108,295,515,147,360
39165083AES,884,210,642,902,278,571,717,248,469,731,273,458,727,237,482,948,333,606
39165083AGD,737,234,487,747,333,386,669,304,365,682,341,341,678,299,367,915,481,426
39165083AFS,838,272,543,858,383,440,731,342,389,745,399,346,750,350,392,1007,557,434
39155078AFH,542,246,261,555,265,265,469,264,205,479,291,188,481,260,199,606,265,328
39099050AMT,636,164,445,638,197,424,525,177,348,530,208,322,534,192,331,696,214,480
39093047AFG,697,456,193,719,523,160,483,370,113,499,398,101,501,377,107,704,466,219
39093047ALE,762,298,425,779,371,377,654,329,325,675,381,294,676,316,333,892,429,459
39109055ACO,612,75,519,624,116,475,482,91,391,501,137,364,501,87,390,679,120,549
39109055ABQ,701,102,570,713,141,544,549,123,426,565,168,397,571,138,413,734,153,569
39093047AIK,762,246,464,791,293,455,641,298,343,682,370,312,687,309,347,870,299,553
39093047ACY,747,417,279,769,496,229,497,344,153,519,379,140,515,336,153,716,480,226
39093047AGP,1058,349,674,1066,452,579,827,396,431,849,445,404,860,399,445,1199,543,641
39093047AHT,923,360,461,946,404,482,724,371,353,744,423,321,749,381,335,1107,504,589
39109055AAF,626,143,452,628,193,407,414,145,269,423,189,234,428,142,275,669,187,464
39093047ADL,545,239,278,558,284,246,419,238,181,429,279,150,435,241,176,580,283,285
39099050AQK,450,283,133,466,315,136,319,229,90,321,240,81,322,225,89,464,309,150
39099050AGK,263,166,81,276,196,69,185,122,63,184,139,45,188,129,52,261,161,94
39001001AAD,504,85,393,513,94,408,407,76,331,422,104,318,421,81,326,544,80,460
39139070ACL,514,96,389,517,95,397,430,103,327,441,155,286,442,102,322,573,100,458
39073037ABF,572,158,375,581,160,409,417,137,280,418,167,251,427,132,278,624,155,462
39021011ABM,478,86,354,478,96,353,373,88,285,374,119,255,377,93,269,574,107,457
39017009AFN,802,142,631,833,167,632,522,149,373,539,162,377,538,140,379,896,211,672
39017009AIB,801,117,648,829,146,656,625,139,486,649,161,488,650,130,510,888,154,730
39017009AAH,393,198,179,416,247,149,273,169,104,288,197,91,290,167,112,397,240,149
39113057APT,660,163,468,660,219,388,571,233,338,581,269,312,580,215,335,723,307,392
39113057APP,486,138,319,491,176,293,367,139,228,368,174,194,364,138,211,562,213,337
39113057AEM,493,158,296,501,189,272,389,170,219,394,194,200,394,161,217,522,242,270
39113057AEK,538,165,336,540,207,286,436,202,234,441,238,203,446,200,223,615,278,321
39049025ANX,1053,469,546,1054,601,406,1047,584,463,1050,687,363,1057,615,419,1239,777,439
39049025BAS,902,333,555,891,477,378,868,418,450,876,505,371,886,457,413,982,554,412
39049025BGO,834,379,428,853,473,333,596,369,227,604,387,217,603,374,218,872,558,297
39049025BLU,354,162,182,363,203,141,407,227,180,414,251,163,415,228,177,564,322,234
39049025BCG,762,255,469,781,296,458,613,268,345,613,297,316,620,280,326,894,378,498
39049025ARS,542,175,361,534,266,244,503,216,287,506,264,242,510,254,253,565,322,235
39049025BIE,991,848,111,1021,924,76,832,766,66,839,795,44,835,772,49,1014,925,73
39049025ADE,688,463,190,701,537,114,516,441,75,524,465,59,526,444,63,686,557,114
39049025AYV,426,256,145,431,295,96,360,254,106,366,278,88,366,266,94,449,330,108
39049025AIM,574,421,121,601,486,100,373,304,69,382,328,54,383,316,60,566,442,116
39049025AJH,556,379,144,568,409,136,432,315,117,436,340,96,437,320,106,573,411,147
39049025AZZ,767,242,488,776,274,459,638,254,384,640,302,338,644,255,363,877,328,541
39049025AOK,927,433,464,941,513,385,836,495,341,841,565,276,848,513,310,1089,711,365
39031016AAT,810,169,601,821,151,643,605,171,434,608,203,405,617,168,422,898,179,704
39031016AAW,927,202,675,933,226,671,737,218,519,743,248,495,749,212,517,1017,206,797
39003002AET,716,92,594,723,116,580,575,98,477,581,160,421,580,93,472,776,128,634
39003002AGI,417,43,360,426,58,355,327,54,273,325,90,235,325,54,269,482,65,409
39003002ABI,678,254,398,686,294,351,561,274,287,564,321,243,564,271,276,723,332,376
39003002ADW,673,98,546,680,115,530,526,108,418,531,166,365,532,110,409,745,117,620
39003002AEC,351,106,220,355,115,218,220,77,143,217,95,122,220,67,139,378,97,276
39003002AAA,524,106,386,530,124,385,410,115,295,411,150,261,415,107,296,565,129,423
39069035AAY,573,97,461,578,138,413,429,98,331,437,151,286,454,92,348,611,141,463
39113057APS,498,129,335,511,161,323,372,137,235,374,164,210,379,132,231,535,181,340
39113057AAI,1112,310,776,1102,460,593,988,438,550,1002,517,485,994,408,560,1212,550,642
39113057ATP,786,116,643,802,130,643,624,136,488,633,168,465,637,131,491,807,152,645
39069035AAJ,333,50,274,338,59,271,277,54,223,284,88,196,283,47,230,361,51,308
39113057AGH,422,367,43,437,405,24,317,303,14,323,312,11,324,300,18,428,396,23
39113057ARS,539,121,395,555,143,378,413,136,277,424,159,265,420,122,281,608,187,412
39113057ANG,845,285,529,851,404,413,745,376,369,766,438,328,759,384,359,983,545,428
39113057ARK,1105,230,835,1128,329,763,858,284,574,876,327,549,867,273,576,1231,393,820
39113057ATM,736,113,589,746,140,570,576,138,438,575,172,403,580,134,425,725,159,558
39113057AUG,690,501,158,707,597,92,489,413,76,501,443,58,500,409,81,686,572,100
39113057APQ,402,153,221,415,168,226,224,114,110,222,132,90,228,102,105,361,139,219
39113057AKW,837,251,545,849,295,489,645,272,373,653,317,336,654,240,385,960,380,556
39031016AAL,1051,258,760,1038,303,683,846,295,551,848,377,471,863,300,545,1134,384,734
39031016ABQ,907,171,694,929,189,700,693,190,503,693,236,457,696,189,487,944,188,742
39031016AAP,571,100,431,589,108,456,427,112,315,434,152,282,437,114,306,675,131,531
39023012AEM,994,203,738,993,270,666,826,257,569,828,330,498,836,233,576,1071,317,727
39023012ADJ,691,140,522,702,172,498,558,159,399,569,202,367,568,156,398,731,188,535
39041021AAG,578,212,347,589,266,288,498,219,279,497,268,229,503,253,229,651,315,320
39041021AAQ,660,223,396,650,274,336,591,246,345,591,296,295,593,251,330,799,394,390
39031016AAA,333,97,219,340,121,207,277,121,156,276,141,135,282,121,152,377,144,220
39031016ABA,896,251,608,906,254,612,713,240,473,719,295,424,715,239,453,991,259,716
39031016AAU,938,192,690,960,209,715,745,219,526,748,274,474,751,214,510,1073,221,839
39031016AAR,577,92,442,585,100,467,435,103,332,435,123,312,433,102,320,679,102,567
39037019ABV,1022,76,923,1047,106,911,854,108,746,854,169,685,861,95,744,1142,117,999
39037019ABP,1021,96,882,1040,144,868,814,119,695,830,201,629,833,118,694,1155,161,978
39037019ABN,432,45,365,429,62,355,346,59,287,347,76,271,350,61,283,472,72,389
39171086AAX,461,82,352,478,82,375,386,86,300,379,118,261,391,79,301,477,81,386
39171086AAY,647,146,471,665,158,478,525,124,401,525,170,355,534,119,393,724,155,561
39171086ABF,424,86,316,434,87,329,302,69,233,302,103,199,307,63,238,466,86,373
39171086ABB,537,144,353,543,152,373,438,145,293,434,163,271,441,131,291,600,170,423
39069035AAW,695,156,514,706,161,511,548,154,394,554,230,324,567,143,403,693,176,512
39031016AAS,230,34,188,225,37,181,161,31,130,163,39,124,165,32,128,240,31,208
39107054ABI,440,61,369,452,60,376,321,59,262,322,77,245,325,54,267,484,60,421
39069035ABB,537,74,441,536,96,412,427,99,328,425,139,286,441,82,344,575,104,462
39003002ABF,440,214,194,456,261,177,331,201,130,332,216,116,333,186,139,473,267,199
39107054AAX,706,90,585,717,123,564,580,129,451,585,184,401,596,134,441,804,159,638
39037019ABJ,672,67,573,680,105,557,499,91,408,498,131,367,505,87,398,733,112,610
39023012ABG,526,187,316,532,248,261,457,224,233,461,259,202,466,227,224,563,288,260
39023012ABC,748,233,488,745,335,385,652,289,363,654,346,308,658,276,357,837,404,417
39047024ABG,448,70,348,452,86,352,337,70,267,341,100,241,337,86,247,491,92,396
39047024ABK,721,133,569,723,143,554,577,104,473,576,146,430,575,117,446,829,143,678
39049025AGP,217,134,71,228,155,67,121,85,36,122,90,32,125,87,35,211,134,74
39155078AAT,636,263,354,653,273,349,532,263,269,538,289,249,540,262,265,687,277,403
39155078AKD,812,324,455,825,328,451,615,283,332,617,344,273,618,303,296,868,346,513
39155078AGR,567,236,303,580,264,289,479,257,222,492,297,195,485,252,222,655,305,340
39147074ABR,392,86,285,393,111,259,306,111,195,313,151,162,314,95,206,446,136,305
39147074AAI,493,196,255,508,223,233,333,170,163,342,200,142,339,165,158,537,220,312
39165083ABN,640,84,520,655,125,504,535,106,429,553,136,417,547,99,428,750,148,595
39165083AAI,641,143,434,663,176,456,469,148,321,477,168,309,475,154,302,751,202,539
39165083AAE,358,70,256,369,90,266,284,88,196,287,104,183,284,79,194,420,105,312
39155078AIQ,695,257,401,717,270,415,540,250,290,552,289,263,550,245,287,785,290,489
39087044ABY,437,125,289,458,108,336,334,93,241,334,116,218,337,105,224,537,132,400
39087044AAE,343,140,194,342,116,210,278,98,180,283,138,145,285,109,169,355,134,216
39089045AAK,938,333,524,944,366,526,650,284,366,664,341,323,660,272,365,1033,362,643
39089045AEK,1150,273,821,1148,340,747,969,311,658,993,373,620,983,316,641,1323,389,915
39089045ABN,556,179,349,553,219,303,469,161,308,474,205,269,474,163,293,552,214,331
39089045ADD,560,112,416,563,125,417,470,118,352,481,153,328,483,129,344,654,145,501
39089045AFJ,856,275,535,868,335,496,658,243,415,680,327,353,679,260,392,1032,332,685
39089045ACX,1117,383,693,1119,494,568,1081,473,608,1095,548,547,1102,495,583,1321,654,651
39003002ADR,539,82,446,551,104,428,483,104,379,483,148,335,487,93,385,588,121,460
39003002ADQ,488,80,378,500,100,378,400,86,314,410,122,288,408,81,314,528,110,414
39069035AAB,424,111,288,431,134,252,311,120,191,325,158,167,323,117,193,508,175,319
39159080ABE,357,71,264,360,82,258,261,67,194,262,84,178,267,69,187,400,121,270
39089045AFM,834,222,563,839,221,568,603,185,418,616,232,384,619,179,404,875,201,655
39089045ACK,905,178,686,918,186,699,746,197,549,752,248,504,758,209,528,1043,246,784
39089045ADJ,726,178,520,729,227,467,644,194,450,657,227,430,657,204,431,818,259,547
39089045ADK,1116,243,831,1130,292,790,902,248,654,920,329,591,921,268,631,1272,342,908
39003002AAH,569,226,300,590,260,294,379,187,192,383,230,153,378,186,181,529,234,287
39003002AEO,164,22,136,165,26,131,117,26,91,118,42,76,120,30,88,172,30,139
39165083AFZ,533,94,417,536,141,356,420,128,292,428,138,290,429,113,302,540,186,338
39165083AHE,720,112,583,715,188,493,681,189,492,685,216,469,682,178,493,864,268,585
39041021ADK,445,110,310,462,148,296,309,99,210,314,146,168,314,108,196,475,139,324
39041021ACU,916,241,650,903,358,499,863,319,544,870,372,498,881,347,525,1137,515,607
39041021ADA,165,23,136,170,30,134,149,26,123,151,41,110,152,30,118,197,43,153
39023012ACI,593,435,126,599,485,95,389,328,61,390,344,46,392,312,71,579,440,126
39023012AFB,819,211,579,816,280,488,601,223,378,619,302,317,620,231,362,896,311,568
39029015ACJ,461,100,327,472,114,341,351,103,248,368,145,223,370,118,241,489,114,367
39029015ACR,492,109,355,504,141,342,392,120,272,407,173,234,404,122,270,549,175,357
39099050AOV,279,120,139,290,131,144,217,117,100,222,133,89,220,121,91,282,118,156
39099050ANG,565,156,373,577,161,393,480,171,309,490,196,294,500,185,304,864,251,610
39099050ABY,473,350,90,491,400,74,297,244,53,299,255,44,299,246,43,383,302,73
39099050AGJ,607,283,273,629,328,284,441,279,162,445,320,125,446,277,152,621,327,285
39099050AJZ,558,265,269,571,312,241,453,261,192,461,307,154,464,279,175,622,305,307
39029015AAS,462,113,315,479,127,325,364,126,238,373,153,220,370,117,232,572,158,406
39099050ANX,626,214,367,637,225,390,497,233,264,501,264,237,503,241,251,704,236,459
39025013ABX,577,111,437,583,162,386,472,160,312,467,186,281,475,158,296,615,215,390
39089045ABV,786,190,569,782,240,516,700,195,505,711,259,452,716,214,486,1007,291,703
39131066AAP,837,243,563,857,203,624,570,170,400,580,211,369,577,160,393,864,154,700
39131066AAG,385,140,232,390,150,227,273,110,163,272,137,135,274,96,172,377,118,253
39025013AFG,870,162,677,880,251,596,818,254,564,817,283,534,825,239,566,1189,378,794
39007004AEM,566,231,318,563,275,266,491,249,242,505,296,209,503,252,237,612,318,282
39007004ACR,371,91,254,371,93,259,292,93,199,297,108,189,300,84,195,413,102,307
39003002AFJ,588,210,355,592,244,319,489,223,266,497,252,245,497,212,278,613,266,339
39069035AAA,435,136,265,445,159,244,303,140,163,314,179,135,312,131,164,473,190,276
39165083ADN,488,51,412,515,58,437,395,67,328,410,76,334,411,64,333,559,74,478
39155078AIE,781,300,454,794,365,412,679,357,322,691,401,290,693,376,312,914,446,458
39089045AEO,993,268,674,995,289,667,828,282,546,838,343,495,832,292,521,1070,298,757
39029015AEO,529,92,401,543,100,424,420,112,308,422,144,278,423,114,287,558,109,441
39041021AFS,743,248,474,747,307,400,649,282,367,654,324,330,657,280,365,916,455,448
39023012AEF,479,96,362,481,85,379,381,82,299,384,105,279,385,75,303,503,95,403
39023012AFF,510,125,365,515,153,348,405,148,257,403,176,227,415,136,264,518,153,360
39007004ADM,421,160,241,431,152,262,358,134,224,360,173,187,368,133,219,477,161,306
39007004ADV,520,191,287,524,232,279,442,211,231,453,245,208,451,213,226,582,243,330
39007004ADX,239,81,141,241,87,140,197,83,114,201,103,98,200,84,105,251,99,149
39007004ABZ,418,124,269,419,129,277,332,128,204,338,161,177,337,122,197,499,158,334
39007004AAH,457,231,187,471,255,188,328,194,134,331,219,112,335,189,124,514,293,208
39007004ACX,264,78,155,274,89,169,186,63,123,191,86,105,196,65,113,291,91,195
39025013AEG,435,70,348,444,94,335,355,86,269,356,102,254,350,77,264,469,98,364
39025013AAF,840,150,660,841,201,598,691,243,448,693,261,432,697,223,449,991,302,677
39025013AAE,711,133,544,722,182,511,516,155,361,517,174,343,517,151,342,838,206,612
39089045AEW,1001,259,679,1013,302,659,779,254,525,788,323,465,801,277,491,1120,396,693
39123062AAT,624,208,391,648,240,369,530,245,285,531,294,237,530,245,270,707,269,432
39001001AAN,798,131,642,804,132,657,649,127,522,671,166,505,682,143,527,886,122,759
39147074ABB,579,138,421,590,187,369,480,162,318,493,223,270,497,170,313,631,232,386
39165083ACZ,859,152,661,877,184,658,718,164,554,733,196,537,730,151,560,1107,206,887
39165083ADB,770,112,605,788,136,630,616,128,488,635,163,472,635,126,492,854,141,706
39155078AET,610,185,413,623,228,379,530,217,313,536,246,290,535,226,302,631,237,390
39155078AHR,499,133,335,517,136,356,383,147,236,391,173,218,390,155,227,577,158,410
39155078AJW,542,339,172,556,359,179,379,267,112,394,291,103,381,268,108,540,317,216
39155078AGE,647,140,474,660,162,469,495,149,346,497,180,317,501,146,324,691,154,527
39155078AEK,630,394,190,650,414,206,462,334,128,473,361,112,474,334,134,662,415,238
39147074AAA,585,204,341,609,262,303,450,243,207,462,286,176,470,236,216,661,317,325
39089045ACM,1029,213,753,1043,209,790,832,196,636,841,255,586,845,206,619,1163,212,938
39089045AES,943,250,629,971,289,631,736,253,483,748,308,440,751,265,458,1054,362,678
39089045ACL,678,150,479,687,166,499,620,162,458,629,203,426,626,172,432,762,182,572
39089045ADT,1107,250,808,1114,269,805,914,234,680,933,308,625,936,245,670,1331,306,1001
39049025AGW,727,448,252,740,555,138,635,517,118,637,553,84,640,524,96,772,626,128
39049025AZR,800,220,555,802,334,434,710,252,458,708,327,381,717,285,425,983,469,500
39049025BHW,817,344,439,837,463,331,702,392,310,724,450,274,725,422,291,1184,753,420
39049025BAU,847,225,617,841,384,436,822,336,486,825,421,404,831,366,460,1156,612,535
39049025ASZ,681,250,395,708,280,384,567,260,307,568,294,274,575,283,274,857,370,470
39049025AZN,446,95,336,457,126,312,360,100,260,360,125,235,358,125,224,453,124,323
39049025BDS,562,163,377,571,217,332,520,209,311,522,257,265,524,251,267,891,386,487
39049025BDU,586,155,413,587,202,355,535,200,335,537,250,287,545,237,295,735,309,417
39049025ASW,717,420,265,731,515,171,680,499,181,689,549,140,694,515,167,779,590,173
39049025AGA,1082,889,173,1101,965,106,1016,882,134,1026,933,93,1028,909,109,1208,1078,124
39049025BCF,843,211,625,852,385,445,816,332,484,820,392,428,819,345,464,1072,532,538
39049025APJ,507,403,81,523,451,58,371,319,52,377,339,38,376,329,41,493,417,61
39049025AYM,1001,405,550,1005,509,430,871,480,391,875,535,340,880,495,361,1168,655,470
39049025ANO,831,481,326,839,579,240,728,506,222,734,554,180,736,513,208,921,664,245
39049025BLC,1028,416,564,1045,548,442,918,482,436,923,563,360,927,502,402,1239,733,487
39049025BMY,417,362,35,434,406,22,279,253,26,277,256,21,277,246,23,389,350,36
39049025ABF,412,359,32,443,402,26,370,342,28,375,357,18,376,351,15,478,423,47
39049025AMK,410,158,229,426,194,208,379,202,177,383,231,152,389,210,170,483,256,216
39049025BMU,482,183,267,499,226,245,270,133,137,268,147,121,275,142,121,485,266,210
39049025ATA,820,274,505,836,333,448,652,296,356,654,362,292,661,337,307,891,372,499
39049025APE,454,169,267,465,208,234,351,171,180,348,191,157,355,169,180,525,252,268
39049025AUA,989,345,595,1007,428,501,791,355,436,801,430,371,808,385,400,1002,486,501
39153077AMK,636,247,339,652,304,315,578,316,262,597,351,246,596,312,260,750,388,351
39153077BCO,768,298,446,767,378,358,665,348,317,673,385,288,675,344,321,862,480,370
39153077BAG,684,278,350,696,322,337,505,299,206,524,317,207,523,289,214,741,371,358
39153077ARP,391,144,215,405,190,192,336,165,171,348,193,155,347,159,179,419,189,216
39153077AMN,588,224,341,608,269,310,564,270,294,570,287,283,567,273,285,797,401,390
39153077AVN,792,232,506,807,301,487,601,246,355,627,270,357,616,250,354,819,285,522
39153077AWJ,598,170,389,615,237,351,474,203,271,486,229,257,486,212,259,660,255,398
39153077ACZ,535,501,18,542,527,12,400,386,14,411,404,7,400,386,11,481,449,25
39153077BCZ,511,203,271,522,212,284,384,188,196,393,203,190,395,178,195,577,199,370
39153077AVS,575,183,341,601,192,371,441,197,244,444,205,239,451,177,251,668,217,441
39049025BJB,598,197,384,596,258,318,566,235,331,569,281,288,571,260,306,749,335,406
39049025APC,561,230,305,584,269,284,520,255,265,524,278,246,523,268,239,747,356,373
39049025ADX,817,511,279,826,602,172,822,604,218,828,670,158,834,634,190,1118,895,208
39049025AUQ,321,91,213,331,117,191,244,105,139,247,131,116,248,110,133,343,142,195
39049025BNO,492,129,347,499,173,298,451,170,281,453,211,242,459,200,247,618,228,384
39089045AFZ,811,184,589,809,223,537,665,187,478,682,243,439,688,208,459,974,325,628
39089045AFL,529,101,394,531,104,409,412,98,314,422,130,292,418,101,308,580,106,464
39153077AKF,701,350,302,728,397,292,558,357,201,570,385,185,569,340,205,819,511,300
39153077BBC,487,192,280,492,237,242,410,208,202,424,221,203,423,203,214,532,271,256
39153077ATO,638,228,355,671,256,389,517,265,252,522,272,250,528,266,247,704,277,417
39021011ABV,818,192,586,827,246,547,613,172,441,640,255,385,627,184,424,882,261,612
39021011AAK,676,190,446,675,241,400,507,194,313,519,270,249,519,215,286,706,274,424
39051026ABK,675,173,442,688,191,448,521,183,338,527,210,317,530,172,332,732,215,504
39153077AZF,437,294,107,457,333,112,318,257,61,330,268,62,323,249,64,446,320,122
39153077AEQ,649,244,361,667,284,366,508,261,247,524,288,236,517,256,250,736,330,399
39153077ASL,623,256,324,640,257,358,451,218,233,473,238,235,467,211,242,696,275,412
39153077AYZ,602,478,103,615,520,79,519,449,70,531,471,60,526,453,63,644,549,88
39153077AGN,838,368,442,861,490,345,745,419,326,767,472,295,768,426,328,915,545,358
39153077AQY,524,281,215,537,336,187,495,340,155,509,361,148,502,329,151,711,487,218
39153077BCE,625,286,306,653,341,274,552,328,224,571,368,203,565,337,212,762,426,326
39153077AJW,489,206,242,516,237,249,361,191,170,363,218,145,368,203,146,552,244,298
39153077AEG,547,231,278,569,259,280,402,214,188,415,227,188,415,198,192,619,288,318
39153077ADT,317,234,62,326,273,46,207,174,33,214,187,27,211,173,29,265,205,57
39109055AAS,689,126,542,703,164,513,543,159,384,550,211,339,555,158,380,888,241,638
39109055ABF,456,112,322,464,124,302,304,116,188,313,147,166,310,113,185,457,159,286
39093047ALK,732,204,503,739,283,428,588,273,315,605,305,300,605,261,335,744,344,388
39093047AHA,532,144,370,541,206,314,663,289,374,675,330,345,676,283,383,828,338,487
39093047AHM,782,631,128,790,698,70,706,637,69,719,650,69,721,639,74,768,699,68
39099050AKK,658,309,312,678,364,279,535,294,241,538,344,194,544,330,201,698,368,315
39093047ACN,743,306,394,755,345,372,561,288,273,585,347,238,588,298,275,786,345,428
39025013ABC,549,80,441,563,101,440,438,97,341,440,106,334,442,89,340,602,116,478
39007004ADD,655,129,483,682,156,498,487,159,328,498,202,296,497,154,327,718,171,540
39007004ACW,371,136,217,379,133,229,285,109,176,288,138,150,286,106,165,406,118,285
39007004ABN,233,101,101,236,101,112,156,91,65,163,106,57,160,89,63,238,99,138
39007004AER,421,101,298,427,113,294,348,114,234,358,154,204,350,111,217,481,127,345
39025013AFV,764,153,567,780,229,521,604,220,384,599,226,373,607,203,386,830,255,559
39089045AEI,641,148,452,650,171,444,475,137,338,481,174,307,486,141,328,743,214,510
39089045AEG,883,212,622,882,245,586,717,218,499,719,275,444,721,219,485,1045,313,713
39089045AFT,716,358,325,718,407,292,617,370,247,625,414,211,624,378,240,848,517,317
39089045AEA,925,197,671,937,181,728,713,169,544,722,204,518,726,166,538,1089,208,872
39089045AAH,934,223,663,957,307,613,749,265,484,769,347,422,767,288,465,1057,333,711
39089045ACT,1127,225,838,1132,244,846,970,247,723,978,312,666,989,257,699,1324,272,1031
39067034AAM,357,92,253,362,85,259,307,111,196,308,132,176,312,100,202,405,91,310
39067034AAE,773,201,525,779,194,548,625,234,391,636,285,351,636,207,400,822,219,589
39131066AAX,842,302,514,851,262,557,648,262,386,665,322,343,672,269,380,904,261,628
39175088ABL,709,146,528,720,155,534,546,167,379,551,222,329,547,163,353,768,180,577
39087044ABZ,487,173,281,497,156,327,324,128,196,324,145,179,320,122,188,537,203,326
39087044ADE,356,83,258,366,73,277,300,80,220,304,105,199,306,86,206,402,78,316
39087044AAG,132,51,69,136,54,81,76,33,43,81,39,42,80,34,45,128,47,80
39047024AAK,577,126,438,581,149,419,479,138,341,479,180,299,483,151,324,666,191,468
39047024AAO,428,109,300,425,129,279,316,96,220,318,116,202,318,102,210,493,141,343
39047024ABM,653,129,495,654,117,510,535,112,423,530,145,385,531,111,408,709,118,585
39151076ABH,271,127,110,282,139,122,175,101,74,175,112,63,176,92,73,251,118,124
39151076ALC,819,283,472,827,342,438,633,325,308,631,339,292,639,293,313,867,358,495
39151076AAZ,465,267,163,474,279,158,347,230,117,354,240,114,354,221,117,491,317,167
39151076ABA,231,132,74,238,155,69,143,103,40,153,109,44,148,100,42,208,130,72
39151076AEN,755,258,433,772,268,466,521,243,278,523,257,266,524,228,265,760,258,484
39151076AIK,571,150,394,582,201,355,459,186,273,470,207,263,471,174,283,628,249,377
39151076ACM,468,230,195,470,254,181,345,215,130,350,234,116,354,211,125,466,245,208
39151076AAS,388,129,246,394,145,233,286,113,173,296,138,158,292,119,161,446,157,282
39151076AAD,270,181,72,280,201,70,184,140,44,187,149,38,186,136,41,305,197,101
39151076AAQ,478,161,305,473,187,272,367,143,224,376,180,196,373,147,221,519,214,296
39151076AJB,694,199,445,694,200,455,608,228,380,612,260,352,616,222,377,784,229,543
39151076AMG,910,311,567,917,384,505,815,390,425,829,443,386,833,392,428,963,487,466
39049025AEK,566,391,127,583,443,104,485,400,85,484,413,71,489,392,79,627,498,115
39049025AJV,425,233,176,441,266,150,358,248,110,362,270,92,365,253,105,778,525,241
39049025BNL,567,311,237,581,353,199,481,333,148,485,360,125,484,336,140,505,367,132
39049025BAG,690,295,358,715,318,358,514,273,241,519,317,202,523,276,226,768,377,373
39049025AWK,620,201,401,620,276,313,552,267,285,554,300,254,560,280,268,698,380,304
39049025BNG,435,198,224,436,247,169,397,241,156,399,264,135,403,250,145,489,316,166
39049025BKJ,530,239,270,530,298,205,483,292,191,482,321,161,487,298,179,854,568,271
39049025ABN,429,382,34,434,402,19,407,380,27,409,391,18,410,378,24,449,413,30
39049025AXS,613,353,224,642,415,205,504,342,162,513,383,130,518,352,149,761,494,254
39049025ASK,980,455,498,980,544,374,899,499,400,894,559,335,907,518,374,1113,689,407
39049025AYX,405,140,240,421,168,236,297,127,170,299,147,152,302,133,162,454,186,266
39049025AWZ,1131,464,631,1132,578,482,1015,528,487,1015,614,401,1022,557,444,1258,731,512
39153077BCC,560,220,308,602,291,282,476,251,225,495,276,219,489,247,232,619,287,322
39011006AAA,602,86,486,622,121,467,554,145,409,555,187,368,554,137,391,716,133,570
39011006AAR,699,94,580,706,143,532,560,126,434,561,176,385,556,117,425,763,153,594
39007004AAY,378,168,192,389,196,177,291,163,128,305,180,125,303,158,133,444,219,216
39079040AAZ,411,106,287,418,87,321,278,73,205,292,98,194,299,82,211,494,103,387
39079040ABN,339,77,245,347,62,266,250,63,187,251,78,173,255,69,176,374,62,308
39093047ADQ,560,264,261,580,308,245,454,269,185,460,305,155,462,258,184,613,310,293
39093047AEZ,642,484,109,677,554,100,425,354,71,451,395,56,450,364,68,620,437,170
39093047AKP,1042,335,637,1065,401,602,869,377,492,891,451,440,900,369,495,1245,428,792
39093047ACP,810,384,368,824,438,331,629,397,232,650,442,208,647,389,236,912,518,378
39093047AEQ,493,227,219,507,273,213,397,250,147,407,289,118,405,249,144,505,276,225
39093047AHD,538,180,320,560,210,319,447,208,239,462,247,215,458,205,244,612,242,362
39143072ACP,297,70,203,310,99,199,263,95,168,269,126,143,266,102,158,324,95,228
39151076AJO,514,133,346,525,134,367,361,128,233,367,161,206,369,126,222,622,164,447
39153077AYS,452,384,45,471,420,38,288,262,26,297,274,23,292,263,26,357,317,36
39153077BAU,625,200,385,649,239,385,504,223,281,516,248,268,515,230,271,667,244,413
39153077AZY,586,311,228,604,348,231,466,307,159,470,326,144,471,307,148,644,383,249
39153077BBN,661,180,445,678,199,460,583,194,389,605,246,359,602,202,375,729,243,478
39051026AAA,925,237,641,945,287,598,709,282,427,724,373,351,737,285,423,1026,326,681
39175088AAO,488,77,398,495,90,373,386,85,301,388,121,267,392,82,295,538,109,420
39131066AAJ,646,193,420,682,177,483,453,160,293,464,195,269,470,158,294,626,113,507
39131066AAS,239,76,154,244,72,164,169,58,111,176,67,109,172,65,105,262,51,208
39151076ABQ,342,283,37,349,302,37,188,168,20,191,172,19,191,164,19,260,224,29
39151076AFH,778,250,483,784,324,409,628,307,321,641,350,291,645,296,326,827,411,406
39151076AEB,450,159,254,455,192,244,344,172,172,339,187,152,346,172,162,524,207,309
39151076ABB,302,184,76,315,221,66,254,191,63,260,190,70,259,164,76,349,236,106
39151076ADG,398,212,146,410,256,131,306,189,117,316,215,101,314,195,100,425,257,159
39151076AMP,880,306,550,906,351,518,693,308,385,697,342,355,702,305,381,1019,406,594
39151076AEO,776,231,505,797,242,528,666,247,419,667,279,388,670,238,412,1066,325,720
39145073ACR,543,137,395,538,123,406,438,113,325,450,166,284,453,123,326,593,142,444
39175088ABM,558,113,411,567,129,415,440,127,313,440,163,277,448,119,314,608,126,477
39175088AAY,277,39,222,283,39,222,211,44,167,213,56,157,212,39,168,300,44,248
39089045ACV,832,269,539,818,332,442,748,317,431,760,369,391,759,322,417,942,490,437
39079040AAC,549,180,342,557,171,353,379,129,250,386,180,206,394,141,243,567,166,388
39079040ABC,561,189,353,564,153,386,423,137,286,439,186,253,440,153,279,581,154,423
39175088ABE,555,92,444,568,122,424,448,101,347,456,135,321,459,111,340,600,128,465
39089045AAJ,937,301,557,951,324,576,614,239,375,617,289,328,621,239,349,1067,356,699
39089045ADX,1041,221,756,1053,238,769,814,207,607,827,264,563,829,202,584,1132,253,855
39089045ABF,624,202,393,637,229,373,495,191,304,504,236,268,503,204,284,712,268,425
39049025AEI,1154,708,379,1171,824,259,1011,738,273,1014,785,229,1023,759,236,1254,967,266
39049025AWC,774,338,410,771,445,290,662,383,279,660,422,238,671,402,260,804,514,279
39049025BDD,540,164,365,533,261,247,487,221,266,484,272,212,491,246,242,580,345,230
39049025BHC,1131,467,610,1134,591,465,995,549,446,999,624,375,1009,568,415,1241,739,476
39049025AXI,688,346,297,705,396,269,559,327,232,562,369,193,564,333,214,726,416,293
39049025BAV,211,67,137,216,90,119,198,85,113,200,100,100,202,84,113,296,133,160
39049025BMM,399,184,206,397,245,132,460,263,197,461,302,159,468,280,181,543,370,170
39049025AYC,868,400,446,866,534,287,721,429,292,718,495,223,730,452,266,809,555,241
39049025AKQ,547,487,39,565,522,34,403,367,36,411,388,23,410,376,29,552,489,59
39049025AOT,529,395,106,549,453,82,418,333,85,413,343,70,423,337,77,525,403,106
39049025AOW,638,348,272,662,436,191,510,320,190,515,379,136,518,340,166,628,450,171
39049025AYS,513,138,365,505,167,316,426,135,291,424,176,248,431,158,263,548,226,313
39049025ATJ,842,243,574,866,288,539,747,264,483,743,312,431,752,310,428,1038,383,643
39049025BGA,976,358,592,977,461,457,799,411,388,800,458,342,808,430,358,1093,604,472
39049025BJJ,302,119,167,312,133,168,202,101,101,205,114,91,209,104,99,319,122,189
39049025AKH,605,520,57,638,570,51,519,460,59,527,487,40,525,476,41,648,575,64
39049025BNI,73,47,23,72,57,12,67,53,14,67,56,11,70,55,14,757,565,185
39049025ACV,948,624,297,973,759,167,899,715,184,902,750,152,903,719,172,744,594,142
39049025BLB,727,318,379,750,386,307,605,353,252,607,384,223,615,357,241,1023,652,356
39073037AAV,618,198,384,620,180,408,487,182,305,492,226,266,498,189,288,638,205,428
39073037AAT,585,144,409,590,146,421,479,158,321,499,196,303,507,160,332,739,173,557
39041021AFN,701,291,389,728,378,308,620,337,283,616,371,245,623,349,257,817,496,296
39015008ACR,614,101,488,632,126,493,470,99,371,473,126,347,479,105,365,653,103,545
39087044AAI,134,48,82,135,36,90,110,34,76,110,40,70,111,31,78,146,40,106
39087044AAK,115,50,64,115,40,69,90,44,46,89,49,40,92,38,54,118,51,65
39023012AED,745,163,541,749,210,511,553,179,374,569,247,322,559,190,352,740,199,530
39023012AGE,1158,301,818,1146,481,630,976,362,614,992,522,470,982,358,604,1192,505,678
39041021ABB,766,182,570,763,298,438,689,238,451,693,299,394,700,258,437,846,425,414
39041021AAA,224,90,129,226,109,106,355,179,176,352,200,152,364,185,175,473,261,206
39041021AEV,585,240,328,603,300,268,372,209,163,373,232,141,374,221,146,538,321,212
39023012AAH,329,140,166,339,165,155,229,118,111,228,135,93,227,113,105,324,133,174
39151076ABP,334,250,62,337,270,57,257,227,30,258,230,28,259,217,32,325,266,52
39151076ABZ,525,229,252,534,230,269,354,192,162,358,208,150,366,185,157,542,221,308
39151076ALP,825,304,461,845,368,427,680,344,336,682,367,315,688,326,336,921,406,503
39151076ACG,624,363,204,637,411,199,456,335,121,466,355,111,468,319,125,669,383,275
39151076AKT,747,191,495,761,212,510,705,240,465,701,280,421,712,240,439,1042,269,754
39151076AHC,541,180,317,571,252,289,413,207,206,417,226,191,421,205,197,592,291,297
39065033ABE,964,197,690,1000,210,748,736,220,516,741,266,475,738,200,508,1078,218,841
39015008AAF,804,129,631,814,163,626,643,152,491,659,179,480,660,140,502,912,178,725
39015008ACU,681,174,482,690,228,436,505,200,305,511,225,286,512,171,324,708,226,475
39023012AEB,795,153,604,795,193,563,663,188,475,675,259,416,676,197,453,883,216,654
39023012ADZ,1027,226,743,1034,305,691,800,228,572,802,308,494,800,235,538,1151,296,838
39023012ABK,646,237,391,646,327,299,568,269,299,572,322,250,571,262,295,751,385,356
39023012AEV,315,71,231,316,107,200,275,92,183,283,118,165,284,96,177,354,133,216
39023012AAO,501,236,239,502,276,198,306,175,131,316,207,109,310,169,127,516,247,253
39155078AJD,537,175,315,543,225,291,417,211,206,421,250,171,412,213,186,568,245,317
39155078AJK,655,167,443,673,191,437,491,175,316,494,209,285,492,180,292,767,204,550
39155078AJU,573,185,346,588,215,337,384,190,194,395,219,176,392,188,192,595,204,379
39155078AGY,729,265,439,734,296,417,617,282,335,621,325,296,627,275,339,824,352,460
39155078AGW,354,157,173,357,167,185,274,159,115,282,188,94,282,159,112,384,178,197
39145073ACQ,402,90,296,410,73,322,302,74,228,298,99,199,304,70,228,450,75,367
39145073ACU,384,176,191,383,164,198,240,118,122,247,142,105,247,119,116,399,159,235
39145073AAA,388,176,196,390,186,194,307,151,156,307,174,133,311,152,155,397,210,180
39145073ABL,436,173,244,432,160,247,299,126,173,309,162,147,308,124,176,435,153,276
39145073AEC,276,108,154,291,88,194,201,69,132,203,90,113,200,81,117,324,70,249
39145073ACF,421,165,242,421,123,284,352,140,212,359,183,176,360,143,205,417,128,285
39001001AAP,662,161,482,674,165,489,475,149,326,493,179,314,494,161,320,673,145,520
39001001AAG,341,86,239,342,73,258,239,65,174,247,82,165,244,69,166,327,60,266
39161081AAV,311,58,212,341,44,284,250,40,210,251,49,202,247,43,198,386,50,330
39161081ABF,517,92,402,521,74,431,413,75,338,416,99,317,417,79,320,588,114,465
39161081ABO,419,48,349,423,49,358,344,46,298,341,63,278,345,46,293,435,53,380
39011006AAW,660,86,542,669,106,522,503,94,409,497,137,360,503,80,410,694,131,553
39137069ABH,1006,146,824,1000,165,786,748,177,571,757,265,492,760,161,576,1055,212,824
39161081ABD,675,141,500,696,128,544,546,116,430,565,153,412,550,110,425,774,151,616
39071036AAJ,703,167,508,718,212,475,505,178,327,504,202,302,510,161,330,818,245,559
39023012AEK,776,176,550,787,211,526,571,178,393,572,233,339,577,166,379,809,228,570
39169085ACE,879,281,538,885,283,558,713,272,441,728,308,420,733,273,433,1015,317,672
39153077ARK,723,248,451,731,335,371,655,330,325,675,360,315,664,335,319,801,393,403
39039020AAW,674,150,483,682,133,497,517,148,369,516,179,337,526,137,369,692,156,526
39039020ABK,495,72,394,507,64,421,393,62,331,391,84,307,394,64,323,559,79,472
39153077AZI,594,237,322,610,284,306,446,228,218,456,268,188,457,237,202,692,325,358
39153077AIG,644,385,219,663,430,209,491,341,150,502,367,135,501,342,146,654,439,206
39153077ADD,599,552,30,613,584,22,464,450,14,474,460,14,463,443,17,571,546,24
39153077AUF,621,192,400,657,260,369,545,248,297,558,283,275,560,244,302,693,299,391
39153077AYA,675,209,448,680,312,338,616,277,339,623,306,317,621,270,342,757,395,355
39153077ADU,398,331,49,414,352,47,332,298,34,338,309,29,336,294,33,426,358,64
39153077BBW,624,230,352,666,292,334,548,282,266,558,312,246,562,281,266,764,355,396
39153077AVH,584,169,369,613,179,406,467,233,234,480,250,230,479,223,232,737,248,484
39153077AZU,606,278,271,625,303,289,419,254,165,429,281,148,425,244,165,656,304,343
39159080ABW,812,112,670,809,158,606,711,135,576,713,174,539,714,149,551,930,218,698
39159080ABJ,581,94,456,589,112,438,501,116,385,501,156,345,505,114,366,666,170,484
39153077ARS,622,164,419,644,181,425,506,188,318,522,208,314,517,186,307,700,207,476
39153077AYY,596,539,37,609,569,30,460,437,23,471,455,16,462,439,20,561,529,29
39055028ABI,738,195,511,762,260,480,635,262,373,660,295,365,652,247,387,840,312,524
39043022ACX,898,222,621,905,283,564,742,260,482,739,310,429,747,266,448,1012,328,667
39055028ACO,666,222,421,657,327,297,576,296,280,592,326,266,596,292,293,732,429,292
39019010ABG,581,157,379,589,171,387,447,161,286,457,207,250,458,147,295,675,171,493
39019010ABH,472,112,323,481,106,354,375,126,249,377,153,224,373,114,235,484,81,400
39019010AAY,528,111,386,527,111,383,412,128,284,412,147,265,415,122,279,593,125,461
39019010AAL,667,212,402,689,226,415,484,196,288,481,232,249,477,194,253,742,214,504
39019010AAJ,461,129,292,476,171,279,371,164,207,375,188,187,377,169,191,509,179,326
39055028ABT,692,163,475,695,235,434,595,217,378,598,262,336,604,208,377,790,261,519
39065033AAQ,300,40,246,305,51,241,263,62,201,263,84,179,261,54,199,317,43,271
39133067ACG,775,361,384,795,409,368,648,372,276,651,390,261,650,347,286,962,493,460
39153077AMC,617,291,297,628,324,272,514,293,221,520,318,202,523,296,213,674,366,301
39153077AYQ,446,261,144,452,294,131,318,220,98,327,231,96,326,205,102,421,278,135
39153077AFK,603,314,256,626,356,236,491,318,173,505,346,159,502,313,173,657,422,219
39153077ABJ,497,277,173,511,318,166,402,282,120,406,301,105,407,283,111,583,364,208
39153077ACB,495,442,33,509,482,21,366,344,22,380,361,19,375,352,17,418,387,21
39153077BCH,690,260,411,707,351,341,633,373,260,647,388,259,645,359,279,821,445,370
39153077AQW,580,331,226,602,407,178,498,362,136,511,386,125,502,350,135,683,511,163
39143072ABH,453,148,275,467,193,249,348,170,178,355,197,158,352,164,174,487,198,271
39143072ADJ,547,107,407,559,148,378,422,133,289,429,185,244,418,146,252,583,164,410
39087044ABA,116,37,75,131,27,101,97,28,69,95,31,64,99,28,70,127,27,99
39087044ABP,135,43,89,135,45,85,86,36,50,89,40,49,89,35,53,119,30,88
39087044AAC,128,56,61,134,44,85,90,42,48,92,52,40,91,40,46,112,34,76
39015008ACK,340,60,265,349,73,267,212,50,162,227,68,159,231,54,170,313,51,259
39123062AAD,730,249,429,750,333,362,568,291,277,577,338,239,571,296,258,817,381,421
39123062AAW,704,216,447,710,256,403,577,255,322,583,315,268,579,248,301,757,244,497
39123062ABC,650,154,485,662,204,427,592,195,397,599,242,357,600,192,397,743,241,496
39123062AAL,578,217,326,602,284,283,451,241,210,452,272,180,454,228,204,649,316,317
39123062ABP,458,142,291,459,176,253,343,157,186,346,174,172,348,162,178,487,188,287
39149075AAL,403,79,308,405,104,282,332,90,242,335,116,219,333,86,231,428,104,319
39133067AFQ,614,181,387,653,231,390,576,231,345,579,267,312,589,228,327,722,248,459
39133067AFT,498,126,334,528,169,323,419,163,256,421,192,229,424,165,243,595,168,418
39159080AAA,654,159,459,670,210,413,548,198,350,552,238,314,560,194,338,638,216,410
39159080ABZ,326,81,227,328,105,201,273,97,176,274,119,155,275,95,166,574,204,356
39151076ANC,606,159,416,609,196,387,525,215,310,529,243,286,534,214,313,559,220,326
39151076ALN,977,263,659,994,309,635,694,279,415,708,325,383,711,271,421,1066,353,698
39151076ALO,416,151,238,411,177,217,315,159,156,322,180,142,318,157,148,439,193,240
39151076AAK,700,299,355,711,321,351,509,253,256,511,285,226,514,249,242,738,329,394
39105053ABA,310,83,213,328,55,259,242,46,196,243,76,167,250,60,186,325,59,262
39105053AAZ,383,77,288,401,62,328,343,52,291,353,85,268,354,72,279,489,66,419
39105053AAH,391,105,267,403,94,298,328,92,236,342,119,223,338,97,234,449,102,341
39105053AAF,354,121,221,370,97,252,270,84,186,280,107,173,285,94,186,424,97,324
39157079ADV,546,124,395,553,122,406,435,109,326,441,136,305,439,116,312,589,118,466
39157079ADT,354,79,249,362,75,268,259,85,174,264,109,155,263,86,165,370,71,297
39157079ADO,414,109,270,419,114,285,262,99,163,268,113,155,264,91,158,438,104,331
39157079ABQ,321,108,172,325,116,182,208,100,108,211,104,107,208,93,102,354,114,234
39157079ACP,244,71,150,255,70,171,183,68,115,186,74,112,181,69,105,264,58,201
39151076AAW,545,271,235,550,288,216,391,244,147,399,269,130,401,236,145,594,330,239
39137069AAV,549,116,410,551,123,392,388,103,285,392,161,231,398,96,289,566,131,421
39161081AAO,465,87,344,492,103,361,355,83,272,354,106,248,358,84,265,493,114,365
39161081ABA,264,42,211,269,43,220,256,26,230,260,56,204,256,31,218,340,60,273
39161081ABK,362,35,307,371,39,318,295,34,261,297,51,246,297,36,253,425,46,371
39161081AAG,233,51,172,238,47,176,165,51,114,164,58,106,164,41,112,244,71,166
39161081AAS,365,84,263,373,87,275,293,78,215,305,100,205,304,75,225,402,103,290
39099050AKW,411,149,249,422,168,243,340,151,189,344,188,156,348,170,167,447,191,255
39029015AEZ,417,124,252,426,123,275,304,119,185,319,149,170,311,124,176,469,114,341
39029015ABX,539,89,433,544,95,429,469,97,372,473,137,336,473,102,361,589,111,465
39029015AAL,450,180,222,468,175,269,333,158,175,344,176,168,340,151,179,542,195,341
39029015ABY,738,154,548,749,177,540,620,185,435,634,223,411,632,190,415,818,198,610
39099050AOA,507,186,290,526,219,278,372,169,203,385,200,185,387,183,184,511,187,314
39099050AAB,343,241,84,347,272,65,243,191,52,252,208,44,252,196,42,349,250,93
39029015AFE,386,66,299,399,74,309,286,57,229,292,78,214,293,66,215,418,63,343
39029015ADP,452,119,301,472,93,363,364,99,265,375,130,245,378,104,258,514,115,399
39029015ACS,652,205,409,673,214,431,481,197,284,493,248,245,495,210,268,712,246,451
39043022AED,779,434,301,789,510,235,555,367,188,563,399,164,560,341,191,772,481,276
39055028ACK,444,69,350,443,96,333,358,82,276,360,96,264,367,79,279,509,92,412
39055028AAC,758,168,551,770,254,488,653,241,412,664,278,386,664,241,404,876,337,531
39043022AEA,573,274,266,583,317,241,464,285,179,464,305,159,469,280,173,572,303,257
39043022AEE,638,355,229,653,405,202,472,319,153,476,335,141,473,302,156,617,385,217
39143072AAO,408,164,203,414,208,169,279,154,125,282,173,109,283,156,108,388,202,176
39143072ACX,749,188,504,757,205,508,571,187,384,590,246,344,589,206,350,833,199,617
39111056AAI,572,243,301,591,198,366,410,209,201,426,251,175,413,181,224,590,177,407
39151076AEM,694,277,364,710,307,357,513,267,246,516,301,215,521,253,240,776,319,441
39151076AFN,628,147,440,638,163,442,475,170,305,482,199,283,484,154,317,665,185,467
39161081ABI,455,78,352,468,67,388,379,65,314,386,87,299,378,66,306,515,80,433
39011006AAM,336,63,254,334,73,241,245,74,171,243,86,157,243,71,166,379,99,268
39137069AAX,718,171,516,720,183,493,527,153,374,531,219,312,538,139,385,713,191,504
39161081AAY,468,77,373,473,59,398,381,46,335,383,68,315,379,51,318,507,75,429
39161081AAL,345,90,230,358,91,254,273,70,203,278,81,197,277,75,190,401,101,295
39011006AAC,493,111,361,502,126,351,443,124,319,445,174,271,447,129,300,527,130,391
39041021AGH,594,172,409,588,252,310,591,273,318,589,322,267,598,288,297,702,378,312
39041021ACG,552,159,380,546,235,286,566,219,347,568,272,296,568,239,324,652,312,334
39041021AEE,646,177,442,650,262,349,668,273,395,673,324,349,682,285,382,869,421,437
39041021AAR,830,343,452,830,424,357,735,355,380,731,436,295,741,377,340,919,510,393
39157079ABY,377,60,310,386,67,310,288,59,229,294,67,227,290,53,227,398,58,340
39017009AJW,805,200,589,821,305,474,694,287,407,709,318,391,712,284,407,903,416,474
39039020AAH,467,183,245,470,189,244,320,148,172,323,177,146,327,157,159,499,195,293
39125063AAJ,679,214,412,686,171,483,539,158,381,548,177,371,544,160,374,721,188,523
39133067AAM,716,185,507,717,292,399,625,267,358,620,280,340,628,258,357,829,380,440
39085043AFA,785,315,424,817,362,414,639,345,294,647,389,258,649,306,316,926,436,482
39149075ABZ,724,78,612,726,125,584,600,114,486,604,154,450,605,128,459,743,129,606
39049025BKL,765,294,437,791,390,348,637,363,274,639,399,240,638,370,252,985,581,388
39159080ABL,912,184,694,914,231,628,790,191,599,796,256,540,805,204,571,1049,281,739
39159080ABT,411,76,310,420,87,312,316,78,238,315,105,210,318,79,221,436,89,333
39157079AAK,506,193,288,526,214,274,435,204,231,446,242,204,447,224,206,537,214,320
39055028ACE,677,193,461,693,274,386,618,284,334,626,330,296,627,264,349,892,415,470
39055028ACR,752,213,511,762,295,442,682,280,402,688,302,386,689,271,401,864,354,501
39041021AAO,489,165,304,488,201,254,368,169,199,375,206,169,378,186,178,505,252,239
39041021AEA,903,262,629,909,393,469,840,327,513,837,398,439,845,348,486,1014,493,511
39023012ADM,740,137,577,727,199,509,591,168,423,604,219,385,605,158,430,751,211,529
39023012AEI,804,169,602,802,224,538,611,191,420,616,256,360,614,184,411,824,252,564
39023012AFQ,724,197,500,726,244,448,600,225,375,606,292,314,606,213,374,716,251,453
39023012AAJ,490,159,298,505,202,280,358,154,204,353,184,169,355,146,198,472,202,262
39173087AAS,686,253,416,678,302,342,591,295,296,598,352,246,606,303,290,718,374,335
39173087ADV,375,89,261,385,104,254,289,107,182,289,132,157,291,99,183,412,117,285
39099050AQY,783,377,370,809,413,367,636,369,267,649,440,209,644,385,243,836,437,391
39029015ABZ,583,97,455,600,105,473,422,85,337,477,138,339,486,109,358,647,130,508
39029015AEJ,571,182,354,585,169,392,446,156,290,450,175,275,445,151,279,664,165,490
39099050AFR,456,404,32,480,448,26,334,300,34,341,318,23,334,297,30,427,372,48
39157079AEU,447,131,300,452,153,286,366,163,203,360,184,176,363,158,199,493,156,327
39037019ABU,586,89,471,604,107,485,452,83,369,449,108,341,455,79,361,646,103,535
39037019AAJ,359,78,251,371,88,256,239,74,165,238,95,143,240,75,150,387,108,260
39041021ACD,578,134,432,569,221,325,538,195,343,541,229,312,553,206,332,660,289,362
39041021AAM,504,301,175,525,369,124,287,188,99,293,209,84,292,189,93,279,169,101
39041021AAL,515,211,279,527,254,227,388,188,200,386,222,164,388,199,180,577,286,274
39143072ADB,375,68,282,379,92,260,306,86,220,303,113,190,312,82,211,427,101,319
39133067AEQ,431,100,301,444,104,322,326,97,229,323,124,199,325,100,213,457,109,345
39023012AEG,690,147,514,687,213,434,605,187,418,609,254,355,614,195,404,757,268,475
39049025BKW,829,315,483,837,397,400,810,407,403,809,459,350,816,415,385,1138,618,507
39049025ADA,1013,573,419,1010,730,240,904,634,270,909,716,193,914,673,226,1349,1039,289
39049025BGC,638,276,324,637,339,264,556,324,232,560,374,186,564,345,206,717,452,261
39049025BBM,585,290,253,601,355,219,407,225,182,410,261,149,414,240,165,551,312,232
39049025BBK,687,240,385,717,297,382,506,242,264,511,283,228,518,257,252,736,319,400
39049025ADM,716,642,44,777,742,21,499,479,20,512,502,10,509,473,20,705,663,29
39049025AAN,762,481,222,779,559,182,657,492,165,658,533,125,661,511,141,894,690,195
39049025AAZ,596,410,146,625,469,126,448,359,89,453,386,67,454,360,81,645,501,131
39049025ACO,480,231,228,487,255,212,365,195,170,370,234,136,370,214,139,508,256,238
39049025ANL,738,398,313,744,465,256,663,421,242,666,463,203,668,441,219,802,536,256
39099050AFP,400,352,35,409,391,16,289,270,19,292,278,14,289,268,19,345,320,21
39029015AED,470,126,323,498,118,361,388,115,273,394,143,251,393,108,269,515,121,383
39029015ABR,461,193,240,476,201,252,316,161,155,336,187,149,323,144,164,516,192,321
39041021AAW,549,191,324,574,256,287,482,218,264,482,258,224,481,232,237,792,350,425
39041021ABL,502,124,357,513,148,341,502,152,350,507,199,308,512,176,320,988,358,609
39041021AFF,873,199,658,862,304,517,817,267,550,818,327,491,830,296,513,1074,478,585
39173087AEE,999,320,647,1016,408,562,790,330,460,796,389,407,806,344,436,1336,616,709
39017009AKO,710,129,550,713,162,520,548,138,410,556,161,395,558,135,414,765,186,574
39017009AFA,517,270,211,536,349,149,361,280,81,365,297,68,359,276,72,440,333,99
39017009AAB,725,284,408,747,354,366,554,287,267,584,319,265,580,295,262,795,404,384
39017009AED,709,164,516,715,243,455,567,194,373,579,229,350,582,198,370,761,243,502
39017009ABH,700,170,493,721,236,459,640,235,405,656,265,391,648,227,409,845,321,511
39017009ADB,536,154,358,551,178,357,374,152,222,392,177,215,389,150,231,593,213,370
39017009ADL,741,152,552,759,210,519,575,185,390,589,205,384,590,173,393,800,237,557
39017009AFQ,476,113,341,504,169,312,354,125,229,367,150,217,359,125,223,541,187,340
39017009AAP,509,132,341,523,179,313,397,154,243,405,169,236,404,138,250,526,171,344
39017009ALX,703,129,558,700,198,468,554,165,389,567,217,350,565,171,385,692,233,453
39017009ADU,328,114,189,346,150,190,207,92,115,217,103,114,214,91,117,415,140,273
39173087AAF,609,357,186,622,406,145,457,330,127,464,345,119,463,309,115,588,391,168
39071036ABL,448,99,329,453,95,344,324,89,235,333,114,219,335,89,237,493,86,403
39161081ABJ,457,53,351,460,57,389,362,55,307,359,82,277,363,57,300,491,68,420
39011006AAB,397,70,308,401,84,301,309,82,227,312,110,202,311,82,214,415,89,318
39039020AAE,597,219,350,614,257,325,462,219,243,471,255,216,470,211,237,709,332,364
39039020ABJ,416,111,271,417,103,300,341,88,253,348,111,237,347,91,243,466,92,364
39039020ABC,409,126,262,416,105,286,275,98,177,279,108,171,284,95,172,474,113,350
39039020ABR,761,203,516,793,204,528,586,197,389,593,256,337,598,194,378,872,238,621
39065033AAN,369,65,290,370,74,282,294,84,210,292,102,190,292,71,210,392,74,313
39071036AAS,679,113,543,687,111,554,490,104,386,496,129,367,500,107,379,759,126,627
39071036ABO,718,104,598,722,111,591,531,111,420,534,134,400,538,103,421,745,109,630
39039020AAI,802,286,469,825,341,424,568,294,274,571,334,237,578,291,265,857,370,464
39039020ABH,642,153,464,650,158,470,495,151,344,508,203,305,507,141,345,677,167,504
39125063AAE,334,54,261,337,41,285,247,39,208,252,54,198,249,40,202,324,50,270
39125063AAX,418,77,322,430,58,357,309,66,243,308,80,228,304,67,224,459,61,387
39125063AAU,521,158,335,536,110,394,408,100,308,417,112,305,419,97,316,541,112,420
39039020AAF,501,190,273,495,202,242,359,168,191,363,192,171,365,162,184,514,226,275
39051026ABF,881,186,659,880,207,613,679,184,495,684,249,435,691,185,492,952,204,739
39051026AAE,974,153,782,964,197,722,774,173,601,771,226,545,782,173,594,1125,252,863
39153077AZC,419,381,24,433,402,25,292,277,15,302,289,13,293,272,15,365,324,37
39153077ACA,529,402,100,543,454,80,444,389,55,459,405,54,452,383,57,570,484,78
39153077AHC,736,303,415,758,404,322,653,358,295,666,400,266,661,359,294,826,486,337
39153077ADV,430,336,63,437,375,50,278,239,39,287,257,30,281,242,34,378,292,76
39153077APQ,656,279,348,668,349,303,561,297,264,573,349,224,572,309,252,693,367,322
39017009AIX,747,219,511,758,305,415,606,246,360,618,274,344,620,250,358,827,390,428
39173087ACR,487,141,317,487,176,265,389,158,231,388,203,185,398,157,228,550,198,340
39173087ABX,592,165,380,598,170,386,392,147,245,400,183,217,401,142,239,604,176,420
39173087AAB,612,336,211,637,394,191,391,272,119,391,284,107,396,261,114,506,370,129
39173087AAA,460,230,190,480,290,151,317,228,89,327,252,75,325,218,90,428,271,145
39173087ADA,728,226,483,744,281,414,579,243,336,583,285,298,593,235,346,799,369,416
39153077ALN,441,246,162,454,261,164,335,211,124,339,227,112,342,208,121,422,259,152
39153077AZN,605,358,211,632,411,207,468,329,139,483,354,129,475,318,141,604,389,210
39039020AAZ,464,94,354,478,96,363,358,68,290,363,116,247,367,76,277,526,104,414
39125063AAM,712,276,378,729,229,449,559,214,345,568,239,329,563,218,321,778,262,495
39153077ARW,736,364,333,752,430,301,639,411,228,657,439,218,653,399,241,882,538,338
39071036AAL,483,138,322,491,153,316,293,105,188,289,115,174,298,103,185,482,159,313
39125063ABD,582,186,366,579,154,401,428,135,293,437,157,280,444,146,289,597,169,415
39125063AAO,601,168,394,624,148,451,462,121,341,465,145,320,465,122,324,654,130,512
39153077AFF,552,316,191,579,359,191,432,288,144,443,314,129,438,279,140,619,347,258
39153077AHP,471,233,202,484,271,195,355,225,130,364,243,121,366,219,126,479,252,214
39071036ABB,363,50,292,374,65,298,274,66,208,274,83,191,278,58,212,390,60,323
39153077AMO,875,275,579,889,361,492,809,370,439,841,425,416,840,359,458,1166,562,593
39153077APX,640,190,414,662,249,382,578,242,336,588,283,305,588,252,319,694,287,398
39153077ADB,614,574,24,620,593,18,497,483,14,507,497,10,498,481,9,619,593,23
39137069AAK,904,139,731,914,139,748,711,137,574,718,216,502,721,127,584,970,115,838
39153077ALF,584,275,265,606,316,266,467,296,171,490,325,165,488,284,186,685,358,315
39153077AWP,755,240,475,788,295,443,603,277,326,629,314,315,615,282,312,870,350,505
39153077AJT,401,188,175,415,191,194,310,184,126,315,193,122,315,180,116,472,238,220
39153077ADY,517,426,59,534,467,54,390,352,38,397,354,43,401,349,40,483,412,63
39017009ABT,413,146,244,429,182,223,284,135,149,283,142,141,287,126,141,435,182,239
39017009ADR,463,322,122,480,369,89,323,269,54,336,285,51,337,275,57,454,339,108
39017009AHK,548,55,472,564,64,486,431,59,372,441,76,365,438,57,375,605,76,527
39137069AAC,811,92,701,811,91,688,657,90,567,663,153,510,672,86,572,872,95,762
39137069ABR,787,88,678,784,128,631,646,112,534,664,185,479,667,107,547,847,137,695
39137069ABF,975,75,874,982,84,860,831,95,736,835,160,675,841,84,739,1078,112,948
39173087AAQ,614,186,406,599,243,310,493,222,271,501,262,239,511,223,271,699,324,360
39173087ABU,465,133,296,457,163,241,359,160,199,361,197,164,364,161,187,524,224,292
39153077ALE,444,241,170,459,257,172,328,230,98,335,239,96,329,219,96,587,369,204
39051026AAF,626,166,440,653,197,412,483,172,311,485,213,272,490,166,309,719,209,494
39153077BCL,857,258,555,860,352,466,720,302,418,733,341,392,736,307,411,966,432,518
39153077ALA,633,252,340,638,310,302,545,309,236,561,335,226,560,304,240,732,401,322
39153077AYP,609,344,223,641,406,201,488,330,158,499,356,143,501,338,145,726,436,271
39153077BAT,700,190,475,742,251,472,582,231,351,596,245,351,596,220,352,824,287,526
39153077AZS,594,239,337,613,310,284,549,308,241,570,344,226,557,298,252,657,393,264
39153077AKC,424,176,206,433,175,229,303,163,140,315,170,145,314,157,144,509,184,310
39153077AWN,706,211,456,728,298,398,583,252,331,603,294,309,597,249,322,757,343,407
39051026AAK,806,178,588,820,215,551,613,180,433,614,238,376,619,182,416,887,215,657
39099050ASQ,202,95,101,209,96,106,147,66,81,153,88,65,151,77,73,207,90,117
39029015ADB,586,100,456,590,117,449,446,110,336,460,146,314,455,121,324,623,115,492
39071036ABC,492,93,365,502,94,386,382,95,287,383,126,257,385,95,279,533,119,411
39031016ABF,772,163,579,780,162,581,608,163,445,608,209,399,613,163,423,842,171,655
39031016ABI,906,219,631,911,268,594,682,258,424,687,299,388,695,246,410,994,276,693
39031016ABH,592,148,393,603,166,407,401,137,264,406,165,241,400,128,252,642,143,485
39031016AAD,477,145,299,471,174,267,355,164,191,360,195,165,358,164,183,510,194,310
39031016AAI,812,209,568,827,265,529,673,242,431,681,301,380,683,229,436,842,260,569
39031016ABG,553,87,428,563,104,444,421,81,340,420,109,311,423,88,327,646,102,540
39061031AOM,803,285,474,806,351,401,690,368,322,693,384,309,697,347,327,881,490,373
39061031ACB,1120,550,516,1160,765,339,917,644,273,921,669,252,928,610,274,1144,833,283
39061031ARJ,754,444,278,756,525,207,618,428,190,624,449,175,622,411,193,766,557,200
39061031BJL,506,160,309,520,184,311,369,157,212,365,168,197,372,139,224,519,212,299
39061031AQE,830,379,410,847,478,320,686,432,254,688,473,215,698,427,245,910,602,294
39061031ADW,1054,435,581,1065,622,370,883,577,306,883,616,267,894,559,300,1153,770,355
39061031ATG,608,154,438,595,269,292,569,259,310,578,302,276,578,257,306,706,396,303
39061031AZS,595,156,426,602,241,335,529,217,312,533,243,290,536,221,298,661,287,362
39061031AEH,608,310,278,606,386,192,597,384,213,597,411,186,599,393,198,656,453,197
39061031ATT,504,148,347,500,232,244,472,237,235,480,253,227,481,223,247,525,289,231
39061031AVW,338,163,154,350,207,122,243,157,86,242,167,75,243,152,76,343,211,125
39061031BDI,335,182,144,334,239,80,335,247,88,343,256,87,342,240,95,365,286,77
39061031AEM,595,435,127,613,512,69,525,456,69,524,466,58,527,448,65,643,548,81
39061031BMR,655,198,447,657,296,336,598,292,306,603,316,287,604,288,303,705,368,329
39061031BAM,656,187,461,657,282,327,582,262,320,586,299,287,590,264,310,714,397,312
39061031BBN,812,318,457,836,397,404,634,341,293,642,370,272,644,323,298,867,444,414
39061031AZA,1010,223,770,990,311,635,870,295,575,869,335,534,879,300,551,1145,470,662
39061031AUE,635,341,271,653,406,228,540,358,182,545,377,168,541,349,181,728,492,229
39167084ACW,808,240,540,827,163,637,646,173,473,675,247,428,686,173,495,922,197,719
39061031ATO,968,274,674,953,368,540,872,359,513,870,387,483,877,350,514,1040,539,485
39077039ABW,267,61,184,271,66,187,205,62,143,206,77,129,208,63,135,320,75,233
39013007AAF,728,300,405,737,268,433,525,276,249,531,313,218,526,242,275,731,268,451
39013007AAX,379,111,255,383,115,263,304,136,168,310,169,141,315,127,180,410,116,290
39061031AUO,716,429,254,728,490,208,543,396,147,548,414,134,552,386,144,765,548,203
39061031AIX,742,575,142,767,675,77,696,617,79,699,634,65,698,608,84,801,708,84
39061031ABY,769,495,240,787,597,155,697,550,147,712,577,135,716,529,165,1006,779,213
39061031BCG,1077,234,811,1089,326,727,881,279,602,884,347,537,896,290,587,1128,388,724
39005003ABS,702,171,478,710,197,474,552,198,354,560,229,331,573,188,353,788,242,535
39013007ABD,214,63,141,218,61,148,168,60,108,168,78,90,169,58,105,234,62,169
39013007ABY,180,74,93,185,66,113,141,60,81,139,72,67,140,54,82,202,69,129
39127064ABR,627,230,360,621,241,353,441,204,237,442,232,210,456,210,224,656,218,428
39127064AAX,363,106,238,370,131,229,279,98,181,288,123,165,289,104,175,433,124,307
39083042ABV,208,58,131,208,61,135,153,47,106,155,67,88,154,55,98,246,62,183
39005003ABO,885,213,624,900,240,610,687,245,442,694,272,422,693,222,431,1027,303,703
39013007ABW,499,174,294,515,174,320,369,174,195,369,199,170,371,147,212,523,141,369
39013007ACT,171,30,137,170,33,130,128,38,90,131,48,83,132,29,97,190,33,156
39083042AAZ,717,163,513,719,185,478,549,159,390,554,198,356,552,165,370,814,234,565
39127064AAC,639,160,438,639,170,442,503,157,346,511,208,303,516,153,332,722,163,539
39061031AKZ,125,70,49,132,90,39,83,62,21,84,66,18,84,58,21,138,82,51
39129065ACC,570,130,415,577,128,425,514,153,361,509,183,326,517,171,327,898,228,651
39057029AIZ,853,200,633,839,261,552,846,287,559,844,332,512,853,265,572,1175,432,733
39083042ABN,561,104,433,556,118,423,473,107,366,474,135,339,474,115,351,649,131,514
39081041AAF,680,280,348,681,283,363,534,272,262,540,292,248,539,255,262,740,310,416
39103052AAU,740,230,464,765,302,432,560,276,284,570,298,272,571,267,299,814,343,463
39103052AES,883,274,578,902,357,500,773,361,412,791,399,392,791,358,418,1079,470,593
39127064AAK,506,157,316,508,165,322,312,128,184,319,151,168,320,125,179,514,153,354
39127064AAI,322,82,224,326,90,223,241,73,168,244,92,152,247,70,169,403,88,312
39127064AAV,546,192,330,556,165,370,409,151,258,422,190,232,425,159,249,568,144,419
39103052AAZ,607,222,341,624,263,330,444,235,209,465,268,197,468,235,217,670,289,368
39103052ADP,929,198,664,956,239,664,715,229,486,736,262,474,741,210,505,1009,251,747
39009005AAE,707,368,312,824,439,329,281,215,66,293,240,53,292,217,59,50,36,13
39103052AAQ,820,282,496,838,343,462,594,289,305,615,321,294,615,283,323,1016,441,554
39103052AGC,452,133,300,466,173,275,385,176,209,400,197,203,399,170,221,882,346,530
39103052AAG,791,227,538,821,300,488,662,294,368,686,314,372,691,286,391,1000,362,630
39103052AER,993,250,715,1002,353,616,897,335,562,910,380,530,919,334,561,1149,439,703
39063032ACE,664,102,534,680,99,533,501,93,408,500,135,365,515,80,423,713,117,584
39063032AAW,383,119,236,392,145,198,285,142,143,294,163,131,300,145,142,398,194,196
39103052AEJ,863,201,602,887,246,613,669,236,433,695,284,411,692,229,438,1000,272,717
39063032ABW,676,81,570,696,96,573,550,100,450,549,132,417,560,87,459,723,117,599
39121061AAH,149,40,98,159,26,130,125,26,99,125,36,89,129,29,98,158,15,142
39083042AAX,390,322,51,401,363,28,324,258,66,331,275,56,327,261,58,304,241,57
39083042ACH,617,510,82,631,575,42,359,347,12,366,357,9,365,344,10,253,239,13
39083042AAA,579,199,351,575,231,318,485,197,288,491,230,261,493,208,270,605,262,335
39119060ABJ,407,90,297,408,93,299,329,100,229,336,130,206,337,95,231,444,115,326
39119060AAZ,482,112,343,492,125,357,380,134,246,377,163,214,379,137,225,565,148,412
39119060ACA,98,11,83,99,6,89,75,7,68,75,18,57,76,10,66,110,9,99
39119060AAQ,414,156,238,419,187,213,336,170,166,336,202,134,337,171,155,459,212,238
39115058AAB,463,95,346,472,95,364,354,89,265,365,118,247,368,94,267,516,103,409
39059030ABX,467,78,367,482,69,399,356,84,272,359,109,250,361,85,265,508,73,432
39135068AAY,522,90,406,536,107,413,444,106,338,451,128,323,452,100,331,573,105,464
39135068AAM,414,75,312,421,86,317,312,83,229,307,95,212,312,76,219,429,75,345
39135068AAU,329,57,256,337,74,256,249,57,192,248,75,173,248,55,175,381,79,296
39035018BCZ,380,219,121,412,277,116,292,206,86,296,224,72,291,189,89,448,281,159
39035018CIP,712,381,274,742,429,270,529,345,184,533,375,158,538,327,180,774,433,328
39035018CLQ,706,272,379,742,338,367,563,341,222,577,370,207,576,311,247,837,394,432
39035018ANZ,205,161,27,235,220,12,230,209,21,234,218,16,233,192,30,262,230,30
39035018BTM,472,313,130,495,345,136,365,279,86,371,299,72,376,270,96,473,335,135
39035018AYP,156,110,29,172,140,26,90,76,14,94,81,13,95,74,15,122,88,32
39035018CGX,425,192,197,456,245,185,343,209,134,348,235,113,355,197,147,489,260,220
39035018AGJ,575,257,273,617,301,289,436,260,176,445,285,160,445,248,178,655,322,323
39035018CLB,638,249,344,660,303,328,507,285,222,517,310,207,521,276,230,729,348,365
39035018AKE,430,395,17,460,453,6,309,300,9,316,306,10,317,302,10,417,404,9
39035018CWQ,665,500,145,669,575,70,592,513,79,597,531,66,603,506,85,725,622,97
39035018AHU,487,452,17,531,521,6,343,332,11,345,336,9,344,327,10,445,425,18
39035018BJG,726,358,323,741,428,289,643,427,216,651,457,194,655,407,227,858,535,308
39035018AZM,579,432,111,595,509,60,558,490,68,561,504,57,568,474,69,694,585,98
39035018BIU,420,231,149,454,281,154,323,216,107,326,232,94,328,212,110,470,280,182
39035018AWO,635,464,136,662,532,114,521,445,76,524,457,67,526,429,87,637,517,113
39035018ATR,288,264,6,313,306,3,191,185,6,195,192,3,196,186,7,230,217,8
39091046AAN,681,180,470,695,229,429,460,170,290,471,209,262,468,171,274,774,251,508
39091046ABS,386,75,297,383,90,287,330,89,241,333,122,211,332,92,227,408,120,286
39035018DBX,769,227,526,744,331,391,676,326,350,678,338,340,676,291,380,806,401,395
39035018AVL,363,326,19,377,359,13,249,235,14,246,239,7,251,240,9,309,293,11
39035018CJU,676,233,402,717,301,390,576,313,263,577,333,244,585,290,270,785,337,444
39035018AKX,340,312,15,356,350,5,266,256,10,266,264,2,270,249,16,284,272,11
39035018CKL,714,254,419,749,329,388,598,303,295,615,352,263,612,272,308,849,378,458
39035018CGF,847,271,548,890,368,480,678,303,375,696,344,352,699,301,389,926,414,501
39035018CAS,742,633,72,779,721,51,562,514,48,554,519,35,563,517,39,755,687,63
39035018CDI,961,355,541,994,447,496,822,431,391,829,466,363,827,410,392,1049,547,491
39035018CST,1019,534,459,1060,661,356,890,596,294,900,629,271,902,579,304,1119,726,386
39035018BMS,418,378,24,448,428,14,263,249,14,261,252,9,265,249,10,316,296,19
39035018CMD,784,307,436,828,372,409,652,356,296,662,389,273,662,339,303,870,401,456
39035018CWG,911,322,540,941,404,507,761,389,372,768,417,351,772,361,383,1204,577,619
39035018CKV,714,276,385,748,342,368,610,334,276,618,366,252,625,333,272,864,433,418
39035018BXN,784,475,255,802,577,182,737,579,158,742,607,135,747,572,155,948,708,226
39035018BYQ,657,312,316,681,425,227,607,403,204,608,425,183,616,396,201,763,511,241
39035018BWH,628,397,193,656,469,160,550,424,126,560,456,104,560,423,114,739,544,180
39035018AGF,688,316,335,732,403,306,544,338,206,556,374,182,555,324,217,754,416,332
39035018AEU,818,291,505,832,376,422,748,369,379,751,410,341,758,363,386,920,446,466
39035018CFK,750,198,523,781,295,460,611,252,359,627,273,354,624,245,371,789,308,478
39035018DAJ,614,317,286,624,462,148,578,466,112,582,464,118,585,444,136,753,582,167
39035018CGL,656,158,461,656,211,430,589,223,366,599,248,351,606,205,388,753,286,460
39035018AMI,624,575,23,642,628,9,512,496,16,509,498,11,513,483,19,586,565,16
39063032ABP,638,102,506,649,113,495,522,101,421,529,147,382,530,102,416,745,153,584
39103052ABI,1051,322,666,1061,439,579,837,381,456,845,425,420,858,360,471,1136,506,615
39035018CTE,857,558,261,875,640,202,757,592,165,766,614,152,765,571,179,912,710,192
39075038AAA,575,33,528,566,42,516,480,42,438,470,48,422,481,43,433,669,76,591
39075038AAB,440,35,392,447,53,386,393,41,352,391,50,341,400,42,350,578,65,507
39103052AFA,1011,225,747,1031,337,653,872,302,570,901,342,559,903,294,593,1088,406,665
39103052AFK,561,142,392,569,160,376,444,177,267,452,191,261,452,175,268,647,226,412
39045023ABO,642,137,470,633,155,449,488,140,348,500,187,313,502,140,350,692,175,507
39045023ABQ,570,152,389,581,172,378,441,139,302,454,186,268,458,157,285,651,187,450
39045023ADA,756,178,553,745,236,481,614,199,415,628,255,373,637,209,412,828,309,504
39063032AAU,403,123,250,403,142,226,314,129,185,315,158,157,315,119,177,477,165,300
39035018BVP,684,397,251,716,481,193,617,460,157,625,491,134,627,459,148,782,596,174
39035018BUL,606,373,205,633,416,201,474,356,118,480,374,106,478,345,128,631,447,180
39035018AEZ,936,315,590,932,450,433,871,462,409,871,504,367,881,444,423,1111,603,495
39035018CQL,842,684,147,851,768,70,776,702,74,788,731,57,787,702,78,924,844,65
39035018CQU,884,672,179,896,772,101,867,766,101,872,774,98,873,748,114,995,883,108
39035018AZC,236,189,38,256,224,24,165,145,20,164,147,17,167,143,19,218,191,23
39035018BBZ,510,289,181,563,364,173,416,308,108,420,310,110,424,287,126,558,337,213
39035018AYT,241,189,31,249,224,21,187,164,23,189,174,15,187,162,19,258,230,24
39035018ASU,419,372,31,455,437,11,300,292,8,299,293,6,310,293,8,381,362,13
39061031ADC,890,735,112,918,866,37,742,704,38,743,712,31,745,699,31,1031,945,71
39061031AVV,878,292,545,899,370,493,659,315,344,660,342,318,664,291,351,938,412,510
39061031AKM,677,559,96,697,636,43,506,473,33,506,478,28,513,471,34,645,588,52
39061031BCS,851,419,392,861,465,364,700,431,269,698,439,259,702,396,291,858,507,340
39061031ADS,911,393,477,913,577,278,811,561,250,805,573,232,815,534,261,1011,707,286
39045023ACV,739,143,570,751,117,607,603,112,491,622,171,451,622,122,480,895,118,771
39091046ABM,1032,140,850,1041,171,817,816,159,657,812,210,602,818,160,617,1125,191,921
39075038AAU,785,141,601,791,161,594,612,155,457,622,193,429,624,151,441,887,168,703
39033017AAT,574,172,377,585,195,359,447,180,267,456,212,244,450,181,249,626,218,400
39063032ABQ,746,118,598,753,170,545,612,152,460,623,207,416,634,158,460,874,218,644
39103052AAJ,873,293,533,904,364,494,709,337,372,720,372,348,729,320,387,1087,445,621
39103052ADN,496,152,317,516,185,306,414,184,230,429,214,215,429,169,250,580,243,331
39061031BBJ,959,153,778,975,213,724,810,200,610,807,235,572,815,176,610,1031,276,746
39061031BAY,1037,169,832,1045,229,766,853,241,612,856,276,580,862,214,626,1075,296,765
39061031ALI,464,315,123,477,369,98,289,212,77,292,225,67,287,192,79,381,277,101
39061031BDT,886,261,590,900,357,496,775,390,385,778,418,360,792,360,408,1019,490,512
39033017ABT,357,38,304,357,48,289,259,50,209,267,69,198,270,53,209,390,44,341
39075038AAJ,794,133,622,828,151,637,585,128,457,582,168,414,590,128,441,893,152,728
39091046ABR,935,163,721,952,224,701,683,172,511,699,225,474,689,166,504,1059,214,829
39009005ABD,408,207,178,419,193,192,308,181,127,313,223,90,313,197,104,396,206,176
39063032ABT,629,94,509,641,89,518,491,90,401,495,137,358,501,93,390,695,111,571
39063032ACM,438,73,350,454,86,346,336,67,269,334,88,246,342,75,259,434,90,340
39103052ADC,914,263,610,924,316,570,751,317,434,786,370,416,794,287,483,1045,376,661
39103052AFE,733,169,527,740,219,483,632,218,414,640,257,383,645,213,411,881,292,573
39103052AEQ,717,143,540,709,211,480,661,223,438,666,238,428,671,217,444,949,301,643
39103052AAE,610,185,390,631,225,388,498,218,280,506,251,255,514,217,280,753,295,448
39135068AAB,547,88,424,542,103,412,392,79,313,392,120,272,395,79,283,567,118,431
39135068ABS,448,59,373,446,94,340,365,87,278,365,111,254,370,83,272,467,95,368
39033017ABU,767,108,637,768,141,604,578,131,447,582,190,392,588,123,445,832,143,673
39061031AXE,809,210,566,829,293,491,667,268,399,674,305,369,678,246,407,877,351,509
39009005ABR,678,197,434,701,169,510,537,176,361,556,214,342,549,170,362,746,180,557
39009005ACK,345,74,244,352,54,288,280,60,220,291,78,213,290,63,217,431,75,349
39119060ABW,387,87,274,390,100,276,317,113,204,320,139,181,320,112,191,429,116,305
39119060ACT,615,180,411,622,221,372,467,181,286,468,232,236,470,182,276,702,212,482
39091046AAL,302,91,181,303,116,162,189,83,106,190,96,94,190,83,95,308,99,200
39091046AAR,341,48,282,346,49,277,259,51,208,264,65,199,264,64,192,357,55,294
39053027AAK,818,209,580,838,139,669,619,145,474,625,193,432,634,163,460,917,162,745
39033017AAQ,542,133,382,557,149,370,401,143,258,407,165,242,410,137,262,584,187,388
39033017AAP,519,105,379,523,126,363,349,102,247,359,134,225,358,99,243,566,134,419
39127064AAG,362,98,242,359,98,247,274,100,174,277,117,160,276,87,182,410,104,306
39083042ABG,288,41,227,290,50,224,231,39,192,239,68,171,239,44,180,336,49,281
39129065AAJ,423,152,241,433,174,240,303,120,183,308,144,164,307,123,170,511,193,313
39129065AAM,608,226,343,622,233,349,410,191,219,416,226,190,420,193,208,651,216,419
39083042AAF,266,66,180,266,71,183,151,50,101,155,54,101,154,48,96,287,63,219
39057029AHY,331,65,249,334,83,227,233,68,165,235,81,154,235,59,168,343,72,262
39057029AHH,721,602,91,722,623,72,688,627,61,692,644,48,696,605,72,781,716,57
39057029AHG,441,245,181,442,281,145,412,265,147,413,279,134,416,257,150,462,311,145
39129065ACE,510,127,364,518,128,363,411,131,280,409,156,253,417,143,263,663,176,478
39129065ABQ,516,127,372,525,132,368,416,133,283,416,161,255,418,144,267,578,173,397
39083042ABW,491,104,356,488,104,354,388,109,279,390,134,256,390,119,252,561,141,412
39083042ABM,548,148,368,547,161,366,458,150,308,463,176,287,463,150,301,629,160,460
39129065ABU,847,161,653,845,179,645,723,163,560,716,215,501,728,171,541,944,216,714
39061031AZC,938,209,686,947,302,604,827,302,525,826,316,510,837,291,527,1028,413,602
39061031BKI,446,87,339,456,91,347,373,100,273,374,113,261,378,93,274,491,122,358
39061031BMP,624,168,434,625,269,320,539,234,305,542,272,270,545,225,302,652,329,320
39061031BBD,668,302,318,679,352,297,479,282,197,479,300,179,483,274,194,669,374,290
39061031AMG,899,667,186,918,749,129,863,731,132,869,746,123,876,718,131,1046,883,150
39061031AMM,1073,825,181,1084,931,94,1009,909,100,1014,924,90,1013,899,93,1208,1088,106
39061031BBZ,875,448,385,884,546,303,745,508,237,742,530,212,748,479,246,1001,688,295
39061031ASJ,575,86,478,552,198,337,515,167,348,511,199,312,513,160,342,611,259,348
39061031BHQ,746,99,636,750,147,581,638,150,488,636,177,459,648,141,488,810,208,596
39061031AKS,490,405,52,502,459,27,360,324,36,362,339,23,358,316,30,473,426,40
39061031BKA,300,78,201,310,88,209,232,78,154,234,85,149,232,66,157,342,79,254
39061031BLW,918,436,455,917,529,353,830,520,310,827,531,296,833,500,315,974,630,332
39119060AAL,556,279,226,562,350,173,402,269,133,403,299,104,406,258,121,625,352,261
39167084ABA,279,134,129,279,150,122,236,128,108,236,140,96,243,125,115,285,163,119
39167084AAN,703,347,327,707,359,306,535,282,253,546,322,224,548,271,256,741,393,330
39053027ABH,527,124,386,539,90,429,407,98,309,414,131,283,415,104,304,578,111,456
39053027AAW,420,113,291,432,67,354,296,60,236,300,95,205,303,71,229,449,63,381
39035018APT,266,241,11,284,276,4,187,179,8,187,186,1,191,177,9,203,198,5
39103052AFH,851,218,561,873,231,602,708,257,451,724,295,429,720,238,450,1031,260,759
39005003ACC,757,130,575,785,146,587,590,136,454,597,183,414,598,124,440,871,165,689
39005003AAS,727,196,496,749,244,458,543,224,319,539,251,288,543,211,309,715,273,426
39005003ABV,315,66,232,316,68,224,243,70,173,242,80,162,243,68,166,349,73,268
39005003ABJ,411,75,299,417,83,316,346,94,252,349,126,223,349,91,238,488,111,367
39005003ACS,615,127,453,615,131,470,448,127,321,446,152,294,455,121,316,667,140,520
39135068ABP,567,89,455,574,90,469,438,98,340,445,118,327,445,90,344,613,100,507
39103052AGD,589,140,429,596,183,388,525,184,341,542,215,327,546,182,346,831,336,488
39103052AEY,609,167,413,611,209,373,554,207,347,571,245,326,569,209,344,891,309,575
39103052AAK,865,294,516,898,355,494,688,315,373,711,363,348,708,306,376,1056,413,631
39063032AAZ,758,191,532,771,252,477,660,232,428,663,291,372,670,213,440,843,306,527
39063032ABZ,585,138,426,590,169,388,473,159,314,484,204,280,487,156,322,660,191,452
39119060AAN,698,236,427,711,287,383,515,256,259,517,297,220,522,243,261,746,333,399
39057029AAZ,734,156,543,739,226,467,647,216,431,654,258,396,655,209,422,772,287,464
39139070ABG,473,119,334,486,116,351,375,139,236,383,157,226,378,121,242,527,141,374
39119060ACX,743,243,457,751,299,402,580,272,308,590,329,261,591,264,306,799,332,448
39119060ACR,367,60,287,371,68,285,284,77,207,283,94,189,281,72,203,402,77,321
39035018BTG,693,460,187,737,526,173,519,402,117,526,427,99,526,389,115,735,542,190
39035018BAL,424,315,83,479,391,69,253,212,41,258,219,39,257,208,44,428,308,113
39035018BFF,650,405,191,689,491,164,490,380,110,494,398,96,494,371,103,702,487,200
39035018AQB,484,451,18,531,522,5,352,339,13,355,347,8,357,340,12,409,390,11
39035018AWR,436,380,39,473,445,27,303,280,23,298,283,15,304,269,19,399,371,26
39035018CFI,815,215,557,841,288,521,673,285,388,683,314,369,690,271,401,874,342,529
39035018CHV,677,259,371,710,335,337,528,297,231,538,329,209,544,283,238,784,382,388
39035018BLG,785,620,135,800,676,108,658,562,96,663,585,78,662,559,89,809,656,140
39035018ALW,477,432,24,496,483,6,358,345,13,363,357,6,363,345,10,415,405,7
39035018AVG,445,400,22,487,472,9,323,303,20,331,320,11,329,304,18,434,407,24
39035018ABK,962,551,401,978,762,191,920,775,145,921,752,169,921,697,216,1084,859,221
39035018AJA,533,491,26,558,537,14,376,359,17,379,368,11,376,359,13,484,458,25
39035018BAN,367,230,90,410,314,86,216,159,57,217,164,53,213,152,55,351,215,130
39139070ABR,1124,205,868,1127,224,851,866,209,657,877,252,625,881,202,645,1229,231,972
39091046ABG,530,66,438,539,92,434,384,63,321,393,90,303,391,71,312,580,77,497
39045023AEE,738,190,503,756,221,503,567,187,380,583,239,344,583,195,369,852,213,630
39045023ADN,688,190,468,689,231,417,622,230,392,627,289,338,634,248,367,1008,453,535
39101051ABY,824,205,577,836,215,581,728,211,517,733,260,473,735,212,507,908,238,659
39103052AAA,773,243,493,804,304,466,635,297,338,657,333,324,662,285,354,929,362,559
39103052AAB,826,250,518,862,322,499,637,292,345,658,331,327,663,277,354,976,357,600
39081041ABM,663,150,454,699,147,530,524,164,360,538,194,344,536,139,377,747,146,592
39081041AAI,592,226,315,585,241,325,420,186,234,417,190,227,422,158,252,570,228,336
39081041ADG,172,57,103,175,57,110,131,61,70,134,69,65,135,53,77,189,63,122
39081041AAW,627,206,391,632,193,427,511,183,328,528,226,302,524,176,336,681,220,457
39035018CUU,642,281,329,668,356,293,565,328,237,564,343,221,568,309,236,762,428,327
39113057APK,779,218,527,798,232,536,627,212,415,637,245,392,639,194,423,926,291,621
39113057ADO,867,319,493,885,393,426,726,379,347,737,438,299,733,369,341,945,504,419
39113057ASV,516,141,354,542,190,336,401,164,237,408,182,226,408,150,251,565,199,357
39113057AVD,899,128,737,909,169,705,758,150,608,761,202,559,766,150,593,1003,198,797
39101051ADK,636,142,446,635,157,449,511,133,378,512,183,329,514,140,357,700,172,517
39045023AED,872,197,637,885,232,621,686,193,493,701,249,452,714,206,489,1001,268,724
39045023AAG,715,215,469,715,257,420,547,212,335,566,267,299,565,226,320,754,301,439
39139070ACY,804,163,595,821,183,618,737,195,542,744,234,510,750,199,533,935,209,721
39139070ADB,841,206,592,837,235,562,713,215,498,713,251,462,720,202,494,859,226,619
39035018ARP,290,240,26,323,306,8,215,200,15,219,207,12,219,201,10,264,241,19
39117059AAX,540,128,385,538,133,388,393,106,287,397,136,261,402,111,281,618,122,486
39117059AAD,483,89,364,482,96,365,368,90,278,372,111,261,375,83,282,510,91,408
39045023AFD,628,204,376,644,222,378,461,202,259,477,234,243,477,197,260,699,229,456
39089045AEF,733,160,542,757,195,508,635,177,458,651,221,430,651,187,452,832,230,591
39089045ADM,696,121,539,707,140,534,641,137,504,643,184,459,648,151,475,829,183,633
39167084ACC,728,229,466,751,163,560,589,146,443,591,195,396,604,151,441,776,198,572
39017009ACI,404,99,284,428,143,268,279,98,181,290,111,179,290,88,173,467,130,329
39017009ABR,642,145,470,652,178,447,541,177,364,551,205,346,549,179,354,720,241,462
39089045ADQ,653,148,479,659,174,464,535,132,403,543,170,373,549,143,388,702,192,499
39089045ADH,813,209,570,810,242,529,668,221,447,679,286,393,674,233,430,913,323,574
39089045ABE,685,214,434,686,252,400,561,219,342,578,267,311,569,231,321,749,270,472
39173087AAM,789,372,353,802,458,286,604,376,228,608,413,195,610,365,211,855,537,293
39173087ADQ,886,230,623,902,318,528,700,239,461,700,349,351,713,258,427,959,341,601
39069035ABA,327,60,247,337,80,239,264,76,188,268,118,150,274,77,191,317,84,231
39003002ADE,534,72,440,538,100,416,479,102,377,479,154,325,483,108,363,631,138,487
39003002ABT,426,212,181,439,251,169,303,192,111,306,218,88,307,185,110,417,225,181
39069035AAI,612,130,467,610,198,389,481,158,323,496,215,281,507,154,346,648,212,432
39061031BHK,886,197,658,895,253,593,725,231,494,720,259,461,726,212,494,950,361,570
39061031AWW,838,273,543,828,348,439,716,330,386,718,355,363,718,325,379,883,443,426
39061031BKF,898,144,716,912,182,693,705,169,536,710,185,525,725,161,546,984,207,763
39061031AYR,549,247,291,549,316,206,510,293,217,512,318,194,514,280,222,577,344,229
39061031BEV,798,158,613,813,197,577,633,205,428,634,252,382,636,185,432,810,256,547
39173087AAO,620,323,255,622,382,185,512,348,164,519,388,131,524,357,149,671,433,213
39017009AAV,503,103,380,497,137,326,430,139,291,433,159,274,437,130,299,549,215,322
39017009AHB,1085,194,847,1107,209,862,819,185,634,847,207,640,851,167,659,1215,231,974
39017009ABZ,529,142,366,538,184,327,399,158,241,406,187,219,406,164,232,574,234,331
39061031ALE,576,352,189,586,404,156,393,283,110,392,298,94,398,270,105,557,371,178
39057029AIN,506,439,51,513,473,31,248,226,22,248,228,20,249,222,26,169,139,27
39057029AAU,527,122,387,524,177,315,452,165,287,459,196,263,461,168,284,563,225,322
39057029AHZ,672,129,527,669,167,472,554,156,398,563,184,379,566,142,405,715,177,527
39013007AAU,239,65,156,235,51,175,214,74,140,218,96,122,217,73,140,270,50,216
39129065ABA,506,101,380,516,109,387,382,94,288,385,136,249,384,111,266,549,150,393
39057029AED,465,135,305,472,160,284,259,111,148,259,128,131,261,104,146,490,187,292
39057029AGQ,433,93,325,436,124,292,414,143,271,420,180,240,422,135,277,512,217,292
39035018AEB,801,455,300,832,544,233,520,350,170,527,382,145,532,342,173,609,376,220
39105053AAY,357,94,252,378,83,282,288,72,216,301,111,190,297,74,213,435,93,338
39117059AAO,416,81,314,416,93,304,345,99,246,347,127,220,352,107,235,450,104,340
39117059ABB,252,51,183,253,48,190,200,53,147,201,59,142,204,56,144,268,55,208
39003002ADZ,581,77,487,587,90,477,463,78,385,467,139,328,472,88,373,596,82,509
39003002ABH,467,140,307,471,170,283,381,151,230,383,184,199,390,150,231,539,218,319
39163082AAW,60,26,29,62,21,38,34,10,24,36,13,23,34,8,26,54,12,42
39061031BJE,812,141,623,830,157,624,611,158,453,608,172,436,616,134,455,919,207,690
39061031BKG,1029,120,877,1046,193,822,893,180,713,888,208,680,901,153,731,1256,240,998
39061031BKJ,871,128,708,883,185,649,710,166,544,722,211,511,728,154,548,831,193,616
39061031BLM,811,348,424,812,441,328,716,403,313,724,439,285,724,407,293,911,562,327
39061031ASL,538,91,438,527,181,328,466,164,302,468,186,282,472,160,302,593,263,320
39061031AGZ,375,292,53,403,372,20,321,287,34,325,306,19,328,288,29,482,434,41
39061031AVZ,592,148,401,604,180,395,433,179,254,440,198,242,435,164,254,635,244,379
39027014ABQ,488,73,402,491,112,359,421,111,310,421,123,298,424,95,320,565,155,404
39095048ATR,1041,331,684,1066,411,596,808,350,458,818,399,419,829,346,467,1126,479,633
39095048ATQ,707,226,462,714,300,380,668,290,378,669,333,336,682,285,384,805,379,414
39101051ADA,493,87,378,490,84,385,397,83,314,401,119,282,399,95,296,547,110,432
39101051ADC,551,133,378,564,138,397,431,118,313,428,156,272,436,115,307,578,138,424
39101051ABJ,663,164,478,661,223,417,607,204,403,612,271,341,618,213,387,721,273,445
39101051ACT,640,139,450,659,133,489,483,134,349,477,174,303,487,140,321,696,140,549
39035018CQM,702,552,132,717,637,58,616,551,65,617,573,44,620,545,63,780,714,61
39035018CUY,482,218,207,522,285,209,327,210,117,332,221,111,335,200,119,570,307,252
39035018DAO,608,293,264,645,361,264,501,325,176,505,345,160,497,295,182,695,376,310
39035018BDS,178,118,42,197,141,48,109,81,28,109,81,28,111,79,26,185,106,74
39095048AHV,636,330,275,664,366,255,509,329,180,513,356,157,521,329,173,624,391,213
39095048AUO,670,283,348,698,337,335,522,304,218,529,340,189,530,288,219,730,347,369
39095048ATU,739,258,461,751,331,386,664,318,346,663,339,324,668,319,340,795,391,396
39027014ABZ,673,91,558,682,83,584,604,106,498,597,115,482,603,97,480,805,114,676
39095048ANZ,583,341,195,597,388,169,273,189,84,277,205,72,281,185,83,391,245,139
39117059AAV,518,119,370,520,121,379,418,102,316,428,129,299,430,109,295,603,108,482
39035018BRD,840,573,229,860,684,162,702,565,137,709,593,116,710,563,132,890,716,164
39109055ACF,862,135,702,863,201,622,717,176,541,731,221,510,736,175,543,908,233,667
39093047AFN,581,386,158,594,419,147,416,311,105,421,335,86,425,317,94,577,375,195
39093047ADS,568,291,219,579,339,209,394,262,132,422,308,114,421,280,127,579,348,222
39093047AFD,613,415,158,633,450,157,449,328,121,460,358,102,466,340,113,648,406,229
39093047AEW,517,373,101,536,447,70,318,274,44,338,302,36,340,285,43,477,350,121
39109055AAI,437,112,295,440,138,276,265,97,168,267,120,147,269,91,170,438,122,311
39109055ACA,961,134,789,969,206,735,794,181,613,794,240,554,803,176,609,1086,245,831
39109055ACN,507,58,435,510,94,398,417,79,338,420,115,305,427,69,332,549,100,443
39095048APX,433,213,198,440,252,165,346,216,130,353,245,108,357,223,120,452,285,162
39095048ANP,403,242,130,417,265,127,231,158,73,229,166,63,233,161,59,345,200,133
39159080AAV,641,119,498,640,164,448,590,150,440,588,200,388,592,167,416,781,215,547
39155078ADG,878,325,523,894,410,470,739,377,362,750,420,330,757,377,371,927,429,483
39155078AAI,506,256,215,516,293,202,342,213,129,343,226,117,345,214,115,479,252,221
39155078AHM,754,259,449,760,249,469,582,230,352,593,293,300,590,257,310,782,277,500
39155078ADV,507,266,207,521,310,187,357,242,115,364,265,99,355,237,112,522,306,207
39155078AHJ,760,254,455,762,289,451,603,283,320,612,319,293,611,283,307,856,333,517
39151076AEF,355,161,162,359,170,177,269,154,115,277,171,106,277,145,113,403,182,210
39151076AHP,438,153,268,443,175,242,356,154,202,358,179,179,361,149,206,479,198,276
39151076AEI,565,370,150,570,397,139,366,277,89,372,290,82,376,276,90,600,376,210
39151076AIU,568,164,367,592,183,373,444,167,277,451,197,254,447,166,259,619,202,408
39151076ADS,498,141,325,497,167,295,462,186,276,466,207,259,466,176,276,605,229,365
39151076AMA,594,249,295,605,267,308,456,230,226,460,267,193,462,233,206,649,310,328
39095048AHF,457,304,126,474,357,92,282,230,52,284,240,44,283,224,52,434,341,87
39095048AAS,656,240,388,661,312,307,530,268,262,532,305,227,540,281,245,709,351,348
39095048AUH,606,309,271,631,367,234,519,340,179,523,359,164,524,324,180,663,402,250
39013007ACX,831,229,555,835,239,570,622,243,379,627,291,336,629,210,396,861,226,623
39013007ADX,396,118,248,404,97,277,271,99,172,276,128,148,276,85,179,439,106,323
39095048ANR,453,260,160,463,301,134,301,215,86,309,245,64,313,210,87,458,284,164
39095048AVD,640,191,423,641,250,356,529,247,282,536,286,250,551,244,289,720,334,377
39095048AUT,820,238,558,834,314,476,680,291,389,678,335,343,683,271,396,924,385,516
39151076AIS,700,161,506,710,191,491,575,191,384,586,212,374,591,191,381,811,201,601
39151076AOZ,861,209,603,873,225,611,711,228,483,718,254,464,722,220,476,1004,266,727
39151076AIY,587,186,359,590,218,337,467,223,244,467,247,220,468,217,227,672,267,391
39095048AFJ,642,319,292,657,366,253,493,289,204,495,327,168,499,288,191,741,424,305
39095048AJR,647,450,170,646,488,115,549,434,115,550,461,89,554,432,106,662,511,140
39095048ALA,407,360,29,422,402,14,282,268,14,285,273,12,284,267,13,324,306,15
39095048ARY,878,264,575,888,327,516,699,274,425,702,315,387,710,264,424,949,316,619
39095048ANY,275,173,82,288,204,71,244,183,61,250,195,55,254,180,61,353,232,110
39095048AED,527,257,245,536,278,218,403,234,169,413,272,141,414,230,167,566,309,242
39095048AIR,522,427,72,529,459,51,445,394,51,448,404,44,448,392,47,485,426,48
39027014AAJ,531,131,374,547,156,363,316,102,214,315,114,201,316,96,207,478,129,333
39027014ACG,229,57,162,237,68,157,299,104,195,303,120,183,301,110,184,427,131,293
39027014ABN,360,100,243,365,100,246,272,82,190,270,93,177,273,78,182,361,83,272
39147074ABT,435,95,326,441,118,299,362,121,241,364,167,197,370,114,253,497,144,347
39165083AEQ,728,131,564,735,194,512,570,154,416,589,187,402,581,150,410,788,208,570
39165083ABS,617,127,462,623,178,411,510,159,351,521,183,338,521,167,345,701,249,444
39165083ABB,675,160,498,670,236,419,633,221,412,640,254,386,643,214,415,787,314,469
39165083ACM,580,106,447,609,118,482,447,109,338,455,119,336,455,96,354,661,147,514
39097049AAP,863,174,644,859,212,602,791,195,596,790,265,525,797,232,550,1072,296,752
39099050ABZ,435,383,31,452,426,24,267,242,25,274,257,17,273,241,29,362,322,36
39093047ABC,1133,344,756,1146,480,614,853,415,438,883,453,430,893,409,466,1159,547,596
39093047AJP,805,207,554,833,249,544,629,232,397,644,275,369,643,221,405,926,259,655
39093047AKN,717,151,510,725,190,509,562,188,374,571,222,349,579,187,374,801,228,568
39109055ACE,637,106,509,645,152,472,513,126,387,521,162,359,523,120,378,716,177,524
39109055ADA,901,119,755,909,180,707,732,158,574,734,230,504,746,157,573,931,184,736
39049025AFB,517,296,181,528,346,156,423,287,136,426,318,108,426,288,116,535,355,166
39101051ABQ,325,101,212,331,125,194,301,113,188,307,143,164,310,122,184,347,153,192
39101051ABF,562,177,340,580,214,325,439,185,254,439,231,208,440,195,232,608,231,362
39101051AAO,298,105,164,307,106,190,193,87,106,192,100,92,191,88,85,332,93,231
39101051AAZ,351,98,222,359,132,195,262,125,137,264,136,128,261,119,124,369,127,222
39139070AAK,858,288,537,855,327,491,694,287,407,704,332,372,709,293,401,891,356,522
39139070ABI,331,100,204,342,91,229,249,83,166,254,99,155,251,76,154,372,90,274
39097049AAD,515,177,302,528,215,291,365,154,211,364,187,177,365,177,176,595,231,355
39079040AAT,577,141,409,590,112,455,434,111,323,445,133,312,453,120,311,648,103,534
39079040AAV,202,66,124,208,59,139,114,34,80,122,54,68,123,42,76,174,47,124
39139070AAJ,808,223,563,800,252,506,725,275,450,741,321,420,747,273,463,930,370,546
39029015AAH,354,142,182,369,149,205,262,125,137,265,136,129,264,121,136,412,148,251
39099050APM,723,222,470,739,265,454,581,224,357,581,282,299,591,231,344,799,250,541
39139070ABU,825,200,562,849,203,597,606,208,398,613,236,377,615,192,399,912,216,677
39139070ACJ,776,158,575,777,156,583,608,162,446,608,209,399,612,162,430,907,172,728
39049025AEL,922,534,364,917,649,222,877,598,279,881,665,216,888,627,242,982,751,224
39049025AEM,752,445,289,755,526,190,735,507,228,737,562,175,740,536,195,801,613,178
39049025AQS,549,264,254,546,313,203,418,286,132,424,309,115,426,277,132,589,414,162
39049025BIQ,784,412,335,798,473,296,646,369,277,651,418,233,648,374,255,840,491,335
39049025BLX,302,159,129,310,184,115,266,218,48,273,231,42,275,219,45,440,338,92
39049025AXP,511,283,193,527,332,176,382,251,131,384,270,114,381,251,118,563,388,167
39049025AIT,800,684,79,838,767,55,570,521,49,580,543,37,580,527,44,804,727,72
39049025AHO,755,369,346,775,402,333,572,328,244,579,384,195,581,339,217,825,458,353
39049025ALS,525,382,102,538,448,62,473,397,76,475,424,51,479,406,64,568,496,59
39139070ABB,513,309,174,519,329,163,382,255,127,394,270,124,394,245,129,543,327,210
39099050ASP,659,270,356,664,300,344,555,292,263,559,339,220,565,318,233,713,349,361
39037019AAU,491,84,387,498,108,365,384,95,289,390,121,269,394,88,295,512,94,413
39171086ABC,781,184,552,785,209,533,590,189,401,598,256,342,602,165,414,803,221,562
39171086AAA,697,212,424,703,228,424,503,208,295,504,259,245,506,193,285,747,267,459
39029015ABQ,187,100,73,197,93,89,121,75,46,121,79,42,124,66,50,178,66,109
39151076ANV,534,147,345,541,143,362,371,150,221,376,168,208,375,135,225,574,158,404
39151076AMC,589,200,356,590,241,323,512,240,272,520,259,261,522,221,287,646,269,374
39151076AEZ,632,202,416,624,254,350,554,240,314,560,273,287,565,233,322,652,299,347
39151076AJA,813,244,506,836,317,476,714,309,405,718,334,384,727,308,397,962,382,566
39151076AAP,676,227,422,686,272,389,546,216,330,554,262,292,557,207,338,757,295,454
39151076AAR,416,114,291,418,147,254,355,154,201,356,173,183,359,143,205,476,187,280
39099050AJV,728,186,486,747,223,493,507,187,320,516,235,281,516,210,298,689,176,503
39099050ABU,482,220,241,485,220,252,390,215,175,397,266,131,397,220,164,488,226,254
39099050AMY,626,191,415,635,235,381,545,214,331,544,241,303,546,212,328,703,245,453
39099050AHZ,593,281,286,625,317,288,519,282,237,515,331,184,524,302,214,648,305,337
39029015AAX,625,186,403,649,216,419,478,179,299,495,211,284,495,180,303,678,210,455
39089045ACN,997,242,707,1012,315,655,807,268,539,820,337,483,824,288,509,1164,395,745
39089045ABM,688,215,439,694,245,426,617,226,391,625,279,346,627,247,370,767,285,476
39173087ADS,923,254,626,928,348,539,772,308,464,771,358,413,777,301,454,1005,386,606
39119060AAB,562,168,347,574,229,296,434,201,233,435,230,205,435,175,235,630,233,377
39057029ACS,959,200,735,954,296,618,861,284,577,869,338,531,873,281,569,1099,420,663
39057029AAK,719,163,545,717,250,435,656,243,413,654,283,371,663,238,406,761,319,429
39151076AOY,853,175,632,857,212,604,695,210,485,704,245,459,709,212,473,861,268,583
39151076AOU,432,77,334,436,99,315,349,98,251,357,120,237,359,98,247,484,114,365
39151076ADJ,384,225,134,392,262,109,300,216,84,309,229,80,311,218,83,399,252,140
39017009ABM,519,103,395,532,121,386,393,117,276,402,137,265,405,138,261,584,185,393
39057029ACX,423,80,325,423,133,269,386,141,245,385,171,214,385,124,248,457,163,286
39037019ABC,510,73,418,518,94,413,394,83,311,402,119,283,402,83,310,559,95,457
39171086AAP,929,174,708,934,215,680,753,207,546,763,301,462,771,207,542,1025,262,749
39049025BKB,560,218,310,555,236,293,400,195,205,398,217,181,395,189,199,620,270,330
39151076AHJ,672,136,522,673,204,451,594,182,412,598,205,393,603,182,416,810,275,532
39151076ANM,721,199,476,732,198,500,546,191,355,556,216,340,562,188,349,830,214,602
39095048AIW,476,369,75,499,419,56,346,294,52,342,304,38,348,277,49,459,394,60
39095048ATT,887,311,542,890,375,457,682,342,340,690,376,314,697,331,339,867,434,411
39095048AUN,706,281,398,730,326,364,574,287,287,590,347,243,598,296,274,752,345,396
39095048AFO,663,322,308,683,396,246,514,342,172,517,373,144,532,346,166,743,473,260
39095048ACM,800,330,430,822,381,384,484,252,232,484,278,206,491,242,227,756,364,377
39095048AUF,887,283,583,884,393,455,638,297,341,635,331,304,641,294,324,866,441,414
39095048ACK,1003,298,687,1007,397,557,834,374,460,837,429,408,851,387,447,1084,507,560
39131066AAH,540,180,337,544,155,376,408,150,258,417,181,236,422,148,259,578,141,428
39079040ABH,352,82,254,366,63,292,271,60,211,278,92,186,284,73,206,399,70,326
39079040ABJ,483,138,324,496,97,383,347,98,249,348,130,218,356,101,244,519,99,418
39131066AAW,547,155,372,557,142,406,421,133,288,427,160,267,433,142,280,619,124,489
39095048AND,292,180,88,298,211,74,195,143,52,197,147,50,196,133,52,226,149,73
39143072ADK,651,123,485,668,170,453,538,166,372,539,217,322,542,167,347,718,179,525
39169085ABB,981,308,640,1002,399,563,865,369,496,874,421,453,880,351,507,1159,504,637
39163082AAK,445,110,312,463,84,352,320,79,241,326,106,220,327,87,230,524,88,432
39033017AAN,615,144,450,619,174,421,531,165,366,540,217,323,541,172,351,682,190,479
39015008ACI,649,129,492,656,162,467,525,160,365,537,191,346,534,140,375,680,150,523
39003002ABE,688,195,464,688,253,399,567,208,359,574,267,307,571,210,351,703,275,407
39003002ACY,498,99,376,496,132,343,387,115,272,388,144,244,389,104,273,503,132,364
39155078AGK,549,174,346,564,193,340,427,171,256,430,207,223,426,172,245,594,182,401
39155078AAO,390,225,139,403,234,148,259,169,90,260,186,74,261,153,91,405,212,186
39165083ACI,530,131,368,542,192,308,422,197,225,431,218,213,430,190,228,604,271,321
39165083ABT,689,144,502,708,213,455,536,181,355,547,209,338,546,177,352,756,249,499
39025013AFT,527,104,395,543,140,363,371,139,232,372,147,225,372,124,234,559,187,365
39025013ADS,412,110,280,417,166,229,367,155,212,366,164,202,364,152,198,476,193,277
39049025AEF,780,590,139,799,687,58,758,679,79,766,705,61,766,674,71,891,796,79
39049025BAR,331,129,189,328,171,141,285,155,130,284,171,113,288,162,123,363,224,128
39049025AOJ,775,352,394,798,460,293,716,416,300,724,470,254,726,423,286,916,577,311
39151076AGH,543,209,298,555,216,309,401,185,216,409,201,208,410,181,216,615,262,344
39151076ABE,627,449,134,637,480,126,437,346,91,449,369,80,445,350,82,593,447,131
39169085AAA,737,199,486,749,255,438,560,206,354,572,239,333,574,215,335,813,279,519
39169085ADM,1002,180,774,1030,243,755,802,227,575,819,272,547,829,228,578,1039,263,761
39169085AAK,565,185,332,566,210,330,417,208,209,422,222,200,424,185,219,636,218,406
39037019AAM,708,110,570,717,129,556,514,107,407,517,144,373,521,106,384,772,120,638
39093047ADJ,778,394,353,801,429,338,558,346,212,571,378,193,576,335,223,852,444,397
39093047ADK,707,304,348,716,332,332,499,284,215,516,329,187,520,289,216,760,369,371
39093047ABE,932,273,620,936,402,495,819,384,435,834,425,409,842,362,463,1074,556,504
39025013AFQ,564,120,421,578,159,384,429,140,289,430,146,284,429,134,287,614,209,391
39093047AKB,970,271,654,992,336,611,803,325,478,818,369,449,825,297,500,1330,450,855
39093047AIZ,823,225,533,852,281,517,637,270,367,663,316,347,667,264,382,1073,371,680
39093047ABD,875,174,688,862,286,554,921,305,616,943,350,593,943,275,649,1275,478,791
39155078AEZ,640,212,392,640,231,380,473,210,263,483,250,233,482,212,251,696,247,441
39153077BCG,618,278,318,633,348,265,546,320,226,557,346,211,554,311,219,755,428,323
39153077AQT,704,330,361,720,424,275,610,380,230,622,416,206,614,386,219,887,565,315
39163082AAS,235,77,144,248,72,166,186,61,125,193,82,111,189,61,125,270,66,198
39109055ACB,977,140,799,978,182,760,759,177,582,774,233,541,777,173,579,1003,205,782
39049025AFZ,699,471,215,727,557,154,534,413,121,541,445,96,540,427,105,794,604,185
39049025BEM,707,326,349,710,398,271,599,397,202,605,430,175,607,408,178,857,567,278
39049025BMW,423,197,211,428,241,163,367,205,162,370,239,131,374,210,155,498,303,190
39049025ARO,716,274,418,720,370,323,667,333,334,670,381,289,676,344,323,869,493,363
39049025AUC,795,257,495,799,329,411,659,314,345,665,362,303,665,322,329,896,453,432
39049025ATN,753,250,468,757,312,411,589,266,323,593,312,281,599,290,296,804,366,429
39049025ACP,727,362,316,738,424,275,574,346,228,578,392,186,582,358,205,742,459,273
39049025AGQ,312,165,120,326,195,116,201,130,71,206,148,58,205,131,60,295,171,120
39049025AJP,873,621,209,914,715,168,695,553,142,699,597,102,701,569,123,934,779,145
39049025AXO,467,209,226,479,257,191,360,197,163,362,227,135,368,203,152,521,287,224
39169085ACR,335,64,249,337,69,249,250,56,194,249,63,186,254,58,181,359,65,291
39169085ABZ,497,80,382,511,103,377,380,96,284,390,123,267,389,93,276,576,122,450
39087044AAX,224,98,113,232,85,134,163,72,91,164,87,77,168,76,88,228,102,120
39087044AAQ,160,58,96,163,50,108,118,45,73,118,53,65,117,44,71,159,54,103
39093047AJT,638,186,420,655,242,387,539,230,309,558,276,282,567,227,326,866,292,562
39109055AAV,772,94,666,766,168,569,639,140,499,640,185,455,651,142,495,809,220,586
39093047AGZ,896,329,522,923,374,505,706,341,365,731,383,348,736,339,381,1049,469,562
39039020ABT,617,135,465,644,152,463,492,129,363,494,176,318,506,136,360,692,158,523
39095048ALY,357,230,109,374,263,86,471,329,142,476,364,112,480,331,127,639,436,190
39093047AIQ,501,164,317,508,202,289,368,173,195,381,206,175,383,163,206,518,202,310
39109055AAY,367,82,265,369,111,221,250,97,153,249,114,135,253,92,151,398,132,258
39087044ACM,322,89,216,340,74,258,235,59,176,239,74,165,241,61,173,362,83,278
39143072ABL,206,85,103,210,114,84,140,88,52,141,97,44,136,83,47,224,117,102
39143072ADI,416,136,259,426,176,222,326,160,166,330,185,145,323,154,151,438,178,251
39019010AAE,440,113,293,454,114,323,360,116,244,360,138,222,357,118,222,504,124,375
39019010AAZ,460,90,330,471,86,365,362,101,261,364,115,249,363,103,245,522,89,425
39099050ANL,447,91,336,447,107,328,359,89,270,356,109,247,362,93,257,511,122,383
39095048AJP,465,282,162,475,304,136,504,364,140,509,390,119,510,357,132,633,424,196
39095048ACO,708,281,401,719,346,332,535,304,231,535,341,194,543,297,230,692,385,294
39095048ABU,814,313,460,832,412,377,633,369,264,644,403,241,650,366,268,823,452,360
39095048APL,662,289,334,673,357,266,520,318,202,520,348,172,526,306,196,731,442,269
39095048AIN,400,361,23,409,393,10,265,250,15,271,262,9,272,252,14,305,285,14
39027014ACE,481,82,383,474,129,335,409,112,297,408,133,275,408,100,297,536,142,389
39099050ASO,569,286,256,574,319,241,458,274,184,463,307,156,466,292,161,617,335,280
39143072ABM,365,141,192,372,188,150,264,152,112,260,171,89,263,143,106,363,194,166
39013007ABX,216,80,128,217,57,153,158,49,109,158,66,92,158,44,110,218,63,155
39065033AAD,920,207,663,945,261,639,717,230,487,721,300,421,723,239,459,1018,285,713
39099050APF,397,77,288,405,73,314,314,89,225,319,89,230,324,89,222,452,67,377
39093047ABG,919,311,571,928,399,493,811,383,428,830,421,409,840,381,447,1108,532,568
39095048ASU,726,248,453,751,297,409,597,268,329,595,316,279,601,277,312,829,324,490
39143072ABA,422,177,211,445,244,176,309,181,128,315,214,101,310,177,118,453,236,203
39049025AUN,670,275,360,683,348,312,575,296,279,584,354,230,584,319,254,782,438,330
39049025AJK,448,282,148,462,317,128,406,279,127,411,298,113,414,275,127,546,401,135
39049025AWR,720,265,443,723,352,345,663,323,340,669,381,288,674,336,326,766,446,312
39049025BJD,1061,479,556,1062,608,397,945,581,364,950,657,293,953,607,336,1283,828,429
39049025AOV,657,351,273,669,421,218,550,359,191,553,388,165,555,362,176,740,500,227
39049025ALH,669,393,257,678,461,191,599,426,173,599,459,140,603,436,155,715,525,179
39049025BLE,761,196,554,770,329,416,850,368,482,856,430,426,857,372,474,1222,631,571
39049025AVM,1157,526,596,1152,665,431,1033,611,422,1047,696,351,1054,645,394,1237,789,431
39095048APR,632,309,301,629,375,230,532,338,194,534,376,158,548,340,190,667,410,251
39095048AAW,868,435,394,895,493,360,708,433,275,715,479,236,720,431,258,962,494,456
39095048AMJ,601,294,275,609,355,226,511,329,182,514,364,150,519,335,168,635,396,224
39095048ASM,814,379,399,830,402,379,662,351,311,664,382,282,681,348,305,873,408,443
39095048ARQ,399,109,275,404,136,243,352,122,230,351,157,194,374,124,223,375,120,253
39095048AKW,599,419,139,605,465,98,398,340,58,402,351,51,403,336,52,496,415,73
39041021ABN,756,182,546,777,247,490,705,213,492,709,283,426,714,250,449,1069,404,646
39041021ABP,490,132,334,503,165,312,388,134,254,388,169,219,393,147,234,535,198,318
39047024ABH,479,71,386,496,79,398,355,74,281,355,93,262,362,73,273,547,83,459
39141071ABJ,462,104,334,470,111,343,361,97,264,364,113,251,364,85,269,515,108,401
39141071AAI,481,166,300,488,202,269,400,173,227,406,199,207,410,181,223,544,208,323
39141071ACP,377,93,259,391,98,278,288,97,191,288,117,171,287,100,173,444,81,360
39093047AHC,622,226,365,632,257,342,450,225,225,460,262,198,466,213,239,655,304,343
39093047AEG,391,304,62,408,360,43,225,198,27,238,211,27,239,203,30,358,294,58
39025013ABO,339,39,285,345,59,274,282,64,218,284,72,212,283,61,210,409,76,329
39025013ADP,702,147,510,714,188,488,520,172,348,525,183,342,524,154,339,790,220,559
39067034ABI,263,87,158,269,78,175,221,91,130,224,107,117,229,74,144,283,72,206
39079040AAS,499,123,354,510,94,401,369,79,290,373,118,255,377,93,276,526,93,427
39145073AEG,379,132,230,376,96,267,269,104,165,273,130,143,276,105,159,360,92,263
39153077AZW,454,292,131,464,319,125,353,281,72,361,300,61,363,283,69,497,362,127
39123062AAU,671,214,427,671,250,386,575,247,328,581,330,251,587,273,292,723,250,463
39123062ACY,415,123,269,430,161,250,369,146,223,382,190,192,382,150,217,492,163,317
39147074ACL,392,88,285,394,87,290,312,90,222,317,134,183,319,77,226,430,95,332
39003002ACE,598,210,370,605,244,324,486,207,279,484,247,237,483,196,276,630,267,350
39175088AAD,431,117,288,435,136,264,321,116,205,319,141,178,327,115,193,449,139,303
39175088AAJ,546,135,379,551,171,332,399,148,251,408,194,214,412,145,246,625,189,417
39175088AAA,501,80,396,505,117,367,397,116,281,393,153,240,403,115,278,531,140,383
39067034AAA,149,33,113,154,27,125,129,37,92,129,48,81,130,33,93,178,26,152
39067034ABA,156,31,116,159,28,123,142,43,99,140,49,91,142,43,96,191,39,151
39131066AAR,883,257,586,893,238,615,667,218,449,682,277,405,678,210,453,918,232,676
39109055ACP,594,100,476,597,132,440,488,125,363,498,165,333,498,116,361,631,137,485
39109055ABV,800,97,671,816,131,658,611,107,504,625,165,460,626,121,478,890,153,728
39109055ACS,902,134,734,905,177,695,691,147,544,700,193,507,708,163,521,957,220,723
39093047AFZ,1053,484,505,1090,569,485,880,512,368,911,572,339,913,539,358,1390,708,667
39155078AGG,730,231,461,753,222,495,564,220,344,565,250,315,568,221,326,769,229,525
39141071ACK,614,188,398,632,218,381,519,211,308,522,251,271,522,205,306,690,257,421
39141071ADA,758,194,532,768,222,518,565,193,372,570,237,333,569,191,365,839,224,605
39141071ACX,667,186,444,676,207,445,519,184,335,525,233,292,525,170,330,784,202,574
39043022ACN,273,80,176,276,98,167,219,91,128,220,111,109,223,86,125,266,103,160
39043022ADS,449,129,295,452,179,245,385,181,204,388,213,175,382,169,197,524,207,314
39049025ALI,486,352,106,500,396,74,320,268,52,324,273,51,324,267,48,518,423,82
39145073AEF,500,164,316,509,124,365,362,151,211,368,176,192,372,154,203,515,120,383
39145073ACC,355,120,224,353,80,261,294,92,202,299,112,187,302,92,198,348,68,278
39145073ACO,434,123,294,441,101,327,343,102,241,352,132,220,353,108,240,464,105,358
39025013AHW,696,161,501,692,224,419,607,242,365,609,255,354,612,217,366,758,330,408
39023012AAK,549,174,335,553,209,314,389,174,215,392,216,176,393,165,213,555,211,329
39023012AFP,869,291,533,876,364,471,652,287,365,657,351,306,655,284,353,924,375,538
39041021AEG,529,148,374,529,219,299,467,185,282,467,223,244,472,187,283,686,326,356
39153077ACG,583,546,20,609,589,15,416,400,16,423,411,12,414,393,15,498,465,27
39153077AAA,397,282,65,403,320,61,285,226,59,292,235,57,286,223,54,384,295,83
39153077BCY,627,180,412,658,209,422,518,181,337,533,201,332,530,177,327,731,196,525
39153077AQX,727,318,396,752,454,263,656,423,233,672,466,206,670,424,239,949,617,325
39141071ACC,657,206,415,677,212,448,474,185,289,480,211,269,483,176,291,694,198,483
39141071ABX,685,202,448,707,195,474,603,198,405,614,252,362,614,206,379,881,211,662
39141071AAX,293,126,156,298,145,140,240,117,123,244,135,109,245,120,118,341,174,165
39113057ANX,627,141,457,638,179,423,516,187,329,518,226,292,519,178,319,675,233,429
39113057AFC,384,193,164,394,254,117,257,157,100,260,170,90,261,146,104,388,237,145
39113057ATR,1019,186,784,1030,261,719,822,250,572,832,307,525,827,247,551,1084,327,743
39113057AVA,422,98,306,428,109,303,325,100,225,328,129,199,332,106,210,498,116,371
39167084ACM,313,102,197,317,63,237,218,59,159,223,79,144,224,57,164,304,62,241
39061031BCO,830,284,522,844,349,452,660,316,344,664,349,315,667,306,342,882,430,443
39061031BQL,662,308,319,672,367,272,527,326,201,538,351,187,539,324,196,678,383,276
39061031AUV,418,195,204,429,234,173,340,211,129,343,226,117,343,208,127,508,300,199
39061031ACZ,689,598,70,705,677,15,557,535,22,563,548,15,564,524,29,666,633,28
39061031AFH,762,676,67,780,749,19,701,683,18,704,689,15,704,667,25,855,815,35
39023012AFH,929,142,739,931,192,704,685,150,535,701,217,484,701,152,529,997,225,754
39123062AAM,534,194,306,544,241,270,438,213,225,442,267,175,443,199,226,583,233,332
39141071AAL,347,163,172,348,166,157,279,150,129,281,173,108,285,150,129,390,207,174
39141071ACY,763,228,490,770,224,521,619,201,418,626,239,387,625,204,407,869,229,633
39141071AAG,594,236,342,598,270,310,477,236,241,478,268,210,482,235,239,674,297,370
39141071AAJ,525,201,304,520,253,254,452,221,231,450,261,189,459,217,238,527,260,263
39107054ABM,929,54,860,932,50,854,837,77,760,837,135,702,856,67,763,1014,73,934
39003002AFI,696,214,460,692,277,392,567,225,342,577,296,281,580,231,331,725,299,414
39107054ABD,609,72,528,601,76,510,459,74,385,466,113,353,466,72,390,612,99,509
39171086AAL,703,141,515,705,176,482,532,157,375,532,206,326,533,150,368,749,187,549
39171086AAF,360,75,271,365,110,239,285,96,189,284,132,152,287,89,189,388,142,238
39155078AIG,408,176,207,416,185,212,351,181,170,357,211,146,357,195,147,462,203,254
39155078AAA,634,307,308,654,343,299,561,331,230,576,385,191,572,345,216,708,389,316
39047024AAH,367,81,269,368,97,255,266,78,188,262,91,171,262,76,181,437,116,317
39047024AAM,707,140,549,717,186,516,621,150,471,622,212,410,628,164,458,840,217,609
39007004AES,713,181,494,724,180,520,581,187,394,594,224,370,593,201,373,808,216,584
39007004ABM,322,147,151,326,144,169,267,145,122,273,168,105,273,143,112,339,154,177
39007004ACA,351,72,251,350,80,252,289,90,199,297,113,184,294,87,193,362,97,260
39007004AEB,478,117,320,485,126,341,389,115,274,393,145,248,395,121,258,525,133,385
39007004ACT,356,97,227,360,92,250,273,80,193,280,119,161,278,97,165,377,96,268
39007004ACQ,351,74,250,361,83,266,280,76,204,284,97,187,282,74,198,388,80,305
39007004ADU,475,131,307,483,149,312,368,139,229,369,165,204,369,133,218,519,145,366
39025013AHG,357,91,250,357,133,195,308,128,180,309,140,169,312,123,172,404,170,224
39025013AEE,324,65,250,327,79,233,234,68,166,233,92,141,235,66,162,337,82,249
39025013AEJ,538,84,431,534,94,416,428,107,321,427,114,313,427,99,314,560,128,422
39025013AGN,413,93,298,413,128,256,301,108,193,300,122,178,302,99,191,442,162,277
39049025ADF,646,351,275,643,419,195,603,385,218,603,428,175,610,412,190,730,527,193
39049025ANV,903,396,482,899,499,360,831,411,420,824,487,337,832,447,376,961,593,365
39049025AJO,565,361,177,587,418,144,444,331,113,451,355,96,451,332,108,644,463,168
39049025BNF,446,285,139,461,330,114,349,260,89,351,276,75,353,260,85,434,355,77
39049025BBI,556,206,325,569,244,302,411,197,214,408,235,173,411,204,201,608,274,323
39001001AAZ,497,91,385,508,106,386,365,93,272,369,115,254,378,85,285,562,101,452
39001001AAS,427,79,332,432,78,340,313,72,241,317,80,237,322,78,237,474,90,379
39151076AMT,989,311,623,1002,352,607,834,366,468,830,398,432,840,354,457,1109,421,673
39151076ALM,453,143,290,465,181,265,319,136,183,325,159,166,325,137,179,466,174,284
39151076ADH,389,198,174,390,214,150,307,193,114,314,206,108,313,194,111,374,220,147
39151076ABR,548,463,61,558,498,52,441,408,33,455,421,34,458,407,37,511,444,65
39151076AFD,732,206,493,719,290,399,642,294,348,645,332,313,652,275,356,746,343,397
39151076ABM,436,230,161,442,247,171,310,203,107,311,217,94,311,196,103,449,244,200
39151076AJS,1027,229,750,1041,260,751,843,258,585,856,317,539,858,247,590,1216,273,928
39049025AQW,825,426,370,850,525,292,741,477,264,750,525,225,747,482,248,953,637,294
39049025BMZ,509,286,199,527,345,154,433,282,151,431,309,122,432,280,137,574,384,172
39049025AOI,578,325,227,600,394,175,407,300,107,411,314,97,412,301,102,583,409,163
39049025BCV,722,377,313,735,430,272,532,321,211,535,357,178,544,341,186,847,455,373
39049025AHW,540,288,216,551,330,199,375,248,127,380,280,100,384,261,113,584,340,231
39049025ATC,635,226,382,653,278,344,533,242,291,535,284,251,538,262,268,711,308,385
39049025BNA,565,165,382,583,220,335,523,212,311,527,260,267,533,255,271,581,244,331
39049025BGX,580,313,237,590,361,187,399,285,114,403,310,93,400,282,107,607,411,178
39049025ATW,961,344,605,948,486,419,879,414,465,879,517,362,894,461,416,1017,590,420
39049025ABR,582,504,56,586,535,30,517,474,43,524,488,36,519,463,36,699,628,60
39049025ARH,466,135,324,466,198,237,448,174,274,445,223,222,454,201,246,508,261,237
39007004ACS,340,106,198,355,114,232,247,82,165,256,105,151,256,88,153,383,101,277
39007004AED,685,228,402,690,255,405,534,221,313,550,262,288,546,214,305,741,247,480
39007004AAI,440,219,183,448,250,176,310,188,122,317,214,103,320,186,124,476,257,209
39007004ADT,413,94,281,429,114,302,331,91,240,330,118,212,337,92,241,479,124,347
39025013ABN,504,50,430,514,67,425,383,47,336,381,64,317,379,37,333,558,77,475
39049025ADT,572,440,113,578,487,62,540,469,71,549,498,51,548,475,63,586,506,74
39113057AGK,546,473,56,573,545,20,432,408,24,444,425,19,443,410,27,564,528,28
39113057AAM,946,236,685,932,308,572,794,304,490,793,362,431,802,294,485,981,395,564
39113057ASI,911,462,395,947,549,344,596,375,221,600,407,193,602,363,219,963,582,361
39113057AWS,670,113,533,689,147,515,539,121,418,540,161,379,545,121,408,716,144,565
39021011AAA,378,105,239,383,124,234,278,117,161,279,132,147,280,110,157,428,143,279
39015008ACS,876,113,712,892,160,712,630,136,494,644,162,482,641,133,493,910,165,729
39037019ABS,809,80,697,816,99,686,610,85,525,612,142,470,617,96,497,841,111,716
39171086AAG,908,201,670,912,296,585,790,258,532,797,365,432,808,246,545,1025,405,605
39171086ABN,644,170,423,653,170,433,442,157,285,437,199,238,447,147,283,742,178,550
39171086ABP,863,199,589,877,254,570,654,222,432,657,301,356,673,201,441,937,280,639
39021011AAT,514,65,427,501,69,409,438,77,361,438,104,334,442,86,331,583,88,488
39025013AAA,409,100,282,415,133,251,348,129,219,350,146,204,354,123,220,462,196,252
39125063ABE,465,167,264,468,145,293,307,128,179,308,149,159,308,123,172,515,167,332
39021011ABO,621,153,432,624,153,439,459,131,328,463,167,296,465,132,309,738,167,556
39123062AAP,700,240,429,713,288,391,551,244,307,561,294,267,557,251,289,775,298,466
39055028AAR,514,103,385,518,134,364,406,127,279,413,152,261,414,121,282,579,128,446
39039020AAR,571,176,356,599,232,331,422,178,244,427,208,219,432,181,237,626,260,353
39161081AAU,547,121,396,570,121,433,467,94,373,468,118,350,463,95,358,622,123,492
39011006ABK,250,22,215,246,22,213,229,34,195,225,50,175,225,26,191,273,31,241
39011006ABC,530,43,470,539,61,466,450,61,389,449,100,349,442,49,389,578,69,502
39161081AAK,274,86,166,288,68,196,186,65,121,190,69,121,187,57,122,328,83,237
39049025BDL,846,437,371,878,528,307,725,473,252,731,516,215,732,473,243,929,589,327
39049025AHN,632,242,366,643,285,326,460,223,237,463,275,188,461,235,218,628,299,322
39049025ARM,426,185,221,426,226,171,351,202,149,350,221,129,355,208,138,464,276,182
39049025AVH,596,154,434,582,274,293,540,219,321,541,287,254,546,235,303,658,366,289
39141071ABP,400,96,280,419,118,291,280,68,212,280,92,188,284,74,198,465,96,360
39141071ACU,550,146,376,554,159,378,503,164,339,505,207,298,507,172,325,683,195,482
39081041AAV,654,172,454,660,179,468,544,200,344,553,232,321,554,189,358,718,229,484
39081041AAA,411,232,156,422,232,173,242,157,85,249,170,79,248,143,98,411,196,206
39169085ACA,872,204,619,887,215,617,727,232,495,741,271,470,745,242,483,992,253,727
39169085ADE,477,34,428,483,44,430,379,45,334,393,55,338,392,41,344,569,45,521
39133067AFP,496,127,328,518,150,347,428,157,271,433,190,243,431,155,262,581,184,391
39133067ABN,381,168,169,387,200,160,269,156,113,275,173,102,272,152,108,432,199,227
39133067ADO,540,232,273,549,260,250,467,263,204,464,282,182,473,258,198,613,294,309
39145073AEA,257,65,183,262,50,201,191,38,153,198,56,142,200,49,143,314,53,255
39145073ACG,384,123,248,385,88,290,294,93,201,297,116,181,302,92,204,467,100,360
39145073ADK,581,140,429,571,140,423,484,126,358,485,164,321,492,128,355,645,151,487
39019010ABB,445,88,323,452,84,342,361,109,252,361,119,242,366,97,256,488,86,401
39141071ACA,489,138,329,505,132,351,357,112,245,362,134,228,362,115,243,506,119,382
39055028ACA,738,177,533,746,239,483,613,209,404,630,240,390,627,212,406,883,293,581
39055028AAH,733,227,486,748,342,382,599,289,310,610,324,286,603,268,321,818,396,414
39049025BAZ,491,113,358,506,127,354,393,118,275,401,154,247,401,135,257,521,135,382
39049025BJT,834,354,430,851,408,408,657,361,296,664,399,265,667,363,288,933,471,440
39049025BCS,541,413,110,562,460,93,396,339,57,400,350,50,399,339,55,528,428,90
39049025BJF,481,285,185,483,346,117,472,324,148,480,366,114,477,343,129,637,472,153
39049025AVF,624,207,408,596,309,265,573,270,303,568,326,242,574,289,277,648,390,252
39049025AXU,746,395,335,748,493,220,727,459,268,730,507,223,731,475,243,822,572,237
39049025ASC,672,254,394,687,343,307,608,313,295,614,368,246,615,333,270,757,467,285
39023012AAG,520,224,249,538,287,214,326,197,129,333,222,111,333,178,137,555,276,268
39023012ADD,728,164,521,731,205,490,487,172,315,491,214,277,497,162,313,769,212,542
39023012ABD,439,258,139,450,310,103,220,165,55,223,171,52,223,158,59,314,207,94
39041021AEM,589,193,384,581,259,299,543,236,307,545,265,280,542,244,290,705,339,352
39043022ACM,697,169,500,686,243,425,639,252,387,645,295,350,647,252,382,751,300,443
39055028AAN,583,171,388,593,223,343,491,215,276,498,248,250,497,209,272,647,272,361
39043022ADC,686,240,416,672,297,346,537,261,276,537,297,240,541,256,267,718,327,385
39099050ACK,467,388,53,514,465,41,263,230,33,269,250,19,266,230,30,397,328,62
39093047AAU,930,270,607,933,372,514,829,378,451,852,445,407,862,363,479,1117,464,630
39093047ACD,739,285,404,739,345,358,608,326,282,619,378,241,629,323,281,992,506,475
39019010AAO,597,115,449,612,134,450,507,123,384,507,143,364,510,115,375,682,104,574
39041021ADE,587,133,442,584,220,349,523,196,327,524,245,279,528,210,312,652,307,339
39041021AGJ,580,132,438,580,218,346,680,222,458,681,273,408,687,241,441,928,420,496
39041021AFL,921,260,646,930,378,517,825,355,470,835,414,421,831,369,449,1051,511,529
39041021AGN,465,141,313,477,192,261,536,232,304,535,274,261,542,253,278,677,318,343
39041021AFE,317,96,218,333,133,183,374,163,211,374,191,183,379,177,195,966,501,455
39015008AAV,619,111,486,635,143,468,479,122,357,487,138,349,485,118,357,658,163,490
39015008ACM,592,118,457,612,140,455,438,118,320,449,131,318,442,108,316,666,135,528
39015008ACT,670,132,505,675,146,507,530,144,386,544,156,388,540,133,389,806,151,645
39137069ABE,509,51,424,526,67,429,419,64,355,420,112,308,423,59,352,539,64,468
39109055ABD,551,193,308,558,257,270,360,199,161,368,216,152,370,199,155,600,299,284
39099050AIK,544,280,225,559,287,234,401,247,154,400,272,128,403,248,135,613,310,295
39093047AIO,811,222,547,838,261,548,684,267,417,714,345,369,716,255,429,898,275,609
39093047ABP,627,288,298,635,333,267,487,301,186,509,347,162,513,311,191,689,371,313
39109055ACL,656,87,540,655,132,499,474,104,370,479,169,310,481,105,363,659,133,512
39169085ABT,536,103,409,545,103,418,419,108,311,423,133,290,425,102,313,607,116,487
39169085ADN,990,252,682,996,301,643,842,298,544,851,332,519,857,283,542,1079,333,725
39169085AAP,413,162,216,416,181,213,305,147,158,313,155,158,311,140,156,447,182,256
39137069ABK,605,41,536,608,71,517,515,67,448,509,105,404,514,65,443,652,91,553
39099050AJW,489,119,348,497,135,345,349,111,238,358,132,226,360,109,239,482,110,369
39109055ABM,806,182,586,811,229,526,612,210,402,621,265,356,634,221,380,896,313,555
39093047AIC,467,164,275,479,188,270,395,195,200,416,220,196,413,181,214,531,195,326
39111056AAR,469,171,280,474,127,328,383,157,226,388,181,207,380,139,223,510,142,360
39111056AAZ,607,181,388,630,115,491,456,172,284,470,205,265,463,137,315,676,112,556
39169085ACJ,821,150,626,832,178,621,615,154,461,618,184,434,620,159,443,886,187,686
39169085ADT,937,202,683,955,281,635,736,234,502,755,278,477,763,236,502,1002,286,703
39151076AIF,964,205,708,975,245,689,785,248,537,798,278,520,798,242,538,1095,310,771
39151076AEW,900,288,555,891,351,494,709,337,372,713,372,341,724,326,370,1020,479,529
39151076AKV,824,320,439,838,337,461,619,296,323,627,332,295,626,294,306,849,333,505
39151076AKO,411,171,209,417,202,192,309,179,130,310,198,112,311,183,119,464,218,235
39121061AAR,303,65,224,315,64,240,229,66,163,235,92,143,230,60,167,315,53,261
39025013ACC,430,82,334,435,110,303,329,107,222,329,115,214,331,101,217,477,183,290
39007004ADW,643,221,361,649,225,391,498,197,301,510,248,262,509,203,283,727,273,441
39007004AEL,479,200,257,471,225,233,394,198,196,405,232,173,407,201,194,537,250,281
39007004AEO,322,103,193,323,117,188,233,97,136,238,116,122,235,101,121,346,113,229
39007004ADZ,494,118,346,485,129,327,391,128,263,396,163,233,394,132,244,567,131,429
39159080ABD,707,173,507,718,284,414,657,255,402,663,304,359,668,272,387,894,379,509
39023012ACN,507,204,266,511,275,215,342,184,158,343,222,121,349,177,158,508,228,269
39169085ADP,497,152,318,492,189,284,421,174,247,426,195,231,431,177,244,534,215,310
39007004AAJ,255,132,100,259,137,109,187,132,55,199,142,57,190,125,57,255,144,110
39153077AOJ,604,231,351,624,302,295,489,259,230,496,287,209,493,250,234,693,366,320
39153077AOG,621,249,333,633,276,314,537,282,255,541,311,230,549,276,243,748,378,358
39153077AAN,796,477,291,805,545,220,751,541,210,772,574,198,767,543,210,877,640,229
39153077AOA,564,168,363,578,193,359,485,197,288,508,224,284,508,207,284,632,223,398
39153077ACE,515,481,14,544,517,14,380,370,10,394,387,7,387,375,10,440,414,19
39153077ACO,466,414,41,482,452,25,351,335,16,362,351,11,358,339,16,461,426,32
39153077BCK,743,249,454,744,305,399,636,284,352,663,328,335,662,271,373,874,375,492
39153077BAA,525,265,201,554,304,212,396,260,136,401,272,129,403,268,123,596,324,263
39153077AGV,648,452,175,661,506,135,549,431,118,563,449,114,559,424,122,691,543,140
39041021AAU,362,134,213,381,141,217,307,146,161,308,172,136,306,146,150,432,171,253
39041021ADD,628,190,418,644,262,344,577,242,335,580,288,292,582,257,315,753,374,364
39041021AAI,934,271,618,927,353,522,812,279,533,812,365,447,821,308,496,1062,455,596
39169085ACP,583,98,456,586,104,453,457,94,363,463,117,346,466,103,350,645,111,527
39037019AAK,679,103,553,677,171,490,516,131,385,528,197,331,532,144,371,705,177,518
39049025AXM,548,397,123,574,466,91,383,312,71,390,330,60,391,314,68,577,477,89
39049025AVR,864,431,403,869,535,301,798,494,304,801,553,248,809,500,282,930,642,274
39049025BIJ,578,353,197,603,413,165,632,505,127,637,539,98,639,513,117,953,751,192
39049025AKW,754,453,263,785,529,226,605,403,202,607,459,148,609,418,170,837,596,233
39049025AVL,687,243,436,674,373,268,633,302,331,636,375,261,643,326,311,733,440,283
39049025AKS,602,513,68,628,571,52,510,467,43,517,483,34,515,473,38,693,611,77
39049025AKL,617,225,347,630,271,331,452,221,231,459,259,200,462,237,212,704,298,391
39049025BMQ,370,150,201,380,177,186,438,254,184,440,265,175,442,255,178,584,345,233
39049025AZY,702,288,381,722,335,355,524,248,276,531,285,246,526,254,258,696,346,341
39149075AAZ,498,88,393,507,126,363,370,101,269,377,139,238,371,84,267,522,115,397
39149075AAB,603,105,457,607,147,428,449,135,314,455,164,291,450,126,301,635,156,466
39149075ABM,489,42,429,498,56,438,396,42,354,395,77,318,393,61,320,541,59,476
39133067ACA,350,163,142,376,181,168,249,150,99,252,157,95,248,150,88,371,188,172
39133067ACV,1039,385,591,1085,451,574,917,471,446,941,538,403,941,474,410,1350,620,710
39133067AEL,490,159,292,514,197,300,423,204,219,421,218,203,423,200,202,582,253,315
39085043AEB,664,234,404,676,290,356,536,274,262,542,302,240,543,254,277,775,369,402
39065033ABH,430,55,354,452,69,355,356,81,275,355,98,257,355,85,261,486,63,412
39105053AAM,422,112,287,436,81,337,297,84,213,310,125,185,307,94,198,436,100,328
39087044ACV,207,69,123,212,67,137,162,46,116,164,65,99,167,46,113,229,62,167
39029015ACZ,359,60,286,371,58,302,285,54,231,290,64,226,289,61,224,403,51,348
39029015AAP,660,242,357,688,221,436,494,221,273,504,244,260,502,210,274,724,248,466
39173087AAK,831,331,450,837,426,344,698,384,314,702,449,253,711,382,306,922,519,387
39017009ALS,626,244,353,637,291,312,441,202,239,459,229,230,460,211,235,654,307,336
39017009AGY,976,163,758,1003,187,779,746,182,564,781,217,564,774,184,571,1053,206,833
39017009ALF,459,116,325,458,155,283,365,144,221,372,164,208,373,137,227,473,191,274
39017009ADM,251,71,165,264,81,173,175,55,120,183,66,117,184,53,123,352,97,250
39017009AHC,187,28,152,195,30,158,132,32,100,136,38,98,137,30,105,194,26,167
39133067ADX,657,202,409,669,246,396,603,254,349,610,300,310,615,254,335,814,301,498
39133067AEN,539,138,367,567,176,372,493,198,295,503,228,275,500,180,300,693,198,487
39099050AOS,578,227,324,601,248,333,484,231,253,488,287,201,498,256,226,587,253,325
39029015AEV,619,144,443,634,143,462,482,131,351,498,158,340,494,141,338,714,147,554
39029015ABC,540,146,365,553,157,373,420,146,274,436,188,248,429,149,272,577,184,386
39029015AEW,553,115,413,575,123,422,466,118,348,487,151,336,481,129,336,661,147,501
39029015AEL,448,150,274,456,130,296,373,133,240,387,156,231,381,139,228,512,144,360
39099050ACL,558,475,70,579,532,40,419,385,34,434,407,27,429,390,30,514,465,47
39087044AAF,373,143,217,390,150,226,296,124,172,297,154,143,297,122,174,351,133,215
39113057AYJ,824,242,558,845,331,475,705,292,413,713,333,380,715,294,399,956,464,474
39113057AHA,636,482,131,644,531,92,526,428,98,529,456,73,531,437,78,648,545,93
39113057ARJ,707,161,513,715,227,453,575,217,358,580,255,325,580,211,352,769,271,480
39113057AGG,570,468,75,590,548,25,408,379,29,412,392,20,416,380,29,517,472,39
39113057AUE,328,98,211,341,114,218,239,78,161,238,87,151,239,76,152,367,115,244
39113057ACV,298,256,28,304,283,15,228,210,18,233,220,13,232,206,18,261,239,19
39073037AAB,819,269,513,829,318,473,693,306,387,717,398,319,716,317,377,889,358,517
39007004AEV,264,60,188,268,64,197,205,53,152,209,85,124,211,60,146,297,73,219
39007004ACU,700,229,420,702,241,421,518,212,306,525,253,272,529,203,303,761,260,485
39007004ABC,225,67,140,221,74,142,179,57,122,181,74,107,183,61,115,268,71,193
39007004ADC,419,127,270,424,149,258,341,134,207,348,167,181,349,129,208,482,175,298
39165083ABE,562,133,411,589,189,367,466,190,276,474,214,260,474,194,264,639,267,356
39155078AGH,418,92,300,420,95,312,335,105,230,338,127,211,340,113,212,456,103,350
39155078AGI,458,142,290,467,150,290,367,163,204,368,190,178,373,157,199,493,170,316
39155078AIA,723,364,322,736,391,327,567,333,234,581,375,206,581,352,215,797,413,373
39071036ABM,508,138,347,513,148,340,407,141,266,405,156,249,413,133,263,587,138,438
39147074ACE,403,75,313,406,94,296,318,84,234,325,118,207,329,89,230,415,90,321
39165083AGT,566,109,435,590,156,404,498,139,359,508,159,349,516,133,366,823,234,575
39161081AAN,288,61,211,301,72,210,205,36,169,208,57,151,207,42,155,318,74,234
39071036AAU,511,62,427,514,77,423,382,75,307,384,94,290,387,64,318,557,86,468
39007004ACJ,392,151,207,391,170,200,308,140,168,317,176,141,314,141,159,381,166,208
39065033ABM,368,43,299,374,53,307,286,63,223,286,87,199,287,64,213,396,57,335
39049025BGB,508,197,290,513,245,227,479,245,234,482,283,199,488,259,204,642,351,268
39049025BDE,1078,349,711,1073,524,499,1025,466,559,1033,572,461,1037,503,527,1378,818,547
39049025AMV,595,300,280,607,359,210,578,348,230,584,392,192,582,357,209,697,454,224
39049025AKT,533,389,122,543,433,99,447,366,81,461,398,63,457,372,71,599,470,120
39049025ANM,674,334,306,678,386,270,576,360,216,578,396,182,582,368,199,738,476,254
39049025AEG,835,589,202,831,668,105,789,682,107,800,712,88,801,683,101,888,785,84
39143072AAD,255,61,183,262,81,168,187,83,104,191,113,78,190,88,90,289,94,192
39157079AEA,480,121,335,483,143,326,366,130,236,370,162,208,371,119,232,528,122,401
39113057AVT,944,175,731,952,286,614,856,271,585,864,356,508,860,260,576,1011,394,599
39113057ABM,615,220,330,636,302,308,399,203,196,402,232,170,404,188,191,614,274,324
39113057AQL,611,529,63,619,587,24,447,420,27,458,445,13,456,426,26,590,555,32
39113057AXD,721,283,415,721,355,345,619,326,293,632,365,267,625,326,288,763,428,325
39113057ABC,1296,490,741,1371,751,544,586,381,205,591,417,174,596,374,197,492,326,159
39113057AQU,583,487,77,595,553,27,473,434,39,477,456,21,477,437,34,550,519,28
39113057AMX,866,324,500,855,424,385,776,402,374,779,457,322,783,411,352,970,562,386
39113057AKD,943,327,578,953,385,524,719,357,362,728,402,326,729,341,361,1019,459,545
39085043AGT,845,319,463,873,352,452,714,344,370,718,393,325,723,328,372,866,368,479
39133067ABX,638,249,354,661,280,344,502,286,216,503,304,199,507,276,210,761,360,386
39085043ACJ,890,340,490,926,408,471,723,356,367,731,404,327,739,335,369,1003,482,502
39085043AGF,620,151,422,638,191,407,515,186,329,520,223,297,527,183,319,720,234,470
39085043AGG,457,173,241,481,169,270,354,167,187,354,199,155,359,154,178,533,198,326
39085043AFK,588,140,428,607,187,402,574,195,379,584,222,362,585,184,391,821,246,571
39085043AIW,394,94,287,408,126,271,386,131,255,392,149,243,393,123,265,537,190,344
39085043AHY,921,184,714,931,257,641,815,259,556,820,298,522,820,254,558,1125,330,791
39133067ABS,472,204,225,490,248,214,345,183,162,346,215,131,346,180,149,555,290,258
39085043ADS,593,267,289,623,315,280,468,272,196,470,292,178,472,248,207,672,363,302
39085043AAW,614,207,374,636,251,349,535,265,270,535,299,236,547,258,270,696,309,376
39085043ACH,780,260,477,807,281,488,639,272,367,644,318,326,652,270,357,946,344,588
39143072ABS,590,182,392,612,239,350,475,205,270,488,260,228,488,193,280,628,235,390
39143072ACB,407,89,283,417,122,272,323,107,216,327,140,187,321,112,195,461,118,336
39173087ABB,664,244,383,683,334,299,485,263,222,496,301,195,499,244,232,692,362,321
39173087ACK,749,313,384,758,339,363,532,293,239,533,334,199,538,282,224,788,346,421
39173087ABE,726,264,436,738,307,389,538,259,279,539,291,248,541,258,261,881,441,432
39017009ADZ,451,133,298,454,156,276,359,145,214,369,163,206,365,144,211,504,203,292
39017009AJU,439,89,325,452,133,300,338,119,219,346,130,216,341,116,214,497,186,304
39017009AAG,500,165,321,508,212,278,424,195,229,433,211,222,436,191,237,557,267,284
39017009AGB,179,22,153,183,23,151,128,26,102,132,33,99,137,22,112,197,36,159
39143072AAW,454,156,267,457,212,214,327,174,153,336,214,122,332,168,154,489,243,239
39143072ACG,502,170,294,497,190,252,381,158,223,386,200,186,385,158,198,567,222,336
39087044ACR,558,162,365,580,133,428,456,126,330,462,151,311,469,134,327,705,164,534
39087044ACS,395,121,261,406,99,301,340,97,243,343,124,219,344,91,246,452,133,315
39087044ACT,236,96,130,242,71,160,164,62,102,166,79,87,171,62,107,235,66,166
39149075ABH,644,52,574,644,74,541,509,72,437,515,112,403,513,83,415,679,89,580
39133067AGA,588,201,354,617,223,374,504,212,292,506,230,276,513,207,276,659,227,419
39151076ABC,295,160,105,300,192,88,178,120,58,179,126,53,180,119,53,252,164,81
39151076AEJ,434,305,107,444,323,104,289,217,72,297,232,65,297,218,66,421,283,132
39151076AEE,524,228,246,543,266,256,403,220,183,404,245,159,404,199,186,550,247,287
39151076AKD,722,231,451,738,213,483,512,202,310,515,227,288,518,190,307,758,234,515
39151076AIA,732,175,524,748,241,468,585,224,361,599,248,351,604,233,358,875,315,549
39151076AHV,484,132,314,494,176,290,394,170,224,402,183,219,407,175,218,534,213,313
39151076ADM,607,157,414,621,193,398,472,181,291,472,197,275,482,163,299,727,234,482
39093047AEA,364,274,63,384,322,46,205,174,31,219,192,27,218,188,24,302,216,79
39093047AIU,1024,262,708,1062,352,660,813,314,499,842,376,466,839,313,501,1163,416,727
39093047ABZ,713,532,145,724,564,142,468,380,88,493,416,77,495,389,89,691,494,186
39109055ACY,795,111,644,801,174,588,617,156,461,629,203,426,635,149,462,858,197,648
39109055ACD,509,77,423,509,98,385,400,94,306,401,131,270,412,98,292,533,127,392
39093047AFV,647,321,297,658,357,284,635,404,231,650,438,212,651,391,237,1154,657,484
39093ZZZZZZ,0,0,0,0,0,0,0,0,0,0,0,0,0,0,0,0,0,0
39099050ANA,616,168,435,647,181,454,537,177,360,536,212,324,537,189,338,703,224,472
39139070ABT,927,157,719,938,176,741,758,170,588,775,211,564,776,166,589,1030,191,825
39173087ACP,1151,309,811,1159,430,685,1090,445,645,1100,528,572,1109,439,662,1676,711,947
39017009ADF,152,60,79,163,62,95,86,33,53,90,38,52,92,33,52,158,68,90
39049025AUM,695,294,384,695,357,315,599,344,255,604,381,223,611,355,242,785,511,262
39049025BNN,458,195,254,459,238,209,398,229,169,400,252,148,403,234,160,500,270,219
39133067ACK,393,147,214,418,178,220,250,133,117,252,136,116,254,123,119,422,179,230
39085043AFP,811,176,611,835,264,527,683,235,448,689,271,418,698,219,462,911,322,578
39149075AAS,497,109,347,505,139,327,315,110,205,315,122,193,318,101,199,505,132,360
39073037AAM,831,244,558,854,271,554,675,243,432,687,300,387,692,267,400,928,292,623
39155078AKV,513,171,321,528,202,298,402,179,223,415,220,195,406,184,212,576,229,344
39147074ACB,666,184,451,683,212,438,503,179,324,516,236,280,520,182,317,721,208,500
39147074ACJ,816,154,620,826,203,564,629,178,451,648,262,386,653,161,462,858,212,630
39157079ADJ,446,167,241,451,171,245,348,184,164,353,203,150,354,176,164,536,189,337
39151076AAF,605,245,320,614,261,323,431,227,204,437,248,189,435,215,197,635,270,351
39151076AOJ,948,232,667,946,273,641,822,270,552,823,332,491,829,271,534,1004,296,697
39151076AMY,649,215,400,651,250,374,554,249,305,558,274,284,556,232,311,705,276,422
39151076ACS,596,295,254,612,353,235,472,286,186,473,317,156,475,294,161,655,368,279
39155078AER,945,342,547,968,398,533,805,390,415,815,454,361,807,399,388,1046,455,577
39155078ADT,564,267,269,584,301,254,412,252,160,424,281,143,422,250,162,586,330,249
39147074ABX,394,80,296,405,94,274,341,102,239,342,143,199,346,93,246,447,116,327
39165083AHF,1054,192,818,1071,280,750,973,285,688,990,318,672,989,276,691,793,246,535
39165083AEA,458,89,353,470,122,320,488,147,341,497,161,336,498,142,344,1115,352,745
39165083AFX,869,190,658,872,273,555,747,256,491,759,296,463,760,258,488,1196,427,753
39165083AET,833,153,664,836,233,578,697,196,501,709,237,472,713,201,505,946,339,596
39155078AKW,588,172,382,608,243,342,516,230,286,519,284,235,522,227,280,650,249,393
39155078AGC,659,144,469,658,151,475,485,143,342,498,176,322,498,127,351,721,167,550
39155078AKM,605,268,320,620,300,300,471,247,224,478,283,195,478,257,213,649,302,341
39157079ACZ,478,131,315,490,150,315,389,156,233,395,171,224,390,147,232,525,166,349
39049025BKP,767,232,513,773,350,379,679,299,380,683,373,310,690,338,341,834,464,351
39049025AMZ,604,338,245,616,401,166,557,401,156,561,436,125,563,395,147,783,592,171
39151076AIE,960,221,684,987,263,670,778,271,507,787,302,485,790,264,508,1132,357,767
39151076ALK,852,292,520,875,328,513,700,297,403,703,350,353,709,295,397,936,338,585
39143072ACS,613,128,464,625,194,405,532,170,362,539,227,312,539,165,353,707,224,469
39049025BDP,455,161,278,454,224,209,393,214,179,394,242,152,398,221,174,510,308,200
39049025BGE,557,354,169,591,410,155,437,326,111,436,339,97,439,329,95,639,462,164
39049025AWF,722,231,477,717,348,350,697,301,396,696,360,336,703,323,373,805,437,358
39049025ABL,547,454,72,560,501,40,470,424,46,471,442,29,474,429,32,628,561,61
39049025AIO,498,300,169,510,340,139,449,277,172,453,315,138,454,298,145,584,380,196
39049025BMD,623,376,213,632,423,171,441,325,116,446,357,89,451,341,101,632,453,164
39049025AIP,603,316,247,625,371,224,508,329,179,509,364,145,515,314,182,692,440,245
39049025ALD,1039,512,480,1045,585,407,863,497,366,862,570,292,870,518,324,1131,708,402
39049025AAQ,447,303,102,457,361,77,354,291,63,354,308,46,356,291,49,607,491,104
39153077AZQ,749,399,310,771,500,230,668,453,215,691,505,186,691,471,201,813,572,232
39153077AZJ,674,264,363,697,311,367,564,300,264,576,337,239,574,302,259,735,364,365
39153077AHS,561,228,275,583,254,303,447,252,195,450,269,181,447,256,180,651,305,341
39049025ATF,843,292,514,864,333,478,676,296,380,683,350,333,692,327,346,964,398,550
39049025BAI,610,288,291,629,338,266,485,277,208,488,308,180,492,287,198,703,407,288
39049025ADC,748,511,216,764,628,109,694,565,129,697,600,97,702,574,114,884,738,133
39049025AEH,775,431,302,793,508,217,726,497,229,737,547,190,739,502,222,846,602,231
39049025ABA,416,343,44,435,384,34,347,316,31,347,324,23,350,318,26,497,432,54
39049025AGD,255,143,101,275,167,102,183,115,68,186,124,62,186,118,63,287,145,139
39049025ALT,712,577,93,716,628,62,630,568,62,636,597,39,636,574,43,772,691,70
39133067AAQ,466,233,205,489,260,197,387,252,135,391,267,124,386,233,134,520,305,205
39133ZZZZZZ,0,0,0,0,0,0,0,0,0,0,0,0,0,0,0,0,0,0
39085043AHE,427,144,260,438,168,248,361,162,199,361,179,182,365,162,192,461,190,263
39085043AHC,492,111,354,498,136,338,411,144,267,409,170,239,416,136,271,562,174,384
39153077BCU,752,228,496,770,321,422,653,295,358,679,341,338,680,278,390,921,417,493
39153077BBJ,481,201,251,495,250,219,418,236,182,430,268,162,429,238,186,552,309,240
39153077AFL,453,277,147,472,296,150,339,234,105,350,251,99,349,239,96,476,314,152
39153077ABE,329,191,109,342,195,138,247,169,78,254,173,81,254,163,79,337,190,140
39051026AAI,459,120,320,472,142,305,322,110,212,320,140,180,323,116,197,459,148,299
39113057ABZ,735,310,378,735,375,326,627,356,271,626,397,229,631,342,267,768,426,332
39113057AMD,609,256,302,639,339,246,414,254,160,415,273,142,424,247,162,684,435,234
39113057APU,850,240,563,860,287,517,624,245,379,633,289,344,635,226,379,899,315,566
39047024ABE,260,74,170,261,80,165,179,62,117,176,71,105,178,64,108,300,83,210
39047024AAP,345,102,230,352,117,226,232,84,148,232,108,124,235,87,142,375,128,243
39049025AZF,390,93,270,409,105,286,290,85,205,291,105,186,291,88,195,421,120,298
39049025BNB,424,175,229,433,217,182,438,254,184,442,278,164,442,260,170,469,280,180
39049025BHY,433,178,236,435,223,184,445,257,188,447,281,166,449,263,173,1151,681,451
39049025BHO,767,338,392,774,372,333,674,378,296,682,433,249,686,376,291,842,522,307
39049025BGM,544,222,286,554,261,271,426,223,203,425,260,165,428,231,185,600,298,295
39049025ADB,767,492,253,781,614,138,684,559,125,692,599,93,693,568,114,868,707,148
39049025BAN,618,228,376,618,303,288,544,258,286,544,299,245,547,270,266,637,337,288
39049025ABO,272,228,30,282,254,18,289,269,20,291,276,15,291,259,18,439,397,34
39049025AGZ,699,507,168,712,587,83,638,531,107,642,570,72,641,540,89,760,646,101
39049025AID,994,695,247,1010,817,133,847,705,142,855,738,117,858,709,120,1078,926,139
39049025ADN,384,335,26,396,378,13,266,258,8,272,269,3,269,252,9,350,331,16
39049025AEY,804,523,239,823,590,199,634,468,166,642,506,136,637,474,150,865,652,203
39049025BGF,768,373,367,782,453,286,677,382,295,684,444,240,687,409,256,877,545,314
39049025ASB,580,332,220,602,368,195,491,329,162,491,346,145,497,329,154,662,445,207
39049025ABQ,620,537,46,655,614,30,420,391,29,422,399,23,430,396,26,595,546,39
39047024AAZ,370,137,209,375,141,220,255,112,143,251,132,119,257,100,142,414,138,270
39047024ABI,310,48,247,308,54,242,249,48,201,247,70,177,246,60,182,352,79,270
39071036ABF,825,99,693,831,111,699,656,113,543,657,137,520,660,108,537,881,132,745
39133067AAF,846,264,551,855,367,461,762,353,409,765,389,376,774,336,426,1060,530,526
39133067AEG,567,135,403,587,156,400,454,143,311,460,170,290,464,146,305,622,175,440
39061031AHF,824,534,239,866,610,194,543,452,91,546,466,80,549,448,79,681,558,110
39061031AGY,824,524,269,824,611,179,694,520,174,696,537,159,702,529,159,834,615,204
39061031AHA,596,458,114,616,551,41,529,471,58,529,472,57,532,464,48,697,617,64
39061031BGU,1027,174,829,1036,239,753,891,236,655,913,291,622,902,231,655,1112,361,732
39061031BNW,308,55,244,311,90,201,263,90,173,265,95,170,266,84,175,337,125,207
39061031AQR,587,312,240,595,364,203,460,293,167,459,298,161,460,274,169,632,410,213
39061031AHG,613,398,170,628,449,132,487,403,84,492,425,67,488,398,69,534,417,106
39111056AAT,212,74,126,219,52,159,155,67,88,159,81,78,152,57,92,221,45,173
39123062ABF,634,155,464,640,227,399,587,216,371,582,248,334,589,233,341,717,268,441
39055028AAS,659,199,420,651,250,367,531,228,303,535,263,272,532,211,293,762,317,434
39173087ABM,668,221,421,677,285,350,522,266,256,519,309,210,527,272,239,694,317,371
39017009AGO,991,217,744,1003,304,652,837,310,527,859,343,516,860,303,535,1170,445,703
39017009AGC,591,103,461,613,125,474,473,120,353,488,136,352,487,110,354,660,152,501
39173087AAW,642,207,402,641,268,317,545,268,277,544,304,240,557,257,279,680,364,305
39035018BJN,543,260,244,575,320,226,434,281,153,439,290,149,439,257,167,623,361,252
39113057AOE,897,242,615,918,315,570,697,235,462,709,283,426,707,227,460,933,324,588
39113057AIR,705,180,495,706,239,444,603,216,387,610,263,347,611,211,386,760,296,455
39113057ASJ,906,297,571,927,387,497,657,288,369,666,334,332,663,278,367,987,398,578
39113057ANH,533,180,331,543,237,269,465,229,236,466,267,199,472,215,239,571,308,250
39113057ANU,943,222,677,964,290,632,765,256,509,762,294,468,773,240,506,1037,380,636
39113057AUL,623,493,119,632,551,58,525,464,61,537,488,49,537,466,55,611,542,60
39113057AUF,936,659,237,944,783,144,697,577,120,721,626,95,709,574,118,901,739,156
39113057AJN,995,298,647,1010,379,591,773,301,472,779,381,398,783,312,451,1024,445,556
39113057AOG,841,238,571,859,323,491,655,262,393,670,325,345,665,260,385,898,380,504
39133067AGF,325,94,215,335,102,217,243,86,157,245,106,139,243,79,144,378,104,269
39085043ABZ,757,211,519,778,274,483,654,275,379,655,309,346,659,265,374,1020,410,604
39085043AAX,599,208,363,612,257,327,493,253,240,500,283,217,499,229,251,714,335,368
39085043AIL,778,196,529,793,242,507,628,234,394,637,272,365,640,208,403,880,281,588
39157079ABO,408,147,240,418,153,249,305,141,164,309,177,132,309,140,158,437,140,292
39157079AAY,549,161,366,551,190,343,458,191,267,460,211,249,455,177,264,566,224,337
39035018CIS,681,277,347,716,370,311,537,308,229,554,328,226,555,295,235,797,396,390
39035018AYZ,924,475,423,932,666,216,830,628,202,836,653,183,837,608,209,1277,942,323
39035018AGW,704,284,373,744,364,348,544,303,241,557,348,209,555,300,237,705,344,352
39035018BLZ,905,739,132,920,813,72,747,678,69,748,692,56,757,671,71,923,834,74
39035018BLQ,771,466,280,799,546,245,629,472,157,632,441,191,631,421,205,839,530,304
39035018BFX,376,300,50,409,363,35,245,219,26,240,217,23,244,211,24,327,277,45
39035018CCB,505,239,247,530,290,226,433,262,171,438,281,157,441,264,172,554,348,201
39035018AVQ,444,391,35,460,434,18,353,341,12,357,349,8,355,335,15,443,413,20
39035018AGO,625,301,280,642,325,285,487,275,212,490,293,197,494,260,211,584,296,284
39035018AAB,681,288,368,697,377,297,568,329,239,573,362,211,576,321,240,804,483,316
39035018BVH,835,203,604,876,280,558,755,312,443,761,338,423,766,289,458,1039,373,661
39035018BLH,698,370,312,722,421,285,548,383,165,551,346,205,550,322,223,771,353,416
39035018AJJ,417,325,68,447,382,59,274,236,38,272,238,34,278,235,42,397,334,61
39035018CNX,656,427,204,670,488,167,587,451,136,591,479,112,590,442,136,700,527,167
39035018AWN,705,478,186,718,544,140,625,492,133,631,526,105,633,491,128,724,571,146
39035018BKW,602,523,49,613,563,30,485,458,27,493,466,27,496,451,30,613,566,39
39035018AUF,579,484,76,616,563,45,372,342,30,379,353,26,381,341,30,450,412,33
39113057ARD,926,775,122,957,884,57,699,649,50,717,684,33,714,649,57,855,763,86
39113057AMH,728,213,469,744,301,395,627,276,351,633,328,305,633,278,335,806,367,422
39113057ACR,435,365,47,439,405,24,320,298,22,326,308,18,327,301,24,436,402,30
39113057AVQ,961,274,639,979,358,559,706,273,433,718,335,383,715,278,416,1017,413,584
39113057AUK,1019,592,385,1044,760,260,947,698,249,965,768,197,966,686,257,1144,854,276
39055028ACW,553,121,368,570,152,384,435,153,282,443,186,257,443,146,282,662,196,456
39017009AEN,337,131,193,334,144,178,274,129,145,278,140,138,277,127,146,403,165,231
39017009AHY,231,30,193,239,41,189,162,32,130,173,49,124,174,37,131,255,48,205
39035018BSG,815,385,377,847,489,311,725,472,253,733,508,225,734,453,260,958,593,352
39035018BCU,496,237,218,537,310,208,371,222,149,379,250,129,379,218,153,583,324,253
39035018DBW,857,339,496,859,483,342,794,497,297,797,491,306,804,439,355,997,629,357
39035018AGH,598,299,254,644,369,246,497,301,196,501,335,166,506,297,183,660,375,279
39035018CNA,852,390,447,875,567,290,775,558,217,772,553,219,773,521,249,1024,732,289
39035018BES,594,373,190,617,464,122,488,381,107,495,404,91,494,388,99,663,505,150
39035018DEK,451,422,11,472,461,5,390,382,8,397,395,2,397,383,9,440,433,5
39035018BHT,458,237,191,502,309,175,351,233,118,353,245,108,359,211,131,521,319,199
39035018ALR,336,313,14,353,347,2,264,256,8,263,259,4,265,257,5,300,287,12
39035018BDY,434,310,89,456,369,66,384,332,52,392,350,42,393,332,49,541,459,76
39105053AAK,337,90,227,352,72,266,271,72,199,274,106,168,285,90,187,384,71,310
39105053AAU,162,51,97,165,44,110,121,47,74,124,64,60,125,48,74,163,41,118
39157079ABL,588,197,372,599,206,370,471,200,271,482,239,243,479,204,262,616,226,377
39157079AAC,708,196,474,713,238,443,632,265,367,646,307,339,643,246,380,789,279,492
39157079AED,680,89,554,699,110,548,567,126,441,569,158,411,570,119,434,786,152,617
39113057AWJ,583,174,387,584,223,336,488,192,296,489,230,259,494,189,293,670,287,369
39157079ABK,532,169,343,535,200,315,457,197,260,458,234,224,457,185,258,579,216,353
39085043AAK,699,241,433,738,261,452,585,257,328,591,301,290,592,251,321,810,307,494
39149075AAQ,990,176,745,1003,239,713,694,195,499,707,270,437,701,208,463,1038,257,763
39149075AAF,908,141,742,917,208,677,813,198,615,821,254,567,827,220,588,1064,256,793
39149075ABC,475,36,426,481,44,429,397,56,341,400,93,307,401,58,335,515,42,469
39133067ABA,446,270,137,469,300,128,368,272,96,377,287,90,372,268,81,469,332,129
39133067ABO,414,179,188,424,214,184,327,197,130,325,215,110,328,201,108,437,215,220
39133067AFV,663,164,450,684,194,467,534,182,352,534,203,331,537,180,342,795,228,560
39111056AAL,238,85,137,239,60,169,177,87,90,178,99,79,182,71,106,238,63,169
39017009ACY,409,106,280,426,135,271,240,77,163,252,95,157,245,73,162,454,142,302
39055028AAY,781,181,573,774,233,502,644,227,417,661,288,373,661,235,413,855,330,512
39043022ABY,576,209,320,588,257,291,514,270,244,509,305,204,514,257,233,670,314,334
39055028ACV,758,243,490,762,326,403,683,308,375,691,343,348,693,293,385,899,438,447
39017009AKI,501,137,336,513,203,288,362,153,209,367,184,183,360,142,209,544,241,293
39017009AHM,704,75,602,708,105,585,584,103,481,597,124,473,595,96,481,788,118,663
39173087ABY,723,202,485,733,244,439,510,204,306,510,248,262,518,205,280,755,260,478
39017009AKU,380,142,203,387,168,201,211,104,107,216,112,104,214,97,109,389,164,223
39017009AFV,589,121,440,608,164,410,490,162,328,504,180,324,501,154,332,638,220,408
39017009AIA,540,72,446,549,112,422,462,109,353,468,129,339,473,94,361,616,134,471
39017009AAU,545,199,313,563,248,283,407,216,191,419,228,191,416,206,193,622,299,312
39017009ABU,514,146,332,523,157,335,319,119,200,332,129,203,333,124,193,522,180,330
39095048ARX,1047,266,761,1066,329,686,858,288,570,859,340,519,869,272,578,1226,413,797
39095048ABT,701,215,463,721,267,413,589,246,343,599,289,310,600,242,339,882,379,488
39095048ALS,559,339,176,566,369,161,373,275,98,377,300,77,372,261,87,524,362,148
39095048ASO,874,369,481,893,428,414,586,328,258,586,374,212,597,330,249,930,499,414
39095048AAX,617,282,304,637,327,276,391,223,168,396,249,147,401,216,167,571,316,244
39095048AAY,816,314,467,840,367,426,742,396,346,752,452,300,763,392,343,977,449,518
39095048AFX,676,546,103,707,613,84,516,446,70,520,452,68,522,444,73,703,582,113
39095048ATI,927,313,584,944,373,522,805,352,453,807,405,402,814,330,469,1078,440,623
39095048ASQ,1015,331,656,1038,442,539,851,409,442,869,471,398,872,406,445,1164,554,596
39095048AJQ,708,397,283,728,468,215,848,570,278,850,620,230,859,576,263,1070,727,328
39167084AAE,820,234,553,857,208,616,672,208,464,678,261,417,689,194,479,944,261,676
39061031BAI,743,187,535,740,286,428,629,258,371,628,286,342,636,269,358,799,377,413
39009005AAX,358,163,166,366,165,182,284,157,127,293,187,106,290,163,110,367,156,199
39061031ACD,782,295,465,795,443,297,650,377,273,654,408,246,654,360,267,844,539,287
39061031AGO,945,604,298,948,751,159,906,720,186,910,754,156,914,712,175,1029,823,196
39061031ATD,464,134,318,463,189,241,386,175,211,389,203,186,391,178,201,500,264,225
39061031BLS,906,524,352,930,608,291,722,481,241,728,515,213,730,474,235,920,637,268
39061031AVH,544,205,304,560,250,280,413,217,196,412,232,180,414,209,187,602,301,290
39095048AHT,573,344,190,591,377,178,381,265,116,383,292,91,385,258,108,507,332,163
39081041AEG,438,144,256,456,130,310,361,158,203,374,186,188,372,140,224,473,113,354
39081041ACI,503,145,332,520,152,350,405,153,252,411,174,237,411,148,251,536,180,353
39061031AQQ,379,296,66,389,333,48,280,242,38,281,247,34,284,239,37,377,329,41
39061031BKD,1022,122,860,1051,199,800,883,208,675,886,235,651,897,197,681,1094,259,817
39061031AMB,854,646,153,868,726,101,731,651,80,730,667,63,735,630,75,943,815,112
39061031AUI,390,204,167,397,251,129,309,209,100,313,216,97,315,195,110,403,274,124
39081041ACU,329,78,242,342,70,256,265,72,193,265,83,182,262,58,194,357,67,289
39081041ABC,613,214,361,641,195,420,470,215,255,480,233,247,479,173,290,666,219,432
39077039ACL,253,64,170,260,67,182,184,62,122,185,78,107,186,59,110,288,54,229
39127064ABC,536,102,410,544,110,419,436,114,322,445,153,292,454,124,320,666,133,523
39083042ABI,455,68,366,463,71,375,388,84,304,386,97,289,391,82,299,496,87,408
39059030ABA,612,100,486,625,118,480,475,123,352,475,138,337,475,113,348,714,145,557
39059030ACB,284,41,215,293,57,230,224,51,173,223,66,157,223,45,171,361,57,298
39059030AAP,553,165,364,562,181,358,429,149,280,436,199,237,433,156,260,597,189,400
39129065AAX,609,142,444,618,158,446,472,137,335,473,161,312,476,145,325,711,186,517
39121061AAZ,148,52,84,163,40,114,103,46,57,110,58,52,111,52,55,165,40,125
39115058AAN,492,92,377,493,100,371,380,91,289,385,137,248,396,90,286,549,105,439
39013007AAP,577,152,409,584,164,398,499,185,314,503,223,280,510,165,331,579,185,389
39013007AAT,343,109,224,344,112,218,307,125,182,316,151,165,319,124,185,365,131,225
39013007AAZ,296,94,178,300,86,201,212,78,134,216,103,113,216,69,140,333,97,230
39049025BBP,357,70,278,360,94,250,319,94,225,320,130,190,320,112,200,384,114,257
39049025ANY,880,450,378,913,573,283,722,486,236,730,522,208,731,493,216,980,657,302
39049025AXN,749,336,380,767,396,342,560,272,288,567,340,227,562,283,264,748,396,337
39049025ALB,509,382,101,529,426,87,502,403,99,508,429,79,506,408,88,664,536,112
39049025BMR,530,400,105,552,446,90,343,290,53,345,305,40,347,297,47,483,398,69
39049025AVI,590,230,340,583,323,240,554,288,266,556,336,220,560,313,238,656,387,262
39049025BHZ,545,238,293,562,311,230,676,382,294,681,437,244,682,393,278,947,569,368
39049025BMJ,665,285,358,683,376,281,379,204,175,379,237,142,382,212,166,523,327,193
39049025BIH,911,496,391,905,592,283,852,562,290,859,638,221,859,585,266,991,692,285
39081041ABZ,421,73,329,435,56,359,329,64,265,339,78,261,344,57,275,448,64,379
39081041ACB,630,170,417,635,155,460,522,190,332,522,208,314,524,150,358,655,133,512
39081041ADN,315,124,169,328,102,216,240,112,128,242,123,119,242,100,130,348,116,226
39083042ACA,455,100,336,455,124,304,378,105,273,388,135,253,388,119,256,522,134,384
39013007ABE,515,137,353,534,122,386,409,142,267,417,176,241,414,118,286,580,122,448
39063032ABO,594,208,349,595,250,292,442,203,239,448,264,184,454,195,247,651,268,369
39103052AFO,614,139,434,621,180,420,497,178,319,502,201,301,505,162,322,695,208,478
39103052ABS,802,238,534,812,302,472,679,305,374,700,335,365,695,295,372,916,412,489
39103052AAN,516,156,318,527,187,315,402,160,242,417,196,221,417,167,234,606,212,381
39093047ALL,489,166,301,490,216,254,497,242,255,507,277,230,514,233,269,854,406,446
39093047ALJ,492,169,304,496,226,251,429,209,220,437,239,198,439,199,232,472,209,252
39093047AGX,651,220,399,656,277,353,649,307,342,668,350,318,672,306,351,743,332,393
39081041ADE,284,85,174,292,80,201,215,92,123,218,110,108,218,77,139,313,83,224
39081041ADO,423,154,247,439,127,294,354,147,207,362,184,178,363,141,213,509,161,341
39147074ABS,610,165,426,623,198,385,507,196,311,522,238,284,527,193,326,700,244,449
39165083AEX,835,200,618,840,278,521,736,241,495,755,283,472,758,245,497,951,360,585
39165083ACU,684,107,549,695,136,537,605,130,475,616,155,461,613,126,472,862,182,670
39165083ADY,566,75,467,578,106,448,479,103,376,483,107,376,484,96,374,628,144,465
39155078AFQ,741,252,448,766,270,474,632,263,369,640,302,338,645,276,346,775,267,499
39155078ADL,464,236,191,472,265,176,324,200,124,335,221,114,334,200,119,470,263,196
39147074AAY,393,110,266,391,147,218,319,130,189,329,184,145,334,136,182,444,195,242
39077039AAS,549,139,370,557,179,336,430,184,246,428,218,210,430,159,247,576,202,358
39077039AAI,498,171,285,501,195,266,360,169,191,355,201,154,356,161,183,552,203,334
39099050AMV,495,217,261,507,233,256,398,213,185,399,230,169,400,203,186,527,256,267
39099050AIV,703,260,417,728,291,412,627,276,351,627,340,287,640,318,303,815,334,472
39099050AMZ,760,199,528,771,249,511,675,247,428,675,307,368,678,259,402,905,292,607
39103052ADH,798,183,584,810,221,554,689,216,473,701,240,461,707,215,478,968,297,656
39103052ACS,973,300,626,991,357,586,785,335,450,810,373,437,807,333,458,1139,466,657
39103052AAL,840,299,500,874,372,460,744,376,368,758,414,344,759,364,379,1137,496,618
39063032ACJ,398,51,337,398,55,333,309,52,257,320,80,240,322,57,259,447,74,363
39063032ABG,331,116,191,339,123,188,222,112,110,220,121,99,225,107,107,305,118,181
39103052ACT,664,258,355,685,295,341,474,264,210,491,290,201,491,255,212,737,354,369
39103052ADI,542,121,387,554,184,344,469,158,311,480,175,305,486,153,317,601,208,387
39077039AAV,399,124,222,409,149,229,285,139,146,288,166,122,293,133,133,447,191,250
39049025AGT,704,432,233,727,478,217,477,324,153,481,352,129,479,319,144,721,449,263
39049025ARQ,1106,286,799,1089,467,576,1043,410,633,1057,523,534,1062,456,594,1246,649,586
39049025AYZ,454,118,313,472,133,322,340,107,233,342,124,218,342,116,210,503,141,354
39121061AAA,260,45,204,267,56,203,190,61,129,201,71,130,196,51,140,277,45,231
39121061AAY,169,31,121,179,29,145,152,33,119,152,51,101,155,31,117,202,21,181
39103052ACK,515,181,305,522,197,294,444,218,226,457,238,219,458,224,225,592,274,311
39103052AFF,940,213,696,948,294,610,794,263,531,812,306,506,815,248,552,1112,375,715
39103052ABE,410,146,224,412,164,225,292,137,155,294,160,134,298,135,147,411,181,222
39103052AED,780,188,555,795,223,546,630,207,423,645,253,392,644,209,415,894,230,650
39063032ABD,707,166,509,723,228,464,626,211,415,638,283,355,651,213,424,852,289,548
39097049ABB,543,106,409,548,142,385,449,119,330,448,164,284,456,126,314,638,143,484
39135068AAQ,577,82,472,582,109,457,471,100,371,479,139,340,475,95,361,594,120,469
39099050APE,379,81,257,378,90,266,281,98,183,281,118,163,280,96,171,413,94,304
39035018CNB,891,332,547,880,547,309,792,504,288,791,509,282,803,466,335,974,641,323
39035018AEV,896,309,554,905,415,446,758,374,384,769,414,355,770,365,382,1067,521,537
39035018AGS,606,259,295,633,292,312,480,279,201,486,292,194,488,270,209,620,289,323
39035018ADN,761,324,396,801,420,350,670,411,259,674,439,235,678,392,263,918,494,414
39035018CQK,628,524,81,642,592,40,531,482,49,532,496,36,538,481,48,679,624,50
39103052AGE,920,237,633,947,297,615,780,303,477,802,357,445,809,304,479,1077,342,723
39103052AFT,576,155,393,583,189,376,494,200,294,505,236,269,509,203,294,730,265,460
39009005ABW,423,165,223,426,167,236,392,172,220,406,214,192,403,185,206,469,201,265
39009005AAG,781,415,323,912,535,314,341,271,70,361,287,74,364,272,75,86,67,17
39059030ACO,531,96,428,534,106,401,379,108,271,378,137,241,376,100,266,588,138,449
39115058AAD,318,94,215,321,58,251,228,62,166,236,87,149,236,68,161,360,69,288
39009005AAZ,244,120,105,258,117,121,213,117,96,221,145,76,215,125,81,253,117,127
39097049ABD,660,142,491,663,166,475,527,148,379,528,203,325,528,169,340,769,201,557
39035018AKF,419,388,19,455,444,8,303,294,9,309,304,5,308,288,16,369,354,15
39035018CBP,688,321,335,715,380,304,592,369,223,595,395,200,599,355,224,838,480,349
39035018AFG,660,175,462,681,269,394,552,239,313,567,267,300,564,221,334,789,348,435
39035018AJN,238,198,25,259,234,18,189,174,15,192,177,15,192,168,19,268,238,24
39035018BUJ,782,459,279,825,529,276,647,462,185,650,475,175,649,441,184,790,532,252
39053027AAY,592,163,408,602,121,462,441,127,314,445,160,285,447,143,290,682,137,541
39081041ACA,565,152,376,583,138,416,462,155,307,465,171,294,470,120,327,603,130,466
39035018CYG,913,291,596,924,406,473,849,420,429,856,460,396,866,412,436,995,521,465
39035018CYE,895,259,611,923,424,472,813,400,413,813,423,390,818,360,446,1033,556,470
39035018CYR,610,205,379,613,293,293,483,247,236,488,274,214,487,239,240,618,339,274
39035018BEY,524,365,116,564,461,83,434,370,64,443,390,53,444,359,63,631,519,105
39035018AGD,541,243,261,573,317,229,436,274,162,445,301,144,446,258,174,627,351,270
39035018BQF,487,367,98,517,422,91,381,313,68,386,326,60,389,311,74,556,458,95
39035018ASN,160,137,14,186,172,11,97,83,14,100,89,11,100,88,11,141,127,14
39035018BED,477,356,80,502,427,57,435,382,53,438,391,47,441,368,55,567,481,79
39035018AXS,291,222,49,323,274,44,192,164,28,194,170,24,198,161,33,278,210,63
39035018CNM,601,432,138,633,488,132,529,410,119,531,429,102,532,406,112,710,560,142
39035018BRE,537,464,41,571,539,25,336,320,16,342,333,9,341,317,17,476,448,24
39035018CEW,727,337,345,760,412,309,600,362,238,608,395,213,612,345,242,870,515,346
39035018DBD,919,275,573,949,383,531,800,386,414,811,443,368,805,361,418,959,439,513
39035018AED,831,392,387,845,475,321,702,429,273,712,464,248,714,418,277,858,516,333
39035018CDJ,910,332,535,941,466,433,786,406,380,809,488,321,812,411,377,1009,517,482
39035018BLR,924,704,195,941,808,108,810,699,111,818,717,101,817,688,119,991,863,121
39035018CQJ,773,582,171,784,660,98,710,609,101,713,627,86,716,601,93,858,751,92
39035018CLO,773,301,418,812,355,415,642,342,300,654,370,284,657,322,308,900,385,500
39045023ACN,770,165,577,767,195,546,667,179,488,681,227,454,688,194,481,874,247,618
39045023ADK,672,264,385,675,325,323,553,276,277,567,333,234,571,293,258,758,463,288
39045023ABC,588,193,366,588,242,315,459,196,263,470,235,235,474,206,259,721,363,343
39045023ABH,881,328,511,899,396,454,704,347,357,730,390,340,740,371,357,1102,542,536
39045023ADF,664,133,491,673,149,496,496,130,366,501,151,350,504,117,369,711,144,558
39045023AAH,909,211,658,922,243,630,725,222,503,732,275,457,737,234,486,962,295,652
39045023AAO,525,162,336,534,197,305,410,177,233,416,209,207,417,179,228,584,264,303
39167084ABN,661,194,430,681,164,501,514,156,358,517,181,336,522,149,362,730,178,540
39091046AAM,649,139,474,662,187,442,452,142,310,461,172,289,464,137,305,718,180,529
39091046AAT,864,129,697,872,166,670,682,140,542,698,210,488,698,133,520,915,172,729
39045023ADG,494,103,361,501,105,369,396,100,296,406,141,265,406,102,290,544,127,407
39035018CSH,696,321,357,713,421,275,598,370,228,608,398,210,606,362,240,762,486,267
39035018CZG,748,238,481,754,345,387,697,347,350,696,384,312,694,340,341,851,426,414
39035018BAQ,238,149,68,278,207,69,142,114,28,143,115,28,144,101,39,239,150,85
39035018AUJ,378,294,53,403,362,25,307,284,23,309,289,20,311,279,23,527,482,41
39035018DBI,736,254,409,790,323,430,597,294,303,603,330,273,609,282,296,910,379,517
39035018DAE,940,351,543,931,498,384,830,477,353,838,508,330,839,460,368,1101,668,423
39035018AAZ,858,255,565,847,408,404,773,392,381,785,408,377,790,366,407,973,516,440
39035018CKW,657,277,326,698,349,326,513,299,214,517,319,198,526,276,225,759,402,344
39035018BEG,298,216,56,331,260,60,198,154,44,200,163,37,201,146,42,277,182,88
39035018CYH,618,209,379,641,295,328,578,305,273,587,319,268,585,286,287,725,386,331
39035018ADU,725,333,361,745,428,292,618,398,220,623,438,185,628,378,219,817,513,293
39035018BGK,462,302,127,506,384,110,357,272,85,358,287,71,362,281,72,505,355,143
39123062ACQ,550,157,362,561,210,305,494,210,284,505,270,235,499,208,271,591,251,331
39101051AAA,303,123,154,310,134,157,196,102,94,197,123,74,197,111,73,322,112,200
39169085ACX,818,148,635,835,178,622,675,173,502,707,216,491,706,177,501,942,239,694
39169085ACZ,717,113,568,711,138,534,584,134,450,607,159,448,613,140,454,733,169,554
39035018BTO,603,356,214,638,431,180,450,329,121,458,352,106,462,321,124,687,487,192
39035018DAI,771,401,347,793,583,198,709,554,155,712,569,143,716,524,186,927,697,221
39035018AUB,357,321,24,381,371,7,255,248,7,257,252,5,260,249,7,296,283,10
39035018ACP,439,320,92,465,364,89,385,309,76,387,325,62,389,304,76,454,373,80
39035018BYC,817,503,274,851,619,184,694,556,138,695,579,116,696,524,152,902,710,185
39035018CWS,638,492,122,663,571,78,549,493,56,552,501,51,554,488,58,760,669,80
39035018AFM,982,287,648,1017,439,549,857,422,435,863,461,402,865,408,443,1090,539,540
39035018ALV,335,303,14,361,352,3,220,214,6,218,217,1,222,212,6,279,270,7
39035018AZL,710,483,178,739,606,100,679,579,100,688,599,89,691,573,97,920,778,127
39035018AQM,373,342,14,429,425,1,295,288,7,297,294,3,298,282,7,345,339,5
39035018BAM,541,246,252,572,328,222,457,292,165,458,304,154,460,269,177,654,367,281
39035018BXC,790,369,397,801,482,287,724,463,261,732,488,244,737,452,269,878,577,293
39035018CPO,851,312,495,877,395,445,763,391,372,780,448,332,786,390,371,996,519,468
39119060AAO,654,204,423,674,256,382,537,228,309,538,277,261,545,221,308,729,310,401
39123062AAO,760,242,474,761,263,442,594,247,347,591,291,300,599,228,339,811,286,517
39117059ABF,583,121,423,586,125,443,475,125,350,479,153,326,486,124,338,682,133,533
39117059AAZ,413,80,306,415,80,326,310,85,225,313,92,221,314,81,224,452,78,372
39045023ABE,890,279,581,896,350,501,772,308,464,786,375,411,792,322,455,1032,464,549
39045023ACX,687,181,478,696,195,462,534,162,372,542,210,332,550,174,355,759,203,550
39045023AAY,476,138,306,486,161,299,348,137,211,352,174,178,357,141,203,621,190,418
39045023ADQ,714,257,439,705,323,348,576,294,282,586,323,263,592,300,285,786,364,410
39117059AAF,393,92,269,396,104,267,318,104,214,325,123,202,328,109,209,495,126,361
39055028ACU,554,173,368,543,244,268,487,241,246,484,242,242,489,218,261,614,313,286
39055028ABM,330,85,233,345,114,212,269,96,173,272,116,156,273,84,177,344,120,219
39043022ADF,745,307,396,755,366,353,548,315,233,555,362,193,551,312,222,773,396,359
39035018CYT,672,253,383,693,360,308,471,253,218,478,288,190,475,248,217,652,358,286
39035018CYW,750,346,362,775,446,295,739,455,284,739,494,245,747,445,284,1009,632,364
39035018AHA,675,323,302,729,365,336,493,284,209,504,308,196,506,272,220,660,331,316
39013007AAY,372,111,244,372,97,263,327,112,215,334,138,196,329,103,218,450,105,342
39117059ABE,439,88,329,437,105,314,345,83,262,349,112,237,350,98,239,492,124,360
39127064AAL,282,108,155,281,118,144,191,96,95,193,111,82,194,92,98,295,110,177
39033017AAY,447,145,265,455,152,277,315,147,168,329,168,161,328,148,171,511,157,346
39057029AAF,582,124,438,574,175,366,567,175,392,568,216,352,574,166,388,743,251,466
39057029AIH,424,57,352,422,101,291,321,74,247,325,101,224,325,74,240,468,147,309
39057029AIC,234,53,167,238,61,163,194,66,128,198,85,113,200,65,122,242,65,176
39057029ACT,580,105,458,590,141,416,485,144,341,490,176,314,493,140,327,690,217,460
39057029AID,563,183,357,575,227,310,446,196,250,445,222,223,452,190,248,757,386,353
39061031BAT,302,125,147,312,140,159,219,103,116,221,110,111,222,96,115,320,141,172
39101051ACQ,231,59,163,231,60,164,177,59,118,181,71,110,176,60,106,237,65,169
39083042AAB,423,125,253,429,151,254,325,114,211,331,145,186,324,127,183,473,127,332
39129065ABX,659,124,514,664,127,510,571,131,440,571,171,400,580,138,424,699,126,570
39057029AEB,335,119,194,343,137,185,225,101,124,224,121,103,227,98,118,349,142,194
39057029AFD,621,178,400,632,223,365,403,173,230,409,200,209,415,174,220,598,194,386
39101051AAS,213,76,123,213,64,136,132,51,81,136,62,74,136,54,76,246,64,171
39057029ACQ,591,168,401,596,212,346,499,181,318,504,219,285,505,183,303,620,246,358
39057029AHD,481,57,410,488,69,405,385,61,324,385,91,294,389,55,328,496,57,436
39057029AAL,820,307,473,844,402,387,735,403,332,739,435,304,749,395,323,997,575,399
39057029AFH,446,128,289,447,147,273,322,135,187,325,151,174,326,128,189,463,161,292
39057029AHQ,367,50,306,363,56,291,323,60,263,320,85,235,324,49,265,418,64,351
39061031ATQ,492,181,297,492,257,209,435,232,203,445,262,183,443,236,201,506,313,191
39061031BMZ,988,251,683,995,374,566,814,354,460,809,375,434,823,339,459,1034,479,539
39061031AIU,404,204,187,407,285,95,360,249,111,367,275,92,368,256,103,426,330,88
39061031AZM,1145,235,877,1141,374,697,1040,374,666,1042,419,623,1050,360,656,1247,526,690
39025013AAK,631,144,443,637,190,419,488,186,302,484,198,286,487,174,296,715,243,461
39007004ACG,537,189,315,532,222,288,437,191,246,446,240,206,447,188,232,611,246,351
39025013AEV,465,61,374,468,89,358,348,77,271,348,94,254,351,74,256,494,89,393
39007004ADF,361,106,231,359,104,236,260,88,172,268,111,157,265,83,167,389,112,274
39131066AAN,500,178,300,512,132,364,362,126,236,369,166,203,381,141,225,518,121,395
39079040ABP,308,80,213,319,71,239,229,61,168,237,83,154,241,70,165,331,55,269
39003002ADB,445,111,321,455,146,293,360,123,237,372,161,211,367,117,244,469,160,304
39003002AAW,440,212,182,461,269,163,303,171,132,309,193,116,301,162,131,411,229,168
39113057ALQ,600,141,429,608,200,377,496,206,290,501,246,255,503,191,293,651,259,378
39113057AXU,1091,280,783,1094,397,637,970,390,580,976,446,530,983,386,567,1187,522,641
39113057AKR,682,160,467,694,228,423,533,219,314,538,257,281,537,211,306,696,252,429
39003002ABQ,268,170,73,285,212,65,187,144,43,189,149,40,187,139,41,245,175,66
39003002AFQ,525,75,434,536,130,379,508,126,382,514,169,345,511,129,372,660,189,464
39003002AEA,453,60,384,459,66,366,352,75,277,353,100,253,354,70,274,505,89,412
39097049AAQ,731,174,524,731,195,512,565,159,406,559,203,356,566,174,383,756,231,518
39097049AAB,983,274,648,997,350,586,788,305,483,791,368,423,805,330,442,1229,437,775
39073037ABB,719,206,470,718,205,478,529,194,335,533,247,286,537,196,321,747,199,539
39139070ABP,637,122,483,648,131,496,547,148,399,557,201,356,557,146,388,718,142,565
39011006ABR,515,75,420,524,119,376,413,93,320,412,136,276,414,94,311,561,139,413
39147074ABI,250,50,171,263,69,174,197,72,125,202,100,102,205,78,117,286,89,190
39147074ABP,331,88,216,331,75,215,230,83,147,246,111,135,248,85,148,344,82,252
39137069AAP,518,69,422,529,104,405,444,99,345,447,151,296,460,101,346,565,124,433
39155078AAX,400,169,206,409,195,193,306,160,146,308,187,121,308,163,133,421,209,204
39165083AGX,747,196,528,776,247,479,675,247,428,696,300,396,693,251,416,1116,438,656
39113057AJW,936,333,553,944,397,502,696,339,357,705,393,312,707,341,341,971,441,512
39113057ABE,405,250,133,421,320,74,299,238,61,304,251,53,305,229,67,372,301,66
39113057AHB,483,347,114,498,404,81,338,275,63,346,296,50,344,281,53,468,386,69
39113057AET,856,367,411,869,423,376,625,353,272,631,379,252,632,328,275,918,503,393
39173087ADO,472,137,316,483,167,281,384,157,227,387,185,202,388,147,232,537,191,335
39017009AGU,552,118,414,568,173,371,420,136,284,426,156,270,426,140,272,603,207,387
39017009AJJ,536,238,271,551,274,230,387,242,145,393,246,147,393,243,140,633,375,234
39017009AJE,622,285,313,628,368,235,474,293,181,491,315,176,486,298,174,713,459,244
39017009AEO,429,146,260,438,166,255,313,136,177,314,146,168,316,138,170,499,190,303
39017009ALW,699,151,519,711,204,479,548,183,365,557,203,354,557,175,363,780,253,516
39017009AFR,712,191,503,729,222,479,612,217,395,631,237,394,634,212,403,908,316,584
39113057AKF,916,331,534,944,424,468,751,366,385,762,418,344,758,347,385,1025,475,533
39113057AKV,607,189,388,628,243,358,474,213,261,471,240,231,474,211,251,639,277,349
39113057AFY,737,663,48,758,734,21,539,518,21,547,528,19,548,512,31,659,632,21
39015008ACO,627,145,449,625,174,423,415,144,271,421,178,243,422,149,258,654,191,453
39165083ACS,800,142,623,821,169,617,750,196,554,770,229,541,771,187,560,1167,293,857
39165083AED,432,61,349,437,85,334,344,66,278,358,80,278,354,64,278,498,104,380
39003002ACT,761,115,619,769,115,621,632,114,518,630,160,470,634,107,504,848,125,716
39139070ABQ,715,130,547,734,139,572,589,136,453,605,195,410,608,146,447,765,142,620
39139070AAV,473,322,122,482,329,127,344,262,82,352,274,78,352,262,82,542,343,190
39113057AVH,632,404,205,640,471,155,440,338,102,450,355,95,444,331,94,624,417,195
39113057AIV,658,242,391,676,319,330,564,285,279,567,330,237,573,277,276,784,398,378
39155078AJH,446,143,277,457,182,250,322,165,157,329,192,137,326,177,143,490,183,299
39165083AEF,680,95,556,691,122,548,600,110,490,614,134,480,606,106,491,850,178,669
39155078AEH,474,374,78,491,406,72,346,308,38,355,314,41,346,297,37,522,434,85
39093047AEH,369,262,78,388,300,72,226,176,50,231,195,36,234,185,39,332,225,104
39093047AGY,841,286,525,864,327,503,671,333,338,693,375,318,697,320,359,974,392,570
39093047ACX,437,202,194,454,249,177,291,180,111,298,203,95,301,177,104,504,268,216
39099050AJY,794,293,482,804,348,430,698,320,378,708,389,319,718,355,350,852,398,449
39099050AOC,514,212,274,510,210,281,417,187,230,416,235,181,420,212,195,546,204,334
39093047AJF,959,246,655,961,304,602,751,282,469,782,339,443,784,285,473,1021,322,681
39109055AAN,529,71,444,527,124,391,456,118,338,462,142,320,466,112,340,574,143,427
39109055AAB,415,95,282,415,140,250,222,81,141,227,95,132,231,76,142,442,131,296
39017009AKP,385,97,269,403,123,255,284,113,171,295,130,165,293,101,183,409,156,245
39017009AER,538,178,332,553,203,324,362,165,197,371,169,202,370,156,206,586,209,367
39017009AEL,471,153,291,488,175,292,329,135,194,334,150,184,338,127,197,538,186,346
39049025BCA,515,260,239,519,313,184,523,337,186,526,363,163,528,335,184,709,467,228
39049025BME,643,325,298,656,389,234,440,279,161,437,305,132,445,283,151,632,429,194
39049025AOC,488,272,191,491,316,148,416,281,135,419,306,113,423,287,124,541,367,166
39049025AOZ,601,301,262,614,330,247,440,285,155,451,312,139,455,279,162,631,353,269
39049025BHR,638,369,240,645,419,191,541,381,160,549,408,141,556,394,142,748,523,214
39049025AAP,952,654,254,962,707,190,847,667,180,850,704,146,856,675,156,1060,831,199
39049025BMB,405,266,127,408,294,98,419,374,45,428,392,36,428,380,36,542,469,67
39049025BIB,782,505,245,788,563,191,550,377,173,554,412,142,557,391,149,709,480,219
39031016AAQ,591,106,449,595,138,433,499,136,363,497,175,322,504,139,346,638,130,499
39031016ABE,333,98,223,341,89,234,250,87,163,249,106,143,252,90,156,342,86,252
39113057ARF,460,351,89,472,403,61,300,263,37,310,278,32,309,266,38,454,388,64
39113057AWO,487,89,375,491,113,348,363,105,258,368,133,235,371,101,260,548,141,400
39113057AFZ,465,397,50,474,457,12,353,340,13,365,354,11,365,340,17,428,406,18
39113057APR,920,253,619,952,331,575,701,290,411,707,353,354,708,282,395,978,337,619
39113057ABN,447,224,180,452,291,133,375,260,115,377,291,86,380,251,111,474,321,140
39113057AFA,442,233,171,446,288,134,355,256,99,356,286,70,357,252,93,477,335,136
39003002ADF,557,88,445,562,118,421,494,105,389,492,129,363,494,103,386,632,148,477
39113057AXW,1017,237,753,1003,336,620,891,313,578,895,378,517,905,308,579,1052,442,600
39113057AEU,613,217,353,623,277,291,429,214,215,434,253,181,438,205,213,642,292,342
39113057ADZ,721,242,414,730,316,358,544,302,242,549,339,210,553,275,240,781,418,342
39031016AAE,457,145,272,456,160,270,326,149,177,327,169,158,327,150,161,502,140,348
39031016AAG,652,198,410,654,230,386,484,193,291,483,248,235,488,198,269,684,229,442
39023012AFG,619,176,417,623,228,362,468,192,276,471,251,220,472,187,268,671,239,422
39023012AGB,1087,258,784,1095,338,713,847,280,567,854,369,485,861,275,565,1151,342,790
39023012ADV,645,159,450,647,203,413,538,168,370,542,212,330,542,174,346,675,198,466
39041021AFY,675,222,434,675,297,343,565,287,278,573,325,248,574,299,265,836,458,362
39003002AEG,404,79,297,410,94,292,309,80,229,316,119,197,313,76,228,449,103,340
39107054AAF,593,154,401,593,157,399,450,152,298,455,184,271,456,144,292,680,183,487
39171086AAJ,402,124,249,401,141,237,282,123,159,289,150,139,291,118,159,447,168,264
39023012UAF,997,169,800,981,235,710,814,203,611,823,296,527,834,212,595,1115,260,844
39023012ADQ,973,172,768,976,233,703,743,200,543,752,262,490,758,193,540,1069,256,797
39023012AFA,1120,249,834,1113,351,730,926,291,635,951,412,539,959,294,643,1186,392,777
39047024AAX,269,43,213,274,53,207,197,34,163,197,59,138,199,44,152,304,48,251
39049025AAO,660,416,196,676,459,179,551,421,130,553,446,107,553,414,117,771,581,171
39049025ATG,715,195,509,717,250,443,618,210,408,623,275,348,627,259,359,781,316,459
39049025BAJ,459,268,170,476,275,183,309,185,124,314,204,110,314,194,110,457,279,170
39049025BER,828,534,263,838,648,147,741,572,169,747,626,121,749,599,136,916,744,160
39003002ACU,392,40,335,402,56,329,309,48,261,315,75,240,312,47,261,415,70,342
39155078ABZ,547,260,258,553,266,255,406,229,177,413,265,148,414,237,164,610,264,334
39155078ABX,555,218,299,558,246,279,387,199,188,391,229,162,392,207,171,576,257,311
39165083ADS,748,106,596,769,162,576,652,153,499,668,179,489,664,159,491,855,208,634
39155078AGD,182,37,130,199,36,147,122,38,84,130,45,85,131,38,86,207,35,170
39155078ABJ,726,374,318,753,415,308,642,410,232,646,444,202,657,408,235,835,460,368
39155078AKA,587,223,331,601,248,318,402,218,184,412,249,163,411,211,179,590,253,328
39155078AKQ,719,196,500,715,256,439,623,271,352,634,333,301,634,278,344,821,329,484
39087044ADF,587,166,393,605,131,459,421,107,314,429,147,282,433,108,311,606,113,480
39087044ACC,123,41,80,127,34,93,105,32,73,106,49,57,110,30,80,142,33,109
39087044ACE,869,244,593,875,216,627,715,207,508,725,273,452,729,213,502,944,253,677
39087044ACJ,308,90,200,314,83,221,255,88,167,252,112,140,258,90,159,333,91,240
39087044ABE,238,86,141,247,62,169,187,73,114,184,91,93,188,81,103,264,65,194
39089045ABS,814,259,521,815,283,490,664,248,416,686,325,361,675,250,408,925,346,558
39089045ACA,804,257,478,813,297,464,626,286,340,634,328,306,630,287,319,931,337,585
39003002ADD,614,105,487,612,132,452,511,128,383,517,197,320,514,127,382,654,156,488
39089045ADR,695,134,536,690,157,504,603,144,459,609,191,418,613,161,441,842,203,622
39141071ABS,453,130,294,457,147,291,313,113,200,311,142,169,316,103,197,456,123,327
39141071ACN,742,221,492,762,234,487,594,210,384,591,250,341,597,213,367,880,247,622
39025013ADB,385,53,302,393,74,300,264,67,197,261,72,189,261,62,193,432,76,354
39025013AEN,593,103,461,601,128,457,419,107,312,426,138,288,428,107,310,644,128,504
39003002AAO,614,235,349,633,265,333,467,205,262,475,251,224,472,206,254,652,286,354
39147074ACP,469,96,350,472,108,343,373,103,270,383,156,227,383,98,271,490,107,374
39165083ABA,752,236,488,773,367,386,671,329,342,685,360,325,689,323,350,849,470,371
39165083ABK,772,112,614,791,165,597,661,166,495,671,180,491,682,149,509,891,223,651
39165083AAJ,493,96,364,511,141,344,388,112,276,396,129,267,393,108,269,546,188,353
39073037ABH,384,90,273,392,94,287,296,90,206,308,123,185,308,95,196,435,99,333
39041021AEY,635,184,438,652,275,356,635,266,369,636,308,328,651,277,359,941,463,468
39041021ACY,608,157,440,603,230,356,561,217,344,563,268,295,570,239,314,729,372,347
39041021AFO,704,233,463,687,317,337,681,305,376,680,356,324,683,321,353,829,437,376
39023012AAR,502,193,280,509,248,235,338,182,156,339,210,129,337,172,146,515,233,273
39023012ADG,674,159,470,688,205,452,468,155,313,467,199,268,473,141,313,704,187,510
39023012ACM,356,164,166,362,204,134,225,131,94,227,143,84,226,121,89,384,188,193
39099050ANU,473,149,297,484,160,299,407,162,245,408,182,226,415,174,221,524,157,365
39089045AAA,909,240,625,922,304,573,794,282,512,804,345,459,802,290,487,1061,366,685
39069035AAV,489,128,326,492,133,312,329,109,220,331,145,186,339,124,198,548,155,375
39155078AHX,635,306,302,648,337,288,558,327,231,558,358,200,562,329,223,668,352,312
39089045AAS,398,147,224,408,157,231,284,125,159,285,146,139,286,121,152,467,161,287
39089045ABR,823,218,569,822,280,505,687,273,414,703,330,373,703,279,409,909,379,519
39089045ACZ,1075,517,520,1062,642,374,990,564,426,1005,633,372,1007,577,417,1170,727,412
39089045AAD,714,180,495,720,197,489,561,181,380,571,225,346,577,180,381,851,218,619
39041021ACI,718,170,523,717,221,453,674,187,487,674,241,433,683,212,458,852,298,542
39041021ACL,670,131,510,665,164,473,606,155,451,610,207,403,610,171,419,858,266,570
39041021AFU,965,219,724,962,360,576,759,309,450,757,368,389,762,313,446,1128,515,604
39041021AGE,725,341,350,742,413,283,581,370,211,581,399,182,588,380,196,847,553,283
39041021AEC,583,229,326,606,289,290,603,343,260,604,371,233,609,351,245,914,550,344
39041021ADW,538,107,411,542,139,369,443,120,323,445,161,284,454,132,306,620,171,438
39023012AFD,723,122,575,722,187,502,571,150,421,577,208,369,583,151,420,780,199,572
39025013AHA,699,111,563,708,152,532,563,128,435,560,143,417,569,125,424,766,155,598
39025013AAN,506,118,354,510,141,344,409,140,269,411,154,257,408,133,265,726,236,479
39089045ADO,680,158,477,682,183,483,555,160,395,566,195,371,565,161,383,792,192,586
39123062ACG,451,113,321,462,125,304,353,124,229,356,165,191,363,120,221,482,134,335
39165083AFC,426,95,309,440,121,301,349,111,238,367,128,239,369,122,235,575,151,414
39155078AFD,680,143,501,700,161,509,492,139,353,497,175,322,497,152,331,746,172,571
39155078AJX,560,220,297,574,230,314,445,213,232,454,249,205,452,216,214,616,234,373
39155078AIZ,548,191,323,550,211,321,435,201,234,434,229,205,434,199,224,601,202,391
39089045AEC,899,202,646,888,225,623,767,230,537,776,269,507,777,237,517,1022,278,726
39067034AAL,322,69,233,320,82,223,256,75,181,255,100,155,260,65,184,344,80,261
39131066AAE,364,126,228,357,125,219,285,125,160,287,152,135,287,126,155,416,134,274
39049025BHV,382,152,221,375,173,184,336,161,175,340,191,149,341,168,162,397,219,173
39049025AHZ,711,420,258,735,511,187,173,136,37,173,141,32,175,138,35,68,56,8
39049025BJS,724,591,105,744,637,83,626,556,70,634,573,61,631,559,64,764,648,107
39049025AZU,921,286,619,933,362,530,823,358,465,825,414,411,831,375,439,1057,473,571
39049025BAM,669,251,387,659,318,302,610,308,302,618,361,257,617,323,282,720,402,309
39049025AFE,595,526,51,613,559,42,437,392,45,436,408,28,441,400,33,599,525,64
39049025ATB,568,150,392,582,175,381,457,161,296,468,195,273,470,179,279,611,216,388
39049025AZQ,278,211,52,314,271,35,206,183,23,212,194,18,212,188,20,316,247,62
39153077APV,601,243,322,636,284,325,528,283,245,544,308,236,547,277,255,688,304,370
39153077ARD,741,200,518,752,270,455,645,261,384,663,286,377,659,265,384,813,340,468
39051026AAD,622,111,489,624,148,449,472,118,354,475,160,315,478,119,344,685,149,523
39153077BBB,647,178,451,655,259,362,564,239,325,578,271,307,581,244,331,760,374,377
39153077AOE,617,245,328,635,311,306,495,271,224,518,303,215,515,269,233,703,368,325
39153077BDA,546,299,242,553,338,191,485,316,169,486,335,151,493,317,166,687,453,231
39153077BCT,606,216,365,631,270,333,533,257,276,557,297,260,555,249,294,722,307,402
39073037AAL,420,161,237,426,156,256,302,149,153,308,169,139,305,135,164,413,144,264
39159080AAQ,431,110,301,437,117,292,327,106,221,329,130,199,330,106,213,485,129,349
39141071ACB,492,136,328,501,135,343,354,113,241,357,146,211,360,116,229,529,108,413
39153077ASW,517,180,302,522,216,289,425,207,218,448,237,211,435,209,213,614,260,348
39153077AWY,647,212,395,666,254,383,547,226,321,564,260,304,556,234,308,721,314,404
39153077ATB,700,250,397,731,303,388,595,292,303,609,327,282,611,290,290,798,328,458
39153077ADA,567,399,134,575,438,114,552,447,105,558,465,93,558,437,97,621,491,121
39153077ABK,608,350,217,614,390,205,526,349,177,538,374,164,538,360,168,687,438,234
39153077AJM,614,326,262,634,374,242,492,317,175,515,354,161,504,300,188,698,416,278
39153077AKO,545,270,234,570,333,209,455,301,154,462,320,142,460,285,157,656,378,267
39153077AZG,310,228,51,332,278,50,175,141,34,177,147,30,176,133,34,228,180,47
39153077BBQ,475,146,303,497,177,309,410,170,240,428,202,226,431,199,226,556,222,327
39153077AJG,578,235,307,607,267,298,445,246,199,454,291,163,459,251,189,648,303,333
39153077BAK,609,272,300,612,336,246,499,302,197,516,329,187,515,298,199,659,365,273
39153077AZD,446,316,91,467,370,84,321,259,62,328,274,54,325,258,59,406,307,96
39093047ABR,724,328,335,734,356,321,552,342,210,567,396,171,571,345,199,787,441,330
39109055AAC,470,94,347,483,139,317,298,113,185,308,141,167,309,106,177,472,142,324
39093047AEN,731,412,277,741,471,246,525,346,179,546,401,145,551,363,176,791,490,296
39093047ADI,778,358,352,804,403,356,610,364,246,633,409,224,641,369,249,860,445,402
39093047AJQ,691,173,469,723,222,460,563,214,349,589,252,337,588,208,355,785,259,512
39093047AKI,440,223,180,458,248,188,308,184,124,321,216,105,320,190,123,469,209,255
39007004ABV,265,96,151,270,91,162,178,74,104,189,88,101,186,72,103,294,92,196
39007004AEW,349,90,225,347,88,241,278,86,192,292,106,186,292,90,191,392,98,289
39067034AAG,772,238,499,779,226,526,650,273,377,657,325,332,655,239,400,845,258,578
39175088AAS,546,148,378,561,173,357,412,162,250,417,195,222,418,146,251,608,183,413
39087044ACI,643,164,451,660,145,500,555,149,406,558,192,366,567,150,402,763,208,547
39151076AJJ,989,185,750,990,210,746,896,211,685,917,253,664,916,210,680,1151,217,924
39151076AED,488,188,275,494,221,256,399,210,189,406,228,178,406,202,195,523,245,272
39151076AJC,586,130,421,607,152,421,496,147,349,503,175,328,501,146,323,649,161,477
39151076AGS,974,239,701,968,368,560,805,298,507,802,323,479,813,290,501,989,383,597
39049025BBG,742,209,480,760,238,486,619,236,383,623,279,344,631,243,371,879,306,559
39049025AAK,654,355,289,632,464,144,628,417,211,630,466,164,636,438,188,724,551,170
39049025BMG,394,342,40,413,378,28,356,314,42,360,331,29,359,323,33,483,427,50
39049025AJL,711,609,73,737,670,49,552,520,32,556,536,20,554,520,29,684,630,45
39049025AWO,994,360,597,975,452,465,902,418,484,892,496,396,906,454,438,1043,583,449
39049025BGR,666,336,293,676,413,224,563,375,188,570,409,161,569,384,172,784,518,250
39093047ACZ,430,346,59,443,390,37,273,230,43,283,248,35,285,230,42,374,287,78
39151076AFK,870,261,563,884,343,498,708,327,381,716,362,354,726,314,389,961,422,524
39175088AAQ,431,137,273,444,151,262,311,123,188,310,154,156,312,116,184,431,136,281
39151076AFE,856,275,543,862,342,460,711,339,372,729,382,347,725,323,375,947,404,531
39151076AGR,544,127,404,539,176,349,482,160,322,487,196,291,489,161,318,577,223,349
39151076AFA,840,259,538,848,329,474,764,331,433,777,373,404,775,325,429,861,403,443
39151076AFY,821,368,395,838,433,355,632,366,266,643,398,245,645,358,271,872,435,430
39151076AHS,538,125,387,544,150,373,474,145,329,473,174,299,476,156,306,629,171,453
39175088ABI,472,82,369,495,103,368,397,97,300,397,145,252,398,99,290,562,115,432
39131066AAQ,996,302,646,997,270,682,708,265,443,719,308,411,722,251,450,1124,258,851
39089045ADE,876,213,620,895,208,648,707,207,500,713,245,468,716,206,493,1020,218,781
39049025AYA,699,410,265,691,497,166,682,490,192,686,543,143,689,510,170,761,589,153
39049025AVZ,1056,392,638,1040,570,414,956,482,474,962,578,384,976,529,434,1191,741,427
39049025BHE,888,391,477,869,479,346,794,451,343,794,538,256,800,495,297,910,566,331
39049025AEE,1205,743,429,1193,908,226,1192,892,300,1196,969,227,1206,935,260,1316,1062,243
39049025AYJ,492,205,253,487,231,213,410,223,187,409,249,160,412,229,171,553,323,218
39049025BLN,392,173,205,393,214,157,427,282,145,430,297,133,435,285,139,700,442,246
39049025APN,953,422,502,965,526,386,704,416,288,705,443,262,705,424,269,1075,674,382
39049025ANQ,625,297,300,613,334,239,512,308,204,517,342,175,515,311,192,716,462,247
39049025AEW,664,495,132,695,579,102,500,419,81,504,443,61,505,415,74,638,527,100
39049025AFY,625,515,94,634,557,67,539,470,69,546,495,51,543,479,61,617,549,64
39049025BKA,542,173,348,558,239,282,435,209,226,435,245,190,442,221,206,604,294,294
39049025AOO,817,446,344,836,500,292,697,443,254,701,483,218,710,455,232,902,600,281
39049025ABD,479,420,36,497,453,34,362,327,35,366,345,21,371,337,28,536,485,41
39049025AEN,831,477,319,841,571,221,805,553,252,812,620,192,812,571,219,933,694,221
39049025AQX,433,191,231,437,256,164,500,303,197,506,319,187,511,310,184,738,496,233
39049025BMO,725,320,390,740,430,277,494,281,213,496,317,179,499,295,199,731,430,296
39049025BHD,982,387,562,991,518,428,832,438,394,840,514,326,840,464,361,1070,631,426
39049025AUF,1087,436,621,1091,548,497,1002,499,503,994,582,412,1014,529,461,1240,713,510
39021011ABW,899,157,701,903,174,696,729,180,549,741,231,510,739,187,527,1049,213,825
39041021ABA,737,189,535,723,293,404,689,239,450,686,292,394,693,264,424,831,381,445
39087044AAJ,187,100,78,193,108,77,134,74,60,134,85,49,132,70,57,183,94,85
39023012AFX,977,253,677,978,313,619,792,288,504,800,377,423,805,294,486,1053,354,675
39023012AEY,560,162,375,552,202,319,444,177,267,455,231,224,456,181,259,591,209,376
39041021ABD,547,187,345,545,272,252,517,240,277,518,286,232,519,253,261,598,319,275
39041021AED,553,160,381,543,214,302,477,165,312,469,215,254,480,180,291,585,305,272
39151076AAM,785,292,443,803,338,415,610,316,294,613,353,260,620,309,284,909,418,481
39151076AAN,695,205,461,690,248,406,555,243,312,566,281,285,570,246,308,738,298,435
39151076AIN,669,165,464,672,191,444,542,186,356,553,211,342,556,192,351,937,271,653
39151076AKR,800,282,477,810,338,437,647,312,335,647,333,314,651,307,320,915,371,519
39151076ACF,532,371,119,542,410,115,325,257,68,329,266,63,327,242,69,479,333,138
39151076AHO,631,187,420,637,252,362,547,231,316,558,271,287,561,231,317,683,307,368
39139070ABE,535,137,364,531,144,360,422,138,284,429,184,245,431,126,292,528,143,378
39139070AAT,417,278,107,422,308,101,336,242,94,341,255,86,341,236,83,449,293,146
39139070ACA,484,135,314,494,130,348,380,132,248,391,155,236,388,127,240,549,137,409
39015008ACW,661,124,509,676,165,487,497,132,365,511,168,343,510,122,370,697,152,536
39015008ABP,365,68,278,374,98,254,321,91,230,327,105,222,329,88,224,445,86,349
39023012AAI,395,166,207,409,214,174,306,173,133,304,203,101,309,168,121,456,230,217
39155078AEI,652,495,127,661,542,99,479,408,71,492,430,62,483,413,60,628,505,115
39155078AJL,541,154,351,547,176,338,385,166,219,392,187,205,391,161,216,598,182,412
39023012ADP,730,174,530,737,242,459,586,195,391,593,263,330,593,197,381,764,283,468
39145073ACT,437,193,232,434,164,253,364,139,225,372,170,202,373,155,211,474,149,320
39145073AAO,315,105,207,314,109,194,242,83,159,253,111,142,251,87,161,267,100,163
39145073AAB,284,125,140,284,128,133,209,103,106,213,123,90,214,103,102,300,121,174
39145073AEE,460,157,286,468,140,304,341,135,206,342,156,186,345,134,201,465,124,335
39145073AAK,298,146,135,312,163,127,171,100,71,173,120,53,177,105,70,227,120,105
39037019ABF,438,51,368,447,62,371,313,63,250,324,95,229,322,56,254,493,66,422
39161081ABC,323,103,186,353,95,245,276,79,197,282,93,189,282,81,199,340,99,240
39011006ABL,1007,103,854,1013,143,825,824,141,683,824,219,605,810,133,655,1102,162,928
39011006AAH,761,125,613,770,181,569,608,152,456,607,205,402,610,141,452,811,184,618
39011006AAI,414,75,312,417,91,302,292,88,204,294,113,181,294,85,200,469,135,325
39161081AAX,322,31,267,317,37,261,262,39,223,265,65,200,264,35,221,354,46,301
39161081ABL,249,55,177,257,54,190,204,42,162,203,56,147,206,39,162,262,54,207
39169085ACF,869,211,619,883,273,581,685,268,417,691,285,406,698,249,433,907,296,596
39039020ABL,505,149,338,519,171,323,409,160,249,412,193,219,411,157,239,554,208,336
39039020AAM,414,162,231,422,173,210,312,142,170,312,169,143,313,136,167,474,208,259
39125063AAV,380,157,190,382,132,226,306,124,182,310,132,178,309,131,172,443,145,287
39153077AEF,576,224,298,606,250,328,455,233,222,462,248,214,461,222,213,697,312,376
39153077ABN,513,308,166,529,349,155,382,274,108,396,286,110,395,275,102,559,375,178
39153077AEL,537,223,273,574,240,312,437,219,218,442,233,209,441,212,208,650,296,348
39153077ARH,752,273,448,765,382,354,651,344,307,671,380,291,667,341,315,826,466,347
39153077AVF,429,154,258,435,204,224,356,193,163,371,220,151,370,198,167,464,241,221
39153077AAE,667,447,189,697,521,151,612,492,120,626,505,121,621,488,120,761,581,165
39159080ABK,809,164,612,802,191,573,706,177,529,708,225,483,725,184,507,881,255,604
39153077AYT,423,309,93,449,341,85,294,245,49,297,248,49,301,239,55,393,303,76
39153077AFR,727,319,362,766,376,356,625,356,269,636,396,240,638,368,253,887,457,418
39043022AEI,453,250,173,456,262,161,343,236,107,352,257,95,346,233,102,474,288,177
39055028AAF,925,457,437,928,599,314,830,521,309,836,564,272,836,500,325,1001,638,354
39055028AAG,822,285,518,819,399,391,746,383,363,746,412,334,747,357,369,962,524,425
39019010AAR,713,158,510,726,175,519,608,205,403,610,241,369,614,219,372,872,195,662
39043022ADO,879,263,564,898,313,556,729,306,423,731,357,374,731,306,400,962,338,611
39085043ADY,657,250,368,689,321,340,563,291,272,574,337,237,573,273,283,797,371,413
39085043AAZ,758,263,462,795,347,416,654,330,324,660,358,302,665,310,343,851,390,456
39133067AFB,528,179,304,533,210,300,400,174,226,406,195,211,402,175,207,593,223,360
39133067AGB,671,200,421,687,213,445,567,224,343,579,249,330,579,223,326,768,245,509
39153077AYL,335,210,94,355,244,102,246,183,63,252,198,54,249,179,63,387,259,124
39051026AAZ,908,250,608,922,280,587,681,264,417,684,320,364,691,255,411,994,326,655
39153077ANK,532,183,321,553,234,300,475,229,246,501,280,221,499,219,265,629,273,343
39153077ABL,518,282,192,536,323,188,413,291,122,431,306,125,430,268,142,583,329,244
39153077BAX,732,247,466,735,350,346,654,335,319,666,374,292,665,335,317,851,459,384
39087044ABB,288,98,182,306,60,229,226,69,157,236,75,161,227,61,158,304,45,257
39087044ABU,180,47,122,184,30,146,149,39,110,156,46,110,153,36,117,201,31,169
39087044ABN,477,183,275,497,162,309,372,144,228,377,178,199,379,147,220,489,183,301
39015008ABI,458,92,349,462,122,317,371,113,258,375,141,234,376,108,257,523,149,364
39123062AAZ,563,188,353,569,210,329,455,175,280,460,213,247,458,180,261,602,211,383
39123062ABX,571,170,383,583,212,347,484,205,279,493,241,252,490,202,270,666,233,426
39123062ABW,496,133,343,497,165,313,460,170,290,465,219,246,465,180,278,571,216,353
39133067AGG,460,134,290,474,155,304,368,139,229,374,174,200,375,136,224,525,128,389
39085043ABS,862,237,596,887,324,536,701,280,421,707,313,394,713,273,427,965,352,603
39085043AAG,633,239,351,665,284,346,499,255,244,512,289,223,511,240,249,746,310,426
39085043AFV,914,209,658,921,260,627,729,255,474,737,300,437,739,232,478,1024,290,723
39151076AKX,850,293,498,865,336,482,611,315,296,616,334,282,619,313,292,932,366,548
39151076ANK,742,230,491,744,279,435,663,309,354,670,328,342,673,291,369,1138,474,658
39151076AND,660,212,419,662,270,363,558,261,297,562,285,277,566,253,297,733,330,392
39085043ADB,786,284,449,822,338,443,728,357,371,729,399,330,734,343,369,916,404,496
39085043AAN,750,259,455,798,283,463,633,288,345,636,334,302,642,268,358,905,354,544
39087044ACW,189,67,115,196,50,138,127,44,83,130,61,69,126,42,79,177,52,122
39087044AAB,138,44,84,143,51,87,98,54,44,101,61,40,103,55,45,147,51,94
39087044AAD,111,52,56,110,35,71,71,35,36,72,39,33,72,32,33,109,37,70
39105053AAG,327,95,218,346,65,274,232,48,184,235,78,157,237,60,173,356,70,285
39105053AAQ,210,62,136,216,46,165,155,39,116,164,60,104,162,48,109,242,54,186
39105053AAO,276,88,180,284,58,219,220,58,162,224,88,136,224,66,153,339,79,255
39105053AAR,261,90,162,265,81,171,168,51,117,170,76,94,172,58,107,250,71,176
39157079ACX,491,86,377,505,95,382,385,104,281,384,122,262,387,100,272,534,111,413
39157079AAG,752,219,501,772,288,458,655,264,391,669,316,353,667,263,388,794,288,498
39011006ABQ,303,37,248,305,44,243,243,47,196,242,66,176,240,45,187,367,75,288
39029015ADH,386,61,296,395,75,306,315,71,244,328,87,241,326,76,238,413,80,328
39029015ADD,418,60,338,436,62,356,338,63,275,346,85,261,347,66,269,495,74,412
39099050APG,130,36,81,137,38,90,91,31,60,95,38,57,93,30,59,136,33,101
39099050AHU,373,217,136,379,214,144,253,161,92,256,181,75,259,165,84,405,231,167
39099050AAE,343,184,149,350,194,146,271,160,111,276,179,97,275,168,103,374,182,189
39149075ABD,636,82,524,640,91,537,521,95,426,524,135,389,526,99,413,693,79,608
39133067AFH,679,189,444,696,229,436,531,222,309,537,249,288,537,211,306,756,267,480
39043022ADV,355,100,223,359,108,235,298,120,178,298,137,161,298,109,180,414,119,291
39055028ABY,523,104,390,527,113,396,406,105,301,408,131,277,410,95,300,577,128,446
39149075ACG,814,74,711,816,96,701,661,112,549,669,154,515,663,104,533,901,121,768
39151076AFO,442,123,293,458,137,299,358,130,228,360,148,212,364,116,234,540,151,379
39161081AAE,332,50,268,329,65,249,268,58,210,269,89,180,272,52,216,380,65,311
39041021AEH,632,301,305,661,378,242,619,411,208,626,449,177,630,439,179,967,633,315
39173087ACQ,502,130,346,506,159,313,425,166,259,433,199,234,435,146,262,553,194,347
39017009AGR,960,199,738,969,281,638,805,256,549,831,295,536,826,254,553,1147,439,689
39017009AKM,855,221,606,869,258,566,615,238,377,634,263,371,626,236,369,937,333,589
39017009AKD,615,120,466,625,111,485,458,103,355,477,125,352,480,102,368,662,113,545
39017009ACQ,789,258,486,810,295,472,556,231,325,567,260,307,565,214,332,851,310,529
39133067ACT,689,292,362,713,338,342,651,356,295,659,395,264,655,349,276,1043,527,504
39085043AFF,830,277,515,872,329,514,706,331,375,721,398,323,724,324,385,1036,431,595
39085043AFD,897,359,492,943,402,483,741,377,364,741,420,321,750,358,370,1056,517,522
39085043AFX,583,203,346,611,231,348,441,206,235,446,241,205,446,207,229,660,268,379
39149075ACL,726,72,627,729,79,626,581,101,480,582,134,448,586,113,458,784,108,669
39149075ACJ,535,36,486,539,51,474,439,59,380,443,70,373,441,58,375,539,59,471
39159080AAZ,442,78,345,444,81,348,365,80,285,365,105,260,366,78,273,502,89,409
39159080AAD,985,257,671,999,325,607,809,290,519,817,351,466,825,295,498,1099,444,620
39041021AGK,339,80,245,337,118,206,473,187,286,469,214,255,476,202,271,785,389,390
39041021ACO,648,164,464,654,223,406,494,144,350,490,185,305,499,165,329,617,243,367
39041021AAT,636,297,307,630,339,251,558,330,228,559,381,178,561,357,187,706,428,257
39041021AES,283,162,101,292,184,88,205,139,66,207,154,53,208,135,61,286,180,99
39041021ADO,957,193,732,970,245,681,874,231,643,876,291,585,883,258,613,1052,300,735
39041021ACN,695,184,489,698,262,404,750,273,477,753,344,409,762,300,446,946,423,509
39173087ABS,791,158,606,802,205,554,648,183,465,657,263,394,662,181,453,857,232,609
39099050AQH,509,287,183,520,318,182,354,234,120,356,244,112,355,229,111,532,305,223
39037019AAX,498,57,420,505,76,407,369,57,312,367,88,279,377,58,307,572,78,486
39041021AAV,481,143,317,485,184,267,439,163,276,440,202,238,441,173,252,669,274,377
39023012AAT,750,259,442,743,328,379,570,292,278,578,350,228,574,272,279,772,326,436
39133067ADP,753,407,288,774,458,267,552,374,178,561,394,167,557,371,167,766,500,252
39133067ACX,767,244,477,794,290,473,646,293,353,661,321,340,659,280,353,855,341,497
39085043AHF,320,66,246,321,102,204,304,115,189,301,123,178,308,111,191,381,165,215
39023012AEQ,961,251,660,971,316,606,852,305,547,853,373,480,866,309,529,1042,360,668
39023012AEU,627,121,481,630,148,461,497,132,365,499,174,325,499,132,356,699,161,527
39049025BJQ,686,261,385,724,318,352,559,293,266,563,327,236,567,287,258,816,384,407
39049025BNR,492,436,46,502,469,28,422,392,30,424,401,23,428,398,26,571,501,64
39049025BIC,583,515,56,598,555,33,495,461,34,501,473,28,505,468,31,596,554,36
39049025AMN,553,282,239,578,319,226,465,287,178,471,319,152,473,306,156,697,411,263
39049025BMX,409,208,176,423,237,164,292,180,112,292,191,101,293,177,102,417,239,171
39049025AVS,745,351,362,745,431,271,678,411,267,677,444,233,679,424,240,814,530,269
39049025AHG,606,404,171,634,458,150,468,349,119,470,364,106,470,351,107,638,454,177
39049025AVN,836,402,419,829,521,271,727,447,280,731,515,216,739,465,268,857,607,240
39099050ACB,576,506,43,584,560,16,387,367,20,394,380,14,392,365,21,483,447,36
39029015ADG,609,104,468,630,126,485,499,133,366,508,163,345,510,130,356,664,142,521
39029015AFC,425,88,305,434,101,316,323,102,221,329,118,211,327,103,214,503,116,378
39029015ABE,683,194,438,689,235,415,458,183,275,471,209,262,466,181,267,730,255,460
39023012ADK,610,117,452,607,146,418,503,163,340,512,194,318,514,150,340,642,191,438
39023012ADS,519,119,373,508,150,336,399,142,257,408,181,227,411,139,263,536,158,372
39041021ACA,604,140,450,613,177,410,569,152,417,565,201,364,575,169,393,689,235,445
39173087AEI,782,245,500,796,332,406,642,291,351,647,339,308,654,298,336,891,443,432
39017009ADD,595,145,413,611,179,397,404,146,258,418,149,269,422,129,273,654,213,430
39017009ABV,487,129,335,511,173,296,391,167,224,413,188,225,411,165,232,547,218,313
39017009AMA,1000,186,785,1010,307,661,811,260,551,840,298,542,839,255,567,1158,422,731
39017009AFM,696,118,527,717,149,537,472,128,344,482,151,331,485,126,341,828,200,617
39017009ACF,138,26,110,141,36,100,134,29,105,140,38,102,141,29,107,224,65,156
39039020AAV,594,170,385,607,161,412,478,161,317,487,194,293,493,151,328,679,182,489
39071036ABT,625,109,499,629,107,502,495,115,380,490,140,350,494,113,364,658,124,529
39039020AAP,546,191,314,562,207,310,410,191,219,415,209,206,415,183,211,592,228,349
39051026AAJ,815,226,550,831,292,482,610,243,367,610,294,316,618,227,365,896,313,564
39153077AZL,653,327,292,688,376,286,558,337,221,577,370,207,576,346,219,767,450,300
39153077AVY,429,362,48,433,382,38,349,323,26,359,332,27,354,321,19,451,398,38
39153077AWH,576,187,340,601,211,353,459,185,274,480,225,255,471,185,262,662,249,397
39173087ABA,803,243,540,793,310,426,678,313,365,682,349,333,690,307,368,889,459,421
39051026AAH,598,189,374,605,212,339,426,163,263,429,213,216,430,159,251,615,190,407
39153077AAC,185,124,52,196,149,38,79,62,17,88,74,14,84,61,15,111,83,27
39125063AAY,631,151,446,640,99,511,509,111,398,512,121,391,517,103,395,672,115,549
39153077ARO,323,158,144,344,198,134,300,183,117,316,204,112,312,193,113,370,208,158
39153077BAC,508,224,240,535,256,259,389,215,174,395,242,153,397,224,161,576,267,298
39153077AWK,640,204,400,658,234,397,618,271,347,627,296,331,628,273,337,893,383,493
39153077BAD,480,203,237,499,237,242,381,217,164,385,235,150,389,221,156,604,262,330
39153077AMS,735,265,445,757,351,375,652,326,326,666,358,308,665,323,328,839,442,388
39153077BAQ,419,169,237,427,210,199,361,201,160,373,221,152,372,191,170,527,322,197
39153077BCJ,683,283,362,713,358,317,623,365,258,637,397,240,635,350,268,965,522,433
39153077AJL,562,407,125,582,437,125,417,320,97,422,335,87,421,323,89,622,424,191
39153077BCP,778,308,452,789,413,344,696,386,310,703,409,294,710,373,330,965,540,417
39051026AAO,797,162,598,805,200,556,626,158,468,630,200,430,632,152,462,898,268,621
39071036AAN,447,117,300,450,119,303,330,118,212,326,123,203,333,109,216,464,131,320
39153077AWA,607,189,357,623,228,366,482,202,280,492,231,261,485,206,260,696,253,435
39153077ATF,610,170,401,645,191,419,509,186,323,519,206,313,519,177,318,730,219,499
39153077ATG,641,203,389,663,247,382,511,224,287,529,248,281,524,227,279,741,286,447
39153077AVT,382,138,203,391,159,214,321,150,171,328,165,163,327,144,169,469,172,288
39153077AFN,506,308,164,521,344,157,354,245,109,363,267,96,358,250,94,503,344,155
39017009AHV,851,99,722,862,144,693,753,136,617,774,172,602,780,139,627,987,179,801
39153077AKG,646,340,277,684,399,249,547,357,190,557,387,170,555,343,192,794,492,280
39153077ARI,751,260,456,777,365,382,681,337,344,690,357,333,691,327,358,858,426,423
39153077AKS,570,232,299,599,317,247,524,306,218,533,333,200,533,300,216,705,389,300
39153077BAL,577,240,303,600,285,272,461,256,205,478,297,181,474,262,191,630,325,289
39153077APM,629,218,366,656,307,308,565,298,267,570,320,250,570,291,255,781,391,373
39153077AIN,634,311,272,665,354,268,494,299,195,509,329,180,501,293,191,660,379,265
39153077AZM,356,258,70,379,283,72,248,204,44,257,215,42,260,207,46,368,260,100
39153077AJV,490,201,241,514,210,278,354,178,176,359,204,155,357,179,161,539,211,316
39029015ACT,438,109,290,438,118,304,333,104,229,341,127,214,341,100,229,468,126,336
39029015AEM,622,114,476,635,122,490,496,125,371,516,158,358,501,128,356,629,127,492
39029015ACD,523,100,373,531,95,402,387,96,291,402,128,274,400,101,286,582,117,454
39029015AAW,445,128,282,467,147,309,333,139,194,344,169,175,346,138,198,520,151,357
39099050API,464,107,317,473,128,320,358,121,237,359,125,234,362,120,227,498,130,361
39071036AAX,698,123,551,713,114,585,539,106,433,543,134,409,547,103,433,812,119,688
39031016AAB,545,184,310,551,193,305,365,167,198,368,191,177,368,151,200,584,205,362
39061031AID,668,544,97,686,644,32,528,496,32,527,501,26,529,483,33,666,618,43
39061031AQM,805,425,342,819,514,257,700,466,234,704,495,209,714,449,243,836,572,251
39061031AHP,1321,750,498,1385,907,368,480,380,100,484,395,89,491,376,89,135,101,33
39167084ADE,710,243,435,738,174,532,546,156,390,548,211,337,551,149,380,765,171,585
39061031BDJ,365,282,71,376,324,39,310,280,30,313,286,27,315,280,29,437,374,55
39061031AAS,929,289,579,958,345,546,727,327,400,724,352,372,734,301,394,1008,439,544
39061031AJO,1076,776,227,1092,920,125,931,817,114,932,829,103,937,783,127,1044,917,113
39061031BIR,1051,130,900,1052,206,811,930,195,735,942,244,698,953,185,749,1134,264,845
39061031AJR,981,748,174,997,853,105,892,803,89,895,822,73,899,796,80,970,865,88
39061031ADB,797,482,290,802,592,177,709,517,192,720,548,172,723,504,202,830,625,197
39061031AUA,943,603,286,955,709,214,699,517,182,701,527,174,708,494,192,950,714,221
39061031AWU,628,255,344,643,303,300,480,267,213,482,288,194,484,258,205,619,345,259
39061031ARQ,730,502,202,740,589,137,633,503,130,631,506,125,634,489,137,777,627,145
39061031AKK,883,786,55,932,909,15,623,596,27,635,618,17,626,581,30,813,761,33
39061031ADQ,797,366,406,802,506,246,714,472,242,711,489,222,718,449,244,863,595,250
39061031ACF,661,202,452,640,309,306,620,309,311,621,337,284,631,297,326,717,410,301
39061031BFB,882,169,691,894,222,637,735,215,520,738,255,483,743,210,509,938,286,644
39061031AWZ,1036,319,661,1046,429,556,890,404,486,888,406,482,890,384,477,1124,522,587
39127064AAA,630,160,442,635,136,475,468,119,349,481,150,331,476,116,353,719,120,587
39127064AAZ,431,102,306,445,113,318,350,108,242,354,127,227,357,117,232,492,123,366
39127064ABT,569,111,430,571,143,410,472,117,355,483,154,329,485,135,334,697,170,520
39167084ABM,605,143,434,636,148,469,506,135,371,507,159,348,512,126,369,731,171,551
39167084AAC,656,211,413,678,164,482,506,172,334,505,215,290,509,162,323,731,221,492
39077039ABZ,491,113,339,500,133,342,363,129,234,365,165,200,368,122,230,499,125,361
39077039ABO,786,160,584,793,181,587,637,187,450,638,231,407,638,167,445,861,186,669
39127064ABB,459,97,340,465,98,344,355,87,268,359,130,229,361,93,258,504,106,393
39083042ABU,535,79,427,531,84,430,427,90,337,434,119,315,427,99,316,642,95,547
39083042ACI,46,8,36,46,8,37,38,9,29,39,11,28,37,9,28,58,12,44
39083042ABP,612,128,451,611,157,432,468,130,338,464,144,320,469,121,333,689,171,511
39129065ABV,768,135,600,779,146,598,598,128,470,600,187,413,599,142,439,870,188,672
39127064ABJ,529,129,376,531,150,361,419,130,289,425,167,258,425,134,279,619,183,426
39057029ADY,607,243,328,625,286,294,268,146,122,267,155,112,270,138,116,442,220,205
39057029AGW,279,36,232,275,57,209,239,48,191,240,61,179,241,42,195,299,58,241
39057029AHK,642,524,101,649,573,55,620,550,70,622,573,49,626,539,70,693,633,49
39057029AJB,925,303,579,926,393,485,894,438,456,899,492,407,915,422,461,1177,643,509
39057029AJC,715,150,541,724,203,473,640,202,438,644,238,406,650,203,423,808,304,484
39057029AHR,595,68,507,594,88,493,495,75,420,497,121,376,502,76,415,634,104,525
39061031AXU,641,284,332,647,319,302,493,259,234,498,271,227,494,245,238,609,349,251
39129065ABO,725,145,546,733,149,546,642,163,479,652,243,409,659,169,467,821,167,645
39057029AGT,1057,254,776,1046,360,646,983,323,660,990,381,609,1000,321,663,1330,495,811
39057029AEZ,431,119,290,428,171,241,369,139,230,365,173,192,367,129,230,446,187,248
39129065AAP,343,86,248,340,96,229,285,83,202,278,111,167,284,90,192,354,105,245
39083042ABK,555,95,434,567,97,451,481,103,378,486,130,356,481,105,360,671,117,543
39083042ACC,510,123,364,527,150,350,419,118,301,423,141,282,423,123,286,631,170,452
39081041AAJ,691,231,422,692,220,441,539,238,301,541,250,291,538,222,298,725,256,462
39081041ADB,270,90,159,276,92,174,212,101,111,219,113,106,218,88,125,299,94,201
39121061AAK,133,33,93,140,25,103,91,26,65,91,32,59,90,26,62,127,25,100
39083042AAG,621,202,368,618,199,369,445,172,273,449,183,266,450,178,240,688,224,445
39103052AEC,540,154,352,551,163,362,435,155,280,450,187,263,457,153,288,599,184,409
39127064AAS,525,103,394,527,100,411,401,87,314,407,113,294,408,90,303,584,83,494
39103052AFB,782,240,503,796,331,425,590,275,315,608,304,304,611,273,322,895,387,495
39009005AAS,530,350,157,534,397,114,475,363,112,487,387,100,491,378,100,556,430,120
39063032ACS,892,157,689,894,205,641,721,182,539,730,252,478,739,191,534,924,227,687
39063032AAR,454,132,291,467,150,289,316,124,192,323,154,169,328,128,186,493,185,298
39013007ACJ,480,106,358,481,110,357,435,112,323,434,149,285,437,107,324,549,136,411
39083042ABE,919,231,644,920,261,620,748,270,478,756,293,463,755,258,478,1063,315,733
39119060AAE,728,227,452,732,290,401,522,230,292,527,269,258,528,211,295,751,277,456
39119060AAS,552,159,361,565,228,304,436,188,248,438,220,218,439,170,250,580,230,335
39119060ADF,705,141,546,708,182,504,554,162,392,562,199,363,564,141,413,797,196,592
39119060ABT,509,119,363,521,125,363,353,108,245,354,130,224,358,108,230,586,132,442
39083042AAW,201,80,113,200,84,102,169,89,80,170,103,67,170,90,80,226,106,117
39083042ABD,917,198,688,933,254,636,764,227,537,781,282,499,773,232,519,1096,352,732
39083042AAV,558,130,391,560,163,375,439,119,320,449,156,293,440,116,302,596,150,429
39059030ACD,119,39,77,121,42,75,93,38,55,92,41,51,95,40,54,134,33,98
39135068AAV,234,33,184,234,49,173,182,51,131,178,58,120,179,54,118,230,61,167
39035018CGY,557,242,274,593,284,275,450,243,207,460,260,200,461,233,216,631,308,317
39035018CQR,688,553,112,704,625,54,603,550,53,604,560,44,608,539,56,772,692,66
39035018CLZ,760,309,410,788,381,371,623,360,263,628,383,245,632,326,280,765,394,361
39035018BBQ,394,241,98,423,311,85,252,203,49,255,214,41,257,195,53,371,253,107
39035018ALD,315,288,14,345,341,2,204,199,5,208,205,3,208,195,6,254,247,3
39035018CWW,673,434,215,684,523,136,578,473,105,583,490,93,580,457,108,702,573,118
39035018DBC,293,246,31,315,283,32,239,214,25,249,227,22,244,212,26,319,279,39
39035018ADE,668,581,64,680,632,44,579,545,34,588,562,26,587,539,37,682,636,44
39035018CMG,780,328,409,827,393,407,621,341,280,630,363,267,635,327,288,864,432,420
39035018APV,289,204,64,319,276,36,251,210,41,259,229,30,255,206,46,283,251,31
39035018APX,354,316,20,390,384,3,273,260,13,280,274,6,279,252,12,332,318,11
39035018BHK,581,336,190,610,404,181,424,297,127,435,320,115,435,281,135,644,416,215
39035018BDQ,277,174,78,311,250,55,158,112,46,165,126,39,166,108,49,270,177,93
39035018CRW,986,511,461,973,703,229,887,647,240,884,647,237,894,611,276,1080,835,235
39035018BOK,483,238,218,498,302,171,422,265,157,436,304,132,438,263,162,508,334,167
39035018ACB,524,290,191,549,346,181,412,286,126,417,305,112,416,268,135,544,368,170
39035018BVJ,847,228,571,886,315,528,751,310,441,766,353,413,772,282,467,957,367,577
39035018CUT,973,285,639,1006,372,603,852,358,494,866,395,471,875,338,525,1185,468,710
39035018BAG,353,241,67,414,342,53,263,228,35,268,236,32,266,217,35,333,242,83
39035018BJW,553,427,94,570,499,53,449,404,45,452,419,33,454,402,38,532,489,37
39035018AKC,250,181,49,270,235,34,165,138,27,166,145,21,165,133,27,228,186,38
39035018BHQ,535,323,172,556,367,173,367,248,119,368,256,112,362,222,124,553,326,220
39035018DEU,331,283,29,349,324,20,247,231,16,248,238,10,253,236,15,287,264,20
39035018CJB,830,323,460,872,381,460,697,363,334,703,387,316,706,334,353,962,402,550
39103052ABH,818,274,490,850,295,519,535,227,308,565,256,309,566,228,315,953,348,587
39035018CWM,756,253,464,786,323,440,641,295,346,654,336,318,656,297,344,912,424,478
39091046AAY,364,57,293,369,82,275,283,67,216,288,85,203,282,71,202,417,86,327
39103052ACP,760,260,466,774,302,423,565,277,288,590,296,294,593,281,301,868,376,477
39103052ACD,635,211,385,654,264,349,501,253,248,516,284,232,515,241,260,700,276,409
39045023AAA,585,165,386,592,174,381,423,155,268,426,197,229,435,154,257,722,236,475
39045023ADW,620,178,424,613,195,393,518,182,336,536,233,303,538,201,332,707,244,451
39103052AEW,593,186,390,593,240,323,461,203,258,466,237,229,471,195,262,627,285,329
39035018BYG,613,400,173,641,456,158,503,396,107,501,411,90,505,390,97,708,520,181
39035018AFW,675,224,421,709,282,403,531,247,284,538,275,263,539,242,285,754,314,429
39035018BPF,647,571,49,683,644,29,463,443,20,469,450,19,470,431,29,576,533,41
39035018ADJ,773,438,277,799,499,259,652,467,185,654,490,164,660,457,190,892,570,311
39035018BFK,385,254,100,412,318,79,247,194,53,247,200,47,251,189,56,351,241,105
39035018DAL,140,64,63,149,80,63,99,63,36,99,63,36,100,57,40,152,91,60
39035018AQO,389,347,20,430,418,11,302,292,10,310,300,10,316,297,14,377,359,15
39061031ADA,622,376,227,632,470,123,535,401,134,541,416,125,541,386,142,680,529,136
39061031AUW,632,256,337,651,327,295,476,264,212,476,275,201,477,235,215,709,388,303
39061031BDE,842,415,387,862,458,370,686,428,258,685,450,235,689,395,265,917,556,350
39061031AAB,551,183,344,555,248,271,496,240,256,500,267,233,500,232,252,725,387,331
39061031AAD,856,266,559,863,363,453,720,338,382,724,366,358,726,327,383,868,425,431
39053027AAE,376,107,251,383,113,247,294,84,210,299,116,183,300,89,204,397,114,276
39061031AXI,803,418,348,826,547,242,710,499,211,702,516,186,714,476,217,864,599,252
39061031AIE,932,697,208,957,846,82,839,732,107,848,756,92,849,721,111,988,868,102
39061031AEG,804,348,441,796,512,252,762,467,295,757,505,252,768,469,283,945,633,293
39061031AXR,704,334,344,714,432,259,592,386,206,597,408,189,596,370,218,740,499,232
39061031BBM,997,130,834,1001,210,745,833,203,630,832,237,595,841,180,644,1000,275,710
39033017ACN,425,63,346,425,64,346,319,73,246,329,96,233,328,65,251,433,76,353
39063032AAB,586,172,376,589,191,356,418,169,249,429,203,226,427,167,248,615,252,351
39119060ADE,403,104,290,406,132,254,299,117,182,300,139,161,303,114,182,453,129,317
39119060ABP,448,65,366,454,75,361,379,89,290,378,112,266,380,82,288,505,92,410
39135068ABC,777,114,620,785,142,606,589,128,461,605,169,436,602,130,454,830,159,663
39033017ABG,454,127,299,458,135,299,362,121,241,371,150,221,369,127,224,463,121,333
39033017ABR,337,44,280,335,44,277,248,57,191,257,74,183,256,60,189,386,55,329
39033017ABX,262,32,203,258,41,207,198,42,156,205,58,147,207,33,171,290,45,241
39061031AFN,778,647,107,795,748,32,667,616,51,672,636,36,676,614,47,832,771,54
39009005AAD,627,426,158,670,493,128,438,356,82,451,379,72,457,352,76,458,367,83
39119060ADD,660,152,478,665,199,429,510,179,331,516,231,285,523,165,346,682,183,485
39091046ABK,360,57,280,372,74,285,302,69,233,304,93,211,305,68,221,450,88,355
39127064ABH,491,197,265,484,180,280,345,159,186,351,191,160,359,150,187,504,155,337
39033017ABB,519,117,385,523,132,365,425,114,311,439,156,283,434,119,303,546,145,397
39057029AHE,120,18,99,121,22,93,83,15,68,82,31,51,80,16,57,102,14,87
39083042ABB,434,102,320,434,106,318,309,91,218,310,104,206,307,85,213,449,138,297
39061031BMT,669,271,366,668,357,269,566,327,239,574,348,226,578,317,247,696,399,282
39061031AFL,828,705,93,864,819,31,696,665,31,705,680,25,708,664,36,831,779,42
39061031AMK,355,292,42,358,311,30,329,304,25,325,303,22,330,298,24,408,372,29
39061031ATN,976,266,690,972,437,488,896,396,500,892,447,445,907,381,505,1073,530,530
39057029AGM,453,114,324,453,120,316,352,103,249,358,142,216,360,105,244,485,153,319
39057029AFM,533,118,390,527,153,340,423,140,283,430,185,245,433,141,283,555,177,363
39119060ABM,385,95,276,385,142,221,343,116,227,351,157,194,357,122,225,399,143,253
39167084ABJ,1055,303,697,1082,276,767,814,228,586,828,273,555,835,224,582,1143,299,829
39035018BVM,930,409,496,930,569,326,850,530,320,849,562,287,859,492,349,1070,688,368
39103052ABX,973,307,623,992,395,548,821,385,436,837,445,392,844,379,447,1180,526,640
39119060ACV,584,111,447,587,129,438,469,131,338,467,175,292,475,123,339,643,164,473
39135068AAG,593,104,455,600,165,408,455,115,340,456,169,287,463,105,327,636,167,463
39063032AAV,420,145,243,428,147,253,263,112,151,266,132,134,268,102,147,435,164,256
39103052AFR,660,151,462,678,193,456,530,185,345,550,213,337,554,178,352,863,268,583
39063032AAG,439,143,259,457,171,245,306,162,144,306,182,124,311,151,145,551,250,285
39057029AIQ,514,66,426,514,106,393,433,79,354,436,115,321,435,77,347,512,110,396
39139070ACG,771,119,624,783,127,631,597,128,469,603,158,445,605,129,454,824,142,672
39139070ABW,898,231,623,914,212,666,699,193,506,709,232,477,708,188,491,1011,209,792
39119060ACD,744,161,559,744,224,477,635,214,421,636,271,365,641,219,404,917,287,618
39119060ACP,535,128,375,539,167,350,405,159,246,406,184,222,414,145,246,564,157,397
39035018AWI,405,363,28,438,414,21,332,310,22,335,320,15,335,304,24,428,393,26
39035018AXU,212,166,34,233,200,29,150,130,20,152,133,19,150,125,23,202,159,40
39035018CMO,781,268,479,803,319,443,653,297,356,658,336,322,670,300,357,804,352,445
39035018BFL,299,203,72,332,254,62,194,161,33,196,159,37,196,151,36,292,199,85
39035018CBI,719,308,375,764,387,349,607,359,248,609,391,218,615,350,246,835,449,380
39035018AKI,403,355,21,430,412,12,294,276,18,306,294,12,305,282,16,370,346,22
39035018BDZ,430,301,104,465,371,74,527,439,88,531,451,80,536,434,91,812,625,173
39035018CWL,946,295,615,959,409,506,791,341,450,810,396,414,816,334,467,1018,449,562
39035018ADO,814,398,382,861,469,349,658,409,249,661,434,227,659,382,258,1077,625,442
39035018BQE,410,379,16,433,420,5,269,259,10,276,273,3,281,265,13,376,356,15
39035018BSQ,620,585,22,656,645,9,516,501,15,520,507,13,526,505,16,567,543,17
39139070ABV,643,165,422,655,160,455,472,158,314,480,186,294,480,144,312,746,172,560
39139070ADC,587,122,431,593,131,441,517,144,373,531,164,367,533,150,370,653,151,496
39045023AEX,734,268,444,733,336,361,710,350,360,729,406,323,733,366,343,1323,709,595
39045023ACO,1013,187,781,1041,219,781,814,189,625,823,253,570,832,226,594,1151,291,848
39101051ABL,360,103,232,361,136,210,284,116,168,287,152,135,287,120,161,371,144,225
39101051AAE,294,103,160,303,117,163,228,101,127,228,115,113,226,98,119,326,140,179
39101051AAP,235,96,107,238,77,135,144,73,71,145,76,69,144,72,66,250,87,153
39101051AAV,182,70,92,180,74,90,110,50,60,115,62,53,112,45,58,183,69,109
39135068AAK,899,153,704,907,175,701,675,144,531,679,198,481,685,140,513,940,200,716
39103052AFN,188,51,124,192,57,125,141,59,82,142,65,77,146,60,82,209,61,145
39035018CTD,757,539,179,785,631,130,649,537,112,658,567,91,659,521,121,813,659,145
39035018AWV,487,408,44,503,458,41,393,362,31,396,369,27,403,360,34,479,429,45
39035018BDC,668,320,311,705,401,278,579,370,209,583,400,183,587,358,212,743,444,290
39113057AUB,626,257,337,638,294,311,378,185,193,385,206,179,387,177,191,613,256,346
39113057AXY,693,260,397,702,332,333,558,277,281,568,328,240,572,279,278,742,402,333
39009005ACI,187,61,117,192,49,137,157,51,106,158,61,97,158,50,104,237,56,179
39139070ACC,533,140,362,545,145,379,424,124,300,430,161,269,428,118,295,597,147,439
39035018APB,502,445,44,521,494,25,390,360,30,399,374,25,398,365,28,487,453,30
39089045ACP,1087,229,811,1093,313,731,939,313,626,959,375,584,956,328,613,1456,532,895
39089045ADS,831,144,650,833,185,596,717,157,560,722,203,519,728,162,546,963,245,712
39089045AEU,945,301,607,960,346,570,758,314,444,770,366,404,773,332,419,1100,478,589
39089045ACR,1255,338,855,1268,397,811,996,375,621,1012,426,586,1013,388,596,1523,542,946
39017009AJB,841,206,612,850,267,549,688,252,436,697,262,435,701,237,453,890,329,547
39089045AFU,1103,569,499,1100,638,398,948,616,332,976,695,281,979,651,309,1299,864,406
39089045AAY,642,215,387,646,253,364,513,229,284,524,269,255,521,234,271,722,310,397
39003002AAY,450,154,267,460,195,245,311,143,168,316,170,146,315,134,171,469,192,271
39061031AWR,488,215,248,498,259,221,378,219,159,379,232,147,383,208,158,519,302,213
39061031BIE,955,107,822,954,189,727,834,170,664,846,213,633,824,158,644,1042,270,761
39017009AIM,837,240,571,835,337,455,690,287,403,703,327,376,705,276,414,897,395,488
39017009ABS,414,116,277,429,156,248,323,137,186,335,152,183,336,133,188,497,200,287
39129065ABC,473,113,331,483,128,330,327,90,237,325,112,213,331,89,226,618,141,473
39057029AHF,415,119,268,429,158,250,366,150,216,364,162,202,376,135,231,436,180,245
39091046AAB,698,142,504,702,209,465,550,186,364,550,228,322,551,185,351,811,275,517
39057029ADI,403,98,279,407,146,236,341,124,217,340,140,200,341,114,222,439,171,258
39049025AHR,603,317,249,661,400,228,420,261,159,429,292,137,434,282,146,614,359,247
39073037AAO,923,263,621,937,255,637,684,244,440,691,302,389,699,238,438,975,271,690
39073037AAR,672,170,469,685,181,479,543,167,376,548,209,339,550,169,356,754,169,574
39035018CCV,743,267,437,761,327,401,604,304,300,604,312,292,610,282,314,840,358,472
39057029AAT,381,89,277,378,132,228,342,103,239,339,125,214,346,99,240,417,160,255
39057029ABD,801,164,612,791,257,486,740,258,482,743,303,440,756,236,495,910,357,537
39003002ADG,481,113,346,487,149,313,379,123,256,375,168,207,382,119,254,506,167,332
39163082AAR,428,101,301,445,92,331,335,91,244,345,122,223,342,105,223,467,88,370
39061031BJZ,607,54,536,609,100,490,530,94,436,527,116,411,534,82,446,620,113,500
39061031AFJ,417,369,34,428,411,10,368,353,15,368,353,15,368,348,17,433,414,16
39095048AKN,501,415,71,510,455,43,388,352,36,392,361,31,394,349,35,469,424,43
39095048ASS,776,304,434,805,371,387,547,313,234,551,346,205,553,299,236,770,438,321
39095048ATF,728,308,380,748,361,352,640,333,307,646,379,267,651,329,305,875,443,413
39095048ATH,889,340,514,910,429,435,670,330,340,674,362,312,675,312,339,880,464,403
39095048AOJ,359,211,127,377,244,109,216,149,67,215,157,58,216,138,64,318,197,111
39095048ATV,698,275,401,722,352,335,620,333,287,623,375,248,633,338,283,747,393,343
39095048AAV,514,198,299,536,200,311,429,195,234,433,218,215,449,192,226,600,239,354
39095048AJB,482,268,185,492,299,156,353,261,92,357,280,77,359,244,103,530,351,162
39095048AUV,813,254,529,829,335,436,738,329,409,739,375,364,765,321,402,999,413,561
39095048ATD,655,342,278,682,404,237,511,345,166,512,364,148,511,335,158,753,457,285
39093047AHY,856,266,553,858,299,510,741,330,411,766,385,381,774,339,414,987,373,601
39093047ACG,954,337,583,974,422,503,748,394,354,770,454,316,782,381,381,1065,515,535
39109055ABB,667,123,520,682,199,455,582,195,387,598,241,357,608,195,395,865,269,588
39095048AHB,380,274,74,390,309,67,259,222,37,261,220,41,263,212,44,334,280,46
39095048APU,529,230,264,536,261,221,422,252,170,426,277,149,428,234,173,575,323,239
39095048AES,555,454,83,579,511,57,390,348,42,391,357,34,391,341,41,499,445,46
39001001AAI,871,154,680,882,168,684,678,164,514,697,205,492,702,160,521,969,171,787
39151076AMU,767,259,472,771,306,433,617,250,367,634,286,348,637,255,361,780,321,444
39151076AKH,642,143,465,645,153,466,514,158,356,520,187,333,522,148,357,708,161,533
39151076ADU,414,166,227,413,181,208,332,182,150,333,198,135,335,176,139,487,220,252
39151076ALW,596,159,396,606,176,399,483,167,316,490,200,290,490,161,304,628,174,438
39151076AID,553,138,389,559,167,365,451,175,276,457,180,277,457,160,286,587,188,387
39151076AJX,424,103,292,434,111,307,335,107,228,332,119,213,337,100,218,461,109,347
39095048ACP,709,301,363,729,330,343,534,284,250,536,322,214,544,279,243,715,300,400
39095048AGD,542,465,52,563,531,16,401,381,20,407,394,13,406,382,20,494,459,25
39095048AGO,771,343,400,786,429,330,663,390,273,663,429,234,673,389,264,849,473,363
39095048AAQ,757,267,459,759,334,389,689,346,343,693,410,283,692,337,337,942,446,483
39095048APA,680,314,327,716,371,294,543,344,199,545,380,165,551,337,194,763,437,312
39139070ABD,504,122,346,509,113,363,366,114,252,376,142,234,376,106,254,526,111,400
39027014ABG,574,103,441,588,121,437,394,99,295,395,125,270,396,95,289,613,115,486
39095048ARG,431,198,215,440,239,177,316,202,114,320,222,98,324,194,116,398,218,171
39095048AUR,709,242,442,709,282,372,597,282,315,606,324,282,609,275,309,801,360,423
39095048ACX,649,287,326,674,311,313,525,316,209,531,356,175,539,322,190,729,352,368
39095048ALX,241,156,73,249,172,62,174,139,35,174,146,28,175,136,34,243,166,71
39151076AIO,455,116,312,464,116,330,380,120,260,384,134,250,383,112,257,596,157,428
39155078AFE,554,206,320,565,209,332,479,220,259,488,255,233,495,231,251,626,236,379
39095048ACJ,740,284,434,753,345,368,634,328,306,638,369,269,650,319,299,765,395,349
39095048AMX,346,208,110,358,235,96,264,178,86,261,193,68,269,182,80,359,255,100
39095048AHE,506,449,40,525,504,12,344,327,17,346,337,9,349,327,17,441,422,17
39095048ABQ,928,437,429,954,492,410,631,369,262,639,411,228,645,365,257,921,444,461
39095048AGT,458,198,237,469,246,193,388,216,172,393,248,145,395,211,166,510,265,236
39005003ACM,923,155,707,947,170,743,716,171,545,717,200,517,723,164,543,1004,153,837
39165083AAG,678,104,541,699,149,520,583,135,448,591,173,418,598,135,443,793,186,595
39165083AAY,1130,333,767,1146,475,608,1006,472,534,1026,513,513,1028,476,528,985,498,474
39139070ACM,778,261,456,793,279,476,584,235,349,600,284,316,599,223,350,831,281,538
39151076AIZ,637,209,394,637,231,373,494,231,263,496,254,242,497,223,257,726,274,437
39013007ABS,331,122,189,333,104,209,255,119,136,254,137,117,260,102,148,350,112,231
39013007ABH,546,221,300,567,195,346,449,207,242,448,230,218,451,184,256,620,212,402
39079040AAW,466,101,352,480,94,372,361,83,278,371,132,239,377,97,272,534,103,426
39029015ADI,595,108,457,604,107,478,480,119,361,484,153,331,489,127,343,648,130,511
39099050AJQ,671,262,384,674,285,363,582,256,326,598,337,261,596,272,308,785,341,440
39029015ADJ,386,127,214,396,121,254,289,114,175,297,127,170,295,106,182,381,113,266
39029015ADZ,416,115,284,422,151,254,357,120,237,358,156,202,359,124,230,454,159,292
39049025AZS,724,188,524,714,264,423,617,215,402,616,257,359,624,226,392,826,360,459
39049025AMR,700,276,371,726,321,353,526,272,254,531,307,224,534,269,239,810,387,400
39049025ARY,879,367,471,886,460,380,734,417,317,743,486,257,746,440,285,944,574,349
39049025AJQ,704,451,219,735,523,179,473,366,107,478,389,89,482,372,92,798,616,167
39139070AAN,601,237,311,600,254,293,503,259,244,503,294,209,503,254,231,636,296,328
39099050AQJ,573,424,112,582,454,117,428,334,94,434,366,68,437,344,82,587,455,124
39099050APT,420,133,264,419,159,243,311,132,179,320,171,149,321,146,162,415,153,258
39021011ABY,758,141,580,762,163,573,669,170,499,675,249,426,679,174,485,861,168,683
39029015AFF,636,184,420,654,197,435,472,183,289,481,212,269,475,167,298,716,194,514
39151076AEC,400,184,183,399,188,193,297,164,133,299,171,128,299,157,129,436,188,239
39151076AGW,953,240,687,966,335,585,836,295,541,855,355,500,858,294,542,1098,436,650
39029015AFB,428,78,319,439,84,334,317,89,228,329,100,229,320,83,221,432,79,345
39099050ARN,603,331,240,619,374,226,452,288,164,465,325,140,454,291,150,623,367,251
39089045AAG,742,180,537,746,206,503,633,193,440,644,243,401,642,192,437,902,268,623
39119060ACW,383,58,312,389,92,280,312,80,232,308,96,212,312,76,231,430,82,343
39089045AFA,792,150,604,801,152,620,595,130,465,601,182,419,605,134,457,874,176,683
39017009AAN,506,172,312,519,217,287,392,186,206,395,201,194,389,167,206,561,249,310
39017009ADG,477,86,375,506,130,359,382,127,255,396,129,267,396,105,274,534,153,373
39171086AAU,1006,211,729,1034,219,761,804,202,602,797,289,508,814,184,607,1113,231,868
39049025BCT,694,450,225,701,513,162,618,493,125,626,499,127,626,480,133,828,657,160
39151076ADQ,682,186,458,692,215,447,532,193,339,544,202,342,544,184,347,726,243,465
39095048AIS,474,405,46,483,438,26,357,329,28,360,344,16,367,321,27,430,389,35
39095048APT,587,246,316,605,289,287,461,254,207,465,287,178,474,252,201,621,321,287
39095048AFZ,551,358,157,554,381,136,426,324,102,431,346,85,433,322,96,678,479,190
39095048AVA,710,215,481,715,301,374,580,270,310,579,301,278,593,264,314,858,358,485
39095048ATZ,882,357,470,900,418,415,643,358,285,647,406,241,651,368,259,900,476,409
39095048AFG,725,332,352,736,378,300,609,378,231,609,427,182,610,369,217,797,447,332
39143072ABZ,404,80,300,407,104,281,326,109,217,327,137,190,335,105,216,450,114,328
39151076AGK,476,146,301,492,193,276,398,182,216,401,199,202,403,167,221,536,216,314
39003002AEQ,746,83,640,755,90,639,594,81,513,601,144,457,600,83,506,806,110,683
39155078AIR,549,187,331,563,207,326,470,224,246,477,270,207,480,233,232,623,258,356
39155078AFN,382,156,201,384,150,221,318,151,167,324,175,149,325,147,164,410,151,254
39155078AKC,270,125,136,281,123,152,188,96,92,196,114,82,190,109,79,294,132,159
39165083AAZ,654,175,453,648,243,379,588,225,363,588,251,337,591,231,355,855,389,460
39165083ABW,739,225,487,740,339,368,605,299,306,625,336,289,620,301,304,867,480,367
39165083ABV,730,209,484,750,300,401,565,240,325,593,290,303,591,246,325,856,385,451
39025013AAJ,552,76,450,548,120,409,453,111,342,454,119,335,453,111,331,606,144,457
39025013ADA,983,175,780,970,312,602,876,296,580,874,327,547,883,288,569,1125,454,662
39037019AAW,711,93,592,715,123,574,525,117,408,537,154,383,536,98,414,738,124,600
39049025BFS,634,176,445,633,231,381,549,213,336,546,264,282,555,220,327,755,333,419
39007ZZZZZZ,0,0,0,0,0,0,0,0,0,0,0,0,0,0,0,0,0,0
39151076ABI,891,397,443,903,443,415,653,378,275,660,406,254,658,368,274,858,473,375
39151076ADZ,446,153,267,457,187,253,351,164,187,353,193,160,356,157,181,486,207,270
39151076ANF,570,169,385,566,219,323,484,206,278,484,230,254,489,205,275,639,280,344
39151076AAH,281,171,90,289,186,85,190,136,54,195,142,53,192,131,54,281,184,91
39169085ACV,815,139,644,818,184,605,619,146,473,617,170,447,629,140,472,882,209,663
39037019ABQ,689,97,566,692,134,528,595,123,472,598,176,422,603,110,476,795,154,623
39093047AJH,853,267,511,882,295,531,650,289,361,679,334,345,683,287,362,996,327,657
39007004AAB,447,191,235,445,225,202,382,201,181,385,239,146,386,197,179,479,260,209
39099050ARA,588,318,237,597,351,227,410,259,151,410,296,114,416,274,136,569,332,227
39147074AAO,512,148,327,513,181,285,390,169,221,403,225,178,404,173,213,549,205,333
39013007AAK,331,110,201,340,115,214,258,117,141,260,134,126,253,101,146,378,125,248
39109055AAQ,436,106,309,444,165,263,282,126,156,293,152,141,292,120,164,432,155,262
39049025AUP,600,280,281,607,315,244,416,230,186,413,249,164,418,233,177,556,310,235
39049025ALR,567,400,151,576,447,117,492,381,111,498,407,91,496,391,101,619,488,130
39049025ART,551,198,341,547,277,245,518,300,218,521,323,198,526,304,213,630,372,251
39169085ADF,745,129,566,768,151,587,582,150,432,592,178,414,602,134,446,859,163,687
39087044ACQ,529,163,348,540,129,398,436,135,301,444,164,280,443,140,292,572,144,423
39087044ACO,575,145,405,593,113,457,453,101,352,460,137,323,461,105,343,637,136,494
39093047AIF,781,296,438,815,368,412,655,353,302,681,411,270,680,351,312,908,428,469
39093047AEY,494,321,139,513,345,141,320,243,77,342,271,71,340,248,81,480,275,201
39109055AAK,432,94,312,437,125,284,364,125,239,373,151,222,379,124,236,586,176,396
39109055ACH,721,85,615,725,132,575,599,106,493,615,154,461,618,120,473,884,147,734
39093047AAT,550,191,341,562,247,287,470,248,222,487,279,208,490,240,241,616,300,311
39093047AKT,711,308,378,725,392,313,568,304,264,572,333,239,578,292,275,888,499,379
39099050ARZ,580,460,79,608,536,61,433,377,56,445,402,43,447,379,55,554,470,73
39109055ACJ,462,79,372,462,110,325,319,101,218,326,123,203,323,86,211,494,105,384
39109055ABX,973,181,767,976,271,669,845,258,587,856,326,530,864,254,581,1165,389,756
39093047AEB,268,117,140,279,128,141,212,115,97,221,131,90,218,127,89,320,156,163
39029015AEU,630,162,426,662,167,462,500,137,363,523,193,330,512,139,357,710,165,534
39095048ABG,580,242,302,589,244,289,430,219,211,430,261,169,441,222,198,611,258,339
39095048ACL,839,361,451,846,439,346,692,391,301,685,434,251,694,376,299,884,515,356
39095048AOZ,405,171,216,413,204,177,319,184,135,322,209,113,326,180,132,438,224,201
39095048AGC,601,486,85,618,536,61,434,394,40,436,409,27,440,391,36,552,474,63
39099050ATA,778,329,420,786,353,400,665,332,333,674,389,285,673,362,293,823,390,417
39099050ANY,766,247,483,772,244,504,613,241,372,618,280,338,615,260,344,855,285,566
39159080AAH,502,128,349,515,145,337,396,134,262,395,157,238,398,134,247,577,189,365
39065033AAJ,417,106,284,433,109,288,309,101,208,311,113,198,314,99,197,460,94,354
39065033AAG,690,186,463,711,213,447,471,176,295,472,221,251,469,171,270,765,215,542
39099050AHL,635,261,335,666,299,331,514,259,255,519,312,207,525,292,213,716,302,405
39095048ALT,600,394,173,614,459,131,477,371,106,484,392,92,489,353,116,628,454,165
39095048APV,675,277,373,685,325,326,565,316,249,570,356,214,579,317,251,735,419,307
39065033ABK,362,56,290,366,61,290,276,60,216,274,78,196,274,58,203,350,68,280
39049025BGW,866,319,503,873,432,381,673,374,299,678,422,256,687,384,289,961,552,391
39049025ATY,947,359,564,967,485,427,942,490,452,948,565,383,954,513,427,1216,711,494
39049025BKE,543,273,255,545,329,197,450,282,168,461,304,157,468,299,158,649,410,228
39049025AEQ,922,509,373,935,582,293,825,532,293,834,599,235,837,543,276,1007,671,318
39095048ADQ,267,214,44,281,243,33,167,147,20,171,156,15,171,142,21,220,193,23
39095048ALU,625,316,277,639,362,249,508,317,191,513,355,158,513,312,179,655,392,254
39095048AGZ,461,205,246,479,235,225,399,236,163,398,251,147,403,226,163,491,259,221
39141071AAM,315,140,163,318,166,138,246,135,111,249,158,91,250,130,109,348,186,148
39141071ACQ,269,67,195,272,71,194,223,63,160,222,79,143,226,61,159,318,76,241
39093047ADY,525,285,187,539,317,186,361,238,123,375,271,104,377,241,125,507,309,189
39093047ADU,580,355,175,606,396,179,372,265,107,387,300,87,390,268,104,590,349,232
39093047AAF,619,211,381,625,256,329,530,260,270,553,322,231,560,271,269,757,339,407
39099050AJO,632,168,440,642,177,451,534,175,359,543,216,327,546,187,355,695,203,491
39025013AFM,702,211,451,714,260,422,537,246,291,538,265,273,539,246,274,817,349,441
39025013ABM,915,179,707,915,258,624,723,225,498,723,259,464,729,215,490,1013,320,682
39175088AAK,305,55,226,308,53,236,202,46,156,201,59,142,204,45,142,346,57,277
39145073ACN,384,96,284,382,77,292,316,86,230,320,116,204,326,91,231,416,83,324
39123062ACE,480,128,333,489,164,289,422,178,244,427,227,200,426,169,235,526,177,339
39047024ABJ,448,121,312,465,132,320,321,97,224,321,121,200,323,106,209,527,134,387
39047024ABB,515,103,393,523,94,411,415,100,315,409,121,288,415,110,297,576,94,477
39047024AAG,376,78,276,384,97,273,297,84,213,295,108,187,298,90,195,412,115,290
39145073ABY,355,110,235,357,111,243,279,97,182,279,130,149,287,108,172,362,97,263
39155078AFK,562,175,351,587,208,365,503,207,296,515,225,290,514,207,291,651,219,423
39055028AAL,870,266,576,863,384,447,725,319,406,734,357,377,737,319,403,971,473,484
39055028ACF,777,200,533,793,279,480,657,278,379,659,295,364,663,248,391,872,338,529
39043022ACQ,691,196,457,694,227,439,562,223,339,573,274,299,568,242,298,738,224,509
39049025BET,607,507,82,627,555,55,481,449,32,486,460,26,489,450,30,621,567,44
39131066AAY,682,205,449,686,211,450,530,219,311,540,251,289,539,228,295,722,197,513
39025013ADM,296,37,244,303,64,229,246,75,171,244,75,169,244,64,169,336,94,237
39025013AEP,783,117,644,791,147,628,624,136,488,620,155,465,621,127,480,870,163,700
39041021AFR,626,177,434,634,252,360,555,213,342,556,269,287,563,242,316,746,353,384
39153077BAH,578,257,289,605,305,262,474,269,205,487,297,190,491,266,204,631,344,275
39153077ABH,488,267,176,521,318,175,358,255,103,366,270,96,364,234,114,499,305,184
39153077BCD,626,247,340,646,306,319,576,311,265,582,336,246,577,305,260,763,402,355
39051026AAY,794,269,481,796,306,450,634,271,363,634,315,319,640,266,349,886,330,547
39051026AAP,743,126,591,749,171,539,621,156,465,624,201,423,629,142,477,807,184,605
39153077BBX,562,230,298,579,273,281,444,261,183,445,271,174,452,244,195,657,363,286
39153077ACT,718,515,180,722,567,130,605,475,130,615,499,116,617,486,121,764,594,159
39153077BCS,606,224,354,626,263,344,522,264,258,533,285,248,537,256,274,664,287,375
39141071AAQ,292,124,143,308,153,137,229,121,108,229,140,89,232,111,113,343,147,189
39141071ACW,856,247,572,861,272,542,650,249,401,659,305,354,661,244,399,967,283,667
39113057AVB,676,149,489,689,188,466,518,161,357,525,193,332,532,170,337,706,160,541
39113057ATJ,716,142,534,733,204,498,568,164,404,571,228,343,573,163,396,766,220,531
39113057AJC,563,328,209,571,369,174,379,255,124,384,286,98,384,245,130,590,421,164
39113057ATS,1087,217,813,1107,281,788,822,243,579,825,299,526,840,230,568,1245,331,889
39113057APA,669,319,329,673,402,232,632,384,248,634,425,209,639,379,238,752,521,215
39113057AHX,581,505,59,599,560,30,400,376,24,404,389,15,410,374,30,574,542,27
39061031AFF,841,716,95,873,812,39,710,663,47,725,695,30,720,662,48,895,831,54
39061031AIZ,839,556,240,846,671,140,772,623,149,777,657,120,778,617,136,950,778,158
39023012ABF,615,287,300,617,326,243,425,262,163,432,289,143,431,257,160,548,317,221
39141071AAD,471,138,324,477,175,289,438,154,284,437,194,243,445,166,277,536,231,297
39171086ABJ,568,133,405,578,140,398,417,117,300,412,163,249,416,115,287,597,131,447
39165083ACY,428,139,266,448,191,233,323,142,181,330,161,169,331,134,183,471,202,262
39165083ABU,590,154,421,590,243,318,513,213,300,540,242,298,538,218,307,654,309,338
39165083AEW,712,132,549,728,198,495,561,197,364,565,230,335,575,188,372,789,288,491
39155078AEL,376,199,141,388,225,146,239,155,84,244,175,69,244,159,80,387,213,166
39047024AAS,599,85,493,606,91,497,502,88,414,499,118,381,502,93,397,714,108,590
39145073ACP,426,102,306,436,90,331,314,82,232,312,111,201,315,82,229,453,85,367
39007004ABG,547,239,274,550,265,260,436,246,190,443,275,168,442,250,177,610,286,307
39049025ARN,416,180,221,424,231,174,425,235,190,429,267,162,431,244,180,507,313,186
39049025AJS,824,417,375,848,478,320,673,426,247,678,465,213,680,436,224,1031,680,327
39049025BKR,518,195,309,522,277,218,492,253,239,496,288,208,502,274,214,572,335,228
39151076ACQ,512,211,277,495,245,217,449,248,201,450,266,184,452,243,194,537,312,213
39151076AME,563,239,275,577,257,283,421,203,218,422,231,191,422,199,193,592,245,338
39151076ACW,664,357,276,673,380,253,506,317,189,517,345,172,520,325,178,738,424,297
39151076ADP,722,239,459,731,282,429,576,246,330,589,290,299,590,241,333,756,290,462
39151076ADK,383,211,133,393,253,116,295,195,100,299,208,91,301,202,88,397,249,143
39151076AIB,659,170,454,673,206,441,519,192,327,519,213,306,525,188,328,740,239,490
39151076AHA,473,149,295,479,181,272,385,170,215,388,194,194,390,177,201,516,212,295
39143072ADA,228,44,167,236,68,148,186,58,128,185,80,105,190,58,127,248,83,163
39049025AEA,669,420,234,666,500,145,651,487,164,654,517,137,658,487,164,696,523,170
39049025ADW,674,416,233,671,500,144,636,470,166,642,521,121,645,487,151,744,589,145
39113057ATX,337,100,213,342,104,215,201,69,132,206,84,122,206,67,129,309,91,209
39113057AKU,658,187,433,668,237,394,530,211,319,535,253,282,534,214,297,716,291,417
39113057AOP,463,125,295,480,149,294,331,141,190,335,158,177,337,133,190,473,153,312
39107054AAN,636,85,533,642,111,506,503,106,397,505,145,360,510,97,402,687,135,544
39021011ABF,805,137,620,808,161,607,725,174,551,729,235,494,736,166,533,909,175,723
39011006ABN,456,37,403,462,54,393,421,57,364,426,87,339,429,50,367,531,73,450
39021011ABR,587,110,454,588,136,427,460,113,347,463,152,311,463,114,334,662,136,512
39141071ABH,385,114,237,393,112,267,281,89,192,283,121,162,284,89,185,441,112,325
39043022AAB,603,218,353,600,273,292,492,252,240,494,278,216,493,246,231,641,333,291
39049025BGG,872,634,206,905,713,160,728,586,142,740,624,116,740,601,118,1016,811,189
39049025BAK,403,238,130,418,278,130,288,192,96,296,212,84,294,198,86,407,268,130
39049025AAW,455,392,42,472,442,25,352,316,36,358,338,20,358,325,20,574,515,52
39049025ADY,797,473,294,795,582,181,771,549,222,777,619,158,783,586,187,851,671,175
39141071ABK,308,82,213,315,79,221,239,70,169,241,92,149,241,72,157,354,73,272
39141071ABF,414,154,240,414,162,228,304,120,184,308,146,162,309,128,173,505,159,342
39141071ABE,352,102,236,356,103,234,283,88,195,293,98,195,292,93,193,424,94,324
39081041ACW,464,108,328,472,81,373,366,106,260,367,134,233,368,87,279,506,80,422
39081041ABJ,821,201,576,838,187,631,688,226,462,698,261,437,701,220,459,903,237,657
39081041ACE,425,136,259,433,119,284,289,117,172,291,132,159,294,96,190,477,139,330
39081041AEF,222,78,137,225,60,160,165,73,92,165,78,87,164,69,90,241,59,179
39169085ABV,822,187,579,840,210,599,629,189,440,647,226,421,650,184,449,985,224,752
39133067ABG,354,228,95,371,252,84,249,198,51,252,208,44,252,203,41,302,250,45
39085043ACD,666,217,427,683,287,375,552,264,288,553,282,271,558,246,296,737,356,373
39085043AFO,855,191,628,874,279,548,729,261,468,734,308,426,739,253,460,972,349,613
39145073ADL,730,195,522,733,166,546,592,181,411,595,231,364,604,179,414,806,187,613
39145073ADC,413,143,260,413,131,274,350,132,218,353,164,189,360,147,199,464,123,337
39145073ACH,443,115,318,443,94,339,333,99,234,337,127,210,339,100,233,449,85,354
39145073ACD,421,134,270,419,115,297,368,136,232,380,157,223,378,139,229,419,109,309
39093047AFF,622,385,194,640,432,187,465,335,130,484,372,112,485,338,135,686,413,262
39049025BNP,169,73,92,174,79,87,150,73,77,149,80,69,152,78,72,529,289,224
39049025BHL,780,328,420,796,359,391,683,335,348,687,366,321,691,350,326,756,352,392
39049025ACC,653,354,264,662,407,208,509,340,169,512,373,139,516,357,143,806,568,227
39049025BIS,565,348,196,581,388,174,387,286,101,392,309,83,393,296,92,575,407,157
39049025AUW,477,318,136,498,358,127,335,236,99,335,258,77,336,239,86,469,334,126
39049025BNE,429,164,252,443,203,217,422,210,212,428,240,188,425,221,197,410,230,176
39049025BKK,640,243,377,646,300,315,622,311,311,627,353,274,629,326,292,856,484,358
39049025BJL,752,311,397,776,374,360,583,340,243,580,365,215,588,343,222,861,468,373
39041021ABS,656,152,480,655,200,417,625,185,440,619,242,377,632,208,408,777,273,494
39043022AEL,583,268,262,587,301,256,440,274,166,443,292,151,445,262,159,608,333,263
39043022ADZ,586,384,178,587,420,157,423,321,102,426,340,86,424,323,87,602,419,170
39099050AQF,432,207,202,450,233,195,330,196,134,335,241,94,341,209,125,461,232,222
39093047AKC,948,260,627,980,313,611,753,292,461,778,360,418,789,290,476,1094,326,754
39093047AFM,552,279,252,564,325,211,431,266,165,448,313,135,452,278,158,574,327,240
39093047AGT,783,271,466,813,335,438,608,322,286,629,367,262,630,308,291,893,408,472
39019010AAC,829,206,588,858,239,583,693,212,481,705,264,441,705,222,457,952,304,640
39041021AAJ,918,270,610,928,355,508,767,306,461,764,380,384,773,336,407,986,456,516
39041021ADB,690,246,425,711,318,350,589,284,305,588,327,261,590,316,264,864,468,380
39093047AHO,612,446,137,621,486,108,505,413,92,530,450,80,529,422,88,680,532,136
39099050AHX,518,293,199,535,336,176,369,240,129,378,276,102,380,255,110,528,324,197
39093047ABQ,817,346,411,838,409,374,605,356,249,631,410,221,630,346,247,914,465,429
39109055ACK,496,75,397,504,103,369,357,106,251,365,138,227,371,99,257,607,130,459
39169085ADQ,710,159,526,713,188,494,549,165,384,568,189,379,566,160,399,792,227,553
39093047AHX,565,184,351,564,223,314,440,205,235,454,248,206,458,203,234,620,270,336
39093047AEI,503,259,214,520,305,198,393,240,153,413,292,121,411,249,145,562,312,248
39151076ANT,444,94,303,450,112,320,289,87,202,290,113,177,289,92,186,439,105,322
39151076AEA,495,250,208,499,260,219,384,226,158,383,248,135,387,217,152,551,285,253
39151076AAB,295,124,146,304,124,159,203,103,100,205,115,90,207,103,94,342,131,204
39159080AAI,500,109,367,503,157,325,446,136,310,448,175,273,451,141,293,960,334,607
39059030AAD,270,97,163,274,116,143,200,93,107,202,115,87,202,92,101,333,126,201
39059030ACI,414,113,286,416,129,267,307,130,177,308,156,152,311,112,185,447,136,308
39099050ASN,513,198,277,525,252,250,445,227,218,449,280,169,449,248,185,546,251,286
39007004AAO,214,106,83,218,127,76,129,76,53,140,105,35,137,86,46,186,101,84
39007004ACY,446,179,242,454,186,242,330,160,170,348,203,145,341,175,154,471,183,282
39041021ABY,779,186,575,787,255,496,725,205,520,716,283,433,727,240,471,945,372,558
39041021ADU,584,108,441,593,147,416,505,120,385,507,168,339,508,145,349,666,193,466
39151076ALB,531,168,332,545,213,304,452,197,255,458,234,224,461,202,249,623,245,376
39025013ADV,756,132,603,753,194,529,674,187,487,666,207,459,677,185,473,847,262,570
39153077BBI,480,169,284,499,210,264,400,195,205,406,213,193,408,192,200,526,247,274
39153077AVZ,720,189,502,720,215,472,612,223,389,636,249,387,625,225,385,793,291,494
39153077AIQ,664,377,250,689,429,232,492,328,164,501,357,144,501,330,149,676,402,265
39041021AFA,777,236,519,790,343,417,723,331,392,725,381,344,729,339,382,975,500,467
39041021ABI,332,69,254,336,94,226,384,97,287,380,128,252,385,116,262,536,187,342
39037019AAI,784,159,600,800,210,562,638,172,466,642,250,392,651,168,459,819,212,596
39049025AKM,478,342,107,490,369,107,326,268,58,328,282,46,330,272,51,450,342,99
39085043AHD,788,224,519,814,280,483,646,240,406,649,298,351,652,239,387,975,355,605
39085043ABH,920,310,560,946,388,510,708,349,359,724,393,331,727,327,377,988,423,544
39133067AEE,635,153,442,670,177,454,554,192,362,553,215,338,558,191,344,745,211,521
39133067ACW,691,201,443,713,239,442,593,234,359,600,265,335,601,240,338,751,252,495
39087044ACB,413,150,246,418,133,271,345,125,220,345,152,193,349,128,220,484,175,306
39099050AJG,592,284,284,611,284,310,510,272,238,519,320,199,518,278,224,675,314,359
39029015ADF,513,90,395,535,112,401,441,117,324,455,146,309,451,114,317,588,126,453
39099050AQR,326,270,44,343,286,48,190,162,28,193,165,28,196,164,26,301,247,50
39099050ABJ,352,175,150,353,169,171,234,128,106,236,156,80,239,131,97,377,177,192
39001001ABH,421,57,344,426,72,345,310,70,240,325,93,232,328,61,257,404,51,353
39017009AJL,754,201,533,756,303,427,706,302,404,729,336,393,726,312,401,1061,535,514
39017009AIU,630,203,410,635,264,360,541,239,302,545,246,299,545,235,302,801,391,399
39017009AAW,507,134,354,513,166,320,401,145,256,409,160,249,409,145,255,527,212,304
39133067ADJ,637,169,423,684,200,451,507,202,305,512,218,294,516,189,303,768,222,531
39029015ACM,454,83,342,467,111,336,402,101,301,406,127,279,408,111,288,515,108,399
39029015ADM,462,144,291,476,129,323,338,123,215,351,146,205,340,114,218,514,146,358
39029015ACH,559,152,359,574,168,371,411,162,249,415,184,231,417,151,241,589,160,414
39099050ATB,579,187,379,591,199,373,460,176,284,459,213,246,474,212,254,651,239,406
39049025ATX,201,75,121,198,104,85,701,406,295,695,444,251,701,423,257,1025,653,351
39049025BMF,1002,373,605,998,521,425,460,208,252,467,246,221,469,211,254,567,303,254
39049025AOY,560,226,296,581,275,272,423,225,198,427,248,179,428,226,189,665,355,300
39049025BLF,835,377,422,849,455,353,693,382,311,696,429,267,700,386,297,915,528,376
39087044ACK,569,165,382,593,131,445,465,129,336,471,160,311,474,137,325,647,128,509
39087044AAH,82,19,56,86,23,59,64,20,44,64,28,36,61,21,38,78,20,57
39113057AYA,934,297,602,948,408,506,744,334,410,756,372,384,756,320,415,990,468,507
39113057AQR,747,617,103,769,679,65,554,499,55,567,520,47,562,500,51,742,658,76
39113057APL,891,339,486,907,383,459,634,299,335,643,345,298,641,284,322,993,446,515
39113057AWE,469,206,232,480,254,194,426,239,187,431,263,168,432,240,172,741,442,292
39073037AAJ,703,230,433,721,239,457,427,168,259,433,220,213,433,178,231,661,215,430
39007004ADJ,650,218,384,656,241,375,500,207,293,504,250,254,502,214,276,689,237,435
39025013AFF,518,114,376,524,150,345,389,130,259,389,141,248,391,120,254,562,212,339
39025013AGC,574,143,389,579,195,346,409,172,237,413,180,233,414,164,237,642,259,373
39007004ACB,373,108,228,382,126,239,280,106,174,281,126,155,281,101,170,398,123,270
39155078AFX,799,265,496,811,295,480,628,275,353,642,305,337,645,270,346,895,315,571
39155078AIT,657,173,450,669,187,452,511,173,338,521,203,318,517,188,308,761,199,552
39169085AAL,941,244,655,955,277,642,706,251,455,726,270,456,732,250,457,1100,328,755
39147074ACD,275,74,190,278,86,177,195,66,129,205,97,108,208,68,128,272,84,186
39165083AEK,919,116,771,952,143,756,820,138,682,831,180,651,841,145,663,1051,193,835
39025013AER,652,100,516,656,126,510,500,113,387,504,125,379,504,108,378,673,125,539
39007004AAP,207,110,81,209,115,82,147,96,51,148,100,48,149,93,49,212,108,99
39049025ANC,893,404,440,914,534,321,725,442,283,726,491,235,733,459,251,970,636,320
39049025AIL,486,273,179,503,331,163,383,252,131,378,270,108,380,254,121,516,340,171
39049025AQD,763,325,416,781,411,335,664,368,296,672,429,243,674,398,257,860,542,304
39049025AAY,725,553,131,761,636,102,508,428,80,513,458,55,515,438,63,825,687,123
39113057ASH,915,235,645,916,266,608,703,219,484,705,270,435,711,212,478,918,296,604
39113057AMC,709,219,467,709,299,370,626,289,337,630,342,288,628,306,310,800,435,348
39113057AFX,635,563,56,656,634,14,469,451,18,481,472,9,482,460,17,573,538,30
39113057AGO,425,315,92,431,353,64,318,271,47,321,279,42,322,267,48,434,368,56
39113057ACB,518,182,304,540,240,288,357,164,193,357,190,167,363,165,186,502,198,293
39133067ADG,495,119,335,525,131,365,398,132,266,402,157,245,398,126,251,634,148,471
39085043ABT,892,303,532,915,387,491,749,360,389,753,404,349,753,347,391,1036,420,603
39085043AEL,840,238,551,874,323,516,770,329,441,784,374,410,787,320,452,936,406,514
39085043ABQ,791,276,468,827,324,453,639,307,332,649,353,296,646,293,328,898,364,524
39173087AAY,884,315,532,904,420,435,700,345,355,710,411,299,715,345,343,968,464,486
39157079ADY,233,76,137,233,67,151,168,56,112,169,72,97,168,54,101,250,65,179
39157079AAI,439,132,289,441,143,273,338,139,199,346,164,182,349,143,194,488,153,324
39133067AFN,515,164,307,529,199,298,413,205,208,419,228,191,421,207,188,623,225,387
39085043ABY,794,273,486,827,339,453,646,327,319,655,362,293,661,321,317,906,397,485
39151076AMQ,631,274,320,649,305,317,505,265,240,505,289,216,510,249,241,695,326,362
39109055ABS,541,72,438,554,98,435,432,99,333,434,128,306,441,105,315,550,129,415
39093047ALM,675,217,424,690,305,360,661,330,331,682,376,306,681,319,348,1418,683,716
39093047AGO,988,328,591,1025,417,551,863,426,437,896,501,395,896,426,438,994,405,569
39099050ANR,486,106,363,497,131,349,405,124,281,413,152,261,419,130,265,525,142,380
39099050AHJ,648,304,318,660,318,323,545,294,251,548,337,211,548,308,231,705,321,377
39085043AFM,674,191,448,689,249,406,581,246,335,586,285,301,585,234,339,760,321,429
39085043ACY,539,322,192,573,388,162,409,288,121,413,304,109,416,284,116,578,376,191
39085043AGB,504,165,304,519,173,326,403,168,235,405,191,214,404,155,233,592,226,348
39149075AAU,543,93,425,553,138,391,423,117,306,428,149,279,431,125,288,605,142,449
39155078AHI,779,297,439,807,356,429,624,320,304,635,366,269,633,323,296,871,375,485
39151076AKF,430,108,290,435,120,286,321,115,206,326,143,183,328,120,195,475,119,347
39151076ANG,401,119,246,405,129,252,297,132,165,301,146,155,302,132,148,424,160,258
39155078AFT,629,239,347,647,257,343,471,233,238,482,270,212,481,227,240,683,266,406
39165083AFN,839,177,635,841,281,512,643,236,407,671,277,394,664,229,422,896,369,514
39165083AFU,790,232,529,802,335,443,609,267,342,627,298,329,627,278,341,916,434,470
39155078AHY,736,364,351,759,447,291,610,361,249,620,416,204,620,369,236,713,427,274
39157079ADS,195,64,123,199,66,123,160,64,96,161,65,96,163,62,96,185,51,129
39049025AFV,815,384,407,803,489,277,717,387,330,715,452,263,726,421,298,860,520,333
39133067AEX,699,218,435,731,226,481,595,228,367,614,266,348,611,220,358,782,236,534
39133067AFF,700,249,386,726,311,373,563,302,261,574,338,236,577,285,258,829,401,416
39133067AFD,409,162,218,440,164,254,308,144,164,317,174,143,316,142,162,513,191,318
39071036AAT,631,91,507,653,82,548,507,95,412,499,98,401,509,88,399,696,85,608
39143072AAI,430,111,277,438,146,265,342,152,190,349,182,167,350,142,195,464,154,295
39049025BDQ,910,287,600,917,418,462,863,365,498,864,442,422,872,379,480,1059,582,472
39049025BIY,594,288,273,621,347,234,462,289,173,467,309,158,468,299,159,729,456,260
39049025ARK,890,261,610,872,395,444,851,326,525,863,407,456,871,347,511,1029,538,481
39049025AOH,657,376,250,676,439,193,584,390,194,588,437,151,595,411,170,852,592,243
39049025BLT,555,319,211,568,371,163,418,283,135,420,314,106,422,300,111,534,391,130
39049025BGJ,1129,614,489,1133,732,379,1003,626,377,1012,710,302,1018,672,333,1161,775,373
39049025AVB,687,309,362,681,428,215,627,380,247,629,447,182,637,401,222,736,518,211
39049025BAP,618,247,360,610,329,261,588,306,282,588,344,244,598,321,264,696,429,257
39049025AIY,545,343,180,542,396,118,457,349,108,462,377,85,462,357,93,611,468,131
39049025ATQ,580,190,372,599,208,343,463,180,283,470,220,250,470,201,259,641,253,377
39049025ATM,681,296,349,707,326,332,451,224,227,458,260,198,459,257,192,700,353,328
39049025AWM,703,275,404,705,348,316,620,322,298,627,372,255,627,343,277,788,473,308
39049025AUX,613,452,136,636,497,120,498,400,98,500,415,85,502,386,98,663,538,122
39049025BLZ,406,296,89,418,327,79,273,230,43,278,238,40,278,230,42,381,318,60
39049025AUZ,552,209,313,570,262,278,440,210,230,444,249,195,440,214,209,614,319,272
39085043ACM,413,232,145,450,299,128,281,186,95,287,207,80,288,180,96,413,258,150
39085043AGU,554,227,299,571,247,285,459,252,207,460,280,180,466,224,223,772,332,430
39153077BBO,554,186,325,564,195,339,451,188,263,463,220,243,466,196,250,636,222,406
39153077AGU,620,313,279,636,367,252,570,340,230,575,359,216,583,326,239,716,435,275
39153077AHJ,612,362,204,633,387,221,446,310,136,462,334,128,463,309,137,602,358,237
39153077AIF,557,271,239,571,288,260,388,228,160,397,263,134,397,247,144,613,310,291
39113057AIQ,666,298,345,680,346,310,546,304,242,547,336,211,548,313,227,727,403,311
39113057AYS,938,233,687,934,323,573,816,301,515,823,346,477,826,311,497,1011,426,566
39113057AUJ,629,493,104,670,581,63,503,431,72,510,446,64,506,411,78,591,484,92
39113057AJV,547,185,339,559,228,309,402,172,230,410,211,199,411,178,220,559,248,304
39113057ATU,672,118,519,680,153,499,546,144,402,546,173,373,552,147,393,744,195,539
39113057APM,934,221,665,945,294,619,754,277,477,757,340,417,763,253,472,974,303,652
39111056ABA,224,64,152,224,60,159,191,68,123,194,84,110,186,55,127,259,60,198
39049025ARU,878,353,508,863,459,365,780,379,401,788,440,348,798,408,377,980,589,380
39049025BBD,478,103,364,486,116,341,417,124,293,419,163,256,419,145,264,537,169,363
39049025ALU,704,595,65,728,651,39,672,607,65,682,634,48,680,615,53,832,745,76
39049025AAG,805,481,305,806,575,187,760,554,206,755,603,152,764,572,175,868,675,177
39133067AAC,751,213,518,766,303,434,619,257,362,620,286,334,629,251,373,860,406,447
39133067AAN,670,200,444,685,283,370,570,265,305,572,296,276,576,265,300,800,390,397
39049025BLA,418,240,155,436,304,98,387,325,62,392,337,55,394,320,59,395,340,53
39061031AOT,735,457,239,745,538,190,549,433,116,550,443,107,558,407,135,745,583,155
39061031BHY,937,273,628,952,345,552,766,330,436,771,365,406,777,318,441,1001,442,549
39061031ANC,677,482,167,682,567,102,555,453,102,559,487,72,562,457,93,708,611,92
39049025ALM,700,517,151,732,606,104,609,505,104,612,523,89,613,502,100,733,608,114
39049025BAT,776,294,466,782,407,346,670,333,337,679,369,310,677,351,316,917,527,382
39043022AAC,640,184,424,638,241,376,577,235,342,578,274,304,583,233,332,706,290,411
39055028ACD,676,193,451,688,254,421,590,224,366,599,271,328,602,214,372,766,302,454
39017009AJX,795,190,568,806,272,490,655,236,419,675,287,388,673,241,413,845,320,502
39113057ASA,1024,260,723,1046,361,628,774,291,483,788,347,441,791,287,477,1131,418,700
39035018ASV,447,404,24,479,468,8,334,320,14,344,340,4,343,328,10,406,390,10
39035018CIV,746,327,353,794,390,347,545,327,218,564,354,210,572,305,237,832,424,398
39035018BCS,525,257,223,547,317,212,412,263,149,428,280,148,424,236,174,593,329,256
39035018AHW,411,369,21,450,436,9,323,312,11,327,319,8,333,310,16,372,350,13
39035018ALU,478,439,22,521,500,16,378,364,14,383,376,7,384,361,21,444,430,13
39035018DAN,406,86,316,399,162,218,349,158,191,351,158,193,353,136,212,431,212,215
39035018CRB,840,502,326,830,676,131,773,631,142,786,644,142,784,608,170,893,746,143
39035018CAL,732,611,87,753,665,78,563,505,58,566,518,48,566,497,60,683,602,74
39035018CSR,1033,530,487,1046,702,313,965,674,291,960,685,275,969,626,327,1217,845,354
39035018AJV,691,504,155,704,572,118,613,525,88,612,540,72,615,528,81,728,603,117
39035ZZZZZZ,0,0,0,0,0,0,0,0,0,0,0,0,0,0,0,0,0,0
39035018CTN,643,387,224,675,464,189,590,449,141,598,472,126,593,426,152,728,548,173
39035018AKA,290,266,11,314,309,4,239,227,12,243,240,3,242,229,12,282,265,12
39035018CAY,602,538,42,625,587,25,464,443,21,460,439,21,466,439,20,584,551,33
39035018BKX,680,541,117,693,610,53,657,592,65,665,609,56,665,586,68,737,676,51
39113057AQY,986,526,428,1027,629,379,823,495,328,833,553,280,831,498,307,1069,628,426
39113057ARQ,877,225,620,892,279,575,700,241,459,699,285,414,705,218,461,970,325,631
39113057ALN,660,162,462,667,241,397,561,237,324,563,266,297,564,224,324,658,242,408
39017009AEX,445,215,203,450,278,144,322,210,112,328,220,108,326,210,107,418,278,135
39105053AAV,267,98,155,285,84,181,197,74,123,203,99,104,200,65,129,277,88,184
39035018BSE,838,355,426,891,454,401,740,459,281,752,501,251,759,455,278,987,590,379
39113057AYQ,660,178,456,657,244,385,572,226,346,578,271,307,575,217,347,736,326,402
39113057AYF,826,178,618,836,266,537,734,230,504,744,281,463,740,234,488,900,350,532
39157079ABS,377,147,186,385,152,203,241,122,119,246,144,102,240,117,109,432,145,282
39085043ABG,871,276,557,895,375,482,682,313,369,688,364,324,697,319,362,966,441,511
39133067AAJ,609,186,405,618,275,329,536,254,282,538,271,267,538,225,302,682,327,349
39133067AEV,660,204,408,676,206,444,575,227,348,587,253,334,582,210,350,739,216,516
39111056AAV,424,137,263,428,97,316,336,118,218,343,137,206,330,95,224,482,90,389
39017009AFP,349,87,238,359,84,260,210,59,151,217,63,154,215,53,152,377,87,284
39043022ABV,464,133,312,475,179,265,411,182,229,414,197,217,412,177,225,562,235,320
39055028ABN,641,170,440,651,193,440,562,183,379,565,228,337,568,178,371,760,230,520
39017009ALJ,938,239,656,940,299,590,823,333,490,852,373,479,842,337,482,1197,533,655
39017009AKE,368,49,304,376,54,317,285,56,229,293,78,215,292,69,213,379,62,316
39017009AFC,599,290,291,600,370,209,523,309,214,537,347,190,525,312,201,577,368,203
39017009AHX,772,100,650,792,122,646,637,106,531,645,141,504,656,115,526,836,134,692
39017009AFO,527,83,426,527,90,417,430,106,324,434,117,317,438,102,326,565,150,405
39017009AHZ,545,97,424,555,104,436,402,93,309,413,108,305,412,89,309,586,114,463
39095048ACW,536,205,316,545,241,279,401,216,185,406,254,152,407,218,173,534,268,256
39027014AAF,427,147,268,436,177,230,336,149,187,338,170,168,336,145,176,474,205,261
39095048ACR,512,229,253,530,269,236,392,215,177,402,253,149,406,222,173,552,271,270
39095048AOY,536,250,251,555,305,215,417,274,143,421,303,118,433,281,133,618,375,234
39061031AWH,607,119,473,616,165,418,485,155,330,477,182,295,491,145,330,661,217,431
39061031AOI,636,520,86,648,584,44,494,462,32,496,469,27,497,451,38,648,588,49
39061031AAH,994,387,590,986,561,378,876,506,370,889,546,343,896,501,377,1211,749,433
39061031BDG,133,68,58,135,87,40,126,86,40,125,86,39,127,82,41,135,91,42
39061031AGQ,593,510,57,625,599,16,436,414,22,449,427,22,441,402,29,558,522,28
39061031BLK,790,378,382,811,455,335,667,394,273,673,417,256,672,388,275,866,519,339
39061031AVA,810,319,437,822,435,335,633,384,249,637,407,230,648,367,250,843,503,315
39061031ART,769,552,192,785,616,143,634,527,107,638,528,110,641,510,117,777,623,140
39061031BMA,994,405,560,1005,529,431,882,516,366,884,532,352,889,490,378,1072,658,397
39095048AKP,515,433,59,547,494,46,399,354,45,408,372,36,408,356,47,466,400,55
39037019AAG,404,75,311,402,98,290,308,90,218,312,116,196,318,90,222,426,109,308
39081041ABO,123,37,82,117,29,84,86,25,61,87,34,53,87,23,63,115,20,93
39013007AAO,362,132,205,364,129,223,301,125,176,303,143,160,304,118,176,364,128,231
39013007AAQ,325,91,212,340,116,210,304,143,161,308,153,155,307,125,175,359,124,231
39013007ABC,254,74,167,261,63,194,205,72,133,208,91,117,208,62,142,292,71,220
39081041ADD,277,101,154,284,104,170,218,103,115,220,116,104,223,95,123,289,106,177
39077039ACD,345,83,241,355,118,226,260,90,170,261,108,153,270,92,174,352,108,237
39115058AAQ,449,123,304,455,144,291,344,127,217,345,160,185,355,143,204,455,143,303
39127064AAH,296,87,184,294,89,184,189,69,120,193,84,109,195,68,120,299,86,210
39049025AVA,730,331,389,724,437,245,640,370,270,643,441,202,646,404,228,758,565,185
39049025AVT,624,247,363,632,350,256,593,326,267,599,374,225,606,351,242,677,430,237
39049025AKX,679,440,218,689,489,173,624,450,174,626,480,146,631,459,156,794,599,184
39081041ACX,930,204,675,956,184,752,768,221,547,784,270,514,778,189,560,1014,194,811
39081041ACS,205,79,107,210,71,129,163,83,80,166,91,75,163,73,87,228,73,152
39063032AAX,606,202,369,610,253,322,504,240,264,504,259,245,513,240,256,669,309,341
39103052ACF,780,231,510,784,309,454,678,306,372,702,341,361,705,290,401,974,427,534
39063032ACV,502,154,318,505,168,306,380,163,217,380,193,187,386,157,213,536,196,327
39109055AAG,633,149,451,640,220,381,470,156,314,472,185,287,475,148,304,737,216,509
39109055ABA,457,92,346,454,119,311,319,93,226,323,121,202,326,90,222,510,139,367
39099050AQX,751,399,316,764,456,281,590,390,200,594,452,142,595,399,185,784,470,304
39081041ABV,360,153,183,374,155,206,290,143,147,295,162,133,295,139,147,378,159,215
39081041ADP,368,137,211,372,122,239,296,144,152,300,164,136,301,130,155,383,118,256
39073037AAZ,670,211,425,668,180,454,515,198,317,519,247,272,531,197,309,741,185,542
39165083AGP,451,54,369,455,61,380,384,64,320,389,69,320,393,63,320,528,75,440
39077039ABG,692,164,493,692,196,467,526,190,336,528,224,304,531,179,332,743,229,503
39109055ADC,770,177,554,778,269,480,586,219,367,602,268,334,604,207,375,784,289,484
39063032ACA,829,130,686,844,184,621,690,153,537,689,203,486,698,155,533,955,255,691
39077039AAM,566,175,351,575,194,338,399,164,235,400,191,209,401,154,222,592,203,377
39121061AAN,201,50,143,207,57,143,153,58,95,155,74,81,156,62,88,225,44,179
39049025AEV,550,390,128,571,438,102,435,349,86,436,372,64,441,350,79,629,498,120
39049025AJF,496,349,125,517,388,98,376,295,81,381,314,67,382,296,76,506,393,107
39049025AJZ,603,505,70,637,579,45,437,395,42,449,424,25,444,395,35,613,559,47
39049025ADZ,898,546,308,894,649,193,848,608,240,861,685,176,860,630,203,950,754,178
39049025BJI,506,310,167,513,346,142,456,337,119,461,363,98,462,339,118,571,401,163
39049025AFH,593,538,40,605,579,20,460,437,23,467,456,11,464,441,19,575,543,29
39103052AEO,588,136,413,598,168,405,471,168,303,482,199,283,486,160,310,694,204,479
39049025BGL,804,530,238,807,572,208,633,479,154,641,507,134,642,487,138,940,700,228
39077039ACQ,433,125,268,435,147,258,330,149,181,334,167,167,336,140,183,469,170,290
39035018CJF,755,231,495,770,296,451,625,291,334,640,322,318,644,271,363,806,332,471
39035018ATT,325,297,12,341,327,12,239,223,16,237,227,10,242,227,11,279,264,15
39035018BJI,577,332,216,591,376,188,476,349,127,480,356,124,481,335,132,652,433,214
39035018DAA,811,288,501,801,439,329,749,408,341,747,417,330,758,390,358,931,550,380
39035018BOU,629,469,131,651,533,100,546,457,89,546,484,62,548,446,92,687,567,111
39009005AAM,401,211,173,474,278,167,215,149,66,225,160,65,223,145,66,211,160,50
39035018AXP,263,190,49,285,231,49,156,123,33,157,125,32,158,117,36,264,189,69
39035018BYR,765,343,392,791,454,309,692,421,271,699,450,249,698,395,287,858,522,327
39035018CJP,704,266,383,738,323,386,598,306,292,606,335,271,609,288,302,833,362,458
39035018CFL,195,46,146,199,63,130,157,65,92,160,71,89,159,57,100,214,80,133
39035018AAL,780,328,415,800,438,328,669,407,262,681,443,238,685,414,253,879,543,327
39053027AAQ,554,130,408,559,89,458,396,77,319,403,124,279,407,82,317,571,105,460
39035018ALS,265,238,13,306,297,5,169,161,8,175,171,4,177,163,11,218,207,7
39035018CYL,660,228,400,668,319,323,578,317,261,580,336,244,584,309,265,767,423,339
39035018CGP,542,203,305,562,265,265,449,234,215,461,268,193,464,227,228,571,291,276
39035018BEF,357,257,76,377,317,44,284,251,33,289,258,31,288,239,34,404,314,88
39035018BJF,667,316,301,695,407,250,594,389,205,596,411,185,605,360,230,797,472,313
39035018CMT,754,350,357,810,434,355,637,381,256,646,402,244,657,363,264,859,466,387
39035018CDN,729,310,378,764,396,321,611,350,261,626,382,244,630,342,273,829,458,363
39035018CSA,688,357,323,693,497,178,620,452,168,628,466,162,626,432,190,716,548,163
39035018CCI,398,170,200,406,216,184,305,171,134,307,195,112,310,168,133,417,210,197
39035018BOA,423,410,7,461,453,6,312,308,4,317,316,1,316,306,6,349,337,10
39045023AAN,525,186,305,535,224,275,404,168,236,414,208,206,416,177,226,579,242,328
39045023ABJ,657,206,413,659,236,378,541,226,315,545,289,256,557,245,302,696,327,359
39045023ADY,672,230,433,673,274,363,548,245,303,556,297,259,560,255,292,728,375,348
39045023AEJ,677,348,301,685,405,240,560,343,217,570,377,193,575,356,206,815,515,280
39045023AEZ,667,387,250,675,448,196,533,384,149,544,408,136,551,390,149,776,547,223
39045023ACQ,695,158,516,694,182,488,556,149,407,560,200,360,562,168,380,744,216,516
39035018DCK,616,162,416,649,212,411,497,227,270,509,256,253,504,202,284,693,237,447
39035018AAD,859,365,458,864,477,344,772,466,306,780,506,274,785,464,303,972,596,363
39035018BJS,666,492,144,692,606,65,461,412,49,464,416,48,465,403,53,553,502,50
39035018BSR,517,479,20,541,528,9,409,400,9,412,402,10,418,398,9,445,426,17
39035018CHL,633,267,320,676,325,316,499,286,213,509,309,200,509,269,212,745,379,355
39035018CZA,917,353,519,940,475,432,705,390,315,715,424,291,721,368,334,980,527,442
39035018CZP,890,291,564,890,405,454,825,415,410,827,447,380,838,396,429,987,520,459
39035018CGS,855,311,507,887,428,431,769,381,388,772,428,344,775,367,398,1040,525,506
39035018CQN,721,570,118,733,649,63,658,591,67,665,601,64,662,577,74,800,717,73
39035018CNE,767,354,391,771,496,254,708,485,223,707,491,216,713,463,242,844,576,265
39035018AOJ,339,304,21,392,379,9,186,179,7,189,187,2,186,177,7,267,246,18
39091046ABA,909,162,702,904,221,636,664,193,471,667,256,411,666,201,449,956,246,692
39035018BRC,742,566,146,763,631,111,562,472,90,565,490,75,569,460,93,754,648,98
39035018BVR,675,359,284,696,464,199,584,419,165,597,450,147,602,424,169,778,548,221
39035018BRN,599,237,331,613,332,246,565,342,223,569,362,207,575,331,230,700,420,273
39035018AVM,302,272,18,318,308,6,211,200,11,213,206,7,215,204,8,241,226,13
39035018AJT,200,186,9,213,210,3,124,122,2,128,124,4,127,121,3,134,130,2
39035018AOL,300,270,12,334,324,3,195,188,7,198,194,4,198,183,4,272,267,3
39035018CGI,860,222,612,902,290,584,694,270,424,699,297,402,705,263,421,970,346,615
39035018CBX,804,315,443,862,409,408,660,381,279,660,400,260,668,365,281,973,492,469
39035018BTT,716,406,259,756,476,253,544,400,144,544,419,125,549,381,153,784,535,243
39035018AQW,299,261,24,322,310,7,226,218,8,228,225,3,235,227,6,270,258,9
39035018BUP,680,223,440,681,313,352,580,295,285,580,313,267,587,276,305,797,390,403
39035018BFD,493,358,85,522,435,69,303,248,55,308,259,49,310,244,56,477,374,98
39117059AAN,328,54,256,333,61,260,281,58,223,286,87,199,285,65,213,376,83,290
39035018ATZ,395,356,25,422,409,9,273,260,13,276,271,5,274,264,7,325,314,10
39045023ADZ,614,191,403,628,277,313,514,226,288,522,265,257,527,241,281,673,321,341
39043022AAA,773,236,504,772,299,436,631,269,362,625,295,330,631,270,344,826,340,472
39045023ACP,596,132,449,606,148,439,501,134,367,506,168,338,508,149,348,644,164,472
39005003ACN,447,80,339,456,93,342,325,92,233,327,108,219,324,87,225,517,89,417
39005003ABB,321,100,184,331,105,201,214,91,123,219,103,116,218,97,112,352,119,224
39117059ABD,483,85,376,486,86,380,412,75,337,416,94,322,420,85,324,585,99,479
39045023ACR,695,201,458,704,240,423,514,158,356,519,228,291,525,176,324,767,223,520
39045023ACB,874,200,635,884,202,638,722,203,519,737,266,471,747,209,508,985,222,754
39117059AAC,812,177,592,818,199,575,630,195,435,630,229,401,635,199,415,926,236,673
39061031BKC,1013,150,828,1027,195,795,827,187,640,827,216,611,835,173,630,1152,243,885
39061031BAX,764,295,445,793,345,420,629,326,303,631,343,288,634,303,308,844,417,411
39061031AGF,1010,402,580,1004,583,383,899,500,399,899,549,350,910,507,379,1141,730,397
39061031AYX,721,164,532,722,255,408,581,246,335,582,268,314,585,231,329,777,346,419
39061031BMG,539,329,193,548,378,152,473,339,134,474,346,128,478,331,139,567,400,160
39057029ACD,945,223,686,940,300,594,794,265,529,794,303,491,799,258,511,1028,383,611
39057029AJA,1009,170,826,997,256,700,961,257,704,968,302,666,971,250,697,1500,522,946
39057029ACV,465,108,338,470,142,303,432,142,290,439,192,247,439,134,295,524,174,340
39157079ABA,415,149,238,411,141,252,283,118,165,290,144,146,289,117,154,434,153,271
39057029AIE,968,201,746,989,295,638,848,279,569,849,329,520,854,257,572,1153,414,723
39057029AGS,1025,201,795,1034,283,704,919,282,637,928,346,582,936,277,635,1275,444,811
39083042AAH,787,223,512,780,274,462,609,236,373,626,295,331,615,243,357,866,304,546
39083042ABA,469,80,377,468,91,353,396,83,313,399,114,285,401,97,295,551,105,440
39057029AAR,463,111,342,471,155,298,431,160,271,431,170,261,441,148,280,505,196,304
39057029AAE,492,135,339,505,182,291,428,160,268,439,182,257,438,147,269,579,206,358
39117059AAT,299,75,199,306,72,203,218,68,150,222,91,131,223,66,141,323,91,224
39061031BFN,958,315,623,953,425,494,860,411,449,866,440,426,868,397,454,985,480,494
39025013AFC,564,126,408,575,162,382,431,134,297,435,149,286,432,122,292,623,206,408
39025013ACM,511,101,391,520,145,349,460,152,308,458,171,287,460,157,293,553,189,348
39025013ADT,455,81,355,463,112,330,366,117,249,366,135,231,365,103,244,465,137,324
39025013AEY,788,122,631,784,219,525,655,195,460,665,222,443,664,197,444,878,286,580
39007004AEC,395,141,231,394,149,233,326,133,193,326,149,177,329,131,185,415,146,257
39025013AEW,561,102,424,576,138,411,406,107,299,410,135,275,412,107,287,596,151,439
39025013AHM,557,192,335,554,259,266,461,224,237,460,238,222,465,220,220,604,298,298
39025013AGQ,374,66,284,374,64,299,287,71,216,285,76,209,289,73,201,408,82,319
39025013AGJ,703,149,528,713,244,436,628,245,383,632,269,363,639,235,385,837,320,497
39025013ADF,713,112,561,728,181,511,582,164,418,581,182,399,580,175,392,791,199,581
39117059AAJ,646,111,504,639,120,498,540,103,437,539,139,400,549,107,425,692,104,579
39003002AFN,556,99,442,572,130,418,464,109,355,463,139,324,469,116,342,573,145,422
39003002AEZ,607,72,515,609,89,491,502,97,405,504,150,354,503,97,388,641,107,526
39003002ABX,456,256,170,474,306,148,286,191,95,299,227,72,294,185,100,407,247,150
39003002AEN,799,84,679,813,103,679,643,89,554,651,136,515,650,85,549,862,117,739
39021011ABD,616,85,503,621,95,503,525,100,425,529,147,382,536,106,411,625,85,534
39113057AMK,701,189,485,698,279,391,624,250,374,628,311,317,632,250,363,728,320,401
39137069AAO,685,94,571,695,111,552,554,119,435,557,167,390,565,107,442,733,109,619
39161081AAA,191,38,145,189,49,133,142,40,102,142,49,93,142,33,102,234,61,171
39161081AAC,257,42,200,264,49,202,196,42,154,200,62,138,199,43,152,321,49,262
39145073AAJ,216,159,46,222,164,48,130,106,24,130,114,16,132,107,19,165,123,40
39145073ACW,322,146,155,327,147,166,240,134,106,247,153,94,248,139,107,331,144,182
39145073AAC,467,198,257,455,202,237,387,188,199,391,235,156,396,197,189,472,222,245
39145073AAP,263,147,103,264,140,108,169,97,72,171,113,58,172,91,70,223,122,95
39145073ACL,490,143,332,495,112,370,373,117,256,379,155,224,382,130,243,505,103,399
39155078AAU,661,262,369,682,318,345,531,261,270,538,308,230,540,275,249,702,305,387
39155078AAQ,450,162,264,456,182,259,371,173,198,378,206,172,378,186,185,490,193,292
39155078ABN,468,234,207,494,263,209,406,249,157,409,280,129,410,260,141,531,293,231
39147074ABU,316,66,240,323,86,212,262,80,182,265,108,157,275,76,189,346,107,234
39165083ADU,620,121,461,644,163,456,511,154,357,532,184,348,522,145,354,980,270,688
39155078AHT,465,122,316,476,133,322,367,126,241,365,152,213,367,120,229,474,128,336
39113057AQK,667,569,85,686,647,29,537,492,45,547,524,23,543,494,43,618,589,27
39113057ABV,377,164,200,386,179,193,262,119,143,268,143,125,268,119,146,426,200,221
39173087ABH,932,258,659,917,361,513,788,315,473,793,385,408,803,312,482,1037,495,524
39017009AFF,589,306,260,571,351,193,483,331,152,487,352,135,487,327,154,594,402,184
39017009AIY,632,227,375,656,281,344,500,239,261,511,258,253,507,229,265,693,340,339
39113057AMF,591,193,375,595,245,313,502,229,273,506,272,234,510,219,268,674,354,312
39113057AOW,973,340,612,969,472,440,834,424,410,844,501,343,853,435,395,1005,575,418
39113057AMO,649,168,463,632,241,358,557,224,333,568,268,300,569,230,325,660,310,343
39113057AIP,930,359,528,929,427,462,725,359,366,740,424,316,737,352,359,1017,506,499
39113057ACM,401,287,92,419,346,61,301,249,52,307,271,36,309,250,52,378,319,51
39165083ADX,601,86,490,615,134,438,548,123,425,571,154,417,567,129,424,798,190,599
39165083AGK,808,156,616,818,220,562,690,207,483,702,246,456,700,195,494,959,336,599
39165083ABL,678,80,562,702,140,536,583,129,454,598,145,453,594,129,451,801,198,593
39165083ABJ,736,136,581,735,214,481,634,199,435,644,244,400,646,202,424,847,307,521
39165083AFM,485,186,274,506,263,222,332,195,137,335,200,135,337,186,136,499,285,202
39165083AGZ,661,200,448,672,301,351,584,311,273,598,335,263,592,300,282,972,524,435
39165083AAH,769,145,563,800,193,589,618,164,454,627,192,435,626,171,442,859,197,657
39109055ACU,460,63,373,464,77,373,350,65,285,360,92,268,362,64,284,494,81,408
39099050APH,408,83,305,416,87,321,331,91,240,334,117,217,334,91,234,461,92,363
39099050ABC,639,205,417,644,226,393,562,226,336,565,275,290,567,246,315,683,263,410
39093047AAK,649,225,386,661,282,346,575,290,285,594,344,250,606,312,278,910,423,469
39093047AAG,591,195,369,595,236,341,460,232,228,475,254,221,477,230,234,630,265,353
39093047AGQ,460,145,290,472,211,244,460,230,230,478,262,216,480,221,245,1046,504,532
39099050APK,566,127,409,579,151,413,468,150,318,468,194,274,477,168,291,635,167,463
39105053AAT,272,103,159,285,98,174,202,69,133,208,96,112,216,81,133,317,87,223
39017009AHF,801,133,630,816,174,615,614,148,466,624,160,464,628,141,469,908,195,704
39049025BMH,459,313,127,470,371,69,478,383,95,483,414,69,482,396,75,574,485,78
39049025ADD,736,501,204,749,591,109,492,416,76,492,438,54,493,408,63,586,502,76
39049025APU,614,274,322,600,326,236,585,313,272,586,372,214,590,348,231,671,411,247
39049025BKM,332,120,203,337,167,156,270,147,123,274,170,104,277,154,118,384,214,170
39113057AQT,536,303,218,546,371,164,437,297,140,445,335,110,440,286,145,489,338,144
39113057AWY,610,226,351,628,285,310,503,260,243,512,289,223,512,255,247,685,339,338
39113057API,532,213,282,536,235,251,363,203,160,365,207,158,366,199,153,582,312,260
39113057ACE,1029,350,645,1029,435,553,815,374,441,820,412,408,820,362,428,1068,524,531
39113057AHW,385,336,35,394,364,21,255,238,17,264,253,11,266,240,19,352,330,18
39113057AGJ,871,742,88,891,851,27,690,659,31,702,687,15,706,664,25,835,789,36
39113057AEC,861,313,496,867,427,398,683,363,320,692,422,270,691,350,315,946,469,458
39031016AAY,1062,180,848,1072,237,799,854,226,628,860,303,557,870,209,637,1114,242,856
39023012AAL,361,111,215,365,141,204,254,108,146,260,137,123,260,112,134,332,92,232
39023012AFM,754,145,574,762,194,533,607,157,450,604,197,407,614,173,419,846,170,663
39041021AFK,786,245,509,788,339,402,788,333,455,789,402,387,799,355,427,978,485,478
39107054AAL,525,44,461,527,51,469,421,49,372,417,72,345,426,47,369,544,54,489
39107054AAD,633,128,484,644,169,456,495,131,364,495,178,317,497,133,353,732,211,513
39003002ACW,579,81,484,590,100,469,478,101,377,479,144,335,479,91,374,626,118,500
39107054ABF,375,55,298,380,63,308,301,64,237,305,90,215,307,63,235,433,95,332
39049025BGD,402,177,208,413,208,176,340,205,135,339,228,111,345,215,123,454,284,163
39155078ACW,421,284,115,424,307,101,256,195,61,258,203,55,255,186,56,351,243,99
39089045AAW,1084,329,704,1106,407,645,848,330,518,868,415,453,864,337,503,1196,478,702
39141071ABM,580,134,433,592,149,420,473,143,330,470,178,292,476,142,324,693,186,498
39165083AFO,602,132,447,604,197,382,459,160,299,482,196,286,478,171,296,651,245,396
39165083ABP,446,54,379,455,112,324,390,101,289,399,118,281,395,92,290,483,142,338
39003002ADY,489,88,390,503,92,389,420,104,316,426,135,291,424,101,312,542,117,422
39003002ADU,182,18,152,189,22,162,134,28,106,134,34,100,134,21,111,199,23,171
39165083AGG,615,139,452,630,185,416,483,167,316,494,187,307,499,171,310,670,235,421
39165083ADW,730,90,614,720,144,541,580,106,474,599,129,470,602,112,481,800,189,605
39155078AHV,440,119,301,439,115,304,364,110,254,371,141,230,370,116,243,511,139,363
39029015ABA,292,96,178,303,113,173,181,80,101,187,87,100,183,76,101,296,93,195
39025013AHT,623,162,441,620,251,330,548,230,318,546,254,292,551,229,311,721,328,384
39025013ABV,528,133,367,536,185,325,441,159,282,447,178,269,446,158,273,578,219,348
39041021ACJ,607,131,449,619,161,420,579,164,415,579,195,384,587,184,390,740,233,493
39041021ABK,693,179,489,702,207,455,673,191,482,665,249,416,678,206,457,944,324,602
39041021ACT,784,269,489,786,364,370,782,353,429,776,404,372,789,381,392,1068,561,486
39023012ABI,783,291,470,782,381,363,676,353,323,687,424,263,690,352,320,837,463,362
39023012ABH,554,216,314,559,301,232,479,260,219,482,307,175,486,258,216,587,357,223
39007004AAM,208,107,89,207,128,67,159,99,60,158,111,47,159,96,53,216,107,100
39025013ACU,656,156,467,660,198,423,469,182,287,470,194,276,478,167,286,677,220,449
39001001AAR,279,62,203,285,71,206,210,64,146,212,78,134,221,57,154,296,60,232
39089045ADV,666,150,494,671,158,489,606,172,434,614,219,395,620,185,424,830,210,617
39049025APM,562,255,275,555,295,213,415,233,182,416,267,149,422,247,155,614,375,222
39049025AAI,589,314,265,592,416,148,541,371,170,541,402,139,541,381,154,650,499,148
39049025AZB,334,266,53,363,307,45,223,206,17,226,214,12,227,211,15,373,326,39
39153077AEU,614,278,292,646,309,296,476,270,206,484,287,197,480,269,191,704,365,335
39153077AXH,718,236,456,737,331,371,634,279,355,643,302,341,646,277,357,941,482,447
39153077AXA,640,242,388,642,324,291,584,315,269,604,352,252,594,305,280,723,416,298
39153077ANH,596,227,336,634,312,304,543,289,254,566,335,231,559,297,248,702,369,324
39153077AII,374,277,68,385,314,60,272,213,59,274,230,44,271,210,47,334,246,81
39141071AAN,261,116,128,272,141,115,186,98,88,190,108,82,185,90,89,247,123,114
39141071AAC,575,171,389,569,222,320,488,195,293,489,233,256,491,191,288,639,279,348
39153077AKW,639,279,327,657,349,275,573,344,229,583,380,203,580,338,225,706,430,271
39153077BBR,507,170,305,514,210,286,433,208,225,454,234,220,454,212,220,555,238,307
39153077ANU,477,162,293,494,199,281,411,186,225,427,209,218,419,194,217,541,232,303
39153077AKP,548,253,247,578,318,230,440,274,166,455,297,158,453,272,159,609,352,249
39093047AAH,712,272,392,731,335,347,569,313,256,581,362,219,592,317,248,841,376,445
39099050ASW,803,333,441,816,365,441,665,308,357,672,368,304,676,347,314,847,366,474
39007004ABY,368,132,221,372,160,189,313,157,156,324,187,137,326,164,153,408,195,207
39007004ABT,295,130,147,291,125,144,232,114,118,237,142,95,239,117,107,332,143,182
39089045AEX,1107,285,781,1110,348,712,949,307,642,968,378,590,970,329,625,1496,577,905
39131066AAA,375,144,224,377,152,207,269,108,161,275,138,137,278,120,157,382,119,257
39087044ACF,349,104,232,361,94,256,310,99,211,319,125,194,316,101,210,409,123,281
39087044ACU,125,35,81,126,33,89,91,27,64,94,31,63,89,25,60,143,39,100
39151076AGY,944,211,706,945,301,613,780,255,525,790,310,480,792,255,521,1098,386,702
39151076AOX,598,149,431,608,207,372,724,264,460,730,285,445,734,256,463,1021,369,642
39151076AKG,683,152,500,697,197,475,548,177,371,560,218,342,556,183,360,792,213,576
39151076AJL,609,121,451,637,163,453,539,175,364,535,185,350,548,160,376,704,169,524
39049025AND,990,356,607,1005,518,437,943,502,441,941,573,368,950,526,409,1154,700,442
39049025ASG,601,237,337,606,300,260,527,273,254,529,314,215,538,278,245,636,366,261
39049025AOU,949,526,380,956,597,307,779,530,249,782,560,222,786,531,237,964,689,258
39153077AEJ,668,276,347,699,295,371,509,256,253,524,284,240,524,251,256,777,351,416
39093047AFO,519,292,192,536,311,196,383,272,111,396,291,105,399,272,113,529,319,194
39153077BAR,703,239,433,721,306,398,607,286,321,621,316,305,623,295,310,800,370,421
39153077BCR,653,224,373,687,258,409,555,246,309,570,275,295,574,237,324,751,308,440
39153077AVX,795,273,500,820,369,437,718,352,366,721,392,329,725,346,365,1025,522,494
39153077ARR,810,230,546,824,317,473,696,300,396,716,347,369,715,292,406,937,403,521
39151076AFF,937,253,652,925,345,547,846,328,518,852,375,477,859,321,523,1061,432,619
39151076AFX,1032,375,602,1035,395,583,756,360,396,764,412,352,767,365,379,1061,372,667
39145073ADX,382,105,264,384,100,271,274,108,166,279,132,147,280,109,166,403,97,304
39175088AAG,425,106,287,437,124,275,349,120,229,356,151,205,353,109,227,496,142,337
39089045ACW,760,300,432,751,385,323,707,351,356,725,419,306,719,378,330,842,466,360
39049025ATS,788,318,431,791,384,374,681,368,313,682,420,262,691,384,289,939,516,404
39049025APV,695,284,380,685,369,270,651,368,283,652,425,227,662,383,265,761,467,281
39049025AZL,501,167,315,521,173,318,391,148,243,396,171,225,398,155,235,516,183,324
39049025AGI,996,520,405,1009,613,330,860,543,317,870,611,259,872,552,278,1088,725,343
39049025AZT,780,207,554,776,304,444,787,339,448,792,380,412,798,349,436,1013,479,523
39049025APX,830,390,411,828,484,306,732,405,327,739,474,265,740,442,284,856,552,290
39049025ARZ,440,180,220,442,204,203,342,182,160,343,211,132,349,186,154,513,302,199
39049025AIE,676,410,243,710,528,137,511,427,84,514,440,74,519,426,77,456,377,69
39049025AII,882,502,349,912,610,244,606,495,111,608,502,106,611,487,102,508,387,109
39049025BBQ,389,221,161,380,273,87,387,264,123,388,297,91,391,270,114,439,343,93
39049025AFI,602,542,34,624,598,18,454,428,26,463,448,15,466,443,16,556,523,25
39049025ACX,394,348,28,414,391,16,296,274,22,302,293,9,299,275,13,361,336,23
39049025AWD,508,159,340,487,244,223,472,201,271,470,250,220,475,216,247,521,290,228
39049025ATZ,634,260,343,644,309,304,502,247,255,503,296,207,507,275,218,696,369,313
39049025AON,718,319,369,719,398,274,655,379,276,658,412,246,663,392,251,797,480,303
39049025BHQ,1010,465,507,1039,600,378,915,565,350,918,623,295,927,586,317,1214,767,427
39049025BEQ,627,323,288,639,421,184,580,378,202,588,405,183,591,382,192,925,615,297
39049025ACB,703,463,178,768,583,147,475,373,102,480,398,82,481,370,79,657,469,174
39049025AVQ,743,300,430,748,396,324,693,341,352,695,418,277,704,380,317,815,487,311
39073037AAE,721,221,459,728,219,473,490,190,300,500,229,271,501,197,278,739,202,518
39001001AAE,245,69,169,257,76,176,161,54,107,167,69,98,170,60,108,286,54,230
39023012ACV,543,411,111,558,475,72,453,391,62,459,411,48,456,376,65,592,491,94
39041021ADT,375,93,265,381,116,248,347,98,249,346,139,207,348,117,224,434,139,287
39151076AJW,655,204,415,669,222,422,514,217,297,522,255,267,523,225,285,691,227,452
39145073ACI,421,149,260,421,115,290,313,114,199,312,142,170,318,122,192,451,117,329
39145073ADJ,293,97,193,293,85,196,221,77,144,223,99,124,233,79,147,336,96,237
39161081AAP,326,101,180,343,96,236,262,81,181,271,100,171,269,83,175,348,104,235
39161081AAI,224,43,174,231,38,185,151,23,128,151,35,116,151,23,124,230,39,187
39011006AAV,1043,112,909,1036,171,827,870,179,691,868,247,621,875,177,683,1188,217,960
39161081AAF,254,74,159,258,67,170,156,60,96,157,64,93,157,51,98,267,77,184
39153077ALV,600,242,325,620,294,302,489,259,230,499,287,212,495,250,228,659,319,334
39125063AAP,409,106,282,417,96,308,318,84,234,326,100,226,326,94,222,423,102,313
39153077AUU,757,276,457,776,381,368,684,373,311,699,400,299,699,364,314,872,442,424
39153077BCW,614,192,391,630,248,347,535,260,275,545,286,259,545,241,299,702,319,377
39153077AXO,702,198,482,692,302,362,589,265,324,602,299,303,599,254,339,744,398,337
39051026ABJ,343,102,215,355,111,209,265,105,160,268,122,146,267,93,155,706,225,462
39153077AJH,649,249,355,660,289,340,505,269,236,520,318,202,517,270,233,670,308,349
39153077ACV,616,541,51,645,588,45,468,434,34,481,456,25,470,433,31,629,570,54
39153077ARY,709,360,309,723,413,280,628,389,239,638,410,228,630,382,232,807,474,320
39153077AER,620,286,298,651,329,292,481,279,202,486,295,191,487,287,191,718,367,339
39043022AEF,673,345,291,689,380,269,491,311,180,500,338,162,495,293,182,699,419,265
39087044ABI,272,85,171,275,78,182,214,73,141,205,85,120,217,77,137,296,87,207
39087044ACL,203,59,129,214,38,172,152,38,114,155,52,103,161,40,120,215,28,186
39055028ACL,597,131,430,596,156,397,470,149,321,477,179,298,472,136,316,634,166,457
39133067ACQ,646,142,454,658,167,452,531,168,363,541,207,334,540,169,332,711,168,525
39085043AIQ,804,239,526,842,318,471,703,323,380,714,364,350,715,308,383,970,409,545
39085043AGR,562,189,353,576,208,339,457,205,252,462,229,233,466,192,262,616,230,380
39085043AGQ,710,244,431,740,309,381,483,236,247,491,261,230,487,216,252,834,363,452
39123062ACW,470,147,298,485,192,257,404,186,218,414,235,179,411,183,216,524,210,300
39153077AZO,576,322,201,591,362,198,437,312,125,444,332,112,443,302,124,565,375,177
39153077ACY,619,416,175,643,485,135,534,434,100,548,457,91,544,433,104,702,542,149
39153077BAF,544,199,310,560,237,297,415,220,195,424,247,177,425,229,179,606,248,343
39153077AGT,812,420,365,823,516,281,702,472,230,718,512,206,713,479,221,882,614,259
39153077BCF,695,325,339,726,421,280,568,356,212,583,395,188,577,351,217,754,461,283
39153077ADP,279,166,94,296,189,95,173,121,52,178,129,49,177,123,51,233,140,87
39153077BCA,520,231,263,525,263,227,509,300,209,526,336,190,521,296,204,723,381,338
39051026ABH,647,183,432,656,209,395,529,198,331,537,253,284,545,217,299,360,128,226
39065033AAZ,724,213,467,740,250,450,509,201,308,513,237,276,515,189,302,814,260,525
39123062ABB,451,91,340,461,133,304,385,122,263,387,155,232,389,127,254,488,167,318
39149075AAA,806,120,653,808,173,599,658,164,494,656,219,437,660,178,463,860,191,653
39133067ADQ,507,264,217,523,329,163,456,294,162,460,336,124,466,309,140,620,396,210
39151076AGE,841,291,498,854,320,496,652,289,363,666,335,331,667,290,338,867,329,525
39157079ABF,328,130,176,330,129,183,225,113,112,229,134,95,230,109,108,349,146,196
39099050AON,918,320,566,934,338,573,809,327,482,815,391,424,820,361,444,1118,426,683
39029015AAK,442,143,270,453,140,302,354,126,228,358,136,222,353,127,220,501,155,341
39029015ADL,595,170,399,614,187,413,470,167,303,484,199,285,477,165,304,657,213,435
39099050AHV,636,266,344,652,304,335,524,278,246,531,319,212,540,294,230,723,328,389
39149075AAH,487,85,363,501,114,353,312,88,224,317,108,209,310,87,207,505,121,367
39043022AEJ,494,262,191,514,295,185,395,278,117,393,296,97,392,258,114,510,291,208
39055028ABF,596,166,408,616,237,356,518,217,301,534,256,278,531,211,306,710,286,422
39041021AGA,483,121,342,473,195,253,457,192,265,458,227,231,462,206,250,610,312,289
39017009AFZ,916,272,610,933,364,542,809,343,466,826,379,447,828,342,471,1081,456,614
39017009AEQ,542,240,270,557,284,244,412,241,171,424,263,161,426,232,182,597,296,290
39017009AIQ,610,170,408,616,230,352,463,207,256,477,222,255,480,204,262,631,287,340
39085043AGE,714,215,442,739,258,456,613,255,358,619,296,323,618,244,352,824,311,508
39085043AGA,746,230,468,772,316,431,618,269,349,622,312,310,627,268,334,827,329,488
39055028ACQ,100,28,71,97,41,52,93,47,46,92,44,48,92,40,51,112,49,60
39041021ACR,644,137,492,644,214,409,582,196,386,587,218,369,591,198,379,733,286,443
39023012AAS,541,190,317,547,230,289,375,179,196,385,237,148,381,180,186,551,246,296
39023012AGA,462,114,332,477,157,309,377,125,252,382,168,214,385,118,251,516,153,355
39029015AET,500,141,323,526,136,369,403,133,270,417,170,247,409,144,253,565,153,409
39029015ACV,552,149,376,561,177,359,451,165,286,455,201,254,458,168,281,654,210,433
39099050ANP,546,135,387,560,150,393,449,135,314,448,175,273,452,147,295,614,163,444
39023012AAP,715,322,348,721,378,305,497,274,223,505,328,177,502,275,193,733,366,349
39023012AEN,484,121,340,491,142,324,399,140,259,402,191,211,405,140,246,514,170,339
39041021AER,670,200,457,674,282,358,787,354,433,791,396,395,797,367,416,1041,537,495
39133067AAZ,597,346,200,624,400,180,451,334,117,454,351,103,458,332,113,593,410,173
39133067AEU,386,115,251,400,124,261,302,123,179,302,136,166,302,118,174,457,136,316
39133067AAB,733,206,493,757,315,403,617,278,339,626,313,313,626,266,343,876,390,476
39023012AFL,815,148,610,819,195,589,618,158,460,626,232,394,623,142,446,867,187,667
39049025AXG,702,249,429,695,338,317,620,306,314,627,358,269,633,317,301,788,444,331
39099050AQD,345,192,123,356,195,147,250,153,97,259,180,79,256,156,96,388,187,195
39017009AKT,524,120,372,547,162,367,396,126,270,405,148,257,402,114,269,563,193,356
39017009ADI,482,125,328,491,157,314,349,136,213,354,144,210,355,126,216,533,174,345
39017009ADK,547,140,391,555,175,362,462,141,321,475,174,301,473,143,317,588,194,389
39039020ABG,600,152,409,619,164,422,461,149,312,464,183,281,465,140,309,627,179,443
39039020ABB,364,110,223,375,114,234,282,103,179,282,113,169,290,102,174,426,133,281
39153077ALH,616,288,285,635,329,264,534,325,209,537,347,190,537,314,201,709,417,280
39153077AXQ,673,231,415,697,301,364,615,283,332,627,327,300,624,285,325,778,397,372
39153077AWV,676,214,423,699,291,376,645,298,347,662,331,331,663,290,349,899,357,532
39153077ANA,624,299,301,633,348,262,596,342,254,609,372,237,601,332,262,734,435,293
39173087AEB,540,320,177,552,350,145,398,308,90,400,320,80,403,295,86,513,380,127
39153077AHB,596,279,292,616,361,233,524,330,194,542,361,181,538,329,191,661,435,222
39153077BAO,572,254,269,586,287,262,438,252,186,451,277,174,450,245,188,632,335,281
39153077AFQ,467,289,141,473,305,140,341,233,108,347,238,109,345,232,102,463,286,161
39153077AWU,672,212,420,710,280,402,541,257,284,554,292,262,553,257,287,766,340,411
39017009ABX,516,140,346,528,173,325,371,156,215,381,166,215,384,149,217,609,226,375
39017009ALD,308,78,219,317,99,207,247,90,157,257,100,157,256,87,166,341,128,210
39137069AAU,939,136,780,930,185,704,760,169,591,765,284,481,779,175,587,1064,249,795
39153077AMU,728,299,401,741,379,338,637,347,290,653,377,276,648,342,303,824,450,371
39153077AMY,680,372,273,697,422,236,580,386,194,593,414,179,589,380,182,768,495,262
39153077AJD,489,209,226,509,223,258,366,184,182,375,206,169,368,183,169,582,236,335
39153077BBM,639,215,375,662,259,379,517,239,278,539,276,263,534,240,278,751,279,464
39099050AKE,508,273,204,514,294,202,386,223,163,400,268,132,397,241,143,548,301,237
39071036ABN,622,153,440,627,163,441,463,140,323,461,156,305,467,115,339,737,157,576
39061031ALH,751,443,273,769,539,203,583,405,178,588,431,157,589,389,177,772,532,220
39061031BMI,651,402,214,661,464,173,515,377,138,522,390,132,513,359,145,651,474,170
39061031ANR,831,590,195,853,674,141,734,603,131,740,624,116,740,593,118,932,763,152
39061031AYQ,621,226,384,616,352,242,550,313,237,552,333,219,556,307,242,648,353,291
39061031BNN,856,247,589,848,383,419,717,335,382,722,369,353,731,330,389,924,495,421
39061031AGD,980,775,157,1010,902,74,686,625,61,694,640,54,697,622,57,870,787,60
39061031BHW,537,67,438,554,112,422,454,118,336,451,132,319,460,100,347,591,156,422
39077039ACB,631,154,425,653,180,439,529,182,347,527,224,303,532,165,329,758,185,559
39077039ABS,462,112,311,469,116,316,339,117,222,346,135,211,342,104,214,529,118,404
39061031BKK,589,127,431,589,218,340,504,199,305,508,229,279,509,189,306,660,277,369
39061031BAO,526,171,338,535,231,267,457,205,252,457,217,240,461,202,239,584,277,292
39077039ABQ,560,94,426,569,116,428,393,101,292,396,135,261,400,88,288,619,107,499
39083042ABC,448,66,357,447,74,358,323,73,250,328,94,234,329,69,250,452,81,365
39057029AJD,344,74,260,337,90,233,293,91,202,293,111,182,301,85,209,376,117,253
39129065ABY,584,113,448,596,132,436,545,147,398,548,196,352,554,153,387,674,155,510
39097049AAS,291,65,215,284,65,206,220,54,166,224,67,157,225,62,156,319,75,241
39129065AAA,764,198,547,773,260,486,609,204,405,617,264,353,626,212,402,876,282,582
39129065AAN,365,130,206,371,130,215,280,109,171,281,129,152,287,105,170,393,123,264
39127064AAT,308,55,243,311,47,258,241,48,193,249,65,184,248,52,189,354,48,297
39009005ACB,197,112,73,208,117,88,147,90,57,150,101,49,151,96,52,197,96,100
39009005ABV,262,156,79,275,167,90,211,153,58,230,177,53,229,162,59,264,171,90
39013007ABP,387,126,231,397,114,274,314,134,180,315,146,169,315,118,192,412,103,303
39119060ABE,736,170,544,733,221,473,627,217,410,632,268,364,638,218,408,830,259,556
39035018BWG,772,458,273,772,578,160,692,530,162,703,557,146,707,524,177,856,668,174
39035018BWP,608,354,220,632,443,140,525,412,113,531,427,104,536,405,114,710,537,164
39035018AHO,733,310,363,774,353,390,555,330,225,574,375,199,569,313,233,725,356,363
39035018CRE,833,497,324,811,665,127,771,630,141,770,642,128,775,611,159,910,777,126
39035018CRY,802,554,230,809,667,124,742,624,118,751,641,110,752,620,129,899,765,126
39035018CAG,535,433,77,565,498,60,425,379,46,419,379,40,423,370,43,527,470,57
39035018CYJ,690,237,432,697,281,390,594,272,322,602,299,303,601,256,330,789,368,411
39091046AAQ,246,24,210,247,46,196,198,37,161,201,56,145,199,41,151,265,49,215
39035018ADV,652,261,342,686,362,271,538,326,212,547,357,190,546,316,208,742,435,299
39035018AIX,657,607,32,689,662,22,560,540,20,563,550,13,561,541,16,666,634,30
39035018AAI,678,299,346,695,387,282,545,349,196,547,377,170,546,333,200,688,437,244
39035018AGB,613,260,309,656,346,295,535,308,227,544,343,201,544,293,237,714,364,343
39035018AXX,556,256,266,587,335,235,469,295,174,479,338,141,478,299,169,660,388,261
39035018AZE,655,461,157,684,546,107,559,470,89,566,496,70,568,469,85,773,624,139
39063032AAM,571,91,456,581,142,410,484,124,360,486,159,327,490,124,358,610,191,409
39045023ACH,548,91,434,552,124,409,479,109,370,481,161,320,488,122,356,634,174,456
39045023AEN,842,246,576,857,323,508,758,308,450,772,368,404,775,317,449,1110,467,631
39035018BPJ,413,306,86,428,339,77,336,270,66,336,286,50,334,265,59,444,362,79
39035018BWU,580,349,195,604,409,168,539,417,122,545,435,110,551,402,138,736,533,191
39035018CZW,40,23,14,42,30,11,29,21,8,29,21,8,29,19,9,30,15,14
39035018CFG,802,251,508,833,326,482,647,284,363,658,310,348,655,268,373,848,339,502
39035018CVD,764,224,509,780,307,428,654,316,338,667,346,321,669,312,346,870,415,446
39035018ADI,674,372,250,704,448,211,486,325,161,490,339,151,496,302,171,637,390,232
39035018BBW,458,246,174,486,300,167,342,235,107,348,246,102,346,217,113,529,304,216
39035018DCE,501,176,310,508,217,273,455,222,233,456,253,203,459,204,243,578,273,302
39061031BBH,850,282,531,861,332,507,704,325,379,706,345,361,708,309,383,942,411,515
39061031APU,504,368,107,518,420,74,353,301,52,354,305,49,353,292,51,492,431,52
39061031BOL,708,561,125,729,622,85,632,564,68,637,570,67,636,553,70,800,703,86
39091046AAG,946,177,720,948,243,652,741,206,535,740,270,470,743,217,496,1013,282,716
39091046AAE,906,197,666,899,256,596,668,187,481,671,249,422,675,201,454,979,279,678
39091046ACA,216,21,180,215,32,174,139,28,111,135,37,98,137,23,102,218,35,181
39061031ALV,374,327,29,397,378,9,249,240,9,246,240,6,245,227,11,331,311,14
39119060ABL,482,142,317,492,160,310,372,132,240,372,163,209,373,128,237,488,164,315
39057029AFF,391,105,274,392,127,251,296,97,199,294,123,171,300,90,203,384,117,259
39103052ACQ,723,231,429,738,282,403,524,264,260,541,292,249,541,258,261,826,349,460
39035018BGP,479,292,153,512,347,134,390,279,111,395,303,92,394,275,100,530,337,178
39139070ACU,745,207,501,746,212,487,641,215,426,647,254,393,654,211,417,813,257,537
39035018CKY,769,314,413,813,394,384,634,364,270,648,407,241,652,353,278,916,468,434
39035018BVI,907,255,608,944,329,589,809,325,484,818,362,456,823,314,498,1057,415,635
39035018AWT,399,343,44,418,384,27,299,276,23,300,280,20,304,273,24,356,307,39
39035018CFW,818,248,525,841,322,492,689,304,385,696,317,379,699,274,412,893,339,543
39035018APL,389,257,106,414,322,69,301,253,48,301,257,44,306,243,47,337,260,66
39035018CIF,561,229,273,580,259,266,407,229,178,412,268,144,421,221,178,641,310,316
39035018AQH,522,479,28,558,534,11,355,345,10,359,351,8,366,345,11,443,418,17
39035018AKV,358,333,11,377,370,4,245,237,8,250,247,3,250,241,6,319,310,6
39035018CRK,757,708,30,771,740,19,582,559,23,589,573,16,590,562,23,702,671,26
39035018BPH,490,333,137,502,378,112,414,328,86,411,337,74,415,314,92,522,415,101
39035018AUI,463,403,39,488,463,20,365,352,13,360,353,7,366,354,11,435,414,14
39035018AJD,509,480,14,532,518,10,403,388,15,403,392,11,406,383,12,463,446,14
39035018DBY,819,231,574,814,346,435,694,311,383,701,325,376,709,281,419,895,412,474
39045023ACC,893,194,655,924,189,694,726,187,539,739,244,495,753,209,516,1089,184,893
39139070AAQ,795,281,489,794,327,441,665,313,352,687,368,319,676,319,345,876,412,455
39101051ACE,158,37,106,161,42,104,104,39,65,100,36,64,104,34,66,163,43,118
39135068ABR,235,44,183,241,52,172,185,54,131,192,68,124,193,46,137,244,49,190
39035018AFL,891,278,583,910,377,490,754,355,399,770,392,378,771,336,418,905,403,493
39081041ACF,190,41,142,197,37,158,155,41,114,156,48,108,159,31,123,206,33,173
39081041ACO,143,57,74,144,56,83,109,64,45,113,74,39,114,63,48,148,43,102
39035018ACV,610,513,71,632,567,56,455,408,47,464,422,42,467,406,51,588,525,60
39113057AEZ,691,255,379,697,303,334,505,269,236,508,295,213,509,262,224,676,322,335
39113057AEH,569,214,309,581,255,275,460,256,204,465,276,189,467,251,193,638,330,286
39045023ADP,878,275,594,883,372,477,778,322,456,794,370,424,799,336,449,1052,501,540
39139070ACV,765,154,590,770,170,563,684,166,518,699,221,478,703,164,519,825,215,604
39117059AAA,676,140,490,685,161,492,577,151,426,578,183,395,580,163,396,844,180,653
39173087ADX,888,320,529,903,356,496,679,324,355,683,367,316,687,315,340,981,415,544
39139070ABY,800,221,530,812,213,550,613,212,401,612,245,367,617,195,404,884,221,643
39017009AGN,1222,226,958,1249,343,858,1167,383,784,1184,420,764,1186,358,799,1994,663,1293
39089045AFE,1152,281,834,1149,406,689,1119,385,734,1131,482,649,1144,418,698,1448,563,867
39089045AEQ,674,153,499,681,151,502,509,139,370,525,185,340,526,142,363,745,149,586
39061031BKB,454,97,321,472,125,327,313,100,213,313,113,200,311,84,213,524,131,382
39061031BBA,877,336,505,879,404,436,648,336,312,656,365,291,650,320,311,867,425,433
39049025AMO,872,374,450,898,430,422,714,377,337,719,451,268,721,410,296,975,514,445
39105053AAL,197,49,140,201,41,154,149,36,113,153,51,102,161,34,123,209,46,154
39057029AHB,511,65,424,494,84,379,440,69,371,442,89,353,441,57,373,524,96,416
39057029ABC,507,139,352,506,183,296,434,160,274,435,188,247,435,148,274,547,221,315
39069035AAE,828,234,548,840,298,489,553,205,348,562,281,281,571,197,356,880,305,563
39003002ACG,663,202,425,682,254,397,526,220,306,528,266,262,531,218,297,708,283,414
39163082AAB,415,125,269,426,96,312,290,89,201,297,107,190,293,93,193,464,103,360
39061031ACC,930,552,334,942,673,223,822,637,185,829,650,179,828,621,187,1036,785,239
39061031BJA,985,120,823,1000,176,792,835,157,678,830,178,652,846,148,677,1067,193,857
39061031AIT,834,700,97,866,801,38,701,663,38,706,675,31,706,641,44,867,805,55
39095048AKL,344,321,16,355,352,2,235,231,4,236,231,5,237,224,11,269,257,10
39095048AKJ,316,282,23,329,313,12,214,199,15,215,207,8,216,201,10,228,209,11
39095048AMZ,651,415,197,680,493,152,356,258,98,360,289,71,362,257,87,510,357,140
39095048ARD,816,456,323,831,517,286,646,427,219,647,480,167,647,421,212,803,535,256
39027014ABW,336,42,282,339,53,276,300,43,257,298,59,239,307,37,258,368,46,316
39095048ABP,765,358,367,793,391,357,593,322,271,600,372,228,610,319,258,844,401,435
39035018AOH,238,209,17,272,270,1,136,130,6,140,133,7,141,127,9,152,140,8
39093047AFY,465,232,193,468,266,182,335,211,124,343,238,105,347,208,127,488,272,206
39099050AAM,436,283,124,439,301,122,312,228,84,310,240,70,312,238,68,419,281,133
39099050AAA,333,225,77,349,278,62,191,164,27,202,174,28,199,162,30,291,208,77
39109055AAH,390,88,282,388,122,246,180,66,114,181,77,104,185,59,116,311,98,203
39095048AKK,615,518,88,632,563,54,457,412,45,471,435,36,467,413,43,580,520,57
39095048APQ,489,234,237,508,285,202,426,259,167,436,288,148,437,262,163,520,319,188
39155078ADA,548,275,244,562,305,236,448,279,169,450,302,148,452,286,159,596,347,241
39151076AMJ,544,265,240,562,302,242,411,255,156,414,259,155,410,237,162,553,315,231
39151076AIC,829,231,550,849,287,524,668,256,412,668,273,395,679,246,413,883,316,555
39095048APK,633,278,319,652,331,268,507,320,187,515,353,162,518,313,190,682,393,271
39095048ACT,335,225,84,344,231,89,227,170,57,233,180,53,235,164,66,305,193,109
39095048ANS,499,254,210,509,283,194,349,238,111,355,272,83,355,231,105,487,268,211
39095048ARA,521,239,253,527,284,209,436,263,173,437,284,153,450,246,177,536,329,198
39155078AFA,645,224,381,654,228,403,443,188,255,451,225,226,454,198,246,675,207,458
39095048AEU,302,269,20,314,288,18,205,195,10,204,196,8,207,195,8,244,212,28
39095048ADZ,523,204,288,541,224,275,410,195,215,422,235,187,425,200,202,581,248,318
39027014ACA,463,98,350,470,147,302,401,131,270,401,152,249,403,120,271,530,182,341
39099050AHM,418,182,216,420,218,174,310,172,138,314,194,120,311,183,117,412,223,182
39139070AAF,470,131,320,475,161,290,411,147,264,417,179,238,425,145,267,538,188,342
39139070ACB,643,164,453,649,162,465,470,141,329,485,184,301,488,146,332,708,148,545
39139070ACW,994,216,719,996,272,680,842,248,594,857,312,545,867,260,586,1024,279,732
39099050AJM,621,158,444,635,173,443,538,167,371,539,215,324,544,169,361,730,236,485
39139070ACH,758,169,541,768,165,566,646,168,478,654,205,449,666,173,477,861,193,659
39049025AGE,430,163,233,447,186,244,323,152,171,325,165,160,329,146,168,516,184,318
39099050ASB,788,606,148,803,668,115,672,580,92,679,600,79,689,584,92,826,690,128
39029015ABF,379,109,241,394,153,228,295,123,172,304,141,163,300,115,174,423,152,269
39151076AOT,532,175,327,548,193,340,447,189,258,447,227,220,446,184,252,652,218,423
39151076ADX,540,173,343,547,230,293,436,204,232,442,233,209,436,192,235,562,240,309
39099050AOU,669,266,376,681,293,360,562,267,295,577,335,242,579,315,253,708,290,410
39029015AAU,381,113,238,393,119,260,268,90,178,274,116,158,271,86,176,458,122,329
39089045AFC,699,144,525,701,172,493,612,166,446,620,201,419,626,175,441,797,204,586
39119060ACZ,611,125,466,611,149,439,480,147,333,483,190,293,487,143,333,689,155,526
39017009AIC,247,40,194,252,56,181,193,64,129,195,73,122,197,62,129,264,59,202
39049025AXC,666,329,298,678,405,227,575,368,207,583,403,180,589,376,199,651,441,204
39095048AMP,779,353,393,795,423,305,662,428,234,670,467,203,671,409,230,859,544,299
39095048AEV,433,357,59,442,385,38,270,237,33,277,245,32,278,233,40,364,305,53
39095048AFV,711,587,106,733,643,74,572,515,57,577,543,34,584,512,57,717,627,76
39143072ACQ,523,196,290,528,251,242,376,209,167,383,248,135,380,193,170,564,268,280
39151076AGT,769,255,468,789,320,432,595,251,344,607,277,330,605,250,343,804,353,439
39015008AAA,349,84,252,351,75,262,251,69,182,259,89,170,259,72,181,372,79,292
39003002AFK,583,123,443,591,172,381,441,123,318,447,183,264,450,134,308,623,211,399
39165083AAS,653,140,476,662,198,412,549,184,365,565,212,353,564,182,358,724,275,430
39147074AAM,264,93,147,274,111,118,182,90,92,188,106,82,183,83,88,308,135,170
39155078ABA,511,274,208,526,289,221,412,244,168,412,267,145,415,253,152,578,300,266
39025013AHH,634,175,427,651,246,367,511,225,286,513,251,262,513,223,267,736,341,386
39037019ABT,559,49,497,563,44,495,478,69,409,480,88,392,487,60,416,572,55,514
39049025APL,795,374,388,810,454,317,681,412,269,685,455,230,693,421,255,1318,835,460
39169085AAX,851,408,406,872,505,326,700,378,322,708,418,290,710,383,304,846,456,377
39093047ACW,437,258,138,446,290,120,284,202,82,291,221,70,294,201,82,430,267,150
39093047AJM,835,298,490,839,330,477,668,327,341,688,390,298,689,312,350,912,374,525
39025013AAT,301,53,227,299,54,240,237,59,178,239,63,176,239,60,172,337,68,265
39109055AAA,305,62,219,315,88,197,188,72,116,196,96,100,198,75,108,351,103,240
39099050ARL,584,319,232,593,332,236,427,280,147,437,321,116,434,296,124,581,359,215
39099050APO,403,114,265,417,119,275,311,102,209,312,124,188,309,114,184,457,135,314
39155078AKG,512,218,261,528,241,264,407,223,184,406,248,158,409,214,181,555,259,293
39155078AJP,821,267,522,847,300,513,660,281,379,662,321,341,662,285,358,864,285,571
39049025BDV,667,243,395,677,325,311,592,279,313,587,342,245,598,313,272,744,407,322
39087044AAS,214,106,101,212,93,108,149,74,75,152,89,63,152,72,74,210,90,116
39037019AAF,434,84,329,447,138,290,305,102,203,306,134,172,309,85,206,428,111,311
39095048ALW,729,525,162,745,576,137,288,256,32,291,267,24,293,258,24,476,416,48
39109055ADB,326,67,231,327,93,209,218,96,122,223,118,105,225,92,119,375,139,225
39109055ADE,954,232,695,962,321,591,734,282,452,755,330,425,765,274,474,1027,386,628
39099050ANJ,525,90,413,532,101,413,450,105,345,446,130,316,455,110,332,590,109,476
39163082AAI,290,73,202,302,80,207,229,63,166,235,93,142,234,79,148,316,86,226
39099050ATH,752,195,539,768,233,520,651,204,447,639,255,384,651,229,408,914,290,613
39095048AHW,674,426,215,699,498,164,450,340,110,449,360,89,454,328,106,611,435,165
39027014ABJ,777,126,619,794,155,618,605,130,475,609,160,449,610,129,462,891,143,735
39143072AAM,426,187,198,429,221,163,334,189,145,335,211,124,338,183,142,472,253,207
39049025BFQ,587,161,411,596,218,350,509,211,298,511,249,262,512,231,273,669,292,368
39049025ASX,657,419,212,666,503,130,715,519,196,715,562,153,722,539,159,1064,803,244
39041021AEX,780,203,559,795,324,437,715,283,432,716,351,365,734,316,406,891,443,428
39093047AEM,735,396,299,758,443,281,571,380,191,586,417,169,589,379,192,840,469,353
39099050AKG,470,205,243,469,213,242,407,217,190,411,246,165,415,225,178,513,247,262
39093047AFW,562,292,234,578,339,223,471,318,153,477,352,125,479,308,156,619,361,251
39025013ABU,631,126,478,631,210,389,555,185,370,556,216,340,563,186,362,733,285,428
39025013AAB,1008,219,758,1008,342,611,892,312,580,894,349,545,899,306,573,1156,464,668
39145073ADU,381,118,247,381,96,275,291,89,202,292,117,175,296,93,199,406,86,313
39165083AFG,785,139,608,792,202,545,662,184,478,670,212,458,670,185,473,900,286,591
39165083AEP,936,115,783,950,165,739,827,166,661,847,205,642,843,166,644,1080,220,847
39165083AEN,824,109,682,854,163,661,676,139,537,711,172,539,710,138,555,991,198,780
39165083AGR,602,90,492,617,114,469,535,118,417,542,132,410,541,109,417,735,180,542
39109055ABY,507,69,425,510,89,404,411,96,315,418,125,293,422,105,306,562,134,421
39047024AAN,633,135,471,649,179,442,525,157,368,522,191,331,528,154,365,701,184,511
39055028AAZ,746,187,525,753,240,482,676,242,434,687,297,390,688,225,448,835,287,539
39145073AAX,330,151,161,329,147,164,211,116,95,211,129,82,211,120,85,306,129,174
39041021ACP,632,147,456,630,233,373,624,221,403,627,256,371,630,231,382,835,370,453
39153077ASR,592,237,309,621,273,324,492,249,243,504,278,226,498,248,224,699,280,413
39153077AFS,604,318,246,642,389,222,511,345,166,519,371,148,524,360,142,670,438,224
39153077AMM,771,290,445,794,352,416,710,359,351,733,410,323,739,376,351,908,447,452
39113057AER,396,147,209,399,171,190,255,115,140,259,148,111,264,126,119,385,154,219
39113057AOZ,649,291,339,639,362,239,548,329,219,552,356,196,558,338,208,657,452,194
39113057ASZ,645,135,492,658,202,434,550,174,376,559,229,330,559,177,373,700,237,456
39113057AJO,443,259,153,450,288,135,302,229,73,308,239,69,308,217,73,473,324,135
39049025AYN,649,296,324,658,359,261,549,326,223,556,360,196,556,327,213,710,438,266
39061031AUZ,677,233,402,684,312,331,568,319,249,568,330,238,573,294,255,733,421,296
39165083AEC,294,51,230,298,76,213,253,73,180,258,82,176,259,71,182,890,258,616
39165083AGB,540,147,381,541,222,305,474,207,267,479,227,252,477,198,275,584,289,290
39155078AHB,838,342,457,853,399,420,703,389,314,716,420,296,712,403,297,901,432,453
39155078AGO,456,210,217,468,220,222,320,180,140,327,191,136,322,172,134,502,243,252
39025013AHV,752,132,587,748,201,504,568,168,400,570,193,377,570,156,389,861,285,557
39025013AHS,695,142,539,678,267,376,578,225,353,582,251,331,583,218,359,765,355,396
39007004ABL,331,170,150,327,163,156,275,158,117,275,180,95,276,157,113,330,173,153
39007004ABF,460,207,216,459,228,205,363,200,163,372,227,145,375,188,172,437,194,231
39025013AHB,412,88,301,415,108,291,302,79,223,302,94,208,301,75,210,426,107,310
39151076AIQ,1022,302,646,1051,350,656,823,348,475,832,385,447,838,335,452,1127,388,723
39049025BCU,517,341,155,549,402,123,437,334,103,440,355,85,436,322,95,564,435,124
39049025ARL,590,218,360,580,277,277,573,270,303,579,316,263,579,285,286,687,357,324
39049025AMY,794,463,276,808,575,168,636,491,145,639,521,118,647,491,131,907,695,189
39007004AEU,252,58,176,254,74,164,206,67,139,210,85,125,207,75,128,281,68,207
39007004AAA,564,262,262,571,296,244,461,265,196,477,321,156,474,270,193,616,328,283
39007004ADB,558,157,376,564,177,361,472,184,288,486,216,270,484,181,289,636,206,421
39113057AXK,1002,230,745,992,324,613,932,340,592,935,369,566,944,315,604,1232,495,713
39113057AIS,726,187,522,734,272,432,642,262,380,646,323,323,649,242,391,806,347,445
39025013AHQ,693,161,493,710,192,489,605,211,394,604,228,376,604,200,378,869,269,585
39141071AAO,556,207,321,561,213,313,427,194,233,428,245,183,431,199,215,561,197,359
39123062ABH,662,209,421,676,221,421,499,212,287,507,251,256,508,200,290,710,240,462
39161081AAJ,286,78,156,306,78,210,215,66,149,218,80,138,219,69,138,313,97,212
39161081ABN,294,56,225,298,46,238,253,51,202,259,59,200,259,52,196,333,59,271
39049025AQQ,1033,412,581,1034,505,462,924,479,445,931,538,393,935,503,415,1165,679,464
39081041AAB,341,220,96,350,221,108,201,141,60,207,147,60,206,128,70,318,182,127
39133067AAV,485,267,172,500,323,142,413,290,123,410,302,108,413,282,118,544,355,184
39133067AFM,611,185,390,628,218,378,533,240,293,541,258,283,548,232,287,752,295,437
39085043AGP,791,291,455,816,350,426,508,241,267,520,294,226,516,238,255,860,364,477
39145073ACE,279,85,188,273,68,194,247,80,167,253,106,147,256,89,165,287,82,204
39145073ABR,411,107,286,405,104,285,317,100,217,324,133,191,326,110,211,465,92,372
39145073ADN,523,156,346,529,137,375,402,141,261,406,190,216,406,144,254,580,176,396
39145073ADH,488,146,325,488,134,334,335,106,229,339,167,172,343,116,218,408,105,298
39145073AED,590,160,416,588,142,424,419,137,282,428,176,252,423,140,270,660,133,521
39157079ACR,544,128,382,550,155,361,401,144,257,401,164,237,409,145,243,572,136,426
39049025BJN,219,110,95,228,135,70,240,153,87,240,162,78,241,154,75,345,224,112
39049025BCK,782,231,535,777,385,365,723,327,396,721,403,318,736,363,369,893,507,376
39041021ADJ,509,121,363,519,148,338,438,119,319,433,164,269,442,124,302,562,159,395
39055028ABZ,767,193,554,763,253,490,638,242,396,635,271,364,645,229,405,815,287,517
39043022ABX,400,162,210,399,187,184,311,154,157,312,182,130,309,154,134,425,174,240
39093047ABS,572,294,239,596,337,225,411,277,134,423,295,128,421,267,144,633,331,282
39041021ACB,786,198,571,785,305,444,706,254,452,707,312,395,717,284,421,876,389,474
39041021AAE,506,174,312,511,199,274,408,173,235,404,213,191,411,185,212,538,247,280
39041021AEO,501,134,353,495,185,291,486,168,318,490,205,285,489,180,303,586,239,339
39169085ABM,1050,347,635,1067,431,581,854,351,503,870,399,471,870,342,494,1178,516,647
39093047AEF,740,519,183,757,577,154,540,439,101,551,475,76,556,447,98,779,525,236
39093047AJC,906,260,594,930,328,567,748,293,455,772,365,407,775,289,473,1019,344,668
39159080AAE,560,134,390,564,187,342,412,159,253,420,192,228,423,142,256,769,262,488
39169085ADK,918,179,693,922,199,688,737,174,563,756,208,548,762,175,556,1112,271,821
39025013AHK,434,110,302,428,172,229,386,161,225,388,178,210,391,162,217,462,221,229
39153077ASG,854,342,489,871,455,378,792,454,338,814,482,332,805,462,334,1054,572,468
39153077AIM,606,316,228,625,392,212,470,320,150,480,332,148,475,306,152,624,388,220
39153077AGW,579,355,181,601,420,147,499,386,113,508,400,108,508,386,102,649,475,158
39153077AZZ,187,129,42,193,139,46,133,105,28,135,112,23,134,105,23,183,138,42
39169085AAJ,452,135,273,461,157,272,310,135,175,322,147,175,324,135,173,539,177,347
39169085ABA,768,213,507,774,283,451,631,255,376,640,275,365,643,253,376,880,345,526
39149075ACB,488,45,415,490,71,407,392,67,325,390,95,295,386,67,310,495,63,428
39085043AAI,734,273,394,776,326,409,584,309,275,584,332,252,586,277,278,850,352,478
39099050AAZ,505,149,334,517,199,303,421,166,255,421,203,218,432,179,248,559,226,329
39099050ASX,487,188,279,489,211,269,405,194,211,412,219,193,413,193,212,525,214,302
39017009ADP,344,168,142,361,211,135,209,134,75,222,148,74,219,123,85,414,246,163
39017009AGV,1130,229,869,1122,347,721,1075,346,729,1100,394,706,1098,350,734,1674,575,1078
39017009AJO,806,169,606,812,229,536,667,211,456,677,237,440,685,209,459,875,292,567
39017009AET,554,266,270,582,357,198,384,262,122,387,279,108,381,255,120,416,294,115
39049025ARG,725,272,431,743,397,314,710,364,346,711,425,286,722,389,323,1030,585,433
39087044ABD,529,179,324,542,123,408,362,106,256,370,144,226,369,111,248,577,110,463
39113057AAQ,1110,286,806,1109,425,659,973,371,602,988,440,548,981,368,603,1205,568,635
39113057AWI,972,253,667,985,322,604,700,274,426,704,319,385,710,278,408,1050,415,619
39113057ALL,1040,283,719,1046,395,618,889,351,538,893,421,472,902,342,529,1197,500,680
39025013AGE,505,94,394,511,142,351,433,127,306,432,137,295,433,115,306,524,156,357
39025013ADO,471,113,325,467,142,294,331,115,216,327,129,198,331,102,215,491,151,332
39165083ACD,729,198,507,741,291,417,612,272,340,627,314,313,627,276,344,879,390,476
39071036ABP,390,69,294,402,68,311,301,64,237,306,75,231,305,64,234,430,71,353
39025013ACY,897,176,699,890,275,574,770,248,522,767,276,491,781,253,511,939,338,590
39007004ADA,435,109,298,420,128,280,357,129,228,364,150,214,370,131,229,475,148,322
39049025AOA,681,368,272,686,426,214,562,370,192,567,416,151,571,388,165,704,496,196
39049025AGY,867,517,311,890,640,177,707,540,167,716,572,144,718,539,156,918,723,184
39049025APZ,1013,483,487,1026,578,396,925,569,356,936,642,294,941,595,324,1338,888,425
39143072AAY,303,128,153,304,165,124,237,118,119,238,152,86,237,116,114,339,168,161
39113057AXE,655,266,366,660,306,316,551,283,268,553,313,240,556,284,260,702,344,342
39113057AAL,705,158,533,688,232,420,621,216,405,623,264,359,622,196,420,735,291,437
39085043AEO,579,396,157,616,457,145,506,388,118,514,406,108,515,380,126,816,542,270
39133067AAU,541,316,186,573,357,183,452,302,150,457,327,130,460,305,134,593,387,200
39133067AAK,541,153,373,553,211,327,528,209,319,527,227,300,529,196,331,722,304,417
39133067ADK,645,166,440,666,174,456,471,158,313,470,172,298,472,141,310,681,158,512
39085043AFZ,646,193,410,676,220,406,525,225,300,532,256,276,530,223,278,710,262,438
39085ZZZZZZ,0,0,0,0,0,0,0,0,0,0,0,0,0,0,0,0,0,0
39085043AHA,774,210,510,803,263,501,590,208,382,600,270,330,602,207,376,844,284,550
39085043AGK,754,232,470,779,278,448,588,259,329,593,302,291,596,240,327,861,317,527
39017009ALA,752,132,587,761,199,516,591,174,417,617,206,411,615,184,421,803,293,500
39017009AAR,573,277,267,586,336,213,443,285,158,454,304,150,453,272,167,596,356,232
39087044AAY,257,81,167,267,76,184,218,71,147,222,94,128,226,74,149,278,81,196
39085043ABR,837,296,513,871,334,513,657,293,364,663,330,333,661,275,368,934,370,553
39085043ACE,877,278,560,900,378,487,767,360,407,778,400,378,780,353,412,1006,436,556
39173087AAR,779,317,434,781,427,307,681,361,320,686,419,267,693,372,305,809,461,337
39173087AAN,930,386,522,934,487,406,860,447,413,863,532,331,876,443,420,1003,566,427
39149075AAN,671,192,433,675,254,395,447,176,271,453,205,248,443,170,245,700,197,481
39151076AMN,521,149,350,529,187,316,442,175,267,452,193,259,452,163,279,569,218,346
39155078AAR,423,189,216,435,203,216,348,188,160,353,209,144,353,199,151,491,203,278
39165083ABM,721,121,576,727,189,507,675,182,493,685,201,484,687,172,504,914,269,632
39049025AAL,913,575,288,906,636,203,714,525,189,723,579,144,725,542,165,783,595,175
39133067ADF,336,112,187,344,137,192,234,111,123,236,121,115,233,118,111,378,124,248
39049025AIJ,313,216,82,327,250,70,474,342,132,484,372,112,480,348,121,669,469,190
39049025BMK,630,436,164,666,506,141,242,205,37,242,217,25,241,206,30,430,368,56
39049025BIO,758,397,318,786,435,312,591,376,215,594,396,198,597,380,200,852,518,317
39153077AGQ,623,420,168,633,476,132,534,431,103,544,451,93,542,425,104,697,547,141
39153077AZK,563,301,204,592,338,229,424,270,154,435,290,145,431,269,143,590,324,258
39049025AZJ,656,218,405,676,241,401,493,198,295,500,241,259,505,212,275,905,328,553
39049025AZC,478,231,239,468,293,159,434,241,193,431,284,147,438,264,164,490,341,144
39049025ALJ,695,495,166,724,547,144,537,423,114,542,452,90,550,436,104,772,596,168
39049025ASY,840,461,359,846,576,230,814,589,225,827,648,179,830,598,202,1098,813,269
39085043AFQ,615,204,388,624,232,363,524,225,299,527,269,258,533,221,301,699,302,390
39085043AGL,820,254,527,837,298,506,586,262,324,598,291,307,603,235,347,832,315,503
39085043AGN,726,230,456,750,268,445,656,285,371,669,344,325,670,277,377,912,321,576
39133067AAD,797,255,502,819,307,485,710,314,396,720,345,375,726,304,402,971,408,552
39153077AYV,246,181,48,256,191,48,140,116,24,145,125,20,144,102,25,226,171,49
39153077BAI,528,226,261,544,275,235,447,269,178,458,293,165,463,268,171,665,366,277
39153077AOI,745,247,475,756,339,388,651,299,352,664,323,341,669,294,360,818,398,407
39113057AWW,552,253,284,557,309,227,452,260,192,452,275,177,457,251,196,591,339,244
39113057AON,606,148,445,616,166,424,496,171,325,502,190,312,500,162,332,663,236,418
39049025AHM,526,454,56,547,496,43,418,381,37,425,400,25,427,384,32,547,483,60
39049025AVG,724,228,490,708,366,301,668,286,382,665,370,295,674,321,346,827,458,362
39049025AYR,936,249,654,944,330,581,855,291,564,857,361,496,861,319,522,1039,404,615
39049025ADH,587,383,147,599,465,87,525,433,92,534,453,81,534,431,83,602,501,84
39017009AJI,819,224,569,816,311,466,665,274,391,681,293,388,677,260,406,874,412,448
39111056AAK,199,57,135,204,42,152,157,61,96,158,73,85,156,59,92,201,43,158
39049025AUD,975,382,573,978,526,409,928,496,432,929,583,346,936,536,384,1500,888,590
39061031AVF,960,372,544,979,451,479,781,414,367,783,441,342,779,393,352,1052,539,495
39061031BGJ,815,124,661,808,185,573,698,178,520,705,224,481,720,168,528,877,262,597
39017009ABW,967,209,734,997,276,689,815,237,578,846,287,559,843,234,588,1152,348,789
39113057AIM,766,261,480,770,358,387,645,312,333,655,357,298,652,314,328,819,401,409
39085043AAJ,713,241,423,736,318,385,556,275,281,562,313,249,564,245,296,792,347,439
39133067ADM,516,192,300,522,217,277,448,218,230,452,228,224,453,212,229,593,278,311
39085043AAY,745,223,488,780,292,452,613,255,358,621,313,308,622,236,366,819,320,496
39157079AAT,349,134,197,361,145,197,272,141,131,274,159,115,274,130,131,344,136,204
39035018CSN,587,252,321,604,321,264,542,333,209,542,331,211,541,302,231,665,387,273
39035018CSJ,976,395,563,989,555,404,861,508,353,876,552,324,882,488,380,1072,696,367
39035018CWH,941,254,662,981,392,555,842,380,462,860,415,445,862,375,478,1206,525,664
39035018ATN,382,349,24,406,393,9,295,288,7,304,302,2,301,294,7,351,337,12
39113057AJA,546,162,370,557,192,348,420,158,262,423,208,215,428,166,247,605,230,368
39113057AVY,593,97,470,597,137,434,448,117,331,457,143,314,454,114,315,651,163,479
39113057ABW,677,229,420,684,271,362,536,258,278,543,289,254,546,260,272,728,363,355
39017009AEP,664,215,406,687,260,398,460,204,256,466,218,248,464,203,254,716,297,405
39105053AAS,248,91,148,255,80,160,192,56,136,194,86,108,199,65,129,273,83,187
39035018AGG,581,277,266,612,310,276,465,279,186,469,303,166,473,258,200,687,356,325
39035018AQC,540,483,40,582,558,21,436,418,18,435,421,14,430,399,23,484,461,22
39035018CTG,728,614,90,746,672,62,650,594,56,654,613,41,656,598,53,737,676,57
39035018BUX,611,184,405,631,257,349,535,266,269,544,293,251,543,251,285,720,340,375
39035018BWR,852,517,282,878,608,230,752,571,181,761,604,157,761,554,183,950,712,225
39157079ABH,426,157,225,430,162,237,285,147,138,288,164,124,284,128,139,427,154,266
39085043ADJ,755,306,395,786,348,394,632,330,302,633,362,271,636,310,296,854,357,483
39133067ABH,422,271,110,437,307,91,350,282,68,357,306,51,356,275,66,422,328,90
39085043AIU,423,138,269,444,182,251,548,265,283,555,304,251,551,246,299,844,374,459
39085043ABL,744,238,470,781,317,438,576,256,320,588,303,285,583,240,330,708,323,380
39085043ADH,474,176,267,489,226,236,378,206,172,380,213,167,377,178,179,533,263,265
39017009AIW,869,222,625,877,322,513,701,281,420,733,326,407,735,291,425,915,402,502
39017009ACA,575,157,389,587,177,391,415,159,256,429,169,260,426,150,269,602,214,379
39017009ABA,436,116,297,457,164,260,346,133,213,350,152,198,354,128,211,482,185,282
39017009AEI,593,156,421,608,198,389,477,178,299,485,190,295,486,174,300,632,230,398
39095048ATK,675,228,404,701,282,377,535,242,293,541,274,267,542,230,295,747,295,445
39061031AYH,1193,496,670,1190,679,427,1074,643,431,1075,696,379,1081,633,414,1260,841,401
39061031BGR,994,183,770,999,256,710,884,288,596,885,311,574,896,267,608,1061,344,697
39061031AVE,528,207,291,539,255,233,463,270,193,457,282,175,464,265,183,628,365,249
39061031BDH,269,114,137,270,160,93,241,144,97,239,156,83,243,139,90,297,186,100
39061031ALT,536,369,142,558,448,96,346,268,78,349,280,69,350,262,75,477,357,113
39061031ANG,558,314,226,580,389,175,463,297,166,464,318,146,467,290,171,515,366,143
39061031ASH,911,164,735,882,273,576,814,249,565,807,282,525,819,249,559,1006,371,627
39061031BJJ,510,75,421,524,116,377,584,178,406,592,195,397,600,170,419,1268,340,911
39167084ACO,616,175,416,636,133,475,491,116,375,500,158,342,505,118,372,665,169,482
39167084ABQ,631,158,451,648,113,523,478,101,377,487,139,348,490,102,380,698,130,560
39127064AAO,682,167,481,684,149,511,528,135,393,538,183,355,545,153,381,784,157,621
39115058AAW,384,124,241,404,130,262,273,119,154,282,153,129,290,126,156,403,103,297
39127064AAF,328,111,197,333,115,208,231,74,157,244,104,140,247,90,146,362,94,266
39049025BHJ,848,350,457,875,422,417,668,372,296,674,422,252,675,382,272,992,522,444
39049025AVU,733,272,445,728,369,312,651,317,334,653,367,286,662,338,310,735,428,295
39049025AJM,658,411,217,676,468,196,519,371,148,524,407,117,528,385,134,691,485,190
39049025BKO,532,204,289,553,250,252,507,246,261,510,289,221,515,248,243,721,363,331
39049025AAE,1007,539,432,995,702,242,930,651,279,930,721,209,937,678,242,1095,833,243
39081041ABT,616,185,393,635,206,405,511,225,286,516,249,267,514,191,310,675,215,451
39013007AAJ,177,72,90,181,71,99,141,66,75,138,77,61,144,57,80,182,68,108
39103052AAX,732,243,441,747,304,411,588,271,317,601,313,288,604,262,327,848,331,509
39103052AAP,653,213,400,672,256,393,526,249,277,550,282,268,551,238,305,763,278,474
39103052ACV,922,280,606,933,359,525,768,341,427,777,367,410,778,326,435,1045,443,590
39063032AAI,754,119,614,756,181,551,606,144,462,612,180,432,617,137,473,822,241,566
39049025AZD,277,100,164,282,102,164,211,88,123,216,103,113,216,93,118,318,136,178
39081041ADU,176,58,105,184,58,118,152,74,78,157,88,69,155,65,84,220,70,146
39155078ABP,636,305,289,649,340,278,505,300,205,516,347,169,513,289,204,628,325,295
39155078AHE,660,196,447,666,234,416,538,233,305,551,274,277,554,240,305,736,267,464
39109055AAO,626,101,509,615,162,437,523,154,369,525,203,322,532,143,366,675,191,477
39099050ATC,670,276,366,686,297,370,537,260,277,544,319,225,553,279,266,704,290,407
39063032AAH,569,139,415,574,202,347,474,153,321,478,214,264,485,152,320,585,224,354
39077039AAQ,330,107,186,331,116,190,217,116,101,220,130,90,219,113,97,334,128,201
39049025ADS,870,631,171,889,724,93,870,783,87,872,802,70,877,766,77,1003,901,88
39049025ALO,646,423,183,674,493,157,432,318,114,445,349,96,447,325,109,573,410,156
39035018CUF,715,427,268,731,520,190,633,493,140,639,498,141,643,471,157,811,607,197
39035018CSD,912,428,458,914,570,314,821,538,283,829,576,253,830,517,307,1008,686,312
39035018BYX,866,384,457,901,472,397,724,440,284,728,464,264,733,417,300,980,575,388
39035018BVA,641,253,372,659,293,344,534,294,240,538,313,225,538,276,258,708,329,371
39035018CPD,580,259,293,597,347,216,513,335,178,523,363,160,525,321,189,676,437,233
39035018BRU,680,310,334,702,381,284,601,382,219,617,409,208,613,391,218,800,483,306
39035018ARN,260,230,17,270,260,4,181,173,8,188,184,4,185,173,8,227,208,16
39035018BBB,366,243,99,412,307,90,240,177,63,247,190,57,248,177,68,366,240,123
39035018BPK,511,441,41,529,495,22,280,261,19,284,271,13,285,258,18,305,274,27
39035018AIC,582,543,26,608,595,6,447,435,12,450,439,11,451,429,15,578,564,12
39035018CBK,611,303,290,637,391,227,532,351,181,540,364,176,539,330,200,688,384,295
39035018BBT,544,273,231,578,344,215,444,298,146,441,310,131,447,282,155,599,355,240
39035018AEP,881,282,569,886,393,470,784,366,418,782,405,377,792,362,418,962,465,493
39035018BJT,614,473,113,648,550,67,529,459,70,532,469,63,530,448,69,662,587,69
39035018CIC,658,256,343,697,305,351,513,268,245,522,300,222,520,243,260,719,325,383
39035018DDX,316,288,15,338,328,5,237,227,10,243,238,5,254,242,11,291,285,5
39081041ACP,705,221,442,713,214,484,545,265,280,547,301,246,552,233,305,773,247,518
39035018ABD,765,341,408,784,470,294,684,459,225,695,451,244,695,421,263,897,521,374
39035018CTS,829,547,242,846,640,179,753,592,161,752,607,145,760,586,164,911,709,192
39035018BBX,375,229,114,406,290,103,265,203,62,268,207,61,270,194,71,402,271,126
39045023ABW,901,203,669,921,252,640,767,206,561,777,264,513,782,213,547,1012,286,705
39091046AAJ,417,112,276,424,134,257,260,92,168,259,110,149,264,88,166,460,142,305
39035018BHU,470,233,197,498,287,193,370,228,142,378,251,127,375,218,146,582,321,255
39035018BMR,465,439,18,513,499,8,310,295,15,317,309,8,314,298,10,363,354,5
39035018AKP,295,272,13,321,316,2,196,187,9,199,194,5,199,193,4,248,237,6
39035018COK,783,317,440,801,434,340,719,409,310,721,426,295,725,386,331,871,518,352
39035018BVO,676,365,279,679,456,179,614,440,174,620,463,157,618,425,176,752,542,203
39035018ABA,879,299,556,882,473,377,798,422,376,803,476,327,814,417,388,996,575,409
39035018BYW,853,399,417,873,495,335,767,487,280,771,518,253,776,456,300,1000,625,357
39035018CMK,702,275,387,734,361,352,564,320,244,579,355,224,584,303,259,730,381,342
39035018AVP,464,418,27,494,471,12,364,346,18,362,356,6,364,340,12,459,440,19
39009005ACD,112,48,53,119,46,62,81,43,38,84,53,31,82,50,31,117,47,70
39035018CCX,680,234,405,716,300,383,599,290,309,608,335,273,610,280,309,769,356,404
39035018CXD,802,453,331,800,574,203,735,522,213,735,544,191,740,511,215,891,685,199
39035018CUJ,507,390,96,529,462,57,414,371,43,407,368,39,409,338,57,523,461,62
39035018CNI,757,471,252,801,549,234,672,490,182,675,502,173,677,476,190,810,597,205
39035018BSJ,835,292,505,865,401,427,744,411,333,752,451,301,757,386,353,993,515,469
39035018CRA,901,647,229,922,775,123,785,678,107,803,699,104,805,661,125,1020,874,137
39119060ADH,893,249,612,900,359,512,737,310,427,738,386,352,753,295,439,971,389,573
39035018BGO,406,264,110,432,325,96,277,209,68,276,223,53,282,205,63,425,312,108
39035018BVU,584,358,190,604,426,142,489,373,116,493,381,112,495,365,110,688,494,178
39045023ADR,375,125,237,374,163,202,342,139,203,341,166,175,342,142,198,439,193,240
39043022ADN,175,72,93,176,68,104,133,51,82,138,66,72,141,57,74,144,65,77
39035018CZJ,591,231,335,604,297,283,541,304,237,549,330,219,544,298,227,734,430,297
39035018CZE,613,188,405,628,257,348,611,287,324,617,305,312,621,274,334,831,406,418
39013007AAN,516,142,354,516,150,355,461,149,312,459,192,267,466,132,326,500,131,363
39013007AAW,636,180,435,649,161,471,543,216,327,546,251,295,552,165,378,699,184,510
39045023ADX,602,187,395,605,235,343,543,237,306,550,266,284,556,248,291,673,311,353
39045023ABD,740,254,462,746,304,409,612,297,315,624,335,289,634,305,311,824,402,413
39057029AIW,592,117,448,595,157,398,478,142,336,482,162,320,488,133,331,800,253,530
39057029AAB,637,165,430,641,227,372,562,218,344,562,241,321,567,201,340,658,279,365
39057029ADM,384,107,242,400,147,214,256,103,153,257,126,131,260,98,146,420,167,242
39117059ABI,599,119,444,597,150,416,485,124,361,488,167,321,488,137,338,658,156,486
39101051ACC,305,49,233,308,70,230,254,83,171,257,95,162,254,78,163,341,76,259
39061031AMQ,883,609,247,888,714,146,768,629,139,772,652,120,777,627,138,903,749,137
39061031AWA,390,99,269,399,120,263,284,104,180,285,110,175,285,91,181,399,145,246
39101051AAY,563,208,318,576,232,310,434,179,255,438,224,214,436,182,238,621,242,368
39083042ABH,536,103,401,533,128,393,443,119,324,446,145,301,444,121,307,609,157,441
39057029ADW,325,119,181,340,157,169,237,133,104,241,147,94,240,127,103,357,170,175
39057029AAO,1029,338,657,1036,451,537,840,397,443,846,446,400,854,378,443,1085,546,522
39061031ARL,678,498,146,699,559,112,535,446,89,533,456,77,535,435,94,706,560,136
39061031BCC,524,194,311,530,235,275,428,223,205,425,233,192,433,204,212,538,278,252
39079040AAG,691,174,496,693,158,498,533,148,385,546,223,323,554,158,376,772,181,579
39101051ABT,276,60,201,282,69,197,223,70,153,229,91,138,231,69,144,320,72,244
39003002AGB,642,122,485,642,161,444,552,145,407,556,211,345,550,140,396,715,189,518
39113057AML,1017,265,727,1025,368,609,913,340,573,922,400,522,920,336,563,1076,485,585
39113057AMI,671,179,472,672,280,377,608,237,371,619,282,337,618,233,372,718,324,386
39011006AAL,420,57,342,426,83,323,319,72,247,319,92,227,315,68,229,457,88,361
39113057AYN,519,131,375,529,198,306,439,157,282,439,195,244,445,160,275,555,258,294
39165083ADF,811,153,617,808,226,545,761,246,515,771,264,507,774,233,519,1009,315,677
39017009AHT,838,185,630,861,211,622,689,212,477,701,244,457,700,219,466,975,255,708
39017009AIS,756,143,602,762,215,520,661,192,469,673,205,468,671,180,485,807,292,510
39017009AJN,700,126,549,699,188,472,617,178,439,625,201,424,629,171,438,859,282,559
39017009ACR,327,121,187,344,145,186,183,79,104,197,98,99,197,84,104,343,136,203
39017009ALI,537,110,417,546,163,370,482,143,339,502,176,326,501,150,346,600,221,377
39017009AHN,610,80,515,627,89,515,474,79,395,495,94,401,498,70,416,674,99,565
39113057ASK,851,260,552,864,327,498,705,295,410,712,344,368,717,291,407,876,373,493
39113057AKT,404,196,181,404,229,153,303,198,105,307,209,98,305,190,98,455,265,183
39165083ADL,577,87,463,602,113,471,497,98,399,502,114,388,505,92,400,656,114,527
39003002AGC,593,110,453,600,135,430,474,142,332,482,186,296,475,133,326,631,151,470
39139070ACP,891,188,670,902,216,655,755,195,560,759,257,502,768,185,560,1025,267,745
39113057AEJ,413,150,231,421,198,190,360,201,159,363,227,136,360,187,157,482,262,207
39113057AGS,585,453,105,602,503,76,395,338,57,404,359,45,402,336,50,537,452,75
39155078AHH,915,318,557,932,370,534,755,334,421,778,392,386,772,352,408,1002,428,565
39165083AAN,644,105,493,671,161,471,568,169,399,576,190,386,581,165,397,723,192,514
39165083AGM,584,82,480,585,133,431,538,120,418,545,130,415,543,105,428,689,159,515
39165083AGW,752,169,552,769,282,447,617,221,396,636,271,365,636,228,395,856,349,492
39093047AAZ,617,172,433,620,270,334,560,253,307,567,280,287,573,243,324,801,354,445
39109055AAE,494,115,344,505,155,318,333,135,198,339,164,175,341,117,209,516,147,356
39017009AEC,560,146,393,570,188,356,441,184,257,456,202,254,454,178,249,580,209,358
39113057AJU,764,230,485,781,302,437,572,249,323,580,288,292,578,247,313,850,375,465
39113057APJ,657,165,464,662,239,397,551,215,336,548,248,300,559,190,355,691,261,419
39049025BKF,547,173,365,534,246,272,508,232,276,511,259,252,515,239,266,642,351,287
39049025AFK,352,313,24,357,342,13,278,262,16,283,273,10,279,265,10,334,310,18
39049025ADJ,602,405,154,626,458,123,442,387,55,443,397,46,449,378,48,591,485,87
39049025AJJ,537,355,161,551,402,128,427,315,112,426,327,99,433,327,98,561,422,132
39003002AAC,461,78,372,470,105,351,386,92,294,383,120,263,387,81,299,530,120,404
39113057AOT,497,121,343,507,134,349,342,120,222,349,155,194,349,118,215,502,143,348
39113057ADP,799,397,355,813,482,283,642,432,210,645,458,187,644,415,203,901,597,283
39113057AEQ,545,200,304,560,259,268,394,201,193,399,231,168,404,203,193,553,270,273
39113057AWZ,852,321,501,861,419,401,722,379,343,734,434,300,730,382,336,908,504,386
39113057AWA,620,150,448,632,218,381,492,190,302,494,232,262,501,201,278,654,255,391
39041021ACW,571,157,406,573,235,314,527,185,342,530,236,294,534,208,315,633,301,317
39037019ABG,364,49,305,368,53,311,273,45,228,273,66,207,272,42,225,393,42,350
39049025AVY,554,219,318,562,284,253,495,261,234,494,293,201,498,265,224,592,347,236
39049025BBO,281,125,137,299,130,143,184,88,96,184,109,75,184,87,86,294,127,164
39049025APP,629,230,380,636,319,281,542,280,262,543,319,224,545,287,249,683,389,283
39049025BCD,553,210,316,553,263,263,443,206,237,445,257,188,446,222,210,601,298,287
39049025AOL,586,265,297,591,345,214,537,318,219,546,358,188,554,333,213,652,406,232
39155078ACV,535,284,204,544,323,186,368,244,124,379,270,109,379,239,128,539,330,198
39155078AJG,519,200,291,526,221,280,398,204,194,402,237,165,402,217,170,610,259,342
39165083AAB,506,83,387,522,104,403,388,96,292,396,116,280,401,93,293,558,116,432
39089045AFD,798,152,603,785,165,579,745,175,570,754,253,501,763,192,549,893,202,675
39089045ABZ,602,211,347,601,236,313,429,208,221,434,247,187,431,216,202,673,279,384
39141071ABT,541,144,376,537,142,380,423,150,273,427,179,248,427,146,270,595,163,426
39141071ACJ,104,37,64,107,44,60,63,30,33,62,33,29,64,28,34,114,40,74
39165083ABQ,853,145,660,864,186,644,714,171,543,732,204,528,723,172,536,983,237,731
39165083AFA,470,96,354,486,126,336,388,119,269,401,147,254,397,117,270,520,172,339
39165083ABD,1017,308,685,1031,502,501,927,435,492,957,492,465,955,421,514,1126,576,545
39165083ADT,562,98,426,571,111,438,487,106,381,501,124,377,500,95,385,635,133,492
39165083ADC,619,107,482,648,138,487,501,125,376,518,135,383,513,116,388,742,175,557
39165083AEE,534,133,386,546,226,293,456,163,293,491,229,262,483,163,309,575,250,324
39041021AGB,747,192,537,751,281,441,693,266,427,693,325,368,699,267,418,1028,479,537
39023012AFE,725,197,510,724,257,441,636,231,405,640,298,342,642,245,383,787,266,511
39023012ABZ,711,215,470,706,310,376,588,251,337,590,322,268,591,242,333,714,307,398
39029015ACB,459,102,328,473,111,341,370,100,270,376,146,230,380,127,239,502,106,390
39089045AAE,757,202,504,760,230,494,577,190,387,602,231,371,595,185,398,807,243,557
39025013AEA,540,118,395,541,155,361,394,118,276,392,124,268,399,113,275,587,190,383
39025013AHF,450,95,339,449,108,314,351,105,246,349,114,235,353,94,241,530,152,367
39041021AGC,624,207,403,600,299,289,560,271,289,556,326,230,561,278,276,707,417,283
39041021ACE,558,140,407,547,190,335,563,184,379,559,216,343,562,206,343,659,249,406
39025013ABL,516,101,388,518,122,364,351,121,230,346,133,213,350,110,226,550,167,371
39165083ACG,705,186,495,700,276,376,565,237,328,573,281,292,572,236,326,710,329,368
39155078AKO,635,298,300,659,332,309,518,287,231,534,339,195,532,302,220,721,338,373
39147074AAF,392,180,175,402,177,184,264,147,117,272,155,117,271,146,109,404,192,198
39131066AAB,573,205,352,572,243,310,504,226,278,498,273,225,507,220,274,661,272,382
39131066AAI,161,55,103,166,44,117,120,52,68,123,64,59,123,44,77,168,39,129
39049025AGU,595,319,242,596,366,193,509,346,163,513,393,120,513,365,137,652,461,187
39049025ANF,714,353,323,713,438,225,534,355,179,535,378,157,539,356,168,834,556,257
39153077ATC,637,193,398,675,232,414,513,212,301,529,236,293,525,215,288,742,245,487
39141071AAU,254,115,124,250,135,104,272,152,120,279,168,111,276,146,120,352,176,166
39153077BAN,556,256,270,564,276,249,456,272,184,462,290,172,463,253,190,619,337,269
39025013ACZ,855,171,649,859,293,517,710,259,451,709,286,423,717,260,430,941,385,544
39087044ABS,472,148,316,479,86,385,389,89,300,389,116,273,394,91,296,514,87,420
39151076AAJ,453,171,262,448,193,234,355,179,176,360,209,151,363,188,163,459,206,240
39049025ARR,844,304,522,845,442,356,769,380,389,775,438,337,784,389,373,936,524,397
39049025APB,523,251,244,544,297,225,365,215,150,368,244,124,366,224,138,527,291,222
39049025AGN,433,243,171,439,267,152,287,181,106,288,189,99,288,173,107,428,231,190
39049025BDZ,707,330,359,713,383,292,636,354,282,647,412,235,652,376,265,775,477,291
39049025AYB,649,325,303,645,418,196,624,384,240,632,446,186,642,410,220,636,468,164
39049025BNT,567,286,264,569,369,173,552,338,214,558,393,165,561,361,196,629,441,176
39049025BJX,622,257,347,607,308,267,534,275,259,536,313,223,543,292,244,638,393,236
39049025AKI,641,554,64,663,599,47,518,464,54,529,502,27,533,484,39,672,602,60
39093047ADM,483,239,218,486,251,213,367,222,145,372,241,131,376,219,144,526,252,264
39143072AAE,575,159,372,572,186,351,468,194,274,475,242,233,471,193,262,609,196,408
39153077BBT,702,265,403,719,323,362,574,300,274,591,335,256,588,281,287,780,388,381
39153077APC,703,272,401,727,351,357,664,317,347,679,354,325,673,327,337,922,431,481
39153077ATV,469,186,255,485,237,222,414,228,186,417,251,166,421,236,178,514,277,225
39153077AZH,262,192,57,284,218,53,169,127,42,173,137,36,174,125,38,234,159,71
39153077APK,685,276,379,685,351,310,580,322,258,585,352,233,586,317,259,749,414,325
39049025BEG,480,180,266,509,215,267,338,150,188,336,171,165,339,154,174,507,211,288
39049025BIP,762,353,364,795,424,338,641,347,294,643,391,252,646,360,260,926,515,391
39049025AXZ,716,405,290,711,512,157,670,470,200,675,534,141,680,494,175,766,591,168
39049025ARJ,672,210,442,653,308,317,623,285,338,630,335,295,637,293,335,754,426,319
39049025AKV,490,420,48,505,459,41,305,276,29,309,291,18,304,277,25,476,423,44
39049025AYH,495,208,274,492,259,193,474,267,207,476,305,171,480,280,192,551,356,190
39041021AAF,352,120,218,362,162,170,305,143,162,305,176,129,309,149,149,395,218,170
39023012AEP,491,98,362,492,127,346,393,116,277,399,151,248,399,104,281,546,149,385
39151076AMX,897,244,620,902,305,555,745,304,441,754,346,408,751,286,445,1074,396,660
39155078ADZ,621,281,321,619,318,283,539,294,245,552,341,211,544,293,240,662,344,309
39161081AAZ,302,62,211,313,65,233,251,60,191,257,77,180,252,61,182,330,66,253
39011006AAG,864,130,699,865,171,649,694,152,542,691,213,478,688,155,512,923,207,701
39071036AAO,373,85,274,380,92,265,268,75,193,266,85,181,268,73,182,378,94,275
39023012AGD,886,250,596,887,299,540,692,252,440,696,319,377,706,228,456,900,328,549
39087044ABF,469,88,356,477,94,372,384,95,289,383,121,262,388,98,279,512,104,399
39055028ABA,479,128,325,487,159,320,435,170,265,439,191,248,440,154,276,546,203,342
39065033ABB,763,239,489,761,306,414,602,260,342,604,311,293,603,258,329,807,322,471
39133067AFX,701,201,455,732,242,471,588,246,342,597,268,329,601,255,333,817,274,537
39153077AQC,547,194,310,563,225,301,516,267,249,526,284,242,524,255,252,698,291,401
39153077ANE,790,359,397,811,443,349,655,379,276,668,420,248,671,370,282,869,484,377
39153077AQZ,379,139,214,395,186,194,288,140,148,295,168,127,292,148,130,437,192,240
39153077AFO,647,317,286,669,373,279,548,335,213,561,360,201,558,327,216,722,397,312
39153077BBK,473,196,249,481,243,216,384,206,178,396,226,170,395,202,174,490,239,242
39123062ACL,669,207,427,678,242,403,533,212,321,537,240,297,531,204,292,735,239,487
39123062ABL,728,250,442,749,276,427,566,278,288,573,309,264,574,269,279,773,289,470
39133067ADN,699,363,300,713,413,266,629,408,221,638,436,202,638,395,228,793,500,285
39151076AGM,763,222,496,756,288,416,620,262,358,621,288,333,630,252,357,854,349,495
39151076ADY,508,182,293,508,224,247,354,173,181,367,188,179,369,170,176,527,231,287
39151076AMV,401,214,155,408,217,165,298,187,111,302,197,105,301,173,114,461,225,213
39133067AGK,463,319,118,493,356,105,243,201,42,248,208,40,250,196,41,263,182,76
39011006AAD,772,134,610,784,198,566,693,170,523,692,242,450,700,170,512,874,199,672
39085043AIS,611,241,329,629,342,265,475,258,217,470,312,158,481,240,232,615,357,254
39055028AAO,691,223,432,696,271,382,537,223,314,538,262,276,540,216,302,781,302,465
39055028ABD,673,195,465,682,245,400,550,234,316,563,266,297,562,232,313,713,293,416
39055028ABW,422,94,296,417,96,301,311,99,212,317,109,208,320,88,220,474,99,369
39043022ADX,333,84,243,327,95,223,281,84,197,280,90,190,280,78,194,357,102,253
39017009AAO,425,206,192,449,253,169,288,174,114,299,198,101,300,174,113,385,221,156
39017009AHP,62,24,36,64,24,35,46,24,22,45,25,20,47,25,21,70,27,41
39041021AGD,379,86,282,382,103,251,357,93,264,356,126,230,362,101,255,394,125,261
39037019ACA,292,40,240,294,42,243,205,49,156,211,65,146,210,47,157,295,42,250
39041021AEZ,528,187,327,541,267,254,476,237,239,482,274,208,481,255,222,616,339,273
39041021ADV,718,145,547,721,161,514,624,158,466,624,200,424,626,167,444,853,223,613
39143072AAA,716,173,501,723,225,457,582,238,344,585,283,302,585,232,320,800,257,535
39133067AGR,592,230,333,613,263,328,515,269,246,515,272,243,520,252,242,722,321,384
39085043AEZ,633,260,325,666,306,317,483,272,211,502,310,192,497,249,228,747,384,353
39085043AEP,575,183,360,604,237,353,537,234,303,545,255,290,546,222,312,706,294,402
39023012ADH,622,132,461,624,181,418,474,138,336,481,197,284,481,141,327,646,175,464
39049025BND,469,431,26,499,471,19,393,380,13,397,387,10,398,386,10,472,453,15
39049025BIF,563,517,33,599,564,25,470,457,13,476,465,11,476,463,11,544,510,28
39049025ASL,757,268,456,774,359,385,675,310,365,680,381,299,689,334,332,825,447,364
39049025ADO,399,361,21,406,389,11,275,258,17,277,265,12,276,259,12,391,362,18
39099050AQU,410,350,40,423,397,23,293,274,19,296,286,10,294,273,16,393,357,34
39041021AAC,909,299,583,913,380,488,817,346,471,822,429,393,831,388,424,1004,475,514
39017009AFL,303,78,208,312,74,235,181,60,121,187,63,124,189,60,124,337,101,230
39017009AFK,760,131,598,782,142,605,545,133,412,558,157,401,558,133,409,887,187,690
39017009AFH,141,23,109,147,25,118,97,17,80,96,19,77,98,22,73,173,26,147
39017009AGP,727,242,454,741,317,389,573,252,321,595,275,320,598,257,322,859,397,449
39153077ABY,559,491,43,591,537,42,455,419,36,460,429,31,458,409,37,530,481,39
39153077AOY,393,183,184,402,222,166,315,186,129,318,202,116,319,178,129,441,259,176
39153077BAV,664,198,448,663,291,335,582,265,317,603,302,301,599,266,324,769,412,353
39153077BCM,723,333,365,724,418,267,632,386,246,642,416,226,647,398,236,780,488,283
39153077BAB,522,218,270,545,224,300,425,222,203,430,246,184,438,226,191,656,283,364
39111056AAG,436,162,251,451,118,314,350,147,203,359,180,179,348,120,217,458,127,325
39153077AUQ,726,183,515,754,269,455,646,224,422,659,262,397,662,209,428,820,312,492
39017009ALY,866,162,663,880,208,626,587,179,408,609,194,415,598,157,422,983,247,720
39017009AFY,890,204,648,912,259,618,710,219,491,737,253,484,734,230,484,959,331,617
39153077AYM,474,266,169,496,302,174,347,246,101,354,254,100,357,243,96,478,284,184
39153077ARA,390,142,234,399,183,200,347,169,178,360,178,182,360,170,183,437,218,209
39153077AXJ,650,189,443,644,289,333,580,244,336,584,270,314,586,242,324,733,355,372
39153077ASE,776,255,475,788,317,436,695,303,392,697,329,368,701,304,380,880,378,491
39153077AYN,568,301,216,582,326,232,452,304,148,457,313,144,461,291,155,644,392,242
39153077AQH,539,225,271,559,269,267,414,238,176,427,263,164,425,240,172,569,302,261
39153077AGS,620,230,367,630,310,305,562,297,265,581,326,255,573,302,266,664,357,302
39153077APB,625,287,289,651,311,302,488,271,217,495,288,207,494,264,210,705,356,342
39153077ALQ,630,246,344,664,327,290,508,288,220,519,315,204,518,285,219,687,355,310
39099050AEX,557,379,141,569,434,118,480,374,106,487,404,83,494,398,87,588,449,134
39061031AGP,604,487,100,647,605,28,483,444,39,481,453,28,484,429,38,607,542,57
39061031AQG,522,266,229,529,324,180,396,273,123,399,282,117,393,255,129,518,365,151
39061031ADR,613,335,260,616,444,138,531,374,157,537,401,136,539,365,166,691,524,157
39061031ASR,668,182,444,670,263,370,519,226,293,523,248,275,532,219,294,714,292,406
39061031ARK,685,528,129,692,577,100,593,511,82,598,535,63,599,512,77,715,616,89
39061031BJM,744,385,330,785,470,294,497,312,185,505,323,182,503,293,199,772,467,296
39061031BKE,1051,85,940,1062,157,863,965,175,790,966,203,763,980,153,806,1271,250,999
39061031BER,997,205,746,1013,280,671,830,302,528,838,343,495,839,272,542,1055,374,666
39061031BEW,437,121,295,445,135,277,320,138,182,319,149,170,322,117,193,459,161,282
39061031BJG,1157,170,939,1173,220,903,940,218,722,940,247,693,948,195,723,1030,246,770
39061031ACJ,1033,478,520,1057,687,313,821,572,249,825,599,226,825,553,250,1116,794,307
39061031ATP,1009,293,688,997,445,498,909,430,479,912,467,445,917,420,480,1120,584,524
39061031ABC,930,352,534,931,488,389,851,506,345,853,524,329,862,479,350,1021,619,384
39061031AOQ,335,160,157,345,210,121,281,190,91,283,201,82,282,183,88,393,257,129
39061031AUC,684,328,329,692,360,304,537,330,207,535,345,190,537,301,215,746,431,305
39057029AFC,435,122,276,447,172,247,327,117,210,328,150,178,331,102,209,431,149,272
39057029AFR,450,150,287,458,192,239,335,131,204,333,153,180,343,120,217,438,173,257
39057029ABG,226,46,171,225,50,160,192,45,147,194,63,131,194,47,139,257,80,172
39077039ABY,401,125,249,409,154,227,298,144,154,296,162,134,295,125,160,453,158,284
39103052ACJ,775,250,495,775,316,411,660,303,357,679,323,356,680,294,361,853,377,467
39119060ABY,615,122,473,612,163,412,499,155,344,501,201,300,501,159,333,700,207,483
39119060ACF,384,98,260,387,110,261,267,90,177,266,118,148,268,85,173,433,104,323
39035018BVQ,655,377,244,676,439,198,601,454,147,608,479,129,610,434,158,831,584,236
39035018ADP,800,379,376,836,485,311,650,421,229,659,450,209,659,409,233,882,529,340
39035018AOS,417,380,15,451,445,3,272,260,12,288,285,3,283,264,12,344,327,11
39035018ABE,714,287,420,729,419,289,641,418,223,648,400,248,652,343,297,879,472,400
39035018CAH,512,437,60,526,479,44,418,385,33,422,399,23,427,390,31,543,499,42
39035018BJO,561,287,234,589,355,202,456,316,140,464,338,126,466,303,144,619,402,209
39035018ASR,314,282,13,324,317,3,221,216,5,226,221,5,222,216,3,282,268,11
39035018COX,689,333,313,702,436,236,614,409,205,629,440,189,630,395,217,765,524,231
39035018BIW,563,275,237,575,329,215,485,321,164,489,343,146,493,317,162,693,429,253
39127064ABA,436,126,280,430,118,293,328,119,209,333,147,186,341,121,213,482,128,349
39035018AUT,310,290,10,335,328,5,234,225,9,236,229,7,246,235,8,273,262,8
39035018CJY,685,200,444,722,270,421,553,259,294,570,295,275,567,242,302,787,311,464
39035018CDD,861,306,510,885,365,468,701,339,362,706,369,337,714,321,373,941,425,507
39035018CEY,722,315,341,750,389,322,592,375,217,599,401,198,606,343,236,824,484,326
39035018CTA,814,360,428,839,471,332,712,429,283,725,461,264,728,409,298,926,552,363
39035018BJY,795,543,225,810,670,113,730,608,122,734,616,118,738,593,135,915,765,140
39035018BHA,478,275,164,509,330,152,389,282,107,392,301,91,393,262,115,554,362,185
39035018CHS,752,310,374,779,375,367,571,339,232,577,371,206,585,337,229,847,434,398
39035018BXM,763,456,266,784,542,199,666,503,163,676,525,151,679,488,164,927,658,254
39035018BDH,530,257,238,559,305,226,408,264,144,415,280,135,413,255,146,604,354,240
39035018BKM,762,568,166,775,652,101,740,643,97,745,671,74,745,640,95,913,799,104
39035018BII,671,299,340,679,384,254,620,390,230,620,411,209,631,376,242,767,471,293
39035018COO,706,253,436,720,365,331,587,317,270,599,335,264,599,302,285,779,447,330
39063032AAJ,838,197,614,851,280,531,717,241,476,724,315,409,739,234,490,918,340,562
39035018CZM,673,205,454,697,313,362,556,265,291,560,285,275,562,245,307,729,373,350
39035018CKE,578,204,347,614,258,327,490,244,246,497,258,239,499,229,261,628,262,361
39035018CMZ,735,320,403,732,455,247,669,442,227,666,451,215,670,396,272,874,570,301
39035018BXX,608,395,167,636,462,130,553,454,99,558,467,91,561,442,101,695,548,137
39035018BXO,634,354,232,653,423,189,571,434,137,579,464,115,585,431,134,766,565,196
39035018BGY,384,235,117,409,291,103,332,248,84,330,254,76,331,234,81,467,330,135
39061031BMY,541,119,414,550,216,315,468,185,283,473,204,269,477,177,286,595,285,295
39091046ABP,408,74,311,413,88,301,291,76,215,290,98,192,289,80,195,482,106,371
39061031AIV,1071,777,257,1087,930,128,953,832,121,955,859,96,957,825,114,1132,979,137
39061031AIB,381,242,125,387,285,86,496,415,81,495,433,62,498,409,81,612,528,74
39061031BQK,799,504,260,812,592,178,290,217,73,294,224,70,296,210,70,249,173,72
39061031ADU,711,313,385,718,467,220,642,412,230,636,434,202,645,409,226,814,563,241
39061031AZK,1123,271,837,1118,463,600,996,398,598,1005,458,547,1011,400,590,1190,598,581
39091046AAS,354,46,290,352,48,284,237,42,195,236,60,176,238,47,179,336,60,272
39033017ABP,502,145,342,510,178,316,374,147,227,385,172,213,385,145,228,545,190,346
39009005AAQ,417,334,70,415,344,57,370,305,65,379,331,48,380,319,52,432,374,53
39045023ABG,517,165,335,524,233,270,416,190,226,429,225,204,437,199,228,562,298,257
39061031BIZ,558,79,460,563,108,440,501,108,393,505,128,377,512,96,403,608,105,497
39053027AAN,826,233,571,837,193,619,604,163,441,611,212,399,613,173,429,872,221,639
39083042AAL,685,186,453,688,207,444,515,179,336,525,213,312,522,181,323,796,236,546
39061031BBW,793,258,496,798,320,455,610,281,329,609,301,308,608,268,321,965,440,509
39061031AZO,1016,296,682,1016,420,550,830,367,463,829,401,428,842,347,465,1087,522,540
39061031BGC,390,136,232,395,157,204,310,152,158,312,167,145,313,147,156,389,196,178
39167084ACA,532,180,330,558,141,398,424,140,284,431,171,260,436,127,295,594,158,431
39103052AFZ,723,212,484,739,263,453,606,245,361,612,258,354,617,236,373,846,344,499
39103052ADE,556,150,375,562,164,368,438,151,287,455,189,266,458,148,286,638,183,446
39103052AEP,679,183,449,715,223,459,546,201,345,567,246,321,565,198,343,830,269,546
39103052ADG,710,193,475,724,235,451,621,232,389,631,265,366,636,230,386,814,294,506
39057029AIG,657,100,538,647,167,456,531,156,375,532,184,348,535,151,368,713,238,469
39035018DBG,651,262,347,693,333,316,528,299,229,539,317,222,533,290,233,767,378,370
39035018BFH,518,362,122,575,453,106,354,270,84,357,287,70,360,270,81,524,368,148
39035018BNZ,430,394,23,460,446,8,298,285,13,300,292,8,302,281,15,347,331,14
39035018BJK,438,220,180,443,260,163,372,244,128,376,270,106,374,232,125,483,294,178
39035018BDF,530,268,210,565,309,232,398,234,164,403,265,138,402,235,159,604,318,278
39035018AND,402,378,13,438,429,5,281,273,8,292,284,8,293,280,11,389,380,7
39035018ARE,307,277,13,351,345,6,197,188,9,202,198,4,203,195,6,251,236,12
39035018ALT,356,315,27,392,378,7,276,261,15,279,274,5,282,258,16,306,292,10
39035018CCH,894,331,506,954,449,465,792,445,347,800,485,315,796,400,376,1048,546,487
39035018BMD,809,750,36,861,829,21,649,632,17,649,633,16,649,623,20,771,732,28
39101051ACG,460,148,278,473,163,279,366,149,217,373,189,184,376,158,197,503,181,311
39135068ABA,277,74,179,271,83,172,203,72,131,203,85,118,202,74,114,264,78,182
39113057AFE,662,244,363,660,315,312,474,247,227,479,295,184,479,236,223,696,363,323
39113057AYC,1072,273,772,1081,383,661,951,356,595,955,389,566,957,344,584,1189,491,679
39163082AAO,114,48,60,113,39,71,103,43,60,104,65,39,102,45,54,134,37,96
39033017AAB,399,110,260,405,112,255,274,94,180,286,121,165,286,103,170,408,107,289
39017009AAY,523,165,341,530,211,296,416,188,228,428,202,226,429,181,237,566,256,304
39061031BLA,819,255,548,822,347,442,730,332,398,727,365,362,735,318,399,903,457,439
39173087AAL,1060,381,643,1068,481,536,972,449,523,970,542,428,990,459,504,1163,584,566
39017009AJT,317,72,230,320,97,209,261,95,166,271,111,160,271,94,174,329,125,200
39163082AAE,123,43,75,131,42,82,93,38,55,96,45,51,93,39,53,157,33,123
39057029ADH,346,121,202,352,153,176,200,87,113,202,98,104,202,75,119,374,164,202
39061031BMV,587,251,300,592,317,241,486,294,192,490,314,176,490,292,182,665,417,238
39021011AAE,703,217,435,710,282,385,530,227,303,540,273,267,533,222,285,768,336,416
39035018BUA,667,387,249,687,448,220,514,372,142,528,415,113,526,370,145,679,466,206
39035018COU,907,313,557,925,490,386,831,451,380,845,503,342,847,437,399,1024,604,409
39027014ACF,505,73,423,498,88,397,402,77,325,401,97,304,404,71,317,515,97,415
39109055ADD,748,118,609,749,203,520,717,180,537,734,234,500,739,180,545,969,267,690
39165083ACK,797,179,585,821,320,459,719,285,434,733,326,407,734,285,432,1008,474,524
39155078ADU,533,286,214,545,327,190,413,276,137,421,311,110,414,264,137,580,358,216
39095048ASZ,939,454,434,969,505,414,761,444,317,774,487,287,778,446,309,999,552,432
39095048AON,275,168,88,275,203,56,141,98,43,138,100,38,142,96,38,235,160,69
39155078AJQ,574,165,385,596,177,393,447,176,271,455,218,237,456,183,257,641,200,431
39155078AIU,527,149,351,543,160,361,434,177,257,439,197,242,434,174,243,605,172,425
39155078ACL,740,411,285,758,444,280,602,394,208,620,439,181,616,388,202,787,466,309
39155078ADH,757,362,347,781,414,336,590,356,234,599,399,200,599,354,229,805,416,381
39095048AFH,531,275,232,541,306,214,426,281,145,429,313,116,428,277,132,583,350,221
39095048AQO,538,267,237,556,300,220,384,256,128,388,277,111,394,252,126,545,292,248
39095048ALG,347,320,13,350,341,6,222,214,8,231,227,4,232,219,7,282,270,11
39095048AUW,848,253,557,865,318,490,687,320,367,694,397,297,705,303,372,1010,406,581
39005003ABZ,816,125,646,837,153,648,636,145,491,630,178,452,640,136,488,877,177,687
39151076ALD,836,281,508,855,287,532,627,271,356,631,314,317,636,270,344,957,332,610
39109055ABL,680,184,461,691,248,405,515,203,312,525,266,259,532,203,304,752,293,445
39139070AAR,495,160,284,506,176,308,354,157,197,357,174,183,359,141,200,537,145,383
39049025AUH,634,334,268,647,415,209,473,308,165,478,342,136,480,315,156,652,440,200
39049025AOS,628,421,182,649,476,132,546,418,128,553,446,107,552,417,117,716,543,165
39107054AAA,746,154,568,755,185,531,619,194,425,617,242,375,621,195,410,842,224,603
39151076AHH,635,213,384,652,257,358,537,230,307,545,256,289,542,231,291,746,318,405
39099050AKT,565,224,326,581,267,298,489,230,259,492,295,197,492,254,237,636,281,350
39099050AQA,239,118,103,252,126,112,178,98,80,179,109,70,178,99,69,238,115,114
39029015ABI,272,76,170,279,89,172,184,84,100,185,100,85,185,88,91,289,95,191
39099050AFS,387,276,91,393,300,87,263,204,59,269,220,49,268,197,67,348,260,85
39089045AAB,620,216,355,615,239,336,470,200,270,477,237,240,477,191,263,660,248,392
39037019AAB,493,84,393,495,128,350,400,119,281,404,160,244,407,107,294,515,146,366
39107054ABG,461,93,349,468,118,325,371,107,264,377,140,237,377,108,259,536,149,377
39095048AFW,530,427,86,546,467,66,413,350,63,412,367,45,415,356,45,522,434,81
39095048AFM,478,325,139,495,341,136,411,327,84,419,341,78,423,323,84,509,375,125
39079040AAJ,418,118,289,420,112,303,337,103,234,339,124,215,345,111,227,480,116,356
39003002AEE,625,146,458,639,176,431,494,153,341,500,203,297,495,152,335,611,180,420
39025013ABA,723,98,585,733,116,593,537,109,428,544,129,415,542,104,411,850,160,682
39025013ABF,479,73,387,485,90,370,354,91,263,357,98,259,357,83,257,658,135,511
39025013AEH,495,74,388,504,117,363,426,108,318,428,126,302,427,97,314,556,136,414
39025013AEF,726,113,573,731,155,547,630,141,489,632,148,484,636,133,482,782,161,606
39151076AGV,618,174,412,622,222,372,512,224,288,518,255,263,516,213,285,697,283,395
39151076AFB,572,187,360,577,253,300,477,219,258,485,261,224,495,222,258,630,328,294
39151076AMF,861,312,503,886,392,468,727,340,387,730,392,338,740,344,369,965,455,495
39025013ADZ,777,123,617,780,171,566,652,181,471,652,209,443,657,160,476,814,239,563
39093047AAA,906,320,546,928,364,528,750,368,382,770,434,336,779,382,384,1017,446,567
39093047ABM,878,258,579,897,373,487,729,314,415,754,372,382,764,320,430,1052,467,574
39093047ABN,797,294,469,811,376,399,706,385,321,735,434,301,742,394,332,1046,539,491
39099050AAW,621,191,409,617,232,362,514,228,286,517,275,242,516,236,266,680,274,396
39093047ACH,995,347,607,1003,443,519,774,399,375,821,479,342,826,403,400,1139,532,595
39093047AAW,1161,340,800,1151,493,605,1018,434,584,1043,502,541,1047,449,588,1248,576,660
39093047ADT,681,364,267,689,431,226,514,354,160,529,384,145,533,353,168,712,418,286
39093047AHG,481,178,265,500,219,259,388,204,184,395,227,168,400,196,191,558,251,299
39147074ACQ,309,40,255,311,49,233,248,41,207,253,78,175,254,42,204,344,63,277
39153077AXX,642,193,440,639,288,327,571,264,307,578,292,286,586,262,321,707,370,330
39013007ABB,120,40,75,128,38,85,93,42,51,94,48,46,92,42,47,131,32,99
39049025ACR,627,250,353,637,294,316,506,253,253,506,293,213,511,258,232,667,319,334
39169085ACT,531,95,412,560,136,404,431,113,318,430,131,299,436,114,308,614,135,473
39109055ACR,507,94,391,517,131,367,439,114,325,446,145,301,449,115,321,556,131,419
39109055ADG,450,45,394,453,87,352,382,85,297,392,110,282,398,86,305,519,141,372
39093047ABL,540,186,334,547,243,286,491,272,219,513,308,205,514,258,243,802,420,367
39093047ADR,560,301,213,573,321,228,375,240,135,382,273,109,384,236,127,553,305,235
39099050AND,329,148,159,329,147,173,260,130,130,265,144,121,259,127,120,325,138,181
39029015ACQ,523,87,413,551,108,426,462,115,347,478,153,325,477,110,347,597,124,466
39095048ADU,860,461,344,898,514,331,557,364,193,563,404,159,559,369,177,771,444,318
39095048AIP,587,420,115,597,482,67,505,433,72,506,457,49,510,421,59,557,482,64
39093047AIS,544,170,342,551,177,347,441,183,258,447,200,247,447,163,263,617,210,398
39099050AHP,632,289,299,635,338,268,475,287,188,481,319,162,487,303,164,661,341,308
39099050AMB,647,352,267,660,398,235,518,332,186,525,364,161,526,352,164,680,445,223
39095048AVK,811,201,593,812,276,501,718,263,455,718,310,408,724,267,445,954,377,559
39143072ABW,459,121,306,473,174,281,379,155,224,384,186,198,387,151,224,508,195,307
39049025AGG,520,300,193,528,345,158,456,305,151,459,340,119,467,313,144,669,442,219
39049025BNH,523,302,194,532,347,157,459,307,152,462,342,120,468,314,145,506,367,130
39049025BKI,746,285,447,734,377,330,685,346,339,690,415,275,692,369,317,836,476,357
39095048AOO,459,254,164,473,270,157,294,199,95,298,220,78,297,198,80,450,254,188
39095048AFY,602,502,73,623,541,60,451,407,44,459,419,40,463,410,43,616,523,84
39041021ADN,637,131,479,644,148,470,585,153,432,588,191,397,590,166,410,713,208,500
39041021ADF,718,251,448,721,335,340,654,288,366,655,339,316,662,300,339,821,433,384
39041021AEB,778,289,473,779,372,358,675,336,339,674,396,278,679,359,306,939,568,359
39141071AAA,697,244,425,705,289,387,571,255,316,573,294,279,578,256,309,794,334,448
39099050ABQ,406,201,187,423,243,167,344,216,128,348,242,106,349,203,137,446,225,217
39025013ADD,679,122,536,687,148,515,581,151,430,578,164,414,585,153,410,751,175,566
39145073ABJ,266,97,158,266,96,157,200,97,103,202,113,89,205,93,106,267,86,178
39055028ABL,676,140,497,668,160,472,529,162,367,537,197,340,531,152,364,720,176,539
39055028AAB,740,183,529,750,244,473,639,240,399,643,299,344,648,230,405,856,332,514
39055028AAT,557,185,342,560,214,323,468,203,265,482,237,245,480,196,262,645,251,378
39049025BIG,575,445,106,606,524,61,534,492,42,536,504,32,537,492,34,735,653,70
39049025BDT,602,166,407,625,190,394,515,178,337,511,246,265,518,229,278,687,260,417
39145073ABG,325,138,179,328,125,186,243,110,133,243,122,121,243,109,130,324,147,173
39025013AAS,608,92,495,615,109,492,473,108,365,473,121,352,472,102,356,658,135,516
39023012ACG,633,413,187,631,475,128,409,305,104,420,334,86,419,309,96,569,414,142
39153077AAP,821,460,327,829,546,247,765,526,239,780,562,218,781,537,223,924,644,269
39153077AKV,601,258,309,613,286,294,491,264,227,510,298,212,510,269,224,680,372,300
39153077AZA,665,410,232,685,485,171,548,406,142,563,433,130,564,408,143,687,498,173
39141071ABW,612,158,431,629,152,452,407,102,305,414,136,278,415,109,291,652,129,517
39141071ABU,714,197,489,727,203,488,554,215,339,564,253,311,564,208,338,807,243,555
39113057AWH,933,234,664,941,306,597,769,289,480,776,334,442,773,277,472,1021,385,625
39113057AKS,648,186,425,669,237,376,510,212,298,515,259,256,525,206,298,710,289,411
39113057AOR,674,175,467,703,254,422,530,205,325,535,243,292,542,194,325,782,289,478
39113057AFI,415,361,34,435,414,13,292,279,13,300,293,7,301,283,13,348,328,15
39113057AHY,684,610,60,723,692,24,532,500,32,540,528,12,541,493,34,690,637,40
39061031AJU,909,609,279,904,712,165,853,685,168,855,706,149,859,686,160,961,805,143
39037019AAZ,716,97,587,718,105,589,510,91,419,509,137,372,513,84,410,769,116,647
39147074ABG,338,92,233,343,116,206,296,114,182,307,152,155,305,117,180,405,152,247
39165083ACT,587,109,428,602,131,448,442,116,326,451,136,315,449,114,327,646,156,483
39025013ACB,691,158,500,697,227,426,588,225,363,598,257,341,599,214,360,818,299,503
39007004ACO,589,164,385,601,173,410,528,187,341,544,236,308,543,191,333,727,219,501
39007004ADP,331,90,203,334,98,214,247,99,148,252,103,149,252,93,141,378,100,273
39049025BGH,733,376,326,740,436,265,553,349,204,565,386,179,568,360,197,818,551,259
39113057ANV,764,164,560,778,202,548,561,174,387,571,227,344,575,180,365,826,250,566
39143072ACO,445,132,291,453,159,274,382,155,227,396,182,214,389,161,218,484,173,303
39039020AAA,813,226,556,831,272,503,655,265,390,658,338,320,668,260,389,858,348,493
39123062ABG,764,167,565,782,241,511,714,249,465,725,312,413,713,254,448,912,311,598
39161081AAR,346,84,236,346,89,243,236,62,174,242,77,165,245,63,177,374,97,267
39081041ACN,632,153,438,667,123,517,489,138,351,497,156,341,498,113,348,676,122,543
39133067ACO,573,197,346,599,238,330,470,208,262,478,236,242,478,203,258,737,313,416
39133067AAT,784,424,321,810,490,283,662,442,220,670,473,197,667,430,219,888,581,293
39133067AGE,142,64,74,141,71,63,133,71,62,134,75,59,134,68,65,167,91,73
39145073ADT,359,123,221,355,99,245,264,87,177,266,103,163,267,90,170,394,94,295
39145073AAY,360,179,156,363,157,183,250,129,121,254,161,93,255,139,109,407,168,234
39055028ABV,500,95,375,492,101,368,381,100,281,386,122,264,384,90,277,553,100,453
39049025AKU,632,526,82,642,574,61,496,440,56,494,448,46,498,443,51,630,543,82
39041021AEI,975,225,736,972,371,563,890,311,579,894,388,506,907,337,557,1140,505,626
39041021AFX,868,243,605,873,332,488,853,319,534,853,388,465,857,351,493,1056,471,575
39109055AAZ,616,124,470,622,173,417,481,147,334,486,177,309,489,140,330,618,177,431
39099050AKV,647,272,345,649,324,299,549,306,243,552,364,188,554,338,200,706,367,335
39099050AHN,587,264,284,595,315,254,454,265,189,457,312,145,467,286,160,600,285,305
39099050ACN,666,560,75,687,614,62,477,422,55,487,441,46,484,423,52,619,533,81
39159080AAM,600,113,460,605,151,420,537,147,390,542,182,360,545,165,362,680,225,441
39123062AAY,642,178,429,665,230,409,530,239,291,542,304,238,548,236,286,690,227,454
39151076AOW,577,152,394,575,173,380,461,174,287,460,189,271,464,167,282,688,271,408
39007004AAC,403,217,162,406,238,145,337,212,125,343,254,89,346,209,120,459,246,204
39007004ADR,476,145,299,479,138,324,344,109,235,351,127,224,354,97,236,490,118,366
39041021ACK,304,88,190,307,103,189,259,85,174,259,103,156,264,92,162,429,118,300
39025013AFK,453,97,331,455,130,302,412,140,272,415,152,263,417,129,275,739,269,460
39153077BAW,714,235,458,736,337,373,695,353,342,707,380,327,703,331,359,887,484,399
39153077AME,469,196,235,494,241,225,380,220,160,387,238,149,386,218,155,601,310,277
39153077AZP,489,341,126,506,377,114,407,316,91,419,327,92,417,314,96,524,382,134
39041021AEU,895,287,581,887,406,437,800,363,437,805,421,384,812,378,420,1009,536,461
39041021ADQ,419,92,304,422,122,282,388,115,273,386,149,237,393,125,260,626,231,386
39041021ABU,536,114,398,539,172,344,500,161,339,500,202,298,505,172,329,803,305,486
39037019ABK,389,79,284,392,108,268,323,93,230,331,122,209,337,90,227,424,111,306
39171086AAI,594,170,378,604,217,350,481,187,294,478,248,230,488,174,290,713,263,429
39049025AGB,571,408,150,575,459,97,530,424,106,541,455,86,546,431,106,595,497,93
39049025ACY,383,357,13,410,398,5,255,247,8,259,253,6,260,251,7,320,297,19
39085043AGH,779,234,504,800,275,485,655,286,369,664,316,348,668,279,371,958,351,599
39085043AIA,503,134,340,515,172,328,473,176,297,471,198,273,473,167,298,606,208,393
39099050AKF,412,149,244,418,179,228,333,163,170,338,184,154,343,172,166,432,188,239
39029015ADY,899,233,621,923,281,601,703,280,423,713,330,383,713,285,410,1028,325,681
39017009AEB,359,115,228,367,141,208,288,122,166,289,124,165,289,122,162,387,168,211
39017009ALC,895,236,638,908,325,543,801,327,474,799,344,455,801,322,464,1062,484,567
39133067AEO,631,136,437,648,152,463,530,159,371,538,189,349,542,165,341,734,147,579
39085043AIR,746,279,415,767,340,365,659,362,297,671,405,266,674,337,310,908,447,441
39099050ACC,393,289,80,408,306,78,199,172,27,202,177,25,196,168,26,241,200,38
39099050APY,354,124,206,370,134,213,259,122,137,258,135,123,260,116,137,389,149,232
39049025AUY,577,276,263,601,336,237,449,254,195,450,289,161,455,261,180,671,387,271
39087044AAM,53,18,31,55,22,30,31,14,17,32,17,15,31,15,15,57,25,30
39087044ABH,399,94,280,409,80,309,309,73,236,310,91,219,312,70,239,434,104,324
39087044ABG,233,53,168,243,51,190,187,42,145,192,54,138,193,44,144,277,49,222
39087044ABK,343,112,219,351,93,249,269,82,187,271,100,171,274,83,188,355,97,254
39025013AFX,473,125,317,477,143,304,308,150,158,309,163,146,309,149,151,480,199,272
39025013AAI,643,128,479,655,158,463,528,144,384,527,166,361,527,143,362,696,200,480
39165083AAM,644,104,498,659,165,465,529,153,376,538,171,367,535,144,372,700,218,472
39165083AFV,730,164,542,723,257,439,594,220,374,600,250,350,605,229,362,850,383,459
39007004AAT,239,101,118,239,109,117,197,108,89,204,129,75,202,102,86,256,128,118
39157079AAZ,661,176,455,671,211,431,553,201,352,554,231,323,560,191,356,712,210,495
39049025BJZ,652,217,417,650,287,334,596,251,345,600,314,286,602,254,332,825,394,426
39049025AFS,718,364,321,722,446,255,625,388,237,634,431,203,636,397,226,758,505,240
39049025AFU,623,465,127,641,517,99,395,294,101,399,320,79,400,300,86,567,447,111
39113057ARU,663,158,469,661,200,433,555,179,376,555,217,338,560,175,373,688,244,434
39113057AWU,665,276,369,672,349,301,569,298,271,574,338,236,576,299,264,688,361,317
39113057AAF,1004,361,591,1017,467,497,780,375,405,784,411,373,789,369,394,1075,524,526
39113057AYG,1017,331,644,1029,434,536,842,379,463,851,441,410,846,389,434,1129,566,537
39113057AWQ,558,71,470,562,94,455,462,87,375,461,120,341,469,80,373,557,86,466
39113057AMY,1007,388,549,1025,514,434,830,483,347,832,530,302,836,476,331,1063,657,390
39133067ADV,640,195,404,660,216,428,531,195,336,539,241,298,538,195,320,740,226,508
39143072ACI,596,188,371,602,220,342,469,201,268,470,251,219,472,207,250,633,241,380
39017009ADS,358,292,45,379,344,18,206,189,17,220,197,23,223,194,20,316,267,40
39017009ACH,1042,200,819,1062,287,748,929,259,670,950,311,639,943,246,681,1225,392,824
39087044ADD,69,20,48,76,18,56,50,18,32,50,22,28,52,19,31,78,20,58
39085043AHR,807,243,511,817,299,486,761,326,435,761,376,385,766,313,440,1005,405,582
39093047AKO,829,240,527,844,287,499,658,294,364,677,354,323,683,282,372,951,318,615
39093047ALF,905,825,35,925,884,25,617,608,9,627,618,9,628,608,10,619,596,21
39133067ACU,835,353,434,865,426,400,751,425,326,771,463,308,770,422,323,1008,504,493
39085043AGJ,737,206,486,771,285,450,578,268,310,586,310,276,580,241,318,879,372,499
39151076ANB,674,182,454,684,227,424,572,227,345,580,256,324,585,224,341,746,271,469
39149075AAT,470,104,336,479,143,311,353,119,234,355,146,209,357,117,214,458,119,334
39133067ABB,429,247,143,449,296,129,380,274,106,385,293,92,383,269,101,472,316,144
39071036ABE,572,93,457,581,96,463,410,79,331,412,89,323,413,67,325,613,88,521
39049025AOP,777,350,388,785,429,312,653,394,259,656,432,224,661,399,250,857,533,311
39049025AAJ,479,275,192,481,335,132,357,227,130,357,261,96,358,250,105,394,278,113
39157079AEI,592,147,413,599,138,437,443,132,311,448,161,287,445,137,292,625,148,473
39049025BGP,739,314,388,749,375,325,617,331,286,623,377,246,625,339,267,831,465,348
39049025BNJ,377,161,199,383,190,167,316,169,147,316,191,125,322,173,137,423,239,175
39049025BFN,639,315,295,643,375,230,570,355,215,576,391,185,577,365,197,712,468,233
39049025AFC,506,381,93,533,444,83,373,310,63,380,328,52,378,317,54,509,423,79
39049025BKZ,424,255,156,445,299,108,286,225,61,288,229,59,289,221,58,214,173,32
39133067ADH,700,177,478,722,204,495,550,176,374,549,192,357,549,178,340,765,186,571
39153077ARX,667,349,279,673,392,257,562,362,200,570,387,183,568,361,195,766,450,301
39113057AQJ,637,468,151,644,522,108,485,374,111,490,392,98,486,371,101,420,321,99
39113057AHR,317,88,209,319,117,176,247,114,133,250,131,119,249,101,132,320,132,179
39113057AHI,549,498,37,574,553,6,315,297,18,323,318,5,322,302,10,435,414,18
39113057AND,940,259,645,928,387,504,847,351,496,863,416,447,864,359,484,1030,501,517
39113057AHQ,763,197,525,774,270,467,594,240,354,598,287,311,603,233,345,818,304,500
39133067AFE,430,138,251,435,156,248,299,125,174,308,157,151,303,134,156,458,170,281
39049025BMV,385,163,201,400,211,160,476,243,233,480,279,201,483,246,222,578,315,255
39049025ATU,724,306,376,752,396,300,432,279,153,441,297,144,445,282,147,608,396,198
39049025APW,674,361,291,668,415,226,643,416,227,651,461,190,654,439,205,768,522,239
39049025BBC,664,193,446,679,233,420,564,203,361,568,276,292,569,255,308,727,255,466
39049025BHT,728,470,228,738,508,200,605,437,168,612,469,143,608,431,159,778,534,224
39049025AJR,627,347,251,640,401,202,482,315,167,486,342,144,485,325,150,667,431,224
39049025ARW,696,311,341,716,341,319,573,304,269,583,347,236,596,313,259,808,430,347
39049025AIB,971,629,297,1001,745,182,596,495,101,598,514,84,604,490,94,671,555,105
39049025BIM,468,346,104,478,359,110,415,308,107,416,326,90,414,315,93,516,400,112
39049025AZG,956,294,605,982,297,618,744,265,479,751,326,425,757,276,455,1047,289,735
39049025ANJ,806,599,157,837,682,131,604,508,96,611,529,82,612,516,87,838,691,132
39061031AOP,640,359,249,652,410,216,485,318,167,480,334,146,484,295,166,748,473,264
39061031AOU,561,321,209,578,369,186,410,277,133,408,285,123,414,257,136,434,297,132
39123062ABR,695,175,498,730,228,478,602,214,388,608,259,349,607,218,373,809,250,544
39043022AEM,883,339,487,901,413,438,748,395,353,751,459,292,747,394,312,997,466,514
39017009ACG,624,158,435,644,188,436,450,165,285,469,181,288,470,158,297,671,222,435
39113057AJP,969,295,635,985,356,579,716,305,411,719,350,369,727,271,425,1019,406,591
39113057AVS,698,265,401,706,330,329,532,278,254,538,311,227,540,273,247,832,431,374
39085043AAE,712,266,400,743,289,411,566,290,276,574,325,249,575,269,284,844,368,462
39035018BEA,468,353,89,490,406,68,413,357,56,422,376,46,424,362,54,507,420,81
39035018AMU,349,317,19,374,371,3,234,224,10,236,234,2,236,229,5,292,284,7
39035018CAX,634,547,60,663,613,40,481,451,30,485,462,23,488,440,37,634,586,43
39035018BUS,737,232,486,736,339,377,641,299,342,638,332,306,644,296,339,851,418,428
39035018BNW,456,423,15,478,463,8,315,307,8,319,314,5,317,308,6,391,381,8
39035018DBV,867,422,434,866,552,291,813,575,238,814,570,244,820,537,278,1001,693,300
39035018CSX,1027,498,496,1045,674,342,931,628,303,934,642,292,936,581,346,1168,793,371
39035018DES,822,757,44,865,831,24,654,629,25,659,640,19,661,623,33,851,814,31
39035018BJJ,384,200,156,403,234,151,363,238,125,370,274,96,371,238,108,511,319,186
39055028ABS,346,66,258,357,82,254,285,79,206,291,89,202,293,67,220,383,87,293
39017009AGE,650,104,523,662,141,503,527,134,393,555,169,386,552,131,408,719,148,560
39017009AAM,521,126,369,540,148,365,379,135,244,392,152,240,392,128,254,539,181,352
39017009ADE,486,144,329,505,186,296,345,149,196,359,169,190,356,144,200,538,207,324
39035018AQE,451,404,29,477,457,13,370,355,15,372,356,16,374,349,22,454,422,28
39035018BJM,620,285,285,658,373,258,545,361,184,542,373,169,546,337,193,722,427,286
39035018AIK,642,605,19,686,666,15,519,495,24,520,511,9,524,501,14,633,607,24
39035018AXL,323,218,76,348,272,68,192,148,44,192,154,38,191,146,41,301,218,77
39035018ANC,847,664,161,863,780,69,780,712,68,786,732,54,788,699,78,848,776,72
39085043ACU,573,251,292,590,274,284,443,238,205,444,264,180,447,233,201,630,302,318
39085043AEC,617,235,349,622,275,312,524,270,254,533,308,225,531,250,266,706,347,347
39133067AEY,707,202,453,729,219,478,595,225,370,597,257,340,610,222,365,811,238,568
39017009AFS,406,161,227,417,209,191,324,161,163,334,177,157,334,159,171,447,229,214
39017009AKW,53,7,45,57,10,44,47,8,39,48,8,40,47,8,37,53,10,43
39017009AAX,601,179,400,608,214,359,503,197,306,513,229,284,516,194,305,640,259,363
39167084AAS,556,215,327,560,216,323,462,189,273,469,225,244,477,185,284,641,288,343
39095048AQJ,537,226,273,556,278,233,441,252,189,446,279,167,450,250,177,588,296,278
39095048AGR,747,292,428,770,362,360,644,355,289,644,406,238,656,353,278,843,435,399
39061031BJI,1060,138,880,1090,181,869,884,182,702,885,226,659,899,185,688,1201,221,966
39061031BAC,938,251,663,921,375,493,836,350,486,844,384,460,855,343,491,1016,499,500
39061031AUM,637,429,177,636,470,140,450,333,117,452,349,103,453,322,119,648,483,155
39061031BCB,1000,159,817,1012,226,759,851,186,665,845,223,622,856,182,657,1038,249,779
39095048AEA,766,380,350,785,426,308,552,327,225,564,366,198,564,317,228,791,426,347
39061031BFW,961,661,267,984,783,173,795,632,163,795,635,160,798,601,174,1002,763,229
39061031APM,630,411,199,640,482,125,533,412,121,535,436,99,538,406,114,684,554,122
39061031BME,940,422,470,938,534,361,841,502,339,841,532,309,844,493,337,1050,682,341
39049025AGO,386,210,135,404,257,126,219,141,78,217,152,65,226,146,68,377,231,140
39081041AAQ,563,236,294,578,229,321,454,232,222,460,254,206,460,237,211,639,275,361
39103052AAC,848,255,553,883,332,513,731,340,391,763,401,362,766,334,412,948,392,542
39103052AFI,294,91,182,307,91,192,209,79,130,217,109,108,218,85,120,309,96,206
39049025ASN,667,262,397,664,333,299,613,311,302,616,380,236,623,347,266,731,433,293
39155078AAL,536,264,242,561,296,247,452,287,165,458,308,150,458,289,157,639,351,281
39093047AHB,859,289,539,879,376,467,685,348,337,716,391,325,714,343,350,972,424,540
39093047AAX,1099,367,681,1101,534,522,878,476,402,902,505,397,903,451,439,1210,644,552
39103052ADS,609,166,403,626,210,380,477,171,306,493,218,275,497,168,316,701,237,456
39121061AAP,325,56,256,335,61,260,273,68,205,282,93,189,273,69,199,368,63,302
39103052ABJ,681,260,373,698,321,333,533,278,255,544,302,242,546,272,241,802,363,427
39077039ABN,491,101,353,509,106,383,372,96,276,380,117,263,380,83,282,536,95,435
39035018ACZ,885,754,98,916,837,67,791,718,73,800,743,57,803,718,71,954,860,88
39035018BAA,425,282,105,455,350,83,376,302,74,380,313,67,381,297,72,571,440,121
39035018AMZ,434,400,15,461,453,4,326,315,11,340,333,7,341,330,9,372,360,9
39035018BQY,664,431,200,687,513,159,518,393,125,525,412,113,534,382,140,721,563,152
39035018BNN,426,392,22,466,451,6,296,287,9,295,291,4,302,287,11,348,334,11
39035018BIY,644,310,298,655,391,239,616,428,188,626,449,177,628,403,210,769,502,262
39035018AII,534,502,17,564,550,8,396,386,10,397,387,10,399,381,13,485,463,21
39035018BDI,526,281,202,563,326,216,395,234,161,400,259,141,401,220,160,574,322,247
39035018CAC,740,539,158,759,580,158,535,431,104,542,465,77,548,434,104,731,567,160
39081041AAS,547,182,342,543,177,347,412,175,237,414,198,216,421,174,236,578,206,364
39035018BPL,559,274,252,559,319,217,489,301,188,488,328,160,500,294,194,603,363,228
39035018CZF,749,295,431,760,390,343,686,387,299,689,412,277,691,375,302,816,476,336
39035018BDG,421,209,170,468,274,178,303,194,109,302,205,97,310,191,103,487,276,204
39035018AOB,418,381,18,440,426,10,337,313,24,340,325,15,344,314,21,378,346,24
39035018BSX,486,318,137,511,362,126,329,267,62,335,276,59,336,256,74,482,369,104
39035018ACF,701,474,185,724,546,158,614,502,112,617,522,95,619,494,111,759,576,174
39035018CKT,750,305,398,787,385,362,573,338,235,599,381,218,593,318,245,868,421,428
39035018AIS,656,598,39,688,663,18,532,505,27,538,520,18,541,511,21,642,611,27
39135068ABK,498,79,385,510,116,387,387,95,292,397,117,280,392,95,282,585,101,479
39135068AAZ,372,67,286,375,81,285,271,69,202,274,82,192,273,68,192,378,79,294
39035018BAR,319,224,64,334,272,52,285,230,55,287,239,48,285,231,47,461,342,114
39035018AVJ,351,330,11,375,363,7,246,237,9,249,244,5,252,237,8,281,272,9
39035018CDZ,691,284,361,710,367,308,539,319,220,550,343,207,548,307,225,759,426,326
39035018BYS,604,298,287,612,382,219,514,350,164,514,361,153,516,334,176,609,416,190
39035018BRS,163,80,66,168,93,65,110,66,44,112,77,35,114,71,40,185,99,84
39035018AYL,305,229,53,340,282,45,204,172,32,210,189,21,208,172,32,255,207,44
39035018AYJ,293,235,35,317,274,32,205,184,21,207,189,18,210,181,19,260,222,36
39035018CDL,970,370,562,983,492,459,847,462,385,858,498,360,866,443,407,1031,553,460
39035018CUI,797,667,93,831,747,72,668,599,69,672,613,59,671,590,66,856,738,112
39035018AXH,220,180,28,237,218,16,157,138,19,161,148,13,160,140,17,243,202,36
39035018CSZ,904,390,487,926,502,398,804,473,331,805,495,310,811,450,354,997,597,393
39035018CGV,529,214,292,551,265,262,444,239,205,448,254,194,449,235,205,574,308,265
39035018DCC,463,141,301,487,201,268,437,202,235,435,225,210,438,198,236,528,237,284
39035018AGX,625,260,325,661,305,332,504,262,242,513,277,236,512,243,248,632,263,366
39101051ACL,526,174,326,535,194,316,393,183,210,393,217,176,396,182,203,570,222,338
39035018AKD,406,368,17,430,419,4,288,273,15,289,286,3,297,284,4,356,347,8
39035018CTZ,599,486,98,608,524,68,499,459,40,505,469,36,505,447,46,640,569,63
39035018DCG,570,204,350,584,290,279,465,242,223,468,258,210,469,231,230,616,334,277
39035018DAX,306,241,52,318,257,53,271,222,49,279,235,44,277,228,47,328,265,63
39035018CQC,744,252,453,776,322,423,661,335,326,675,373,302,683,319,340,835,378,451
39035018COV,703,295,370,725,409,276,637,397,240,648,438,210,651,388,245,795,497,289
39043022ADD,638,208,397,645,236,374,510,208,302,514,255,259,515,218,272,669,263,395
39043022AEH,685,369,253,701,413,245,484,331,153,479,345,134,488,319,142,692,429,242
39043022ACL,701,198,479,707,246,434,639,273,366,650,297,353,642,269,352,870,334,526
39005003ACQ,565,131,402,589,110,443,436,114,322,440,129,311,445,108,313,614,98,506
39117059AAH,499,87,370,505,90,392,374,88,286,382,106,276,382,87,283,517,86,422
39117059ABA,361,70,262,372,71,284,295,60,235,301,78,223,302,63,226,421,64,348
39013007AAR,408,122,265,407,132,259,360,156,204,360,177,183,366,138,220,397,143,253
39057029AAD,436,112,311,436,153,266,361,139,222,359,164,195,370,141,215,489,206,276
39101051ABK,343,92,246,352,107,232,315,100,215,320,121,199,315,110,202,392,122,265
39057029AAQ,734,131,582,733,185,491,686,200,486,688,243,445,692,171,496,797,269,511
39061031APQ,584,476,84,603,545,45,412,365,47,415,379,36,411,362,39,541,486,46
39061031BNX,850,204,631,834,336,455,728,287,441,731,323,408,737,265,452,894,428,449
39061031AXS,714,298,396,729,388,312,610,350,260,616,379,237,609,328,275,745,455,281
39057029AAC,941,278,625,946,351,543,765,319,446,764,353,411,767,295,451,1040,472,550
39025013AHJ,223,51,165,234,102,124,205,83,122,212,98,114,204,75,120,238,99,138
39079040ABG,292,67,218,299,57,241,189,37,152,192,53,139,193,44,147,316,56,258
39079040ABQ,386,75,297,397,81,304,305,77,228,314,106,208,318,85,225,439,80,352
39003002ABW,507,247,222,515,300,192,357,212,145,360,235,125,361,203,146,483,266,208
39003002ACZ,457,227,203,467,268,187,361,216,145,365,245,120,361,210,143,495,278,207
39139070ACS,650,175,431,650,160,463,527,175,352,535,208,327,535,173,346,733,183,544
39139070ABK,612,129,459,614,165,423,531,153,378,536,191,345,541,155,366,685,196,477
39015008AAG,327,55,259,331,69,257,254,62,192,256,71,185,257,60,188,373,74,298
39145073ABE,304,96,196,301,92,191,249,98,151,253,129,124,256,99,150,329,127,198
39147074AAW,375,129,231,388,164,195,268,138,130,279,167,112,278,138,126,375,159,209
39017009ACC,385,107,253,402,144,240,256,101,155,268,106,162,260,92,160,408,146,254
39017009ALT,923,194,697,938,290,597,778,249,529,794,295,499,791,256,517,1018,380,625
39017009ADO,406,92,289,418,117,283,296,93,203,301,104,197,298,86,199,447,121,314
39017009AEM,489,146,317,498,178,298,345,135,210,358,157,201,355,120,217,518,202,311
39113057ABP,455,172,254,467,228,207,320,165,155,326,189,137,324,173,140,478,240,234
39113057AEA,566,197,338,571,249,274,479,247,232,482,284,198,486,233,232,622,333,267
39087044ABO,315,104,190,319,89,221,211,71,140,199,86,113,207,61,133,279,63,213
39165083AGU,595,72,492,599,92,474,523,97,426,536,118,418,540,96,426,650,122,512
39155078AHF,749,282,428,760,318,407,611,297,314,630,343,287,622,300,299,850,385,450
39155078AFM,772,312,437,790,333,437,701,349,352,714,387,327,712,340,353,859,367,489
39165083ABY,584,169,387,591,209,341,475,196,279,480,219,261,482,183,270,650,288,345
39099050AKJ,677,255,392,694,282,388,587,291,296,592,346,246,594,314,270,760,350,402
39099050ASZ,393,147,223,396,172,207,325,156,169,328,186,142,332,177,149,434,194,236
39099050AKM,731,306,384,743,345,361,585,313,272,593,361,232,592,331,242,792,395,380
39017009AJA,580,133,423,578,163,395,493,155,338,513,175,338,513,149,342,619,203,409
39017009AKC,317,28,271,331,43,272,283,43,240,291,56,235,294,46,244,385,62,315
39113057AMZ,547,152,374,551,214,320,454,197,257,462,246,216,464,189,270,585,258,315
39049025BDY,645,336,291,653,401,231,617,352,265,619,412,207,624,381,234,720,476,240
39113057AVZ,1016,251,726,1030,379,610,860,364,496,866,426,440,866,350,490,1151,487,649
39113057AYO,956,250,674,957,359,544,920,372,548,919,424,495,925,360,547,1119,476,619
39049025ACS,681,515,130,706,590,76,731,633,98,741,665,76,747,634,86,915,793,112
39155078AFG,494,268,182,501,296,182,408,254,154,416,291,125,410,251,138,538,313,217
39155078ABF,682,318,326,698,376,291,519,324,195,528,373,155,524,321,185,731,392,331
39089045ABK,998,241,719,978,292,644,854,275,579,864,339,525,868,285,563,1133,436,684
39089045ABB,930,328,545,930,368,510,706,300,406,724,363,361,721,307,386,986,411,553
39003002AFE,141,22,114,141,12,121,97,17,80,96,24,72,97,17,75,144,19,121
39087044ADA,159,49,96,170,33,126,110,35,75,110,46,64,109,41,65,158,28,128
39041021ADZ,585,155,421,577,242,309,524,215,309,528,259,269,531,232,290,698,354,336
39041021ABH,425,128,284,436,186,231,395,143,252,399,181,218,402,152,245,651,244,398
39165083ADR,492,75,392,514,90,395,387,94,293,405,114,291,406,89,297,533,114,411
39089045ADZ,664,171,463,665,173,467,497,155,342,496,191,305,506,163,326,724,170,540
39049025AMT,595,294,261,618,347,245,490,290,200,495,338,157,497,303,179,656,367,282
39049025BLO,593,292,276,595,356,203,354,238,116,358,257,101,360,236,110,567,421,130
39049025AMX,675,334,315,680,405,232,735,474,261,740,522,218,749,501,236,915,643,253
39049025BKC,537,257,251,551,309,205,407,246,161,408,275,133,410,253,144,605,419,179
39049025BLM,15,4,11,18,9,9,473,273,200,480,297,183,481,270,198,1014,582,420
39049025AUG,1446,495,922,1475,715,672,870,403,467,891,481,410,895,439,437,1229,689,521
39153077AQV,740,310,404,746,395,325,666,374,292,683,416,267,678,372,301,829,484,340
39153077ALP,660,300,324,667,363,281,565,330,235,567,366,201,569,317,241,766,468,288
39051026ABD,879,304,531,899,344,510,668,307,361,664,352,312,682,307,351,969,364,591
39153077AWX,638,228,367,655,270,353,483,214,269,507,248,259,504,219,259,681,274,400
39153077AUL,821,240,558,846,344,472,759,316,443,781,348,433,774,309,448,983,432,540
39093047ABO,917,285,602,932,390,515,824,382,442,848,431,417,855,386,457,1150,554,591
39025013AGV,552,78,445,557,86,456,446,93,353,446,101,345,451,88,355,660,116,535
39025013ABJ,470,62,376,484,91,372,361,84,277,365,91,274,364,75,275,498,106,386
39007004ABB,240,101,117,241,111,125,185,102,83,189,118,71,187,103,75,263,117,143
39087044ABM,522,169,326,530,147,362,436,145,291,434,169,265,439,136,295,582,186,389
39151076AKZ,792,298,438,806,339,432,617,319,298,621,341,280,626,286,310,891,384,492
39049025AQL,683,282,392,666,391,250,645,346,299,643,406,237,651,366,275,717,482,231
39049025AGV,436,270,150,444,321,85,387,303,84,393,327,66,396,313,67,467,375,83
39153077AEH,560,252,260,578,270,273,413,245,168,420,271,149,421,246,156,608,319,279
39153077APN,741,254,467,767,347,379,656,330,326,679,363,316,681,321,336,822,399,405
39151076ADV,479,184,257,489,199,247,357,189,168,361,208,153,363,181,165,510,244,252
39151076AHK,938,255,658,953,365,538,723,307,416,734,344,390,740,305,417,1081,418,644
39175088AAV,528,96,423,549,113,416,427,122,305,431,155,276,428,118,296,636,127,500
39089045ABT,587,175,377,584,212,336,474,188,286,481,230,251,476,198,263,677,265,395
39049025BIV,593,278,288,608,318,256,454,279,175,458,304,154,461,289,159,775,480,281
39049025BLW,564,262,274,577,301,244,435,253,182,435,271,164,438,255,178,644,379,255
39049025AHS,348,188,121,363,221,116,239,167,72,238,178,60,239,166,70,532,377,142
39049025ARA,728,270,432,736,372,316,675,343,332,675,406,269,685,373,299,794,461,328
39049025AOM,566,214,331,553,280,236,519,262,257,518,326,192,529,303,220,608,371,229
39049025APQ,601,220,358,613,324,259,554,280,274,547,321,226,561,310,243,676,385,280
39049025ATO,777,259,484,776,328,411,647,274,373,650,343,307,648,311,323,890,380,493
39041021AFJ,581,209,361,584,282,271,647,301,346,649,376,273,655,334,307,826,460,354
39023012ACA,554,230,301,551,282,241,431,234,197,444,286,158,439,225,203,581,301,262
39041021ABO,694,146,528,702,231,436,648,214,434,646,259,387,655,236,406,661,259,394
39041021AGL,241,51,185,241,79,152,225,74,151,228,92,136,226,82,142,660,270,382
39151076AEG,625,189,410,624,245,356,537,226,311,539,251,288,547,232,311,687,289,395
39151076AKQ,733,232,460,742,261,440,574,251,323,582,272,310,587,243,319,817,325,481
39049025BLS,583,429,122,616,503,93,374,321,53,380,335,45,378,324,47,503,420,74
39049025APH,438,322,91,461,378,70,386,303,83,386,324,62,386,305,67,506,405,93
39085043ADX,621,254,325,645,304,306,509,293,216,517,319,198,518,272,225,777,412,354
39085043ADR,538,194,303,558,239,288,433,225,208,435,240,195,437,205,214,613,251,356
39085043ABK,510,159,330,542,187,327,438,198,240,437,214,223,445,179,250,592,230,353
39153077AHR,574,276,251,599,301,261,432,271,161,442,301,141,435,264,151,621,322,283
39153077BCN,813,290,493,839,358,437,698,332,366,710,373,337,713,322,370,922,444,466
39087044ABJ,541,157,361,553,128,403,434,125,309,436,153,283,445,118,313,590,163,422
39133067AGM,447,298,119,469,360,87,213,170,43,214,181,33,215,174,34,195,149,40
39133067AGJ,580,336,213,598,398,169,507,353,154,508,378,130,506,354,137,651,459,183
39157079ACF,744,161,541,768,180,552,636,194,442,650,251,399,652,201,425,785,207,572
39041021ADX,587,137,424,598,171,396,495,158,337,497,199,298,504,175,314,702,234,453
39173087ADR,191,50,134,190,56,119,145,56,89,147,71,76,145,52,91,201,61,135
39085043AAP,535,192,317,552,217,310,442,203,239,440,247,193,443,195,234,653,262,388
39099050ABO,323,171,129,333,178,139,230,142,88,234,164,70,233,156,64,336,167,159
39029015ADR,519,125,367,533,114,401,390,102,288,399,119,280,399,103,284,564,110,444
39037019AAE,419,85,310,426,95,304,290,79,211,292,105,187,291,66,213,442,87,349
39133067ABK,518,341,143,525,393,101,419,334,85,423,346,77,424,340,68,495,382,106
39085043AER,518,355,140,551,418,119,474,394,80,480,413,67,478,390,80,657,517,132
39049025AHP,867,556,278,943,679,233,754,574,180,761,620,141,765,597,153,933,699,216
39049025BBL,537,181,323,551,187,324,436,180,256,442,208,234,439,186,235,588,232,350
39049025BNS,425,132,283,420,186,218,393,169,224,392,202,190,394,185,205,512,243,264
39049025BFT,714,223,478,707,318,366,659,282,377,662,341,321,663,312,346,766,394,365
39029015AEK,737,180,529,756,198,529,621,190,431,638,222,416,635,200,425,912,234,673
39023012ADI,658,133,501,671,185,461,567,179,388,571,226,345,583,174,394,737,202,522
39023012ACR,193,37,152,192,70,115,157,52,105,159,71,88,157,43,110,174,86,88
39173087AAI,639,362,227,652,416,171,513,387,126,518,408,110,523,374,114,687,478,194
39017009ACL,645,129,482,664,171,466,528,155,373,541,168,373,547,145,387,739,219,509
39017009ALV,394,82,303,398,108,278,338,107,231,341,116,225,343,107,229,402,119,280
39017009AKN,911,202,669,935,267,614,684,233,451,711,279,432,713,235,462,1103,362,722
39017009AJV,439,313,105,453,358,83,282,211,71,286,222,64,285,212,66,394,310,72
39153077AWI,650,205,412,661,263,369,570,241,329,578,267,311,571,254,299,779,325,445
39153077ADO,446,343,75,464,395,63,349,293,56,359,313,46,357,297,48,477,388,84
39039020ABD,438,102,311,447,105,321,312,69,243,318,87,231,318,67,240,487,124,351
39153077ANP,497,171,306,521,214,295,440,209,231,453,231,222,445,202,230,565,234,325
39153077AAR,657,429,168,670,496,128,582,475,107,595,504,91,592,470,99,749,608,127
39153077AZE,437,394,31,460,427,24,294,271,23,303,283,20,300,279,17,395,358,33
39017009AJH,759,222,519,762,311,417,628,250,378,645,269,376,645,250,384,783,340,435
39017009ADC,394,117,253,411,147,239,273,112,161,282,127,155,281,106,156,427,145,273
39153077AHK,555,363,160,570,390,160,439,316,123,448,333,115,443,320,112,584,382,199
39153077BAS,595,208,343,620,237,359,459,217,242,475,245,230,474,214,238,687,272,407
39153077AFM,450,312,93,477,372,87,311,248,63,314,252,62,315,249,56,479,365,108
39153077AOZ,688,278,371,696,340,317,560,293,267,574,334,240,569,288,271,711,390,312
39051026AAG,673,165,483,685,194,447,514,161,353,523,216,307,522,170,332,736,224,502
39061031AUJ,755,376,347,777,442,303,615,374,241,618,398,220,631,367,246,807,505,289
39061031AIS,913,593,273,915,716,166,797,650,147,800,674,126,812,648,146,1002,818,160
39061031BEX,954,165,749,962,229,685,795,243,552,788,294,494,804,227,547,1003,313,678
39061031BIX,1109,219,865,1119,314,755,917,291,626,925,333,592,922,282,612,1315,433,863
39057029AEA,410,181,196,421,213,168,254,142,112,263,152,111,264,132,117,429,237,177
39057029ACU,608,166,421,600,207,368,538,210,328,539,241,298,543,210,308,676,276,384
39103052AFQ,745,172,539,751,235,485,637,215,422,658,252,406,660,222,426,871,298,564
39129065ACD,815,225,555,821,248,536,648,232,416,650,269,381,654,257,377,967,309,644
39035018CMJ,773,285,433,811,369,404,643,347,296,661,389,272,664,342,301,842,395,434
39035018CWO,659,520,105,678,594,70,550,498,52,552,504,48,550,478,59,709,635,65
39035018CMB,743,280,410,775,351,383,541,300,241,544,317,227,542,287,237,855,406,438
39035018BSM,863,347,463,878,438,401,769,445,324,783,488,295,793,430,343,991,537,444
39035018CMR,539,236,254,581,294,240,407,264,143,412,279,133,416,251,145,666,347,311
39035018CJJ,703,218,460,726,285,421,582,260,322,585,273,312,595,239,346,761,298,459
39035018DAW,519,482,24,530,513,14,486,474,12,486,477,9,490,464,17,566,547,16
39035018BLB,604,453,136,620,517,75,545,475,70,554,487,67,554,471,74,653,555,93
39035018CWI,627,209,389,648,271,355,524,229,295,527,255,272,526,210,305,671,296,368
39035018AME,308,266,31,334,316,15,260,243,17,271,253,18,268,246,19,304,284,17
39035018CJI,781,258,485,832,330,480,668,346,322,683,370,313,689,321,350,898,364,528
39035018CZO,876,231,620,899,339,524,766,325,441,776,354,422,778,323,447,1025,483,533
39103052ABP,660,246,380,676,285,350,540,251,289,551,289,262,556,245,291,757,351,395
39063032ABA,722,234,451,730,261,414,589,249,340,597,289,308,605,249,331,785,341,424
39035018DCN,687,201,454,714,280,411,598,272,326,600,305,295,605,258,334,769,330,438
39035018BBR,570,367,158,657,485,150,426,325,101,431,347,84,433,314,99,565,358,196
39035018BKY,459,378,40,477,425,29,320,297,23,325,307,18,324,288,27,434,395,31
39035018BNV,306,280,15,327,316,4,216,208,8,212,210,2,216,209,6,261,250,9
39061031AMD,645,566,50,666,640,22,360,345,15,364,353,11,367,344,17,472,450,20
39061031ABN,741,251,475,732,404,276,650,377,273,648,404,244,663,368,281,783,490,277
39061031ACH,810,476,288,815,603,177,669,513,156,676,531,145,680,500,162,845,639,197
39103052AAS,499,215,260,529,245,258,397,219,178,407,244,163,406,213,183,629,290,332
39101051AAU,172,79,76,178,80,88,118,61,57,119,64,55,120,53,59,157,72,81
39129065AAT,592,138,418,597,150,415,509,157,352,507,205,302,515,164,332,630,164,454
39083042AAM,442,140,280,444,139,281,299,114,185,305,136,169,305,123,167,499,158,328
39061031ALF,526,318,174,538,377,135,363,264,99,362,270,92,364,246,104,516,362,144
39061031ARP,538,416,102,561,477,72,463,399,64,472,409,63,464,393,62,576,497,73
39103052AAW,710,247,408,763,318,409,588,292,296,605,330,275,605,279,303,926,397,517
39103052ACZ,974,262,659,984,335,604,811,331,480,818,371,447,832,310,500,1225,444,767
39135068ABB,322,96,213,327,102,219,234,73,161,237,88,149,238,74,149,351,94,252
39057029AFJ,544,138,376,540,172,339,456,169,287,453,204,249,460,154,294,550,180,359
39057029ABS,549,120,409,546,159,356,470,147,323,472,188,284,478,139,327,571,202,365
39035018ASX,359,312,30,381,367,11,299,293,6,302,298,4,303,283,12,317,308,5
39035018BZC,705,330,349,720,441,253,611,423,188,612,434,178,613,412,192,754,510,238
39139070AAB,716,144,548,705,182,494,682,211,471,682,274,408,686,200,470,774,235,534
39101051AAQ,263,83,153,268,83,171,192,91,101,195,105,90,196,95,97,259,87,168
39117059AAS,480,122,334,483,130,318,367,127,240,377,164,213,381,123,236,486,160,310
39135068ABD,680,113,536,686,120,540,538,115,423,541,142,399,542,103,413,685,120,554
39035018DEP,509,472,20,531,509,15,402,390,12,401,396,5,404,385,12,485,469,14
39081041ACV,249,61,163,254,43,198,216,60,156,221,76,145,223,54,160,253,48,202
39081041AAE,534,219,286,513,209,284,382,173,209,390,193,197,393,173,202,532,229,294
39035018BBH,357,235,91,390,286,95,244,185,59,249,195,54,248,179,56,338,226,104
39035018CBV,859,354,473,921,462,424,734,402,332,741,429,312,739,373,344,997,512,471
39035018BGN,387,291,81,411,333,58,300,262,38,309,266,43,312,252,46,413,335,73
39081041ABS,579,186,363,599,168,409,464,177,287,471,196,275,465,162,280,645,191,440
39045023ABX,841,152,660,835,192,612,718,162,556,729,215,514,738,189,533,990,262,719
39119060ABR,519,112,387,523,145,367,414,136,278,419,160,259,422,123,281,578,145,426
39089045ADL,965,200,725,994,262,677,823,250,573,837,312,525,839,255,572,1212,363,824
39069035AAC,816,208,575,815,266,493,627,231,396,634,324,310,643,225,399,898,313,563
39017009AEW,550,321,191,568,393,141,403,302,101,415,314,101,417,308,95,526,398,121
39061031BCQ,701,150,520,715,210,464,570,200,370,577,227,350,581,177,379,770,264,494
39095048AUU,824,273,520,833,348,428,694,338,356,700,390,310,716,342,350,931,438,470
39095048ATG,972,278,674,974,362,581,674,272,402,674,297,377,688,272,398,1069,453,606
39035018ANF,568,495,45,580,534,30,476,454,22,478,463,15,480,446,22,528,494,29
39027014ABU,475,63,390,475,94,373,403,100,303,404,116,288,403,93,304,498,106,388
39155078AGU,830,247,561,849,318,509,729,298,431,728,344,384,729,300,417,922,381,533
39155078AHG,477,186,277,482,199,270,402,197,205,406,239,167,410,209,195,514,238,272
39095048AAZ,635,310,291,647,352,266,459,284,175,466,300,166,473,272,189,640,341,283
39095048ASV,717,320,369,734,337,366,564,284,280,567,303,264,577,275,271,830,380,439
39095048AFI,653,366,248,661,427,212,519,358,161,519,389,130,522,335,166,684,419,253
39095048AFF,677,407,232,692,448,195,480,358,122,485,374,111,487,358,119,649,466,172
39151076AIX,529,164,337,541,183,330,403,168,235,402,190,212,408,163,225,556,218,328
39095048AAR,753,324,387,779,373,358,716,417,299,719,467,252,728,399,294,974,516,435
39165083AFI,469,100,353,459,150,290,397,151,246,402,171,231,402,150,248,524,229,289
39027014AAB,602,119,463,610,180,400,495,176,319,498,208,290,497,161,315,652,212,431
39027014AAA,428,122,280,435,140,255,333,144,189,331,150,181,334,133,186,485,182,292
39151076AOO,731,198,511,728,274,419,639,225,414,655,263,392,652,226,419,791,302,479
39101051ABM,288,100,168,292,113,164,237,95,142,236,117,119,238,98,133,314,106,201
39049025ABG,390,348,25,407,384,13,274,253,21,283,270,13,281,262,15,400,376,21
39139070AAC,507,183,288,512,194,284,396,177,219,398,189,209,401,165,218,578,241,326
39119060ABD,592,137,436,592,177,395,511,162,349,511,214,297,518,163,345,655,210,443
39151076AMD,614,207,376,614,262,325,526,266,260,529,284,245,532,262,261,616,293,319
39029015AEH,446,126,287,459,120,318,375,115,260,384,127,257,382,110,254,509,135,365
39119060ADA,539,101,418,549,135,392,441,132,309,444,171,273,445,125,309,605,164,435
39057029ADQ,642,142,474,638,202,411,540,186,354,545,223,322,543,175,356,664,227,417
39017009AKG,432,75,340,449,77,357,334,79,255,344,84,260,336,72,253,472,90,377
39169085ACI,692,195,470,702,249,422,593,247,346,611,280,331,617,246,355,771,283,476
39099050AHG,569,244,303,587,273,297,491,253,238,497,306,191,502,271,217,622,294,324
39099050AKS,694,288,369,716,324,366,587,294,293,599,334,265,596,295,276,802,365,431
39165083AFH,508,169,315,523,214,278,428,203,225,442,225,217,441,198,237,701,344,351
39165083AEY,655,133,492,659,198,430,491,163,328,504,188,316,503,154,337,716,267,439
39155078AJF,361,108,233,360,98,243,247,102,145,254,124,130,254,101,135,389,119,260
39165083ADG,798,142,623,831,190,601,756,229,527,763,264,499,776,228,525,1059,346,697
39049025AXD,632,393,213,643,463,156,551,393,158,559,433,126,567,419,141,718,513,192
39007004AEP,290,101,164,293,117,166,239,107,132,245,132,113,244,108,129,315,132,179
39025013AGL,553,117,415,548,183,338,443,151,292,449,163,286,449,155,281,601,214,379
39093047AKU,989,352,596,1021,489,500,849,456,393,874,503,371,884,444,423,1242,634,598
39093047AKY,997,340,619,1007,430,538,777,379,398,798,416,382,801,366,419,1151,534,600
39093047AFL,805,457,299,810,512,275,693,447,246,726,505,221,728,454,252,971,579,387
39013007ABA,384,113,254,390,112,262,336,129,207,338,162,176,338,125,206,423,118,301
39049025AHQ,484,181,267,496,216,246,369,165,204,369,211,158,366,176,178,485,197,280
39169085AAW,471,188,254,473,218,233,370,191,179,374,205,169,378,182,180,500,241,255
39087044ACD,366,97,248,378,88,273,304,88,216,308,114,194,306,87,211,416,115,296
39093047AEP,588,319,230,593,357,212,411,261,150,422,292,130,427,264,148,607,359,239
39099050ALB,735,332,376,764,391,344,598,292,306,621,373,248,616,336,265,799,433,355
39095048ACU,642,282,324,662,297,307,506,263,243,521,311,210,521,259,243,686,303,373
39143072ABP,450,111,311,439,138,273,352,144,208,350,176,174,355,150,195,452,168,278
39095048AQK,651,263,365,661,314,318,537,287,250,544,326,218,544,291,243,681,343,328
39141071AAS,459,195,240,465,222,220,319,160,159,320,187,133,318,158,150,452,198,246
39015008AAK,596,126,443,611,138,452,485,145,340,499,166,333,492,129,346,641,131,501
39025013AFY,284,61,204,283,88,184,276,100,176,273,110,163,277,96,173,358,128,224
39153077ACW,661,429,205,672,489,160,629,475,154,638,490,148,639,481,149,765,575,171
39165083ABI,731,228,475,747,317,388,604,291,313,621,321,300,619,274,328,858,422,421
39003002AFT,605,95,497,614,138,455,537,136,401,541,168,373,543,128,406,690,192,487
39155078AJJ,547,163,352,554,180,343,418,177,241,426,208,218,426,185,233,579,184,388
39145073AEP,196,76,110,200,61,133,136,55,81,140,66,74,139,56,78,189,50,138
39041021AAZ,584,139,435,572,219,336,513,174,339,517,231,286,525,185,328,661,303,350
39153077ADS,454,361,69,479,406,61,310,268,42,314,281,33,307,257,39,426,351,70
39153077AUJ,592,201,367,600,247,325,499,233,266,508,266,242,511,227,274,698,293,401
39113057ALJ,800,213,547,802,308,437,652,278,374,661,332,329,661,264,371,833,390,423
39147074ABL,124,32,86,127,36,81,92,32,60,93,40,53,93,26,63,139,37,100
39165083AEH,642,139,465,661,158,470,469,141,328,483,162,321,475,137,322,838,255,570
39165083AAU,563,149,392,568,220,323,462,189,273,484,225,259,478,205,264,616,261,343
39025013AGI,786,154,595,789,209,546,616,196,420,617,225,392,620,185,413,879,290,576
39049025AOG,732,371,336,740,440,266,628,400,228,631,433,198,634,404,213,814,541,265
39049025BLD,652,347,275,671,410,240,483,330,153,489,346,143,493,336,142,706,486,212
39049025AED,900,659,204,914,763,111,888,749,139,895,794,101,900,771,113,976,861,107
39049025AEB,853,600,205,859,682,144,859,678,181,860,723,137,865,700,156,913,780,124
39049025AKR,698,466,202,718,500,199,524,392,132,536,417,119,531,399,121,735,474,250
39049025ASP,568,223,333,570,299,238,498,258,240,503,306,197,507,278,221,588,367,209
39049025ACD,1039,407,607,1047,568,413,858,471,387,858,545,313,857,497,345,1089,709,363
39025013ADU,607,110,463,615,137,444,484,138,346,482,154,328,485,132,333,721,165,541
39025013AED,702,148,522,716,186,489,552,189,363,555,204,351,559,173,350,888,282,595
39025013ADR,677,127,528,670,183,460,558,176,382,563,199,364,564,166,381,716,235,473
39049025AVV,753,358,371,753,446,270,685,389,296,683,435,248,690,403,269,792,525,252
39141071AAW,487,164,309,493,201,261,379,179,200,382,212,170,384,172,199,508,208,292
39085043AAT,1028,242,752,1032,336,659,918,324,594,926,376,550,930,313,598,1157,419,728
39085043AFL,934,272,616,933,317,583,769,310,459,764,363,401,775,287,466,1039,383,646
39145073ADY,519,113,393,524,103,413,449,111,338,456,160,296,460,112,340,538,103,432
39055028ABJ,161,42,104,160,46,107,127,48,79,130,56,74,128,42,81,159,54,104
39109055ACV,514,57,439,520,72,435,391,61,330,394,91,303,399,63,326,510,73,432
39049025AMJ,640,336,276,639,394,208,503,329,174,506,368,138,506,339,157,641,430,197
39049025AKP,517,441,51,537,492,33,385,349,36,388,366,22,392,362,24,460,401,48
39049025AVO,746,359,373,741,445,264,674,397,277,675,457,218,689,418,264,786,512,262
39041021AGM,243,63,175,242,87,139,217,84,133,218,99,119,219,85,130,507,249,253
39041021AEW,668,174,485,667,242,383,602,234,368,607,281,326,607,239,358,722,334,374
39023012AER,901,181,673,905,231,639,748,220,528,758,281,477,752,215,516,972,275,679
39099050ARB,700,366,292,706,391,283,584,369,215,593,434,159,601,396,193,767,452,304
39093047ACF,640,268,351,663,320,309,533,308,225,552,347,205,558,302,240,741,410,326
39157079ABX,276,45,213,279,49,215,195,48,147,200,62,138,198,45,143,294,52,242
39007004AAW,156,65,75,156,79,74,108,59,49,112,70,42,109,60,47,163,84,77
39151076AJQ,769,208,527,789,243,516,651,244,407,657,284,373,660,234,407,888,285,594
39169085AAE,1001,260,692,1019,295,667,800,284,516,824,326,498,827,289,511,1113,360,729
39153077AKZ,675,280,352,691,348,312,569,310,259,579,345,234,581,308,254,761,401,352
39049025BAL,663,193,444,671,250,387,569,212,357,573,270,303,572,239,321,773,342,416
39049025ALP,585,372,190,604,417,164,509,372,137,516,405,111,518,383,124,645,462,175
39085043AEF,659,195,440,671,264,385,587,266,321,588,311,277,589,271,304,747,348,392
39133067ABQ,356,159,170,371,183,161,304,175,129,307,190,117,305,178,106,414,204,205
39085043AED,606,245,343,623,293,313,522,269,253,530,303,227,530,259,256,680,359,319
39099050AKU,573,277,270,579,291,275,479,269,210,488,311,177,490,294,186,633,342,287
39017009AKF,628,89,517,649,117,521,531,107,424,541,130,411,543,109,421,727,139,581
39099050AMW,858,246,593,875,328,528,774,283,491,773,345,428,780,309,464,1035,413,616
39113057AQS,596,446,125,647,578,54,482,427,55,493,451,42,495,417,71,621,567,50
39113057AWF,625,221,383,629,264,330,545,243,302,550,280,270,550,241,296,845,428,402
39007004ABQ,190,79,95,191,92,91,118,60,58,122,66,56,119,54,56,194,71,113
39025013AET,601,78,496,616,100,493,488,93,395,484,100,384,492,87,390,640,109,516
39011006ABP,431,39,371,431,35,377,356,38,318,357,67,290,352,36,311,479,44,431
39113057AAK,1135,305,791,1144,405,681,969,394,575,982,456,526,982,389,572,1292,551,720
39113057ATH,918,123,772,925,151,751,722,146,576,723,200,523,728,140,570,970,177,780
39113057ACK,390,281,97,401,318,70,294,222,72,298,238,60,298,225,66,373,289,74
39113057ANF,817,281,503,815,378,396,698,364,334,710,413,297,712,357,339,870,502,350
39113057ANC,735,275,428,738,364,342,654,331,323,660,383,277,662,339,306,799,447,343
39085043ABB,803,224,545,816,308,481,693,295,398,695,332,363,703,266,420,915,374,531
39085043ACG,894,289,544,945,364,541,788,350,438,794,394,400,800,330,439,1084,447,623
39157079AAB,516,153,340,527,182,312,413,179,234,418,205,213,420,183,216,591,225,358
39085043ACI,662,235,392,687,298,351,511,234,277,517,274,243,518,235,261,790,360,423
39085043ACB,482,171,269,517,208,277,390,198,192,389,220,169,392,183,196,555,221,328
39093047AKZ,1115,302,787,1140,450,649,944,431,513,976,504,472,978,435,523,1392,648,731
39133067ABR,559,223,300,566,270,271,485,257,228,483,281,202,488,238,226,628,293,327
39155078AAZ,393,162,212,405,177,211,349,171,178,356,206,150,354,176,171,448,204,236
39155078AFS,673,247,391,692,259,402,505,209,296,509,267,242,508,216,277,658,199,446
39155078AHO,638,262,343,646,279,343,530,273,257,532,299,233,533,276,237,704,279,416
39049025AMU,690,274,385,705,323,352,508,245,263,515,282,233,515,276,229,787,348,426
39149075AAY,696,104,571,703,162,515,592,138,454,600,210,390,601,157,426,729,187,533
39133067AFL,833,278,516,852,291,513,795,341,454,804,378,426,796,330,433,969,375,572
39049025AWE,1197,441,743,1172,604,522,1139,536,603,1145,652,493,1154,572,556,1316,765,534
39049025AOF,657,268,361,655,327,285,601,307,294,601,361,240,610,342,260,800,473,313
39153077AHN,607,264,303,628,292,311,498,280,218,505,297,208,505,277,212,747,329,408
39113057AJJ,952,299,620,959,393,531,798,343,455,810,401,409,810,337,455,1017,426,577
39049025BLR,341,176,143,350,211,115,427,296,131,434,313,121,434,292,129,683,459,212
39049025BHG,786,408,330,820,494,271,482,331,151,483,354,129,485,332,137,685,440,232
39049025BGU,457,182,258,455,228,196,365,206,159,369,223,146,374,214,145,498,278,206
39049025AHI,819,584,201,856,665,163,593,466,127,600,503,97,604,478,114,818,663,144
39049025ABM,456,394,39,466,435,17,373,351,22,376,363,13,372,351,18,499,464,29
39017009AJY,679,165,498,690,221,435,561,190,371,578,216,362,576,196,364,699,253,435
39017009AEH,479,140,318,487,171,291,346,129,217,362,144,218,359,125,221,473,190,270
39133067AGS,566,182,341,576,192,359,459,207,252,460,227,233,460,174,262,685,253,428
39055028ABO,494,121,346,497,136,343,417,141,276,420,171,249,426,141,271,566,149,410
39113057AYP,575,206,344,576,258,285,463,234,229,467,257,210,470,225,234,627,315,298
39035018ARJ,284,245,23,307,289,14,255,235,20,258,244,14,259,230,17,301,283,16
39035018CWT,580,369,186,613,448,143,459,366,93,462,372,90,467,351,111,666,483,180
39035018CAW,535,462,51,568,522,35,414,383,31,415,393,22,417,386,26,516,473,36
39113057AJB,1024,335,646,1043,457,543,804,373,431,814,437,377,816,370,420,1062,501,540
39017009AEU,456,262,179,462,327,112,313,240,73,322,252,70,318,225,71,334,257,71
39035018BGD,467,289,136,506,348,142,373,271,102,384,284,100,380,257,109,533,344,188
39035018AFQ,502,158,323,521,209,285,411,183,228,416,197,219,421,184,226,550,243,304
39085043AFS,794,177,591,805,253,527,669,228,441,671,260,411,677,235,420,917,340,567
39133067AAW,519,304,174,533,373,120,452,350,102,459,372,87,457,345,97,565,423,132
39043022ACB,464,159,271,460,182,266,372,160,212,377,188,189,380,160,205,488,191,293
39017009AIP,791,227,540,786,302,447,640,268,372,668,314,354,661,280,362,844,410,426
39159080ABQ,322,70,238,328,76,234,257,66,191,258,83,175,259,70,180,380,92,281
39017009ADY,517,88,418,518,145,360,454,131,323,461,156,305,463,129,327,552,173,377
39167084ABL,411,131,261,430,95,319,319,88,231,318,109,209,321,88,222,466,107,354
39095048AQN,703,299,370,714,337,332,546,309,237,546,338,208,544,286,235,692,348,332
39095048AMG,687,282,360,701,356,303,595,362,233,599,412,187,606,363,213,754,440,298
39061031BHT,577,59,498,582,95,458,512,102,410,512,129,383,518,102,399,631,167,457
39061031BLC,329,137,175,337,166,154,242,131,111,246,145,101,247,125,108,340,197,140
39061031AWI,845,158,662,857,235,584,708,217,491,715,273,442,713,201,494,941,302,630
39061031AAA,549,140,388,542,240,277,471,212,259,472,239,233,473,210,248,588,295,284
39061031ARC,685,207,451,691,289,351,603,300,303,604,325,279,613,283,303,773,385,376
39095048AQG,652,328,285,668,338,263,530,331,199,547,369,178,544,321,190,726,373,338
39061031ALG,843,439,351,856,503,310,672,461,211,671,487,184,674,438,214,894,574,307
39167084AAZ,740,279,440,743,276,432,583,228,355,596,286,310,604,230,355,807,307,487
39077039AAR,490,140,314,490,151,309,407,178,229,410,219,191,411,163,221,562,205,343
39049025AGJ,481,293,169,487,325,139,436,280,156,440,316,124,437,286,139,575,416,151
39049025AVX,711,282,413,709,389,295,686,341,345,687,401,286,691,368,310,768,448,312
39049025APD,800,332,422,831,418,368,596,334,262,606,388,218,611,368,225,893,453,420
39063032ACW,564,156,375,567,194,334,437,156,281,437,194,243,442,159,267,602,222,365
39049025BCC,425,144,257,439,156,261,355,149,206,360,172,188,360,147,198,480,174,303
39035018CCT,696,250,414,735,326,388,572,306,266,578,331,247,580,275,292,765,351,410
39035018BNM,371,332,24,379,360,13,333,315,18,334,315,19,336,304,24,362,338,20
39035018BHC,667,368,266,693,458,205,637,456,181,637,473,164,645,438,189,829,543,281
39035018BVD,942,260,641,990,379,588,852,363,489,854,405,449,875,358,500,1134,458,664
39035018BHO,466,306,122,512,384,111,306,222,84,312,239,73,311,214,80,463,315,136
39035018ARH,348,319,18,374,363,4,260,248,12,263,257,6,261,248,9,301,291,6
39035018BJX,903,616,255,920,756,145,796,665,131,799,688,111,803,664,131,933,798,126
39035018BUK,611,367,213,637,430,181,458,355,103,461,356,105,461,333,120,606,437,157
39035018ARZ,421,388,24,453,439,11,296,282,14,306,298,8,306,289,13,398,380,14
39035018AJY,248,234,8,268,266,1,194,185,9,190,186,4,194,183,8,233,221,10
39035018BKO,798,603,152,813,685,92,760,677,83,763,688,75,765,659,88,840,749,79
39045023ADO,619,185,408,625,236,357,543,219,324,549,263,286,552,225,318,678,322,341
39035018CVQ,873,288,549,901,400,459,742,376,366,747,396,351,755,353,385,961,447,503
39035018BUZ,579,179,378,600,254,319,484,241,243,492,270,222,493,228,257,642,289,342
39035018CIJ,522,225,253,545,263,251,410,244,166,416,265,151,417,234,169,624,308,309
39035018CNV,866,574,272,905,668,219,811,658,153,817,688,129,817,658,152,1023,812,204
39035018AAS,816,260,538,808,400,367,725,391,334,741,430,311,745,379,351,891,527,353
39035018AVD,438,410,14,453,437,12,318,305,13,323,312,11,328,313,11,393,372,18
39009005AAW,578,343,197,647,430,164,436,346,90,455,369,86,458,350,83,356,278,69
39035018AYR,295,197,71,311,230,56,148,126,22,147,128,19,149,125,17,199,151,37
39101051ABI,285,87,174,299,106,175,230,94,136,227,106,121,233,88,133,290,111,172
39101051ABB,539,190,300,558,203,322,351,158,193,354,184,170,353,160,178,578,186,372
39035018DCM,622,173,432,653,226,410,539,218,321,546,251,295,549,218,321,678,259,415
39035018CWX,770,380,367,783,531,229,676,469,207,678,487,191,682,454,219,879,582,288
39035018ABG,879,566,292,885,710,164,836,702,134,839,696,143,838,653,176,970,795,173
39035018BSY,573,355,186,603,406,179,448,328,120,443,341,102,449,320,119,560,387,171
39035018CDU,754,336,378,792,425,336,627,363,264,640,412,228,643,347,277,816,445,358
39101051ACK,304,79,208,315,83,220,285,95,190,287,112,175,291,97,186,335,110,222
39045023ACZ,563,128,420,554,146,386,451,137,314,462,187,275,465,147,302,580,176,393
39043022ADB,959,288,620,975,371,560,799,323,476,802,393,409,797,316,459,1029,391,623
39043022AEK,539,335,175,551,364,155,425,292,133,433,336,97,432,303,112,562,359,192
39045023ACS,617,179,398,616,181,404,456,157,299,467,205,262,473,162,288,692,199,483
39057029AAX,516,112,377,517,159,303,428,155,273,426,195,231,438,143,277,564,228,319
39057029AFP,489,105,359,481,141,329,397,110,287,401,150,251,407,114,280,509,159,343
39061031AQA,714,332,345,725,405,279,589,362,227,597,382,215,600,349,231,758,461,276
39057029ACW,626,150,446,630,214,376,498,187,311,498,216,282,504,182,305,667,252,398
39057029AHX,517,81,408,520,122,379,404,107,297,412,160,252,415,98,298,569,132,427
39061031BIC,516,77,416,525,125,378,599,150,449,595,174,421,608,138,457,948,268,659
39061031AZU,966,263,680,937,382,504,841,403,438,847,433,414,855,376,456,1064,535,503
39025013ABY,392,91,286,394,142,223,350,129,221,353,143,210,353,129,216,406,160,240
39113057AMM,623,188,404,625,233,350,509,217,292,516,272,244,516,220,272,677,308,355
39113057AXQ,1011,272,709,1013,373,604,896,348,548,905,393,512,908,340,550,1058,475,573
39113057ALO,874,251,587,877,340,483,740,301,439,743,362,381,748,299,426,900,411,472
39165083AAO,818,161,613,834,224,562,689,211,478,703,234,469,706,208,483,1052,284,749
39017009ACD,379,97,265,390,116,264,316,103,213,320,125,195,322,97,221,409,133,271
39017009AGX,865,200,642,872,287,543,742,255,487,762,299,463,759,258,487,999,390,598
39017009AFT,828,210,604,845,278,536,674,249,425,693,276,417,689,245,430,884,324,546
39113057AKZ,1121,350,733,1133,440,623,917,449,468,925,505,420,936,432,458,1210,546,636
39105053AAP,291,77,205,300,65,229,221,45,176,221,69,152,220,52,164,318,64,251
39155078ACG,492,253,196,503,299,174,272,167,105,274,177,97,277,158,110,423,227,192
39093047ACO,946,402,492,981,483,449,808,456,352,840,535,305,843,446,363,1056,561,477
39049025ATP,729,233,459,737,301,413,686,257,429,689,331,358,695,302,382,881,365,501
39049025BHF,559,204,335,569,244,302,495,237,258,495,251,244,495,241,246,627,300,323
39049025BMC,322,154,148,328,183,123,320,215,105,325,235,90,327,219,102,442,306,128
39049025ARC,788,374,358,795,446,298,630,388,242,639,439,200,647,406,225,863,557,287
39049025AJE,601,444,136,623,492,119,466,351,115,470,381,89,469,366,97,595,461,128
39113057ASX,831,218,592,845,283,528,705,254,451,707,297,410,713,246,450,852,314,519
39041021ACX,855,247,580,835,357,442,776,297,479,772,352,420,785,319,458,948,448,491
39041021AAH,653,197,422,675,270,366,513,214,299,512,251,261,524,229,287,688,324,351
39041021ACC,839,271,548,845,392,423,779,340,439,775,422,353,788,383,387,925,506,404
39023012ADF,539,104,407,529,150,355,454,147,307,460,187,273,463,132,313,602,158,427
39155078ABL,643,327,283,659,357,275,505,315,190,530,359,171,521,318,188,676,352,317
39165083AEZ,355,87,249,363,124,219,269,94,175,278,113,165,281,102,174,388,131,251
39049025AHD,642,494,129,666,543,103,513,423,90,522,439,83,521,422,87,678,550,114
39049025AAH,639,398,218,633,468,127,604,438,166,610,497,113,613,454,143,678,540,128
39049025AUJ,742,446,265,780,523,223,523,345,178,526,368,158,526,343,169,751,536,203
39049025BBX,641,371,232,660,425,208,446,300,146,450,325,125,448,310,130,613,363,242
39049025BMI,417,243,152,430,276,138,358,250,108,362,267,95,362,260,93,508,363,140
39153077AQN,624,285,299,640,321,291,457,270,187,476,298,178,470,250,199,698,367,318
39141071ABC,405,175,196,420,208,179,270,136,134,266,153,113,269,134,125,409,170,237
39141071ACT,445,118,315,447,148,283,353,118,235,351,156,195,354,111,236,465,151,313
39153077ANC,704,214,468,739,295,410,536,235,301,555,269,286,556,235,307,920,409,502
39153077AIP,519,358,124,535,392,130,416,314,102,420,327,93,419,325,90,545,385,151
39153077BAJ,650,278,329,665,335,295,523,305,218,532,332,200,532,302,218,703,414,282
39153077ALY,574,250,285,585,287,261,441,254,187,448,279,169,455,234,190,681,363,304
39153077BBE,390,165,206,402,197,190,329,179,150,337,199,138,334,171,153,440,227,211
39153077BAE,453,185,228,470,213,230,342,181,161,348,209,139,341,186,141,493,219,267
39153077AXC,656,223,413,662,320,321,600,304,296,612,336,276,610,297,301,715,383,327
39087044AAO,200,97,100,199,92,92,156,81,75,162,94,68,161,82,77,209,87,120
39093047AGS,716,302,364,732,327,345,526,272,254,545,324,221,548,271,259,841,394,428
39093047ABI,982,324,630,981,447,498,814,401,413,833,456,377,836,378,449,1085,548,530
39153077ACC,550,507,29,560,542,14,439,416,23,449,435,14,447,422,16,521,496,24
39153077AYR,535,465,46,555,509,37,434,393,41,440,414,26,438,402,31,520,459,54
39153077AYW,386,342,26,400,367,24,311,286,25,318,297,21,310,287,17,391,354,33
39151076AOC,585,110,443,590,128,433,489,131,358,497,158,339,501,132,360,651,139,503
39049025AHJ,512,439,49,529,485,31,358,331,27,363,351,12,362,337,16,517,479,31
39049025AJY,661,505,142,694,556,114,538,429,109,547,465,82,550,447,88,765,630,123
39049025BIX,499,170,311,512,210,273,392,188,204,395,221,174,391,201,182,580,261,306
39049025AEC,714,427,263,700,503,167,682,473,209,685,537,148,687,505,175,763,580,170
39145073AAR,610,219,381,614,233,372,499,183,316,501,238,263,505,194,304,605,243,356
39153077AAJ,663,438,184,676,485,154,610,489,121,618,508,110,617,483,114,757,581,160
39065033AAO,255,58,185,257,68,177,232,74,158,234,98,136,235,68,161,273,69,199
39133067ACR,633,156,435,655,159,473,518,173,345,524,197,327,526,164,334,718,173,539
39153077ANG,452,160,268,474,197,266,383,185,198,400,209,191,396,181,205,528,227,298
39153077BBZ,706,271,391,717,320,362,616,294,322,622,313,309,618,290,313,756,363,382
39153077AQG,556,214,313,587,256,299,479,262,217,504,290,214,510,258,235,602,279,316
39151076AOQ,859,260,561,877,325,524,776,325,451,780,372,408,786,297,470,1028,402,613
39151076AEQ,582,221,308,586,249,293,430,219,211,434,235,199,437,206,206,607,233,361
39029015ABB,638,169,436,649,203,407,503,204,299,513,236,277,517,202,305,722,258,450
39099050AKN,545,231,289,564,261,277,441,223,218,451,265,186,452,238,207,604,287,309
39085043ABI,743,290,399,771,360,376,637,314,323,636,349,287,647,299,328,871,418,437
39055028ACG,585,144,414,584,178,384,482,169,313,486,197,289,482,165,297,672,220,450
39151076ABN,803,355,396,815,412,357,616,370,246,624,404,220,624,362,236,844,443,383
39017009AIJ,971,278,668,977,376,573,857,322,535,878,365,513,881,330,543,1255,534,710
39017009AGQ,843,186,629,866,263,580,758,280,478,775,327,448,781,278,480,1300,499,774
39017009AGM,953,269,649,957,341,571,817,323,494,836,358,478,840,316,506,1157,470,669
39085043AAO,845,304,494,887,335,520,704,342,362,719,374,345,721,329,378,939,366,563
39049025AYI,370,137,227,350,182,158,342,174,168,342,203,139,342,182,153,422,272,147
39041021AEQ,772,210,549,786,293,460,708,234,474,707,297,410,715,271,429,886,376,494
39041021ACQ,731,199,521,735,297,416,681,240,441,685,299,386,690,252,434,945,397,540
39041021AFI,839,198,617,852,252,547,704,229,475,702,290,412,714,236,457,1001,357,625
39133067AAL,718,183,506,712,262,430,589,264,325,597,287,310,598,247,339,761,324,428
39049025BHM,996,495,450,1016,586,352,752,479,273,761,534,227,765,487,253,1058,696,347
39017009AKQ,838,174,633,838,220,584,644,210,434,665,227,438,668,194,452,911,287,613
39071036AAI,582,146,415,592,180,391,451,153,298,454,181,273,456,151,292,606,172,422
39153077AGP,666,438,195,676,497,157,591,444,147,599,463,136,596,445,139,750,570,165
39153077BCB,705,260,415,726,312,378,594,278,316,610,328,282,611,294,299,730,345,377
39153077AMH,585,252,288,602,291,286,456,265,191,464,287,177,462,259,188,652,323,320
39153077AYO,513,304,177,522,326,176,401,273,128,414,292,122,409,273,128,598,374,216
39153077AQQ,581,222,339,600,288,291,547,296,251,554,318,236,552,282,261,701,381,317
39153077ATA,636,222,372,651,246,362,502,222,280,523,252,271,525,227,281,702,278,416
39167084ACB,473,134,316,481,127,343,348,95,253,361,136,225,361,91,264,547,137,406
39061031AAY,973,335,583,995,426,498,796,442,354,812,473,339,821,419,377,1049,554,477
39061031BDK,260,135,114,263,168,83,218,128,90,217,133,84,218,130,84,258,168,87
39061031BLE,685,386,279,693,430,247,415,277,138,559,390,169,395,263,125,742,488,242
39061031BEJ,1034,188,807,1046,280,714,824,280,544,835,333,502,841,239,568,1152,398,730
39061031ABD,1013,420,533,1020,562,394,847,521,326,855,558,297,862,495,338,1116,688,410
39127064ABU,305,64,220,303,73,217,244,78,166,248,92,156,249,81,161,362,86,271
39077039AAW,401,137,230,407,161,217,288,139,149,287,160,127,287,124,154,446,165,272
39061031ANE,828,592,210,836,655,161,715,591,124,716,603,113,718,589,123,848,698,141
39035018AOU,280,252,15,310,305,1,167,161,6,168,164,4,167,162,4,167,155,8
39035018BBU,569,249,285,577,312,243,494,300,194,498,334,164,499,313,175,639,381,246
39035018CPS,840,273,516,885,372,477,726,345,381,738,393,345,744,346,376,974,437,523
39035018CKH,739,261,422,789,332,431,605,304,301,615,326,289,617,286,306,860,350,499
39035018COM,788,308,453,801,418,367,708,380,328,714,410,304,717,379,325,867,503,360
39103052ABQ,751,234,470,763,301,423,569,268,301,581,316,265,583,251,305,856,381,456
39103052ABM,838,293,515,844,354,449,702,327,375,723,370,353,727,315,397,914,423,476
39063032ABJ,400,109,250,414,138,242,273,118,155,274,137,137,274,110,140,392,155,226
39045023AEO,592,223,355,589,269,294,483,244,239,490,281,209,496,255,232,614,308,296
39035018AWY,419,359,43,447,405,32,300,277,23,301,275,26,302,265,31,374,325,44
39035018AIO,632,581,33,655,626,24,535,505,30,538,522,16,534,488,33,604,574,27
39035018ADF,403,317,64,415,346,63,350,306,44,350,315,35,353,303,39,456,379,75
39035018BXZ,430,322,72,453,369,55,389,328,61,393,328,65,394,312,60,589,458,119
39061031BGD,767,228,508,782,298,434,677,304,373,681,327,354,686,291,367,856,411,425
39061031AFP,622,521,80,647,609,30,548,516,32,549,523,26,548,509,30,653,607,42
39061031ATB,673,189,470,675,309,331,607,279,328,610,305,305,615,281,320,718,383,324
39061031AND,856,556,271,867,662,168,776,629,147,780,659,121,780,617,145,906,737,156
39119060ADG,693,112,558,696,150,516,565,147,418,565,198,367,574,145,419,790,183,596
39119060ABG,908,175,710,899,245,612,814,243,571,806,337,469,820,230,574,982,298,664
39033017ABO,437,114,295,448,119,312,283,90,193,295,105,190,297,96,192,469,119,341
39061031ASK,747,160,578,735,294,412,675,243,432,677,268,409,678,229,437,851,371,468
39061031ARM,695,469,185,720,573,124,552,455,97,560,469,91,559,450,100,703,565,132
39061031AXQ,570,329,218,574,382,175,495,355,140,496,357,139,498,349,140,588,416,163
39061031BIH,554,79,458,554,101,434,467,108,359,468,137,331,472,106,354,612,137,465
39061031BGP,825,158,634,844,222,578,668,215,453,669,243,426,674,187,466,864,272,583
39061031BIP,799,161,605,801,249,512,650,229,421,643,253,390,658,216,422,868,342,518
39061031BNO,906,232,658,907,339,526,832,345,487,838,384,454,840,331,494,1121,531,572
39035018CFJ,817,224,562,849,265,561,672,237,435,693,267,426,690,237,443,907,315,587
39035018BPD,567,402,140,581,451,117,452,359,93,454,370,84,454,343,97,600,469,126
39035018BON,583,427,132,608,489,103,453,369,84,463,396,67,459,368,81,602,492,104
39035018CFE,763,210,514,808,294,478,631,262,369,652,304,348,652,253,379,814,306,498
39035018ALB,456,415,21,484,471,7,355,341,14,361,350,11,354,339,9,420,406,12
39035018BKG,758,641,85,788,711,47,660,615,45,660,622,38,664,610,44,806,730,69
39035018DBK,706,217,452,717,312,365,609,321,288,618,356,262,627,304,299,780,391,383
39035018BRP,541,251,263,560,332,200,464,305,159,472,326,146,474,296,161,630,402,214
39035018AFB,896,243,623,882,342,504,791,332,459,792,356,436,794,319,464,1015,439,566
39113057AGZ,412,335,55,424,386,25,329,302,27,337,322,15,337,305,30,416,374,31
39009005AAP,597,473,90,619,516,64,487,439,48,505,461,44,508,443,44,585,534,45
39089045ACQ,1068,260,766,1071,269,756,867,256,611,876,297,579,873,259,597,1235,344,868
39167084AAJ,727,310,383,750,286,429,611,262,349,622,319,303,624,254,354,801,335,454
39017009AKA,763,164,579,757,250,468,677,254,423,685,269,416,691,243,437,868,332,517
39017009AGT,786,153,613,808,233,545,592,183,409,614,218,396,608,181,411,879,309,560
39061031BDC,884,413,432,891,451,400,661,410,251,666,421,245,665,394,256,907,514,381
39173087ABK,608,273,297,619,319,252,443,267,176,442,294,148,446,271,159,649,346,280
39017009ABQ,609,141,445,619,176,412,469,156,313,491,180,311,491,167,314,652,220,420
39057029ABA,625,138,465,632,195,409,554,199,355,549,236,313,560,192,356,642,238,389
39061031BNR,957,318,609,957,431,469,801,386,415,803,402,401,808,371,413,1070,585,462
39061031ALR,304,214,71,305,257,43,211,174,37,211,176,35,213,165,42,283,230,48
39061031BOQ,506,481,16,516,499,11,346,338,8,342,335,7,343,326,14,460,442,10
39061031BAV,961,121,821,963,193,726,866,206,660,858,256,602,874,192,671,1024,276,734
39021011AAB,481,156,291,489,185,274,363,145,218,364,179,185,367,155,197,506,216,283
39095048AFN,971,596,339,973,665,273,885,647,238,890,691,199,897,632,246,1067,742,317
39099050APJ,741,231,475,751,248,475,610,226,384,610,283,327,618,258,344,854,262,585
39099050AHT,502,249,232,517,276,226,367,207,160,369,245,124,368,215,135,543,283,247
39093047AAS,655,169,474,662,234,394,542,222,320,562,252,310,566,203,352,774,317,446
39095048ARE,571,363,178,585,431,125,391,313,78,394,320,74,397,299,86,644,480,152
39095048ARH,678,505,150,695,553,118,516,432,84,519,456,63,521,431,76,676,540,126
39095048AJF,313,161,135,317,187,105,257,173,84,264,192,72,264,175,84,392,259,124
39139070ACE,718,205,472,725,216,478,499,176,323,507,196,311,514,175,317,748,228,508
39095048AVJ,673,168,493,685,233,426,555,207,348,568,237,331,573,213,350,770,315,446
39095048AGP,496,266,203,516,356,131,382,273,109,388,295,93,393,267,101,506,356,142
39095048ATE,694,324,333,704,344,302,505,284,221,503,317,186,512,288,207,708,364,325
39095048AIL,469,371,77,482,411,57,341,300,41,345,310,35,343,292,45,409,338,63
39049025ANB,714,383,288,723,446,237,630,416,214,636,460,176,642,424,196,842,565,256
39151076AFI,661,221,423,660,279,357,550,239,311,560,272,288,564,240,313,722,330,381
39173087ACC,571,222,317,592,251,313,468,225,243,474,267,207,479,224,233,641,267,360
39057029ADZ,430,158,251,438,173,229,330,161,169,334,180,154,335,151,167,445,213,219
39049025BFX,732,274,446,747,385,335,811,425,386,819,480,339,821,435,370,1147,669,469
39049025BLP,658,247,396,667,345,297,496,262,234,496,302,194,505,270,229,671,392,273
39095048APP,645,347,272,658,401,216,531,373,158,532,403,129,535,349,172,669,448,209
39015008ACP,628,115,492,639,157,459,444,146,298,450,180,270,443,125,304,667,151,502
39003002AFO,543,123,395,539,149,367,457,142,315,455,161,294,453,132,310,581,163,410
39165083AAQ,673,145,507,686,185,473,518,151,367,550,178,372,540,155,375,749,232,508
39165083AFY,951,183,722,961,248,655,752,230,522,768,263,505,771,227,515,1054,342,687
39155078AHZ,762,459,275,778,498,262,619,423,196,636,475,161,627,417,193,831,539,283
39049025AQY,695,287,382,707,362,301,629,349,280,633,402,231,641,369,255,772,441,319
39025013AIB,797,166,599,805,229,538,713,232,481,710,252,458,713,223,465,922,299,604
39025013AAO,404,97,284,405,124,255,371,135,236,371,151,220,373,125,230,839,272,550
39025013ABT,610,114,477,613,171,425,525,148,377,523,169,354,523,135,373,661,200,450
39093047AAQ,906,333,544,907,441,443,844,444,400,865,502,363,872,446,412,1141,598,535
39049025BKN,619,230,359,620,251,318,499,227,272,497,255,242,508,234,261,669,314,341
39049025AAB,1173,567,594,1163,789,336,1079,673,406,1086,775,311,1092,722,349,1295,934,355
39087044ABX,246,62,177,256,40,211,189,45,144,188,57,131,197,48,144,271,41,228
39109055AAP,486,90,381,496,146,335,368,115,253,372,148,224,378,116,253,488,146,339
39049025BJP,560,168,369,561,216,321,506,223,283,505,256,249,512,232,270,632,299,321
39095048ALF,392,356,21,401,389,9,266,258,8,275,273,2,276,255,13,342,331,8
39025013ACQ,338,62,261,335,88,225,295,100,195,294,103,191,295,89,196,385,120,257
39165083AFK,554,80,454,565,107,440,488,98,390,503,122,381,495,97,393,649,152,490
39003002AAJ,547,166,346,558,199,328,400,174,226,399,212,187,399,157,220,579,207,363
39003002AAQ,650,210,410,664,247,385,475,200,275,481,251,230,485,193,278,675,282,376
39041021ACS,746,135,600,726,243,471,687,221,466,689,272,417,693,229,460,871,354,505
39141071ABQ,235,52,172,238,59,172,183,54,129,184,56,128,189,49,133,264,50,209
39141071ABY,371,107,237,382,126,245,301,102,199,304,120,184,306,105,189,507,114,384
39061031ANB,340,209,105,347,260,73,283,232,51,285,241,44,286,226,51,389,316,65
39049025AZW,488,167,309,498,193,287,422,171,251,417,193,224,428,176,247,552,230,317
39155078AFR,828,301,494,851,330,488,664,310,354,672,356,316,671,298,357,885,317,555
39047024AAQ,258,87,153,262,104,143,181,69,112,180,82,98,182,66,105,295,76,213
39049025BBN,569,229,293,589,263,298,410,199,211,409,218,191,414,189,207,624,288,324
39043022ACW,528,153,350,540,180,336,425,164,261,435,198,237,431,167,247,593,191,393
39049025AQV,548,267,256,552,303,221,467,275,192,472,312,160,474,289,171,600,381,212
39049025ARI,884,292,565,889,460,387,841,407,434,851,481,370,854,426,417,1090,625,453
39023012ABE,491,269,179,497,313,155,320,215,105,329,233,96,324,208,102,492,296,175
39007004AEI,363,156,185,366,159,191,257,123,134,264,151,113,265,125,122,387,167,212
39153077AAG,760,254,478,773,324,426,700,324,376,724,368,356,723,320,391,819,394,412
39041021AFC,752,175,569,753,278,445,660,244,416,656,282,374,662,258,399,883,369,501
39041021ADG,755,173,573,750,269,443,684,256,428,680,314,366,687,276,401,882,416,457
39037019AAC,475,80,384,478,119,347,401,116,285,407,151,256,409,115,286,540,141,388
39051026ABI,425,142,251,432,155,227,329,142,187,324,171,153,331,142,175,453,168,270
39099050AHF,610,255,330,619,278,320,504,241,263,506,307,199,504,270,221,643,267,367
39099050AMM,522,288,207,541,298,215,426,275,151,438,306,132,445,291,137,548,307,229
39133067AFY,624,186,408,659,207,428,513,197,316,523,214,309,527,202,313,704,216,485
39133067AGH,207,70,115,209,82,113,168,83,85,168,97,71,168,88,72,251,91,153
39099050AHY,491,267,193,500,286,193,398,256,142,398,287,111,398,260,126,540,298,234
39155078AEV,486,151,317,498,171,302,390,159,231,394,177,217,398,158,229,496,178,317
39025013AHU,934,167,747,935,275,620,842,242,600,848,280,568,850,245,592,1138,389,728
39049025AXK,612,363,227,628,379,220,460,304,156,470,353,117,469,308,146,651,429,207
39049025AMS,642,306,296,657,318,308,454,244,210,457,279,178,458,249,189,724,349,355
39049025ANP,893,514,332,905,603,254,729,511,218,733,551,182,738,533,191,981,680,270
39113057AVP,770,192,545,780,253,475,605,227,378,614,280,334,608,218,368,836,327,491
39113057AAT,980,231,726,974,332,590,865,324,541,875,388,487,875,316,535,1035,453,571
39085043AFY,747,236,446,781,278,457,669,284,385,671,342,329,683,287,374,929,357,558
39085043ADT,474,189,246,497,230,238,363,182,181,365,205,160,367,174,179,574,266,295
39151076AIH,715,164,513,720,198,496,595,184,411,600,208,392,605,187,405,804,217,576
39173087AED,763,491,236,820,541,209,147,119,28,150,124,26,149,119,22,76,56,19
39017009AAQ,539,159,353,548,179,335,413,167,246,427,187,240,427,168,249,583,224,350
39155078AEC,533,461,44,557,509,33,333,310,23,340,321,19,333,304,23,411,370,37
39049025ARD,684,321,309,688,393,233,604,413,191,610,434,176,616,410,192,702,466,216
39049025ABK,530,451,51,560,519,26,420,381,39,427,404,23,426,386,31,533,481,45
39049025BFO,667,376,269,671,460,181,600,400,200,604,455,149,608,418,172,713,539,167
39153077AVG,434,156,256,444,196,226,404,190,214,408,202,206,408,192,211,483,224,255
39113057ACC,1060,412,601,1073,497,527,873,445,428,885,491,394,882,431,423,1153,599,533
39113057AUN,423,329,81,423,378,35,321,288,33,325,299,26,325,285,35,393,355,34
39049025AIU,460,401,39,467,423,30,327,303,24,330,311,19,330,305,19,471,415,44
39049025ALA,540,443,65,582,524,51,370,320,50,374,336,38,376,325,42,566,455,103
39049025AQU,894,427,430,911,534,334,733,436,297,733,471,262,739,457,266,1015,641,356
39049025AYO,654,226,388,644,277,303,588,276,312,589,329,260,591,288,281,735,398,322
39017009AFX,601,124,457,608,157,419,456,128,328,469,153,316,465,120,327,654,191,455
39017009AFW,618,129,473,632,169,438,513,159,354,530,188,342,534,169,349,660,201,454
39061031AWP,528,224,281,532,261,244,438,244,194,437,260,177,443,230,201,576,313,255
39049025AWB,757,244,501,758,348,377,668,267,401,663,326,337,673,293,372,837,425,402
39049025ANI,508,306,183,520,349,146,412,291,121,421,316,105,418,292,112,498,344,147
39035018AZI,592,356,208,608,451,122,547,440,107,555,464,91,561,439,108,855,658,182
39113057ADD,313,273,25,325,312,6,227,222,5,229,225,4,228,219,8,248,241,5
39035018AAQ,732,244,465,734,390,309,652,359,293,650,382,268,657,338,307,835,490,342
39035018CZT,914,472,420,929,608,289,866,588,278,866,616,250,876,568,292,1070,740,322
39043022ACC,333,108,196,336,122,187,272,135,137,271,149,122,271,135,119,361,137,212
39017009AJS,810,178,587,811,232,534,643,198,445,659,220,439,657,195,445,869,288,555
39035018BXP,728,447,234,742,537,170,612,488,124,615,505,110,627,479,128,866,656,197
39035018CHM,754,311,388,786,361,386,578,340,238,580,363,217,590,314,255,871,420,436
39157079ADB,421,100,304,427,131,271,332,110,222,334,131,203,335,113,209,444,157,275
39113057AYI,1013,219,760,1014,354,619,913,340,573,913,376,537,916,315,587,1184,508,664
39157079ACE,579,137,412,584,155,401,484,153,331,487,183,304,492,160,315,627,183,434
39133067AGL,760,523,200,800,579,175,283,250,33,287,255,32,289,238,32,250,197,46
39085043AAA,651,273,323,693,320,329,474,258,216,484,290,194,483,248,208,722,323,384
39043022ADU,502,153,308,507,177,299,422,180,242,426,206,220,425,172,232,555,198,352
39017009AGG,81,16,57,80,20,57,54,19,35,60,19,41,57,20,35,88,23,65
39095048AOC,320,203,93,331,226,78,211,172,39,213,174,39,213,160,44,292,180,106
39095048AMM,743,288,436,749,354,361,651,344,307,657,387,270,660,341,303,778,402,365
39061031AZY,417,83,321,411,149,228,379,156,223,378,181,197,384,143,224,451,214,229
39095048AJA,648,342,250,671,401,214,467,322,145,469,351,118,472,310,132,585,381,192
39061031AUS,556,430,103,567,482,67,458,409,49,461,417,44,460,402,47,558,495,55
39061031AQP,599,480,90,619,547,57,354,312,42,356,323,33,358,297,46,499,446,44
39061031BJS,926,327,572,911,496,355,813,451,362,821,485,336,822,443,352,1012,625,372
39049025APO,827,289,515,819,423,353,759,388,371,770,456,314,769,411,340,937,541,384
39063032ABM,441,105,315,454,131,290,326,123,203,333,153,180,337,119,207,479,160,313
39103052AEX,776,231,512,792,302,466,663,288,375,663,331,332,673,266,393,891,373,506
39109055AAM,537,103,401,540,157,364,383,118,265,391,155,236,391,112,264,596,163,425
39103052ADA,1035,357,623,1044,430,566,828,409,419,851,453,398,848,392,437,1166,497,655
39103052ABZ,629,163,433,642,208,397,501,201,300,506,219,287,510,194,301,751,279,452
39077039AAH,748,255,438,752,296,421,606,278,328,612,326,286,615,273,313,916,375,523
39077039ABI,470,93,359,475,116,339,375,105,270,381,135,246,380,107,264,526,139,381
39035018CQZ,769,464,291,772,609,148,730,599,131,734,607,127,735,564,168,841,697,139
39035018AQD,669,556,87,683,603,55,586,533,53,583,532,51,593,528,51,701,635,59
39035018BAI,306,214,69,342,265,68,145,116,29,146,121,25,147,111,31,290,187,100
39035018AWS,627,497,101,651,579,59,524,478,46,525,486,39,529,472,48,599,533,62
39081041AEC,92,24,60,94,23,68,59,27,32,62,29,33,60,19,36,90,21,67
39035018AZG,193,130,45,210,165,37,161,132,29,167,143,24,165,127,28,230,166,62
39035018DCQ,436,358,55,457,403,42,369,328,41,378,346,32,378,324,43,444,393,47
39033017ABM,390,98,263,401,112,265,279,100,179,292,118,174,291,102,179,428,122,301
39045023ABV,951,238,672,968,285,652,761,241,520,769,304,465,778,262,504,1065,342,713
39035018CGT,358,146,182,374,193,164,276,173,103,286,193,93,285,167,107,443,242,196
39035018CPE,687,296,364,714,382,296,632,412,220,633,427,206,638,385,244,752,426,319
39035018CYP,661,248,390,685,334,332,566,298,268,573,328,245,577,292,273,748,395,351
39035018DCO,678,218,420,691,257,417,593,267,326,597,301,296,598,246,342,743,268,462
39009005AAI,455,287,156,463,330,113,416,292,124,430,321,109,431,300,120,526,389,128
39035018BCW,457,239,174,484,289,166,381,247,134,383,269,114,382,243,124,549,339,207
39019010AAQ,607,137,440,630,194,415,475,158,317,483,195,288,484,154,317,669,179,477
39035018BOT,761,464,267,782,539,215,664,487,177,671,523,148,681,472,187,824,608,210
39045023ACY,574,124,422,574,125,429,439,90,349,443,141,302,445,100,337,652,148,494
39101051ACX,422,99,309,426,116,294,348,96,252,354,143,211,353,103,243,429,118,306
39101051AAW,370,123,211,385,130,222,250,96,154,248,117,131,247,86,140,390,143,236
39045023ABK,494,186,286,505,238,231,343,175,168,356,216,140,358,190,155,503,298,193
39101051ACH,534,157,357,536,175,337,452,152,300,458,198,260,458,161,276,562,185,367
39061031BMQ,1077,266,788,1067,433,589,896,367,529,899,395,504,897,355,534,1119,536,572
39057029AFE,460,106,334,470,133,317,327,106,221,325,128,197,325,109,205,435,132,290
39057029AAA,834,306,469,855,384,416,651,329,322,657,357,300,659,305,326,977,500,457
39057029ADT,628,210,389,637,253,346,518,209,309,514,235,279,518,206,299,699,316,372
39057029AFT,565,126,425,567,176,376,471,170,301,464,209,255,473,138,326,596,199,388
39117059AAG,351,89,228,352,92,242,254,95,159,258,112,146,258,97,152,437,99,328
39113057AWD,1039,370,637,1050,475,531,811,381,430,823,425,398,825,368,432,1099,539,542
39097049AAA,310,93,193,310,102,184,224,81,143,222,112,110,225,97,122,330,122,203
39097049AAZ,639,197,417,635,229,375,576,203,373,586,263,323,591,227,352,775,277,491
39139070ACD,691,204,458,705,216,471,570,227,343,582,267,315,582,219,346,778,231,538
39113057AAH,889,253,608,872,358,481,805,344,461,810,406,404,816,328,473,942,412,514
39017009AIZ,640,174,443,646,234,376,517,206,311,527,222,305,531,203,315,678,287,383
39017009AEG,441,99,325,449,135,300,337,110,227,352,125,227,351,111,225,474,154,320
39165083ABO,703,97,578,722,109,579,624,126,498,627,147,480,627,117,493,785,139,638
39139070ABC,622,203,378,632,205,397,480,190,290,491,221,270,490,199,274,765,263,497
39113057ATL,792,130,640,800,173,594,651,148,503,663,199,464,660,147,486,855,214,630
39165083AAK,463,89,349,470,116,323,344,101,243,350,119,231,353,90,250,495,135,350
39093047ABH,930,333,562,963,412,487,763,397,366,781,455,326,795,405,364,1036,535,479
39099050ABK,446,230,180,459,243,192,346,206,140,347,237,110,351,221,119,501,236,253
39093047AJA,990,288,641,1011,351,619,886,357,529,901,415,486,914,361,533,1199,439,754
39049025BHS,745,396,310,758,476,247,628,434,194,636,474,162,639,449,170,867,585,264
39049025ACT,826,614,141,843,719,62,730,648,82,734,669,65,736,639,69,1311,1120,162
39113057AWR,637,94,529,638,131,489,555,132,423,556,174,382,560,125,426,661,144,508
39113057AVU,374,117,246,372,150,205,318,125,193,322,153,169,324,123,195,445,213,227
39113057AFR,478,418,38,490,474,10,358,344,14,363,354,9,364,344,16,458,427,22
39041021ACV,518,150,360,522,234,265,467,181,286,468,234,234,467,201,258,566,279,281
39165083AFJ,786,175,588,787,257,481,673,247,426,694,291,403,692,251,424,854,350,491
39089045ABJ,826,204,597,814,264,518,746,217,529,752,289,463,757,241,506,920,335,570
39165083ACJ,869,287,551,889,435,409,784,392,392,796,436,360,803,402,386,1068,567,490
39041021ABF,794,263,508,792,362,386,721,318,403,732,399,333,740,347,372,879,460,407
39025013AAD,611,120,467,614,159,426,582,174,408,583,191,392,582,168,391,838,251,575
39003002ADC,631,100,509,636,126,487,544,122,422,547,184,363,556,118,427,683,157,519
39041021ADC,864,283,556,853,385,426,783,333,450,777,418,359,793,380,401,913,474,422
39025013ACN,621,128,470,625,194,397,564,181,383,563,208,355,570,175,380,690,249,434
39049025ANW,749,341,367,760,456,259,688,449,239,696,502,194,700,461,219,836,559,264
39087044ABW,481,139,323,486,96,382,346,90,256,345,114,231,352,92,251,469,100,359
39049025AQT,796,345,416,775,408,313,713,394,319,716,467,249,724,425,278,866,534,313
39049025AEZ,461,293,132,469,338,109,314,230,84,316,249,67,317,242,68,435,316,113
39151076ADD,487,167,303,494,211,268,428,203,225,437,216,221,434,196,230,491,218,267
39151076ANU,458,122,297,481,142,301,365,141,224,368,170,198,370,134,216,496,149,338
39049025AXE,671,253,394,680,326,319,622,300,322,629,357,272,634,324,296,771,456,297
39049025ALK,331,224,88,333,251,64,255,214,41,257,221,36,255,206,39,394,317,66
39151076AHQ,515,187,302,518,226,275,417,210,207,419,234,185,424,206,197,605,282,315
39145073ADV,396,139,246,395,127,254,324,108,216,324,141,183,326,125,194,423,126,293
39153077AEV,620,298,289,632,331,281,467,271,196,478,291,187,473,264,189,669,371,285
39153077AXI,681,166,498,678,254,394,584,225,359,595,259,336,590,217,362,834,379,440
39153077AAH,627,348,244,651,418,217,502,336,166,521,370,151,516,351,154,732,495,226
39123062ACA,564,160,382,553,196,339,505,202,303,509,250,259,509,198,299,641,269,364
39149075AAM,726,135,554,718,188,497,560,168,392,557,220,337,552,167,363,776,207,554
39015008ACE,609,97,489,612,122,477,457,95,362,464,111,353,472,91,371,690,125,561
39085043AEU,527,204,295,538,238,269,423,211,212,426,245,181,426,193,217,618,276,331
39049025AIZ,556,486,42,594,566,18,421,398,23,425,410,15,424,394,22,596,559,32
39143072AAR,429,138,272,426,169,227,355,146,209,358,180,178,355,142,202,447,175,256
39133067ACP,678,300,329,707,368,301,577,333,244,582,353,229,581,324,234,957,541,400
39153077ABW,439,376,43,454,421,26,296,263,33,298,272,26,300,268,28,373,320,45
39153077ASF,797,307,464,825,403,383,766,429,337,778,458,320,774,425,339,1108,623,471
39153077BBD,605,248,342,630,332,281,574,299,275,599,338,261,594,300,286,738,382,348
39017009AKL,573,111,441,577,135,411,428,106,322,445,133,312,453,121,316,671,169,493
39153077AZB,596,555,23,620,604,11,467,459,8,477,470,7,472,455,11,545,519,22
39153077AXV,623,152,457,624,248,356,553,218,335,566,253,313,562,221,329,695,294,388
39153077AJR,349,159,157,352,183,143,252,136,116,261,155,106,261,147,104,397,190,196
39031016AAK,348,117,205,349,129,201,226,94,132,230,122,108,231,92,128,371,102,256
39167084AAI,525,259,247,543,219,290,375,190,185,377,209,168,385,173,194,615,286,317
39061031AUQ,751,384,338,762,464,266,611,399,212,615,414,201,621,374,227,821,549,257
39061031AJT,450,335,100,456,380,61,412,347,65,415,359,56,412,340,64,485,413,64
39061031AEF,823,296,506,822,481,311,758,422,336,755,459,296,763,415,335,962,606,341
39061031AXJ,827,633,158,851,729,93,708,624,84,705,631,74,708,605,88,1039,871,154
39061031AWD,732,190,488,743,260,438,561,229,332,563,262,301,566,217,330,800,320,462
39061031BNT,390,91,285,382,136,227,326,120,206,329,128,201,333,120,199,406,178,221
39005003AAB,783,197,558,786,255,482,607,203,404,600,255,345,612,186,404,786,299,470
39129065ABW,430,95,313,417,113,293,385,104,281,384,125,259,390,113,271,446,116,322
39057029AIR,460,90,356,462,129,318,401,117,284,403,148,255,405,112,288,488,153,333
39057029ABB,523,130,376,515,187,303,483,183,300,486,205,281,488,170,306,590,244,340
39103052ACE,455,147,283,456,169,262,378,174,204,385,186,199,388,175,201,505,209,288
39103052AEZ,972,177,768,981,255,691,829,263,566,854,302,552,860,249,590,1157,334,815
39119060ADB,635,134,471,640,167,439,502,164,338,504,222,282,510,172,333,708,201,496
39135068AAH,501,107,374,519,138,358,399,123,276,405,150,255,403,114,276,529,145,379
39035018BOP,566,428,111,586,487,84,405,347,58,409,365,44,409,338,64,599,499,88
39035018CWB,668,223,401,700,291,374,574,287,287,581,318,263,585,272,291,755,334,413
39035018CQB,851,260,552,893,363,501,781,358,423,798,397,401,799,329,452,930,373,549
39035018CSM,570,244,318,573,350,202,536,339,197,535,349,186,539,323,209,627,440,183
39035018BHZ,338,201,106,360,234,113,259,197,62,261,201,60,262,183,66,382,243,136
39035018CJV,750,239,472,772,317,435,620,293,327,630,324,306,639,272,345,835,344,483
39035018CVI,720,198,500,729,279,426,614,254,360,624,289,335,629,245,372,761,340,417
39035018BKZ,566,444,91,579,515,49,512,456,56,511,463,48,509,446,53,611,540,64
39035018ANA,366,351,6,390,383,7,275,263,12,281,271,10,283,268,9,361,347,12
39035018CHG,598,313,244,630,335,270,504,325,179,509,343,166,505,317,181,773,444,323
39035018AEY,787,182,580,778,293,457,667,279,388,664,309,355,670,271,391,945,403,534
39035018CGK,881,214,632,905,286,586,726,285,441,741,328,413,750,288,446,1041,371,663
39061031BGM,766,135,610,771,191,543,643,203,440,652,246,406,653,191,441,820,288,516
39061031ARU,752,582,145,762,643,98,614,537,77,617,550,67,619,523,80,784,679,96
39129065ABB,789,198,560,800,203,556,556,152,404,552,167,385,560,156,393,983,234,733
39061031BDN,3,2,1,3,2,1,4,3,1,4,3,1,4,3,1,2,2,0
39061031BBQ,620,274,311,638,338,279,448,254,194,451,266,185,450,229,199,645,352,281
39061031AMO,705,608,71,732,705,16,573,546,27,576,556,20,576,530,36,685,644,31
39061031AYD,1210,545,636,1208,697,448,1117,681,436,1112,718,394,1126,672,435,1314,872,426
39103052AEU,766,208,530,779,244,503,633,254,379,654,272,382,656,234,409,894,315,574
39035018APZ,319,284,27,335,314,16,261,244,17,262,250,12,266,244,18,300,272,27
39035018AXF,292,203,71,322,248,67,193,154,39,195,164,31,195,152,41,303,226,76
39035018BQI,698,490,172,716,530,165,549,425,124,559,447,112,559,421,126,750,583,157
39135068ABN,311,63,226,319,57,234,238,61,177,248,89,159,250,59,170,340,72,265
39035018ABF,921,572,337,939,754,171,928,763,165,924,756,168,930,719,203,1089,879,209
39101051ACB,260,62,184,258,57,191,205,63,142,211,88,123,209,58,147,257,56,198
39017009ALM,442,79,349,443,109,327,348,88,260,364,96,268,364,86,267,470,100,370
39173087AEC,260,153,80,263,165,77,200,158,42,201,168,33,202,160,34,236,177,54
39003002ADI,497,146,323,506,175,303,396,154,242,401,200,201,406,168,229,524,214,305
39017009AJR,959,286,646,971,368,561,771,297,474,799,337,462,797,304,474,1013,466,535
39013007ABU,272,88,174,278,90,169,237,112,125,237,128,109,242,98,142,313,108,201
39095048AHC,463,411,31,483,465,9,333,327,6,339,335,4,343,328,9,404,382,17
39095048ALC,452,407,28,478,463,8,282,274,8,286,282,4,283,267,11,338,320,11
39035018BXW,819,489,288,837,571,233,705,531,174,708,545,163,716,516,183,911,681,222
39035018AMX,368,331,26,399,390,3,246,238,8,248,242,6,251,240,8,351,336,8
39095048AOG,293,182,92,313,214,87,182,122,60,186,135,51,187,117,56,337,209,124
39095048AVU,812,250,549,831,315,479,811,339,472,814,399,415,823,321,482,1194,531,647
39095048ALM,365,315,35,379,352,18,281,261,20,284,274,10,286,260,18,321,300,15
39165083ACA,724,143,555,732,226,469,707,255,452,718,293,425,723,254,450,1066,421,620
39095048ADX,579,259,287,594,307,249,419,248,171,422,285,137,423,248,158,594,296,289
39095048AEE,483,260,184,501,269,186,312,206,106,317,228,89,318,193,110,502,275,211
39095048AGA,536,414,100,553,454,83,271,237,34,273,244,29,276,239,32,307,262,43
39013007ACZ,494,142,331,505,139,339,358,136,222,362,165,197,364,120,238,497,139,350
39099050AQS,390,304,59,409,359,42,229,203,26,230,205,25,232,195,28,338,264,67
39089045AEZ,954,263,651,970,327,604,794,290,504,801,336,465,798,301,478,1218,478,717
39057029AAM,561,136,397,559,186,339,485,195,290,490,243,247,494,188,285,635,244,380
39057029AHS,515,65,439,521,82,417,404,78,326,404,104,300,410,73,324,577,107,461
39143072ACZ,119,25,83,117,33,80,92,30,62,93,41,52,93,32,51,111,32,78
39025013AAC,831,143,664,831,214,585,828,241,587,829,265,564,836,248,571,1113,336,769
39025013AAL,780,126,623,781,154,601,626,166,460,629,188,441,634,158,447,850,177,664
39025013ACS,643,116,492,642,152,454,480,130,350,476,151,325,480,119,341,646,189,448
39087044AAP,130,57,67,135,50,78,96,43,53,95,55,40,97,47,48,140,57,80
39095048ACN,668,231,415,678,293,353,559,282,277,565,307,258,574,273,288,751,398,347
39095048AIM,474,407,42,489,448,24,344,315,29,349,327,22,350,319,21,429,394,29
39143072ADG,689,229,420,707,270,370,525,240,285,534,297,237,536,230,282,745,292,428
39001001AAY,523,112,390,529,111,399,396,110,286,403,129,274,413,106,291,568,112,448
39095048AWA,278,130,135,287,150,122,237,159,78,237,167,70,248,159,72,304,206,92
39095048AFK,462,227,214,487,280,188,370,244,126,375,262,113,373,231,129,523,320,197
39141071ABZ,496,148,327,519,158,354,309,112,197,316,135,181,316,112,196,519,128,382
39153077ASZ,644,221,378,673,260,376,520,234,286,537,264,273,540,246,272,755,277,466
39055028AAI,1011,242,747,997,401,566,978,422,556,977,446,531,982,398,573,1315,607,697
39055028AAV,902,253,615,906,341,531,757,321,436,766,360,406,767,294,453,1053,404,633
39153077AMG,492,190,283,510,242,247,411,203,208,435,241,194,425,217,200,562,295,257
39141071AAV,462,179,266,470,188,251,313,136,177,314,161,153,313,134,172,437,196,238
39141071ABN,547,122,394,564,144,401,426,122,304,426,151,275,430,108,309,638,139,480
39113057ALP,364,111,238,366,149,203,292,136,156,299,167,132,299,140,147,368,190,175
39155078AIC,707,477,200,723,526,181,563,432,131,571,470,101,571,442,117,723,519,197
39049025ATT,630,263,351,636,331,267,570,307,263,575,365,210,581,315,256,715,420,284
39151076ADF,430,230,165,433,250,155,335,212,123,340,226,114,341,216,117,455,292,160
39049025AMG,564,292,232,585,322,229,385,242,143,394,268,126,393,244,134,596,362,221
39049025AIA,743,530,150,761,599,94,659,568,91,670,591,79,670,559,84,851,724,106
39025013ADJ,241,43,184,241,70,160,136,43,93,135,47,88,135,37,95,264,56,206
39049025AVK,620,329,277,613,381,200,568,345,223,572,380,192,576,354,203,664,451,200
39145073ABF,335,81,252,338,104,225,275,87,188,276,117,159,278,95,179,368,119,246
39049025BMT,413,199,200,418,221,179,333,219,114,338,234,104,340,227,103,532,350,170
39049025BIW,684,325,330,693,365,295,534,310,224,536,338,198,542,312,218,758,438,306
39049025BJU,410,186,200,433,210,201,299,164,135,305,176,129,307,165,136,456,235,211
39049025ANE,790,339,432,797,445,325,680,364,316,678,425,253,688,385,297,799,470,317
39043022AEC,658,343,266,663,403,229,529,359,170,536,401,135,534,363,154,743,459,276
39043022ADH,770,286,455,778,317,434,580,283,297,588,327,261,586,263,308,805,314,482
39041021AFV,449,133,306,441,200,228,434,200,234,434,215,219,441,197,239,575,277,279
39099050APX,439,134,284,446,144,280,305,130,175,311,157,154,308,143,154,440,145,289
39025013AGG,584,127,436,583,158,402,465,161,304,462,172,290,462,145,304,668,222,437
39153077BBS,632,250,340,674,316,327,513,276,237,528,307,221,523,292,213,731,375,349
39153077ABI,604,375,174,615,437,157,413,299,114,433,331,102,423,292,118,526,375,141
39173087ACO,577,159,396,592,192,350,523,193,330,533,254,279,532,190,310,713,263,437
39173087ABF,751,262,472,755,328,380,617,284,333,630,326,304,637,277,344,809,393,405
39007004ABW,234,92,122,240,102,123,155,81,74,161,101,60,161,89,69,256,109,138
39017009AAT,486,123,342,497,162,306,390,135,255,410,155,255,407,140,259,518,183,322
39133067ADY,421,144,247,435,167,239,384,187,197,388,225,163,386,181,187,500,203,288
39025013AAV,493,71,403,500,89,401,337,79,258,334,90,244,335,78,243,496,92,394
39165083AGC,610,172,418,606,245,337,550,221,329,555,250,305,558,231,318,707,342,353
39169085AAM,426,126,271,437,141,277,325,128,197,332,135,197,332,123,200,477,138,334
39011006AAX,274,25,241,272,34,222,202,23,179,204,44,160,206,34,170,286,32,250
39007004ACM,344,117,201,354,129,213,240,101,139,246,135,111,243,107,125,362,133,223
39007004AAR,181,100,68,183,105,68,127,80,47,137,99,38,134,75,53,191,102,85
39049025AKK,550,243,273,565,255,276,390,210,180,400,240,160,395,224,160,586,284,292
39173087AAU,597,221,352,600,286,278,505,246,259,513,288,225,518,257,239,626,320,295
39017009ACB,567,130,416,581,166,392,412,126,286,435,153,282,436,134,287,578,157,411
39155078AKX,615,195,398,627,241,357,485,209,276,496,248,248,500,229,265,678,273,397
39049025ASR,869,328,528,862,441,380,768,378,390,769,439,330,779,403,360,910,527,377
39153077AVK,688,261,361,691,279,387,552,250,302,557,280,277,562,249,285,747,275,458
39049025BDO,735,227,495,721,331,361,682,310,372,685,366,319,685,327,352,812,448,359
39049025BFV,892,231,645,874,384,463,804,327,477,807,368,439,812,331,477,1016,520,487
39153077AWM,690,197,445,714,246,429,590,243,347,605,271,334,605,248,329,808,298,496
39153077ARE,872,237,609,878,325,505,752,279,473,760,313,447,760,273,474,1029,450,564
39113057ARV,1073,215,820,1084,307,738,903,273,630,902,350,552,913,261,632,1148,362,774
39049025AYQ,811,384,388,801,455,306,835,520,315,843,590,253,845,541,278,1264,869,378
39049025AGF,528,195,306,551,223,307,400,167,233,404,221,183,406,185,207,619,213,401
39049025AFR,431,342,73,452,386,58,301,268,33,309,281,28,309,268,36,435,371,58
39049025AIG,769,389,355,797,523,218,524,411,113,531,428,103,533,420,102,568,464,97
39049025AIC,920,576,289,951,707,163,718,607,111,722,644,78,726,604,99,861,728,117
39017009ADW,247,174,58,256,184,61,150,120,30,158,130,28,156,123,29,269,184,84
39049025AIQ,541,319,199,554,363,174,405,295,110,408,315,93,410,297,95,588,407,175
39061031AIW,902,694,183,922,790,109,776,676,100,777,689,88,786,674,97,943,832,102
39061031AEL,1032,398,606,1030,614,356,919,532,387,938,585,353,936,533,386,1151,780,357
39061031APS,619,484,103,651,586,52,427,380,47,435,390,45,427,369,47,589,527,54
39085043AHX,532,140,378,546,213,310,471,216,255,476,249,227,472,215,247,607,273,332
39035018CVT,863,279,554,894,369,495,814,384,430,825,438,387,823,373,430,1023,476,541
39035018AAV,859,301,532,869,441,397,774,412,362,795,463,332,793,392,389,985,562,412
39035018AHG,642,281,317,682,342,304,512,293,219,521,325,196,523,268,238,729,363,352
39035018BGE,449,292,124,483,346,114,333,242,91,342,271,71,340,243,87,484,328,149
39035018CCA,709,361,316,733,474,235,599,417,182,604,437,167,600,395,191,818,550,260
39035018CIR,700,303,337,730,373,315,561,330,231,574,370,204,576,316,238,807,427,373
39035018BQW,852,776,40,952,928,17,753,717,36,755,729,26,756,708,37,920,883,34
39055028ACI,730,199,487,736,254,446,645,261,384,642,293,349,655,251,384,805,312,483
39095048AJV,887,513,339,905,600,254,574,415,159,584,452,132,599,412,156,762,548,202
39061031ANY,264,242,15,272,269,2,154,150,4,155,153,2,154,148,4,252,242,6
39061031BIN,528,50,462,542,87,434,455,97,358,455,114,341,465,82,374,569,149,415
39061031BKS,655,339,283,662,379,253,555,332,223,549,353,196,557,337,207,690,427,257
39061031BDR,45,27,15,46,28,16,43,30,13,44,28,16,43,27,13,58,37,20
39095048AQL,370,189,166,383,192,165,259,154,105,264,169,95,268,156,101,367,191,163
39049025BNM,560,339,192,583,403,149,437,333,104,440,354,86,444,328,107,471,396,70
39049025AKY,482,292,166,502,348,129,378,287,91,381,306,75,383,283,93,672,454,206
39109055AAU,821,166,632,830,234,552,685,209,476,707,260,447,711,208,488,902,268,622
39035018ARM,345,291,36,364,328,31,211,185,26,218,192,26,216,180,29,322,264,53
39035018COC,619,208,394,633,307,309,573,287,286,575,319,256,576,277,286,658,353,302
39035018BQV,545,459,71,563,511,39,466,421,45,469,440,29,479,422,48,584,537,42
39035018CVY,795,238,515,805,314,465,686,318,368,697,344,353,694,300,379,891,388,493
39035018BYK,440,275,125,461,340,106,319,247,72,321,258,63,322,237,73,537,395,135
39035018AJL,416,374,21,442,430,6,275,268,7,279,273,6,283,267,10,367,347,16
39035018BQJ,630,403,184,651,449,180,498,375,123,503,405,98,498,373,116,678,513,162
39035018ASD,369,341,12,399,392,3,262,253,9,265,259,6,268,258,6,318,302,13
39035018CTW,657,506,119,686,577,93,558,486,72,562,495,67,565,488,67,705,595,102
39035018AAR,704,244,430,681,353,303,652,358,294,655,379,276,658,351,299,817,469,343
39035018AZH,243,176,48,276,220,43,163,132,31,169,143,26,165,133,23,253,184,64
39035018CEE,680,299,342,707,385,297,572,345,227,584,372,212,582,315,250,723,405,312
39035018ANE,332,304,13,353,347,5,256,247,9,259,254,5,261,246,9,295,285,10
39035018BPZ,283,218,52,316,270,45,251,215,36,258,230,28,256,212,35,268,224,44
39035018CPI,925,391,503,942,513,389,800,484,316,805,516,289,810,452,339,1038,609,418
39035018BBJ,393,251,101,423,312,94,271,215,56,277,221,56,272,208,62,399,273,119
39045023AAS,688,182,466,703,260,403,517,213,304,519,259,260,529,216,301,766,270,480
39055028AAP,466,106,340,465,120,332,389,116,273,390,139,251,392,116,265,514,171,335
39101051ACJ,288,64,207,293,82,193,236,82,154,242,96,146,244,75,161,303,96,202
39101051ABX,299,69,213,308,69,224,234,59,175,237,73,164,232,62,161,319,61,256
39057029AAY,584,124,430,586,189,358,519,165,354,525,214,311,527,156,360,605,238,360
39061031AXT,597,220,349,606,267,311,487,228,259,489,241,248,492,217,260,627,292,321
39025013AHP,616,139,451,630,206,405,493,167,326,493,188,305,493,161,325,677,249,418
39007004AEK,404,143,237,403,165,224,335,160,175,342,187,155,340,157,167,455,195,255
39097049AAY,556,109,419,560,138,388,440,113,327,438,141,297,448,114,316,637,152,471
39113057AUD,990,497,458,1009,605,371,872,556,316,882,601,281,887,548,318,1042,682,349
39017009AGW,994,198,769,996,274,684,812,261,551,821,290,531,823,251,547,1091,402,678
39113057AKM,1066,332,675,1076,420,593,844,357,487,851,415,436,849,337,481,1210,524,664
39155078AIP,525,187,306,535,192,328,387,173,214,390,199,191,391,175,211,548,187,358
39093047AAB,897,304,555,907,382,472,752,379,373,762,421,341,778,377,381,970,420,537
39099050ASY,476,236,222,483,261,197,374,211,163,382,253,129,382,228,145,476,272,199
39113057AVG,858,457,367,875,520,328,734,462,272,739,489,250,741,458,269,919,506,407
39113057AJY,445,199,221,446,230,196,358,212,146,359,233,126,360,205,147,497,296,197
39049025AOQ,656,299,317,652,380,236,530,331,199,532,369,163,544,340,186,685,448,224
39155078ABG,673,282,343,693,329,334,489,284,205,501,321,180,498,292,191,676,314,355
39165083ADK,831,135,667,832,207,582,682,187,495,697,215,482,702,183,501,924,306,601
39029015ABL,397,89,287,403,113,273,318,101,217,325,121,204,321,102,214,438,133,300
39029015ABM,392,93,277,405,109,278,313,108,205,324,145,179,321,112,202,411,128,276
39099050ANT,135,46,79,139,52,83,110,37,73,111,45,66,112,45,63,158,60,96
39007004AEA,587,162,365,585,195,349,428,167,261,433,191,242,435,157,253,598,203,386
39041021ABM,476,122,336,471,133,295,379,128,251,377,165,212,381,138,232,546,193,347
39147074ABC,903,247,623,902,343,511,783,313,470,817,437,380,811,298,494,939,393,533
39155078AFB,696,184,452,713,213,460,557,209,348,569,268,301,572,222,327,777,230,534
39049025BLV,301,247,38,311,274,29,275,253,22,275,259,16,277,252,18,378,344,30
39049025AIX,561,464,70,584,513,56,279,246,33,292,264,28,292,250,32,488,400,73
39153077AYU,214,144,53,227,155,55,139,100,39,142,101,41,143,98,37,213,142,62
39153077AVI,564,199,315,586,201,356,387,181,206,398,196,202,394,181,197,598,197,396
39049025AQC,649,360,254,667,419,203,500,347,153,507,377,130,509,349,145,807,558,232
39025013ADL,404,67,321,412,87,305,334,91,243,331,114,217,335,86,232,458,102,348
39151076AOR,528,149,363,537,200,301,454,196,258,452,208,244,454,190,253,580,250,322
39153077ARC,442,164,258,454,195,234,384,182,202,391,202,189,393,192,194,476,233,237
39089045AFS,1038,426,562,1055,526,480,887,481,406,910,559,351,909,510,377,1149,694,433
39049025AWV,623,258,342,621,353,242,532,299,233,533,340,193,534,322,199,638,405,223
39049025AUB,980,341,609,992,462,475,848,395,453,851,481,370,863,424,423,1108,618,472
39049025AEO,662,419,221,658,491,136,634,465,169,637,519,118,644,497,137,738,559,169
39049025AXR,612,392,199,642,445,168,481,310,171,494,342,152,491,318,166,661,477,172
39087044AAA,265,109,148,268,107,154,224,101,123,224,121,103,227,102,123,287,107,175
39151076AHG,1018,261,709,1028,316,672,809,311,498,816,341,475,822,306,498,1104,378,713
39145073AAI,142,63,70,145,69,69,104,58,46,106,64,42,105,52,50,151,71,79
39153077AAL,589,355,163,597,409,143,463,371,92,471,373,98,473,338,95,687,479,189
39055028AAU,544,181,332,558,201,326,426,200,226,434,218,216,429,185,231,582,206,370
39133067ACH,409,222,167,421,254,150,319,211,108,324,217,107,325,205,109,501,311,175
39149075AAJ,628,110,491,646,155,467,512,125,387,516,185,331,506,130,361,653,151,494
39157079AEN,317,66,237,333,64,257,264,76,188,271,90,181,269,75,180,348,56,290
39099050AJK,583,268,289,598,299,274,459,249,210,465,291,174,471,274,185,620,302,308
39149075ACF,578,66,488,585,91,474,486,75,411,488,97,391,490,83,397,620,112,500
39017009ADJ,521,119,382,517,172,315,449,146,303,468,181,287,466,146,311,568,189,374
39173087ACN,532,150,350,547,193,330,439,165,274,434,197,237,448,167,260,600,213,375
39133067ACL,807,306,475,821,346,444,731,333,398,738,362,376,742,334,396,1037,441,587
39017009AHL,768,95,639,795,133,635,614,122,492,630,139,491,627,116,500,849,142,700
39017009AIK,771,178,576,763,265,469,633,219,414,641,244,397,636,214,412,823,320,491
39173087AAT,385,168,198,389,193,171,293,166,127,294,190,104,294,160,122,402,205,191
39153077AUM,788,220,511,806,287,484,697,288,409,707,312,395,708,282,406,889,355,521
39039020ABS,143,39,97,149,43,100,117,50,67,120,57,63,119,38,77,168,48,118
39153077AYD,510,160,319,517,178,314,401,176,225,419,201,218,412,178,220,561,209,339
39017009AJP,667,157,491,681,216,432,536,180,356,552,208,344,544,176,345,701,255,434
39153077APS,442,216,208,461,258,192,330,196,134,334,201,133,332,193,133,475,254,215
39061031BAQ,441,83,345,450,126,302,351,121,230,352,137,215,356,118,225,514,193,317
39061031ASG,553,122,424,534,211,307,475,176,299,482,195,287,485,176,303,587,282,301
39061031BIF,924,109,792,921,175,714,825,187,638,829,238,591,837,178,647,996,234,744
39061031BBP,913,215,664,937,281,619,831,314,517,833,345,488,844,296,521,1293,518,760
39061031APO,444,256,175,446,295,127,329,236,93,331,244,87,338,228,96,426,308,112
39061031APK,881,416,417,886,514,325,775,473,302,786,497,289,789,452,313,928,561,351
39061031BBG,1113,208,864,1122,285,790,929,264,665,925,304,621,930,244,660,1167,344,804
39035018CMM,591,274,265,630,361,248,494,328,166,499,360,139,499,313,167,616,407,206
39035018BRZ,742,297,412,762,410,323,686,408,278,700,444,256,703,400,292,883,516,360
39035018BWI,768,442,282,776,520,204,672,492,180,677,508,169,683,481,182,843,632,197
39035018CBT,800,359,398,856,441,375,652,404,248,662,432,230,666,391,255,951,540,401
39035018AMM,289,256,19,319,314,4,192,188,4,193,189,4,199,191,5,247,236,7
39035018AFK,981,302,634,1016,373,589,786,357,429,799,411,388,807,343,443,1024,461,555
39035018BEH,256,169,57,286,217,58,142,107,35,146,115,31,149,103,34,238,142,92
39035018BQT,578,478,81,591,520,62,511,463,48,515,476,39,522,462,51,613,556,52
39103052ABW,807,289,470,805,336,429,625,319,306,632,356,276,636,297,324,885,397,466
39035018DFF,668,331,297,707,385,283,518,317,201,527,343,184,528,300,209,784,435,341
39035018BOB,403,369,20,432,416,5,262,254,8,263,256,7,265,246,12,302,288,9
39035018BBP,314,188,93,331,223,95,235,174,61,238,183,55,237,172,54,314,202,111
39061031AAG,730,254,460,727,382,316,713,365,348,715,397,318,715,367,343,897,528,357
39101051ACW,281,48,222,292,60,226,259,65,194,262,88,174,264,65,192,299,50,246
39061031BNU,649,280,348,656,376,241,511,288,223,515,313,202,516,286,223,692,417,264
39061031BBY,624,194,413,623,229,373,511,221,290,509,239,270,514,212,285,664,270,384
39035018BVX,650,397,228,661,437,187,579,427,152,586,460,126,587,423,148,757,562,183
39035018CVN,612,194,393,618,251,344,514,243,271,520,266,254,524,235,280,740,313,420
39035018ARA,305,289,8,329,322,4,230,220,10,228,225,3,234,214,10,262,250,8
39061031AZD,549,156,377,542,209,309,468,202,266,466,221,245,471,194,267,619,275,338
39061031BEF,681,140,517,688,186,476,572,188,384,571,222,349,580,175,389,720,218,495
39061031AYW,829,178,626,832,284,501,699,263,436,701,298,403,707,243,446,847,353,484
39061031BMS,877,272,588,869,388,446,765,335,430,769,368,401,773,330,430,942,491,441
39101051ACI,349,79,259,356,99,236,301,95,206,300,109,191,304,97,200,366,108,253
39035018CYZ,737,234,474,756,332,391,643,309,334,650,340,310,660,300,346,790,398,381
39163082AAJ,136,36,90,140,24,109,101,27,74,106,38,68,103,28,69,174,40,134
39095048AKD,997,537,410,1028,630,338,190,140,50,194,148,46,194,132,44,163,109,50
39095048ANQ,228,186,30,238,212,23,86,70,16,89,79,10,90,69,16,150,113,33
39095048AOB,382,219,132,389,236,132,240,154,86,240,171,69,243,154,80,367,226,136
39099050AOT,665,261,376,693,305,361,578,270,308,583,329,254,591,302,267,736,339,386
39029015AEI,419,134,259,433,146,274,311,119,192,321,137,184,318,115,197,462,140,320
39151076AHD,630,217,373,638,293,310,499,228,271,513,262,251,515,222,271,658,317,328
39089045AFV,1045,603,419,1043,675,322,881,598,283,902,661,241,901,614,272,1181,852,315
39057029ADP,443,148,271,450,163,264,335,142,193,335,165,170,336,127,199,478,179,293
39093047AFX,567,315,216,578,358,197,460,338,122,487,383,104,483,354,116,585,387,191
39093047ABB,971,284,656,983,399,536,816,359,457,852,423,429,861,369,468,1146,511,623
39095048AJD,488,265,193,507,292,167,385,249,136,393,281,112,396,237,134,511,308,191
39095048AEF,526,241,252,535,270,237,401,231,170,412,273,139,414,241,152,546,291,244
39095048ARO,487,316,144,498,344,126,352,276,76,349,284,65,352,272,68,481,361,110
39153077ASP,681,216,421,717,271,412,538,240,298,554,265,289,547,235,290,724,267,446
39175088AAF,596,143,431,608,188,390,523,177,346,527,206,321,531,176,341,679,215,457
39025013AEB,787,131,630,785,201,553,627,193,434,630,225,405,637,174,438,843,252,574
39041021AFM,801,257,518,820,371,397,715,337,378,714,374,340,718,343,362,913,476,420
39113057AZG,643,395,216,648,474,138,514,417,97,526,438,88,529,396,112,620,482,122
39107054AAE,613,109,483,628,164,439,512,130,382,518,185,333,522,114,394,744,199,530
39169085ABC,515,193,289,508,217,266,443,221,222,445,233,212,454,217,217,576,248,315
39169085AAH,538,192,322,528,217,283,465,203,262,471,232,239,468,205,251,668,280,378
39133067AAH,890,280,581,922,406,464,816,366,450,819,418,401,823,371,434,1198,604,578
39049025AES,630,333,262,643,427,180,540,362,178,543,396,147,545,360,176,719,507,197
39049025AUO,312,130,167,311,144,150,240,131,109,243,156,87,242,143,94,328,193,131
39049025BII,731,506,196,765,582,162,610,489,121,617,516,101,619,491,120,824,647,174
39049025AFL,599,501,74,628,561,50,502,458,44,506,471,35,506,452,41,640,572,58
39093047AKS,512,436,53,521,485,28,461,431,30,466,442,24,468,429,30,515,483,30
39099050AKY,483,201,263,493,222,253,429,228,201,431,262,169,437,239,188,530,252,271
39099050ABB,595,194,383,594,226,354,490,209,281,490,254,236,497,236,252,629,267,359
39007004ABJ,257,90,152,257,114,133,215,100,115,222,120,102,220,114,95,270,125,138
39151076AGI,598,235,331,606,274,296,477,223,254,481,254,227,481,219,246,715,320,385
39151076AHY,692,209,445,716,246,449,530,209,321,537,228,309,537,206,319,713,249,457
39041021AFH,787,211,549,801,314,460,721,252,469,734,339,395,737,287,444,971,447,517
39049025ADK,708,398,271,724,506,155,517,444,73,522,457,65,522,444,63,556,472,72
39161081AAT,573,93,457,591,143,428,502,98,404,515,142,373,514,103,401,631,154,467
39049025BBJ,684,211,430,694,221,424,531,219,312,529,256,273,538,231,290,748,269,464
39049025AMW,784,367,387,780,461,290,728,421,307,732,487,245,739,446,275,824,535,280
39049025BIU,799,409,361,824,468,318,691,444,247,692,479,213,690,442,217,953,625,310
39049025AVD,559,223,320,558,328,211,484,252,232,487,304,183,493,282,204,586,377,202
39085043AEM,680,217,437,702,263,411,634,270,364,642,304,338,645,254,367,828,323,496
39155078ACF,809,435,329,830,475,320,640,421,219,652,452,200,652,407,236,862,511,341
39155078ADI,582,297,242,597,326,225,393,253,140,399,275,124,394,241,133,606,356,242
39049025AGH,539,352,153,555,401,122,373,281,92,376,302,74,381,290,86,533,401,120
39153077ASH,698,262,410,727,361,332,579,314,265,594,337,257,587,301,272,809,460,340
39153077ACH,548,474,41,581,531,40,391,361,30,405,384,21,395,360,27,437,394,37
39085043AEI,613,229,350,642,278,326,517,265,252,529,298,231,530,260,257,741,352,383
39049025AUE,914,343,529,943,460,441,748,351,397,762,462,300,775,384,372,1033,587,431
39049025BEJ,522,243,248,538,303,203,442,263,179,435,299,136,440,274,154,594,393,194
39049025ACN,457,328,112,509,406,96,266,197,69,272,223,49,281,215,61,418,312,100
39017009AAC,639,123,499,633,196,411,547,167,380,557,187,370,559,159,382,681,226,447
39133067ABJ,351,232,92,356,244,82,296,247,49,298,253,45,297,233,46,372,271,98
39049025AWT,573,212,334,580,276,275,547,255,292,545,309,236,553,279,260,647,341,293
39049025BML,619,230,361,628,298,297,507,246,261,505,290,215,514,263,238,639,348,281
39049025ALN,617,409,176,628,455,143,503,376,127,503,403,100,509,383,117,656,518,133
39035018BOM,513,372,112,538,425,100,422,337,85,433,365,68,433,328,94,557,436,116
39035018CWJ,891,256,602,928,380,518,749,360,389,764,395,369,767,355,398,1017,463,545
39035018CNO,651,452,180,676,530,128,602,486,116,602,502,100,608,474,124,713,582,126
39035018ABU,550,386,137,571,444,114,444,365,79,447,383,64,449,361,84,529,431,96
39113057ARR,647,208,419,656,252,377,525,198,327,526,233,293,528,194,325,737,321,403
39035018BZR,798,508,250,846,597,233,666,512,154,669,537,132,672,506,147,850,634,211
39133067AFR,692,203,444,722,227,461,636,241,395,640,290,350,647,250,367,804,253,534
39133067AAA,498,181,269,521,225,255,360,177,183,366,195,171,369,170,172,593,251,329
39133067ABW,445,180,231,461,209,228,332,177,155,341,199,142,336,169,150,508,215,287
39027014AAE,379,111,247,379,145,213,249,102,147,251,116,135,249,84,154,366,127,229
39061031BGL,858,244,583,870,302,530,729,299,430,728,343,385,734,287,432,951,402,537
39061031AMY,782,479,261,791,557,200,612,424,188,618,460,158,613,410,190,760,548,199
39095048ARF,488,247,227,483,275,183,394,251,143,396,283,113,401,247,142,530,353,171
39061031BEL,898,124,738,905,197,678,757,172,585,756,192,564,773,160,602,936,226,694
39061031BEY,783,131,624,779,180,571,653,185,468,657,215,442,661,188,460,824,232,583
39059030ABB,332,68,257,340,79,248,275,84,191,271,99,172,276,91,182,367,89,275
39103052ABL,668,219,415,671,284,359,557,265,292,569,292,277,582,251,313,748,325,413
39049025ARE,836,352,445,856,483,314,773,445,328,770,506,264,790,475,302,957,638,304
39165083ABC,380,97,252,383,132,220,328,126,202,335,145,190,332,132,191,417,152,256
39049025BHU,781,390,347,779,475,267,634,372,262,634,420,214,638,399,226,829,553,271
39103052AET,663,173,465,681,208,453,600,219,381,613,244,369,616,206,398,746,241,498
39035018BAT,272,195,55,327,277,41,182,157,25,183,155,28,179,154,19,276,220,51
39035018CJE,601,230,338,627,268,334,512,264,248,520,282,238,520,244,265,698,307,384
39035018BHE,474,290,155,492,323,144,376,271,105,382,288,94,381,254,112,538,337,194
39035018BJV,640,481,141,657,575,57,558,484,74,553,486,67,561,476,73,661,591,68
39035018ASS,397,362,20,421,412,4,283,275,8,285,280,5,287,269,11,323,310,9
39035018AUD,296,277,5,308,306,2,211,207,4,220,216,4,220,212,4,251,236,12
39035018BEB,600,372,196,641,475,140,539,425,114,547,444,103,546,413,115,794,597,193
39035018CIE,615,249,306,652,322,293,458,272,186,463,293,170,465,263,185,674,316,349
39035018AVI,316,292,16,342,337,4,224,216,8,227,223,4,228,217,7,271,265,3
39167084ACF,557,181,360,572,166,372,448,158,290,460,204,256,454,157,285,594,216,369
39035018BHG,417,247,150,436,276,137,330,233,97,337,259,78,336,234,91,517,328,179
39035018BLM,744,610,86,763,693,45,611,563,48,619,577,42,625,562,47,759,688,61
39035018CQV,549,483,50,570,532,28,446,420,26,449,427,22,453,423,26,535,499,33
39055028ABP,683,158,495,692,180,491,564,172,392,569,199,370,569,167,382,775,205,559
39013007AAV,213,46,158,217,48,165,154,49,105,156,54,102,156,37,115,239,44,192
39045023ABI,789,282,484,803,343,420,643,270,373,659,327,332,660,291,362,903,439,460
39101051AAN,266,107,141,282,124,146,190,90,100,194,112,82,189,92,90,270,74,191
39061031AXA,874,238,601,883,319,525,769,312,457,761,333,428,774,304,444,960,409,537
39057029ACR,521,138,356,525,194,308,455,182,273,456,214,242,458,186,257,569,257,299
39025013AAH,729,144,560,734,172,542,590,156,434,592,184,408,597,149,434,888,218,657
39007004ACD,347,132,189,352,157,177,257,125,132,265,142,123,266,126,128,384,164,214
39025013ACA,912,207,671,915,325,548,820,290,530,818,315,503,818,270,531,1038,402,626
39101051ABR,228,89,124,231,112,105,172,78,94,174,101,73,173,84,79,242,118,118
39003002AFR,499,118,362,520,141,356,421,132,289,421,164,257,425,126,288,534,167,363
39003002AFS,615,123,475,633,177,440,549,156,393,553,204,349,555,148,387,684,210,466
39113057AAA,713,270,417,726,321,363,544,280,264,554,321,233,553,270,254,886,477,388
39017009ACE,756,183,556,767,257,493,641,236,405,653,268,385,653,242,396,828,294,529
39113057AJQ,435,134,288,445,151,270,323,122,201,328,146,182,327,109,205,447,162,272
39139070ABZ,681,191,447,688,207,453,521,197,324,524,234,290,528,192,326,742,210,527
39049025BEL,210,109,88,209,119,79,211,145,66,215,155,60,217,144,62,345,243,95
39037019AAL,356,68,273,361,104,243,237,69,168,239,101,138,245,63,172,390,106,280
39165083AER,752,130,584,763,159,560,610,146,464,625,169,456,627,143,474,843,201,628
39041021AAY,525,132,391,528,191,331,509,160,349,510,206,304,514,184,326,651,276,374
39025013AFB,711,139,532,724,196,489,560,177,383,554,192,362,558,159,371,787,235,536
39025013AHO,217,53,155,215,53,157,119,31,88,118,43,75,119,26,91,207,30,175
39049025ATE,680,241,408,712,274,387,528,226,302,540,283,257,545,280,253,769,327,426
39049025AKZ,483,381,74,516,435,66,388,330,58,398,353,45,397,334,53,581,466,105
39153077AXS,665,198,442,671,289,349,588,255,333,594,293,301,593,250,329,738,366,362
39153077AKJ,663,290,325,685,341,299,490,295,195,501,314,187,496,287,192,703,379,309
39159080AAB,862,212,610,875,258,552,703,249,454,704,300,404,713,275,417,975,353,603
39141071AAR,278,136,119,284,143,118,192,113,79,194,115,79,195,106,77,316,134,177
39109055ABT,784,105,644,796,158,610,673,142,531,688,185,503,694,152,527,829,184,641
39025013AHZ,552,98,435,552,146,374,457,129,328,456,150,306,458,124,318,612,196,408
39087044ABT,241,78,154,252,42,201,186,49,137,185,63,122,190,50,135,303,50,250
39049025AUL,407,176,211,406,218,163,324,180,144,331,218,113,333,196,131,414,250,155
39093047AKK,468,255,175,482,284,178,344,207,137,353,236,117,356,209,132,526,279,239
39153077BAM,469,250,187,488,295,170,425,267,158,440,302,138,436,270,151,661,413,241
39049025AXX,377,147,221,372,219,138,380,199,181,380,233,147,383,207,170,447,272,170
39049025AEP,841,540,270,866,615,201,789,595,194,798,644,154,803,610,175,911,703,197
39151076ALJ,293,113,165,301,129,159,233,119,114,234,133,101,235,119,105,353,151,195
39145073ABD,237,91,137,238,96,137,174,77,97,175,89,86,176,80,93,236,99,136
39071036ABD,467,82,364,474,79,384,370,82,288,369,102,267,376,91,275,518,97,415
39153077ANI,655,215,409,661,251,385,547,228,319,570,283,287,565,232,311,713,312,387
39085043AEV,837,325,463,879,381,458,720,376,344,721,406,315,726,356,349,1040,437,587
39153077AUS,721,202,493,739,264,445,662,267,395,673,313,360,668,261,386,871,322,542
39133067ABC,320,225,71,338,252,67,279,209,70,286,227,59,285,212,65,386,285,93
39049025AGR,882,476,358,907,573,295,807,549,258,807,599,208,813,570,229,998,700,291
39153077BCX,692,234,400,706,271,405,581,239,342,590,267,323,591,230,343,811,305,492
39153077ATZ,351,146,182,372,162,190,277,158,119,285,172,113,284,154,123,397,188,208
39153077AQL,579,260,294,600,319,254,525,312,213,529,330,199,525,301,214,734,405,325
39153077BBG,319,128,177,327,154,161,278,133,145,283,157,126,285,136,142,400,196,201
39153077AOT,692,260,402,717,346,340,601,281,320,612,327,285,615,297,309,798,400,389
39061031ATV,796,204,582,766,349,378,732,318,414,736,355,381,742,298,431,867,462,397
39061031BFA,683,161,501,687,249,418,587,232,355,583,262,321,592,213,361,769,304,459
39061031ANH,377,287,82,388,313,69,374,320,54,374,328,46,376,315,50,453,375,69
39061031AEI,1034,423,594,1031,645,343,926,577,349,932,622,310,940,572,347,1145,796,332
39061031ATU,774,204,557,759,333,382,731,322,409,728,345,383,737,305,422,891,462,413
39061031BGY,716,173,505,726,223,455,644,226,418,637,249,388,648,211,422,791,286,490
39057029AEY,330,94,221,337,111,201,262,91,171,263,110,153,264,81,175,333,125,201
39083042AAI,633,179,436,622,245,359,581,225,356,587,258,329,580,218,349,721,303,412
39035018BTN,617,360,228,636,399,214,455,322,133,462,350,112,462,320,135,649,445,197
39035018AQU,387,353,18,432,420,5,302,289,13,308,302,6,306,285,13,340,321,16
39035018CVE,746,228,485,776,319,439,660,321,339,670,341,329,674,295,364,875,391,481
39035018CJG,556,219,311,603,251,331,434,226,208,446,256,190,452,227,213,690,281,401
39035018CEL,967,359,546,996,441,506,773,404,369,791,440,351,797,380,381,1026,486,527
39035018DBN,812,288,495,829,368,429,630,328,302,655,379,276,659,325,317,944,467,460
39035018DAF,79,14,65,72,29,41,73,30,43,74,30,44,75,31,43,90,50,39
39035018CSF,900,368,493,913,536,350,830,517,313,832,539,293,838,485,343,1097,694,390
39061031ANU,410,371,27,416,396,15,193,183,10,193,178,15,196,176,16,289,256,29
39103052ABF,420,217,169,430,232,166,350,198,152,359,236,123,365,196,152,599,331,262
39061031ARI,707,532,147,718,606,93,580,506,74,583,517,66,579,491,70,698,596,97
39063032ACU,577,136,425,588,175,376,483,180,303,492,217,275,502,179,305,649,236,402
39035018ARC,348,309,17,378,368,9,233,227,6,238,236,2,235,222,11,295,277,13
39103052AAY,948,337,554,1004,397,560,769,388,381,795,438,357,796,375,388,1217,501,695
39035018BFB,460,327,101,483,375,96,341,272,69,344,285,59,344,270,66,490,354,124
39035018CGW,596,223,336,614,285,292,496,274,222,503,298,205,503,268,219,673,355,309
39035018AWA,389,319,51,433,400,25,308,282,26,320,302,18,310,281,24,344,308,29
39113057AGQ,655,527,95,671,597,57,455,406,49,461,420,41,464,407,48,575,501,58
39017009ABC,504,147,332,510,191,287,392,161,231,404,179,225,402,165,228,556,243,305
39089045AEE,632,128,469,653,160,466,514,149,365,526,186,340,528,160,352,711,205,494
39089045ADB,967,269,669,956,401,500,927,377,550,934,445,489,940,388,533,1093,548,532
39061031BIJ,903,173,700,917,227,646,703,210,493,701,254,447,713,199,482,956,302,633
39061031BEP,453,89,349,459,118,318,369,103,266,378,140,238,378,107,258,503,166,325
39095048AIZ,422,243,143,443,298,111,281,208,73,283,226,57,286,203,70,400,289,105
39093047AGU,735,256,425,757,313,401,599,281,318,609,325,284,615,289,311,838,351,474
39095048AEC,298,169,107,309,193,102,204,127,77,209,144,65,211,129,72,324,201,117
39099050AQB,342,150,171,351,172,168,253,142,111,258,158,100,264,145,116,348,160,181
39173087ADF,543,160,369,535,216,300,512,201,311,513,239,274,515,203,307,594,258,334
39017009ABI,604,122,462,613,158,429,488,153,335,498,181,317,497,154,331,675,210,453
39025013ACO,572,104,444,569,152,384,440,135,305,436,145,291,442,125,302,598,173,407
39049025BDX,392,159,218,392,204,173,348,171,177,351,204,147,352,186,165,411,244,164
39093047AAO,699,245,439,713,320,365,585,280,305,615,318,297,619,291,314,978,463,510
39049025BKS,648,216,393,660,274,358,526,206,320,532,277,255,530,239,275,771,329,422
39087044AAR,172,46,120,179,44,130,157,49,108,157,64,93,160,64,93,182,52,127
39095048AGL,497,253,226,505,277,199,367,221,146,369,253,116,374,220,139,493,280,208
39049025ALG,733,451,244,763,546,183,623,472,151,627,493,134,628,492,128,821,625,177
39049025APF,588,264,287,600,301,266,416,233,183,418,264,154,415,238,159,628,329,278
39049025ALZ,718,687,15,779,763,11,595,589,6,609,605,4,606,587,8,692,659,25
39041021AFZ,425,128,290,426,146,259,348,116,232,349,148,201,349,124,221,429,178,247
39093047AKV,852,201,632,864,302,541,699,278,421,712,330,382,716,269,435,999,427,568
39099050AAY,645,251,372,640,285,337,542,247,295,545,289,256,553,269,276,693,313,377
39025013ABI,442,53,367,458,75,377,354,79,275,355,84,271,357,65,285,489,87,400
39025013ABE,299,46,235,306,59,235,218,52,166,218,57,161,217,40,167,311,62,245
39113057AME,820,240,546,822,344,445,733,325,408,733,384,349,750,330,391,900,438,447
39049025AKD,412,327,65,424,364,51,279,233,46,281,247,34,276,232,37,348,293,51
39145073ADG,535,181,342,531,158,357,480,170,310,482,214,268,485,175,304,635,180,449
39049025AFN,465,330,109,489,397,69,372,307,65,378,333,45,381,306,61,399,346,47
39133067ADZ,437,283,117,447,319,104,287,218,69,291,227,64,297,220,64,414,287,121
39085043ABJ,530,208,303,549,231,291,425,220,205,432,245,187,432,199,222,651,325,319
39049025ASE,477,230,232,473,277,176,422,239,183,419,282,137,427,262,160,551,348,200
39049025AOB,600,248,335,607,316,260,508,279,229,505,312,193,517,279,225,644,387,247
39025013ABQ,742,215,500,748,289,418,600,261,339,606,283,323,607,254,328,844,391,430
39049025ALW,620,513,72,655,597,52,492,455,37,497,468,29,497,449,38,688,601,80
39025013AHN,730,156,548,731,257,435,656,267,389,655,298,357,663,248,394,797,346,436
39165083AAC,681,131,502,711,174,511,540,159,381,552,203,349,547,153,379,766,199,554
39157079AAE,556,170,355,561,209,322,490,223,267,490,237,253,495,219,267,555,235,316
39151076AOS,676,166,495,685,252,409,593,255,338,606,278,328,605,252,345,787,314,467
39151076AHW,880,265,578,882,329,513,687,278,409,704,334,370,700,276,402,962,357,584
39099050AKX,374,198,160,392,208,172,297,159,138,305,182,123,308,169,130,403,217,179
39017009ALE,570,231,306,576,279,263,430,251,179,445,265,180,444,239,188,633,340,286
39133067ACE,473,156,266,502,188,289,380,164,216,384,183,201,384,149,213,554,192,348
39153077BBL,515,185,285,523,196,307,416,207,209,426,225,201,424,205,204,589,231,350
39153077BBP,511,127,348,527,143,354,424,160,264,433,171,262,436,168,254,604,187,407
39049025ALE,510,198,300,511,246,243,444,209,235,444,247,197,445,221,214,538,284,248
39049025AHE,643,480,140,650,528,107,531,436,95,534,452,82,534,440,91,647,549,93
39017009AAL,558,142,400,575,170,388,426,147,279,439,169,270,437,146,281,623,191,419
39049025ASS,596,239,347,586,312,242,529,271,258,525,332,193,536,300,228,638,410,215
39061031AOK,568,379,157,595,443,139,336,232,104,341,257,84,336,218,101,506,344,153
39055028AAM,782,248,499,782,331,419,665,335,330,671,350,321,671,308,344,860,397,454
39017009AJF,595,199,373,607,256,324,434,202,232,445,228,217,444,198,231,611,293,306
39085043ABF,815,258,504,862,325,489,690,329,361,692,355,337,698,296,373,1016,439,563
39035018DBF,519,194,298,548,257,265,434,253,181,436,266,170,435,244,180,706,381,312
39055028ABQ,690,173,471,709,188,484,552,197,355,564,242,322,565,185,350,790,245,536
39035018DEI,536,489,23,558,545,6,464,448,16,472,462,10,471,454,12,551,528,17
39055028ACM,693,199,479,677,307,344,635,316,319,642,347,295,644,292,342,811,438,366
39061031BMC,834,235,573,841,351,444,747,344,403,755,366,389,757,329,405,912,470,431
39061031BGV,774,177,566,781,237,515,612,222,390,622,259,363,629,219,391,832,325,489
39061031BLO,431,331,87,440,373,59,366,317,49,367,325,42,365,311,42,434,379,50
39077039AAG,742,215,480,750,264,454,599,255,344,597,313,284,601,245,316,821,284,520
39049025AWY,745,254,463,733,328,365,810,406,404,813,488,325,818,439,368,1061,586,455
39165083AAV,538,148,360,541,189,329,434,179,255,437,197,240,441,171,258,606,251,347
39165083ADM,507,78,409,527,82,425,431,80,351,436,91,345,438,67,357,591,86,493
39109055ABO,511,95,397,518,141,358,382,116,266,390,141,249,393,112,262,615,172,426
39049025AYK,301,85,209,296,111,176,266,96,170,265,121,144,266,109,154,349,158,188
39035018BMA,821,707,85,853,784,55,687,632,55,691,649,42,693,632,51,836,760,65
39035018BNG,410,379,12,431,422,6,318,311,7,315,312,3,324,317,6,331,325,4
39035018CGG,737,274,428,759,330,394,515,263,252,523,283,240,529,260,252,748,358,384
39035018CNS,372,231,125,389,269,109,327,251,76,330,261,69,327,246,78,447,328,114
39035018BZX,732,574,125,780,665,98,579,490,89,583,513,70,587,497,83,774,640,128
39035018DCW,349,274,61,364,304,51,286,253,33,289,263,26,293,256,33,353,307,41
39035018AEJ,589,234,319,604,289,289,497,278,219,502,302,200,501,270,210,650,340,306
39035018DER,412,368,23,433,408,20,354,335,19,355,343,12,361,344,14,394,373,18
39045023AEQ,691,462,199,700,515,161,482,370,112,494,392,102,498,373,111,557,453,94
39035018BQA,611,422,162,635,475,144,514,391,123,515,418,97,522,396,108,737,573,159
39035018ARV,371,335,21,403,392,8,257,245,12,260,253,7,263,241,18,315,294,13
39035018AIG,566,509,26,616,592,14,442,418,24,448,435,13,447,417,19,569,530,36
39035018AFH,828,257,545,874,368,468,707,356,351,715,378,337,719,332,365,946,467,468
39101051AAJ,305,110,168,316,119,176,214,112,102,214,116,98,218,106,103,290,104,176
39057029AAG,851,230,599,846,301,500,639,260,379,638,293,345,645,234,393,761,314,435
39025013AGD,675,146,514,677,215,430,576,209,367,572,224,348,581,192,376,746,262,470
39113057AXM,585,143,426,588,216,342,495,193,302,500,224,276,499,193,295,608,277,318
39021011ACA,671,116,524,685,142,515,595,144,451,603,197,406,611,157,430,654,138,509
39165083AGO,815,246,550,815,338,457,781,366,415,810,403,407,807,354,430,1145,551,578
39173087ABL,707,306,372,721,346,336,526,303,223,534,337,197,539,296,231,715,384,322
39017009AHU,549,79,453,552,99,440,421,94,327,434,110,324,440,95,338,599,119,474
39017009AHJ,429,62,353,448,91,336,353,91,262,367,104,263,370,84,279,489,111,376
39113057AJF,454,164,270,460,191,249,357,170,187,362,200,162,362,175,176,497,240,247
39113057AJG,372,113,247,382,141,223,274,119,155,280,135,145,280,110,164,364,144,210
39165083AGL,682,96,567,687,164,505,594,142,452,604,176,428,603,146,448,774,222,546
39087044AAV,199,92,95,202,87,111,156,77,79,156,86,70,155,80,72,235,93,134
39041021AFQ,489,88,390,489,170,305,452,145,307,450,181,269,455,151,302,542,201,336
39165083ACH,753,225,504,771,327,391,627,310,317,636,344,292,639,303,322,885,483,395
39153077AMJ,736,245,450,764,291,440,665,308,357,678,358,320,680,317,335,860,385,459
39153077AWB,702,201,463,718,246,442,579,236,343,600,263,337,588,240,330,934,360,565
39087044ACG,553,146,376,572,154,399,485,134,351,485,177,308,490,136,342,645,189,447
39151076AOV,674,168,483,680,203,444,606,208,398,611,223,388,613,193,408,753,289,458
39049025AWN,772,266,481,758,368,357,700,333,367,711,401,310,715,351,354,835,464,359
39049025ASF,545,232,281,558,283,229,486,253,233,486,291,195,491,267,212,606,357,234
39049025AET,732,449,260,741,542,169,734,546,188,736,589,147,739,558,169,810,640,159
39049025AUS,799,397,378,801,480,305,721,428,293,719,489,230,722,436,270,890,558,319
39049025BIK,995,540,426,1009,638,340,895,555,340,889,627,262,897,580,303,1090,744,335
39153077BCV,394,131,240,414,169,226,327,146,181,328,165,163,333,145,181,445,178,257
39153077AUT,705,263,406,738,342,359,630,316,314,642,353,289,637,309,308,815,410,396
39055028ABX,550,136,376,581,144,412,446,152,294,453,173,280,451,142,295,603,143,454
39049025AUK,698,300,365,705,369,309,642,341,301,642,401,241,652,347,282,750,439,301
39173087ADB,488,210,240,504,251,217,315,175,140,319,200,119,323,164,148,547,259,279
39153077AGH,556,266,267,569,337,212,507,335,172,511,352,159,512,328,179,632,415,207
39153077BAP,581,222,312,591,269,273,493,286,207,505,317,188,502,279,204,675,357,301
39153077AQI,587,268,280,610,316,249,522,303,219,536,325,211,536,296,215,702,381,312
39153077AUI,740,394,313,779,521,234,768,537,231,776,569,207,774,508,243,1114,746,359
39153077AOD,694,292,373,706,365,313,552,307,245,575,345,230,570,323,235,738,410,317
39061031AAP,909,335,527,931,405,477,723,382,341,733,411,322,733,346,360,979,500,462
39061031BJF,838,134,660,863,174,648,645,176,469,644,194,450,645,165,458,978,207,756
39061031BED,891,162,696,888,219,629,757,215,542,756,247,509,779,199,557,948,296,635
39061031ASQ,797,232,546,837,341,472,697,323,374,695,342,353,697,303,372,841,387,438
39061031AXK,821,539,253,835,612,183,715,562,153,720,579,141,716,551,145,927,704,208
39057029AIO,408,212,169,411,242,150,320,175,145,319,183,136,323,164,142,310,119,180
39035018BFZ,501,408,71,531,479,45,396,359,37,408,371,37,405,352,42,523,450,65
39035018CKM,762,249,458,792,303,447,627,292,335,632,311,321,637,277,339,902,358,532
39035018ATL,415,375,23,448,432,9,298,288,10,302,293,9,306,294,10,349,334,9
39035018BCY,331,160,145,346,209,126,209,133,76,212,143,69,212,123,80,351,197,148
39035018AEX,634,217,393,632,283,326,575,277,298,583,316,267,581,273,300,730,375,346
39045023ADU,581,200,356,577,249,299,487,231,256,498,280,218,505,258,242,673,310,354
39035018CXC,808,323,462,845,427,376,598,353,245,608,330,278,609,293,303,726,331,392
39035018BXI,705,410,255,734,522,181,618,448,170,627,472,155,628,435,174,759,552,192
39035018BYD,650,409,199,683,503,147,551,425,126,557,446,111,557,418,119,744,564,172
39103052ADX,923,200,680,946,293,617,783,277,506,799,311,488,803,258,522,1085,362,706
39009005AAF,227,128,91,244,148,83,123,96,27,124,101,23,128,99,24,78,59,17
39061031AXV,535,234,279,553,268,264,430,236,194,433,246,187,431,219,200,592,316,263
39061031BKH,705,78,616,703,128,554,634,119,515,632,142,490,638,116,509,799,180,612
39061031AAM,856,271,572,843,422,382,803,420,383,801,456,345,810,422,374,913,543,366
39035018CEZ,551,269,247,586,337,231,456,299,157,461,313,148,467,288,164,668,379,281
39035018AUH,327,305,10,351,340,8,265,255,10,269,258,11,266,252,12,284,267,17
39035018CVF,686,209,439,722,289,397,563,255,308,583,287,296,591,245,330,768,357,400
39035018APY,290,261,14,323,316,4,127,121,6,130,127,3,132,120,7,195,186,6
39101051ACV,575,133,408,580,148,401,505,150,355,508,184,324,510,134,341,655,169,477
39103052AGA,1024,324,669,1048,376,623,756,314,442,779,367,412,792,327,450,1277,474,790
39113057AIX,508,181,308,520,261,246,448,224,224,450,247,203,452,220,223,577,296,273
39035018DEV,524,470,29,547,523,13,364,349,15,362,352,10,367,351,11,429,418,9
39017009ALN,277,53,222,274,75,192,222,63,159,230,74,156,236,62,167,302,85,215
39061031ABI,495,177,309,501,275,202,434,227,207,441,253,188,443,234,198,557,325,219
39061031BCW,755,222,483,766,297,441,579,258,321,578,279,299,586,239,326,811,346,458
39095048ADY,411,226,164,428,257,146,296,211,85,299,237,62,300,210,80,423,271,148
39165083AHD,312,61,241,317,90,217,315,97,218,319,105,214,322,94,223,620,202,408
39165083ADJ,649,127,500,657,186,449,650,198,452,663,219,444,663,191,462,845,279,558
39005003AAF,528,90,414,518,109,379,466,117,349,465,142,323,470,112,348,576,163,403
39029015ABJ,637,166,424,640,195,410,497,178,319,505,221,284,505,183,305,706,250,447
39049025BKT,434,110,311,442,128,291,398,120,278,399,151,248,407,140,259,601,228,367
39099050AIA,358,187,148,365,219,132,279,182,97,284,200,84,284,186,87,394,227,164
39153077AUA,359,131,195,376,156,197,298,151,147,301,169,132,301,149,138,431,185,231
39095048AUA,539,199,324,529,237,264,447,220,227,448,240,208,453,220,221,580,280,287
39095048AMI,433,191,213,450,214,191,301,175,126,306,189,117,312,172,123,409,227,171
39099050ASL,583,188,372,591,234,334,505,199,306,520,264,256,525,236,277,610,235,368
39023012AAE,720,170,508,729,195,500,478,159,319,485,195,290,482,160,298,751,193,538
39153077AZR,723,414,275,736,483,221,611,419,192,630,453,177,631,437,184,811,543,253
39145073ACM,275,79,183,278,76,195,192,68,124,195,86,109,201,70,129,283,69,212
39049025AER,553,272,256,558,329,201,470,285,185,484,331,153,485,303,169,610,404,199
39099050AIB,591,325,236,599,347,228,447,267,180,448,298,150,449,271,164,642,373,262
39025013AFI,774,175,556,783,243,498,585,197,388,594,218,376,596,196,383,855,285,556
39153077AOS,735,248,454,747,330,378,638,302,336,643,350,293,653,322,316,852,418,424
39085043ADN,781,275,462,813,346,431,641,302,339,645,348,297,649,284,346,892,386,493
39017009AKJ,485,103,372,478,152,307,405,126,279,415,151,264,404,122,275,496,173,317
39099050APS,453,169,263,473,202,259,381,188,193,381,214,167,387,197,183,513,203,306
39025013AFO,576,136,406,584,186,363,434,159,275,438,175,263,439,141,274,599,229,361
39165083ACO,754,128,576,781,159,598,579,142,437,588,166,422,585,133,432,884,176,704
39165083AFQ,608,163,419,620,208,380,558,215,343,560,230,330,568,207,339,763,267,484
39165083AEB,673,86,563,694,118,554,603,112,491,619,127,492,618,108,495,761,161,590
39143072ABX,284,85,174,281,96,168,204,76,128,210,107,103,207,81,106,311,97,208
39049025AHC,439,302,124,444,350,72,387,328,59,391,344,47,396,335,55,492,409,78
39085043ACC,743,220,486,782,277,463,640,272,368,639,301,338,644,254,370,897,354,526
39085043AEJ,585,187,380,587,256,305,496,255,241,494,281,213,504,227,259,645,344,292
39133067ACN,539,174,337,553,227,301,473,193,280,480,216,264,476,188,276,631,236,387
39049025AVC,569,177,376,563,310,237,499,216,283,510,301,209,513,256,253,563,331,228
39017009AGA,374,78,284,379,104,268,256,80,176,271,97,174,272,82,186,400,137,253
39017009AJD,820,304,491,835,426,375,667,385,282,680,414,266,680,381,285,946,529,410
39035018BFI,413,285,106,444,340,89,279,222,57,282,224,58,283,220,55,460,303,145
39085043ADC,777,299,437,827,374,417,641,336,305,647,382,265,652,327,298,892,414,464
39055028AAX,503,126,367,515,166,328,440,143,297,441,170,271,438,130,300,567,174,387
39061031BEZ,982,110,846,979,216,724,861,204,657,858,252,606,874,189,667,1046,292,745
39061031BGE,763,247,460,764,303,408,631,296,335,635,322,313,635,276,330,764,371,378
39061031AEJ,834,327,486,831,476,294,723,453,270,718,477,241,726,444,265,879,605,266
39061031AZE,995,217,762,996,363,587,881,327,554,880,354,526,888,314,554,1073,501,564
39103052AAR,721,201,485,745,252,447,552,234,318,575,292,283,577,225,331,818,314,497
39035018DCI,407,173,217,417,228,174,321,194,127,321,202,119,324,184,137,463,260,199
39035018ANB,306,278,18,335,331,3,222,215,7,227,223,4,228,217,4,266,253,8
39009005AAL,410,213,169,492,300,160,264,200,64,280,226,54,278,210,56,286,213,70
39009005ACS,603,339,225,689,437,194,275,230,45,280,236,44,284,217,45,72,58,11
39035018DAZ,291,142,131,308,152,145,264,156,108,268,176,92,265,158,99,341,168,171
39035018AOD,381,273,89,406,329,60,320,257,63,321,272,49,320,248,63,349,286,60
39035018CLP,804,321,424,841,423,387,646,347,299,662,395,267,659,334,303,929,449,473
39035018CYX,523,248,237,545,299,216,431,296,135,437,313,124,440,286,146,643,440,197
39035018DEJ,476,451,17,487,470,11,418,398,20,418,407,11,419,402,13,523,502,18
39035018BZW,779,590,152,811,673,125,615,532,83,623,549,74,629,539,71,794,667,124
39035018CII,511,200,274,533,224,281,357,187,170,367,212,155,372,187,166,594,265,322
39035018CEF,178,68,105,177,95,81,154,81,73,152,90,62,157,77,79,178,96,82
39035018BMF,845,722,92,875,797,58,657,613,44,657,615,42,661,603,44,858,786,64
39055028ABK,497,86,375,496,118,357,434,114,320,439,137,302,441,104,321,562,139,414
39057029AAH,493,108,371,493,140,320,456,150,306,458,177,281,461,153,290,559,208,345
39061031ABF,787,386,362,790,458,276,658,433,225,658,450,208,663,422,219,930,628,286
39061031BKO,508,247,242,503,307,176,433,278,155,428,291,137,433,268,159,541,354,178
39061031AZI,957,261,671,952,375,523,849,360,489,851,386,465,862,339,499,1057,472,560
39025013AFJ,971,189,739,955,286,623,825,295,530,826,324,502,834,284,521,1113,421,677
39025013ADX,680,118,531,679,180,474,570,170,400,571,198,373,578,161,395,793,254,524
39017009AEA,451,155,281,453,176,249,354,148,206,366,168,198,365,157,198,475,193,275
39113057AOJ,717,140,537,750,216,492,574,190,384,573,217,356,583,181,383,757,231,509
39113057AEN,528,178,295,529,214,271,392,206,186,396,232,164,401,201,179,562,277,273
39099050AMS,448,221,198,458,220,217,361,200,161,362,233,129,362,209,137,516,270,238
39113057AKJ,1057,298,730,1056,387,638,835,355,480,851,411,440,845,348,482,1168,487,667
39113057ARP,489,120,346,496,136,335,380,131,249,380,161,219,385,124,249,521,163,341
39113057AGA,533,446,61,548,526,15,414,402,12,419,410,9,426,399,18,518,502,11
39165083AEV,612,117,477,609,187,393,542,163,379,553,193,360,551,153,388,673,235,432
39025013ACE,636,145,463,648,200,425,508,171,337,505,190,315,512,157,334,739,240,486
39041021ADI,878,272,576,883,418,401,771,377,394,777,443,334,783,393,374,1034,598,418
39049025AUT,339,132,200,339,161,162,309,136,173,309,171,138,313,160,150,363,210,151
39153077APL,664,257,370,670,289,333,502,268,234,503,285,218,507,254,238,737,363,359
39153077AVC,643,235,368,679,308,343,535,278,257,556,312,244,551,260,277,755,333,419
39153077BBA,655,180,454,652,255,364,579,220,359,585,259,326,589,218,356,711,330,375
39007004ADH,368,77,278,375,89,270,300,98,202,303,134,169,305,88,200,412,122,282
39161081AAH,221,65,133,227,57,149,152,47,105,154,59,95,154,49,101,209,63,137
39085043AEE,701,273,383,712,339,339,653,375,278,653,403,250,658,348,291,817,445,361
39085043ADG,416,125,274,418,158,241,325,150,175,325,166,159,334,154,173,509,209,289
39153077AQE,569,219,315,577,228,314,443,215,228,459,252,207,465,225,223,654,259,390
39085043ADU,736,323,378,765,401,342,621,377,244,627,411,216,632,365,250,909,508,393
39055028ABH,624,198,396,647,233,375,525,232,293,531,259,272,534,219,297,723,268,445
39041021AEN,764,216,535,758,310,409,725,285,440,726,354,372,728,314,400,953,462,474
39041021ACF,712,223,467,704,310,352,687,285,402,683,347,336,697,309,378,818,435,374
39049025AKC,537,375,138,562,423,115,475,356,119,479,381,98,479,351,116,569,444,120
39017009ABD,621,107,492,620,166,428,502,133,369,511,149,362,506,123,369,622,205,409
39153077ALO,634,255,361,647,322,303,573,287,286,595,353,242,587,285,292,693,385,307
39099050ALF,573,234,308,581,268,292,491,242,249,497,291,206,500,265,226,588,268,313
39061031AUR,378,217,146,379,257,111,294,209,85,290,218,72,295,198,91,410,294,113
39061031AFO,316,278,30,340,322,13,234,218,16,229,213,16,232,205,20,293,269,20
39061031AON,952,458,434,960,542,381,711,427,284,711,451,260,718,400,290,944,556,364
39035018CCN,707,242,417,742,327,372,546,275,271,558,318,240,566,266,278,828,403,410
39035018AST,289,253,16,308,300,3,227,214,13,230,222,8,230,217,11,260,250,10
39035018CHC,539,292,209,568,338,205,393,244,149,401,261,140,398,235,151,616,360,242
39035018AES,763,254,486,772,324,422,676,323,353,680,351,329,688,310,366,857,414,436
39035018CVP,769,265,468,792,320,439,634,310,324,644,330,314,651,292,346,883,393,478
39035018CKI,499,187,274,531,262,245,381,227,154,388,242,146,389,229,157,534,284,243
39035018ANV,265,233,16,322,317,5,146,139,7,148,144,4,153,142,9,220,201,14
39035018BDA,434,244,155,459,295,142,329,221,108,337,235,102,336,217,103,470,292,170
39061031BHJ,739,113,604,748,187,530,643,185,458,645,208,437,651,171,465,784,228,548
39061031ATF,534,156,357,524,231,261,455,215,240,460,235,225,466,210,241,568,300,257
39061031AQK,666,454,186,674,515,140,505,377,128,501,388,113,507,366,128,671,500,159
39061031AQC,793,622,146,810,712,78,620,549,71,621,569,52,619,533,74,797,710,76
39061031AQO,830,580,223,854,693,140,615,511,104,626,528,98,628,507,107,826,663,148
39061031BFP,195,67,123,187,103,73,172,96,76,172,98,74,173,88,80,200,112,83
39009005AAB,399,299,60,433,340,48,340,300,40,354,323,31,354,310,31,385,348,31
39045023ABF,468,133,303,482,154,296,395,139,256,402,169,233,411,159,241,528,199,315
39101051ABH,304,122,162,314,140,155,251,140,111,256,157,99,259,147,108,335,160,167
39035018BXF,534,289,216,540,371,146,460,339,121,458,352,106,467,336,115,601,456,139
39009005AAH,280,189,67,308,226,53,229,197,32,231,204,27,231,194,26,215,172,37
39017009ALK,542,133,386,543,191,323,455,179,276,462,209,253,457,174,267,578,260,304
39061031AYV,954,277,650,951,398,494,799,355,444,797,397,400,812,361,430,981,489,472
39035018BQX,510,441,39,526,490,33,362,340,22,366,346,20,369,338,23,428,399,28
39109055AAT,818,163,612,829,234,552,604,186,418,619,253,366,623,187,412,873,255,597
39109055AAR,680,115,541,678,163,486,558,155,403,570,188,382,572,143,413,769,213,540
39095048ASH,614,182,397,623,231,354,493,206,287,501,246,255,509,193,292,704,267,421
39095048ADA,388,180,181,403,208,167,274,173,101,274,185,89,284,170,97,392,197,189
39095048AQQ,580,259,302,588,307,245,459,272,187,463,303,160,471,269,192,594,338,247
39095048AGB,590,485,79,609,524,59,482,426,56,480,438,42,486,436,44,609,536,59
39151076AGU,578,193,356,583,215,340,473,225,248,480,241,239,485,227,250,610,282,312
39165083AAT,979,156,781,976,259,655,833,240,593,852,274,578,854,239,591,1102,391,694
39049025BFR,673,268,382,689,318,344,597,310,287,601,344,257,596,316,272,758,399,357
39093047AER,310,133,158,317,137,164,255,135,120,264,165,99,261,139,109,357,178,174
39049025AFT,618,417,164,627,465,131,514,396,118,522,418,104,518,391,106,600,472,118
39025013AIA,667,93,566,667,175,471,627,169,458,627,193,434,631,172,454,729,235,490
39049025AQO,649,276,361,640,380,223,623,334,289,621,405,216,635,361,260,710,463,235
39145073ADM,492,130,347,497,125,356,318,89,229,318,124,194,324,98,221,415,108,303
39049025AIH,1074,620,410,1120,789,271,293,245,48,298,253,45,298,236,51,183,156,27
39049025BLL,675,389,257,701,493,170,356,279,77,366,300,66,368,284,74,228,191,34
39049025BLK,558,322,214,582,410,140,389,308,81,385,313,72,393,294,75,269,221,44
39133067AAO,737,356,335,764,441,270,590,363,227,592,381,211,596,344,232,714,410,294
39007004ABA,259,138,92,268,152,102,158,97,61,163,109,54,163,96,52,246,127,113
39153077BAZ,655,248,370,659,335,290,571,310,261,582,333,249,584,310,264,727,397,320
39085043AGI,775,218,496,797,262,493,624,261,363,625,299,326,632,251,354,898,330,556
39017009AAS,286,136,136,290,159,108,148,102,46,154,110,44,156,103,48,208,137,68
39085043ACA,539,178,323,545,203,312,432,206,226,437,221,216,437,196,231,648,243,387
39155078AFW,790,260,489,801,312,454,593,288,305,603,324,279,601,285,302,796,324,459
39049025AEJ,747,426,272,776,535,191,672,452,220,679,514,165,687,478,194,787,606,164
39049025ASA,786,344,416,795,426,326,714,402,312,721,459,262,726,417,286,863,523,325
39085043AEY,722,242,436,752,305,411,591,281,310,601,325,276,609,263,316,845,349,480
39049025AMP,603,202,368,617,238,359,466,205,261,469,247,222,476,221,232,677,264,399
39035018CGC,572,217,332,575,264,280,435,221,214,438,234,204,436,207,220,624,315,302
39035018BZM,706,340,352,705,452,229,648,438,210,656,457,199,661,415,233,801,544,247
39095048AGM,439,340,67,460,385,52,249,229,20,250,234,16,252,223,19,391,335,52
39095048AHR,513,322,158,526,370,129,365,277,88,365,293,72,372,273,91,532,406,114
39093047ACE,609,267,309,626,330,260,463,257,206,489,308,181,488,265,214,660,366,283
39165083AFL,862,253,598,866,385,451,767,336,431,784,372,412,783,337,438,1036,556,469
39099050AOY,776,310,441,781,334,414,627,285,342,634,334,300,646,305,327,811,338,459
39099050AAF,410,244,146,415,255,142,282,188,94,279,209,70,286,194,86,393,236,152
39035018BUT,589,213,364,589,295,273,545,274,271,552,307,245,556,269,281,743,373,366
39035018DAK,135,95,36,138,112,22,113,99,14,115,102,13,115,100,14,170,141,27
39135068AAF,350,69,267,355,91,252,268,83,185,275,108,167,275,88,173,397,112,283
39035018BOR,403,281,109,431,315,106,342,260,82,345,277,68,343,253,81,457,360,94
39035018ATP,296,266,15,338,330,5,210,205,5,207,202,5,213,201,6,260,249,9
39035018CTY,651,427,197,669,512,137,554,436,118,559,456,103,559,423,127,672,533,133
39035018CDV,654,266,353,669,323,316,554,309,245,561,341,220,570,303,248,764,416,339
39167084ACD,23,14,8,25,9,14,15,9,6,12,9,3,15,8,6,23,12,10
39035018AQQ,276,237,21,289,280,6,218,213,5,222,212,10,221,205,11,326,304,20
39035018DAS,472,373,84,482,416,62,443,388,55,447,389,58,447,389,55,542,472,67
39035018CAJ,479,400,51,496,442,42,367,338,29,369,340,29,373,337,27,475,425,46
39057029AAS,584,150,414,579,195,349,504,179,325,507,214,293,512,168,327,583,224,344
39057029ABF,580,114,446,583,178,383,511,164,347,511,198,313,519,159,348,610,221,382
39061031BBE,645,476,134,656,542,94,498,428,70,501,434,67,501,421,67,676,567,98
39145073ABW,405,147,245,406,114,279,303,117,186,313,134,179,316,115,189,442,107,330
39165083AGJ,703,165,509,708,216,444,592,213,379,600,235,365,605,215,377,873,323,539
39113057AUI,831,631,174,849,738,93,710,615,95,720,654,66,716,617,86,878,771,95
39049025BNU,420,267,134,420,314,79,414,326,88,416,350,66,418,335,73,505,411,85
39049025AGX,534,338,170,534,398,102,523,413,110,527,444,83,532,424,93,683,544,127
39147074AAX,399,125,245,400,145,223,326,139,187,329,168,161,324,139,170,446,159,279
39087044ACX,329,99,221,346,86,242,262,91,171,271,105,166,272,93,173,391,96,292
39165083AAD,528,100,387,550,128,396,380,121,259,389,139,250,391,107,266,612,160,441
39153077ASK,617,244,326,634,269,338,490,231,259,509,261,248,505,241,250,671,273,395
39093047AGV,789,251,482,828,315,452,650,322,328,666,364,302,670,309,333,937,381,540
39151076AGF,453,149,287,455,194,251,394,185,209,400,205,195,400,185,211,517,246,271
39153077AVO,746,215,483,776,270,479,604,233,371,614,260,354,610,232,362,830,299,520
39049025BDB,328,124,200,329,158,162,319,150,169,320,176,144,323,162,159,353,201,149
39049025AJU,930,394,490,964,453,443,786,466,320,795,511,284,803,476,302,1076,638,425
39153077ARB,780,224,538,788,323,432,691,285,406,702,326,376,700,281,409,882,398,479
39017009ALH,598,163,410,613,213,380,478,171,307,493,200,293,494,167,313,626,214,403
39153077AYH,670,304,343,689,387,282,536,295,241,553,316,237,548,295,245,741,407,325
39153077AUY,748,299,433,767,406,335,684,365,319,696,421,275,700,353,332,904,496,401
39153077ANJ,660,300,318,685,380,283,596,364,232,629,414,215,614,364,234,865,519,338
39035018ATV,253,227,18,277,266,6,194,185,9,196,190,6,197,182,9,195,189,5
39035018ASH,312,287,14,340,330,7,218,208,10,217,206,11,224,207,15,282,264,14
39035018BEV,644,420,177,663,475,148,607,487,120,612,511,101,617,476,121,723,545,166
39035018ABQ,766,414,338,787,539,226,741,566,175,741,545,196,747,509,223,918,616,293
39035018CFR,887,298,552,951,391,533,736,352,384,746,404,342,744,343,387,1007,438,562
39035018CUV,736,261,446,756,330,407,632,311,321,631,329,302,634,295,323,836,405,421
39061031ADT,841,373,437,858,557,259,708,459,249,719,494,225,724,468,238,918,661,248
39057029ABH,512,118,368,516,166,321,434,152,282,436,177,259,446,142,285,519,219,294
39061031BBB,670,336,293,685,393,274,465,282,183,467,302,165,473,275,186,629,331,292
39035018AFR,699,208,472,722,270,429,574,250,324,584,269,315,589,246,332,723,309,405
39103052AFV,530,196,311,534,238,280,411,223,188,431,248,183,434,223,204,606,291,310
39061031AJV,667,498,139,680,566,77,586,509,77,596,527,69,597,499,77,682,597,72
39093047AHI,612,461,113,622,523,76,522,449,73,536,477,59,541,452,75,667,542,113
39165083ABR,507,146,333,522,210,287,443,214,229,458,229,229,456,210,235,598,278,307
39057029ADF,508,159,312,522,202,271,779,352,427,786,425,361,788,334,420,570,254,299
39099050AIC,329,155,145,340,182,137,225,147,78,228,158,70,229,145,73,334,200,128
39087044ABR,348,99,239,354,92,255,260,76,184,266,97,169,270,81,184,374,80,287
39093047AHH,676,236,408,687,268,395,548,248,300,563,299,264,573,237,315,785,334,440
39099050AHE,589,293,257,594,316,249,426,253,173,437,295,142,434,261,153,585,301,275
39095048AHA,418,208,200,428,251,161,354,234,120,355,258,97,358,226,122,426,274,147
39041021AAN,597,200,366,616,252,327,437,187,250,444,225,219,441,194,218,679,302,358
39025013ACG,763,157,572,768,234,504,624,211,413,625,232,393,628,204,399,808,253,547
39109055ABZ,522,91,418,516,134,364,446,119,327,450,155,295,452,121,321,560,191,362
39153077BBF,552,227,300,577,284,277,488,277,211,503,310,193,505,272,217,631,343,281
39049025AHL,610,545,39,630,592,27,468,438,30,477,461,16,476,448,26,594,542,41
39107054ABT,756,88,656,767,127,615,619,124,495,625,176,449,638,134,496,836,150,681
39049025AVJ,506,202,290,498,281,193,486,253,233,488,303,185,494,261,224,562,358,201
39093047AHK,427,347,62,438,387,43,352,318,34,361,335,26,361,314,37,421,366,47
39025013ABK,680,116,529,692,144,515,538,149,389,536,154,382,542,134,381,739,175,550
39025013AFS,664,189,437,665,260,379,469,211,258,473,229,244,474,210,250,697,317,364
39017009AFI,808,125,653,827,170,624,651,168,483,654,195,459,660,163,477,900,206,689
39133067AED,614,138,429,649,173,455,515,191,324,519,219,300,517,180,320,727,211,506
39133067ACZ,558,175,339,571,200,344,436,196,240,442,222,220,446,199,214,639,220,403
39099050ASR,840,312,501,865,375,463,711,336,375,717,405,312,722,365,340,998,450,537
39099050APA,417,152,253,427,194,222,350,170,180,360,210,150,364,183,173,465,215,244
39133067AFU,462,126,293,492,131,334,372,146,226,383,176,207,381,134,229,528,154,362
39049025AIK,197,157,29,215,174,33,120,100,20,122,109,13,124,106,17,162,129,31
39049025AVE,743,264,471,722,397,282,664,339,325,665,400,265,673,350,318,798,498,293
39085043AIO,793,233,532,824,274,513,646,278,368,654,319,335,658,262,369,906,352,540
39133067ABE,1037,706,289,1101,769,248,211,186,25,211,187,24,211,179,23,138,115,20
39151076AMM,578,177,381,567,239,306,515,236,279,524,270,254,524,239,279,643,310,326
39143072AAQ,277,101,155,292,148,114,224,110,114,228,134,94,228,112,108,308,138,158
39049025AST,769,308,437,770,395,342,718,358,360,725,440,285,731,406,313,837,470,358
39017009AAZ,596,157,418,594,204,358,454,173,281,467,204,263,471,169,294,610,246,353
39113057AIO,551,185,349,561,237,302,436,209,227,444,251,193,444,199,231,591,283,305
39113057ABX,573,277,253,581,353,208,409,252,157,410,271,139,416,241,162,510,296,209
39035018AXQ,250,185,39,267,223,36,174,147,27,181,155,26,181,145,31,234,189,43
39035018ASL,364,330,21,395,386,5,300,292,8,306,300,6,310,294,14,323,305,13
39085043ABW,589,194,369,606,255,323,489,238,251,484,264,220,493,218,270,645,294,347
39055028ABB,754,203,524,761,274,451,617,241,376,628,279,349,626,231,375,826,298,518
39095048AIO,243,208,17,253,236,11,182,170,12,187,178,9,187,166,15,219,194,21
39049025ATD,1023,248,750,1019,328,644,859,271,588,856,369,487,874,366,505,1068,384,670
39035018BVW,739,432,260,767,527,194,647,485,162,645,505,140,650,476,150,865,635,206
39035018BDB,532,251,250,564,316,220,394,255,139,394,271,123,396,236,146,571,338,227
39035018CLK,690,266,371,722,349,348,577,313,264,600,357,243,588,288,274,815,352,452
39035018ACE,573,468,82,596,510,69,454,402,52,457,415,42,457,401,53,583,501,74
39045023ADS,807,203,580,810,242,537,744,249,495,749,292,457,754,246,493,936,344,577
39045023ADT,706,182,506,712,237,444,626,212,414,631,245,386,638,215,417,961,376,572
39035018BQU,578,469,87,589,505,75,484,411,73,492,433,59,493,409,79,624,537,81
39035018BOW,526,388,109,542,436,94,411,334,77,418,366,52,419,338,69,558,458,94
39035018CRI,754,648,96,761,697,51,694,631,63,703,651,52,703,638,58,831,761,66
39035018COD,823,320,476,827,440,350,736,416,320,747,445,302,752,390,345,932,542,384
39101051AAT,331,95,221,331,102,207,263,98,165,263,131,132,262,111,144,343,120,215
39023012ACB,554,231,298,552,272,256,404,212,192,410,257,153,410,202,189,559,277,273
39155078AFV,707,246,418,717,296,391,543,274,269,551,318,233,554,273,268,792,322,464
39087044ACN,252,60,174,258,46,203,212,54,158,215,74,141,218,60,154,301,58,241
39087044ADB,356,123,221,364,90,265,246,62,184,252,84,168,255,72,177,391,69,322
39087044AAN,119,42,66,121,54,62,94,42,52,91,55,36,99,45,51,123,52,70
39049025AHX,289,199,71,309,233,66,202,164,38,207,175,32,211,169,38,281,214,65
39153077AAF,512,400,67,533,447,61,452,398,54,465,425,40,459,396,45,533,459,65
39087044ACZ,263,97,156,272,83,177,222,76,146,226,92,134,225,76,142,284,70,206
39055028ABG,839,235,572,843,301,506,717,297,420,723,332,391,720,269,434,940,361,568
39085043AAU,1046,330,669,1078,419,618,949,409,540,956,463,493,962,397,540,1239,502,727
39143072ABO,357,76,260,365,110,247,294,103,191,300,130,170,305,95,198,357,118,236
39041021AAD,748,223,496,766,282,440,611,232,379,610,284,326,618,240,357,849,360,472
39153077BBU,736,271,430,753,350,371,623,314,309,632,333,299,634,307,319,802,416,378
39061031AYY,1077,327,733,1077,482,545,951,440,511,960,473,487,970,444,512,1163,609,539
39061031AOS,695,274,381,706,352,321,553,330,223,556,335,221,560,298,243,751,420,323
39061031BGX,832,121,682,863,182,639,667,180,487,667,205,462,677,173,472,923,252,655
39061031BET,642,110,512,650,178,442,542,168,374,544,206,338,550,156,380,665,210,440
39035018BJC,716,326,342,746,416,295,645,418,227,654,453,201,659,408,235,821,498,306
39061031BCU,730,264,440,743,313,400,584,287,297,591,309,282,591,276,296,755,358,391
39061031BMU,963,238,704,966,364,583,806,282,524,808,329,479,809,292,511,984,444,535
39035018CEH,799,272,485,820,382,400,641,350,291,653,367,286,651,323,310,854,430,410
39017009AIO,649,168,462,655,228,384,536,215,321,535,240,295,539,206,311,647,286,352
39003002ACX,481,112,345,504,149,328,384,111,273,387,149,238,387,113,266,506,150,350
39095048ABN,701,295,383,706,341,344,584,312,272,583,362,221,594,315,264,707,345,352
39049025ALY,567,479,69,589,528,51,454,410,44,461,427,34,461,420,40,589,503,79
39025013ABD,708,117,554,727,159,538,588,145,443,584,164,420,590,132,430,869,192,668
39153077AUE,696,349,314,719,423,270,654,407,247,666,438,228,676,394,258,869,535,324
39041021AEP,578,157,408,576,238,314,522,218,304,523,267,256,527,238,281,648,330,308
39133067ABL,187,123,40,208,149,41,155,127,28,159,135,24,160,120,34,181,145,33
39113057AQN,365,321,39,381,362,15,314,301,13,320,304,16,316,297,12,391,362,22
39025013AHX,748,121,610,721,213,482,627,193,434,625,226,399,632,197,424,810,310,485
39113057AYM,706,249,430,708,309,374,615,296,319,623,333,290,625,294,323,837,443,378
39049025ABS,460,397,45,468,431,23,216,195,21,218,203,15,217,199,14,332,298,29
39113057AOK,631,118,499,637,168,438,538,147,391,546,196,350,543,145,387,715,246,461
39017009AGS,704,151,535,712,242,436,566,214,352,577,246,331,579,215,347,860,363,484
39113057AKB,796,251,500,810,318,459,512,224,288,523,273,250,522,222,288,796,365,421
39113057AHK,262,225,23,268,254,9,171,162,9,169,163,6,172,155,12,237,225,7
39085043AAB,552,194,316,580,223,320,388,205,183,391,233,158,390,186,179,610,259,334
39061031BHN,813,113,669,831,171,623,751,184,567,746,206,540,757,169,568,904,234,651
39061031ASU,503,139,355,493,200,266,439,180,259,433,204,229,441,181,247,532,243,280
39061031ACG,579,353,203,586,419,124,485,397,88,493,414,79,495,391,89,647,511,124
39061031ANX,265,243,16,270,267,3,123,114,9,130,125,5,127,115,10,165,151,12
39061031ANQ,912,779,107,947,889,41,794,756,38,797,763,34,798,749,44,943,882,47
39035018BXK,680,397,248,717,505,184,606,469,137,616,496,120,620,469,136,774,592,171
39035018DFI,1097,270,791,1107,416,669,1024,415,609,1035,470,565,1042,407,623,1320,520,792
39025013AGM,432,90,324,444,125,291,319,109,210,328,123,205,326,97,220,485,151,320
39003002AEF,591,122,448,595,144,430,498,148,350,495,191,304,498,143,347,629,169,455
39165083ABX,600,154,418,600,222,329,483,188,295,499,219,280,493,181,290,635,294,330
39049025ARB,519,246,246,519,306,175,438,268,170,445,301,144,444,285,143,583,394,179
39007004AAE,319,157,143,323,176,136,237,151,86,247,172,75,244,152,87,334,200,130
39025013AAM,423,96,308,426,129,281,343,110,233,343,120,223,344,103,229,527,173,345
39049025AIF,756,422,311,795,514,239,297,242,55,297,245,52,301,224,65,174,136,32
39153077BBH,485,191,275,500,239,237,409,205,204,413,229,184,418,203,207,539,262,270
39025013AFU,610,180,390,630,225,378,419,188,231,420,208,212,425,179,225,640,283,345
39151076AET,464,149,283,463,186,251,402,197,205,408,216,192,413,197,198,597,278,308
39049025BAH,562,232,290,581,274,280,377,195,182,384,216,168,387,208,166,613,285,316
39049025BBF,599,192,378,612,243,336,490,214,276,496,244,252,494,222,258,699,298,395
39151076AHF,465,122,313,476,175,270,377,149,228,375,163,212,378,149,222,541,217,320
39041021AET,652,215,412,661,249,367,532,239,293,529,280,249,532,247,267,772,352,405
39035018AUZ,302,266,27,317,301,12,221,212,9,220,212,8,224,207,14,261,248,11
39035018DAM,139,92,38,142,100,38,122,89,33,124,96,28,122,87,31,164,116,47
39035018AJC,549,501,31,579,562,9,436,417,19,441,433,8,444,415,23,557,528,21
39035018BGM,221,143,60,241,196,37,171,147,24,171,148,23,171,137,26,242,184,57
39035018BYH,462,300,131,493,376,95,384,318,66,387,328,59,393,316,64,554,445,98
39061031BCY,462,212,218,469,255,193,310,192,118,313,208,105,314,190,116,427,262,160
39061031ATR,521,188,317,524,270,232,450,231,219,459,260,199,461,226,216,560,314,242
39061031ASZ,889,272,588,877,411,427,776,390,386,775,425,350,781,385,378,970,543,412
39061031ANA,888,650,208,909,737,149,780,649,131,778,668,110,785,645,125,928,785,131
39035018BLO,717,526,151,745,588,136,615,517,98,617,527,90,621,502,103,764,592,167
39061031BCI,428,97,316,428,134,275,357,125,232,359,142,217,363,126,218,429,147,279
39061031AZF,909,262,628,909,385,484,762,338,424,767,377,390,768,328,428,1013,518,484
39095048AJC,610,328,257,614,348,236,428,264,164,435,304,131,437,265,159,605,354,234
39057029ADR,563,138,411,575,181,375,428,153,275,431,186,245,435,140,282,583,201,376
39093047ACQ,718,284,396,726,382,315,569,322,247,586,373,213,592,319,252,762,401,345
39145073ACS,467,189,258,478,158,300,298,121,177,310,147,163,313,131,173,462,126,327
39153077API,675,257,375,698,336,313,561,271,290,576,313,263,575,272,284,743,376,350
39049025ANK,639,468,134,667,548,96,539,445,94,542,462,80,547,449,92,721,587,121
39085043ACZ,382,210,144,403,244,138,321,213,108,324,234,90,326,207,109,417,260,154
39043022ACA,479,154,284,485,191,261,388,179,209,391,218,173,389,174,197,525,221,296
39099050AAI,443,287,138,458,310,134,325,244,81,334,259,75,328,254,73,446,289,151
39023012ABX,510,171,320,513,214,268,428,210,218,437,244,193,437,208,226,559,264,289
39017009AKZ,677,151,512,693,215,440,555,210,345,571,230,341,575,205,354,718,290,423
39165083AFE,550,157,376,551,225,290,446,180,266,448,206,242,450,172,258,559,269,278
39017009AFU,678,127,522,695,173,501,545,154,391,556,185,371,556,154,382,679,208,465
39049025AXL,447,219,206,461,254,182,342,188,154,350,219,131,351,197,141,524,312,206
39049025AAR,802,512,261,804,588,168,726,559,167,731,611,120,735,575,143,857,699,137
39049025AQE,319,196,108,324,218,88,214,149,65,214,159,55,217,147,60,319,223,87
39085043AHB,735,212,470,759,265,458,607,247,360,615,297,318,619,235,367,855,314,522
39035018CNQ,565,345,199,572,418,141,498,378,120,502,402,100,506,373,125,621,471,147
39035018CUS,946,283,613,968,422,526,811,376,435,831,427,404,843,356,468,1097,494,598
39035018ABV,451,347,85,479,392,76,355,306,49,358,316,42,361,302,55,463,370,84
39061031BKM,502,394,82,523,458,52,394,355,39,396,361,35,391,343,39,483,436,41
39061031BNS,530,158,362,522,246,258,472,218,254,473,237,236,473,210,254,563,301,253
39061031BKP,549,152,374,547,219,301,495,212,283,493,230,263,500,207,279,572,258,305
39165083AAP,784,132,614,806,201,569,672,197,475,678,215,463,684,197,475,869,280,572
39099050AKB,496,198,287,506,216,273,416,195,221,425,237,188,425,209,211,538,217,317
39035018AHL,731,276,384,776,345,395,555,302,253,562,337,225,568,287,261,751,343,393
39035018ACW,564,510,31,585,552,26,431,411,20,428,413,15,436,401,21,549,515,31
39035018BIO,548,294,230,573,354,200,464,330,134,476,355,121,472,316,150,664,435,221
39035018BPM,539,297,214,556,343,193,447,306,141,454,323,131,459,304,142,584,399,182
39035018AWZ,323,271,32,375,346,28,223,197,26,238,220,18,236,200,23,270,255,14
39035018ARO,295,260,24,327,316,7,227,213,14,232,220,12,235,215,12,290,274,16
39035018DBH,735,245,455,751,316,395,642,310,332,645,346,299,650,291,342,815,388,423
39099050ATG,631,178,436,645,233,390,558,219,339,566,272,294,566,253,304,740,267,468
39087044ACH,349,101,236,346,99,238,277,94,183,277,112,165,284,88,189,373,110,259
39049025BHP,579,250,287,582,322,219,484,270,214,486,313,173,486,285,191,646,411,224
39049025ATR,442,142,275,453,173,247,344,144,200,348,172,176,347,157,181,471,207,251
39049025AQP,892,333,536,899,490,365,824,438,386,840,526,314,847,477,360,1005,636,360
39173087AAH,663,362,232,686,401,202,474,350,124,477,368,109,481,326,130,668,414,239
39017009AKY,743,151,557,737,230,468,601,201,400,615,218,397,619,192,390,808,313,483
39077039AAX,687,200,439,695,244,404,528,223,305,523,261,262,528,210,295,727,247,465
39061031APW,608,250,335,614,327,260,502,280,222,503,308,195,510,267,221,637,379,245
39095048ANO,360,218,122,371,243,103,224,157,67,225,160,65,225,155,58,325,200,120
39099050AJR,260,66,187,268,83,179,219,81,138,221,99,122,223,95,125,290,91,196
39099050AOR,348,171,161,355,191,151,305,183,122,302,199,103,306,187,112,377,182,190
39095048AGN,669,292,357,674,347,298,552,314,238,558,365,193,567,319,235,712,411,294
39025013AGA,754,153,566,753,217,498,589,201,388,593,224,369,599,184,395,835,268,550
39093047AAV,1068,224,803,1078,357,679,893,341,552,910,401,509,919,308,595,1221,495,722
39049025AOR,768,305,428,779,393,345,693,389,304,693,446,247,702,407,276,863,523,325
39041021AEF,938,242,673,946,360,544,854,324,530,854,395,459,862,339,511,1041,485,538
39141071ACM,510,190,300,514,227,262,389,181,208,392,202,190,394,184,200,560,237,312
39141071AAB,446,138,299,452,174,261,392,158,234,395,201,194,394,158,231,471,199,268
39113057AWG,438,163,246,459,228,209,350,168,182,356,199,157,360,169,181,455,221,226
39113057AAS,825,203,607,822,323,462,720,282,438,725,368,357,727,290,416,805,390,410
39093047AHF,606,192,381,609,250,334,535,258,277,550,305,245,557,241,303,681,341,331
39085043AIP,473,173,279,486,205,262,422,216,206,425,237,188,425,202,217,675,327,341
39035018ASW,374,346,13,406,395,8,245,237,8,247,239,8,250,234,9,309,294,12
39035018CUR,798,289,484,829,383,417,700,353,347,713,399,314,717,342,363,895,459,430
39035018CRQ,877,666,185,894,773,105,772,689,83,775,707,68,779,688,80,953,859,85
39035018CJQ,671,238,372,697,300,372,554,285,269,569,325,244,572,283,268,794,346,436
39101051AAC,312,116,177,316,135,171,238,97,141,238,114,124,242,111,123,356,131,214
39035018ABX,470,315,118,502,386,101,375,299,76,385,309,76,386,289,84,570,436,124
39035018ALQ,399,354,25,430,416,9,284,273,11,285,277,8,290,278,6,328,317,9
39057029ADS,620,218,374,627,278,302,503,254,249,506,288,218,512,235,251,711,377,306
39083042ACG,410,339,53,422,392,23,347,328,19,352,338,14,346,323,15,314,299,12
39057029AFK,471,126,331,486,152,311,387,131,256,386,154,232,386,127,246,517,155,356
39165083ABF,455,118,306,465,138,290,371,150,221,375,157,218,379,144,218,478,185,280
39165083AFT,732,217,493,752,318,406,679,293,386,692,329,363,692,294,384,884,432,439
39113057ABY,350,143,175,361,191,157,226,117,109,229,135,94,231,116,101,341,161,176
39025013AGO,444,64,344,437,106,306,383,115,268,386,130,256,390,106,271,467,139,324
39155078ABD,561,247,287,571,285,272,465,282,183,476,312,164,477,285,184,621,290,328
39055028AAA,933,226,691,924,361,525,829,339,490,836,384,452,837,318,503,993,442,542
39133067ACD,424,176,218,436,198,224,355,174,181,358,195,163,356,174,171,466,192,268
39099050AOO,309,132,163,316,160,148,252,131,121,259,158,101,260,141,114,340,167,165
39085043AET,728,280,402,766,326,392,595,318,277,594,347,247,600,296,288,864,401,452
39017009ALO,357,45,306,362,48,304,288,49,239,296,60,236,296,39,246,403,61,337
39153077AUX,727,221,476,754,317,407,617,288,329,633,338,295,639,283,340,848,375,468
39017009ABO,555,100,444,571,137,405,444,122,322,463,136,327,460,119,335,609,190,416
39061031BMJ,500,251,230,504,291,196,405,249,156,409,265,144,411,248,150,517,355,154
39061031BIV,732,138,573,741,204,498,663,174,489,661,200,461,665,160,489,783,246,524
39061031AXX,706,452,234,709,520,166,620,463,157,616,487,129,619,466,146,719,530,179
39061031AFG,346,288,45,360,345,15,271,249,22,273,258,15,271,238,25,400,368,27
39035018CFT,388,157,212,416,194,199,309,184,125,315,195,120,319,185,129,472,217,250
39061031AZW,995,261,685,1013,353,586,810,346,464,808,365,443,817,317,454,1112,487,605
39035018CET,721,297,381,753,388,333,615,367,248,623,398,225,628,358,248,802,434,358
39035018BEW,343,231,83,396,318,72,221,179,42,224,195,29,228,167,53,328,255,68
39061031APY,408,364,27,424,408,9,185,176,9,187,177,10,183,171,9,287,259,24
39017009AHW,1029,148,850,1044,187,825,871,212,659,892,250,642,899,211,668,1172,251,912
39169085ABD,734,249,446,739,305,406,594,265,329,608,296,312,613,275,325,750,326,408
39165083AGA,728,139,563,729,191,493,628,182,446,634,205,429,633,181,426,878,266,593
39049025AQN,658,220,430,674,346,306,626,284,342,640,356,284,640,334,301,700,381,309
39041021AAK,618,193,388,636,254,338,512,212,300,516,275,241,521,247,257,752,338,390
39061031AZQ,779,184,575,784,323,425,697,292,405,700,333,367,701,295,391,863,403,445
39049025AUI,742,305,399,747,358,354,621,325,296,626,368,258,636,329,281,769,432,326
39049025BKU,377,249,110,401,299,75,146,126,20,147,130,17,147,118,20,58,49,8
39153077ATS,472,170,274,476,223,234,381,198,183,394,231,163,393,198,181,499,251,238
39017009AIL,767,210,533,766,304,419,605,251,354,625,298,327,624,264,341,820,423,382
39017009AMB,462,82,355,458,120,310,353,107,246,368,125,243,367,102,258,512,180,323
39099050AID,619,249,346,630,281,319,490,242,248,502,291,211,502,254,231,649,301,341
39007004ABX,363,144,199,366,163,189,272,137,135,277,152,125,278,132,133,389,153,226
39099050ASS,575,217,338,602,270,303,500,248,252,499,304,195,508,252,251,645,267,370
39113057ASF,741,185,514,755,235,472,583,215,368,586,252,334,591,217,354,752,260,485
39085043AFE,595,283,279,619,344,249,525,336,189,531,357,174,534,319,198,722,445,268
39035018BUB,612,352,223,639,413,207,455,339,116,459,361,98,466,327,123,591,419,165
39061031AEN,1183,440,726,1171,631,467,1009,537,472,1010,596,414,1023,546,450,1303,813,471
39035018BUQ,628,205,407,632,281,331,532,258,274,547,290,257,544,246,289,695,310,376
39061031BAA,1147,272,832,1138,422,659,968,407,561,966,454,512,976,401,551,1211,557,635
39153077BBV,706,223,458,736,326,385,611,303,308,633,339,294,630,307,309,776,376,392
39151076AFL,208,54,149,210,68,137,190,79,111,194,100,94,195,82,106,263,99,161
39049025AMA,603,543,46,626,591,28,498,469,29,513,494,19,508,480,22,630,585,44
39061031BHZ,502,68,417,519,98,398,432,106,326,431,130,301,432,90,329,510,105,391
39057029ADK,480,134,321,476,183,268,419,174,245,421,204,217,416,167,237,529,232,287
39035018ARX,352,318,20,377,368,6,280,269,11,281,272,9,286,269,12,325,315,8
39035018BRV,757,349,367,798,449,310,664,415,249,677,455,222,683,415,249,888,538,336
39035018ANX,362,330,18,413,408,3,148,146,2,146,144,2,148,139,0,215,198,15
39035018DBM,561,254,261,583,309,235,441,272,169,441,297,144,444,262,167,653,361,278
39095048ABR,1025,329,654,1028,454,514,834,415,419,846,471,375,855,407,426,1060,532,512
39025013AHY,540,127,392,545,164,351,426,150,276,430,164,266,433,148,268,610,197,403
39165083AGF,1059,132,892,1066,230,795,886,199,687,908,234,674,905,197,685,1182,319,853
39017009ALG,824,151,653,835,213,593,654,196,458,671,231,440,660,197,445,942,304,624
39173087ABG,711,179,516,713,248,435,602,223,379,606,278,328,608,224,374,824,359,454
39155078AGA,491,168,301,501,189,297,396,169,227,408,204,204,400,177,214,549,194,345
39113057ART,519,138,364,521,187,311,468,197,271,471,225,246,474,189,273,581,235,336
39113057ACF,575,201,352,577,229,319,463,198,265,470,228,242,474,198,261,591,260,324
39103052ADF,608,172,402,611,226,360,522,232,290,537,256,281,537,225,300,699,277,408
39063032AAA,442,150,254,450,185,228,308,139,169,315,159,156,319,133,168,470,200,260
39035018CVK,807,251,520,832,357,440,680,316,364,691,354,337,696,305,375,920,421,489
39035018AFP,623,172,431,642,244,380,505,221,284,520,234,286,527,213,305,710,295,413
39061031AAN,556,223,318,565,325,201,506,307,199,508,330,178,511,296,198,600,396,196
39025013ACW,463,100,330,465,111,328,332,102,230,332,116,216,333,87,222,488,130,351
39003002AFU,568,101,426,566,124,400,448,126,322,453,170,283,456,118,322,590,149,430
39017009AJQ,670,160,479,679,227,412,546,216,330,558,237,321,559,208,326,735,289,431
39049025BKQ,593,159,408,598,194,384,509,177,332,512,250,262,515,233,271,627,235,387
39153077AOP,653,274,360,692,355,312,566,305,261,575,342,233,584,303,260,803,439,351
39153077AUB,406,181,205,424,198,208,328,183,145,345,208,137,334,182,139,473,244,217
39035018BWQ,760,445,258,796,564,191,687,533,154,692,559,133,692,519,150,902,655,229
39103052ADZ,969,246,678,992,296,659,841,305,536,863,332,531,867,289,563,1138,361,763
39035018ADW,444,170,262,467,227,218,388,226,162,394,242,152,395,216,167,484,262,221
39035018ACQ,556,471,75,578,516,57,485,436,49,487,447,40,490,434,53,558,491,65
39061031BLQ,619,414,195,629,476,141,502,370,132,501,382,119,509,372,130,652,503,142
39005003AAA,681,167,481,700,210,467,570,191,379,569,233,336,582,197,373,724,255,458
39093047AHE,631,223,377,625,283,320,520,251,269,545,303,242,548,248,288,707,353,345
39025013AHL,386,82,275,393,122,246,286,112,174,286,130,156,289,107,171,447,168,268
39061031BKU,398,220,159,398,278,108,349,255,94,345,262,83,347,244,95,417,306,104
39055028AAJ,793,247,514,791,336,439,726,313,413,728,341,387,732,297,422,929,433,487
39085043ABM,578,161,395,592,224,342,500,223,277,510,250,260,511,203,294,684,284,395
39049025ASO,945,449,470,943,567,344,870,529,341,874,599,275,881,548,323,1131,764,351
39049025APA,314,174,105,328,187,112,227,158,69,230,166,64,231,155,69,335,209,120
39133067AAE,726,190,519,735,294,415,685,303,382,695,318,377,693,291,396,995,442,548
39035018DEX,576,522,37,598,573,18,563,531,32,567,547,20,571,537,26,594,568,25
39035018BXL,492,283,164,509,351,137,411,301,110,411,326,85,416,286,115,551,428,118
39085043AFU,134,53,67,139,68,66,112,64,48,113,69,44,114,62,48,150,71,77
39085043ADO,656,267,351,677,311,335,544,291,253,558,329,229,557,278,251,747,373,357
39165083AFP,826,212,586,845,328,481,722,292,430,741,342,399,741,299,420,938,454,467
39035018CMP,687,340,291,708,417,258,538,368,170,546,384,162,545,350,182,751,475,271
39013007AAS,320,101,199,321,102,199,294,134,160,306,153,153,307,117,183,337,125,209
39025013AFW,412,82,313,411,113,284,325,95,230,322,110,212,324,95,214,459,133,314
39113057AXS,565,149,403,565,206,337,504,190,314,513,236,277,516,184,316,609,252,346
39165083AGS,497,91,380,508,108,360,469,123,346,479,146,333,478,118,339,655,167,478
39049025ASQ,754,283,451,750,371,341,711,337,374,715,401,314,717,365,342,810,457,336
39099050AAX,555,181,350,559,237,303,456,190,266,465,251,214,465,213,240,578,254,318
39055028ACP,516,154,357,512,234,260,476,232,244,473,245,228,479,218,250,597,300,293
39153077BCI,554,236,290,569,299,251,473,267,206,486,288,198,478,253,210,635,333,297
39049025BJY,814,334,430,835,417,359,691,386,305,690,429,261,694,385,289,949,547,378
39153077BBY,541,254,248,561,315,206,475,315,160,483,327,156,481,304,160,700,432,255
39035018DEC,644,261,352,662,331,302,565,306,259,568,335,233,574,310,248,719,388,323
39035018BEZ,719,503,162,746,576,129,688,600,88,694,617,77,695,593,78,832,674,149
39129065ACB,282,77,187,290,86,193,212,60,152,215,74,141,219,69,145,297,87,206
39089045ABO,610,173,404,621,234,348,492,183,309,499,239,260,494,190,288,657,262,377
39165083AGQ,446,68,360,462,75,370,343,82,261,351,92,259,349,77,261,497,91,401
39025013ABH,456,83,343,468,105,342,272,83,189,273,83,190,276,74,189,452,102,341
39025013ACF,670,126,526,672,192,436,591,191,400,590,204,386,589,179,384,851,298,531
39153077ATW,507,187,303,520,247,253,427,220,207,446,251,195,448,222,218,537,280,253
39143072ABR,689,170,486,691,267,387,593,230,363,604,304,300,607,234,354,746,289,448
39035018CCQ,485,197,252,508,222,264,388,205,183,396,220,176,396,196,189,587,278,306
39017009AJG,703,236,447,719,329,356,585,284,301,596,308,288,602,294,290,776,380,383
39061031AIC,546,471,58,580,552,24,428,402,26,436,417,19,424,389,22,568,534,27
39099050AKZ,402,174,210,409,194,200,339,166,173,345,201,144,345,181,159,419,206,207
39103052ADY,702,177,500,717,206,480,626,206,420,640,239,401,645,207,417,862,265,587
39035018DAH,639,371,251,653,499,133,587,460,127,587,454,133,593,424,161,721,556,159
39035018BSA,667,277,349,682,385,261,593,359,234,604,391,213,607,363,230,785,482,292
39165083AFR,447,90,335,449,130,303,372,123,249,380,140,240,381,116,257,465,152,310
39035018CFZ,706,189,484,727,273,434,595,252,343,607,290,317,608,244,353,802,317,478
39035018AVB,261,228,19,276,260,7,187,176,11,190,181,9,188,173,11,239,229,5
39057029ADO,369,124,226,367,143,202,262,120,142,265,137,128,267,116,143,416,160,246
39153077AYI,675,251,418,662,329,306,616,319,297,616,346,270,620,317,294,768,435,324
39061031BBK,353,92,240,358,128,219,260,110,150,262,127,135,261,109,145,344,161,178
39049025AQA,566,239,297,578,332,214,508,290,218,503,320,183,509,297,200,637,374,249
39041021ABE,707,223,469,706,330,333,610,262,348,615,321,294,617,279,329,758,433,310
39133067AGQ,531,216,278,550,260,260,456,243,213,461,262,199,464,242,204,595,298,285
39085043ABC,839,242,567,869,314,519,706,297,409,703,329,374,714,277,422,942,368,561
39061031ANV,606,448,133,629,547,69,468,396,72,474,410,64,465,379,76,595,515,74
39061031BLI,205,137,60,203,164,38,155,130,25,157,134,23,155,119,32,217,174,41
39145073ADE,111,32,76,113,23,87,57,18,39,56,22,34,58,20,37,82,15,67
39017009ABK,609,108,476,620,149,426,433,124,309,450,129,321,456,129,309,631,180,437
39107054AAJ,482,71,391,480,109,351,396,94,302,393,147,246,398,98,286,517,110,400
39165083ACE,648,161,454,646,244,359,533,201,332,550,237,313,554,207,324,670,283,371
39055028ACB,768,187,547,769,226,512,635,214,421,631,246,385,639,206,408,821,269,541
39017009AGF,706,131,550,729,169,535,528,118,410,544,146,398,548,123,414,789,161,618
39061031ABL,709,318,352,728,427,257,568,360,208,569,375,194,577,339,213,753,481,255
39035018ABP,552,342,202,587,451,132,483,395,88,483,399,84,483,373,103,660,528,129
39017009AAI,409,126,267,413,158,220,309,145,164,316,166,150,316,142,162,427,203,216
39095048AOV,496,218,239,510,266,207,388,251,137,392,276,116,394,245,134,549,309,228
39113057AVX,411,163,215,424,203,201,331,162,169,331,191,140,335,154,161,450,212,229
39085043AAC,879,312,537,901,359,502,753,333,420,765,387,378,769,309,438,970,380,584
39017009AJZ,735,177,535,739,246,455,612,227,385,631,260,371,632,222,389,785,326,451
39035018DEL,435,395,29,453,435,12,322,312,10,324,318,6,332,323,5,375,363,10
39035018BZL,732,355,349,754,450,269,651,423,228,652,449,203,658,399,244,812,536,270
39081041ABU,551,189,328,559,175,357,429,197,232,429,217,212,430,173,249,592,214,377
39035018CVO,444,157,269,466,209,247,365,182,183,374,202,172,371,168,193,505,230,273
39165083ABZ,682,161,496,697,241,416,602,243,359,613,269,344,613,243,365,763,316,431
39099050AKA,466,221,220,481,247,212,381,229,152,390,263,127,392,242,140,545,304,237
39175088AAB,407,98,290,415,119,272,299,97,202,300,124,176,299,92,199,416,119,296
39035018CEX,707,256,426,722,355,340,596,302,294,605,333,272,612,299,302,797,412,379
39035018BFA,321,205,82,350,258,83,197,144,53,199,151,48,202,138,57,318,202,111
39035018CGH,622,214,361,636,254,353,497,243,254,501,264,237,505,226,262,673,295,365
39035018AXV,293,202,70,330,253,71,190,144,46,190,150,40,189,140,42,279,210,66
39093047AFP,451,332,92,472,369,87,305,252,53,321,272,49,317,250,57,423,297,121
39095048ABL,599,246,325,624,279,314,512,274,238,514,299,215,521,269,229,668,316,342
39113057AAG,1160,272,846,1168,378,721,978,349,629,993,426,567,998,339,638,1228,511,700
39049025BDA,519,199,304,490,249,223,486,233,253,493,279,214,496,262,227,547,298,241
39173087AAX,687,264,390,688,312,316,589,290,299,595,323,272,595,292,286,765,405,346
39061031AJW,488,435,39,506,485,14,349,334,15,347,339,8,343,317,13,454,423,22
39061031BHH,485,209,251,499,271,206,413,255,158,413,264,149,419,245,163,549,320,217
39025013ACT,376,73,278,375,87,272,276,75,201,274,79,195,277,72,188,423,120,291
39017009AME,634,139,470,650,190,442,505,146,359,525,175,350,523,151,354,711,237,459
39099050AOE,617,158,446,636,199,418,516,168,348,527,239,288,534,202,323,659,232,423
39061031BIL,396,95,280,400,120,259,300,114,186,301,126,175,301,104,187,424,148,261
39103052ABU,940,300,602,948,414,486,732,361,371,748,399,349,751,357,379,1045,503,527
39035018CVU,948,270,647,961,379,557,835,372,463,845,396,449,851,349,487,1152,487,658
39061031BGI,910,168,710,931,230,660,774,238,536,774,278,496,787,217,540,951,304,633
39061031BCM,988,139,814,1003,225,729,853,199,654,859,243,616,872,185,658,1043,290,742
39025013ACD,623,120,486,614,195,379,549,200,349,546,224,322,554,197,340,674,286,372
39055028ACN,562,195,339,558,276,257,492,253,239,495,285,210,500,238,244,613,312,289
39049025BKV,919,498,405,969,634,288,446,350,96,446,356,90,447,346,90,220,173,44
39049025ASM,613,282,306,616,330,241,564,334,230,566,379,187,572,350,208,673,429,234
39049025AWS,654,223,415,650,305,316,642,303,339,638,340,298,645,314,322,745,395,339
39055028ACT,800,270,503,787,363,399,673,310,363,683,350,333,681,304,368,855,391,456
39025013AAG,784,179,574,791,236,510,574,208,366,573,214,359,575,204,357,775,270,492
39041021ABG,735,231,479,725,335,359,693,315,378,695,387,308,699,346,342,816,462,342
39153077AWQ,697,271,392,726,309,386,588,293,295,609,329,280,598,269,304,864,397,451
39061031BBT,398,114,267,402,133,250,346,149,197,346,161,185,347,140,200,389,163,222
39035018BHS,524,269,211,543,336,181,394,274,120,402,294,108,402,256,136,569,359,200
39061031BDA,680,256,396,691,305,355,536,275,261,538,297,241,541,261,261,762,407,340
39061031BGS,725,121,585,726,209,494,621,187,434,621,232,389,629,172,439,734,225,503
39035018AUG,773,578,154,816,683,101,321,291,30,329,302,27,328,286,30,362,325,31
39151076AHX,728,182,507,754,229,501,577,204,373,580,222,358,586,198,368,841,278,561
39049025AWQ,519,168,338,515,237,255,481,227,254,484,267,217,490,237,245,538,289,246
39035018CLH,249,105,120,263,128,115,185,113,72,193,115,78,195,109,75,285,151,129
39055028ABE,622,183,419,638,247,378,511,228,283,519,255,264,519,212,294,717,278,430
39017009AIN,623,169,431,631,225,378,497,203,294,516,223,293,517,203,298,694,302,381
39017009AEK,511,187,294,523,227,270,344,172,172,363,189,174,354,160,175,574,262,304
39057029AFL,349,128,202,359,167,175,244,104,140,245,128,117,246,94,142,397,152,232
39085043ABU,630,207,402,662,270,367,534,257,277,542,293,249,540,243,280,745,315,417
39157079ADC,689,140,517,706,174,501,565,172,393,569,208,361,571,174,380,755,221,525
39061031AJQ,552,471,65,571,538,20,435,415,20,445,429,16,442,412,21,557,519,34
39035018AUX,559,521,21,599,583,10,461,448,13,466,460,6,468,449,12,538,518,15
39035018AHN,716,308,353,760,378,349,553,349,204,562,360,202,559,328,213,744,376,356
39025013ACR,519,105,393,522,141,360,461,166,295,462,167,295,465,155,294,590,216,369
39041021ABV,330,83,236,339,107,214,300,82,218,297,123,174,306,101,195,369,141,224
39049025ARV,655,251,391,632,330,276,606,274,332,605,327,278,612,293,310,671,359,299
39039020AAB,672,203,449,677,242,411,592,222,370,591,262,329,601,213,375,735,254,465
39061031ABM,504,162,326,505,233,252,465,218,247,463,229,234,469,212,253,571,300,265
39061031ASI,691,164,520,674,273,375,589,227,362,593,257,336,591,229,348,740,365,367
39061031BAG,551,135,401,546,208,323,459,187,272,463,211,252,465,177,272,602,273,321
39035018AEQ,810,218,571,818,310,476,713,295,418,714,317,397,725,283,428,928,423,500
39025013ACV,498,97,392,504,140,338,434,149,285,433,169,264,436,148,274,536,192,337
39049025ASD,733,370,339,738,441,252,588,362,226,596,404,192,599,373,208,771,519,233
39151076AHE,584,165,389,587,207,353,488,202,286,492,224,268,494,208,277,655,290,359
39081041ABL,544,183,338,554,163,367,460,193,267,464,217,247,464,170,283,615,210,398
39061031AQI,368,261,78,380,304,62,287,234,53,290,245,45,289,230,52,354,288,63
39061031AFK,568,500,50,590,576,8,458,443,15,457,446,11,461,436,16,560,548,11
39035018CPX,890,304,544,914,403,481,713,365,348,725,411,314,732,360,351,880,385,487
39035018CFS,725,223,468,737,280,430,616,277,339,621,300,321,630,261,359,815,373,436
39007004ADS,203,68,110,208,71,129,153,69,84,157,83,74,156,66,83,283,93,183
39061031BDP,2,0,2,2,0,2,2,0,2,2,0,2,2,0,2,2,2,0
39035018ACY,677,611,34,697,658,22,510,494,16,507,493,14,513,490,12,614,586,26
39035018BYF,455,299,112,476,358,92,368,299,69,371,316,55,371,289,71,533,389,132
39061031ARN,406,274,117,411,308,90,348,284,64,349,288,61,349,279,65,448,372,70
39061031BMK,92,72,19,96,87,8,73,67,6,74,67,7,75,69,6,95,87,6
39017009ABN,595,146,435,598,186,386,480,166,314,498,201,297,498,165,312,656,240,401
39049025AWU,415,210,189,430,255,158,440,222,218,442,260,182,443,237,202,637,387,246
39035018CVJ,683,205,454,708,295,392,576,233,343,580,259,321,593,232,350,755,325,423
39035018BPN,537,315,188,575,387,167,454,312,142,462,339,123,467,313,145,579,405,172
39061031BHS,634,79,544,639,129,482,533,109,424,531,120,411,540,98,438,663,166,486
39061031ABH,454,210,221,463,270,173,396,253,143,393,269,124,402,237,151,494,310,179
39061031ASO,615,171,431,613,241,329,536,225,311,551,248,303,546,224,313,659,280,370
39093047AAP,551,148,380,563,221,315,463,204,259,484,251,233,487,217,260,637,287,348
39061031AST,576,144,415,581,211,346,486,197,289,485,219,266,490,187,290,628,270,346
39035018BPE,427,320,87,448,368,67,331,278,53,338,285,53,344,276,61,484,401,80
39043022ADJ,559,209,328,570,240,299,466,217,249,471,264,207,471,231,221,615,270,333
39061031BDO,9,0,9,10,3,7,10,3,7,10,3,7,10,2,7,10,3,7
39099050AOG,595,199,371,606,252,340,553,237,316,556,289,267,561,249,302,650,264,385
39035018AFV,228,119,89,236,129,88,169,122,47,167,119,48,174,119,47,256,161,89
39061031AYU,849,210,616,851,330,470,717,299,418,715,335,380,716,294,407,894,424,459
39035018AET,778,203,552,777,281,458,703,284,419,709,320,389,710,278,422,881,384,481
39061031ARR,662,528,116,673,595,61,590,530,60,592,543,49,586,517,62,689,612,70
39035018CBY,696,457,208,733,532,181,532,410,122,538,419,119,536,391,128,752,586,164
39061031BHP,1001,200,771,1015,299,689,889,286,603,900,329,571,890,251,612,1082,332,742
39025013AFH,851,150,659,860,222,598,715,202,513,714,232,482,725,199,509,965,286,663
39085043ABD,667,223,430,699,290,375,602,263,339,601,301,300,605,257,337,771,346,416
39103052ACB,751,210,505,763,300,430,612,247,365,630,283,347,635,253,370,938,424,500
39061031BHM,977,137,812,969,220,706,847,226,621,853,261,592,856,195,643,986,297,675
39017009AAD,455,174,261,464,231,215,332,188,144,342,200,142,337,189,142,538,318,213
39061031AYP,607,261,336,602,372,206,556,359,197,557,370,187,560,344,206,692,430,258
39035018CNJ,411,369,22,437,416,14,254,229,25,257,239,18,258,232,20,306,283,22
39017009AAE,382,157,211,388,191,176,299,157,142,309,175,134,306,155,138,449,272,169
39035018AFZ,444,253,164,459,309,135,334,242,92,337,250,87,339,239,90,502,351,145
39057029AFB,445,111,302,450,144,271,348,135,213,350,159,191,352,124,213,475,175,286
39087044AAW,145,60,77,148,56,86,102,45,57,105,57,48,103,45,55,156,52,104
39035018AZB,183,143,32,193,163,22,156,127,29,159,135,24,158,125,28,179,129,39
39095048ARJ,751,459,239,767,541,187,614,471,143,620,504,116,622,461,144,803,608,179
39061031BHB,990,157,812,1010,236,729,853,216,637,861,266,595,868,199,646,1074,288,766
39061031AMI,779,649,92,808,735,51,503,456,47,500,464,36,503,450,35,710,622,75
39035018AFU,793,235,524,811,351,439,660,310,350,675,352,323,676,307,357,883,413,463
39035018CNR,557,385,147,575,440,125,467,376,91,472,392,80,476,377,94,633,500,127
39061031AYZ,553,138,400,552,225,294,454,207,247,456,225,231,455,193,254,571,270,290
39035018BJA,689,345,311,719,445,253,608,404,204,610,421,189,616,392,214,743,449,284
39061031AWE,553,135,396,560,180,358,443,172,271,442,189,253,443,155,264,609,230,365
39035018BXV,613,330,267,640,410,205,563,373,190,566,387,179,564,367,184,713,481,231
39035018DEO,406,368,18,423,413,4,284,278,6,282,278,4,285,271,7,319,302,13
39165083AGE,1000,315,657,1015,442,534,836,384,452,847,421,426,847,380,452,1178,575,585
39061031BEU,654,127,506,659,171,457,548,163,385,552,198,354,561,151,399,686,203,469
39061031BAK,507,120,363,502,189,279,433,184,249,438,205,233,439,182,248,537,254,276
39153077AUZ,32,17,10,40,22,16,10,4,6,10,6,4,11,2,4,13,7,6
39061031AJS,407,269,119,417,328,76,406,323,83,408,340,68,411,314,89,457,383,66
39061031AOV,460,382,57,481,445,28,347,318,29,346,324,22,347,316,28,476,432,39
39061031BJX,383,53,316,385,68,298,321,65,256,320,91,229,323,66,253,405,100,296
39035018CBE,567,421,118,587,480,89,401,334,67,400,346,54,404,323,68,535,449,81
