GEOID20,Tot_2016_pres,D_2016_pres,R_2016_pres,Tot_2019_ag,D_2019_ag,R_2019_ag,Tot_2019_gov,D_2019_gov,R_2019_gov,Tot_2019_ltg,D_2019_ltg,R_2019_ltg,Tot_2020_sen,D_2020_sen,R_2020_sen,Tot_2020_pres,D_2020_pres,R_2020_pres,Tot_2018_sen_roff,D_2018_sen_roff,R_2018_sen_roff,Tot_2018_sen,D_2018_sen,R_2018_sen,Tot_2018_sen_spec,D_2018_sen_spec,R_2018_sen_spec
28037000102,440,276,157,396,241,155,396,258,136,382,221,161,460,292,166,464,279,176,330,233,97,310,200,102,317,210,107
28037000103,264,189,68,209,159,50,211,160,47,203,141,62,272,204,65,270,196,66,190,154,36,193,140,44,202,143,59
28027000004,621,609,10,296,278,18,301,293,6,292,281,11,568,557,11,567,542,16,444,440,4,364,341,14,384,378,6
28027000001,264,141,120,161,86,75,168,95,73,159,81,78,270,143,125,271,134,136,194,112,82,189,90,97,197,112,85
28013000004,524,425,86,414,324,90,420,344,71,403,307,96,492,394,95,489,377,103,381,315,66,362,275,82,372,294,78
28013000001,392,38,347,325,40,285,326,56,269,325,48,277,441,59,374,441,52,388,287,33,254,310,27,275,308,39,269
28095000506,566,553,10,391,380,11,394,387,4,386,369,17,564,547,15,561,535,18,452,448,4,380,355,24,385,371,14
28119000103,205,150,53,146,97,49,154,115,38,142,97,45,174,135,34,175,128,44,150,118,32,138,91,42,141,103,38
28095000103,79,9,69,68,12,56,69,13,54,69,10,59,98,13,83,99,9,90,64,9,55,60,10,49,59,10,49
28095000302,260,20,239,181,26,155,182,26,156,178,20,158,263,26,230,262,17,245,153,14,139,173,14,155,170,21,149
28095000401,1007,844,160,744,605,139,759,632,123,732,565,167,1018,847,162,1004,812,170,854,728,126,717,553,157,732,573,159
28095000305,680,103,566,584,100,484,585,119,460,582,87,495,778,137,629,770,107,647,506,90,416,539,71,460,542,89,453
28095000307,412,77,332,319,68,251,326,89,233,319,56,263,474,97,363,473,79,393,288,60,228,294,51,238,300,61,239
28119000202,560,450,103,401,298,103,431,331,91,394,283,111,511,412,91,509,393,110,391,318,73,361,242,108,371,289,82
28119000301,363,183,174,350,193,157,364,220,140,351,190,161,377,222,153,376,198,171,266,151,115,301,148,146,304,174,130
28119000401,351,252,84,281,205,76,307,237,62,281,205,76,340,259,75,333,243,84,255,201,54,232,167,60,240,192,48
28155000101,128,60,68,104,43,61,104,55,49,102,39,63,133,57,76,130,49,81,102,51,51,91,43,48,93,42,51
28135000402,167,103,61,106,63,43,113,74,38,104,56,48,157,103,53,157,98,55,131,90,41,115,67,47,121,81,40
28135000503,538,479,54,373,329,44,386,332,44,369,303,66,491,449,39,491,435,46,463,429,34,397,329,60,440,397,43
28135000502,123,89,34,76,55,21,82,64,17,74,54,20,104,81,23,103,79,24,91,70,21,71,49,22,82,59,23
28027000014,1312,1222,71,600,551,49,619,569,42,578,514,64,1143,1077,58,1134,1029,89,931,887,44,764,658,77,864,806,58
28027000017,481,460,16,252,243,9,259,249,7,246,219,27,464,453,8,460,432,21,390,383,7,331,299,26,361,347,14
28027000005,910,312,585,602,196,406,614,251,361,604,191,413,954,370,580,957,335,613,762,272,490,763,199,556,777,250,527
28027000002,204,182,20,98,87,11,106,95,10,97,87,10,195,184,11,200,180,18,174,163,11,149,123,23,155,143,12
28049000203,454,446,5,333,324,9,335,330,3,333,280,53,417,411,4,416,401,12,393,392,1,368,350,15,370,363,7
28049000202,372,363,5,275,268,7,276,270,4,272,229,43,389,378,9,383,369,12,322,320,2,302,285,12,306,297,9
28049000317,489,450,26,253,234,19,254,235,15,252,213,39,392,364,24,387,355,29,344,335,9,321,293,22,327,302,25
28049000306,375,353,19,199,183,16,200,186,12,200,170,30,387,363,21,391,356,29,271,264,7,253,231,18,259,238,21
28049000511,344,335,4,241,236,5,245,241,2,244,218,26,331,323,4,330,316,8,291,290,1,269,254,12,275,266,9
28043000401,1507,1378,114,968,884,84,976,891,71,956,861,95,1491,1374,106,1479,1333,137,1184,1104,80,1159,1009,132,1173,1078,95
28043000102,1614,500,1089,1194,380,814,1218,486,718,1197,418,779,1678,624,1035,1672,557,1098,1196,415,781,1236,360,856,1235,400,835
28043000103,500,83,410,351,84,267,359,103,254,354,95,259,562,144,408,566,114,446,336,81,255,348,63,279,352,85,267
28043000203,729,171,551,504,124,380,514,173,339,503,138,365,771,194,567,779,172,602,457,114,343,513,110,394,510,128,382
28043000104,328,105,223,257,66,191,263,91,170,258,81,177,349,99,245,347,89,257,250,75,175,250,61,179,256,71,185
28043000301,1461,1045,396,810,626,184,817,645,166,803,605,198,1549,1180,351,1536,1132,385,1053,823,230,1037,762,263,1057,808,249
28043000502,731,185,540,541,164,377,556,193,350,545,179,366,756,204,532,755,186,562,471,122,349,487,110,370,493,128,365
28061000201,565,400,165,396,261,135,398,264,130,388,242,146,590,406,183,582,388,192,476,340,136,439,289,146,448,297,151
28061000205,401,196,204,285,127,158,285,133,147,283,123,160,431,210,220,427,200,223,314,166,148,311,144,160,311,145,166
28061000206,399,329,68,254,203,51,257,207,49,249,192,57,389,320,67,388,310,72,323,274,49,286,227,52,295,237,58
28049000516,280,271,6,200,197,3,202,197,3,199,179,20,298,292,4,299,282,10,236,234,2,220,208,10,223,219,4
28049000518,463,439,17,333,320,13,333,323,7,330,296,34,486,475,8,488,463,19,393,387,6,359,332,21,368,355,13
28049000526,686,657,5,266,264,2,266,258,3,264,255,9,411,408,2,411,395,5,345,345,0,382,376,3,385,362,23
28049000517,221,213,6,159,153,6,158,153,5,159,143,16,211,208,3,210,201,7,186,185,1,173,162,9,177,172,5
28049000520,330,317,10,216,209,7,216,209,3,216,185,31,302,297,5,302,287,12,289,288,1,263,243,15,270,268,2
28049000208,611,596,11,490,475,15,490,476,7,483,407,76,671,657,11,670,644,16,544,536,8,513,480,25,524,507,17
28049000105,615,453,147,449,349,100,455,379,73,453,325,128,622,507,111,621,487,123,502,414,88,501,391,106,499,394,105
28049000514,547,441,102,358,294,64,360,300,57,360,273,87,526,444,80,522,419,99,415,351,64,392,308,82,395,315,80
28049000522,232,186,43,152,124,28,150,124,24,148,114,34,243,205,37,243,195,45,177,149,28,165,128,33,168,133,35
28049000307,1160,1084,66,912,863,49,917,870,36,910,785,125,1294,1231,59,1297,1219,64,1034,997,37,969,886,67,980,922,58
28049000121,563,209,333,489,177,312,492,268,219,498,139,359,661,278,372,658,266,368,467,191,276,514,191,320,512,202,310
28049000120,1846,1796,31,1439,1401,38,1447,1419,20,1437,1257,180,1807,1779,26,1803,1747,43,1642,1625,17,1584,1515,52,1605,1574,31
28049000217,1538,1488,33,1198,1181,17,1202,1180,15,1187,1074,113,1524,1502,18,1522,1486,29,1383,1372,11,1314,1253,42,1337,1307,30
28103000403,129,36,92,115,34,81,114,39,73,111,30,81,134,36,98,132,32,100,97,23,74,103,21,77,105,28,77
28103000404,649,510,135,519,412,107,537,429,104,511,385,126,673,543,125,666,525,136,535,433,102,488,374,111,483,371,112
28063000004,220,201,17,202,186,16,204,192,10,201,172,29,240,220,19,236,208,26,188,175,13,192,160,19,202,184,18
28063000013,241,215,26,208,180,28,208,188,19,204,159,45,238,215,23,235,207,26,211,193,18,209,162,39,216,180,36
28063000005,326,306,15,286,267,19,294,274,16,284,247,37,328,310,16,325,302,19,276,263,13,257,227,22,262,231,31
28063000009,795,749,44,699,644,55,711,661,39,689,574,115,828,785,42,825,760,52,673,643,30,645,548,81,676,611,65
28115000405,427,112,306,312,80,232,315,107,202,310,70,240,482,133,343,481,120,354,319,85,234,307,67,228,315,74,241
28115000503,537,65,466,369,62,307,371,78,292,366,56,310,577,85,478,582,68,509,386,50,336,395,50,330,400,62,338
28147000103,564,82,472,375,68,307,377,77,297,372,63,309,583,115,459,585,100,481,376,66,310,406,59,340,414,66,348
28067000509,178,158,18,144,128,16,148,135,12,141,116,25,204,175,26,204,169,31,166,150,16,163,141,21,166,146,20
28027000006,177,146,30,90,69,21,91,73,18,88,69,19,165,136,28,166,126,38,123,105,18,116,89,26,119,96,23
28027000018,656,414,231,349,195,154,356,204,144,349,181,168,636,428,203,639,411,216,495,318,177,469,235,222,494,291,203
28027000015,170,89,77,101,56,45,106,57,45,99,50,49,197,122,74,197,109,84,129,77,52,120,51,65,130,70,60
28027000003,539,488,47,262,241,21,269,247,19,255,222,33,498,462,36,495,440,43,421,399,22,397,325,51,424,389,35
28027000016,50,16,34,38,16,22,39,17,22,39,18,21,55,22,33,55,21,34,40,14,26,43,11,28,42,12,30
28107000204,1011,760,240,732,531,201,756,549,197,734,532,202,1013,774,231,1011,740,259,763,600,163,754,530,216,762,539,223
28107000101,1031,670,348,697,422,275,708,434,260,697,424,273,999,657,333,997,611,371,760,536,224,763,472,273,774,515,259
28107000103,1166,847,305,815,548,267,838,567,257,823,539,284,1110,754,340,1100,712,378,899,676,223,797,521,263,803,555,248
28123000203,283,133,147,215,98,117,214,111,101,214,86,128,302,134,160,304,133,167,211,100,111,207,80,124,213,92,121
28085000302,964,61,892,704,80,624,702,118,570,700,76,624,1068,95,951,1072,75,987,731,49,682,713,46,658,733,47,686
28085000103,519,194,318,394,162,232,395,187,206,388,149,239,549,211,329,551,208,338,427,173,254,416,165,245,427,172,255
28121000107,740,151,566,550,135,415,548,147,388,550,110,440,763,161,591,761,147,605,550,130,420,586,117,444,588,133,455
28121000303,1125,508,603,787,395,392,782,403,367,781,362,419,1202,547,636,1202,519,672,849,438,411,879,402,467,884,424,460
28121000104,397,74,316,283,59,224,285,70,205,284,53,231,425,91,332,425,89,334,286,63,223,291,50,236,295,58,237
28121000312,3618,931,2616,2586,841,1745,2570,1062,1489,2589,788,1801,4186,1412,2697,4185,1306,2825,2770,959,1811,2984,833,2085,2986,898,2088
28121000315,715,83,609,513,79,434,509,99,392,510,58,452,839,128,679,842,93,737,512,71,441,547,62,472,550,79,471
28121000408,2385,580,1744,1678,489,1189,1677,569,1085,1688,428,1260,2639,759,1811,2647,710,1903,1831,547,1284,1922,515,1354,1940,553,1387
28089000403,932,313,614,680,240,440,678,267,411,681,219,462,1031,353,667,1032,338,692,723,260,463,719,219,491,727,235,492
28089000402,1228,790,428,982,625,357,995,658,328,985,587,398,1224,779,431,1228,759,454,1038,692,346,986,588,384,1013,641,372
28089000407,259,182,75,200,147,53,200,155,45,199,137,62,366,271,91,367,261,104,224,167,57,215,151,61,219,159,60
28089000410,2119,346,1742,2011,361,1650,2017,595,1404,2018,334,1684,2927,518,2365,2934,490,2425,1916,363,1553,2015,335,1655,2014,357,1657
28089000109,1092,206,847,813,195,618,809,278,521,814,176,638,1157,305,830,1160,291,856,837,200,637,898,188,697,897,192,705
28089000105,610,332,264,493,318,175,495,331,161,490,290,200,739,484,246,740,469,263,468,318,150,468,277,180,468,294,174
28089000505,1163,888,265,811,614,197,822,653,164,805,572,233,1165,926,231,1170,897,258,944,746,198,896,648,231,918,699,219
28089000506,1283,1136,143,938,829,109,946,845,98,945,785,160,1379,1236,135,1363,1206,145,1113,1012,101,989,846,130,1018,903,115
28015000111,259,168,89,193,123,70,199,135,61,188,115,73,274,183,89,272,173,94,200,139,61,200,123,75,209,135,74
28015000109,474,42,429,352,38,314,355,67,286,351,55,296,435,59,373,438,44,394,319,43,276,347,34,303,349,42,307
28121000204,1603,348,1206,1249,315,934,1246,385,855,1253,264,989,2069,591,1445,2069,559,1491,1286,336,950,1384,306,1061,1389,325,1064
28121000101,640,123,516,500,119,381,501,152,338,500,109,391,726,164,541,730,151,574,467,111,356,506,107,383,507,108,399
28121000105,1118,269,820,764,238,526,755,272,466,764,206,558,1182,363,793,1184,319,850,803,256,547,860,232,609,866,253,613
28121000202,1168,240,898,829,240,589,827,286,530,832,219,613,1273,377,854,1274,346,909,851,250,601,936,231,685,935,243,692
28121000207,2039,350,1652,1576,321,1255,1578,470,1085,1577,292,1285,2303,497,1746,2303,471,1793,1653,361,1292,1748,326,1382,1752,343,1409
28153000502,1237,32,1197,944,58,886,951,120,820,940,62,878,1291,80,1188,1290,45,1234,798,28,770,862,34,809,871,43,828
28107000503,990,901,85,712,624,88,720,625,89,715,618,97,997,894,95,997,869,114,740,692,48,692,598,79,693,608,85
28161000301,459,108,346,415,104,311,415,119,287,417,123,294,523,113,398,526,103,416,343,100,243,350,78,265,354,89,265
28153000505,163,3,159,129,11,118,132,15,114,129,13,116,190,13,173,192,4,186,133,7,126,122,2,117,131,8,123
28003000016,828,119,700,689,114,575,702,149,544,689,124,565,951,187,732,957,130,812,529,93,436,589,67,514,577,102,475
28061000503,981,836,138,741,635,106,748,656,87,714,579,135,986,856,126,983,840,133,802,718,84,756,633,108,775,665,110
28085000405,1153,193,944,941,158,783,937,282,646,943,161,782,1330,300,1020,1334,291,1022,1043,184,859,1064,167,885,1087,167,920
28025000302,850,473,360,597,340,257,601,373,224,586,322,264,886,541,327,878,522,340,640,395,245,627,324,289,624,345,279
28103000203,1233,1021,207,709,555,154,718,576,140,692,530,162,986,799,186,987,783,199,851,698,153,813,612,193,820,636,184
28025000201,513,284,221,411,233,178,418,244,173,406,207,199,569,309,254,567,294,267,432,254,178,409,212,191,407,217,190
28037000301,103,72,30,89,59,30,91,62,28,90,60,30,116,71,43,116,67,46,77,49,28,74,42,31,81,48,33
28085000203,183,47,134,154,38,116,154,47,106,150,35,115,201,41,152,200,42,154,154,43,111,140,37,99,149,41,108
28023000402,192,12,179,130,4,126,132,10,121,127,6,121,158,12,145,160,8,152,119,3,116,130,5,123,131,12,119
28115000304,829,189,629,618,150,468,620,237,379,622,156,466,890,257,622,887,214,663,569,152,417,583,111,454,596,150,446
28115000504,1049,208,823,749,196,553,757,295,457,748,200,548,1133,294,811,1134,253,863,783,209,574,799,165,598,802,190,612
28115000402,494,135,353,375,113,262,382,155,227,378,117,261,520,152,361,519,127,383,387,110,277,380,91,280,383,109,274
28085000202,561,91,458,432,90,342,433,118,312,432,92,340,613,124,482,616,109,498,439,86,353,450,82,359,465,82,383
28103000103,492,373,119,292,206,86,294,210,84,285,177,108,494,355,138,495,345,143,356,263,93,339,222,113,338,230,108
28027000012,140,93,47,82,54,28,83,54,29,81,50,31,138,97,39,138,94,41,111,74,37,102,59,42,107,72,35
28029000303,1068,836,224,794,625,169,808,665,134,781,576,205,1065,864,192,1057,841,197,912,741,171,906,664,224,927,709,218
28015000103,164,3,161,124,7,117,124,8,114,125,9,116,173,10,158,174,3,168,125,2,123,132,2,127,133,9,124
28121000203,1555,315,1201,1325,325,1000,1320,423,877,1332,316,1016,2036,465,1533,2050,435,1582,1296,346,950,1390,315,1046,1401,351,1050
28121000409,462,164,291,368,120,248,367,134,228,367,110,257,559,162,385,558,152,399,342,122,220,366,117,244,365,126,239
28067000211,1111,198,894,820,165,655,824,212,601,816,174,642,1089,222,855,1094,198,887,798,182,616,881,168,690,895,173,722
28067000202,1439,80,1343,1134,84,1050,1136,155,955,1133,114,1019,1505,138,1325,1510,103,1391,985,78,907,1103,72,988,1127,75,1052
28147000204,638,576,52,401,359,42,409,373,36,383,313,70,610,543,65,611,536,71,495,462,33,426,368,48,439,385,54
28067000503,1288,1249,29,950,891,59,982,949,24,932,831,101,1290,1256,29,1286,1227,43,1120,1104,16,997,949,34,1038,1005,33
28067000204,782,331,439,564,231,333,569,294,267,568,219,349,820,428,378,832,410,412,620,306,314,620,257,338,639,283,356
28067000303,855,43,800,661,52,609,659,92,549,659,68,591,888,84,782,889,53,823,571,39,532,654,36,592,673,37,636
28089000101,703,397,298,566,327,239,566,330,233,561,287,274,779,443,328,778,423,348,578,342,236,565,303,251,568,322,246
28089000203,2458,582,1784,1754,507,1247,1752,707,1030,1759,459,1300,2599,852,1699,2598,796,1769,1853,591,1262,1998,554,1403,1998,602,1396
28121000103,1848,332,1481,1377,329,1048,1372,404,938,1379,297,1082,2055,449,1551,2066,413,1632,1364,318,1046,1476,281,1166,1474,301,1173
28121000102,1363,139,1205,1035,149,886,1035,201,818,1043,115,928,1484,197,1253,1484,178,1296,1015,133,882,1088,127,938,1098,132,966
28013000003,738,92,634,567,99,468,567,134,419,565,110,455,773,125,629,771,103,662,500,76,424,524,57,456,531,84,447
28013000002,919,213,695,750,195,555,755,263,483,753,207,546,986,255,715,985,227,749,650,178,472,678,138,532,673,168,505
28129000202,632,390,234,511,334,177,513,360,151,505,308,197,655,435,220,655,412,231,514,357,157,537,341,180,541,347,194
28129000302,800,66,729,633,84,549,634,156,473,633,110,523,828,110,708,833,87,740,579,65,514,627,55,561,651,74,577
28121000507,1421,536,842,1076,453,623,1078,525,544,1083,422,661,1795,828,943,1800,772,1003,1059,493,566,1144,458,666,1141,474,667
28027000011,1151,941,195,505,405,100,520,414,95,496,382,114,1030,895,124,1029,859,156,902,792,110,769,571,165,837,698,139
28027000008,1382,739,623,803,415,388,815,445,365,805,423,382,1386,872,509,1376,819,546,1076,639,437,1022,488,505,1074,579,495
28043000501,1444,277,1150,1009,251,758,1023,325,689,1012,276,736,1473,435,1006,1476,381,1081,973,230,743,1022,215,789,1024,234,790
28043000402,661,94,560,491,105,386,495,125,360,490,113,377,692,148,533,693,119,569,468,86,382,505,77,419,511,99,412
28155000202,363,29,330,305,28,277,306,60,243,305,52,253,358,30,322,360,20,337,274,24,250,279,27,251,275,30,245
28117000304,933,447,473,633,290,343,644,350,287,627,261,366,975,472,488,981,440,528,719,374,345,653,274,365,665,327,338
28117000302,665,138,520,474,129,345,477,174,299,474,118,356,767,173,579,770,131,630,449,112,337,453,77,370,462,107,355
28117000303,205,14,191,165,21,144,165,45,119,165,23,142,217,30,181,215,21,194,161,17,144,163,10,151,166,14,152
28117000404,568,64,497,541,125,416,551,167,370,548,100,448,629,89,521,635,60,573,415,62,353,450,61,378,451,63,388
28061000501,304,249,54,226,183,43,228,190,38,216,172,44,317,251,64,322,253,68,253,218,35,244,191,48,245,197,48
28037000302,700,412,279,561,357,204,576,372,183,561,337,224,671,407,254,666,384,273,521,350,171,479,288,176,493,300,193
28017000109,1209,230,970,1031,231,800,1039,496,532,1036,272,764,1201,297,879,1196,251,918,901,188,713,961,148,791,963,176,787
28075000204,375,329,45,224,200,24,226,194,23,220,186,34,442,392,46,441,375,56,266,243,23,244,215,28,241,211,30
28075000105,145,20,124,100,14,86,101,23,76,99,11,88,131,25,101,132,26,101,95,17,78,102,16,86,102,19,83
28075000101,1534,458,1030,1143,405,738,1147,494,632,1147,360,787,1620,700,892,1620,670,928,1174,443,731,1284,415,858,1281,432,849
28075000512,365,31,331,266,27,239,269,29,234,271,29,242,369,45,321,372,29,339,252,19,233,281,23,253,282,24,258
28075000208,236,108,128,167,77,90,169,78,88,167,78,89,234,129,100,237,124,110,168,84,84,187,86,93,180,80,100
28037000203,406,74,322,324,58,266,328,97,217,325,78,247,399,78,318,399,73,322,274,55,219,288,48,234,295,53,242
28025000101,483,277,201,359,210,149,361,215,142,356,193,163,529,305,220,524,290,228,398,245,153,386,209,171,391,224,167
28025000503,477,248,223,357,190,167,365,205,159,361,184,177,464,250,208,460,235,217,377,212,165,372,178,190,392,198,194
28039000501,505,192,300,260,116,144,259,127,126,254,106,148,526,234,277,532,213,313,284,150,134,355,148,191,348,172,176
28129000505,157,53,100,129,47,82,130,51,77,130,42,88,163,56,107,163,55,108,127,47,80,115,41,71,128,44,84
28043000201,559,210,346,357,171,186,363,192,160,357,172,185,545,281,258,547,265,281,376,185,191,376,157,216,382,169,213
28155000102,810,412,386,643,328,315,650,351,290,636,304,332,839,455,369,841,425,398,615,340,275,638,304,320,644,320,324
28089000307,3070,936,2037,2645,823,1822,2656,1108,1530,2662,680,1982,3603,1292,2272,3587,1260,2281,2816,986,1830,2838,832,1968,2844,910,1934
28037000404,169,23,145,137,23,114,140,35,102,133,15,118,170,25,143,170,23,147,130,20,110,117,12,103,125,17,108
28089000211,3080,743,2254,2466,599,1867,2461,911,1522,2481,551,1930,3701,1057,2589,3696,1018,2623,2554,728,1826,2731,646,2056,2731,700,2031
28015000113,369,169,198,268,124,144,272,133,139,272,123,149,386,187,194,378,169,205,286,149,137,282,117,158,286,137,149
28121000405,1576,405,1142,1209,335,874,1207,407,785,1209,329,880,1650,453,1159,1651,424,1213,1232,364,868,1261,314,921,1263,334,929
28121000402,534,30,498,438,37,401,435,58,373,437,34,403,681,49,616,686,40,636,428,31,397,442,27,403,445,35,410
28121000305,693,108,565,476,102,374,480,120,349,478,79,399,713,169,522,711,148,557,493,103,390,522,87,421,528,100,428
28121000313,539,127,406,393,94,299,392,109,280,393,79,314,604,143,448,608,133,471,434,117,317,449,105,332,447,110,337
28121000311,415,48,361,323,43,280,322,64,256,322,49,273,473,75,392,472,66,401,333,54,279,343,44,293,345,45,300
28055000104,153,96,57,126,77,49,129,87,42,117,62,55,142,79,63,143,80,62,112,70,42,115,64,50,122,75,47
28055000103,165,157,8,103,94,9,108,96,8,96,76,20,171,157,12,170,151,13,129,120,9,124,102,17,129,118,11
28089000103,1426,216,1178,1238,225,1013,1238,339,889,1237,221,1016,1899,428,1442,1900,394,1483,1225,238,987,1233,192,1021,1231,210,1021
28089000503,717,624,83,527,449,78,535,459,74,529,421,108,791,673,114,794,663,124,622,552,70,570,460,97,585,499,86
28103000101,496,458,34,296,271,25,298,280,16,294,259,35,452,424,27,448,413,29,367,343,24,333,295,33,348,306,42
28085000105,471,447,19,330,309,21,336,320,13,320,279,41,469,445,20,470,440,21,398,384,14,359,326,24,373,344,29
28085000402,559,87,464,381,62,319,387,86,296,385,66,319,591,105,484,589,93,494,432,75,357,423,59,357,435,74,361
28025000203,1402,504,874,1051,387,664,1058,462,589,1051,370,681,1450,593,846,1441,556,860,1145,456,689,1141,387,741,1147,414,733
28123000404,712,431,274,521,326,195,523,354,159,517,305,212,661,424,221,661,396,251,523,361,162,470,279,177,491,313,178
28063000014,220,175,41,200,159,41,204,170,33,195,137,58,238,192,46,237,184,51,185,152,33,183,127,49,197,150,47
28063000015,410,394,12,336,317,19,338,323,12,334,285,49,426,415,10,428,407,17,313,307,6,301,276,20,315,294,21
28121000411,2005,396,1567,1582,388,1194,1581,520,1045,1581,381,1200,2262,552,1674,2279,529,1728,1646,394,1252,1778,374,1365,1781,403,1378
28121000504,1815,592,1184,1454,627,827,1456,685,754,1454,562,892,2400,979,1373,2402,919,1460,1378,608,770,1477,555,881,1484,584,900
28107000207,727,593,131,618,522,96,628,521,96,619,522,97,773,649,117,768,627,135,584,513,71,553,440,109,560,467,93
28133000403,329,150,176,248,117,131,249,126,120,245,125,120,353,173,180,356,169,183,269,131,138,262,105,153,283,134,149
28141000405,267,16,247,222,28,194,223,37,180,220,18,202,310,35,263,315,26,281,183,14,169,189,10,176,186,14,172
28141000502,810,56,737,663,73,590,673,118,549,667,71,596,898,106,773,899,56,832,539,46,493,584,45,531,580,48,532
28141000301,1192,186,970,920,227,693,938,287,634,924,210,714,1256,296,917,1272,201,1047,776,157,619,897,149,719,898,167,731
28141000401,242,25,211,192,34,158,198,44,152,194,33,161,263,41,207,261,31,228,173,25,148,169,26,143,166,22,144
28141000202,485,58,418,401,86,315,410,97,306,407,77,330,514,95,411,518,46,465,267,37,230,318,37,273,314,55,259
28133000202,1529,1496,15,923,896,27,933,908,16,908,856,52,1529,1492,31,1529,1471,42,1168,1154,14,1127,1017,77,1204,1168,36
28095000205,1579,333,1216,1193,332,861,1207,427,767,1189,294,895,1772,525,1200,1777,455,1296,1081,304,777,1118,228,871,1128,302,826
28095000204,882,83,788,694,94,600,703,145,551,696,82,614,1031,145,866,1024,95,917,651,77,574,667,65,597,670,79,591
28095000102,793,101,675,635,112,523,640,148,486,632,96,536,915,128,760,926,93,823,540,71,469,556,55,494,556,68,488
28135000302,349,153,194,281,119,162,297,152,142,281,129,152,388,207,178,385,184,198,256,130,126,258,103,150,263,124,139
28135000401,239,137,101,199,109,90,206,116,89,192,101,91,214,116,96,215,114,99,196,117,79,177,86,90,184,101,83
28135000307,41,31,9,32,24,8,33,27,6,31,22,9,42,33,8,41,31,9,32,27,5,30,20,9,32,24,8
28129000404,433,29,401,378,28,350,383,63,319,375,31,344,490,35,448,490,30,455,347,25,322,348,20,319,362,27,335
28129000504,341,39,294,271,54,217,274,73,200,270,48,222,368,66,299,370,60,309,243,39,204,242,27,211,249,33,216
28129000403,347,15,332,293,28,265,292,57,233,292,29,263,367,19,343,368,15,352,247,14,233,247,10,234,258,8,250
28037000501,348,12,335,298,20,278,302,30,269,300,24,276,396,19,375,397,16,380,265,13,252,278,8,262,275,12,263
28153000102,546,529,14,408,387,21,415,396,16,403,356,47,545,522,20,541,508,21,469,457,12,446,403,26,454,431,23
28153000405,196,47,145,163,44,119,164,48,112,162,41,121,228,62,162,229,53,170,149,44,105,160,40,116,169,45,124
28133000103,867,722,140,508,426,82,515,440,68,496,402,94,799,684,112,801,665,129,630,538,92,617,486,123,645,537,108
28133000101,707,309,394,511,207,304,510,234,273,502,203,299,729,322,405,729,313,409,541,249,292,540,202,325,552,243,309
28133000401,871,781,87,557,493,64,569,506,58,548,461,87,850,778,66,850,751,87,695,632,63,654,544,90,677,606,71
28117000501,338,35,296,266,45,221,268,45,216,259,30,229,348,51,293,352,33,318,250,42,208,261,28,226,263,40,223
28107000504,1793,502,1252,1429,453,976,1446,536,888,1434,516,918,1880,678,1171,1889,610,1258,1218,425,793,1308,366,926,1311,423,888
28107000402,1045,270,757,816,253,563,831,253,561,820,265,555,1131,366,732,1140,318,807,708,245,463,772,202,550,767,243,524
28107000405,558,124,424,437,87,350,439,127,310,436,94,342,573,160,406,578,138,434,391,91,300,446,80,354,442,101,341
28107000404,842,202,634,707,159,548,713,179,525,706,168,538,924,231,679,929,201,722,604,152,452,630,125,502,626,157,469
28161000402,487,384,100,404,317,87,409,323,81,406,306,100,472,388,81,473,377,92,365,294,71,353,275,74,354,275,79
28161000502,151,48,101,119,39,80,119,42,76,118,37,81,143,43,98,141,39,101,117,39,78,113,30,81,115,35,80
28119000502,266,39,227,232,55,177,242,55,185,237,53,184,248,57,189,253,37,215,188,31,157,189,24,161,191,38,153
28119000302,386,198,185,326,165,161,346,187,152,321,159,162,387,200,181,387,187,194,289,156,133,323,154,164,328,182,146
28135000104,708,434,266,633,385,248,649,443,194,623,388,235,733,469,254,739,459,266,502,325,177,458,235,213,482,282,200
28135000201,748,511,226,655,442,213,680,480,177,650,436,214,724,504,210,723,476,232,549,389,160,529,300,209,540,356,184
28135000301,344,201,134,285,178,107,296,201,85,280,172,108,352,224,122,348,218,120,258,172,86,250,132,112,248,155,93
28161000401,795,414,373,627,337,290,633,341,284,628,322,306,842,438,394,842,415,420,601,360,241,617,339,269,618,349,269
28151000401,1378,1226,136,1030,929,101,1052,952,88,1011,885,126,2127,1973,142,2123,1907,189,1190,1113,77,1178,1035,130,1234,1125,109
28151000505,1091,1051,35,638,607,31,652,621,23,618,556,62,979,955,22,971,913,47,774,755,19,727,665,52,779,744,35
28095000202,123,7,116,92,9,83,92,14,76,92,7,85,121,9,109,126,3,123,81,3,78,87,4,81,85,6,79
28095000501,646,501,138,496,381,115,502,398,104,489,361,128,692,531,157,690,514,169,552,450,102,476,347,126,495,376,119
28095000406,390,305,80,327,264,63,330,265,64,320,244,76,432,338,90,431,327,96,323,268,55,301,230,68,309,247,62
28095000109,340,29,305,247,27,220,251,42,206,247,25,222,365,34,322,365,24,335,211,19,192,224,21,198,224,24,200
28095000108,166,8,157,120,8,112,122,18,104,121,8,113,184,17,159,189,14,173,106,5,101,113,7,106,111,8,103
28095000407,1137,714,407,810,508,302,816,536,277,801,483,318,1155,755,383,1142,725,401,907,590,317,835,458,370,847,505,342
28089000302,2091,531,1493,2086,665,1421,2083,885,1181,2096,606,1490,3104,1065,1989,3108,1018,2054,2048,701,1347,2159,629,1498,2157,667,1490
28089000210,2257,554,1630,1549,436,1113,1542,628,898,1553,408,1145,2514,754,1714,2526,709,1776,1553,482,1071,1619,433,1163,1622,471,1151
28089000401,273,23,244,206,14,192,208,24,181,207,9,198,296,24,272,297,23,274,215,17,198,212,14,195,216,16,200
28089000108,1633,721,865,1197,573,624,1197,667,518,1196,514,682,2317,845,1423,2312,803,1477,1253,656,597,1285,588,680,1287,611,676
28089000204,2265,1119,1078,1649,887,762,1647,992,641,1648,795,853,2086,1623,430,2083,1565,490,1746,989,757,1793,905,853,1794,942,852
28153000103,279,48,223,183,43,140,185,50,131,182,46,136,295,67,222,298,57,239,183,42,141,197,42,150,204,50,154
28153000501,288,193,89,216,140,76,220,159,58,212,141,71,300,203,96,298,189,105,223,160,63,202,128,67,206,138,68
28153000401,373,258,113,270,192,78,273,203,66,266,171,95,367,261,102,365,252,109,285,221,64,284,198,79,287,202,85
28153000202,147,71,76,117,60,57,118,63,54,115,55,60,177,81,93,177,76,96,120,61,59,115,49,64,118,61,57
28153000201,787,388,394,610,313,297,612,334,270,601,303,298,846,472,362,842,432,392,608,343,265,615,307,293,628,324,304
28003000203,288,21,262,236,25,211,238,38,192,238,31,207,309,28,272,315,21,291,189,20,169,194,18,169,194,20,174
28003000202,986,114,853,724,132,592,741,133,591,721,126,595,1015,164,816,1029,96,924,577,76,501,657,79,562,638,98,540
28003000303,886,145,724,669,148,521,669,182,475,667,139,528,975,200,748,983,160,814,582,144,438,638,109,513,636,142,494
28121000109,1603,304,1263,1188,293,895,1188,372,782,1189,258,931,1615,372,1213,1617,340,1265,1173,293,880,1253,257,940,1256,286,970
28121000501,844,126,687,567,129,438,562,176,377,570,107,463,896,243,621,900,207,671,597,121,476,656,110,527,659,113,546
28089000308,1354,309,1011,1135,265,870,1134,389,734,1142,223,919,1569,430,1117,1570,415,1145,1185,315,870,1209,280,919,1213,292,921
28089000303,1085,440,618,952,363,589,943,431,500,949,304,645,1293,543,736,1297,544,736,980,437,543,1010,405,592,1017,433,584
28015000106,370,58,306,276,34,242,285,53,228,278,40,238,374,69,299,373,63,309,245,48,197,277,33,237,274,39,235
28151000403,838,479,350,663,377,286,673,407,262,660,372,288,949,585,357,943,563,374,731,452,279,770,414,346,797,479,318
28151000204,394,235,156,288,178,110,292,189,101,285,168,117,448,277,171,451,265,181,305,205,100,298,175,119,317,206,111
28151000502,116,62,52,86,44,42,87,50,36,85,39,46,130,71,59,130,67,63,102,59,43,93,42,51,94,50,44
28151000103,846,138,698,648,156,492,662,199,459,647,146,501,969,223,737,957,169,781,585,132,453,626,108,514,627,148,479
28117000405,753,180,565,545,153,392,549,185,358,538,123,415,804,258,526,811,192,607,470,135,335,504,123,372,503,129,374
28151000303,492,478,12,321,307,14,326,312,9,305,280,25,518,501,17,507,471,25,374,366,8,361,323,26,397,384,13
28151000504,845,633,200,593,470,123,607,492,108,588,443,145,895,694,197,896,667,222,660,542,118,672,510,155,688,551,137
28151000402,1217,774,431,898,577,321,914,616,283,881,559,322,1143,760,373,1147,727,405,944,649,295,1002,613,373,1025,674,351
28153000101,500,269,225,355,192,163,363,212,150,353,181,172,507,272,229,505,254,242,392,234,158,357,183,160,370,196,174
28161000102,920,296,588,786,295,491,796,354,429,799,358,441,1006,431,562,1016,389,613,667,280,387,721,266,437,723,276,447
28161000201,614,394,208,531,347,184,543,365,167,536,342,194,702,472,227,701,440,251,460,326,134,467,295,166,473,307,166
28161000302,821,202,601,753,219,534,761,248,498,758,252,506,934,278,638,936,253,675,581,172,409,634,169,459,633,174,459
28161000503,605,207,390,489,180,309,490,210,276,488,185,303,657,271,374,661,241,410,442,171,271,460,153,301,466,158,308
28161000202,438,279,148,386,252,134,388,261,120,382,244,138,455,306,146,459,286,162,321,229,92,337,212,120,332,218,114
28153000301,758,157,591,639,163,476,634,198,423,637,165,472,776,211,556,775,193,574,591,159,432,596,130,460,603,129,474
28133000301,502,395,104,351,281,70,354,292,60,342,273,69,466,382,82,463,366,94,381,314,67,387,287,90,399,319,80
28133000304,422,195,227,294,128,166,296,138,157,292,123,169,429,224,202,428,205,219,340,166,174,349,143,202,363,166,197
28117000104,1011,127,867,802,143,659,804,202,591,804,135,669,1109,213,876,1117,154,945,727,118,609,786,102,663,781,130,651
28115000104,520,74,428,383,66,317,389,92,293,389,74,315,577,107,461,582,79,495,379,68,311,398,61,327,401,70,331
28023000503,1132,96,1018,961,113,848,964,183,758,961,116,845,1183,171,986,1179,129,1038,774,83,691,854,80,761,862,121,741
28023000405,319,70,245,265,68,197,262,82,172,260,65,195,343,85,251,341,76,262,224,67,157,242,60,178,245,72,173
28023000102,242,125,116,201,109,92,202,114,84,196,101,95,250,140,108,248,136,111,181,103,78,183,90,89,191,108,83
28115000502,538,83,443,403,82,321,401,126,271,398,87,311,577,107,449,582,87,487,378,74,304,384,65,308,382,79,303
28117000103,458,115,339,362,116,246,368,150,212,356,111,245,475,146,316,476,126,345,325,115,210,328,103,225,335,113,222
28117000205,1592,249,1307,1231,279,952,1234,422,796,1230,277,953,1620,345,1248,1624,264,1337,1190,227,963,1198,192,992,1197,226,971
28117000202,559,64,484,413,96,317,419,142,275,413,93,320,560,118,424,562,55,503,375,63,312,390,50,332,391,67,324
28117000203,384,51,330,311,51,260,311,75,234,308,39,269,388,61,319,385,45,336,293,47,246,293,30,257,292,42,250
28117000101,525,83,434,430,83,347,438,103,318,431,80,351,578,113,449,590,78,505,346,68,278,363,55,303,366,64,302
28151000501,1050,821,222,668,516,152,680,537,139,658,482,176,1017,829,183,1019,806,205,817,664,153,772,538,217,790,609,181
28115000106,331,45,284,227,33,194,229,41,185,227,31,196,334,66,262,334,43,284,235,34,201,234,23,204,234,30,204
28117000502,810,68,725,616,109,507,617,124,475,612,68,544,867,102,739,872,72,790,511,61,450,552,54,494,554,69,485
28117000402,467,47,414,462,95,367,466,109,350,464,77,387,574,72,487,577,56,517,354,48,306,377,36,331,380,55,325
28061000301,818,450,352,546,297,249,554,328,219,546,298,248,826,473,346,823,446,366,613,360,253,577,299,267,596,316,280
28061000102,521,260,255,376,174,202,376,198,173,370,185,185,526,264,256,526,247,271,386,216,170,391,177,206,404,202,202
28061000401,755,414,335,491,246,245,491,286,200,485,263,222,786,431,348,778,403,365,554,338,216,522,267,247,544,293,251
28097000502,913,658,249,659,468,191,664,492,162,643,441,202,869,645,211,861,631,222,668,514,154,670,463,198,678,480,198
28097000202,568,127,436,448,103,345,455,135,310,445,115,330,599,152,433,596,127,466,419,103,316,423,90,329,434,98,336
28159000504,580,234,339,416,173,243,418,180,235,415,163,252,631,274,350,626,250,373,422,197,225,426,173,244,429,191,238
28097000403,247,32,210,204,32,172,206,41,163,199,34,165,278,32,241,278,26,251,165,20,145,173,19,150,176,27,149
28159000303,1089,370,699,861,315,546,868,369,487,863,337,526,1131,435,688,1136,396,727,848,335,513,879,301,563,882,327,555
28163000108,54,15,36,45,13,32,46,16,30,45,15,30,54,16,38,53,13,40,46,14,32,42,12,30,44,14,30
28151000304,1110,841,255,715,536,179,736,565,159,710,514,196,1065,816,242,1066,776,274,777,617,160,925,679,236,977,742,235
28151000104,409,161,243,285,109,176,289,126,162,285,103,182,445,194,249,445,182,255,321,135,186,320,110,205,332,125,207
28061000304,294,143,148,187,100,87,190,107,82,187,96,91,288,140,143,291,135,152,217,119,98,219,104,110,229,115,114
28061000303,576,323,243,419,211,208,427,245,178,425,214,211,605,335,260,597,318,269,453,264,189,436,227,197,448,240,208
28061000402,1006,82,917,697,68,629,705,151,545,701,124,577,1057,108,936,1060,82,970,676,72,604,682,68,598,713,62,651
28159000104,322,83,233,254,57,197,254,67,182,254,53,201,360,97,252,359,89,262,257,72,185,275,60,211,271,60,211
28097000501,97,7,90,75,14,61,79,12,63,75,13,62,103,8,91,103,6,97,75,5,70,73,4,66,75,8,67
28163000504,116,48,68,88,35,53,86,36,49,86,29,57,116,46,70,117,44,70,101,42,59,95,34,59,102,39,63
28163000503,24,10,14,18,8,10,19,9,10,17,5,12,30,12,18,30,12,18,22,9,13,21,8,13,20,9,11
28163000505,145,31,111,118,27,91,123,35,85,116,24,92,142,34,107,143,32,110,119,29,90,116,25,86,116,28,88
28065000031,1027,823,195,731,579,152,744,607,132,717,554,163,932,724,197,934,705,215,792,649,143,757,568,178,771,589,182
28065000041,175,87,85,137,66,71,140,77,61,139,68,71,167,83,83,168,79,86,147,76,71,147,65,75,149,71,78
28123000301,1004,338,649,771,318,453,777,376,392,767,314,453,1003,403,583,1008,367,631,754,303,451,742,264,466,754,281,473
28123000102,712,434,267,500,325,175,508,343,160,490,304,186,712,461,247,707,425,268,545,368,177,471,272,192,500,317,183
28123000101,714,429,280,517,304,213,518,325,191,517,301,216,717,427,287,719,416,300,571,365,206,524,304,216,535,333,202
28159000502,788,250,529,536,189,347,537,217,320,538,184,354,769,271,482,774,256,512,570,199,371,598,165,422,607,188,419
28113000506,341,117,221,264,78,186,267,85,179,262,80,182,355,125,227,355,124,229,231,92,139,259,79,177,255,79,176
28113000403,566,268,277,409,212,197,414,236,174,404,189,215,573,343,221,570,326,233,421,224,197,455,217,225,452,233,219
28113000203,801,554,228,590,399,191,595,417,172,586,378,208,798,563,225,796,552,234,613,440,173,579,365,207,588,375,213
28113000501,851,476,360,679,358,321,687,374,304,670,337,333,949,515,410,950,496,435,688,404,284,646,345,285,660,365,295
28113000504,647,252,388,524,186,338,529,206,319,522,177,345,705,276,423,709,267,436,509,197,312,523,184,334,523,182,341
28163000111,203,17,185,180,24,156,178,30,148,183,15,168,242,35,204,238,25,213,167,18,149,170,14,153,175,18,157
28163000105,328,28,290,294,34,260,299,51,243,292,21,271,379,40,333,379,33,342,258,25,233,265,17,241,278,24,254
28097000101,218,53,164,160,35,125,158,38,119,156,36,120,212,48,160,213,43,169,172,38,134,169,34,134,169,39,130
28091000001,1252,439,793,946,313,633,955,351,597,948,318,630,1273,461,799,1279,431,839,957,369,588,956,324,608,970,335,635
28003000201,1371,131,1221,960,139,821,987,173,800,966,136,830,1386,241,1102,1402,171,1218,771,115,656,874,95,758,853,128,725
28003000101,1462,157,1281,1144,168,976,1164,192,959,1151,168,983,1489,245,1205,1506,162,1330,928,132,796,1053,134,900,1031,163,868
28003000401,833,327,481,515,174,341,522,207,305,514,175,339,852,372,462,864,322,530,461,204,257,495,171,312,492,206,286
28003000301,989,545,417,557,257,300,566,289,269,554,253,301,921,528,379,932,482,429,590,354,236,628,314,293,612,334,278
28163000302,530,438,88,419,361,58,433,384,45,411,322,89,558,498,60,561,470,82,460,407,53,369,293,71,412,356,56
28097000302,502,313,179,382,223,159,391,243,141,374,216,158,510,326,177,504,318,178,417,277,140,423,251,169,426,254,172
28159000301,807,686,108,527,453,74,526,455,71,526,433,93,817,715,96,803,686,109,604,522,82,575,472,96,577,490,87
28029000101,1433,769,646,1082,592,490,1104,640,459,1062,530,532,1472,801,656,1479,773,682,1182,689,493,1125,558,542,1165,637,528
28029000104,1090,1028,53,794,735,59,800,756,39,777,686,91,1033,983,46,1017,926,75,901,862,39,817,713,76,847,794,53
28123000402,93,12,80,76,15,61,77,19,58,78,17,61,103,21,82,103,13,86,76,15,61,67,11,56,71,12,59
28113000304,626,248,368,466,185,281,467,205,258,463,174,289,677,288,377,675,271,400,459,227,232,482,186,283,489,205,284
28113000306,655,116,534,520,102,418,525,128,394,517,97,420,731,175,546,735,158,568,463,87,376,500,83,409,503,81,422
28113000402,500,164,325,407,150,257,405,174,226,408,118,290,543,208,322,539,202,332,388,136,252,430,129,297,429,130,299
28113000201,477,378,97,332,262,70,336,255,71,323,241,82,494,388,104,493,378,110,341,274,67,326,239,78,335,259,76
28031000011,1056,565,483,878,442,436,883,516,349,868,415,453,1085,598,472,1089,566,512,829,489,340,809,405,389,836,457,379
28031000008,273,54,215,242,52,190,242,61,177,241,48,193,278,54,218,282,52,228,224,48,176,220,37,179,222,42,180
28065000026,351,161,184,205,111,94,206,118,86,200,95,105,351,173,174,353,163,187,272,147,125,263,121,137,282,139,143
28023000504,230,67,161,187,55,132,186,66,116,187,60,127,233,77,153,233,70,163,164,54,110,184,50,133,184,55,129
28163000403,149,28,119,126,29,97,126,33,92,124,20,104,150,35,115,149,26,120,105,20,85,107,15,91,115,20,95
28121000209,2344,528,1747,1790,549,1241,1788,696,1066,1793,477,1316,2718,911,1730,2727,856,1817,1784,541,1243,1987,523,1405,1985,553,1432
28121000208,1343,232,1062,1002,211,791,998,297,688,1003,166,837,1381,321,1015,1375,292,1062,1057,238,819,1132,219,875,1134,231,903
28121000206,1419,239,1143,1055,261,794,1057,342,695,1061,235,826,1591,397,1128,1594,342,1219,1139,286,853,1230,267,930,1230,280,950
28121000309,514,91,416,423,83,340,423,114,307,423,82,341,600,122,475,603,107,494,403,91,312,423,79,338,424,86,338
28121000301,859,195,650,639,152,487,638,184,444,639,130,509,916,223,673,913,211,694,657,169,488,709,149,549,711,157,554
28121000412,2414,354,2002,1802,344,1458,1808,502,1286,1819,300,1519,2554,525,1959,2559,485,2039,1842,339,1503,2011,317,1648,2013,350,1663
28121000403,1973,548,1394,1553,517,1036,1542,617,915,1557,455,1102,2354,768,1548,2372,739,1615,1646,565,1081,1721,506,1185,1725,541,1184
28089000306,1732,579,1106,1440,566,874,1436,744,671,1445,499,946,1886,890,961,1883,843,1011,1446,623,823,1523,568,929,1523,608,915
28091000006,375,109,260,301,92,209,302,105,195,300,91,209,403,131,266,405,122,279,292,100,192,303,89,209,295,89,206
28075000309,1450,286,1147,1069,259,810,1074,301,758,1073,250,823,1486,369,1083,1491,347,1132,1050,255,795,1174,259,899,1168,277,891
28075000304,1388,216,1151,1111,212,899,1113,251,843,1111,201,910,1592,326,1234,1601,301,1279,1018,191,827,1149,176,955,1144,187,957
28075000308,320,36,282,227,32,195,222,42,176,226,34,192,364,58,300,367,51,315,219,40,179,256,33,222,257,37,220
28075000303,855,94,740,590,80,510,596,113,467,592,90,502,868,135,715,877,120,750,579,98,481,682,86,584,682,100,582
28075000508,449,89,347,323,60,263,326,68,251,326,60,266,466,94,360,465,82,373,371,131,240,345,61,274,343,66,277
28075000509,378,87,284,244,49,195,245,52,188,243,58,185,372,104,261,374,88,282,241,54,187,270,54,214,270,62,208
28075000505,229,76,151,169,58,111,169,64,101,168,56,112,249,98,146,246,89,157,169,60,109,186,60,124,189,60,129
28075000504,29,9,20,19,5,14,19,7,12,19,5,14,53,22,31,54,21,33,19,5,14,21,5,16,21,5,16
28075000513,247,80,163,183,62,121,185,67,113,183,61,122,262,105,151,268,96,166,183,65,118,207,65,137,204,67,137
28075000403,622,499,111,367,287,80,375,296,70,363,277,86,624,532,81,628,525,93,449,377,72,452,366,83,453,362,91
28075000406,85,68,17,50,35,15,47,35,12,50,35,15,91,75,15,90,73,17,57,45,12,55,43,12,53,41,12
28077000024,260,20,237,203,18,185,204,37,164,200,24,176,231,20,209,234,13,220,189,18,171,184,14,168,198,22,176
28077000007,383,22,355,352,32,320,359,52,298,353,40,313,480,41,429,483,36,444,328,25,303,343,22,312,356,25,331
28077000004,1203,194,991,954,169,785,955,236,704,953,164,789,1251,204,1039,1256,212,1036,958,165,793,945,150,774,994,151,843
28115000401,591,278,303,469,223,246,481,250,228,471,224,247,663,311,343,666,296,363,476,234,242,456,191,259,481,221,260
28023000101,666,402,254,549,333,216,550,348,192,538,304,234,742,463,271,736,445,277,507,339,168,522,309,204,533,348,185
28003000103,840,150,675,631,135,496,652,157,489,639,141,498,856,212,624,865,159,697,500,124,376,570,111,446,566,127,439
28023000202,248,163,83,217,154,63,220,159,59,209,136,73,297,204,91,297,197,92,201,148,53,199,140,53,204,146,58
28077000009,113,19,92,95,28,67,95,34,60,94,22,72,107,28,79,107,28,78,93,25,68,91,17,70,94,19,75
28077000022,409,234,169,358,203,155,364,225,135,352,188,164,462,269,189,461,257,197,360,208,152,325,175,141,355,205,150
28017000111,873,669,194,704,538,166,729,601,125,691,502,189,897,712,177,888,672,200,706,578,128,636,456,170,638,485,153
28065000051,261,166,93,175,105,70,177,116,59,167,92,75,252,165,87,249,155,88,219,144,75,194,106,86,198,119,79
28031000006,327,44,278,267,34,233,266,53,209,266,33,233,368,56,302,362,44,315,245,41,204,273,33,232,274,39,235
28031000013,684,445,235,575,375,200,578,403,170,558,358,200,714,478,227,712,465,232,565,393,172,528,318,193,549,361,188
28113000302,1095,449,627,860,370,490,863,396,458,855,348,507,1195,560,611,1193,524,653,834,392,442,874,339,508,880,357,523
28031000016,409,296,112,325,231,94,336,250,83,317,215,102,466,339,125,462,327,134,341,266,75,320,219,95,340,246,94
28031000010,238,65,172,209,59,150,209,63,144,207,54,153,253,73,180,251,68,182,200,54,146,190,45,143,192,49,143
28023000104,317,218,98,247,170,77,251,167,78,241,153,88,343,250,88,342,244,92,240,174,66,226,150,73,233,167,66
28075000102,1340,450,874,1052,350,702,1048,440,599,1053,337,716,1451,578,853,1462,586,864,1017,359,658,1129,339,776,1122,375,747
28039000303,855,146,697,466,104,362,468,120,345,464,102,362,1061,223,821,1071,177,883,535,134,401,642,125,493,634,142,492
28113000505,917,370,535,689,273,416,702,291,405,686,264,422,894,359,522,895,331,555,645,307,338,670,265,398,678,291,387
28031000007,1444,704,716,1170,561,609,1188,629,541,1157,513,644,1461,731,710,1458,710,730,1084,581,503,1099,475,595,1123,518,605
28113000305,648,188,451,536,172,364,539,211,319,537,181,356,702,224,466,701,206,484,499,171,328,530,168,350,543,183,360
28113000103,670,649,13,509,494,15,516,500,11,498,463,35,656,632,18,652,615,27,523,515,8,470,450,17,474,454,20
28031000005,769,63,697,550,50,500,551,90,455,550,55,495,812,92,694,817,76,735,500,57,443,548,50,485,560,55,505
28113000401,900,107,779,732,120,612,738,166,565,737,117,620,1034,165,848,1034,138,882,649,103,546,720,101,593,726,123,603
28029000402,190,42,144,152,39,113,151,58,93,148,33,115,217,62,151,218,62,154,158,38,120,156,28,126,165,32,133
28075000404,372,303,69,221,183,38,220,186,32,223,175,48,317,277,37,309,266,43,282,247,35,288,241,47,292,242,50
28075000502,628,444,177,459,347,112,462,354,104,458,326,132,688,552,133,696,541,147,494,394,100,512,371,139,514,366,148
28077000010,417,97,315,282,65,217,284,72,204,281,64,217,358,80,277,361,82,279,316,90,226,307,74,226,326,88,238
28077000005,190,33,155,148,32,116,150,40,108,146,28,118,206,49,157,206,48,156,150,29,121,137,20,116,147,27,120
28077000018,296,166,124,246,148,98,248,149,97,245,136,109,329,195,134,328,192,133,249,157,92,231,135,92,252,153,99
28077000017,378,232,142,298,180,118,303,194,107,297,160,137,399,240,152,398,240,155,299,185,114,298,169,123,310,184,126
28129000103,533,44,482,514,77,437,518,129,380,517,90,427,599,79,508,600,65,526,399,43,356,408,42,351,414,43,371
28129000101,374,20,351,315,28,287,315,50,256,313,28,285,403,29,364,407,25,380,218,17,201,254,17,233,259,19,240
28129000301,661,132,516,534,121,413,530,171,352,539,115,424,757,169,573,757,149,600,480,125,355,534,111,405,548,129,419
28029000301,471,248,222,347,191,156,346,205,139,338,173,165,479,238,241,474,227,245,377,207,170,346,167,173,360,182,178
28029000206,313,188,124,236,156,80,239,165,72,232,141,91,301,193,105,303,183,114,266,176,90,265,161,95,266,166,100
28001000102,757,504,241,570,400,170,580,407,165,565,388,177,796,539,248,791,521,262,574,405,169,578,389,180,584,386,198
28001000101,594,171,402,480,138,342,477,203,268,478,141,337,596,199,385,595,185,399,465,154,311,497,145,342,495,153,342
28001000302,416,251,160,307,191,116,313,205,104,302,186,116,377,240,132,377,236,135,313,208,105,316,197,110,318,197,121
28001000504,523,168,348,432,160,272,435,168,263,432,156,276,552,205,341,550,192,355,382,162,220,397,148,235,404,155,249
28121000106,1826,364,1421,1280,352,928,1276,401,843,1282,312,970,2025,580,1383,2033,522,1482,1299,344,955,1429,332,1070,1434,353,1081
28121000304,639,197,432,482,168,314,481,183,292,482,142,340,690,229,443,690,219,465,502,184,318,519,168,338,523,179,344
28015000107,382,27,350,281,23,258,286,41,242,281,20,261,403,42,356,405,36,368,265,23,242,286,24,257,289,25,264
28001000304,867,479,382,663,398,265,670,406,256,645,369,276,873,507,351,873,492,372,628,392,236,650,374,267,655,376,279
28001000103,1564,442,1090,1259,417,842,1263,480,772,1251,379,872,1522,553,947,1526,519,988,1210,402,808,1257,379,854,1268,375,893
28001000502,618,419,192,488,338,150,490,350,140,477,311,166,604,409,192,600,399,199,498,355,143,480,333,141,484,334,150
28113000503,756,388,345,588,337,251,587,363,219,581,311,270,817,525,282,817,502,306,590,350,240,571,291,269,587,314,273
28143000011,385,316,64,193,142,51,196,145,51,182,118,64,374,303,69,375,282,85,266,217,49,258,179,62,264,198,66
28143000010,89,51,36,65,32,33,68,36,32,65,33,32,92,55,37,92,53,36,63,38,25,65,30,35,64,32,32
28131000201,641,400,234,462,292,170,464,298,163,450,264,186,548,327,212,542,311,228,459,307,152,419,236,176,425,251,174
28131000102,467,94,354,314,64,250,315,91,223,314,73,241,479,115,350,482,102,369,297,74,223,333,64,262,337,71,266
28131000402,269,29,237,217,28,189,216,31,180,213,24,189,419,108,299,427,97,321,198,22,176,214,17,191,215,23,192
28131000103,461,58,389,321,50,271,321,77,237,319,47,272,499,106,381,502,91,403,314,51,263,345,46,294,346,58,288
28143000002,180,176,3,160,155,5,164,150,7,155,148,7,198,197,1,197,189,6,132,130,2,130,125,5,137,135,2
28143000001,301,232,66,137,111,26,141,108,30,133,99,34,308,247,59,309,240,67,171,142,29,191,139,49,190,146,44
28145000205,903,269,615,691,201,490,694,252,433,686,203,483,923,314,581,923,266,645,654,239,415,640,180,440,652,204,448
28145000105,626,140,471,471,106,365,476,152,316,471,114,357,697,206,461,701,171,514,430,108,322,441,82,355,446,91,355
28145000404,341,19,314,273,30,243,274,68,204,274,44,230,420,37,368,419,34,381,258,16,242,250,12,232,249,13,236
28145000402,618,231,373,435,130,305,440,187,250,437,143,294,672,282,373,667,244,414,434,180,254,441,153,281,445,169,276
28041000403,616,65,543,449,70,379,458,78,365,447,87,360,645,86,543,663,56,601,321,35,286,410,52,352,399,71,328
28143000012,386,287,93,291,215,76,306,234,67,271,191,80,392,308,81,392,282,105,291,237,54,292,199,90,307,236,71
28143000013,294,255,35,152,137,15,153,137,13,149,131,18,292,265,24,291,252,34,172,160,12,181,151,26,181,156,25
28001000503,1017,466,539,772,398,374,781,409,360,766,386,380,1052,586,457,1050,551,485,773,417,356,798,398,391,795,389,406
28003000501,535,104,408,448,92,356,455,121,326,448,98,350,591,174,404,600,127,460,339,86,253,376,77,293,373,92,281
28111000202,877,42,820,654,45,609,657,80,574,652,53,599,959,83,858,958,56,899,585,33,552,621,36,572,629,35,594
28059000203,1208,1025,171,738,624,114,746,640,101,729,595,134,1158,988,164,1156,965,179,928,806,122,903,741,148,915,766,149
28059000111,1,0,1,1,0,1,1,0,1,0,0,0,0,0,0,0,0,0,1,0,1,1,0,1,0,0,0
28059110-1C,761,168,577,458,111,347,460,110,347,456,99,357,716,208,494,715,176,534,501,132,369,564,130,425,564,148,416
28059000112,0,0,0,0,0,0,0,0,0,0,0,0,0,0,0,0,0,0,0,0,0,0,0,0,0,0,0
28059000110,1511,338,1145,903,211,692,908,209,693,906,198,708,1399,403,974,1399,343,1042,994,259,735,1118,255,848,1110,292,818
28059000102,1565,194,1325,1025,182,843,1028,196,819,1016,172,844,1735,337,1349,1746,277,1442,1084,202,882,1203,192,986,1196,213,983
28081000108,1578,286,1254,1239,282,957,1244,353,874,1244,261,983,1769,496,1230,1775,428,1321,1269,295,974,1288,264,1000,1284,289,995
28081000102,282,30,247,219,28,191,216,33,183,220,16,204,320,36,281,321,28,289,216,18,198,225,15,202,226,19,207
28081000115,2318,636,1600,1823,658,1165,1832,835,980,1836,597,1239,2682,1077,1535,2669,963,1639,1866,713,1153,1909,595,1272,1906,654,1252
28059000101,359,16,333,222,23,199,222,26,192,222,21,201,406,35,359,407,24,379,255,17,238,287,19,261,285,22,263
28011000501,839,317,513,641,232,409,650,261,387,636,219,417,889,366,517,891,339,542,667,267,400,678,236,436,686,262,424
28011000101,280,203,74,182,123,59,185,130,55,179,110,69,264,184,79,265,170,92,205,149,56,202,122,72,207,139,68
28011000204,1402,214,1150,990,142,848,1002,236,754,992,172,820,1300,295,989,1305,240,1051,1000,176,824,1107,172,925,1111,199,912
28011000110,85,22,63,50,14,36,51,15,36,50,14,36,77,25,52,77,22,55,61,22,39,65,16,49,65,19,46
28073000005,1259,128,1099,846,102,744,857,175,675,854,126,728,1493,241,1214,1500,198,1287,858,111,747,977,99,856,991,118,873
28073000011,865,451,381,617,350,267,629,387,235,620,301,319,1024,643,355,1028,606,397,689,420,269,710,371,325,724,403,321
28011000503,1033,880,146,729,605,124,747,629,116,702,557,145,998,871,122,1001,850,138,829,721,108,764,611,139,813,687,126
28011000502,199,8,189,154,10,144,159,18,140,157,12,145,206,15,187,205,11,193,147,10,137,164,8,152,163,10,153
28047000101,1041,748,280,733,556,177,743,569,169,727,535,192,1176,847,317,1170,801,358,849,670,179,802,598,196,803,621,182
28047000308,1681,334,1300,1160,308,852,1165,336,814,1160,281,879,1934,598,1268,1937,506,1398,1203,330,873,1344,322,1005,1328,360,968
28047000502,1237,463,734,879,375,504,885,374,496,881,337,544,1502,685,781,1502,624,853,906,400,506,939,359,556,928,400,528
28047000509,1155,315,797,858,273,585,861,289,557,858,257,601,1454,516,893,1451,445,985,876,314,562,979,296,661,975,328,647
28091000008,869,296,562,620,226,394,624,239,379,619,228,391,889,308,566,889,283,600,624,256,368,633,219,395,647,256,391
28051000303,681,581,91,507,435,72,519,455,59,492,372,120,651,584,63,647,573,68,559,499,60,470,393,73,494,424,70
28069000404,352,141,205,292,117,175,294,135,157,287,112,175,348,152,194,351,138,206,260,108,152,265,97,167,271,107,164
28087000502,1429,1396,25,831,801,30,846,824,20,809,747,62,1341,1301,33,1340,1278,49,1025,1012,13,934,863,61,953,913,40
28087000401,262,250,8,140,135,5,143,136,6,138,122,16,259,253,6,260,247,11,183,178,5,173,155,15,176,163,13
28101000502,1117,291,814,926,255,671,928,298,610,931,255,676,1225,359,849,1236,328,894,864,261,603,864,212,637,876,245,631
28101000501,406,25,374,324,32,292,322,36,276,328,27,301,450,45,394,457,40,409,291,15,276,302,21,274,310,26,284
28105000104,446,68,370,328,58,270,328,64,260,324,56,268,462,91,366,463,76,384,322,61,261,343,48,291,338,54,284
28105000305,236,144,89,155,78,77,155,83,70,152,74,78,231,123,106,232,119,109,173,105,68,169,86,81,162,83,79
28041000505,296,7,281,248,19,229,250,39,206,249,36,213,305,19,278,308,8,299,184,2,182,213,7,196,202,12,190
28041000501,202,8,192,142,11,131,145,25,117,140,17,123,205,16,182,207,9,196,121,3,118,149,6,138,152,8,144
28031000001,1541,168,1357,1282,164,1118,1286,263,997,1279,179,1100,1674,248,1411,1678,201,1467,1060,151,909,1156,141,984,1184,155,1029
28031000002,144,35,107,109,23,86,110,37,72,109,24,85,140,36,104,140,32,107,105,28,77,98,18,79,102,25,77
28011000105,149,77,72,96,44,52,98,49,48,97,41,56,144,66,78,145,65,80,122,63,59,112,50,61,119,60,59
28011000202,749,106,628,612,96,516,627,160,462,617,107,510,851,155,679,847,134,702,592,97,495,655,97,551,660,111,549
28011000403,516,378,130,382,278,104,390,290,96,381,271,110,560,435,121,564,427,133,408,319,89,391,276,108,405,305,100
28011000401,330,174,154,234,122,112,239,142,96,232,119,113,315,179,133,322,166,150,266,153,113,274,132,134,284,158,126
28007000501,121,10,111,102,9,93,103,13,89,102,10,92,145,13,129,147,11,134,101,8,93,103,7,94,108,13,95
28007000505,312,97,211,231,73,158,234,104,129,228,64,164,327,123,201,324,98,220,231,83,148,232,66,158,238,76,162
28007000204,1050,767,271,670,497,173,672,527,143,659,468,191,1145,875,264,1144,845,286,834,657,177,783,564,211,792,596,196
28099000303,324,12,306,249,29,220,246,38,207,249,32,217,368,32,325,369,24,340,220,11,209,271,7,260,268,22,246
28083000003,257,221,36,146,125,21,151,123,22,139,114,25,206,182,22,205,174,31,179,162,17,162,131,28,175,153,22
28083000018,948,713,228,638,455,183,645,484,145,623,420,203,912,701,206,905,681,222,772,592,180,725,502,210,761,564,197
28083000010,804,671,126,627,528,99,640,515,86,597,487,110,852,737,109,849,698,136,628,545,83,601,475,110,631,532,99
28083000017,679,624,45,446,411,35,453,409,28,439,386,53,730,684,43,727,668,51,501,475,26,497,430,55,532,497,35
28099000107,189,30,158,141,34,107,139,38,101,141,39,102,232,71,152,236,62,170,115,22,93,131,21,109,128,23,105
28035000104,767,416,313,547,299,248,550,341,204,545,276,269,834,513,303,835,474,330,570,355,215,567,293,259,573,327,246
28045000016,394,39,350,266,35,231,266,35,227,263,37,226,531,91,420,532,63,467,272,33,239,323,46,271,307,58,249
28045000018,3098,525,2466,2127,470,1657,2154,545,1591,2127,452,1675,3487,880,2545,3497,753,2690,2302,525,1777,2679,602,2046,2596,595,2001
28007000304,240,24,212,155,23,132,157,34,122,157,20,137,250,32,213,251,26,223,176,22,154,175,22,150,179,26,153
28007000302,236,29,202,173,25,148,177,32,144,172,22,150,259,31,226,259,27,230,169,23,146,173,20,150,181,29,152
28083000009,959,855,101,740,669,71,763,684,64,711,604,107,982,909,72,980,888,84,763,701,62,688,575,90,737,661,76
28139000405,932,266,650,660,169,491,666,228,421,657,159,498,1013,368,621,1016,311,691,702,231,471,742,174,553,741,212,529
28139000202,1013,318,671,713,209,504,715,227,476,707,184,523,1055,367,666,1060,319,730,682,249,433,733,201,520,730,244,486
28139000201,635,90,529,500,83,417,497,109,368,496,81,415,712,123,575,716,83,626,447,77,370,499,61,430,500,86,414
28139000508,952,264,672,669,175,494,671,195,460,665,174,491,1025,336,671,1041,302,723,660,219,441,712,189,504,705,197,508
28099000301,1001,185,806,755,148,607,756,228,520,759,196,563,1039,276,750,1045,251,784,707,137,570,778,128,640,780,138,642
28099000306,287,15,270,220,13,207,221,26,192,222,16,206,324,34,281,325,22,302,185,8,177,213,8,202,218,20,198
28007000504,689,125,550,561,132,429,563,194,366,565,125,440,770,211,548,774,186,579,533,138,395,546,100,435,559,123,436
28099000108,252,177,63,209,145,64,210,152,52,208,132,76,396,314,73,401,299,94,200,158,42,201,128,68,199,137,62
28099000101,245,58,177,193,57,136,195,64,126,195,58,137,280,85,190,283,75,208,175,50,125,176,39,134,182,53,129
28099000501,1201,1013,169,927,807,120,933,815,110,923,803,120,1285,1143,136,1275,1067,183,856,767,89,870,722,139,893,772,121
28099000106,212,45,165,156,45,111,156,39,115,156,38,118,231,56,169,232,53,177,140,31,109,148,22,123,151,33,118
28101000302,608,122,478,481,99,382,480,147,328,479,118,361,624,142,475,621,128,488,429,104,325,462,81,371,464,99,365
28101000301,353,67,283,254,46,208,253,66,179,255,60,195,379,75,297,382,63,314,243,54,189,247,36,203,258,46,212
28101000402,983,407,559,735,314,421,735,333,385,734,300,434,990,455,511,990,431,547,654,300,354,692,272,405,704,297,407
28105000101,2392,1163,1109,1560,882,678,1582,991,573,1548,844,704,2650,1619,977,2647,1546,1024,1768,1100,668,1875,963,866,1875,1026,849
28083000001,886,868,10,579,571,8,595,547,16,573,528,45,791,778,8,790,763,19,674,669,5,633,586,36,663,648,15
28081000508,679,359,307,515,315,200,518,330,185,513,304,209,770,460,294,769,431,327,525,317,208,513,268,229,516,289,227
28081000505,707,349,347,611,334,277,622,376,243,610,316,294,786,428,349,786,400,372,619,346,273,579,298,272,583,310,273
28081000301,1687,518,1129,1290,436,854,1300,539,757,1296,434,862,1853,658,1164,1857,619,1212,1336,486,850,1308,387,896,1319,425,894
28081000401,842,521,311,650,428,222,661,450,201,654,404,250,798,522,267,797,498,292,674,472,202,633,402,218,641,431,210
28143000004,398,371,26,187,160,27,193,166,23,186,153,33,387,351,30,383,333,41,269,253,16,233,197,29,245,213,32
28045000005,313,73,226,226,62,164,230,75,152,225,62,163,384,118,252,385,97,276,225,63,162,268,84,180,254,75,179
28045000003,1157,120,1012,680,120,560,689,132,532,676,114,562,1287,324,918,1324,216,1096,558,95,463,706,142,547,686,152,534
28069000301,519,312,205,459,280,179,460,278,178,451,269,182,506,308,193,510,306,199,385,238,147,378,215,159,378,222,156
28139000404,306,20,284,246,26,220,251,43,205,246,31,215,356,39,314,360,19,337,211,21,190,232,13,215,231,25,206
28035000501,429,24,400,361,31,330,362,48,303,360,34,326,502,47,445,504,30,467,313,24,289,338,20,305,347,26,321
28069000102,113,63,50,100,59,41,100,60,40,96,60,36,112,65,47,114,64,50,84,49,35,81,43,36,83,47,36
28069000202,496,380,114,486,391,95,500,407,89,476,376,100,517,407,106,521,408,109,359,275,84,374,272,97,373,267,106
28111000404,119,94,23,110,87,23,110,93,16,105,72,33,137,103,33,138,100,37,102,92,10,90,72,15,94,80,14
28111000403,428,52,370,389,64,325,392,94,292,391,77,314,471,86,375,475,68,402,315,46,269,319,41,271,324,55,269
28111000502,60,3,56,47,4,43,47,9,38,47,5,42,67,4,62,66,3,63,46,2,44,47,6,41,51,8,43
28111000401,357,92,263,281,84,197,285,99,182,282,78,204,364,119,239,371,100,267,235,78,157,231,54,172,247,72,175
28111000101,216,111,101,157,75,82,161,86,73,159,61,98,237,116,114,239,105,129,144,85,59,159,70,84,167,85,82
28011000302,989,906,68,661,600,61,694,639,51,652,561,91,932,868,57,930,845,74,772,727,45,722,621,79,777,710,67
28011000106,36,4,32,28,4,24,28,9,19,27,5,22,35,9,26,36,3,30,31,6,25,31,3,28,32,6,26
28047000405,1037,943,83,661,608,53,666,612,49,655,585,70,1085,1019,54,1079,989,70,818,782,36,765,695,60,769,718,51
28047000113,277,34,241,231,37,194,233,44,187,233,30,203,398,58,328,399,48,346,222,35,187,239,37,198,241,36,205
28047000507,1126,152,948,732,148,584,735,180,548,736,126,610,1287,215,1044,1295,177,1107,721,128,593,815,121,686,813,135,678
28047000404,870,672,177,493,404,89,496,408,82,493,383,110,1080,873,190,1075,830,229,657,567,90,626,488,131,634,511,123
28047000505,1813,532,1219,1258,439,819,1270,470,770,1263,398,865,2056,791,1197,2049,727,1278,1354,500,854,1474,488,958,1466,519,947
28047000111,2992,864,2044,2268,783,1485,2279,824,1410,2274,715,1559,4291,1591,2562,4312,1462,2779,2402,885,1517,2668,841,1771,2660,908,1752
28047000112,664,78,577,463,82,381,468,92,371,467,73,394,827,144,658,828,123,700,462,90,372,515,82,422,514,93,421
28047000302,1263,565,661,951,440,511,950,473,468,949,412,537,1492,743,713,1488,692,782,994,517,477,1097,517,559,1090,528,562
28047000315,450,35,404,302,37,265,302,38,261,302,30,272,519,65,439,520,41,474,270,27,243,322,29,285,323,35,288
28047000314,1335,186,1114,895,195,700,899,213,663,898,162,736,1553,338,1170,1564,277,1268,905,188,717,1060,201,840,1053,213,840
28059000305,1012,179,806,651,125,526,656,135,512,655,112,543,988,240,717,992,197,777,707,142,565,801,135,659,787,150,637
280590105-1,4216,319,3832,2582,266,2316,2592,294,2275,2572,247,2325,4328,495,3759,4363,369,3958,2787,292,2495,3308,290,2971,3296,371,2925
28059000503,1416,348,1024,969,300,669,972,312,645,966,272,694,2130,708,1352,2141,638,1467,1057,340,717,1201,341,837,1189,365,824
28059503-1A,369,90,265,252,78,174,255,81,167,252,71,181,311,104,197,313,93,214,275,89,186,313,89,217,309,95,214
28059503-1C,5,1,4,4,1,3,4,1,3,4,1,3,3,1,2,4,1,3,4,1,3,5,1,4,4,1,3
28059503-1D,649,157,464,442,136,306,441,140,292,443,126,317,857,283,543,859,253,589,480,155,325,546,155,379,539,166,373
28059503-1B,0,0,0,0,0,0,0,0,0,0,0,0,0,0,0,0,0,0,0,0,0,0,0,0,0,0,0
28059209-1D,365,238,123,185,119,66,185,119,65,182,109,73,343,228,110,342,217,123,247,166,81,256,157,95,265,166,99
280590209-1,1255,808,425,634,406,228,637,406,223,621,374,247,1146,761,369,1153,730,408,831,563,268,869,531,323,875,556,319
28059209-1H,1,1,0,0,0,0,0,0,0,0,0,0,2,2,0,2,2,0,1,1,0,1,1,0,0,0,0
28059209-1C,852,547,289,430,275,155,432,274,153,422,258,164,814,540,259,815,517,288,562,382,180,589,360,220,599,382,217
28059304-1a,425,108,308,274,67,207,278,76,199,274,63,211,405,127,268,426,108,288,296,81,215,335,80,249,333,85,248
280590304-1,1051,264,765,685,169,516,689,189,491,683,158,525,1118,348,737,1170,295,790,741,203,538,834,201,618,827,215,612
280590108-1,1602,85,1491,978,75,903,977,65,897,970,63,907,1684,193,1434,1695,113,1570,987,67,920,1182,71,1088,1165,101,1064
28059000207,1521,1146,348,1019,759,260,1028,765,257,1003,720,283,1568,1206,348,1558,1170,372,1235,961,274,1250,914,318,1275,955,320
28059000504,2007,452,1477,1318,391,927,1325,423,880,1316,351,965,2254,753,1437,2262,666,1568,1429,425,1004,1658,431,1185,1631,465,1166
28157000202,358,281,74,269,219,50,273,223,39,267,207,60,322,249,70,320,250,69,240,198,42,221,180,38,218,167,51
28059301-1B,188,38,144,115,26,89,115,32,80,113,24,89,178,56,117,178,46,131,129,32,97,151,32,112,141,33,108
28059000301,655,138,508,397,90,307,397,116,277,395,86,309,692,216,457,696,181,504,455,109,346,510,113,388,506,120,386
280590301-C,5,1,4,3,1,2,3,1,2,3,1,2,4,1,3,4,1,3,3,1,2,4,1,3,4,1,3
28035000406,544,532,7,368,358,10,373,365,3,356,323,33,534,527,6,528,507,14,461,459,2,412,380,18,452,445,7
28035000103,934,467,401,699,398,301,717,461,242,706,363,343,1012,631,346,1007,589,393,756,464,292,812,438,351,839,468,371
28035000108,442,235,177,330,176,154,339,221,112,338,170,168,464,283,164,457,270,178,360,222,138,395,216,167,396,224,172
28035000507,1627,484,1060,1424,422,1002,1432,616,792,1440,374,1066,1861,696,1124,1868,644,1179,1364,502,862,1493,441,1021,1492,499,993
28035000207,534,199,316,387,120,267,388,157,224,387,113,274,636,283,336,638,267,357,384,152,232,416,139,267,415,149,266
28035000303,1064,129,883,734,136,598,746,205,523,745,141,604,1117,287,788,1120,224,862,759,172,587,843,145,659,858,155,703
28035000302,1052,102,928,793,108,685,789,165,615,792,110,682,1265,198,1041,1271,168,1095,775,121,654,877,105,746,885,119,766
28035000505,773,657,89,538,476,62,546,490,52,535,436,99,894,808,80,883,778,91,647,596,51,601,516,76,637,564,73
28059505-1B,767,187,554,564,173,391,571,194,370,567,155,412,922,309,589,936,283,634,591,174,417,646,165,467,636,179,457
28059000506,2415,591,1728,1926,661,1265,1950,722,1198,1937,588,1349,3098,1069,1940,3106,978,2070,2041,697,1344,2213,676,1487,2209,718,1491
28059000505,307,74,222,225,69,156,227,76,148,227,62,165,454,153,288,452,137,307,237,69,168,258,66,187,256,71,185
28059508-1a,1010,247,724,743,229,514,749,256,485,745,203,542,1025,338,652,1029,312,697,776,230,546,859,221,616,846,241,605
28059505-1b,37,9,27,30,10,20,31,12,19,31,9,22,41,14,26,41,13,28,34,12,22,35,11,24,35,11,24
28005000503,241,114,122,168,90,78,176,97,75,169,88,81,243,120,121,242,115,125,171,92,79,181,90,87,175,88,87
28005000401,420,83,332,311,56,255,317,72,242,312,62,250,449,83,359,448,77,367,310,65,245,331,59,256,329,64,265
28093000103,587,281,296,346,175,171,352,182,167,342,163,179,690,364,311,704,341,354,418,229,189,428,186,233,425,203,222
28093000302,710,352,350,404,220,184,410,227,183,401,210,191,755,389,348,760,365,389,497,290,207,557,271,270,556,306,250
28093000206,443,218,219,228,96,132,235,108,127,219,88,131,531,265,252,537,236,298,307,171,136,318,139,173,315,168,147
28145000302,734,185,521,563,110,453,563,208,347,566,139,427,839,256,562,835,222,597,526,129,397,526,98,417,538,131,407
28087000508,333,273,56,220,184,36,224,190,34,215,177,38,333,284,49,336,277,53,251,215,36,230,178,50,236,188,48
28087000402,924,842,68,540,488,52,551,500,47,527,470,57,872,801,70,864,770,83,664,613,51,651,564,78,685,612,73
28087000303,3622,586,2976,2667,536,2131,2670,630,2008,2660,540,2120,3928,923,2945,3942,814,3097,2608,575,2033,2906,521,2357,2892,565,2327
28087000104,1865,1158,683,1234,825,409,1245,848,386,1230,785,445,1976,1439,517,1974,1380,575,1428,984,444,1396,887,494,1413,920,493
28087000403,321,298,22,237,217,20,240,225,15,230,203,27,323,292,30,322,285,36,233,220,13,192,163,27,218,198,20
28087000409,2218,1807,376,1396,1142,254,1401,1152,241,1382,1092,290,2390,2032,340,2375,1954,387,1680,1446,234,1622,1289,314,1654,1338,316
28087000302,1828,453,1348,1242,351,891,1247,395,845,1236,317,919,2012,672,1309,2021,604,1390,1287,394,893,1387,346,1012,1382,386,996
28087000101,2566,345,2164,1938,324,1614,1940,396,1519,1927,309,1618,2954,536,2339,2966,444,2471,1834,316,1518,2031,278,1709,2031,349,1682
28087000507,929,246,658,785,217,568,789,248,531,788,202,586,1061,293,753,1061,279,770,809,237,572,830,197,619,821,223,598
28087000102,484,62,410,366,51,315,367,62,304,363,48,315,526,83,436,529,62,457,353,48,305,395,43,344,383,54,329
28087000204,949,440,482,635,310,325,635,314,316,624,298,326,1036,527,494,1037,484,538,637,343,294,681,304,368,693,335,358
28071000506,1605,744,768,945,455,490,944,590,342,946,563,383,1678,954,680,1670,878,750,1116,652,464,1216,604,580,1206,640,566
28071000406,2787,1216,1416,2051,958,1093,2065,1217,829,2072,1199,873,3193,1678,1456,3192,1579,1545,2086,1146,940,2289,1095,1163,2253,1147,1106
28071000103,2602,1053,1446,2058,804,1254,2076,1098,948,2089,1092,997,3198,1436,1722,3200,1341,1805,2045,1008,1037,2216,908,1277,2187,978,1209
28071000102,552,77,451,454,95,359,460,139,315,458,159,299,732,155,552,734,122,591,408,84,324,467,75,386,460,90,370
28071000304,2276,1214,970,1738,936,802,1760,1112,623,1751,1089,662,2643,1509,1099,2649,1463,1142,1804,1084,720,1954,1069,861,1946,1108,838
28071000303,1529,567,900,1258,536,722,1268,645,606,1264,662,602,1868,856,972,1872,770,1059,1210,577,633,1313,526,765,1307,587,720
28071000201,207,84,121,173,75,98,174,79,92,172,85,87,242,103,134,243,99,144,177,83,94,171,78,92,170,77,93
28145000201,331,24,302,284,34,250,290,77,208,287,47,240,390,35,323,389,19,370,228,16,212,239,12,224,240,16,224
28087000106,661,234,413,469,179,290,470,183,284,469,166,303,723,290,417,726,278,440,506,221,285,529,191,325,536,218,318
28087000201,2707,729,1905,1938,604,1334,1949,713,1227,1943,550,1393,2781,1012,1730,2783,940,1802,2093,703,1390,2235,654,1552,2233,708,1525
28087000202,1536,648,854,1097,487,610,1107,533,566,1097,459,638,1707,887,793,1706,839,842,1186,572,614,1241,526,696,1239,560,679
28099000206,1333,199,1112,1018,178,840,1021,264,747,1020,209,811,1467,275,1162,1480,242,1229,949,151,798,1029,143,876,1028,168,860
28099000502,390,232,156,301,184,117,303,195,105,301,188,113,390,235,150,396,239,155,291,197,94,303,175,125,302,183,119
28091000016,515,130,377,350,98,252,354,109,240,347,91,256,545,147,386,549,117,426,349,105,244,375,91,276,381,105,276
28091000014,472,121,336,347,114,233,347,138,198,347,108,239,507,177,314,505,153,338,315,110,205,348,99,242,351,107,244
28087000301,774,510,246,497,349,148,502,362,136,489,329,160,819,624,186,819,604,204,586,440,146,556,378,171,563,389,174
28073000020,1157,564,578,722,361,361,728,380,340,718,333,385,1159,592,542,1152,551,582,822,457,365,853,390,444,861,428,433
28053000502,427,316,102,304,228,76,306,243,59,298,214,84,398,307,84,399,292,97,371,299,72,301,213,79,330,260,70
28053000501,141,74,66,83,43,40,88,51,36,82,38,44,126,66,60,128,64,61,104,55,49,100,43,51,64,47,17
28053000302,96,12,83,65,8,57,66,15,49,65,7,58,75,13,62,75,9,65,61,9,52,59,6,51,63,9,54
28057000504,150,8,140,118,13,105,116,29,87,117,13,104,162,21,138,163,12,149,106,8,98,111,9,102,111,8,103
28053000301,333,225,105,215,136,79,216,140,76,211,120,91,313,208,103,312,207,102,278,192,86,226,126,93,238,150,88
28051000401,290,264,25,234,198,36,236,203,31,232,181,51,303,263,40,303,261,40,229,202,27,192,163,29,209,182,27
28051000502,1087,1003,78,871,778,93,899,809,81,855,704,151,1061,989,71,1061,942,100,926,869,57,793,693,85,812,743,69
28051000501,267,198,68,212,156,56,220,173,46,210,143,67,264,205,59,268,202,62,231,176,55,213,142,69,232,164,68
28057000505,447,105,336,305,91,214,301,99,201,304,76,228,463,140,313,466,111,348,291,90,201,298,76,216,297,90,207
28057000502,628,94,519,487,101,386,489,121,364,481,71,410,681,148,514,686,117,554,435,86,349,450,64,375,448,83,365
28149000301,1424,1023,372,869,628,241,878,656,211,869,524,345,1406,1044,343,1416,1028,370,1024,779,245,984,641,314,1026,720,306
28149000202,803,484,305,504,302,202,507,300,197,497,257,240,775,470,303,781,453,319,550,362,188,546,298,231,570,353,217
28149000205,850,744,94,577,490,87,581,503,70,571,413,158,817,714,97,817,693,114,663,601,62,621,493,106,657,580,77
28059000501,1367,398,933,901,290,611,902,301,592,895,266,629,1529,584,912,1533,538,981,1013,357,656,1052,332,704,1057,356,701
28059000502,184,52,125,120,38,82,121,40,79,118,35,83,194,74,115,194,67,124,134,47,87,143,44,95,140,47,93
28059000310,3269,1297,1903,2289,961,1328,2308,999,1275,2265,863,1402,3765,1708,1974,3783,1563,2157,2719,1253,1466,2920,1128,1721,2932,1253,1679
28059000311,74,30,43,52,22,30,52,24,28,53,21,32,107,48,56,104,43,61,60,28,32,64,26,38,68,29,39
28059000312,320,127,186,226,95,131,226,98,125,224,85,139,381,172,201,385,160,218,266,122,144,280,109,167,285,122,163
28099000406,286,40,246,218,53,165,217,53,159,215,52,163,297,52,241,299,49,248,197,37,160,209,35,168,209,38,171
28083000012,202,117,85,139,68,71,143,86,57,140,64,76,224,133,90,226,119,106,167,94,73,157,74,81,168,89,79
28141000501,207,9,195,167,16,151,170,25,139,169,15,154,233,25,206,234,15,218,144,12,132,137,9,121,140,15,125
28049000414,1372,1221,131,1006,933,73,1008,943,55,1001,857,144,1442,1341,91,1444,1302,117,1187,1102,85,1077,935,118,1083,976,107
28049000411,462,400,58,312,282,30,314,280,26,311,256,55,477,443,32,473,422,42,361,330,31,355,293,50,355,308,47
28151000302,588,571,12,365,355,10,373,359,10,348,320,28,545,527,12,540,510,26,433,427,6,403,381,20,422,409,13
28049000111,982,917,49,719,674,45,724,684,34,718,620,98,1180,1119,51,1185,1094,76,848,818,30,810,732,63,822,765,57
28049000210,740,724,12,513,498,15,517,510,5,513,458,55,694,688,5,697,672,19,622,619,3,564,536,17,567,552,15
28049000521,307,297,7,199,194,5,199,195,2,199,174,25,277,271,6,279,269,7,239,236,3,229,214,11,230,225,5
28049000322,629,569,54,406,376,30,411,381,27,407,345,62,767,716,46,768,703,57,511,479,32,502,436,59,503,458,45
28049000320,1574,1392,162,1233,1132,101,1233,1134,93,1222,1006,216,1614,1493,111,1626,1470,144,1426,1326,100,1375,1211,144,1385,1252,133
28049000508,307,296,7,198,191,7,199,188,7,198,181,17,321,307,11,316,294,13,247,243,4,223,200,14,225,211,14
28049000515,395,363,29,249,226,23,249,231,17,248,202,46,368,343,23,367,332,30,292,277,15,273,236,30,275,245,30
28049000501,583,430,113,444,351,93,448,374,68,447,328,119,683,581,94,681,555,111,488,424,64,504,399,97,509,408,101
28049000408,1649,640,984,1250,545,705,1260,604,644,1260,510,750,1713,736,957,1719,724,984,1346,596,750,1372,556,795,1376,579,797
28049000420,412,146,262,329,119,210,329,139,189,329,105,224,464,180,279,465,170,290,350,128,222,352,114,234,357,120,237
28049000228,818,208,591,670,215,455,668,279,382,667,197,470,989,318,649,999,311,675,662,216,446,672,193,465,678,207,471
28049000226,465,280,182,388,257,131,389,266,120,387,232,155,492,315,174,494,309,183,430,277,153,430,258,164,431,271,160
28049000206,879,614,214,727,509,218,738,594,134,733,461,272,1049,794,233,1050,761,250,788,624,164,793,584,191,795,598,197
28049000207,335,236,80,280,196,84,283,227,53,282,176,106,373,286,83,372,273,89,303,239,64,306,226,76,300,228,72
28151000305,377,368,6,252,241,11,264,253,9,253,229,24,402,392,9,401,380,13,305,303,2,306,292,11,319,312,7
28151000301,401,298,97,286,220,66,294,229,63,281,206,75,397,309,85,394,293,99,311,241,70,301,214,84,309,233,76
28151000105,1640,677,940,1223,547,676,1227,626,593,1217,521,696,1724,887,824,1640,768,859,1303,637,666,1380,575,792,1405,652,753
28047000303,569,206,340,431,206,225,434,204,219,432,186,246,705,317,364,705,298,394,467,221,246,512,214,289,509,214,295
28047000311,1667,285,1325,1187,267,920,1194,346,827,1195,267,928,1843,475,1303,1840,406,1385,1215,268,947,1390,278,1091,1384,294,1090
28047000501,1069,397,648,792,330,462,791,347,433,791,308,483,1431,670,730,1430,637,778,855,382,473,916,373,534,921,389,532
28013000009,1032,246,775,819,212,607,830,276,543,817,199,618,1004,272,716,1005,243,753,727,193,534,764,156,596,767,187,580
28041000504,340,164,172,246,124,122,250,134,111,242,124,118,338,190,141,343,170,170,222,130,92,242,124,106,241,132,109
28019000002,302,219,77,202,144,58,205,146,54,201,143,58,296,219,73,290,204,84,236,183,53,210,145,58,224,164,60
28081000201,2715,851,1805,2110,799,1311,2123,918,1190,2116,741,1375,2907,1226,1627,2914,1150,1715,2177,833,1344,2134,677,1408,2135,730,1405
28081000304,1669,1257,379,1115,844,271,1128,893,222,1110,800,310,1794,1450,318,1792,1369,378,1235,1008,227,1075,738,319,1090,802,288
28095000107,647,81,560,525,94,431,528,153,370,529,79,450,683,123,546,682,100,573,492,72,420,515,56,458,511,68,443
28095000105,1368,99,1256,1110,127,983,1129,232,888,1118,126,992,1582,173,1380,1587,124,1452,993,94,899,1008,71,924,1013,97,916
28095000306,584,251,327,424,198,226,429,219,205,427,176,251,609,314,284,610,299,307,448,195,253,461,176,276,463,188,275
28119000101,407,355,46,281,239,42,300,261,32,272,221,51,389,341,41,384,321,55,308,277,31,285,226,54,289,247,42
28119000102,114,110,3,84,76,8,92,86,5,81,69,12,120,116,3,119,114,3,98,97,1,81,71,7,81,78,3
28049000103,1081,264,778,884,237,647,883,402,472,895,171,724,1226,409,795,1219,390,801,917,284,633,954,243,699,953,249,704
28049000211,751,719,21,544,527,17,548,536,9,540,474,66,702,673,20,687,646,28,642,637,5,563,526,31,576,548,28
28049000305,353,330,20,245,232,13,247,236,11,243,209,34,426,406,17,424,394,23,299,289,10,273,252,18,280,265,15
28049000221,1966,943,970,1661,860,801,1655,986,657,1662,759,903,2325,1231,1058,2326,1190,1099,1712,923,789,1771,849,894,1784,908,876
28049000218,799,780,17,640,632,8,640,625,8,636,581,55,830,819,5,816,788,20,766,762,4,708,672,26,714,695,19
28091000005,743,48,683,577,43,534,583,54,519,579,42,537,754,85,656,754,56,688,506,38,468,544,40,489,550,39,511
28091000023,395,102,291,279,88,191,279,88,183,274,82,192,422,118,297,424,112,309,257,92,165,256,74,174,261,85,176
28011000402,1218,1169,39,910,872,38,941,894,39,897,833,64,1175,1139,34,1180,1109,59,1036,1019,17,951,895,36,990,959,31
28011000405,441,412,29,315,281,34,321,292,27,308,271,37,493,453,39,487,439,44,373,352,21,341,305,33,350,325,25
28019000011,186,21,161,152,21,131,151,18,131,152,13,139,216,36,174,219,31,187,128,14,114,141,8,128,145,15,130
28019000010,206,58,144,158,46,112,157,52,105,159,42,117,209,66,141,211,57,151,150,61,89,157,49,102,158,55,103
28047000109,974,415,524,648,312,336,652,326,310,646,304,342,1103,532,548,1104,481,603,684,325,359,723,316,382,719,329,390
28047000108,730,245,467,452,168,284,453,177,268,450,159,291,795,307,463,793,280,498,504,190,314,579,195,373,580,210,370
28079000103,322,15,307,275,23,252,276,37,235,274,22,252,371,31,336,372,20,349,248,13,235,249,15,229,262,16,246
28079000301,683,555,124,519,409,110,523,431,85,516,384,132,746,622,118,742,604,133,572,477,95,571,411,138,596,475,121
28079000201,652,267,379,556,244,312,561,277,279,556,232,324,727,352,360,729,337,386,506,237,269,520,195,318,540,232,308
28079000401,343,131,209,287,111,176,289,117,167,280,105,175,388,151,233,386,146,237,259,109,150,253,99,148,264,117,147
28019000008,241,17,223,182,15,167,188,24,164,182,15,167,254,24,224,259,8,250,176,7,169,186,11,170,190,14,176
28019000007,305,57,240,215,39,176,218,41,174,215,39,176,324,61,256,328,53,271,231,40,191,231,29,200,242,39,203
28101000201,491,36,446,347,41,306,347,78,250,348,53,295,530,72,448,538,64,472,332,34,298,372,34,321,376,52,324
28105000204,696,535,138,510,409,101,514,419,90,500,386,114,737,608,124,738,580,142,568,474,94,560,415,136,573,444,129
28041000202,600,343,255,466,245,221,482,258,214,464,246,218,637,339,293,638,315,314,355,222,133,404,230,165,386,224,162
28041000201,298,162,133,227,120,107,236,127,103,223,123,100,307,168,133,316,162,149,198,119,79,214,110,97,213,117,96
28041000502,338,12,324,249,22,227,258,39,213,252,42,210,394,26,360,405,11,392,179,8,171,242,9,221,235,20,215
28149000103,1942,497,1412,1464,450,1014,1464,541,902,1461,379,1082,2269,741,1491,2275,694,1565,1444,489,955,1537,433,1077,1553,485,1068
28149000102,1668,387,1262,1285,349,936,1291,422,852,1280,292,988,1698,530,1140,1698,496,1188,1271,371,900,1346,319,1007,1371,364,1007
28149000143,573,146,415,587,128,459,590,178,405,589,99,490,818,180,628,816,175,633,557,118,439,583,102,473,596,126,470
28149000303,823,611,196,623,476,147,621,484,129,624,398,226,913,720,184,915,701,203,676,543,133,624,448,169,657,510,147
28035000503,181,32,145,124,27,97,124,32,87,121,19,102,196,49,141,197,39,154,128,32,96,132,21,103,134,29,105
28101000504,484,186,287,393,161,232,392,177,206,395,164,231,526,245,279,528,230,289,377,157,220,390,150,234,391,158,233
28101000401,948,319,615,717,261,456,721,295,419,720,275,445,989,370,600,994,343,634,728,270,458,705,229,461,726,265,461
28105000502,954,629,283,626,439,187,629,478,143,613,413,200,1033,758,262,1026,726,276,724,545,179,730,478,234,743,523,220
28105000501,996,770,189,583,488,95,593,514,72,577,469,108,996,795,188,994,752,216,711,616,95,708,542,154,725,573,152
28105000203,1760,887,780,998,549,449,1009,601,397,994,532,462,1890,1113,718,1891,1029,796,1154,686,468,1195,621,537,1240,688,552
28035000402,321,41,276,258,32,226,257,53,197,258,35,223,378,63,309,378,49,323,243,41,202,248,31,208,256,42,214
28035000405,706,528,157,486,341,145,496,385,103,478,294,184,747,590,148,752,564,167,532,423,109,512,366,139,542,407,135
28035000204,383,326,43,249,212,37,253,223,28,243,184,59,367,320,40,363,305,51,289,263,26,273,211,44,288,245,43
28035000409,924,738,174,648,514,134,666,539,120,624,441,183,954,756,185,953,735,201,726,619,107,670,494,149,715,580,135
28035000502,645,21,617,474,20,454,479,52,422,476,31,445,748,67,657,752,28,716,441,21,420,486,22,455,488,33,455
28035000101,788,174,588,692,157,535,689,222,456,698,137,561,965,255,692,960,233,716,675,170,505,733,156,569,740,174,566
28149000502,1256,286,927,1077,272,805,1079,350,709,1080,202,878,1448,450,983,1453,415,1018,1045,302,743,1101,251,833,1127,299,828
28053000305,398,367,31,213,193,20,213,196,15,205,174,31,365,345,20,366,335,28,306,286,20,250,208,32,261,227,34
28053000402,777,531,244,539,383,156,551,408,141,530,342,188,844,636,204,846,615,225,634,453,181,572,354,202,576,378,198
28149000204,128,50,78,101,35,66,101,41,59,101,32,69,141,48,93,141,47,93,96,39,57,90,26,64,90,32,58
28057000105,271,21,245,223,32,191,224,52,171,226,28,198,319,44,269,319,30,287,180,20,160,182,19,159,187,31,156
28057000409,387,50,333,269,66,203,269,83,184,268,54,214,402,78,310,406,60,341,263,49,214,258,35,217,265,58,207
28149000104,274,35,231,210,31,179,210,44,163,207,29,178,269,41,221,271,33,234,199,32,167,212,23,185,216,30,186
28053000401,175,42,132,114,34,80,116,36,80,112,27,85,169,51,117,167,41,126,121,40,81,120,31,88,124,39,85
28057000501,672,47,608,541,54,487,542,89,445,543,45,498,746,83,647,750,58,685,471,43,428,482,40,435,492,48,444
28057000306,345,107,230,263,89,174,265,102,161,259,72,187,395,135,250,396,124,269,251,95,156,235,68,164,241,90,151
28045000024,680,49,620,395,32,363,398,46,350,398,40,358,794,115,656,805,67,728,421,43,378,508,46,455,501,52,449
28045000015,297,50,240,197,44,153,198,50,145,196,49,147,375,113,249,387,79,300,177,36,141,219,50,165,209,53,156
28033000510,2084,392,1626,1244,259,985,1248,387,840,1242,283,959,2469,639,1745,2480,538,1902,1234,305,929,1553,283,1218,1535,320,1215
28033000502,1471,423,1010,897,285,612,904,343,543,903,296,607,2066,812,1213,2063,746,1276,1017,415,602,1171,372,781,1159,401,758
28033000405,1118,306,784,741,193,548,749,243,493,740,193,547,1401,423,948,1399,366,1012,796,266,530,926,245,655,920,253,667
28033000307,1348,736,576,647,374,273,649,390,252,648,368,280,1380,924,433,1380,860,489,864,577,287,987,589,377,982,582,400
28101000304,348,15,331,291,13,278,291,33,256,293,25,268,407,28,370,410,22,385,270,14,256,280,14,259,286,26,260
28041000101,1087,87,991,799,103,696,808,169,629,802,170,632,1158,157,965,1177,107,1052,579,67,512,737,80,639,719,97,622
28033000202,2227,1039,1118,1236,659,577,1240,680,542,1236,634,602,2611,1617,942,2612,1519,1038,1542,941,601,1814,924,850,1788,936,852
28157000301,762,462,293,632,393,239,641,379,242,620,360,260,744,445,289,747,444,294,505,307,198,530,302,214,523,301,222
28157000402,182,89,91,164,77,87,166,79,84,159,70,89,203,98,102,205,101,101,131,75,56,130,63,61,133,66,67
28045000001,547,169,366,312,121,191,317,115,197,310,114,196,581,229,328,595,197,393,319,139,180,401,164,229,377,163,214
28045000014,646,97,538,413,78,335,417,113,303,414,78,336,761,151,586,773,106,657,385,62,323,476,96,370,458,88,370
28045000022,464,36,422,290,37,253,292,52,238,292,48,244,577,85,474,580,48,529,284,32,252,318,33,278,321,42,279
28137000402,772,325,435,527,219,308,536,234,291,515,198,317,876,380,483,876,344,523,558,247,311,559,209,331,576,231,345
28009000105,835,105,724,669,101,568,684,174,496,668,122,546,939,157,743,949,114,826,515,81,434,573,70,490,561,82,479
28155000303,323,30,287,268,39,229,269,43,225,266,37,229,323,37,278,324,32,290,243,24,219,241,21,217,241,22,219
28135000404,111,86,24,79,63,16,80,64,14,76,55,21,86,67,18,85,64,20,89,75,14,73,50,22,80,62,18
28135000203,143,76,67,107,49,58,111,59,51,107,47,60,80,41,39,79,38,41,111,58,53,109,50,58,110,59,51
28135000403,330,309,18,221,206,15,235,221,9,216,198,18,281,268,10,281,253,19,256,250,6,204,184,17,227,215,12
28135000501,403,348,51,301,253,48,309,268,38,294,242,52,319,280,37,317,265,44,289,254,35,296,238,49,315,274,41
28135000204,145,57,88,109,35,74,111,47,64,109,33,76,137,55,81,137,49,86,111,43,68,108,34,74,109,45,64
28131000101,135,9,121,72,5,67,72,12,57,72,7,65,129,20,105,129,10,116,84,6,78,93,6,85,96,9,87
28131000401,884,58,811,670,79,591,679,83,583,673,68,605,1101,114,962,1101,90,998,678,53,625,698,49,637,702,61,641
28131000502,617,75,525,489,85,404,497,113,372,495,90,405,665,112,531,663,91,567,445,66,379,468,61,393,473,80,393
28101000102,582,176,399,442,140,302,441,169,259,445,141,304,614,214,393,613,208,401,423,137,286,429,129,290,432,136,296
28105000301,525,220,277,158,80,78,156,100,54,157,79,78,412,247,159,414,223,180,185,118,67,224,122,95,223,124,99
28041000304,479,28,450,375,34,341,379,54,317,375,37,338,525,42,468,529,35,491,299,18,281,361,23,326,362,27,335
28041000402,482,46,430,332,48,284,333,53,276,334,56,278,526,93,424,537,45,492,248,23,225,320,27,287,315,44,271
28035000506,705,397,256,485,286,199,494,342,146,493,285,208,816,553,245,815,528,267,569,393,176,610,381,204,607,404,203
28035000102,1089,734,282,745,530,215,756,583,162,734,488,246,1339,1031,281,1337,971,324,903,714,189,886,625,234,928,695,233
28035000408,478,130,329,334,110,224,336,131,198,333,110,223,611,255,331,609,215,378,305,112,193,349,108,225,352,121,231
28035000201,844,404,425,653,317,336,655,343,300,652,285,367,940,473,454,944,447,472,659,353,306,659,310,338,681,325,356
28033000106,1910,709,1142,878,322,556,884,339,531,879,311,568,2005,988,985,2017,932,1058,1176,555,621,1383,538,819,1361,571,790
28033000203,1726,503,1151,861,231,630,860,265,582,858,232,626,1852,773,1021,1857,674,1134,962,354,608,1189,365,786,1165,368,797
28039000203,819,34,776,463,30,433,463,46,412,459,30,429,871,104,745,887,51,828,490,50,440,600,45,543,574,75,499
28039000205,340,22,315,185,8,177,185,17,167,184,13,171,386,26,347,389,16,372,187,12,175,232,13,215,229,20,209
28093000501,1368,846,497,881,484,397,891,540,347,865,480,385,1477,961,503,1480,907,554,1113,726,387,1123,654,452,1128,698,430
28093000101,1085,909,163,564,431,133,578,453,115,552,414,138,982,830,143,976,793,165,753,632,121,782,607,164,786,630,156
28033000506,3521,562,2864,2158,397,1761,2165,598,1547,2166,422,1744,4148,932,3098,4158,767,3330,2354,519,1835,2856,453,2323,2815,515,2300
28033000503,1859,295,1523,1078,210,868,1082,250,815,1083,210,873,2124,488,1564,2127,416,1680,1203,268,935,1447,256,1164,1424,266,1158
28033000205,2143,569,1517,1426,412,1014,1432,482,935,1435,409,1026,2486,923,1519,2491,854,1602,1602,548,1054,1851,498,1318,1825,533,1292
28033000201,2204,705,1424,1349,518,831,1358,555,795,1349,495,854,2482,1189,1256,2485,1123,1319,1632,709,923,1836,662,1135,1814,688,1126
28033000406,1151,210,900,694,134,560,697,162,523,690,122,568,1344,306,991,1349,234,1083,716,166,550,889,148,709,883,160,723
28137000401,840,187,638,579,146,433,587,177,404,583,148,435,897,255,622,904,212,672,560,145,415,624,124,484,623,147,476
28131000304,363,18,335,278,36,242,285,33,245,281,34,247,404,40,350,403,24,372,258,19,239,276,18,251,280,21,259
28131000501,778,122,643,559,105,454,563,130,420,559,116,443,815,169,630,817,139,671,574,104,470,611,88,512,614,106,508
28073000013,1479,283,1146,1019,264,755,1017,338,665,1024,271,753,1691,479,1164,1694,439,1217,1059,277,782,1212,265,917,1218,285,933
28073000002,2107,509,1528,1500,444,1056,1501,557,923,1494,440,1054,2534,896,1588,2535,833,1668,1618,538,1080,1775,492,1244,1777,534,1243
28073000015,492,15,468,315,18,297,316,21,289,316,15,301,525,41,473,529,27,496,338,18,320,362,13,336,369,14,355
28137000203,705,258,436,458,161,297,469,183,280,452,155,297,728,254,455,735,222,499,447,179,268,463,147,304,464,168,296
28091000015,542,113,422,404,94,310,410,112,295,411,96,315,555,134,416,552,127,422,408,103,305,431,89,331,437,94,343
28091000010,462,218,232,328,160,168,331,168,160,326,155,171,454,221,228,453,199,248,329,170,159,328,151,167,324,152,172
28071000501,255,18,235,206,25,181,207,25,179,206,36,170,305,36,261,306,29,274,200,21,179,205,17,184,202,23,179
28093000102,1036,900,124,675,577,98,692,603,81,650,543,107,1044,898,136,1051,866,168,822,752,70,810,673,127,827,724,103
28009000104,764,179,573,520,112,408,530,146,377,518,120,398,805,229,562,802,193,606,503,141,362,541,116,421,539,135,404
28005000504,539,176,359,428,146,282,441,165,271,432,152,280,578,184,388,579,169,403,379,143,236,422,136,280,421,152,269
28137000202,1279,828,429,718,457,261,742,471,259,699,415,284,1245,790,429,1248,756,475,879,614,265,863,515,337,886,568,318
28033000103,1290,428,815,960,322,638,971,344,617,965,310,655,2009,774,1190,2004,712,1263,1115,435,680,1288,414,847,1261,443,818
28033000110,1497,501,949,656,339,317,660,347,306,651,325,326,1563,830,704,1562,775,756,843,450,393,1012,454,530,982,475,507
28033000101,918,263,619,577,165,412,580,184,387,579,162,417,1256,349,887,1255,301,933,627,230,397,752,211,524,741,238,503
28033000509,812,79,720,501,50,451,500,81,415,502,63,439,1137,147,949,1142,125,1002,520,63,457,638,60,555,634,78,556
28049000313,221,211,4,164,160,4,164,162,2,163,150,13,188,182,5,186,168,11,194,193,1,182,166,11,183,176,7
28049000309,645,629,13,450,434,16,455,447,5,447,397,50,592,584,6,586,572,11,533,529,4,512,482,22,518,505,13
28049000502,139,136,1,113,107,6,114,110,4,113,91,22,166,156,9,167,150,12,135,129,6,119,103,10,123,116,7
28155000204,317,45,267,228,36,192,227,59,165,228,31,197,279,46,215,281,39,235,210,29,181,226,23,197,228,29,199
28155000401,214,13,200,157,17,140,161,27,133,158,21,137,205,23,176,208,16,192,158,14,144,154,12,139,156,14,142
28155000503,292,42,243,223,38,185,225,50,173,224,31,193,336,64,264,338,54,282,205,40,165,223,39,180,219,43,176
28025000502,189,23,163,132,16,116,133,22,110,131,13,118,179,27,145,178,17,159,130,19,111,131,11,118,128,17,111
28025000102,1338,756,562,949,546,403,954,561,389,942,521,421,1370,833,531,1355,788,552,1076,674,402,1015,541,466,1031,578,453
28049000404,856,415,414,645,392,253,644,435,203,644,368,276,1018,626,369,1017,596,404,705,440,265,701,387,298,709,404,305
28049000223,386,174,207,320,169,151,324,178,145,330,153,177,425,209,208,432,202,228,326,167,159,335,154,169,338,159,179
28049000503,1392,627,739,1090,623,467,1094,663,423,1091,577,514,1605,942,632,1610,913,683,1162,674,488,1170,610,554,1167,613,554
28049000524,722,246,461,574,244,330,576,259,314,573,200,373,753,285,456,763,279,476,593,245,348,619,218,389,622,238,384
28049000528,2451,796,1621,1952,799,1153,1956,861,1080,1949,713,1236,2776,1143,1600,2788,1100,1665,2066,842,1224,2070,764,1270,2071,785,1286
28049000114,1999,1096,850,1647,1021,626,1647,1123,509,1653,888,765,2091,1436,642,2079,1397,661,1785,1142,643,1819,1100,702,1825,1129,696
28013000007,687,210,463,518,151,367,522,212,305,516,150,366,740,243,483,744,202,533,519,166,353,479,118,355,485,148,337
28027000009,416,365,48,205,173,32,213,179,33,197,148,49,387,334,51,389,327,62,331,291,40,281,211,65,315,264,51
28049000108,491,285,176,423,246,177,431,313,113,428,235,193,625,408,203,620,388,216,453,313,140,495,308,173,489,302,187
28049000109,840,430,353,679,364,315,687,491,187,692,344,348,931,571,348,926,542,343,703,448,255,758,430,317,758,443,315
28049000204,579,246,303,496,225,271,505,330,171,507,203,304,728,397,320,726,380,332,543,299,244,560,270,284,562,277,285
28049000209,830,814,8,617,600,17,624,616,5,618,543,75,847,832,12,847,821,19,742,736,6,656,608,33,673,655,18
28049000304,752,728,15,518,500,18,519,499,11,514,443,71,697,683,13,692,664,20,623,616,7,588,562,18,600,586,14
28049000512,326,320,4,219,218,1,223,221,0,223,204,19,322,316,4,317,310,3,254,254,0,234,226,7,238,237,1
28025000303,332,159,172,272,120,152,273,146,127,272,109,163,341,159,176,337,149,185,275,140,135,266,119,144,262,122,140
28155000302,240,59,174,185,53,132,188,59,127,183,47,136,247,78,164,249,67,181,175,56,119,175,43,126,174,48,126
28135000102,309,98,210,259,101,158,267,109,152,257,104,153,341,130,202,342,107,231,232,97,135,234,72,157,239,97,142
28085000204,382,312,66,303,257,46,303,260,40,295,231,64,443,378,62,438,365,69,350,298,52,284,222,56,303,253,50
28085000501,477,69,402,335,52,283,334,77,254,331,49,282,512,77,431,513,75,436,404,65,339,397,55,341,418,63,355
28049000222,189,182,4,131,128,3,131,127,3,130,117,13,170,166,4,168,162,5,145,144,1,137,124,11,135,130,5
28049000227,315,298,14,241,230,11,242,229,9,240,212,28,343,322,20,343,311,27,274,266,8,265,242,13,271,252,19
28049000401,1115,419,647,817,374,443,819,440,368,821,343,478,1172,559,596,1174,538,620,836,396,440,905,367,519,904,393,511
28049000106,503,447,42,379,357,22,379,359,16,379,320,59,561,535,23,560,522,27,430,406,24,415,373,36,417,382,35
28151000102,1050,652,379,738,498,240,747,525,215,729,467,262,1079,779,294,1071,738,320,822,578,244,882,546,324,897,601,296
28049000229,607,301,295,444,244,200,447,262,182,445,219,226,601,325,272,601,313,282,469,251,218,499,243,246,505,252,253
28049000527,613,505,100,437,364,73,441,374,62,435,322,113,610,509,101,610,497,107,512,437,75,501,388,100,505,410,95
28049000412,313,288,22,210,192,18,211,193,14,207,170,37,306,287,18,303,279,21,263,245,18,237,206,24,243,219,24
28049000308,455,417,35,300,273,27,305,282,21,298,243,55,433,406,26,433,399,31,375,349,26,342,300,36,350,312,38
28049000219,975,718,249,797,591,206,798,606,186,791,532,259,1006,742,258,1008,721,274,860,666,194,849,615,210,861,644,217
28049000112,1258,862,365,973,718,255,974,763,197,970,651,319,1305,1011,286,1306,992,301,1103,833,270,1071,746,309,1074,771,303
28049000507,1274,973,293,1047,855,192,1051,878,169,1048,779,269,1445,1161,275,1449,1123,313,1117,921,196,1102,839,250,1109,869,240
28049000220,1315,1007,290,1096,831,265,1109,866,227,1076,733,343,1560,1184,370,1567,1154,397,1219,975,244,1184,826,324,1207,912,295
28049000422,1277,869,391,1020,788,232,1022,806,207,1019,718,301,1402,1143,257,1400,1113,280,1094,862,232,1091,809,270,1097,841,256
28049000407,1556,623,905,1215,523,692,1223,589,623,1220,446,774,1578,664,895,1571,647,908,1261,564,697,1290,494,766,1304,542,762
28049000421,1373,490,833,1110,511,599,1112,605,498,1116,461,655,1582,731,811,1581,715,834,1127,522,605,1198,486,692,1200,513,687
28085000401,728,38,686,514,52,462,516,83,429,511,43,468,805,63,732,808,53,752,534,39,495,532,32,488,544,31,513
28017000103,289,115,167,249,96,153,250,130,119,247,98,149,303,131,170,298,115,178,228,92,136,218,78,136,220,87,133
28017000108,492,378,107,387,306,81,393,333,58,378,290,88,513,412,94,512,386,111,393,321,72,369,270,96,378,296,82
28075000109,1361,616,703,960,486,474,959,500,439,957,454,503,1442,846,577,1451,810,616,1012,543,469,1088,510,564,1087,518,569
28077000016,318,108,207,264,86,178,264,99,161,259,72,187,354,105,244,356,102,252,253,79,174,228,67,157,249,72,177
28077000021,79,12,67,65,6,59,66,11,55,66,10,56,73,13,57,73,13,58,59,8,51,56,7,49,58,9,49
28067000309,697,27,658,529,29,500,528,62,455,525,46,479,735,72,634,738,29,701,450,28,422,507,29,459,526,28,498
28067000306,655,35,608,452,44,408,453,59,387,454,42,412,699,70,605,702,43,646,433,35,398,467,35,417,478,41,437
28067000205,248,65,179,180,43,137,184,53,126,182,53,129,237,64,167,240,58,180,186,53,133,190,47,136,192,47,145
28067000206,559,330,223,425,260,165,430,282,145,422,256,166,574,365,203,575,342,225,456,297,159,444,270,170,464,293,171
28067000102,1749,663,1047,1264,491,773,1278,595,663,1260,465,795,1889,890,978,1899,838,1041,1347,611,736,1419,540,843,1460,567,893
28067000103,1755,492,1226,1226,352,874,1228,422,792,1220,342,878,1669,575,1057,1684,523,1136,1219,441,778,1321,399,882,1368,429,939
28067000104,1663,312,1329,1201,220,981,1209,287,906,1196,215,981,1726,401,1275,1735,352,1364,1136,268,868,1249,242,969,1294,252,1042
28049000418,2057,1515,514,1577,1267,310,1589,1302,275,1581,1167,414,2165,1774,370,2169,1731,411,1724,1399,325,1563,1198,345,1567,1224,343
28049000312,471,456,11,336,324,12,338,330,5,335,293,42,467,458,9,470,447,17,398,395,3,372,346,18,377,365,12
28067000402,382,87,291,270,74,196,269,90,178,270,72,198,439,131,298,436,118,314,258,79,179,279,65,204,299,68,231
28067000404,836,177,633,576,150,426,585,184,388,577,148,429,890,263,601,906,234,654,557,161,396,611,135,440,642,145,497
28067000506,874,319,528,538,228,310,541,263,270,537,215,322,787,374,399,786,338,432,619,295,324,667,250,391,689,276,413
28067000406,821,150,660,603,133,470,607,151,440,608,128,480,937,216,688,943,195,733,573,141,432,636,137,478,655,148,507
28067000412,651,29,613,485,29,456,486,47,434,487,44,443,743,61,663,746,39,705,467,30,437,514,28,470,524,27,497
28029000502,855,355,489,643,272,371,648,298,344,638,248,390,882,361,511,874,335,527,657,297,360,645,235,395,662,266,396
28029000501,1931,687,1218,1499,598,901,1506,654,844,1481,511,970,1807,702,1079,1804,676,1107,1537,634,903,1495,510,950,1535,574,961
28067000310,368,15,348,253,24,229,251,34,210,250,22,228,382,42,330,384,16,364,208,13,195,247,14,226,257,10,247
28067000304,992,41,940,818,52,766,818,103,699,819,79,740,1051,87,933,1051,45,988,628,33,595,725,38,653,751,35,716
28067000307,491,15,467,418,30,388,421,44,370,421,38,383,562,41,509,566,26,536,339,11,328,354,16,329,376,15,361
28067000510,1452,1137,303,960,736,224,979,788,188,946,684,262,1484,1204,267,1479,1146,309,1152,972,180,1102,850,227,1127,893,234
28067000305,862,171,680,672,140,532,672,183,474,669,127,542,954,237,692,962,213,744,605,145,460,645,118,510,672,134,538
28067000208,532,33,494,413,27,386,413,51,354,411,37,374,542,51,479,545,30,511,349,29,320,402,30,363,414,29,385
28147000301,424,102,319,306,72,234,311,70,237,303,75,228,441,114,322,446,104,341,292,68,224,303,59,238,318,78,240
28147000402,115,22,93,80,11,69,82,18,63,79,10,69,110,19,89,112,17,93,88,18,70,93,9,81,97,18,79
28147000302,556,137,416,391,93,298,396,105,289,391,90,301,589,147,436,594,140,449,372,99,273,409,89,308,412,96,316
28147000102,397,225,167,268,140,128,272,150,118,264,131,133,390,213,172,395,205,185,297,170,127,275,142,130,290,157,133
28147000104,201,60,140,142,47,95,144,48,95,142,50,92,213,64,145,214,57,155,143,52,91,138,37,99,138,43,95
28067000308,603,100,491,460,86,374,458,116,328,457,89,368,628,138,476,630,117,504,407,95,312,450,82,351,461,81,380
28067000302,359,194,160,251,129,122,252,143,107,247,120,127,393,236,152,392,221,168,284,176,108,284,150,130,298,167,131
28055000102,136,59,75,109,49,60,110,56,52,105,42,63,144,60,83,143,59,82,114,54,60,119,53,65,123,57,66
28055000105,136,52,82,88,25,63,86,35,51,81,16,65,136,51,84,131,46,83,98,38,60,99,28,67,109,41,68
28089000106,212,202,9,112,108,4,111,107,3,111,98,13,164,160,2,162,157,4,156,154,2,142,125,13,145,141,4
28089000406,639,622,12,338,327,11,340,328,8,334,306,28,492,481,8,485,464,15,448,442,6,407,386,14,418,405,13
28089000104,1398,831,551,1080,648,432,1077,685,384,1081,602,479,1418,913,498,1411,886,514,1212,777,435,1129,651,454,1153,697,456
28089000404,288,64,217,252,54,198,251,68,178,252,43,209,346,59,282,347,58,281,241,59,182,251,54,196,251,54,197
28103000401,330,157,169,253,108,145,256,119,137,249,104,145,350,157,192,353,152,196,251,116,135,262,114,144,265,119,146
28025000403,1254,948,294,831,650,181,837,660,172,820,611,209,1241,973,262,1222,921,278,977,789,188,917,677,226,936,725,211
28077000011,58,4,54,41,3,38,41,10,31,40,5,35,52,2,50,52,2,50,47,4,43,44,3,41,48,5,43
28077000006,161,121,38,128,85,43,130,99,29,126,76,50,165,123,42,164,119,45,149,117,32,121,78,38,136,100,36
28133000402,130,105,24,90,68,22,94,72,21,88,63,25,138,118,20,140,111,24,102,85,17,91,65,23,97,77,20
28063000012,149,53,93,117,47,70,117,49,68,116,38,78,156,60,96,159,62,96,129,50,79,118,38,77,121,46,75
28063000011,225,203,20,185,164,21,186,164,20,177,137,40,218,195,22,222,198,21,185,165,20,170,142,23,181,158,23
28125000101,320,234,83,226,162,64,231,189,41,227,145,82,308,228,80,307,222,79,227,180,47,214,139,68,235,168,67
28075000107,1199,188,981,891,169,722,891,230,653,893,167,726,1291,282,987,1296,268,1015,894,163,731,894,147,739,899,172,727
28123000304,580,33,535,467,53,414,470,103,364,468,72,396,569,54,505,571,45,522,448,39,409,430,32,396,439,45,394
28123000505,498,288,204,391,228,163,396,239,155,386,195,191,558,340,212,560,324,230,391,247,144,357,188,164,380,222,158
28125000107,347,206,139,256,153,103,266,182,84,250,135,115,359,230,128,360,224,133,284,187,97,270,155,110,285,170,115
28125000110,183,154,26,122,98,24,126,106,20,120,91,29,154,131,21,156,124,25,144,127,17,138,115,21,148,129,19
28125000105,369,346,20,256,234,22,266,246,17,253,204,49,366,343,21,368,336,25,276,262,14,285,248,29,292,272,20
28029000204,520,132,382,398,120,278,404,146,254,400,101,299,590,155,428,591,145,440,431,120,311,421,107,304,439,115,324
28147000401,192,58,132,148,56,92,150,65,85,148,50,98,196,72,122,196,71,123,136,55,81,141,42,92,149,52,97
28123000201,823,513,298,580,364,216,580,392,185,573,342,231,835,538,288,838,511,317,629,421,208,596,345,245,614,379,235
28021000501,435,406,23,402,371,31,409,370,27,396,323,73,516,497,19,516,487,23,382,363,19,366,310,42,381,347,34
28021000402,750,655,94,654,577,77,660,600,55,641,527,114,806,733,68,797,709,76,677,628,49,593,472,95,618,541,77
28039000504,545,120,418,313,80,233,320,87,230,307,71,236,589,141,436,600,119,472,350,102,248,384,81,291,377,88,289
28107000202,371,246,125,239,156,83,243,156,83,239,152,87,383,258,124,376,240,133,280,209,71,276,181,92,280,190,90
28107000201,216,120,91,174,103,71,178,99,75,172,90,82,251,139,110,252,131,121,167,103,64,163,96,62,163,99,64
28067000410,522,149,371,424,124,300,425,148,273,420,119,301,610,193,407,612,169,437,402,149,253,424,133,278,426,139,287
28141000103,1654,238,1374,1310,276,1034,1340,345,971,1324,257,1067,1789,343,1391,1806,218,1552,1107,209,898,1241,183,1020,1225,227,998
28067000210,827,344,474,621,264,357,625,293,327,613,248,365,864,374,475,862,358,495,595,291,304,619,265,330,636,275,361
28133000504,431,176,245,300,131,169,301,149,152,295,125,170,407,187,218,402,166,232,313,147,166,329,130,196,327,140,187
28075000106,467,216,237,326,146,180,331,167,159,327,151,176,504,260,231,505,248,250,348,167,181,372,159,206,372,155,217
28075000207,194,91,101,141,62,79,141,71,68,140,63,77,245,127,112,251,124,126,150,71,79,158,68,88,158,63,95
28075000209,325,154,166,234,104,130,236,104,126,230,99,131,364,189,167,362,178,180,221,117,104,239,101,136,242,103,139
28075000514,1065,308,737,792,248,544,795,263,521,793,242,551,1128,377,731,1136,355,773,742,252,490,815,237,571,809,241,568
28075000401,408,344,58,302,265,37,302,264,31,302,249,53,395,347,42,388,335,50,324,296,28,330,271,48,326,265,61
28115000501,533,72,457,396,63,333,390,116,267,393,83,310,543,93,440,549,62,476,383,52,331,384,37,333,391,55,336
28023000401,585,35,547,472,25,447,467,52,405,471,37,434,649,44,592,650,32,617,420,28,392,459,23,428,462,39,423
28115000203,516,41,466,383,51,332,386,93,291,382,64,318,556,88,456,558,46,504,348,43,305,362,40,316,372,51,321
28115000201,425,21,395,309,31,278,315,60,252,315,43,272,494,41,440,500,32,464,301,19,282,315,23,282,312,35,277
28115000206,471,96,361,336,89,247,339,102,231,338,96,242,518,134,373,519,105,405,353,83,270,357,66,277,359,79,280
28089000301,1472,564,852,1190,523,667,1192,623,556,1199,458,741,1630,796,807,1629,747,858,1224,559,665,1210,487,702,1216,523,693
28133000302,415,226,185,249,115,134,252,130,119,250,118,132,445,278,166,443,266,173,281,162,119,298,147,146,301,163,138
28133000503,979,691,284,705,508,197,718,520,191,685,476,209,1000,742,252,995,707,275,703,535,168,629,428,191,649,471,178
28141000403,998,191,782,881,244,637,899,307,580,877,214,663,1125,266,830,1132,207,908,659,192,467,709,154,535,712,195,517
28141000302,424,63,344,320,90,230,328,104,220,326,75,251,457,103,336,460,82,373,253,55,198,289,47,233,285,59,226
28023000206,202,140,61,159,105,54,165,115,50,152,99,53,211,150,60,209,143,64,161,126,35,157,102,50,161,115,46
28125000109,227,148,78,150,78,72,155,91,62,146,74,72,238,150,88,239,151,87,190,121,69,176,104,71,190,119,71
28023000301,1144,193,945,903,164,739,913,225,671,900,183,717,1191,246,928,1199,214,973,780,168,612,889,154,720,901,184,717
28023000303,410,71,333,346,68,278,348,81,260,343,68,275,469,104,354,470,90,376,292,60,232,323,57,260,324,74,250
28141000504,531,35,488,384,36,348,389,56,331,389,37,352,538,53,472,541,37,495,352,32,320,374,25,342,373,29,344
28141000201,476,51,410,387,61,326,398,62,329,386,52,334,543,83,452,546,58,486,315,42,273,373,46,323,361,55,306
28133000303,970,499,454,651,299,352,654,348,298,647,300,347,970,538,428,972,516,447,766,407,359,767,332,422,789,388,401
28067000408,866,31,824,688,50,638,690,73,601,687,47,640,971,73,878,974,51,918,609,32,577,679,33,630,692,30,662
28061000202,112,22,90,90,17,73,90,25,63,89,19,70,138,34,102,139,32,104,92,17,75,91,18,73,93,19,74
28095000405,474,412,58,380,339,41,380,342,38,372,311,61,505,450,52,501,443,55,413,371,42,391,336,53,391,332,59
28153000404,429,126,301,316,93,223,317,113,202,315,87,228,402,123,272,399,107,286,287,89,198,306,81,214,321,87,234
28107000403,920,308,596,804,268,536,819,307,498,810,297,513,969,343,607,966,316,643,676,270,406,739,249,475,735,284,451
28107000305,1168,779,378,902,613,289,923,630,276,910,613,297,1214,845,357,1221,806,399,863,631,232,842,546,283,845,573,272
28115000108,669,146,510,475,131,344,477,151,310,475,138,337,792,198,570,797,173,611,469,120,349,501,102,392,501,118,383
28095000503,753,312,429,567,244,323,571,262,301,561,223,338,812,374,426,813,347,456,595,294,301,540,211,315,559,259,300
28023000205,513,410,99,433,352,81,440,359,72,423,334,89,536,448,81,533,436,91,410,338,72,391,302,79,400,322,78
28109000410,900,66,815,500,53,447,505,62,437,500,53,447,990,138,825,1013,84,920,487,57,430,646,61,560,622,78,544
28109000407,691,58,615,395,47,348,398,71,323,394,51,343,789,134,631,804,80,717,416,50,366,496,56,431,488,69,419
28109000320,1625,110,1480,948,103,845,953,111,834,954,114,840,1817,246,1504,1856,163,1678,942,118,824,1170,117,1015,1150,162,988
28125000104,515,252,256,401,190,211,403,238,160,385,158,227,541,297,243,536,281,252,393,209,184,418,187,223,443,226,217
28055000101,109,31,76,71,14,57,70,19,49,69,15,54,88,20,67,89,19,68,79,23,56,75,14,59,77,19,58
28121000508,1902,421,1418,1420,453,967,1427,549,854,1428,412,1016,2166,708,1397,2169,655,1475,1488,482,1006,1581,413,1130,1577,448,1129
28141000204,733,46,670,604,92,512,609,114,481,604,96,508,775,107,643,785,54,709,442,53,389,511,38,457,498,63,435
28097000102,711,113,589,583,112,471,589,175,407,584,141,443,756,173,563,754,152,598,541,104,437,578,94,480,583,103,480
28097000303,183,139,41,162,125,37,172,133,39,164,117,47,190,141,47,189,139,50,156,118,38,137,93,40,147,102,45
28155000402,481,80,395,391,65,326,393,79,313,390,68,322,565,92,466,566,90,468,375,74,301,405,65,330,410,62,348
28107000105,430,230,197,310,147,163,313,153,158,309,144,165,453,225,220,459,221,238,324,182,142,336,166,165,339,182,157
28039000403,668,34,625,341,22,319,340,41,297,339,32,307,725,88,612,737,45,687,314,29,285,442,30,394,440,48,392
28039000402,449,72,371,226,47,179,226,62,161,224,48,176,447,127,308,446,82,356,225,53,172,288,52,220,288,66,222
28039000503,226,20,204,94,7,87,94,14,80,94,11,83,237,39,190,238,18,217,118,15,103,144,16,124,137,20,117
28109000520,983,133,831,523,86,437,532,108,416,526,109,417,988,181,778,1008,146,850,555,101,454,670,106,542,654,130,524
28109000527,1772,176,1551,946,120,826,952,158,773,949,152,797,1838,266,1504,1860,193,1645,927,141,786,1190,153,990,1167,166,1001
28109000359,673,38,619,398,42,356,401,58,337,400,48,352,761,96,641,776,58,710,377,34,343,471,34,426,464,52,412
28159000102,1581,539,1015,1192,432,760,1192,501,681,1190,436,754,1666,665,972,1663,627,1023,1241,478,763,1285,416,847,1285,454,831
28097000402,77,6,71,66,6,60,66,9,55,66,6,60,82,8,73,82,6,76,60,4,56,61,3,58,64,7,57
28159000405,385,96,285,284,74,210,287,75,212,287,69,218,380,98,277,381,90,289,285,75,210,302,72,227,303,82,221
28163000102,341,59,274,242,40,202,245,49,194,239,38,201,329,49,278,328,43,285,231,33,198,224,27,190,230,30,200
28163000201,540,170,364,508,164,344,509,183,320,492,149,343,649,228,416,649,218,431,468,158,310,425,118,305,438,141,297
28153000105,590,243,342,371,175,196,379,208,164,368,187,181,618,272,332,608,242,355,396,205,191,412,170,230,415,181,234
28153000402,303,58,242,254,48,206,253,59,192,250,53,197,334,74,255,338,64,273,238,49,189,234,43,187,247,52,195
28105000302,1464,711,683,1041,577,464,1049,662,378,1044,527,517,1628,943,654,1613,903,668,1120,655,465,1166,584,565,1171,626,545
28065000013,1048,510,526,766,406,360,775,435,338,755,353,402,1023,546,472,1031,515,499,826,458,368,789,369,400,819,416,403
28065000022,227,59,167,181,56,125,181,58,122,178,50,128,221,70,146,220,62,156,170,55,115,153,38,112,159,44,115
28065000023,302,93,209,233,74,159,231,79,148,231,66,165,301,99,201,304,90,212,233,83,150,238,64,169,239,81,158
28107000307,213,152,59,156,114,42,159,115,42,158,111,47,216,163,52,218,158,56,193,165,28,161,116,40,159,123,36
28161000101,373,140,223,312,122,190,315,127,182,312,127,185,387,160,220,391,150,237,282,122,160,292,109,180,291,122,169
28011000107,569,522,42,346,304,42,367,335,30,343,297,46,578,538,39,580,520,48,439,409,30,377,319,48,420,379,41
28011000201,262,257,3,182,178,4,192,179,10,182,166,16,284,281,2,283,269,11,215,215,0,198,181,10,214,209,5
28003000502,922,80,832,856,149,707,881,140,728,857,150,707,1046,133,889,1060,66,987,531,57,474,581,40,532,573,89,484
28163000304,365,180,185,299,154,145,304,167,133,291,127,164,379,201,178,382,185,193,274,152,122,237,97,133,258,130,128
28163000405,1213,867,337,1042,723,319,1062,763,289,1033,670,363,1382,1013,363,1380,976,392,1110,907,203,882,616,246,959,743,216
28163000406,14,10,4,12,8,4,13,9,4,12,8,4,19,13,6,19,13,6,13,10,3,10,6,4,12,9,3
28163000204,497,208,286,307,185,122,312,195,111,302,167,135,401,271,128,398,252,141,422,214,208,388,153,230,418,186,232
28115000301,664,39,612,464,50,414,468,80,382,464,53,411,734,64,649,736,36,694,454,28,426,480,35,428,476,39,437
28115000303,650,90,545,462,87,375,468,139,323,461,101,360,734,140,574,736,112,617,441,81,360,478,64,400,475,78,397
28023000204,236,202,32,189,153,36,191,159,32,180,145,35,257,223,33,254,218,33,184,162,22,172,134,31,179,150,29
28023000304,278,109,167,225,80,145,223,85,135,222,78,144,297,118,174,295,108,186,200,81,119,205,75,127,206,83,123
28093000403,403,188,206,263,111,152,265,119,142,258,106,152,442,194,243,443,180,260,294,140,154,331,140,184,333,158,175
28097000203,137,73,62,92,46,46,95,52,42,91,46,45,143,75,67,144,71,72,106,61,45,118,61,55,118,63,55
28093000401,377,264,108,204,119,85,212,130,80,205,112,93,387,250,131,390,236,147,259,185,74,286,187,93,285,190,95
28113000405,777,216,551,656,197,459,661,241,408,655,203,452,898,277,603,897,262,625,606,192,414,640,182,445,650,191,459
28101000203,449,73,368,362,58,304,358,104,247,364,59,305,510,101,397,511,90,419,319,58,261,343,56,283,343,56,287
28101000202,515,35,473,385,29,356,389,51,332,387,30,357,566,58,494,570,54,514,360,35,325,387,25,355,389,43,346
28105000201,803,551,234,570,392,178,573,410,161,563,366,197,859,605,245,860,571,273,625,453,172,616,380,219,631,418,213
28075000501,643,484,148,414,329,85,417,333,77,409,311,98,669,565,95,662,536,116,462,386,76,480,351,121,482,356,126
28075000302,902,690,203,616,487,129,618,488,119,609,461,148,956,803,144,968,800,162,718,599,119,706,540,157,711,543,168
28075000402,852,767,77,434,398,36,437,400,32,433,379,54,706,661,43,704,637,63,533,500,33,518,462,49,516,454,62
28137000305,496,406,85,318,258,60,334,268,55,310,250,60,507,427,74,503,408,89,385,328,57,317,243,66,323,255,68
28137000304,177,115,61,134,90,44,135,90,43,127,76,51,182,125,55,181,120,59,143,104,39,130,82,46,138,92,46
28017000106,734,657,70,559,508,51,569,525,42,541,467,74,761,689,70,759,667,74,621,565,56,514,433,71,524,457,67
28075000405,634,601,32,475,447,28,477,441,30,469,424,45,692,650,38,691,642,41,540,515,25,529,483,42,529,485,44
28137000104,404,38,356,279,35,244,285,47,232,276,34,242,519,76,425,524,53,463,238,31,207,284,27,251,278,43,235
28145000103,966,132,815,759,137,622,770,207,552,760,160,600,1016,188,790,1016,148,860,623,133,490,656,106,536,663,125,538
28145000102,221,26,193,190,28,162,195,32,161,190,28,162,270,38,217,272,23,248,152,24,128,165,21,143,161,25,136
28073000010,1152,510,592,833,415,418,838,463,364,832,384,448,1348,753,569,1350,688,630,891,496,395,938,458,456,948,481,467
28073000001,2340,233,2063,1687,199,1488,1684,304,1344,1685,235,1450,2777,372,2323,2785,316,2433,1695,223,1472,1857,190,1630,1869,206,1663
28073000017,1455,118,1313,1012,103,909,1011,146,849,1012,116,896,1647,192,1414,1653,152,1486,1065,91,974,1150,87,1036,1152,103,1049
28077000027,12,1,11,10,1,9,10,1,9,10,1,9,15,1,14,15,1,14,9,0,9,10,1,9,9,0,9
28075000516,832,115,699,565,96,469,567,111,445,565,80,485,834,142,671,842,124,713,548,103,445,616,92,508,614,106,508
28075000407,341,89,248,224,61,163,227,66,154,224,53,171,339,104,231,337,90,246,218,66,152,242,57,178,247,64,183
28127000403,316,107,208,247,93,154,249,99,146,243,70,173,323,101,220,321,95,224,240,80,160,244,67,169,254,81,173
28127000406,252,114,133,193,89,104,193,93,100,187,78,109,260,115,143,259,114,144,202,94,108,186,72,110,196,83,113
28127000502,606,56,536,492,54,438,495,111,378,495,65,430,641,81,547,641,64,567,448,52,396,474,49,411,480,55,425
28127000208,316,59,255,266,61,205,266,70,193,269,59,210,348,81,264,350,77,270,232,59,173,238,45,190,247,50,197
28127000205,670,125,535,558,129,429,557,149,396,551,113,438,701,167,526,698,158,532,470,113,357,504,99,394,515,109,406
28127000203,276,93,181,226,80,146,231,92,132,228,66,162,287,104,180,289,93,190,215,88,127,201,61,136,211,78,133
28127000202,233,110,120,215,102,113,216,105,110,214,94,120,277,126,149,275,121,153,181,88,93,182,75,105,196,85,111
28157000501,422,223,190,359,213,146,363,216,135,353,201,152,434,252,171,446,256,184,276,159,117,284,150,127,265,135,130
28157000503,74,42,32,67,39,28,67,40,25,65,37,28,83,46,34,84,48,36,49,29,20,51,28,23,47,24,23
28127000404,103,47,54,77,36,41,79,38,41,78,33,45,113,51,62,113,51,62,86,41,45,77,31,45,85,34,51
28127000501,692,39,644,561,57,504,566,79,478,557,43,514,718,74,633,719,58,655,517,40,477,512,33,470,535,45,490
28139000403,438,18,409,353,22,331,360,57,300,356,38,318,521,54,454,526,26,496,298,20,278,334,15,311,328,25,303
28139000401,193,13,179,141,18,123,140,25,115,136,13,123,205,17,187,209,9,200,143,9,134,151,8,143,151,13,138
28139000102,133,10,123,115,16,99,117,19,97,113,15,98,140,18,120,141,10,130,87,6,81,86,8,77,83,9,74
28139000103,487,93,386,409,89,320,421,108,304,409,102,307,517,116,395,526,88,433,315,76,239,357,64,287,355,80,275
28139000301,725,265,448,531,208,323,537,210,311,524,190,334,681,293,368,679,269,399,503,213,290,494,168,311,497,187,310
28139000302,176,90,83,131,65,66,134,68,64,125,58,67,194,103,87,194,100,91,152,92,60,133,64,68,139,76,63
28139000303,271,21,248,206,16,190,205,37,168,205,17,188,289,28,255,291,20,267,198,16,182,214,12,195,211,19,192
28139000402,168,7,161,133,11,122,134,19,115,133,17,116,209,18,190,207,5,202,122,7,115,129,6,121,129,10,119
28073000016,1705,283,1400,1190,239,951,1196,306,874,1186,241,945,1826,380,1393,1830,329,1486,1195,263,932,1292,212,1032,1312,236,1076
28073000009,1087,468,576,710,317,393,709,361,342,711,301,410,1235,667,543,1232,617,590,776,374,402,822,354,453,838,367,471
28111000501,295,25,268,231,28,203,236,40,189,235,30,205,301,43,249,303,35,262,191,16,175,195,18,174,205,18,187
28111000504,505,72,429,387,62,325,394,65,320,387,55,332,548,74,458,547,61,483,336,49,287,370,47,314,377,58,319
28111000505,89,16,66,54,11,43,54,15,38,52,8,44,74,19,54,75,17,58,57,10,47,60,12,47,59,9,50
28081000205,2061,319,1706,1436,316,1120,1449,420,1016,1449,315,1134,2265,544,1677,2279,458,1792,1419,324,1095,1512,277,1186,1499,284,1215
28081000202,1228,205,997,395,79,316,393,115,273,397,89,308,1550,334,1179,1560,290,1249,967,217,750,967,172,762,965,189,776
28047000204,2019,789,1162,1266,572,694,1271,593,665,1267,544,723,2394,1131,1193,2394,1033,1317,1432,664,768,1574,636,918,1569,675,894
28047000210,2925,621,2235,2156,609,1547,2166,652,1480,2164,590,1574,3715,1140,2458,3721,1020,2657,2245,675,1570,2529,654,1819,2509,717,1792
28047000410,1386,752,585,787,502,285,788,500,278,784,478,306,1560,1006,509,1560,940,591,943,647,296,1008,610,380,1009,647,362
28047000409,2256,1268,930,1567,986,581,1576,1000,551,1565,947,618,2879,1849,963,2870,1722,1097,1845,1225,620,1907,1147,730,1907,1174,733
28127000104,271,182,85,206,147,59,211,157,48,198,132,66,261,180,80,264,170,88,211,162,49,198,132,59,200,142,58
28081000509,127,16,105,111,20,91,112,22,89,111,18,93,151,26,119,151,21,125,99,18,81,106,13,90,104,16,88
28081000106,316,20,292,253,26,227,254,40,212,252,19,233,358,38,311,359,32,323,223,21,202,244,18,218,242,23,219
28143000007,465,243,216,338,155,183,356,177,168,337,147,190,454,251,192,445,238,201,354,194,160,363,152,198,376,188,188
28127000103,703,568,127,545,438,107,550,451,96,534,399,135,718,576,141,714,557,145,575,485,90,526,414,111,551,451,100
28139000503,188,21,166,159,24,135,162,35,126,159,23,136,232,25,202,231,16,214,131,17,114,142,12,128,138,15,123
28059000403,1549,423,1056,1176,451,725,1174,473,679,1166,391,775,1585,538,1007,1594,479,1074,1252,476,776,1365,460,878,1359,496,863
28059000307,912,168,717,597,140,457,604,164,427,596,114,482,896,243,638,901,209,676,626,136,490,744,142,581,741,163,578
28059000205,1186,745,420,813,496,317,821,506,307,804,460,344,1176,755,409,1169,722,440,922,596,326,945,576,359,947,583,364
28059205-1B,0,0,0,0,0,0,0,0,0,0,0,0,0,0,0,0,0,0,0,0,0,0,0,0,0,0,0
280590113-1,871,98,758,492,78,414,495,80,412,491,70,421,873,167,688,884,130,748,552,98,454,640,89,534,641,128,513
28059113-1B,2,0,2,1,0,1,1,0,1,1,0,1,6,1,5,6,1,5,1,0,1,1,0,1,1,0,1
28059202-1A,104,102,2,67,65,2,67,65,2,63,61,2,106,103,3,103,100,3,82,81,1,75,73,2,78,76,2
28059000202,1621,1549,52,1026,994,32,1029,996,26,997,935,62,1601,1544,52,1588,1515,56,1248,1228,20,1174,1098,57,1203,1159,44
28047000110,897,347,518,514,219,295,519,225,281,514,195,319,1012,492,484,1011,458,524,602,280,322,658,263,378,649,276,373
28047000310,1899,480,1360,1307,434,873,1317,464,839,1318,376,942,2203,731,1369,2198,656,1493,1403,473,930,1591,453,1108,1570,481,1089
28047000508,1515,142,1332,1144,185,959,1143,205,928,1149,164,985,1826,263,1516,1831,207,1604,1123,149,974,1279,157,1103,1273,187,1086
28045000019,1158,205,914,747,188,559,757,234,517,756,192,564,1369,358,967,1380,299,1051,815,211,604,952,227,706,926,230,696
28081000112,1103,95,994,906,117,789,907,167,732,911,105,806,1452,188,1225,1467,129,1320,825,88,737,868,71,766,863,104,759
28081000506,360,62,292,281,62,219,285,81,201,281,52,229,399,74,312,403,62,336,294,56,238,284,49,225,285,50,235
28081000502,229,19,204,186,25,161,187,32,155,186,21,165,276,34,238,278,24,254,177,20,157,163,15,145,164,20,144
28127000303,281,27,254,252,31,221,253,47,201,250,24,226,295,44,248,294,40,251,199,25,174,214,16,194,219,24,195
28127000302,867,141,703,703,155,548,706,206,480,706,132,574,905,187,697,906,168,725,652,142,510,674,126,531,691,148,543
28127000105,126,93,29,94,71,23,96,73,22,91,60,31,131,97,33,130,92,35,112,85,27,98,69,27,99,74,25
28145000401,433,54,374,330,39,291,328,71,252,330,45,285,477,61,403,479,46,432,311,30,281,328,35,280,324,45,279
28139000507,174,18,153,152,27,125,155,36,116,152,25,127,235,46,187,236,31,203,133,24,109,150,14,133,148,26,122
28139000304,142,4,135,115,9,106,115,14,101,115,7,108,151,12,137,150,9,140,112,4,108,113,2,111,117,4,113
28111000103,387,296,88,350,274,76,353,294,56,330,239,91,476,380,92,475,361,106,338,288,50,288,206,73,317,247,70
28111000503,195,56,135,134,39,95,139,53,86,135,40,95,174,58,112,174,52,120,131,45,86,120,30,82,129,41,88
28081000404,679,279,391,558,245,313,563,267,293,560,236,324,789,364,411,789,323,455,559,262,297,537,211,315,543,229,314
28041000503,120,42,76,88,28,60,90,31,53,88,31,57,124,39,82,126,36,89,73,28,45,92,29,60,91,29,62
28047000306,574,59,507,377,48,329,378,69,304,378,56,322,666,85,559,668,59,608,379,53,326,464,60,395,452,78,374
28047000506,2038,304,1672,1607,359,1248,1619,413,1178,1615,328,1287,2816,672,2044,2822,575,2193,1595,316,1279,1796,341,1421,1779,373,1406
28047000201,876,92,763,532,92,440,536,98,434,536,78,458,1075,176,871,1084,124,945,554,84,470,667,91,560,660,111,549
28111000402,235,74,158,214,67,147,221,75,144,214,57,157,281,90,184,278,87,190,186,69,117,184,56,126,184,65,119
28083000008,2627,656,1894,1904,466,1438,1912,800,1094,1909,448,1461,2675,865,1788,2680,807,1845,2231,652,1579,2228,541,1658,2258,603,1655
28051000201,408,285,121,358,241,117,358,235,120,349,198,151,429,293,128,431,284,143,369,270,99,294,174,114,310,204,106
28109000367,920,84,807,587,83,504,590,126,443,588,92,496,960,150,770,970,116,832,540,83,457,697,85,593,689,97,592
28109000340,839,61,766,528,61,467,533,68,455,533,59,474,880,105,744,894,66,822,496,39,457,583,46,505,594,49,545
28081000507,413,111,297,348,105,243,351,122,227,347,105,242,481,144,327,480,136,339,342,108,234,323,92,221,331,109,222
28081000109,487,70,407,441,74,367,436,153,280,444,56,388,553,115,426,551,113,430,452,85,367,463,63,397,461,71,390
28073000021,216,11,204,174,11,163,174,11,160,174,11,163,272,20,243,274,12,262,167,9,158,174,8,164,174,13,161
28051000104,603,439,158,467,342,125,470,339,125,459,298,161,607,472,131,606,457,142,501,392,109,369,263,103,393,288,105
28051000202,368,320,44,267,232,35,271,236,35,264,213,51,356,320,35,358,311,43,310,276,34,244,204,37,256,222,34
28051000103,238,212,23,197,180,17,197,185,12,191,157,34,240,220,20,238,207,26,216,200,16,165,146,18,172,157,15
28051000503,377,203,171,318,179,139,324,201,121,309,161,148,382,227,154,385,217,159,329,193,136,259,126,129,273,148,125
28051000304,547,473,67,385,338,47,390,340,45,381,298,83,524,458,60,523,446,68,459,415,44,355,288,57,376,334,42
28051000101,954,843,101,742,636,106,755,660,88,711,545,166,944,829,113,950,817,124,760,689,71,584,493,81,605,526,79
28051000402,1177,1045,124,964,828,136,973,854,110,932,731,201,1197,1072,123,1193,1033,140,1025,931,94,721,611,92,745,661,84
28047000408,652,512,128,432,342,90,438,337,93,435,327,108,756,603,141,754,574,171,517,434,83,494,386,100,495,394,101
28047000402,812,540,245,472,342,130,478,350,120,474,330,144,873,630,218,869,604,251,580,424,156,602,403,189,608,418,190
28047000209,1573,210,1310,1161,201,960,1159,273,853,1161,193,968,1725,381,1294,1725,318,1384,1218,211,1007,1319,212,1085,1310,234,1076
28047000304,971,298,656,732,268,464,735,289,444,734,253,481,1182,431,721,1182,402,767,795,291,504,873,296,567,868,295,573
28047000411,1041,1011,26,696,681,15,702,670,18,696,660,36,1116,1081,31,1106,1048,40,894,881,13,846,805,34,850,813,37
28047000406,719,602,108,481,419,62,489,425,58,480,403,77,744,651,89,744,626,107,569,513,56,557,476,76,565,493,72
28093000502,804,331,469,555,202,353,559,222,332,543,197,346,827,324,491,831,298,531,554,235,319,589,201,371,586,223,363
28093000201,703,544,145,370,254,116,372,272,91,354,243,111,731,565,157,733,537,179,494,400,94,529,376,142,537,402,135
28081000303,1255,1087,156,877,777,100,909,809,96,883,740,143,1326,1194,122,1318,1147,152,1052,958,94,896,748,137,906,791,115
28005000303,81,12,68,55,11,44,56,15,41,56,12,44,74,16,57,76,16,60,60,12,48,64,10,53,63,10,53
28157000502,383,149,229,318,145,173,324,147,171,320,143,177,363,144,210,373,143,225,250,118,132,277,116,153,273,120,153
28081000503,550,303,235,422,249,173,432,271,158,425,242,183,565,340,221,563,319,237,448,272,176,384,212,164,393,228,165
28127000504,647,80,557,502,82,420,501,104,384,499,64,435,646,97,539,645,83,557,449,75,374,450,67,368,465,76,389
28045000008,1017,265,705,740,244,496,747,281,459,734,248,486,1148,418,710,1151,364,771,743,285,458,855,326,517,830,296,534
28045000007,1027,254,745,688,218,470,701,248,435,695,202,493,1197,408,752,1204,332,842,686,224,462,823,309,506,794,284,510
28091000022,977,703,260,720,533,187,724,546,170,711,505,206,976,705,262,963,674,279,759,574,185,735,507,215,742,525,217
28091000002,1245,104,1123,983,99,884,972,158,805,984,86,898,1303,197,1093,1300,157,1135,929,90,839,989,80,895,1002,101,901
28091000017,444,19,423,360,21,339,359,40,313,360,28,332,488,39,441,495,30,462,327,15,312,346,15,321,350,21,329
28047000213,1212,316,869,864,276,588,867,300,549,866,252,614,1621,574,1005,1624,518,1079,920,311,609,1005,287,705,995,304,691
28047000504,1074,252,776,767,237,530,767,275,484,767,220,547,1164,404,725,1167,364,783,805,242,563,891,234,635,887,250,637
28047000313,393,53,323,250,41,209,251,46,201,251,32,219,402,74,313,404,55,344,260,36,224,293,41,242,293,45,248
28081000208,461,146,307,374,140,234,379,165,211,377,142,235,530,214,308,534,201,327,399,160,239,411,128,274,413,138,275
28081000204,1190,174,983,972,163,809,976,218,745,972,142,830,1398,253,1110,1405,219,1154,973,170,803,986,152,800,989,169,820
28093000505,508,217,278,341,136,205,347,161,184,337,138,199,539,252,281,542,234,301,384,184,200,411,175,232,415,185,230
28127000201,254,132,117,209,109,100,212,114,96,207,94,113,245,127,118,246,122,120,192,106,86,195,93,97,207,109,98
28127000102,407,308,96,315,237,78,319,244,75,311,204,107,429,319,107,427,303,115,367,281,86,325,235,89,338,248,90
28127000304,600,54,540,474,62,412,480,83,383,478,65,413,519,64,448,520,53,465,437,58,379,438,48,380,448,56,392
28047000214,1500,288,1164,1115,249,866,1120,315,790,1123,231,892,1673,420,1215,1677,396,1255,1177,265,912,1282,244,1023,1278,266,1012
28109000420,671,81,567,311,40,271,315,38,274,315,39,276,669,138,501,679,107,560,337,56,281,424,65,342,406,83,323
28069000101,690,449,239,572,372,200,581,394,181,558,340,218,704,455,241,704,454,242,504,355,149,485,300,181,474,290,184
28079000101,393,14,375,317,21,296,321,37,283,317,22,295,425,26,397,425,20,404,284,13,271,300,16,280,302,17,285
28079000304,331,283,43,225,185,40,232,198,33,221,176,45,359,297,60,360,286,70,276,242,34,234,189,43,257,218,39
28079000402,472,117,350,386,94,292,389,106,278,378,73,305,537,128,403,534,111,418,360,90,270,316,68,240,332,75,257
28079000403,398,226,169,311,155,156,314,177,136,307,146,161,414,217,195,409,203,200,315,176,139,267,128,134,279,138,141
28079000404,466,83,376,391,79,312,392,109,281,394,76,318,534,111,418,536,97,431,370,85,285,337,62,268,348,69,279
28079000504,428,93,328,347,67,280,348,87,259,344,67,277,462,104,354,464,95,368,337,85,252,315,62,251,324,79,245
28073000003,551,114,427,361,78,283,358,94,261,362,74,288,621,153,458,622,130,485,395,111,284,436,90,330,451,96,355
28057000302,417,33,379,322,38,284,325,70,247,324,34,290,460,54,396,462,36,420,278,23,255,287,26,255,293,30,263
28057000303,348,124,218,281,117,164,283,127,154,279,103,176,406,144,261,410,131,274,276,113,163,266,86,173,270,97,173
28021000502,442,402,39,401,339,62,405,357,47,390,297,93,475,413,60,465,394,60,386,343,43,326,257,57,354,295,59
28079000502,737,556,177,563,419,144,575,449,121,551,386,165,735,566,166,736,545,186,597,477,120,525,369,142,555,428,127
28079000501,313,193,117,256,158,98,252,165,87,251,150,101,347,212,133,343,201,140,240,169,71,234,143,84,252,168,84
28079000503,342,25,314,237,38,199,241,46,193,240,34,206,352,60,290,351,54,295,240,26,214,234,18,211,242,27,215
28109000270,1249,150,1068,688,90,598,691,120,564,692,98,594,1391,267,1062,1421,225,1174,801,138,663,927,125,784,916,145,771
28109000390,781,69,697,545,57,488,551,79,463,547,67,480,890,101,761,896,67,819,529,61,468,599,66,514,610,61,549
28053000204,130,116,13,161,149,12,165,154,11,158,130,28,160,148,11,157,144,12,223,212,11,177,153,18,192,176,16
28057000102,564,59,499,423,55,368,435,66,365,425,35,390,604,71,521,615,42,564,343,30,313,350,30,318,345,37,308
28057000205,324,28,290,245,30,215,247,41,204,245,25,220,345,38,302,348,31,315,224,25,199,229,18,206,230,25,205
28081000104,651,154,487,484,136,348,487,171,310,489,133,356,742,224,489,747,196,538,445,139,306,470,108,348,472,137,335
28099000304,454,25,425,352,25,327,352,40,302,352,45,307,514,63,435,517,50,464,324,21,303,362,17,340,361,29,332
28083000014,574,565,7,341,334,7,349,320,10,319,298,21,593,586,6,596,570,16,415,412,3,381,350,20,407,398,9
28021000301,839,682,152,671,547,124,676,557,111,668,482,186,846,700,138,841,678,149,688,568,120,628,451,155,654,512,142
28021000403,0,0,0,0,0,0,0,0,0,0,0,0,0,0,0,0,0,0,0,0,0,0,0,0,0,0,0
28109000110,337,209,122,242,151,91,246,152,86,242,149,93,356,216,135,356,204,149,237,168,69,248,156,84,242,159,83
28053000201,561,416,142,431,302,129,435,313,121,425,288,137,625,463,156,624,441,173,484,360,124,448,306,129,460,343,117
28099000504,331,3,324,225,14,211,227,18,206,228,23,205,362,20,332,368,7,360,197,4,193,220,6,207,228,15,213
28005000104,367,61,303,286,56,230,291,66,223,284,59,225,404,65,335,405,60,345,262,51,211,287,47,236,282,53,229
28005000202,355,244,109,230,176,54,231,172,56,228,160,68,333,224,105,332,208,113,228,175,53,237,159,71,231,167,64
28083000004,224,96,125,133,47,86,139,60,76,132,45,87,187,85,102,191,80,108,157,63,94,155,60,94,163,71,92
28079000303,351,196,153,280,160,120,280,161,116,276,152,124,372,223,146,372,208,160,293,178,115,266,137,125,280,152,128
28019000006,277,99,174,188,57,131,195,67,127,189,56,133,271,91,176,271,85,184,213,85,128,208,66,134,218,75,143
28079000102,614,134,474,528,125,403,528,156,367,525,118,407,661,192,463,661,180,474,474,111,363,497,102,385,513,118,395
28007000503,270,22,246,202,22,180,204,33,168,203,22,181,272,36,228,274,32,241,187,18,169,188,14,173,189,21,168
28007000502,238,69,167,187,55,132,190,60,130,184,42,142,284,88,190,289,83,202,186,56,130,186,44,136,199,58,141
28087000504,717,607,101,430,352,78,436,366,61,418,334,84,674,578,93,674,566,98,534,472,62,509,402,101,518,426,92
28007000202,273,61,203,199,60,139,202,71,129,199,49,150,273,73,193,273,63,205,196,58,138,214,58,155,212,58,154
28099000407,331,46,284,234,47,187,234,61,172,236,45,191,378,73,294,383,65,316,221,38,183,241,26,203,238,29,209
28083000005,121,33,87,80,20,60,80,28,52,80,22,58,131,36,92,131,33,98,91,29,62,91,20,70,90,28,62
28005000302,619,488,124,442,356,86,448,363,79,438,345,93,577,448,122,586,453,130,435,347,88,446,342,87,435,318,117
28005000304,225,7,218,193,15,178,197,11,183,195,14,181,250,15,234,252,9,242,163,4,159,197,6,182,192,12,180
28157000101,390,240,150,314,193,121,318,194,120,316,186,130,351,216,130,355,223,130,247,158,89,253,139,110,243,134,109
28157000102,467,387,74,372,298,74,380,289,70,364,281,83,468,372,83,478,389,75,328,266,62,326,242,75,317,233,84
28059000511,121,3,114,79,4,75,80,3,77,80,3,77,139,8,129,138,7,129,72,5,67,92,5,79,93,6,87
28019000001,216,82,128,173,68,105,173,68,102,167,64,103,233,102,126,231,92,138,164,68,96,168,58,109,171,69,102
28079000202,370,256,111,332,229,103,337,242,91,336,219,117,410,290,116,412,287,121,312,233,79,259,169,81,287,203,84
28019000004,317,262,53,210,168,42,214,178,34,210,166,44,303,249,49,302,249,47,254,218,36,230,177,49,233,194,39
28059409-1a,900,226,648,734,260,474,745,279,449,738,234,504,1198,446,720,1208,394,795,773,280,493,856,260,571,855,288,567
280590406-1,2306,576,1651,1222,353,869,1232,354,840,1214,307,907,2231,722,1433,2243,611,1590,1270,377,893,1426,377,1015,1421,413,1008
28059406-1b,30,8,21,22,8,14,21,8,13,24,8,16,92,35,54,93,31,60,24,8,16,28,8,20,26,9,17
280590409-1,1030,260,739,851,304,547,851,320,516,848,272,576,1777,660,1063,1788,579,1171,896,323,573,981,302,659,980,333,647
28059406-1C,94,23,67,49,13,36,48,13,33,50,13,37,105,34,68,106,29,76,50,14,36,55,14,41,54,14,40
28059409-1c,200,50,142,161,58,103,164,62,100,162,52,110,249,91,150,248,81,164,170,62,108,187,58,126,191,66,125
28069000201,410,262,144,335,221,114,344,232,109,331,205,126,390,264,123,391,257,131,296,201,95,290,181,103,282,168,114
28035000301,1910,270,1593,1414,237,1177,1427,315,1091,1417,252,1165,2169,421,1680,2182,375,1784,1388,263,1125,1471,215,1215,1503,246,1257
28035000206,406,398,5,252,233,19,260,250,8,233,203,30,399,388,8,401,382,14,327,321,6,263,243,18,296,291,5
28035000205,654,605,39,451,419,32,456,430,22,432,384,48,662,618,39,663,603,47,543,512,31,463,405,40,483,448,35
28083000006,222,130,90,145,84,61,162,102,58,147,74,73,210,129,81,208,119,85,172,109,63,160,81,74,170,104,66
28007000101,690,287,391,458,210,248,463,240,215,451,196,255,727,360,353,725,323,386,494,246,248,496,197,289,502,220,282
28007000404,310,208,98,207,134,73,210,140,70,198,112,86,364,261,101,366,246,115,252,174,78,227,132,88,245,161,84
28083000007,414,380,24,108,96,12,108,94,12,107,92,15,276,256,19,276,249,19,229,214,15,206,179,23,208,183,25
28007000305,514,199,308,342,125,217,343,143,196,340,117,223,482,200,272,488,182,301,371,161,210,360,125,229,369,142,227
28007000306,129,51,76,87,32,55,89,38,50,88,30,58,210,87,120,206,78,127,93,41,52,91,32,58,92,36,56
28007000303,219,82,134,159,72,87,162,84,78,159,70,89,219,91,127,220,83,133,174,77,97,167,66,99,172,70,102
28007000301,210,9,195,151,10,141,156,22,134,151,14,137,206,13,192,208,8,200,143,8,135,143,6,134,149,11,138
28057000407,361,32,326,258,22,236,259,38,213,260,20,240,431,50,373,431,34,392,233,17,216,253,12,237,254,20,234
28071000202,3485,1580,1743,2949,1399,1550,2995,1806,1152,2991,1738,1253,4520,2304,2148,4538,2182,2283,2860,1567,1293,3104,1448,1607,3070,1570,1500
28149000203,1080,854,212,745,599,146,754,620,128,737,534,203,1168,938,219,1167,916,234,878,748,130,842,634,187,883,716,167
28005000102,558,143,406,416,113,303,415,136,274,416,121,295,561,150,403,558,134,419,412,124,288,455,111,332,452,126,326
28081000302,3672,723,2868,3047,718,2329,3045,1009,2020,3057,689,2368,4109,1155,2874,4123,1021,3042,3002,732,2270,3065,604,2403,3059,679,2380
28081000501,619,113,500,491,106,385,489,139,343,491,115,376,711,140,554,718,120,595,442,90,352,436,71,356,433,88,345
28099000402,537,29,503,423,25,398,426,52,372,425,46,379,578,49,513,580,32,541,348,16,332,402,19,379,408,33,375
28099000201,430,21,402,320,24,296,317,41,273,321,39,282,441,30,399,446,23,418,284,15,269,301,20,279,311,22,289
28083000016,1280,1063,213,935,790,145,955,800,133,909,726,183,1249,1083,165,1247,1054,179,1038,900,138,977,786,172,1031,876,155
28007000402,278,128,147,192,88,104,193,95,97,192,89,103,292,140,151,288,133,151,233,109,124,200,80,116,216,96,120
28007000401,276,146,128,193,105,88,196,109,87,192,93,99,300,162,134,302,154,143,213,124,89,199,94,105,200,110,90
28071000301,395,51,336,305,56,249,309,48,253,299,53,246,472,71,380,484,43,436,253,31,222,310,25,283,312,38,274
28071000302,983,558,410,728,425,303,741,454,278,717,439,278,995,587,393,995,563,425,737,454,283,754,421,319,749,448,301
28045000023,738,52,674,461,60,401,467,78,381,461,67,394,928,141,761,933,75,847,415,37,378,500,64,431,500,47,453
28109000130,448,73,369,288,60,228,293,66,223,292,74,218,496,108,371,502,81,413,268,61,207,310,70,232,302,61,241
28109000227,948,92,825,658,79,579,664,119,529,659,84,575,1011,161,810,1020,117,885,638,88,550,725,83,619,725,98,627
28109000250,244,21,218,185,14,171,186,14,171,185,15,170,284,26,252,288,22,265,168,12,156,187,13,173,188,19,169
28109000269,440,20,405,270,20,250,271,25,241,271,23,248,427,42,378,427,27,395,230,31,199,260,29,221,265,37,228
28109000240,622,47,561,374,27,347,373,42,324,375,33,342,677,72,583,685,54,624,375,39,336,446,50,383,435,50,385
28109000550,2490,278,2160,1515,197,1318,1533,249,1262,1529,219,1310,2812,486,2252,2871,393,2445,1574,229,1345,1886,241,1609,1816,267,1549
28093000205,887,264,604,537,157,380,542,163,376,526,145,381,951,308,629,969,278,677,655,234,421,701,195,495,680,248,432
28071000502,509,105,380,418,122,296,425,163,254,425,159,266,653,195,442,657,165,478,390,121,269,419,111,299,412,123,289
28093000504,305,45,257,234,27,207,235,39,196,232,32,200,317,48,266,319,42,276,232,37,195,231,20,210,234,32,202
28143000009,256,157,88,224,149,75,231,146,79,219,134,85,276,170,99,277,163,108,201,133,68,191,101,81,199,119,80
28005000205,319,185,131,222,128,94,224,128,92,217,126,91,338,195,141,338,192,141,235,145,90,242,136,99,229,126,103
28101000204,703,39,657,556,46,510,556,66,486,556,50,506,748,50,681,756,39,713,504,33,471,535,30,490,539,46,493
28101000104,746,665,67,557,509,48,560,503,45,559,487,72,776,715,57,781,696,74,598,560,38,540,473,65,561,504,57
28033000511,604,95,498,436,86,350,442,115,325,439,86,353,855,175,655,862,153,689,421,91,330,502,82,402,491,89,402
28137000201,1040,269,745,728,209,519,741,250,478,725,206,519,1217,404,788,1222,342,855,751,272,479,841,234,580,850,254,596
28071000401,392,99,285,343,95,248,350,121,227,347,138,209,482,152,320,484,133,343,331,100,231,355,92,257,348,108,240
28033000204,2970,858,2014,1494,530,964,1508,566,922,1501,507,994,3010,1327,1608,3003,1212,1738,1798,772,1026,2157,743,1357,2134,772,1362
28033000303,1358,691,625,679,369,310,680,369,303,676,355,321,1522,907,568,1527,847,639,851,547,304,962,523,418,944,536,408
28033000402,1144,672,438,480,291,189,484,300,173,478,275,203,1114,756,338,1119,711,388,650,470,180,782,500,261,770,476,294
28033000507,2677,654,1917,1591,338,1253,1595,489,1077,1593,344,1249,3347,902,2355,3342,785,2497,1754,548,1206,2073,471,1538,2063,519,1544
28033000206,2267,491,1716,1419,401,1018,1439,475,951,1426,378,1048,3031,1012,1957,3034,952,2047,1595,484,1111,1941,461,1443,1917,511,1406
28069000406,335,191,144,312,158,154,316,189,123,305,165,140,367,209,155,368,204,161,275,164,111,265,127,134,277,150,127
28069000403,167,136,29,138,111,27,143,117,26,135,105,30,164,137,26,163,129,29,146,124,22,135,107,26,124,97,27
28109000440,1163,915,225,657,549,108,662,553,104,661,543,118,1245,1002,216,1250,978,249,770,657,113,850,688,150,822,654,168
28109000140,1021,507,492,579,290,289,580,305,267,578,297,281,1055,539,485,1084,512,563,613,353,260,675,347,315,666,337,329
28109000210,572,51,509,341,34,307,342,47,288,341,36,305,655,98,527,665,64,588,314,36,278,400,39,352,396,56,340
28021000201,626,543,80,502,419,83,520,441,75,502,375,127,649,553,92,639,520,106,486,425,61,451,341,92,474,385,89
28021000101,737,627,105,602,505,97,612,529,81,590,425,165,723,635,87,719,613,93,620,535,85,584,440,118,621,528,93
28057000204,741,55,675,586,65,521,584,96,482,586,42,544,794,84,687,804,59,735,506,48,458,532,39,478,527,55,472
28033000306,414,135,269,221,73,148,220,84,133,218,72,146,521,169,339,521,157,361,256,103,153,307,94,203,301,103,198
28033000108,805,278,514,510,189,321,519,195,317,513,173,340,943,415,516,946,372,550,550,228,322,676,216,453,660,226,434
28033000305,1794,717,1027,974,383,591,980,416,547,968,380,588,1909,970,906,1907,893,969,1139,572,567,1364,572,760,1340,600,740
28033000302,1562,714,802,846,413,433,853,435,406,850,408,442,1704,1040,637,1703,959,703,1013,595,418,1166,599,534,1155,616,539
28057000401,1067,121,930,781,132,649,778,195,570,779,114,665,1150,213,912,1156,162,979,728,108,620,760,87,650,768,121,647
28093000301,1366,534,810,773,309,464,787,324,458,756,278,478,1366,578,759,1383,532,842,908,415,493,998,374,599,992,428,564
28155000304,214,35,175,190,37,153,190,53,132,191,35,156,243,47,191,244,41,201,155,31,124,162,25,134,166,32,134
28095000304,1334,254,1059,1007,213,794,1012,265,737,999,189,810,1410,312,1071,1416,270,1129,921,202,719,986,164,803,990,203,787
28095000201,199,10,188,156,11,145,155,17,136,154,10,144,244,21,213,245,12,229,144,10,134,156,4,148,154,9,145
28049000119,859,836,15,672,660,12,674,663,7,671,577,94,899,891,7,899,876,13,772,762,10,759,733,21,764,749,15
28049000118,1360,1310,37,1198,1160,38,1203,1173,24,1193,1022,171,1419,1387,28,1423,1373,38,1324,1306,18,1293,1225,59,1306,1273,33
28043000304,332,213,115,277,220,57,288,224,57,274,211,63,408,324,82,401,304,88,247,173,74,242,147,92,249,166,83
28043000403,147,95,51,79,11,68,78,15,63,78,5,73,116,17,98,116,12,104,109,78,31,102,64,38,106,71,35
28049000523,623,322,294,494,266,228,494,281,211,494,242,252,688,360,324,693,349,334,515,293,222,529,267,254,537,276,261
28049000419,1738,737,971,1359,722,637,1357,757,592,1361,639,722,1835,980,841,1843,962,873,1408,744,664,1410,675,708,1414,705,709
28037000502,282,31,244,252,33,219,255,43,205,252,45,207,307,40,262,310,37,272,211,26,185,214,23,173,218,24,194
28063000008,264,236,25,220,197,23,224,199,20,217,172,45,270,247,23,270,244,20,216,199,17,191,155,32,207,183,24
28115000205,359,36,311,262,39,223,260,48,210,261,38,223,391,41,343,392,23,364,253,27,226,274,34,228,273,30,243
28147000203,65,6,55,40,3,37,40,7,33,40,2,38,59,15,41,59,11,47,42,7,35,47,6,38,47,8,39
28147000304,11,0,11,7,0,7,7,0,7,7,0,7,11,2,9,11,2,9,8,1,7,8,0,8,7,0,7
28123000503,427,49,373,334,43,291,334,83,248,332,45,287,435,88,335,432,74,355,352,56,296,347,42,303,354,47,307
28123000202,274,33,240,202,29,173,201,47,151,203,37,166,278,39,237,277,31,242,188,20,168,194,18,176,202,26,176
28085000506,579,222,354,442,201,241,444,221,215,440,175,265,632,292,336,626,281,341,463,196,267,459,168,285,474,182,292
28085000106,407,375,29,268,247,21,272,252,18,270,229,41,420,393,24,419,380,32,341,325,16,290,255,31,303,275,28
28085000104,208,15,191,166,12,154,166,26,140,167,13,154,227,12,214,227,14,210,164,8,156,166,13,152,168,9,159
28089000107,2779,859,1852,2197,880,1317,2195,1062,1111,2194,824,1370,3158,1327,1775,3166,1288,1832,2289,946,1343,1288,492,772,1296,526,770
28089000997,427,239,180,325,217,108,323,223,99,322,197,125,411,277,131,409,267,139,317,215,102,294,187,105,290,192,98
28015000108,668,438,221,469,303,166,472,309,157,467,285,182,696,463,222,688,439,238,497,349,148,546,336,204,560,382,178
28015000105,367,134,230,308,108,200,312,120,191,306,107,199,432,161,266,429,156,271,305,127,178,310,106,200,317,120,197
28153000204,407,66,333,298,69,229,300,79,214,296,69,227,443,100,337,441,77,355,259,60,199,280,48,221,301,57,244
28085000206,845,251,583,658,220,438,661,260,395,660,202,458,972,307,656,975,301,663,739,232,507,718,217,484,741,219,522
28063000003,311,259,50,279,237,42,284,249,32,273,215,58,312,268,43,311,251,54,265,226,39,268,197,57,280,227,53
28063000001,322,177,140,238,132,106,242,147,93,231,112,119,297,169,126,294,159,133,246,133,113,224,97,121,240,120,120
28025000202,304,179,119,223,143,80,223,155,67,219,128,91,325,206,113,323,192,126,253,171,82,244,140,98,245,152,93
28025000301,799,294,501,596,229,367,604,243,359,590,209,381,856,338,506,849,310,520,622,252,370,623,226,389,626,234,392
28013000010,363,74,286,316,69,247,317,111,204,315,77,238,370,77,290,369,63,303,278,63,215,281,46,229,280,61,219
28015000110,268,67,198,219,64,155,222,76,145,215,58,157,287,92,192,287,74,213,201,60,141,191,47,141,201,63,138
28147000202,298,163,134,204,113,91,208,119,85,199,100,99,295,162,127,293,158,133,224,134,90,212,104,102,212,111,101
28147000406,101,55,45,68,38,30,67,39,27,68,35,33,113,62,50,118,59,53,73,44,29,71,35,35,69,37,32
28037000403,325,60,259,267,50,217,271,70,195,266,57,209,343,60,276,342,57,282,244,49,195,242,47,191,245,46,199
28115000101,218,27,186,154,34,120,156,38,116,153,33,120,233,47,181,235,39,192,139,22,117,140,15,119,140,20,120
28043000202,500,68,425,379,71,308,383,93,288,380,78,302,541,96,433,544,70,471,366,57,309,368,41,321,373,58,315
28037000503,248,56,187,193,37,156,194,51,141,190,33,157,249,55,191,250,56,192,181,43,138,184,37,143,188,44,144
28037000401,359,43,311,301,32,269,306,60,243,300,50,250,363,41,317,366,31,329,263,36,227,269,26,237,276,32,244
28017000113,609,122,472,512,116,396,517,220,295,511,126,385,663,166,489,663,143,511,481,111,370,512,90,417,519,118,401
28075000515,446,66,372,347,66,281,348,75,265,349,81,268,489,84,390,496,86,408,314,48,266,349,47,300,356,53,303
28025000504,363,288,71,252,205,47,254,214,38,237,172,65,354,288,64,351,267,75,281,235,46,252,179,67,259,203,56
28037000202,356,178,175,332,166,166,338,185,143,329,156,173,409,206,198,408,193,207,304,165,139,289,133,148,299,153,146
28039000401,720,78,624,389,59,330,394,78,312,387,55,332,761,135,608,765,96,661,426,67,359,550,71,459,528,91,437
28129000501,606,210,386,540,194,346,550,278,266,528,198,330,684,264,402,683,251,422,480,204,276,484,160,311,504,178,326
28129000102,196,15,181,190,20,170,190,36,151,189,24,165,199,21,172,199,17,181,150,15,135,146,14,129,153,13,140
28155000403,424,119,297,327,81,246,328,89,237,323,76,247,469,129,330,467,115,342,307,95,212,316,70,246,321,82,239
28121000310,789,619,160,579,479,100,583,483,94,579,441,138,841,694,141,839,663,170,662,566,96,646,497,139,652,524,128
28015000114,579,268,305,389,173,216,395,199,190,385,167,218,583,289,288,579,260,310,433,217,216,419,173,233,426,202,224
28121000401,529,44,480,416,57,359,414,69,339,416,52,364,580,70,492,579,63,512,400,44,356,427,38,380,429,40,389
28103000501,1087,805,276,659,472,187,667,489,173,643,440,203,1042,777,259,1043,757,269,790,589,201,770,506,254,783,531,252
28103000302,1158,987,168,682,560,122,694,585,106,665,528,137,1206,1047,153,1215,1033,168,870,752,118,811,644,160,831,681,150
28123000403,233,10,220,185,16,169,184,27,157,183,19,164,233,17,214,231,13,216,187,12,175,188,9,176,193,9,184
28039000204,377,21,351,208,9,199,209,13,194,208,14,194,416,36,368,434,16,412,222,15,207,285,13,269,263,34,229
28107000304,805,238,557,705,241,464,720,260,455,710,255,455,872,285,571,881,245,622,587,222,365,610,185,415,607,211,396
28133000201,594,408,183,400,269,131,404,291,111,401,263,138,704,519,182,706,501,195,498,350,148,493,294,187,517,337,180
28115000103,273,27,238,221,32,189,222,45,175,220,39,181,304,38,262,306,29,269,215,29,186,219,24,185,220,26,194
28115000102,506,51,442,396,45,351,400,81,314,393,51,342,629,75,536,633,64,561,365,41,324,405,36,346,409,46,363
28085000306,799,121,663,625,113,512,626,178,443,627,96,531,853,162,678,856,163,682,680,107,573,682,99,580,697,97,600
28085000502,867,135,722,633,147,486,630,194,426,629,120,509,1011,193,812,1005,182,813,711,127,584,698,111,579,727,124,603
28151000202,1551,1212,312,1131,912,219,1145,949,183,1117,856,261,1724,1432,282,1711,1391,287,1313,1087,226,1322,1027,279,1357,1100,257
28153000503,251,8,241,188,15,173,192,23,166,190,14,176,273,15,255,270,7,263,151,8,143,186,5,178,189,5,184
28153000403,607,83,520,459,70,389,463,91,367,461,85,376,650,95,541,653,79,568,424,58,366,458,62,390,465,63,402
28119000402,359,277,74,250,180,70,277,202,70,252,168,84,347,274,69,341,242,93,267,217,50,244,169,71,249,185,64
28119000501,354,298,52,267,209,58,291,243,38,263,203,60,345,291,47,349,287,57,260,222,38,235,168,59,246,210,36
28153000203,538,335,202,447,259,188,451,283,159,442,248,194,573,352,217,576,344,225,461,299,162,434,259,166,441,272,169
28121000505,1483,365,1082,1117,305,812,1114,385,715,1124,296,828,1762,519,1201,1769,476,1278,1164,355,809,1261,327,911,1267,350,917
28121000110,963,352,591,643,287,356,644,313,316,643,262,381,1057,471,564,1061,446,593,665,318,347,695,286,396,700,301,399
28121000502,1000,115,862,768,113,655,757,187,560,768,114,654,1054,184,848,1046,159,877,780,114,666,824,105,706,822,107,715
28089000501,127,61,66,84,39,45,84,40,44,83,32,51,100,48,51,99,46,53,94,50,44,92,40,50,96,46,50
28135000202,41,25,16,25,15,10,29,16,13,26,16,10,45,27,18,46,26,19,24,14,10,32,15,17,32,23,9
28003000302,699,124,559,519,118,401,523,130,391,516,120,396,749,178,553,756,126,623,450,112,338,445,73,365,444,83,361
28115000404,615,267,335,477,224,253,480,236,241,468,207,261,672,309,351,675,283,381,486,227,259,458,174,271,465,193,272
28029000302,775,303,465,592,241,351,598,268,324,589,217,372,849,323,520,849,315,526,683,276,407,684,246,423,702,265,437
28029000403,1615,1145,455,1160,799,361,1172,868,300,1139,736,403,1414,983,425,1408,967,430,1308,971,337,1195,772,390,1252,854,398
28039000101,1194,65,1109,596,41,555,601,72,522,593,67,526,1293,155,1109,1305,74,1222,638,50,588,818,59,737,804,87,717
28039000102,308,21,279,154,18,136,158,27,130,155,21,134,352,53,296,356,31,320,185,29,156,222,24,191,216,34,182
28163000103,299,106,189,251,103,148,257,113,144,246,76,170,315,132,178,316,113,201,234,100,134,202,70,125,217,85,132
28163000205,345,82,257,262,66,196,268,81,181,261,64,197,353,107,242,356,102,254,244,70,174,240,56,181,249,64,185
28097000201,463,185,277,324,132,192,326,143,180,319,122,197,481,219,257,484,192,288,320,144,176,348,133,209,349,139,210
28003000504,1223,317,885,923,235,688,934,318,608,930,243,687,1307,440,843,1310,372,919,856,282,574,936,247,672,922,266,656
28065000024,415,226,188,307,177,130,312,181,130,307,155,152,427,240,180,429,235,188,330,201,129,299,164,132,309,179,130
28163000110,468,258,203,361,201,160,372,213,155,358,184,174,469,270,193,471,256,206,387,241,146,316,158,153,380,222,158
28163000107,372,54,315,311,62,249,316,77,237,307,60,247,411,77,331,411,71,337,302,61,241,282,46,231,304,57,247
28097000503,176,64,109,119,54,65,122,62,60,118,50,68,184,95,86,184,85,98,123,55,68,125,48,75,124,54,70
28091000021,388,222,156,301,174,127,302,179,117,299,172,127,394,231,158,395,215,177,316,198,118,297,169,125,306,177,129
28097000401,500,227,260,390,172,218,397,194,195,381,166,215,461,221,235,465,209,251,361,165,196,373,144,219,383,171,212
28163000202,447,239,202,331,202,129,338,212,121,323,170,153,408,256,148,408,247,154,326,207,119,291,160,125,315,194,121
28029000201,354,127,226,257,95,162,257,105,151,248,77,171,371,145,223,373,141,230,279,110,169,268,87,173,276,99,177
28113000105,363,299,63,263,221,42,266,230,35,256,202,54,369,311,54,363,303,58,277,232,45,266,198,62,266,201,65
28031000009,361,270,89,303,223,80,308,246,58,292,182,110,379,295,80,371,284,82,282,224,58,267,195,67,272,208,64
28113000301,367,219,145,286,178,108,291,185,105,280,159,121,401,246,152,402,233,164,285,184,101,271,157,112,281,172,109
28031000014,164,8,155,142,7,135,143,20,116,141,10,131,178,10,165,177,7,170,123,4,119,143,3,135,147,6,141
28163000404,177,25,151,121,55,66,124,63,61,121,51,70,185,98,85,186,96,89,121,63,58,104,47,55,115,55,60
28163000506,1195,1169,21,836,799,37,868,828,30,814,721,93,1083,1043,35,1076,999,57,774,766,8,561,515,29,636,625,11
28003000102,931,133,772,739,121,618,752,159,584,743,130,613,1062,217,827,1062,182,857,641,120,521,716,104,597,696,121,575
28077000013,128,23,104,104,18,86,103,16,85,102,16,86,128,19,107,129,15,111,83,9,74,83,4,75,87,8,79
28075000210,644,210,422,472,167,305,476,178,294,471,158,313,689,262,414,693,249,438,468,163,305,516,152,357,517,165,352
28075000510,133,44,89,102,36,66,101,40,61,101,35,66,111,42,69,114,40,74,101,35,66,109,33,76,110,37,73
28077000023,545,243,298,453,231,222,455,244,203,447,211,236,579,279,297,578,269,299,467,227,240,422,183,235,448,202,246
28075000206,815,283,522,598,191,407,600,210,381,600,188,412,944,375,559,952,360,585,599,207,392,643,199,434,639,201,438
28075000211,176,61,115,129,41,88,134,47,85,130,41,89,161,64,95,157,58,99,133,47,86,138,42,95,140,44,96
28075000103,697,156,524,508,134,374,509,150,351,510,133,377,706,193,494,713,190,513,495,147,348,561,135,418,559,139,420
28113000204,867,506,346,632,374,258,636,392,243,622,353,269,863,560,293,863,527,325,660,425,235,642,378,256,641,375,266
28039000302,330,21,304,174,15,159,175,19,156,174,17,157,358,44,302,357,17,335,195,17,178,247,18,218,239,24,215
28039000104,266,14,246,138,10,128,139,24,115,137,20,117,272,48,216,273,27,242,151,19,132,173,17,148,170,28,142
28039000505,169,3,161,122,9,113,123,17,105,121,11,110,189,15,168,196,3,192,128,3,125,140,1,136,137,8,129
28113000404,707,374,320,598,311,287,609,347,253,595,308,287,742,423,311,747,409,329,569,327,242,565,271,278,579,290,289
28113000101,632,580,45,456,424,32,461,421,31,450,399,51,668,627,37,668,604,49,492,463,29,454,401,45,458,413,45
28113000406,898,161,722,797,162,635,798,213,581,796,145,651,976,226,733,977,219,750,746,154,592,779,141,633,779,149,630
28075000408,99,25,71,63,17,46,65,20,44,62,15,47,77,24,52,81,21,56,61,18,43,69,16,51,65,16,49
28065000056,297,253,44,223,180,43,227,190,35,220,159,61,296,247,48,298,242,51,251,220,31,229,189,37,248,209,39
28129000502,258,66,190,211,59,152,213,67,143,214,54,160,289,90,197,289,86,202,199,55,144,190,45,139,197,52,145
28129000303,510,33,472,473,39,434,475,82,374,473,57,416,613,53,549,614,37,569,369,27,342,380,25,338,393,20,373
28001000201,743,161,572,544,150,394,547,163,378,544,139,405,734,222,503,734,206,521,526,142,384,573,140,425,573,148,425
28015000112,218,147,71,144,93,51,146,96,49,143,85,58,231,163,67,229,157,72,180,130,50,165,105,56,176,123,53
28143000003,293,272,17,203,188,15,211,188,20,197,171,26,306,281,23,307,277,27,236,222,14,214,182,28,223,203,20
28111000301,1163,143,1006,929,123,806,936,186,727,927,132,795,1293,220,1031,1296,167,1115,783,114,669,820,95,698,844,110,734
28001000501,920,868,47,676,644,32,685,644,35,669,601,68,874,831,38,874,821,50,736,703,33,705,660,40,711,661,50
28001000204,656,99,548,471,78,393,479,79,392,468,74,394,628,105,513,627,96,525,450,76,374,487,77,398,495,78,417
28001000405,445,323,117,356,277,79,359,279,78,355,266,89,463,362,99,463,352,106,374,291,83,369,280,87,365,274,91
28059000509,259,12,232,184,15,169,185,13,169,185,12,173,309,24,271,310,20,285,200,10,190,209,11,185,215,12,203
28011000504,154,125,27,121,93,28,123,96,26,118,80,38,171,142,29,172,140,31,144,121,23,132,105,27,139,104,35
28011000102,264,201,61,197,154,43,207,169,37,198,147,51,253,206,47,244,194,50,232,192,40,211,149,57,224,169,55
28001000403,442,350,87,345,285,60,350,281,64,337,257,80,452,369,80,451,362,84,379,322,57,360,299,61,361,301,60
28047000401,421,361,52,307,262,45,307,253,43,305,250,55,440,383,53,437,368,66,333,298,35,321,273,43,322,277,45
28011000103,292,227,63,224,178,46,227,172,45,214,163,51,298,243,54,298,228,65,214,181,33,215,161,52,222,178,44
28031000004,677,37,629,522,41,481,524,71,447,522,41,481,799,68,718,804,50,746,492,34,458,534,24,499,541,31,510
28011000108,245,233,11,173,162,11,180,167,12,166,153,13,236,224,11,235,218,14,205,196,9,187,169,15,207,191,16
28011000303,1048,968,71,716,664,52,739,674,52,706,627,79,964,895,66,962,867,83,854,814,40,765,684,67,818,757,61
28007000203,134,11,120,88,13,75,90,13,74,88,9,79,151,22,127,151,18,132,92,9,83,99,10,87,101,13,88
28099000403,453,167,280,379,161,218,380,175,203,379,168,211,486,192,283,488,174,311,340,139,201,315,118,188,319,134,185
28083000015,293,236,56,230,193,37,232,193,34,223,172,51,319,270,48,312,249,59,240,199,41,232,181,48,245,204,41
28099000103,320,9,306,244,14,230,244,35,207,245,26,219,370,22,338,371,14,353,209,5,204,246,8,237,250,14,236
28007000102,1080,314,751,779,248,531,787,302,470,772,228,544,1114,365,740,1112,332,768,800,274,526,803,234,548,832,266,566
28099000204,278,41,232,222,46,176,223,58,161,222,52,170,316,67,247,318,56,259,203,35,168,234,43,187,231,54,177
28081000105,415,21,388,300,18,282,302,30,266,304,12,292,489,47,424,490,35,452,283,13,270,311,19,285,311,28,283
28045000017,502,43,449,309,42,267,312,51,258,308,41,267,587,85,487,596,65,528,295,34,261,363,42,317,360,50,310
28069000303,144,37,103,109,25,84,110,26,80,107,25,82,146,27,116,147,25,122,97,25,72,106,23,82,102,23,79
28047000510,1889,496,1333,1325,381,944,1331,446,869,1327,364,963,2018,652,1289,2016,574,1399,1411,461,950,1533,422,1075,1525,470,1055
28047000205,276,59,205,261,80,181,261,90,168,263,67,196,399,129,255,402,123,271,272,84,188,284,75,204,279,73,206
28047000207,753,216,501,536,179,357,540,186,336,537,164,373,888,347,504,895,313,559,548,202,346,595,189,394,590,209,381
28059000408,226,16,205,146,15,131,146,18,122,146,11,135,271,36,226,274,22,248,160,20,140,178,15,160,170,26,144
28059307-1a,11,2,9,8,2,6,7,2,5,8,2,6,45,12,32,45,11,33,8,2,6,8,2,6,10,2,8
28059000314,79,15,62,51,13,38,49,14,35,50,11,39,99,28,70,100,24,75,55,13,42,64,13,50,62,14,48
28005000024,203,30,172,146,23,123,149,24,122,146,19,127,219,25,194,217,21,194,136,20,116,152,17,131,153,18,135
28035000304,1982,250,1691,1590,251,1339,1599,393,1176,1602,241,1361,2489,496,1927,2494,412,2032,1510,283,1227,1671,266,1371,1679,272,1407
28035000305,1162,176,945,826,179,647,828,244,562,825,183,642,1326,368,901,1335,295,1000,783,181,602,907,163,713,927,187,740
28035000110,451,131,308,418,140,278,413,179,233,420,127,293,565,201,352,565,196,359,395,161,234,410,132,263,420,152,268
28093000204,513,212,290,360,130,230,370,144,225,347,121,226,586,234,348,588,226,356,403,159,244,419,153,262,406,154,252
28137000101,1771,459,1278,1375,432,943,1392,563,814,1375,451,924,2028,729,1275,2041,675,1331,1339,484,855,1419,384,1003,1423,415,1008
28087000404,798,653,134,573,467,106,579,481,97,569,450,119,837,667,165,839,648,179,664,540,124,608,448,150,625,487,138
28087000505,652,282,342,461,202,259,462,264,195,462,198,264,670,349,305,667,334,318,488,257,231,540,251,277,538,258,280
28071000402,533,361,155,427,284,143,432,319,104,422,305,117,620,426,186,624,411,202,445,336,109,466,306,155,472,327,145
28071000405,484,60,409,398,81,317,406,92,306,402,121,281,574,113,450,581,93,486,367,77,290,395,63,324,382,76,306
28071000504,271,35,229,239,46,193,241,66,173,240,73,167,315,50,256,314,39,273,203,34,169,218,29,187,214,38,176
28071000403,278,90,184,218,75,143,217,90,122,219,88,131,307,90,211,307,87,217,222,83,139,228,69,159,228,90,138
28145000202,563,36,517,470,51,419,478,112,363,477,61,416,627,60,540,632,34,589,373,34,339,400,19,373,402,29,373
28073000022,743,20,719,511,19,492,516,45,466,513,34,479,835,59,759,845,34,804,498,19,479,527,22,491,537,30,507
28053000102,828,663,155,494,380,114,503,396,103,493,342,151,724,587,131,725,561,150,647,536,111,612,446,148,626,486,140
28149000302,1130,897,212,721,573,148,728,597,123,713,466,247,1140,925,198,1135,902,221,865,722,143,817,591,211,864,677,187
28149000503,508,193,300,377,146,231,380,171,209,376,130,246,525,229,287,526,210,305,398,168,230,427,153,270,431,180,251
28081000101,652,329,313,487,259,228,500,308,189,487,257,230,688,357,327,688,335,345,564,323,241,536,264,262,535,275,260
28081000511,932,556,358,715,455,260,736,492,236,711,411,300,989,654,323,984,626,341,783,522,261,704,402,281,719,439,280
28049000301,274,259,12,190,186,4,191,186,5,189,167,22,288,279,8,285,271,12,217,214,3,209,197,9,214,204,10
28049000406,1127,617,468,845,519,326,852,561,277,849,474,375,1278,836,417,1280,803,454,913,591,322,941,546,376,945,561,384
28049000403,1760,759,954,1353,673,680,1358,748,593,1361,598,763,1788,966,791,1797,939,828,1420,731,689,1350,648,679,1350,661,689
28049000509,411,392,18,208,198,10,211,201,7,208,175,33,378,357,16,378,354,18,287,280,7,267,242,17,268,249,19
28049000225,431,364,61,344,308,36,346,314,28,343,257,86,413,372,41,411,360,46,381,340,41,345,295,47,351,307,44
28151000201,1432,703,708,1082,595,487,1105,660,434,1077,562,515,1599,951,636,1596,910,675,1145,667,478,1244,646,585,1268,720,548
28019000003,864,147,704,676,129,547,683,193,478,683,129,554,958,202,734,962,168,785,611,143,468,651,110,529,656,116,540
28095000505,864,171,684,648,167,481,655,189,459,645,146,499,920,246,661,926,210,706,611,152,459,619,134,475,626,155,471
28079000104,313,51,258,275,41,234,281,65,208,275,47,228,362,83,273,363,66,296,243,50,193,246,37,203,257,50,207
28105000304,564,265,289,440,207,233,449,232,212,438,203,235,598,307,280,599,293,300,462,242,220,463,193,257,479,225,254
28149000404,494,139,347,362,115,247,364,116,246,350,95,255,552,206,339,557,194,356,361,122,239,382,110,268,391,131,260
28035000203,897,628,253,725,509,216,730,535,187,726,463,263,1003,742,250,1000,712,279,760,571,189,739,508,216,759,551,208
28011000104,320,237,81,181,112,69,194,130,61,174,103,71,280,195,83,277,189,83,233,174,59,201,120,68,227,158,69
28033000104,1649,690,914,955,431,524,959,449,496,959,417,542,1766,888,850,1770,837,905,1150,577,573,1273,534,712,1251,538,713
28149000501,888,358,516,660,280,380,665,310,351,659,224,435,1016,474,529,1014,459,536,714,324,390,729,261,456,747,313,434
28149000206,255,36,216,202,24,178,201,31,165,198,16,182,263,33,230,266,30,234,200,29,171,213,27,184,220,32,188
28009000102,777,475,299,429,221,208,437,203,226,415,185,230,820,468,344,819,424,387,530,336,194,528,288,231,520,285,235
28057000202,636,39,593,473,42,431,472,81,383,471,31,440,708,63,633,713,33,670,432,21,411,420,26,383,412,28,384
28149000505,697,409,277,526,293,233,527,302,215,520,254,266,802,465,332,805,457,343,581,346,235,560,282,268,581,319,262
28149000555,425,248,171,328,220,108,328,232,93,321,192,129,482,324,151,482,316,161,350,246,104,335,214,114,342,235,107
28053000203,45,6,39,41,7,34,43,11,31,42,6,36,53,15,38,53,15,38,43,6,37,39,5,34,39,5,34
28033000401,698,467,210,280,196,84,283,199,78,282,191,91,806,623,165,811,585,196,446,346,100,478,315,147,463,315,148
28035000504,818,529,247,434,289,145,444,328,109,438,270,168,859,657,191,858,617,219,528,406,122,565,379,166,562,386,176
28035000202,685,149,523,562,142,420,568,190,372,566,148,418,763,215,538,763,197,561,521,144,377,585,141,435,591,153,438
28033000105,2522,550,1880,1339,358,981,1350,411,921,1344,345,999,2639,922,1644,2645,793,1796,1512,477,1035,1907,470,1377,1854,495,1359
28033000304,1148,557,561,488,266,222,489,262,212,484,251,233,1144,738,369,1146,664,457,621,396,225,756,395,341,733,405,328
28045000013,208,69,136,110,37,73,118,45,71,115,33,82,271,121,144,272,94,174,122,56,66,139,70,66,134,58,76
28137000504,1359,419,921,1006,307,699,1017,351,646,998,297,701,1604,493,1078,1617,422,1175,973,337,636,997,265,713,1008,300,708
28009000103,850,366,469,517,195,322,534,225,306,521,194,327,870,397,451,872,353,506,528,246,282,596,230,353,584,252,332
28105000401,3404,1159,2092,2609,910,1699,2642,1162,1455,2640,895,1745,4018,1657,2306,4018,1585,2338,2791,1117,1674,3005,1032,1929,2999,1097,1902
28105000103,631,175,429,500,137,363,500,163,328,498,138,360,713,210,491,712,181,515,490,153,337,512,123,377,525,150,375
28035000404,1567,1475,72,971,922,49,990,951,30,955,831,124,1604,1539,51,1587,1465,90,1242,1215,27,1091,988,74,1165,1113,52
28033000501,2232,572,1576,1245,404,841,1255,493,751,1251,417,834,2727,1028,1630,2733,931,1759,1441,552,889,1762,524,1185,1739,532,1207
28029000203,645,87,545,420,67,353,420,128,284,417,69,348,637,101,526,644,93,538,478,70,408,495,60,416,510,69,441
28033000404,1971,880,1032,847,384,463,851,414,425,850,382,468,2092,1191,862,2094,1099,944,1133,654,479,1360,658,676,1334,673,661
28033000403,1655,478,1118,914,283,631,927,306,608,921,277,644,1784,694,1056,1781,644,1106,1109,411,698,1302,412,872,1275,425,850
28131000403,482,83,383,337,100,237,340,106,229,337,85,252,593,166,406,591,137,441,355,102,253,361,85,271,368,95,273
28131000303,411,33,365,289,51,238,293,48,240,290,44,246,457,67,378,463,45,409,284,39,245,298,31,261,295,42,253
28131000203,682,493,182,542,399,143,546,408,134,529,370,159,796,572,218,798,550,234,550,424,126,538,361,158,554,392,162
28137000502,254,66,184,188,46,142,193,58,129,189,47,142,273,72,195,280,57,222,149,42,107,168,41,124,169,43,126
28093000203,380,212,163,235,127,108,238,139,97,223,121,102,388,217,162,393,211,179,269,165,104,280,140,134,281,161,120
28033000505,2619,577,1971,1626,409,1217,1629,512,1105,1609,424,1185,3332,1032,2241,3330,916,2367,1777,539,1238,2131,504,1581,2099,533,1566
28135000305,153,14,131,147,16,131,151,21,123,145,25,120,182,25,156,182,18,163,129,11,118,132,9,117,131,15,116
28085000205,306,113,191,237,76,161,237,97,136,234,82,152,348,143,200,348,142,202,264,105,159,260,85,169,260,90,170
28049000510,247,244,2,153,148,5,153,152,1,153,134,19,221,219,1,222,216,3,214,214,0,181,169,7,186,182,4
28049000104,669,454,195,566,416,150,568,449,117,566,359,207,781,614,160,778,596,173,622,464,158,624,447,172,627,454,173
28049000409,2262,1297,930,1733,1136,597,1740,1181,548,1734,1025,709,2455,1596,845,2457,1559,869,1959,1269,690,1940,1165,744,1952,1219,733
28013000006,572,142,420,404,122,282,406,163,240,402,112,290,566,160,390,570,138,428,364,106,258,358,84,268,370,105,265
28049000402,1998,650,1290,1588,655,933,1593,798,775,1595,585,1010,2219,951,1226,2224,930,1256,1643,685,958,1654,612,1012,1657,644,1013
28049000113,1282,419,803,1058,449,609,1052,587,455,1058,381,677,1379,695,662,1372,673,678,1074,466,608,1158,444,695,1155,471,684
28095000502,303,200,99,230,153,77,231,153,78,226,132,94,326,220,101,323,208,111,245,169,76,234,139,94,247,155,92
28135000101,296,57,234,248,64,184,250,70,177,248,73,175,313,76,233,313,61,250,196,38,158,214,38,170,215,44,171
28085000505,430,87,342,313,59,254,311,84,224,310,56,254,495,96,391,497,91,404,351,79,272,363,67,290,377,78,299
28085000301,234,80,150,192,68,124,192,105,83,192,71,121,280,105,169,274,109,161,221,85,136,222,75,143,224,78,146
28049000310,531,472,50,347,311,36,347,319,25,343,282,61,530,489,38,529,475,47,404,376,28,382,327,50,384,342,42
28049000215,405,401,2,286,282,4,287,284,2,286,249,37,370,369,1,369,367,1,331,330,1,309,288,14,312,305,7
28085000304,479,21,450,363,29,334,365,45,315,364,27,337,565,25,535,567,25,541,376,16,360,373,12,352,391,18,373
28017000116,247,128,118,187,99,88,192,125,67,179,92,87,254,137,115,257,129,123,198,106,92,178,79,96,179,88,91
28029000205,404,88,312,320,89,231,321,116,203,317,99,218,440,106,330,437,103,327,329,86,243,332,71,255,340,82,258
28147000303,364,106,256,254,72,182,256,95,161,252,66,186,356,123,232,358,114,239,276,89,187,284,74,207,290,86,204
28147000205,100,29,71,72,20,52,72,26,46,71,19,52,84,29,55,83,27,56,78,25,53,79,21,58,79,23,56
28067000409,904,55,827,716,59,657,716,107,584,715,67,648,969,91,855,970,68,895,636,44,592,712,48,632,731,42,689
28067000401,59,0,59,50,2,48,49,3,46,50,2,48,62,3,58,61,1,60,41,0,41,42,0,42,44,0,44
28121000302,707,157,533,497,152,345,501,174,313,501,123,378,724,238,468,734,226,496,513,154,359,578,146,419,578,155,423
28123000204,266,129,131,212,101,111,214,109,102,206,92,114,314,165,140,309,163,144,200,105,95,199,93,99,202,100,102
28133000501,136,73,62,98,53,45,100,59,41,97,53,44,136,74,59,136,72,64,119,69,50,109,57,52,114,62,52
28121000410,246,82,161,207,69,138,208,75,129,207,66,141,287,88,193,288,85,199,216,75,141,232,77,151,234,79,155
28123000504,506,130,366,367,100,267,368,132,232,366,108,258,532,151,375,534,137,394,370,113,257,363,89,270,372,105,267
28123000303,278,28,247,213,40,173,215,58,155,212,49,163,295,53,234,294,43,248,209,39,170,212,35,172,215,37,178
28147000404,343,33,306,239,25,214,241,44,193,238,27,211,314,33,275,316,27,286,211,18,193,243,24,214,244,19,225
28123000501,369,12,354,269,15,254,270,27,242,269,16,253,434,29,397,435,20,414,271,17,254,286,14,268,286,17,269
28147000502,671,468,193,436,316,120,441,330,104,428,293,135,776,569,200,775,551,218,529,419,110,495,361,125,510,377,133
28039000502,268,15,245,154,18,136,157,29,123,154,19,135,306,63,234,308,37,266,143,17,126,185,20,159,185,23,162
28067000407,484,22,455,449,32,417,452,62,379,451,41,410,738,62,650,739,44,690,330,18,312,372,12,341,378,15,363
28067000207,440,37,394,333,35,298,334,55,275,333,42,291,446,48,388,446,37,405,296,28,268,351,26,310,352,28,324
28141000404,233,12,219,203,20,183,206,35,168,205,22,183,232,24,204,232,14,216,156,9,147,175,6,166,171,11,160
28121000205,799,162,603,595,163,432,598,242,347,599,154,445,889,276,587,894,253,620,595,177,418,653,151,478,654,175,479
28089000405,919,902,11,646,633,13,652,639,11,645,590,55,1003,984,13,999,974,21,793,787,6,706,666,24,727,714,13
28089000508,431,423,6,267,258,9,267,260,4,262,238,24,406,400,5,408,394,10,329,327,2,298,278,12,304,299,5
28023000404,131,74,55,112,55,57,114,60,52,113,59,54,149,77,70,149,76,72,98,57,41,104,52,50,111,61,50
28017000101,467,121,339,371,121,250,374,208,161,368,123,245,463,147,305,463,121,337,293,109,184,301,81,214,309,97,212
28135000304,185,43,141,146,49,97,148,54,94,145,49,96,215,61,152,211,49,162,124,33,91,119,26,92,120,36,84
28135000303,193,59,130,145,52,93,149,58,89,143,53,90,185,69,115,187,61,125,132,48,84,125,36,87,125,47,78
28095000402,137,23,113,119,26,93,120,29,89,120,25,95,149,36,111,147,31,115,120,25,95,122,23,99,121,20,101
28107000303,675,102,567,590,95,495,602,135,462,595,116,479,739,142,584,746,113,624,479,90,389,535,89,437,538,105,433
28133000102,474,469,3,258,253,5,259,255,2,254,243,11,476,470,5,475,464,9,346,345,1,346,319,17,367,351,16
28121000201,2438,580,1780,1644,496,1148,1644,677,949,1650,450,1200,2545,852,1632,2560,807,1711,1769,575,1194,1937,521,1368,1943,563,1380
28015000104,444,71,368,316,48,268,324,87,234,316,45,271,439,81,347,436,68,364,310,57,253,332,49,271,341,65,276
28133000404,102,15,86,80,10,70,80,18,61,77,13,64,106,21,85,105,20,84,78,9,69,82,12,65,80,11,69
28061000203,241,151,87,177,102,75,179,109,67,177,102,75,239,141,97,241,141,99,196,120,76,197,115,79,198,115,83
28039000304,686,58,617,435,44,391,439,46,390,433,45,388,787,121,651,799,71,719,451,49,402,520,55,460,526,72,454
28153000304,277,211,64,241,180,61,243,187,51,237,181,56,322,248,73,320,244,75,250,196,54,237,171,63,237,180,57
28153000305,141,28,113,105,29,76,105,33,71,102,31,71,144,34,107,144,31,113,102,26,76,105,23,82,107,31,76
28011000505,729,684,40,469,437,32,481,439,32,458,399,59,697,662,29,699,640,46,544,525,19,527,476,41,559,524,35
28011000203,807,123,656,578,130,448,584,171,407,578,131,447,814,213,589,811,183,619,596,139,457,659,135,511,655,151,504
28003000503,83,1,82,78,13,65,80,19,61,77,17,60,84,11,73,86,2,84,56,3,53,60,6,54,58,4,54
28163000501,33,7,26,28,6,22,29,8,21,28,5,23,40,8,32,40,8,32,29,7,22,26,4,22,28,6,22
28065000033,311,105,200,215,77,138,219,85,132,212,68,144,339,117,220,341,102,237,241,98,143,231,75,148,242,84,158
28163000203,219,176,42,217,131,86,224,144,80,215,114,101,295,187,105,294,182,109,217,139,78,192,106,83,206,127,79
28093000406,459,391,67,277,227,50,282,239,41,267,221,46,536,437,98,539,426,104,350,308,42,344,282,56,354,302,52
28017000104,540,281,252,417,213,204,419,258,159,413,221,192,527,284,237,526,268,250,437,250,187,399,196,197,407,209,198
28077000003,426,33,389,337,34,303,342,58,280,336,43,293,419,34,379,421,33,385,307,19,288,313,22,285,329,17,312
28077000019,186,44,140,138,31,107,138,34,102,134,30,104,185,41,142,186,41,145,133,37,96,126,23,103,138,29,109
28017000105,667,354,306,536,310,226,547,360,186,534,299,235,757,464,284,757,436,305,578,356,222,495,249,241,516,284,232
28075000201,1192,1041,138,785,668,117,789,671,104,782,625,157,1280,1143,133,1273,1114,152,880,789,91,891,739,143,890,738,152
28077000002,142,6,132,107,2,105,109,11,95,109,6,103,137,5,132,138,3,135,114,5,109,105,11,90,113,8,105
28017000112,546,47,485,453,80,373,445,145,297,450,85,365,606,96,495,607,76,526,375,42,333,396,43,349,396,55,341
28001000203,766,285,468,642,239,403,651,266,379,643,225,418,814,332,471,819,318,496,620,257,363,644,234,398,647,245,402
28075000506,675,46,622,478,52,426,478,85,385,483,57,426,736,73,651,735,60,673,464,39,425,527,40,482,527,52,475
28075000507,454,30,415,322,36,286,324,58,259,322,38,284,487,50,428,490,38,443,308,24,284,355,27,321,350,36,314
28145000503,1109,282,789,824,205,619,834,307,517,824,205,619,1133,362,738,1135,311,793,776,227,549,800,190,596,813,234,579
28143000014,424,295,127,239,139,100,245,146,93,233,140,93,409,273,132,409,258,144,306,202,104,299,170,118,296,178,118
28145000407,724,121,591,584,117,467,592,186,397,589,107,482,823,154,652,826,135,685,519,102,417,515,71,435,523,91,432
28017000114,332,79,248,272,85,187,272,119,152,268,72,196,327,80,238,328,74,242,248,68,180,257,52,202,254,60,194
28157000201,489,389,98,405,315,90,407,307,79,392,302,90,496,372,111,499,383,112,311,250,61,297,225,71,291,218,73
28139000105,246,100,145,205,76,129,209,68,129,206,69,137,287,126,154,290,108,178,188,93,95,190,67,120,193,76,117
28047000206,635,231,385,451,183,268,455,209,232,454,173,281,677,328,326,681,297,373,489,211,278,524,200,318,524,216,308
28081000402,379,174,202,303,143,160,303,153,146,302,132,170,408,184,214,412,179,228,312,160,152,286,120,158,291,128,163
28139000104,507,59,443,455,72,383,464,112,344,458,85,373,601,97,486,608,39,563,298,42,256,346,37,305,343,59,284
28139000305,473,57,406,352,34,318,362,73,284,355,37,318,472,70,387,475,53,418,324,44,280,363,37,316,362,60,302
28047000211,2274,681,1528,1624,640,984,1628,653,949,1621,582,1039,2838,1172,1591,2843,1078,1724,1724,706,1018,1978,687,1248,1967,731,1236
28127000204,235,116,119,213,109,104,213,118,94,210,104,106,259,128,128,256,122,131,205,104,101,202,89,109,212,103,109
28127000207,102,50,52,95,49,46,91,51,40,96,47,49,113,56,56,112,53,58,89,46,43,90,39,49,90,44,46
28127000206,191,93,96,170,88,82,172,95,74,167,83,84,199,98,99,203,95,103,160,82,78,162,72,85,166,80,86
28127000301,406,78,325,338,67,271,343,79,263,335,65,270,433,96,331,438,89,347,325,75,250,331,60,259,338,70,268
28127000405,317,215,99,265,182,83,267,187,78,260,167,93,342,226,116,337,215,117,271,192,79,238,151,82,253,166,87
28143000005,96,12,82,64,10,54,66,12,54,63,9,54,85,16,67,85,13,72,54,9,45,63,5,58,60,9,51
28073000007,2221,291,1865,1617,283,1334,1621,435,1165,1622,292,1330,2599,597,1944,2601,545,2021,1720,324,1396,1879,299,1546,1887,312,1575
28047000202,1479,232,1215,1094,245,849,1093,264,814,1091,228,863,1874,433,1387,1883,373,1486,1131,241,890,1276,245,1004,1268,263,1005
28047000407,676,646,21,383,370,13,386,368,11,384,359,25,615,588,22,612,572,31,470,461,9,469,438,26,468,443,25
28091000020,180,174,6,136,130,6,140,135,4,134,119,15,165,160,5,163,152,9,152,150,2,130,114,8,134,132,2
28093000402,517,288,224,257,133,124,264,144,118,251,123,128,598,325,269,602,297,294,363,235,128,391,219,162,383,226,157
28005000402,250,62,185,173,51,122,174,62,111,170,45,125,243,66,173,247,62,182,185,56,129,201,53,138,197,48,149
28047000301,1149,438,677,882,390,492,882,427,449,877,366,511,1404,576,789,1404,548,842,914,419,495,982,407,555,973,408,565
28045000012,475,88,375,332,71,261,333,93,236,331,67,264,540,139,385,552,118,431,326,81,245,375,99,274,356,99,257
28083000013,260,186,72,162,106,56,172,121,47,159,103,56,225,170,52,226,167,58,189,136,53,194,131,56,196,145,51
28045000027,641,50,572,400,36,364,402,41,358,397,34,363,785,125,639,800,79,710,415,46,369,483,48,419,489,52,437
28091000003,261,9,250,207,8,199,206,15,189,206,16,190,275,17,250,273,12,260,185,4,181,197,12,182,202,7,195
28091000004,755,392,351,623,345,278,633,374,253,627,355,272,890,509,373,892,487,391,595,349,246,586,310,265,597,315,282
28093000407,201,105,94,146,73,73,146,77,68,144,71,73,199,99,99,200,89,105,159,90,69,163,80,81,163,87,76
28081000113,975,83,875,735,87,648,737,120,610,739,72,667,1106,152,918,1115,124,979,701,81,620,731,75,643,724,101,623
28047000305,866,133,710,619,126,493,621,125,485,620,115,505,1085,196,854,1093,154,930,620,112,508,685,108,566,684,126,558
28057000206,364,26,330,290,40,250,294,54,237,293,29,264,465,57,395,465,32,430,258,27,231,268,29,234,269,37,232
28057000104,204,22,179,159,23,136,160,25,130,157,24,133,220,36,176,220,23,191,144,20,124,157,19,133,155,21,134
28021000302,39,12,27,33,14,19,33,17,16,32,12,20,34,17,17,34,16,18,34,17,17,36,14,21,36,18,18
28057000404,166,13,153,114,7,107,114,18,95,116,8,108,177,11,162,178,7,169,118,10,108,124,9,112,127,12,115
28021000401,95,80,15,80,27,53,81,27,52,80,18,62,100,28,70,101,30,70,77,19,58,74,14,60,78,15,63
28099000102,60,43,12,29,22,7,29,19,10,29,20,9,78,64,12,79,64,12,43,34,9,39,23,13,40,22,18
28059000309,370,65,300,270,52,218,269,67,199,266,40,226,401,96,295,402,76,318,275,57,218,326,65,254,326,78,248
28059000407,2176,276,1824,1388,271,1117,1389,295,1066,1383,241,1142,2328,510,1732,2349,407,1903,1483,271,1212,1612,250,1329,1603,306,1297
28005000403,372,135,236,264,101,163,266,104,161,263,95,168,372,137,230,373,131,238,278,121,157,284,105,175,284,110,174
28045000010,557,226,309,415,178,237,420,206,208,416,173,243,612,298,303,614,264,335,418,211,207,493,254,231,483,235,248
28045000028,186,55,123,142,50,92,143,58,84,138,43,95,211,71,140,213,60,148,141,47,94,166,60,105,159,50,109
28101000303,416,128,284,343,100,243,346,119,212,346,106,240,462,161,288,467,147,309,324,118,206,321,84,224,330,101,229
28099000305,441,32,404,330,28,302,329,47,277,329,43,286,482,40,432,488,36,451,327,31,296,349,24,321,349,31,318
28005000101,255,69,182,179,58,121,184,60,117,178,51,127,242,83,155,244,78,164,155,47,108,187,46,129,178,46,132
28069000502,314,191,122,283,186,97,293,203,86,280,179,101,326,216,107,323,206,110,247,155,92,228,130,97,236,135,101
28007000403,752,514,232,558,371,187,561,386,173,546,326,220,793,541,245,786,519,262,639,451,188,576,352,213,600,402,198
28099000205,60,32,25,36,22,14,36,22,13,36,20,16,81,53,27,82,53,27,44,31,13,39,26,13,40,24,16
28045000006,795,262,504,526,160,366,531,186,337,524,156,368,999,379,595,1003,308,675,521,202,319,600,219,373,579,220,359
28033000107,1795,650,1059,776,334,442,784,339,430,774,318,456,1828,853,916,1824,757,1031,1008,515,493,1227,490,699,1212,516,696
28033000109,1459,720,699,771,428,343,782,433,342,776,400,376,1718,1060,615,1715,1001,682,982,591,391,1135,583,528,1100,582,518
28137000103,257,16,235,200,15,185,203,39,161,202,21,181,319,34,278,324,22,298,171,14,157,180,12,159,185,9,176
28093000404,515,376,128,318,230,88,319,228,89,308,211,97,574,412,158,574,391,178,399,311,88,363,247,110,392,280,112
28155000201,106,10,96,81,6,75,83,10,73,82,8,74,109,8,98,108,8,100,84,6,78,90,7,83,90,9,81
28049000212,949,927,16,669,651,18,675,653,19,665,577,88,914,903,8,918,883,25,780,774,6,747,709,29,763,746,17
28049000101,719,163,525,657,154,503,660,271,385,668,127,541,939,315,616,939,290,631,682,210,472,717,171,538,719,193,526
28049000321,983,928,50,645,610,35,652,622,23,643,554,89,903,855,38,899,835,55,791,762,29,739,673,52,752,704,48
28049000319,768,719,43,532,502,30,534,508,23,526,454,72,817,775,35,814,759,45,649,629,20,598,550,38,612,578,34
28049000224,239,157,78,213,141,72,216,150,65,215,131,84,276,178,98,271,173,97,207,146,61,211,137,72,212,141,71
28049000415,791,693,94,570,510,60,572,518,48,565,460,105,782,720,59,778,704,66,667,615,52,618,540,74,626,554,72
28049000216,1228,1208,11,914,890,24,924,907,8,909,793,116,1185,1174,10,1182,1159,16,1045,1038,7,954,908,34,984,966,18
28037000101,170,67,99,149,53,96,152,60,92,149,60,89,173,61,108,173,59,111,124,44,80,113,39,74,114,39,75
28067000403,507,13,488,388,20,368,389,54,327,388,40,348,566,48,494,569,30,529,331,18,313,371,21,334,386,14,372
28027000010,213,30,181,135,29,106,138,34,102,136,30,106,211,43,167,210,29,181,151,31,120,170,25,140,167,37,130
28013000008,465,90,371,355,76,279,359,98,259,358,82,276,482,117,359,483,97,381,343,74,269,333,56,274,337,69,268
28107000203,218,69,146,189,54,135,197,62,134,191,53,138,216,72,141,217,65,150,155,52,103,160,42,116,160,47,113
28085000504,366,80,283,261,63,198,263,75,183,259,56,203,395,101,293,393,90,298,311,76,235,293,65,226,309,77,232
28085000403,526,86,433,408,85,323,407,108,294,399,81,318,642,135,500,641,132,504,429,92,337,430,78,344,441,78,363
28107000306,512,118,387,420,71,349,424,108,313,423,77,346,516,115,395,516,104,410,350,68,282,378,66,306,380,76,304
28085000503,529,62,462,381,58,323,382,91,288,379,56,323,590,84,504,594,75,518,436,57,379,435,54,377,447,57,390
28147000403,527,114,410,382,108,274,384,126,250,380,98,282,529,134,389,532,122,408,364,102,262,385,85,292,394,92,302
28147000101,232,50,182,158,36,122,161,35,124,158,33,125,236,49,184,237,47,190,161,36,125,175,27,143,174,35,139
28067000405,318,14,300,265,13,252,267,29,229,266,23,243,365,31,328,367,20,347,229,9,220,263,14,235,272,14,258
28129000203,364,325,36,296,256,40,297,259,37,291,234,57,382,339,43,380,330,49,328,297,31,296,258,34,308,270,38
28089000504,545,482,60,450,389,61,458,398,58,452,367,85,618,542,73,611,531,77,490,436,54,466,379,79,476,410,66
28121000308,1112,224,865,757,214,543,753,254,493,759,178,581,1274,407,828,1271,367,891,770,212,558,826,177,630,833,187,646
28085000201,219,83,133,153,51,102,156,56,98,151,43,108,219,78,139,218,73,141,175,70,105,162,57,104,177,68,109
28025000501,1063,745,301,733,525,208,737,537,187,724,496,228,1047,781,252,1036,747,271,867,664,203,763,513,239,770,545,225
28129000401,322,22,298,294,41,253,301,84,209,295,55,240,351,26,317,357,17,339,221,20,201,245,16,225,247,21,226
28107000106,245,153,89,204,126,78,207,125,81,205,125,80,242,159,81,240,145,93,190,127,63,198,119,76,195,118,77
28155000301,107,4,100,90,7,83,91,11,79,88,11,77,107,7,99,107,3,104,82,6,76,80,3,74,82,3,79
28089000996,136,14,118,111,12,99,111,14,97,110,11,99,152,16,133,152,13,137,98,7,91,111,8,103,110,9,101
28089000998,510,112,372,372,92,280,371,123,244,374,79,295,580,182,387,584,175,402,404,100,304,440,95,334,438,102,336
28023000103,125,42,83,94,31,63,96,35,58,91,27,64,143,52,88,142,47,93,82,34,48,97,33,62,102,43,59
28115000305,318,18,295,224,14,210,230,55,175,226,27,199,334,31,292,337,21,313,196,12,184,220,12,200,215,13,202
28003000204,493,120,363,345,65,280,351,97,249,342,72,270,475,138,326,480,110,362,337,96,241,357,81,267,347,93,254
28163000101,397,46,343,355,64,291,359,79,275,352,60,292,441,88,345,446,77,365,313,60,253,305,50,253,313,56,257
28123000502,442,221,217,299,154,145,300,162,137,295,146,149,456,240,212,456,221,227,314,178,136,294,136,154,311,151,160
28159000401,455,404,45,318,278,40,319,275,41,319,264,55,465,413,51,457,398,56,363,329,34,358,304,46,358,311,47
28163000303,340,336,4,263,253,10,269,258,8,257,221,36,331,328,3,333,313,15,283,281,2,195,174,15,222,222,0
28163000104,366,181,182,300,147,153,305,151,152,295,133,162,378,185,189,381,180,197,296,150,146,269,123,145,278,137,141
28121000404,1859,313,1496,1365,298,1067,1369,405,950,1375,246,1129,1547,368,1121,1561,342,1185,1417,292,1125,1551,268,1237,1557,297,1260
28003000402,1414,96,1304,1196,125,1071,1217,145,1058,1199,146,1053,1567,173,1361,1586,94,1481,867,66,801,997,54,920,987,84,903
28113000202,666,471,189,526,366,160,529,368,158,514,333,181,733,524,200,730,499,224,541,393,148,512,333,175,527,359,168
28113000102,296,223,65,198,153,45,202,160,41,198,146,52,300,240,52,300,235,59,228,176,52,223,159,57,225,152,73
28065000042,206,188,13,149,136,13,151,135,14,144,117,27,204,187,17,205,186,16,164,155,9,151,132,15,153,139,14
28129000201,473,134,334,368,113,255,371,136,226,367,121,246,469,142,314,464,125,332,343,123,220,352,96,246,357,111,246
28029000401,182,130,51,135,90,45,136,97,39,133,82,51,177,126,51,177,123,52,153,113,40,139,88,45,151,103,48
28089000507,652,554,89,491,431,60,496,444,52,490,412,78,744,649,89,747,629,109,554,497,57,546,458,80,563,492,71
28001000404,416,288,119,294,200,94,297,208,81,293,190,103,413,287,125,411,276,128,333,242,91,335,220,108,336,223,113
28001000202,825,338,461,641,278,363,645,318,320,643,271,372,861,410,432,864,387,466,602,285,317,646,267,363,646,282,364
28145000505,243,23,211,195,25,170,196,39,156,194,24,170,276,33,230,280,19,260,149,13,136,162,13,147,162,17,145
28145000306,610,100,492,534,106,428,532,144,383,535,109,426,701,158,525,707,135,566,453,88,365,478,84,381,480,92,388
28081000103,164,11,152,128,8,120,129,22,107,129,5,124,186,15,171,187,11,176,126,7,119,130,5,122,131,6,125
28047000212,182,9,167,113,9,104,115,18,97,115,13,102,206,17,185,207,11,196,126,13,113,137,13,122,135,12,123
28099000404,128,7,119,112,9,103,110,18,92,112,14,98,160,26,131,158,16,140,78,5,73,93,6,87,95,11,84
28099000401,172,22,146,135,21,114,137,34,100,136,30,106,197,49,145,199,33,158,112,13,99,126,16,110,125,20,105
28105000405,734,180,546,584,161,423,590,173,412,577,160,417,765,220,534,768,201,560,582,156,426,583,137,435,590,149,441
28073000012,1545,379,1098,1119,345,774,1120,437,657,1116,355,761,1822,662,1109,1819,596,1179,1165,410,755,1261,377,854,1270,399,871
28139000306,144,5,134,126,10,116,128,31,95,128,18,110,144,16,128,146,10,135,106,4,102,117,5,109,116,7,109
28005000502,309,193,111,226,155,71,228,160,68,225,146,79,305,201,99,303,193,102,234,161,73,227,151,71,221,149,72
28005000103,328,45,281,215,39,176,218,53,160,211,42,169,326,46,275,329,37,289,222,32,190,239,31,199,240,40,200
28059000507,1340,102,1202,856,100,756,866,103,746,852,97,755,1423,180,1197,1435,122,1284,885,88,797,1001,86,891,999,106,893
2805900507a,661,53,596,430,53,377,428,53,370,425,49,376,691,87,583,688,59,624,436,43,393,497,43,443,500,54,446
28059507-1B,162,12,148,106,12,94,106,12,92,107,13,94,165,20,139,166,14,149,109,11,98,123,11,110,124,14,110
28059507-1C,6,0,6,4,0,4,4,0,4,4,0,4,17,2,15,17,1,16,4,0,4,4,0,4,3,0,3
28005000501,325,149,171,246,119,127,250,123,124,242,114,128,345,157,188,347,152,194,231,109,122,238,93,138,240,97,143
28145000206,769,126,632,610,102,508,613,175,426,617,162,455,894,159,711,899,129,761,538,105,433,558,83,469,570,93,477
28083000011,390,373,13,278,265,13,286,259,12,266,237,29,345,332,11,344,329,13,287,282,5,277,250,25,305,292,13
28049000213,763,738,16,558,545,13,558,551,4,554,489,65,739,723,12,737,711,21,618,614,4,615,572,28,631,616,15
28049000302,991,973,12,741,723,18,745,730,8,740,661,79,951,934,12,956,930,15,878,871,7,805,766,21,821,808,13
28049000315,199,191,8,142,138,4,143,141,1,143,126,17,204,197,5,205,193,10,170,169,1,159,153,3,161,155,6
28049000316,366,356,4,287,273,14,289,283,4,287,256,31,382,375,4,385,368,12,337,334,3,292,272,16,297,285,12
28081000107,485,59,413,328,57,271,327,70,257,330,52,278,527,93,419,535,78,449,323,55,268,337,53,275,342,68,274
28049000116,1085,908,157,816,694,122,815,709,99,812,622,190,1259,1125,126,1263,1106,141,975,875,100,939,782,143,945,809,136
28049000417,1166,924,229,944,796,148,946,801,138,941,704,237,1214,1039,164,1213,1020,185,999,859,140,989,792,185,988,817,171
28049000410,469,426,36,276,254,22,276,258,14,274,234,40,459,436,19,459,424,29,339,323,16,317,284,25,322,290,32
28011000301,233,174,55,142,89,53,146,97,45,138,86,52,218,158,58,214,148,62,175,130,45,174,112,54,195,148,47
28057000307,149,8,140,125,12,113,124,22,102,124,18,106,168,19,143,168,19,147,101,9,92,114,13,95,111,13,98
28149000401,1071,630,427,745,464,281,749,479,266,738,401,337,1151,753,388,1154,722,422,786,515,271,807,466,334,824,507,317
28105000403,196,13,181,158,10,148,159,19,140,156,13,143,213,21,189,215,12,198,156,16,140,175,14,159,172,15,157
28045000009,537,372,156,400,295,105,400,291,104,397,287,110,671,490,173,673,462,199,453,353,100,503,383,118,489,370,119
28005000203,351,128,223,259,106,153,262,114,146,261,91,170,381,154,225,384,146,236,242,98,144,278,101,173,271,94,177
28137000505,240,84,155,179,63,116,182,76,102,170,59,111,285,98,186,283,89,191,177,76,101,176,56,116,181,58,123
28105000303,327,220,104,279,178,101,281,190,87,276,183,93,319,212,105,322,210,111,274,201,73,264,173,87,263,178,85
28041000303,314,4,302,259,14,245,260,16,241,257,21,236,351,13,333,358,11,346,187,6,181,217,5,209,211,8,203
28035000306,661,200,454,526,173,353,536,199,326,524,156,368,807,287,511,807,253,545,511,205,306,519,167,338,528,178,350
28033000301,741,167,550,421,131,290,425,135,273,422,119,303,854,331,495,859,275,552,462,156,306,539,163,358,539,167,372
28131000302,345,21,317,282,31,251,287,30,250,280,31,249,399,38,352,398,30,361,254,22,232,288,24,254,292,24,268
28091000018,341,117,222,242,78,164,241,73,163,238,78,160,361,129,226,360,119,238,259,95,164,253,84,163,259,83,176
28033000508,1119,188,906,742,128,614,749,152,586,746,118,628,1352,232,1085,1358,197,1144,765,149,616,910,130,744,905,152,753
28049000314,465,452,9,354,344,10,354,344,8,352,307,45,431,423,7,431,416,9,393,392,1,374,354,15,379,370,9
28049000318,836,799,33,617,590,27,617,597,15,608,528,80,847,822,18,857,816,25,687,672,15,631,586,31,642,616,26
28027000019,177,100,74,112,69,43,117,78,39,114,69,45,162,106,55,161,98,59,143,90,53,130,66,59,138,81,57
28049000214,445,434,4,343,328,15,346,339,5,343,285,58,450,443,6,450,435,11,389,386,3,381,353,20,388,377,11
28025000401,636,544,88,474,403,71,480,415,65,463,377,86,675,568,102,668,556,103,528,459,69,464,375,82,479,397,82
28085000305,208,38,165,171,49,122,170,51,117,169,42,127,228,50,176,232,53,178,167,41,126,171,37,129,177,41,136
28049000323,1316,1218,81,1064,999,65,1071,1013,51,1064,924,140,1430,1352,73,1425,1325,88,1221,1171,50,1161,1047,87,1172,1102,70
28029000202,371,31,336,265,30,235,262,44,214,260,20,240,421,38,381,425,30,392,281,21,260,286,15,265,304,19,285
28089000304,1044,591,426,718,444,274,725,486,232,722,392,330,1107,712,374,1107,686,405,2725,961,1764,813,464,330,819,491,328
28117000504,604,385,206,437,306,131,447,315,130,428,265,163,683,471,205,677,426,242,457,347,110,402,255,138,435,316,119
28123000103,650,549,94,431,360,71,436,370,64,425,328,97,633,539,94,632,528,96,521,460,61,463,377,78,481,407,74
28123000405,560,106,450,429,93,336,428,115,306,428,105,323,539,105,424,540,84,452,426,86,340,386,76,302,399,79,320
28075000108,345,78,259,267,52,215,271,75,195,271,52,219,383,107,268,387,104,278,260,69,191,282,59,220,280,63,217
28077000008,116,112,4,78,72,6,77,73,2,76,69,7,98,92,6,98,91,5,99,96,3,75,65,6,80,75,5
28023000305,173,24,145,167,28,139,168,40,126,169,31,138,206,35,164,206,27,177,127,28,99,149,29,114,151,35,116
28125000108,93,38,55,75,32,43,76,33,42,74,32,42,82,33,49,85,34,51,78,35,43,78,29,48,79,31,48
28155000504,323,28,293,281,36,245,284,51,229,281,37,244,356,43,307,354,34,319,268,23,245,269,21,245,262,22,240
28089000502,47,30,16,43,30,13,43,30,13,43,29,14,50,34,16,50,34,16,37,28,9,36,24,11,36,25,11
28039000301,165,22,141,115,13,102,114,23,91,114,16,98,200,41,157,201,22,174,113,18,95,133,16,113,130,20,110
28163000109,62,2,57,51,7,44,52,9,42,50,3,47,57,11,45,57,6,50,50,3,47,51,4,47,53,5,48
28161000505,205,38,165,144,32,112,146,38,105,145,30,115,203,43,155,205,34,169,147,34,113,150,30,118,148,38,110
28161000504,209,72,133,142,57,85,142,58,82,142,52,90,184,62,122,184,58,125,139,57,82,160,55,104,161,62,99
28153000302,509,187,320,373,136,237,373,165,206,370,142,228,509,188,313,504,163,339,355,144,211,367,122,236,371,128,243
28153000303,273,184,86,224,163,61,229,172,55,216,151,65,292,209,79,291,203,87,204,152,52,208,138,68,216,146,70
28105000503,838,592,226,634,434,200,636,451,179,612,392,220,971,684,281,963,656,288,682,508,174,676,434,225,684,475,209
28091000007,402,54,339,307,46,261,306,58,246,305,46,259,416,70,331,414,57,351,283,48,235,301,39,255,308,51,257
28105000504,640,405,224,515,311,204,520,331,188,507,291,216,738,437,290,736,426,298,559,358,201,538,304,227,542,324,218
28075000203,243,170,64,186,134,52,189,142,45,188,136,52,276,207,65,277,200,73,199,147,52,195,135,54,196,141,55
28137000102,152,9,141,102,8,94,107,14,89,101,12,89,182,21,157,182,8,171,86,9,77,103,6,93,100,9,91
28145000101,279,23,255,228,23,205,236,51,181,228,29,199,322,26,279,324,17,306,177,7,170,191,9,177,192,14,178
28073000019,348,6,339,245,18,227,248,28,211,247,22,225,411,30,368,414,16,390,225,12,213,262,10,244,262,14,248
28127000402,821,173,633,671,157,514,671,193,461,669,144,525,822,204,604,824,187,630,597,141,456,611,113,489,629,126,503
28047000115,781,250,507,585,199,386,585,224,351,583,196,387,1084,422,635,1089,385,684,579,207,372,637,204,423,633,219,414
28127000505,411,72,330,333,79,254,337,85,240,336,69,267,436,92,338,441,83,354,317,76,241,310,55,245,317,66,251
28127000506,30,5,25,25,6,19,26,7,18,25,5,20,29,6,22,28,5,23,23,5,18,22,4,18,25,5,20
28145000301,390,42,343,306,56,250,301,101,198,306,66,240,449,76,354,446,55,387,282,36,246,303,34,262,304,44,260
28073000006,1258,130,1100,983,130,853,982,212,757,983,110,873,1389,234,1130,1387,215,1151,1007,140,867,1091,116,952,1095,127,968
28047000312,931,153,749,629,159,470,630,176,445,628,137,491,1164,302,815,1163,257,883,653,149,504,721,138,564,722,158,564
28073000014,495,100,376,351,89,262,355,111,238,355,100,255,546,163,361,547,138,394,368,105,263,408,88,300,409,99,310
28051000403,175,160,13,123,110,13,124,111,12,118,84,34,178,163,14,179,153,20,137,129,8,115,97,13,121,114,7
28109000525,761,74,672,420,50,370,424,64,356,424,53,371,776,123,621,795,96,691,471,58,413,571,60,498,543,83,460
28069000302,327,88,235,308,79,229,309,93,214,305,77,228,359,112,241,355,102,249,246,69,177,259,58,197,259,54,205
28019000009,255,74,180,202,57,145,204,61,138,200,50,150,257,71,186,256,64,191,196,56,140,190,39,149,195,47,148
28021000102,7,6,1,6,5,1,6,5,1,6,4,2,6,5,1,6,5,1,6,5,1,5,4,1,6,5,1
28045000011,741,146,567,542,129,413,546,161,374,538,126,412,905,264,608,905,221,665,534,143,391,637,190,439,619,172,447
28079000302,331,215,113,289,191,98,287,195,89,284,170,114,382,272,106,382,264,113,289,197,92,260,152,104,276,183,93
28019000013,300,100,197,219,77,142,221,84,136,220,68,152,294,98,194,296,89,205,193,71,122,184,44,137,197,57,140
28099000202,320,39,275,241,40,201,241,46,190,241,53,188,307,40,259,308,35,271,230,34,196,242,26,209,242,36,206
28069000501,636,458,172,572,406,166,584,427,145,557,381,176,659,500,157,657,481,166,466,342,124,463,311,142,458,297,161
28157000401,691,595,87,549,453,96,557,440,92,533,433,100,613,508,95,620,512,98,480,406,74,462,378,78,433,339,94
28149000403,784,203,560,547,161,386,550,170,370,546,131,415,827,274,546,831,249,570,543,177,366,569,149,408,582,170,412
28071000101,500,57,434,410,68,342,421,98,319,420,123,297,568,91,465,573,73,496,364,58,306,410,45,358,404,67,337
28045000020,643,55,583,406,65,341,407,63,341,405,68,337,793,124,645,805,80,718,401,56,345,494,75,410,485,62,423
28131000301,310,58,235,219,43,176,219,49,166,218,39,179,327,65,251,331,60,270,205,43,162,229,36,191,232,40,192
28109000350,289,11,271,201,14,187,202,14,184,202,11,191,325,30,285,329,15,311,163,10,153,202,11,184,204,18,186
28109000150,518,196,310,349,129,220,354,144,201,353,117,236,544,211,315,553,198,347,355,151,204,372,135,227,369,137,232
28013000005,704,380,313,585,340,245,594,372,216,574,306,268,737,436,290,733,400,325,512,311,201,510,273,229,518,287,231
28049000504,326,319,2,232,227,5,232,231,0,232,205,27,348,339,9,344,335,4,285,283,2,261,245,8,267,253,14
28063000010,377,369,7,315,301,14,322,312,7,307,268,39,365,352,10,366,345,16,305,301,4,302,269,22,318,292,26
28067000201,412,23,384,344,18,326,343,46,296,342,24,318,452,28,418,454,23,429,284,13,271,323,16,292,331,18,313
28085000102,258,11,247,196,15,181,196,25,170,196,8,188,291,14,275,294,7,285,199,3,196,205,2,199,215,4,211
28085000207,690,465,211,460,341,119,464,352,108,450,309,141,703,507,190,695,484,199,549,391,158,519,338,171,532,355,177
28115000107,345,54,286,285,67,218,285,81,201,283,65,218,396,85,299,395,78,312,269,58,211,289,51,230,291,57,234
28147000501,193,37,153,144,35,109,144,44,99,145,28,117,211,43,162,210,35,174,151,41,110,144,29,112,149,32,117
28121000210,2121,418,1627,1482,420,1062,1480,540,929,1495,373,1122,2544,783,1707,2543,741,1767,1662,449,1213,1808,404,1370,1814,444,1370
28115000306,59,14,43,51,14,37,49,17,30,49,12,37,64,16,45,63,15,48,44,17,27,42,10,31,47,14,33
28115000403,267,116,146,205,98,107,207,100,106,199,87,112,300,128,165,302,121,175,229,112,117,216,98,116,222,104,118
28115000406,147,15,128,111,17,94,114,24,90,113,12,101,157,21,127,158,16,141,103,11,92,105,7,93,103,8,95
28107000301,128,47,81,89,28,61,93,35,57,88,30,58,127,44,79,126,33,93,75,28,47,92,23,65,93,29,64
28163000301,335,331,3,235,223,12,239,231,6,227,195,32,319,316,2,318,304,9,250,247,3,178,168,7,199,198,1
28065000044,293,114,178,252,94,158,254,103,148,246,82,164,320,122,196,314,111,199,248,96,152,242,74,163,250,84,166
28123000401,257,175,80,194,123,71,196,131,64,189,112,77,260,169,87,259,165,91,203,143,60,177,110,61,189,126,63
28031000015,595,507,81,492,423,69,506,447,53,490,395,95,628,540,81,619,517,93,534,471,63,496,408,74,521,437,84
28001000401,1173,1118,46,853,811,42,865,814,40,824,751,73,1130,1069,55,1132,1062,58,943,911,32,902,852,39,914,861,53
28015000101,786,62,721,608,54,554,615,104,507,609,72,537,829,93,716,831,64,760,528,60,468,604,47,545,616,66,550
28145000304,808,119,667,621,81,540,624,142,471,622,91,531,821,123,667,821,87,726,562,74,488,563,55,499,570,62,508
28011000404,226,211,13,173,162,11,181,169,10,174,151,23,252,242,9,252,235,14,195,188,7,180,164,12,185,176,9
28011000109,173,154,19,117,91,26,133,111,21,123,90,33,171,146,25,172,145,26,145,129,16,124,97,25,132,109,23
28129000402,364,11,349,299,15,284,300,66,225,299,20,279,412,21,386,414,11,400,246,13,233,257,10,235,270,10,260
28007000201,235,89,144,168,72,96,164,73,90,166,66,100,237,100,134,236,95,140,160,67,93,169,68,100,170,75,95
28101000101,289,172,113,228,138,90,232,143,84,229,136,93,329,200,126,329,192,135,227,148,79,235,140,93,239,144,95
28145000508,323,22,296,253,26,227,252,65,186,253,34,219,385,40,336,387,31,352,229,17,212,225,12,211,231,20,211
28145000504,505,38,464,388,47,341,384,73,306,385,39,346,521,52,462,525,34,487,339,26,313,358,28,321,362,25,337
28111000201,208,16,191,172,16,156,172,25,144,170,19,151,233,24,200,232,17,215,157,14,143,155,15,136,160,17,143
28111000102,298,128,161,207,107,100,209,113,96,204,94,110,286,136,143,289,133,154,207,118,89,205,95,108,211,102,109
28073000023,463,60,393,325,55,270,327,76,248,324,68,256,524,109,398,526,100,420,348,51,297,374,46,310,377,53,324
28051000102,467,425,34,360,332,28,362,337,22,344,294,50,485,447,37,488,439,46,386,363,23,312,276,33,333,308,25
28047000503,2719,859,1752,1854,656,1198,1862,695,1137,1860,607,1253,3074,1244,1735,3091,1132,1883,2016,782,1234,2181,746,1407,2164,774,1390
28149000201,256,243,10,165,154,11,165,157,6,164,134,30,247,241,6,248,240,5,190,184,6,164,143,20,179,169,10
28057000203,191,4,185,144,10,134,144,14,129,143,2,141,220,14,199,221,6,212,121,7,114,130,4,119,131,6,125
28155000502,282,10,268,212,13,199,215,18,196,212,11,201,321,27,290,322,10,312,196,9,187,208,6,199,206,11,195
28073000004,596,30,555,428,26,402,431,41,387,432,28,404,677,73,590,679,56,621,424,31,393,478,30,431,478,37,441
28091000019,136,129,5,104,94,10,108,99,9,98,90,8,140,128,10,138,103,35,114,107,7,96,90,5,101,91,10
28093000405,506,296,202,300,172,128,301,184,116,296,168,128,544,313,224,549,287,255,376,243,133,369,208,151,370,237,133
28009000101,787,594,186,393,265,128,401,277,121,388,252,136,846,617,220,847,595,245,535,420,115,546,387,150,537,387,150
28033000102,423,43,369,258,38,220,260,54,204,260,47,213,483,88,384,482,64,409,274,31,243,325,31,285,321,37,284
28135000306,128,6,120,101,9,92,103,13,89,103,11,92,130,7,122,131,3,127,87,2,85,92,2,89,94,5,89
28049000115,928,546,361,742,446,296,737,489,239,744,406,338,1078,696,373,1079,687,379,798,500,298,820,475,339,822,481,341
28027000013,49,31,17,36,20,16,39,21,17,36,19,17,57,36,21,57,35,22,42,24,18,35,17,17,42,25,17
28049000303,453,437,13,292,285,7,297,287,8,291,259,32,416,403,11,420,397,16,381,372,9,360,337,13,362,345,17
28155000501,210,13,195,178,14,164,181,23,156,179,11,168,226,23,195,229,12,214,156,6,150,172,9,155,171,8,163
28085000101,456,435,17,347,335,12,349,338,10,340,314,26,480,469,11,478,454,22,419,411,8,389,368,18,402,387,15
28085000303,335,165,168,257,118,139,261,131,128,254,103,151,344,160,180,344,152,191,279,136,143,266,113,145,272,129,143
28049000110,861,797,53,570,534,36,569,532,31,567,466,101,822,780,35,819,762,46,674,643,31,670,610,51,673,633,40
28075000511,118,22,95,109,31,78,106,31,72,111,27,84,137,43,94,137,39,98,101,31,70,114,29,84,115,30,85
28049000513,387,372,7,245,237,8,248,243,4,246,215,31,365,357,7,365,350,12,310,306,4,278,264,8,284,275,9
28089000202,1809,281,1463,1426,282,1144,1419,459,944,1435,253,1182,1915,466,1391,1917,444,1439,1397,283,1114,1532,272,1243,1534,283,1251
28123000406,443,136,304,327,115,212,329,118,205,327,92,235,447,159,280,446,143,297,351,124,227,339,100,232,347,116,231
28125000103,37,3,34,27,6,21,28,6,22,27,2,25,33,3,30,32,3,29,26,2,24,27,3,24,27,3,24
28023000501,106,6,100,93,4,89,93,12,78,92,7,85,111,4,107,111,5,105,74,3,71,84,8,73,83,11,72
28039000404,81,10,71,61,11,50,60,12,48,60,13,47,105,21,84,105,18,87,60,10,50,66,6,57,66,8,58
28089000999,803,165,610,637,148,489,637,226,402,640,151,489,842,236,586,841,223,597,622,177,445,676,173,491,678,185,493
28125000102,23,23,0,12,12,0,12,12,0,11,10,1,18,18,0,17,15,2,15,15,0,14,13,0,16,16,0
28115000202,436,34,395,302,33,269,307,56,248,304,43,261,472,52,402,474,33,435,277,27,250,283,20,250,284,31,253
28141000101,119,13,101,94,11,83,97,23,73,95,14,81,133,17,111,137,14,123,81,12,69,100,13,86,97,15,82
28109000280,748,73,662,481,36,445,490,55,429,485,42,443,824,102,696,842,77,760,456,51,405,559,53,496,547,56,491
28159000203,1034,178,848,768,151,617,768,204,556,768,171,597,1107,210,883,1107,184,919,718,139,579,782,130,646,782,158,624
28159000402,870,715,142,617,501,116,618,522,92,618,502,116,919,761,153,911,726,171,736,621,115,704,552,139,706,564,142
28023000406,207,18,189,172,17,155,173,21,151,168,15,153,216,29,186,219,24,194,151,17,134,158,15,143,157,24,133
28097000103,119,48,67,96,38,58,97,38,56,97,38,59,137,53,82,136,50,86,94,43,51,101,35,60,104,38,66
28091000009,419,19,393,300,23,277,300,36,259,299,24,275,445,30,406,444,18,425,286,15,271,300,13,282,305,25,280
28091000011,266,120,141,189,94,95,193,102,90,188,93,95,268,132,129,269,118,146,200,110,90,196,92,100,202,95,107
28077000014,280,234,42,238,200,38,241,207,29,237,169,68,308,251,54,309,239,58,256,214,42,225,163,52,238,189,49
28017000115,221,63,152,177,53,124,178,81,95,175,55,120,206,70,133,206,55,146,162,51,111,163,36,122,162,39,123
28077000015,157,138,17,132,111,21,134,112,21,128,100,28,159,135,23,157,135,19,135,118,17,118,91,26,131,110,21
28081000504,377,42,329,295,41,254,295,73,222,297,35,262,387,66,317,389,53,333,296,34,262,299,29,268,296,41,255
28127000503,316,211,102,284,189,95,284,194,90,279,177,102,355,252,101,352,237,109,279,203,76,259,169,86,273,185,88
28139000101,229,18,207,198,14,184,203,22,178,199,25,174,247,27,212,250,14,235,150,9,141,168,4,159,166,16,150
28127000407,79,13,66,72,13,59,69,18,51,71,12,59,96,19,76,93,16,77,63,10,53,70,11,59,70,11,59
28127000401,361,62,296,325,57,268,325,84,233,323,57,266,376,76,293,374,66,304,300,51,249,319,47,265,321,55,266
28139000501,320,19,298,257,30,227,262,56,202,254,27,227,326,32,289,327,20,301,221,26,195,235,15,215,238,26,212
28079000203,590,174,405,500,140,360,498,163,330,497,130,367,622,186,424,623,173,447,418,131,287,385,98,282,395,114,281
28005000301,192,98,92,128,70,58,131,73,56,129,69,60,190,96,92,191,95,92,134,70,64,129,64,60,127,58,69
28059000402,218,75,131,181,81,100,182,80,95,179,70,109,246,107,135,245,97,144,189,84,105,202,87,112,199,90,109
28017000107,365,228,130,296,192,104,298,212,83,291,178,113,353,236,115,355,225,126,305,215,90,300,192,105,305,208,97
28129000503,256,13,243,216,21,195,218,40,178,218,28,190,280,23,252,284,19,263,186,10,176,182,10,172,185,14,171
28089000201,1684,355,1287,1353,334,1019,1350,506,830,1354,305,1049,1899,538,1326,1892,493,1376,1396,390,1006,1483,328,1137,1479,360,1119
28029000103,268,175,90,210,141,69,212,145,66,208,126,82,259,170,86,259,161,91,219,148,71,213,125,81,218,136,82
28061000105,723,167,553,500,105,395,507,142,357,501,114,387,732,179,540,733,150,576,503,132,371,524,109,404,541,120,421
28159000201,588,151,430,461,135,326,460,142,314,462,132,330,605,174,423,603,156,441,436,130,306,466,119,342,466,135,331
28163000402,238,59,174,191,42,149,193,54,136,189,38,151,257,66,187,255,64,190,198,54,144,188,41,146,199,52,147
28065000053,260,193,67,205,157,48,206,163,42,209,133,76,269,212,57,266,206,59,218,168,50,193,144,48,203,151,52
28065000043,615,426,187,468,326,142,470,336,130,461,301,160,620,433,184,619,422,191,501,371,130,480,312,151,500,347,153
28089000408,709,696,9,449,440,9,459,453,4,449,420,29,683,671,9,679,652,18,625,620,5,530,495,20,542,529,13
28061000101,289,35,251,191,27,164,194,47,141,192,33,159,281,41,233,283,34,245,189,26,163,184,24,154,192,27,165
28075000301,211,66,140,159,60,99,159,71,86,158,56,102,210,93,111,215,89,121,157,60,97,168,58,109,167,57,110
28029000404,348,266,76,242,184,58,245,191,53,235,162,73,340,254,82,338,248,89,295,229,66,269,184,77,279,201,78
28001000301,559,523,29,398,372,26,400,368,25,391,351,40,569,534,31,572,522,41,427,407,20,419,386,28,419,380,39
28099000104,230,10,214,182,11,171,182,28,153,182,31,151,263,25,231,265,13,248,151,6,145,173,6,163,173,17,156
28139000506,193,27,166,145,30,115,143,28,113,143,20,123,209,42,160,209,32,175,123,21,102,124,18,104,121,23,98
28049000117,1146,1088,47,792,764,28,797,768,20,787,685,102,1111,1076,30,1108,1059,40,963,941,22,898,833,49,908,865,43
28035000107,1192,113,1050,886,109,777,886,186,684,886,129,757,1271,197,1033,1278,147,1115,840,111,729,953,88,835,953,107,846
28149000402,1071,537,508,817,434,383,819,472,340,814,362,452,1192,707,473,1191,685,487,848,479,369,874,412,449,909,474,435
28149000504,1016,274,719,766,226,540,771,262,500,768,178,590,1092,346,731,1094,327,754,800,261,539,822,230,578,832,265,567
28035000109,449,22,415,353,28,325,345,49,291,351,34,317,548,57,482,550,36,510,334,27,307,354,21,318,359,29,330
28131000503,200,22,175,152,24,128,150,21,129,151,19,132,227,32,184,231,25,204,122,21,101,138,20,116,138,19,119
28093000303,813,114,678,469,67,402,484,75,407,469,63,406,866,188,665,876,154,711,536,96,440,623,75,537,607,88,519
28033000408,1053,464,557,566,258,308,574,285,281,568,240,328,1265,722,521,1259,659,578,732,410,322,815,395,405,793,387,406
28005000404,447,54,392,345,45,300,344,65,274,345,47,298,448,61,382,451,54,393,318,44,274,342,36,301,343,41,302
28137000303,259,29,224,200,29,171,203,47,153,200,19,181,326,45,278,330,30,294,184,21,163,186,14,166,188,18,170
28049000102,1212,324,832,1061,304,757,1062,496,549,1068,243,825,1429,501,897,1410,458,909,1103,399,704,1181,358,810,1176,384,792
28037000201,120,9,110,105,8,97,110,19,90,108,15,93,129,11,117,130,9,120,87,7,80,95,7,81,95,10,85
28049000201,302,298,3,219,215,4,220,214,4,218,187,31,298,294,3,296,290,4,252,249,3,242,233,6,244,237,7
28017000102,299,177,117,240,147,93,242,174,66,228,131,97,328,213,112,326,192,128,239,158,81,227,109,110,234,137,97
28123000205,256,59,195,231,52,179,231,65,166,227,43,184,280,68,209,280,56,223,218,52,166,212,37,171,213,48,165
28123000302,142,20,117,103,16,87,104,39,64,104,29,75,137,25,110,137,22,114,117,22,95,118,15,102,118,22,96
28147000405,403,85,313,272,58,214,274,63,211,271,52,219,428,100,323,431,87,339,283,70,213,301,56,238,308,55,253
28075000104,1155,272,863,876,249,627,875,273,587,879,226,653,1275,371,885,1276,351,912,863,243,620,965,226,729,953,238,715
28023000403,154,2,152,120,6,114,120,8,111,119,4,115,167,7,160,168,3,164,125,2,123,134,5,129,135,10,125
28121000413,1268,231,1014,1082,238,844,1078,331,731,1088,225,863,1552,355,1161,1569,325,1227,1081,237,844,1162,201,939,1159,217,942
28039000202,386,19,361,219,19,200,222,32,184,218,26,192,480,60,407,485,39,438,247,23,224,302,21,274,298,37,261
28075000305,839,29,800,595,37,558,598,62,523,598,35,563,871,50,810,880,42,834,562,25,537,663,30,623,661,34,627
28077000026,53,47,6,38,34,4,40,33,6,37,28,9,53,45,8,53,44,9,39,35,4,35,27,7,38,34,4
28081000203,242,18,213,208,22,186,208,46,160,209,22,187,288,31,250,290,23,264,189,16,173,201,10,184,196,16,180
28059000401,384,125,251,333,112,221,338,121,213,335,101,234,483,183,292,484,158,323,338,123,215,355,116,236,356,116,240
28069000204,136,119,16,105,92,13,106,94,11,103,81,22,127,113,14,127,113,13,112,102,10,102,91,11,104,89,15
28105000402,166,44,117,112,36,76,112,37,74,111,35,76,151,51,97,153,50,101,114,40,74,119,40,78,122,41,81
28045000026,688,36,644,450,43,407,457,69,382,453,58,395,815,102,676,820,47,759,459,25,434,522,47,458,522,31,491
28057000301,534,33,489,429,42,387,430,57,369,431,46,385,594,62,518,599,38,554,381,27,354,398,23,364,400,36,364
28137000204,181,55,120,127,31,96,130,36,89,131,42,89,187,56,129,188,46,139,127,45,82,137,36,94,140,44,96
28039000103,296,14,277,173,6,167,172,14,158,171,14,157,323,33,288,329,17,311,188,9,179,235,14,216,219,22,197
28061000104,74,62,12,49,40,9,53,41,11,51,39,12,85,73,11,86,71,14,61,56,5,57,49,5,59,48,11
28065000055,323,232,90,262,186,76,270,204,63,265,170,95,351,261,89,353,250,99,290,222,68,242,167,72,266,193,73
28105000102,352,128,216,262,100,162,267,115,152,267,99,168,391,169,220,393,160,227,285,113,172,298,109,182,306,127,179
28011000406,236,60,161,198,62,136,203,88,110,200,72,128,294,125,163,290,108,176,185,60,125,205,53,148,203,62,141
28049000405,802,270,489,641,260,381,645,322,312,644,228,416,905,408,478,905,385,507,630,275,355,690,254,423,690,275,415
28049000525,788,761,12,617,607,10,621,612,5,616,556,60,773,760,8,769,744,15,714,712,2,685,668,12,695,680,15
28019000005,267,67,196,199,51,148,201,67,128,200,50,150,273,81,187,278,72,205,183,49,134,185,46,135,181,44,137
28019000012,329,15,311,232,9,223,230,21,206,234,17,217,321,20,291,320,13,303,197,5,192,212,9,201,213,11,202
28137000503,188,68,116,130,42,88,136,45,90,133,39,94,193,62,127,195,56,134,133,50,83,142,37,100,143,42,101
28067000203,160,9,150,134,8,126,134,17,115,134,17,117,177,16,157,176,11,164,116,9,107,110,7,101,118,8,110
28109000321,178,11,165,110,9,101,110,8,99,110,11,99,187,15,167,189,5,183,113,8,105,140,10,128,141,14,127
28065000011,126,84,40,90,54,36,95,59,36,90,48,42,129,79,49,129,76,51,95,62,33,93,52,35,97,58,39
28127000101,530,451,76,408,349,59,413,358,53,398,322,76,545,459,82,546,450,84,423,374,49,383,313,65,399,337,62
28051000301,167,40,124,131,36,95,130,52,77,130,34,96,173,51,118,212,46,120,131,39,92,118,25,92,121,31,90
28053000504,306,301,5,185,182,3,191,188,3,175,158,17,298,294,3,299,289,6,247,246,1,210,189,8,222,206,16
28053000101,36,2,34,21,0,21,21,1,20,21,0,21,37,2,34,38,3,35,28,2,26,30,2,28,32,4,28
28057000101,378,32,343,313,43,270,315,37,276,309,22,287,422,48,363,423,31,390,244,20,224,238,20,217,242,30,212
28049000506,441,367,56,291,255,36,294,259,28,291,219,72,452,388,60,448,371,64,372,340,32,382,303,71,386,332,54
28085000404,455,74,373,368,57,311,371,75,294,366,53,313,526,91,432,527,81,440,358,55,303,344,48,286,361,51,310
28061000502,416,249,166,321,212,109,323,219,104,312,195,117,474,294,170,477,291,183,368,244,124,351,208,134,360,215,145
28147000503,226,194,30,178,154,24,179,156,20,174,134,40,248,217,30,249,207,41,211,191,20,182,158,21,185,159,26
28135000103,176,21,153,138,29,109,141,40,98,138,31,107,170,24,143,172,17,152,124,19,105,113,20,89,114,20,94
28031000012,129,15,109,104,10,94,104,20,81,104,12,92,137,19,117,138,17,121,99,14,85,107,11,93,105,12,93
28113000206,287,270,15,211,206,5,216,208,8,207,194,13,276,268,7,281,265,12,215,212,3,211,196,9,218,199,19
28075000202,178,59,113,121,31,90,123,37,85,124,36,88,205,64,139,206,62,143,118,35,83,129,31,97,128,32,96
28001000303,535,504,26,353,338,15,358,339,12,342,314,28,448,431,16,450,420,26,368,357,11,347,319,20,356,329,27
28139000106,190,39,144,158,40,118,163,47,113,158,39,119,213,59,149,214,44,167,124,42,82,142,35,101,140,45,95
28049000311,246,238,2,185,185,0,188,187,1,185,162,23,292,287,3,292,285,5,217,217,0,205,199,4,208,205,3
28133000502,140,15,125,108,10,98,110,19,91,108,16,92,148,18,130,151,18,133,105,8,97,109,11,98,104,17,87
28075000517,437,96,331,318,84,234,320,95,216,315,93,222,435,134,290,436,127,303,306,90,216,346,82,253,348,92,256
28023000502,130,70,60,95,47,48,95,50,44,93,47,46,141,75,63,142,75,66,89,53,36,95,42,51,101,57,44
28155000205,235,30,202,212,30,182,213,39,173,214,20,194,262,32,227,267,28,235,177,17,160,188,15,170,181,21,160
28073000008,747,271,456,581,236,345,584,265,311,584,229,355,1055,484,546,1053,437,593,551,252,299,615,244,352,619,246,373
28073000024,311,216,75,220,157,63,223,166,56,220,146,74,428,317,104,430,305,112,262,204,58,258,176,74,261,179,82
28093000202,235,130,104,138,69,69,138,67,69,131,62,69,252,129,121,253,125,124,159,93,66,172,87,85,164,94,70
28057000103,130,11,117,100,16,84,101,25,74,100,13,87,142,17,119,142,11,130,80,5,75,83,8,73,83,13,70
28137000105,318,29,284,205,17,188,205,25,170,203,21,182,380,44,321,385,27,354,191,19,172,229,17,204,227,30,197
28115000204,197,33,150,140,30,110,144,38,103,140,33,107,228,51,168,229,39,187,129,37,92,129,21,103,137,33,104
28159000204,382,144,237,296,134,162,297,144,151,296,128,168,413,190,219,416,182,230,326,150,176,331,136,193,331,143,188
28097000304,85,70,14,65,51,14,69,54,12,65,51,14,83,68,15,82,66,15,68,58,10,68,54,12,68,54,14
28015000102,180,26,152,146,26,120,150,37,110,144,24,120,181,31,149,182,23,158,145,23,122,147,16,129,149,24,125
28077000025,54,52,2,41,37,4,41,41,0,40,32,8,49,47,2,50,45,2,45,45,0,39,37,1,40,39,1
28075000205,379,169,205,285,119,166,285,124,158,284,110,174,404,189,206,406,173,228,202,58,144,305,138,164,302,133,169
28029000304,149,104,45,122,86,36,123,94,29,120,79,41,156,125,29,156,121,34,139,103,36,123,76,42,127,87,40
28041000302,197,6,186,138,5,133,139,16,122,139,12,127,205,8,193,205,1,203,117,0,117,132,1,127,130,4,126
28095000104,161,24,136,114,23,91,117,29,88,116,24,92,169,23,143,170,21,148,118,22,96,123,19,100,123,23,100
28067000505,651,643,6,441,418,23,453,442,10,436,403,33,643,634,8,647,622,15,564,563,1,490,470,16,514,508,6
28125000106,76,75,1,74,72,2,76,75,1,74,66,8,82,78,3,83,75,5,55,54,1,58,53,2,58,56,2
28051000302,270,198,67,202,146,56,212,157,53,202,115,87,270,205,64,273,200,68,220,171,49,171,128,43,188,144,44
28081000110,414,33,377,334,31,303,337,51,283,337,27,310,454,39,408,459,28,427,334,34,300,347,29,312,350,33,317
28021000103,302,295,4,283,278,5,287,275,7,285,275,10,333,326,3,331,320,7,192,192,0,177,165,12,181,170,11
28137000302,669,121,535,511,100,411,520,125,393,512,92,420,780,160,600,779,137,630,471,92,379,515,86,417,512,99,413
28033000207,1737,563,1129,1022,390,632,1027,438,576,1026,380,646,1975,926,1014,1972,860,1078,1242,543,699,1437,521,880,1411,563,848
28005000201,294,221,72,230,184,46,230,189,39,226,171,55,293,224,69,294,218,74,221,183,38,224,173,48,223,170,53
28137000403,266,145,117,204,109,95,210,116,91,200,108,92,293,169,116,296,157,133,196,114,82,198,103,92,196,105,91
28049000413,365,299,60,254,211,43,254,211,38,250,190,60,342,293,44,341,286,52,298,261,37,290,232,53,290,236,54
28049000416,389,342,41,305,278,27,307,280,25,307,252,55,430,397,31,428,388,37,354,327,27,339,299,36,345,312,33
28163000401,258,189,68,242,111,131,242,123,117,236,104,132,262,141,117,262,136,124,235,120,115,209,94,109,223,111,112
28091000013,254,39,211,199,36,163,198,36,161,199,35,164,262,48,209,261,45,216,190,38,152,201,33,160,208,38,170
28023000105,51,36,15,35,19,16,35,20,15,34,17,17,55,39,16,55,35,19,39,28,11,33,18,13,40,27,13
28147000504,238,179,55,169,120,49,170,129,41,165,117,48,228,156,69,229,148,75,199,154,45,181,126,49,185,129,56
28099000503,288,183,100,251,178,73,218,164,54,249,178,71,311,216,90,312,206,101,240,168,72,235,149,81,240,157,83
28039000201,238,26,204,137,21,116,139,31,106,139,27,112,231,37,187,236,29,206,139,18,121,178,21,152,171,21,150
28147000201,60,9,51,45,8,37,45,9,36,45,9,36,64,12,49,65,10,54,36,8,28,40,8,30,42,7,35
28093000503,118,6,111,95,4,91,98,10,88,97,10,87,124,10,110,125,6,119,92,4,88,95,3,92,95,2,93
28057000305,263,45,213,197,39,158,198,50,145,198,36,162,275,50,217,278,42,233,180,29,151,169,23,143,169,23,146
28045000021,128,8,115,88,8,80,88,10,78,86,8,78,153,22,124,158,10,143,80,12,68,96,16,78,93,12,81
28089000305,341,329,2,104,103,1,104,100,0,102,99,3,92,92,0,94,94,0,177,177,0,172,160,8,170,162,8
