GEOID20,Tot_2016_sen,D_2016_sen,R_2016_sen,Tot_2016_pres,D_2016_pres,R_2016_pres,Tot_2019_gov,D_2019_gov,R_2019_gov,Tot_2019_ag,D_2019_ag,R_2019_ag,Tot_2020_pres,D_2020_pres,R_2020_pres,Tot_2020_sen,D_2020_sen,R_2020_sen
2101700B101,642,296,346,651,178,439,555,242,304,549,185,364,691,204,475,700,230,442
2101700G101,693,297,396,693,195,464,545,235,298,541,194,347,734,222,500,766,230,505
2101700C101,443,199,244,443,108,313,361,132,221,355,114,241,495,131,357,507,163,330
2101700F103,327,140,187,325,76,227,290,120,166,290,99,191,357,92,258,385,114,252
2107100D108,633,264,369,675,122,532,443,218,212,437,233,204,678,116,558,663,141,502
2103300B102,433,142,291,435,84,334,308,93,204,301,84,217,451,93,351,455,113,322
2101700F101,552,256,296,549,141,370,452,212,229,450,178,272,576,162,400,604,199,378
2116900B103,316,113,203,319,47,261,278,106,160,268,88,180,337,46,287,336,75,245
2116900A103,677,220,457,687,104,555,587,187,377,559,125,434,762,106,641,797,152,577
2107100A105,488,220,268,509,125,373,397,188,205,393,197,196,561,155,400,557,180,365
2107100A103,402,168,234,420,67,345,274,112,155,279,126,153,412,66,341,411,91,312
2107100C107,305,175,130,327,90,226,210,115,87,212,126,86,299,74,221,302,101,189
2107100C108,310,192,118,355,128,216,245,132,104,242,139,103,370,116,245,363,153,199
2107100A116,639,234,405,657,124,519,468,204,251,467,187,280,672,130,531,667,152,495
2107100A106,529,235,294,541,144,379,363,177,175,363,190,173,569,153,409,567,185,369
2113100C102,228,41,187,243,23,217,181,45,136,176,23,153,289,28,261,289,35,240
2113100A101,179,18,161,193,10,181,144,16,127,141,10,131,192,10,180,195,15,174
2113100B102,213,59,154,219,45,170,155,65,84,140,62,78,213,33,178,208,46,157
2112700B103,864,333,531,882,179,667,610,236,361,603,207,396,963,203,745,987,219,708
2112700D104,307,120,187,305,51,245,208,79,128,203,67,136,325,56,265,341,76,242
2112700C104,558,172,386,582,59,512,361,97,258,362,85,277,683,71,607,684,120,546
2112700A104,262,107,155,270,43,214,169,61,105,170,64,106,290,48,235,300,69,202
2103500B103,503,179,324,510,130,351,379,126,248,378,118,260,552,159,383,553,180,349
2107100A110,347,159,188,361,99,254,234,105,125,237,115,122,369,105,256,367,121,237
2107100D105,224,98,126,244,47,190,142,66,74,139,73,66,260,51,208,255,62,180
2102500A102,350,143,207,344,63,271,265,121,142,261,111,150,289,44,242,309,74,225
2103300D104,477,164,313,481,101,364,371,125,240,370,122,248,513,115,393,510,135,356
2102500C101,431,263,168,464,149,290,246,128,116,237,120,117,469,132,328,431,171,233
2102500B105,172,101,71,184,68,110,114,73,40,104,65,39,200,64,133,186,70,104
2102500D103,356,171,185,372,92,274,250,113,134,244,103,141,265,55,207,249,74,171
2111700C103,416,135,281,425,125,272,285,143,135,287,125,162,489,170,308,481,194,269
2107100B102,537,263,274,568,138,405,415,231,178,408,213,195,554,139,410,551,179,356
2103300A103,569,236,333,573,149,392,374,144,225,370,134,236,575,160,399,588,183,356
2103300D101,389,104,285,392,53,328,320,85,230,318,75,243,443,63,375,456,91,343
2106700A131,362,253,109,372,203,135,279,208,67,271,186,85,393,244,138,401,259,121
2106700C130,405,261,144,397,219,151,346,217,122,343,193,150,414,256,152,410,239,163
2107700D102,430,119,311,431,77,334,311,119,184,300,89,211,531,91,430,533,132,373
2111900C101,177,82,95,193,43,134,145,65,74,138,54,84,180,41,137,183,47,126
2107700B102,448,88,360,457,88,339,284,97,170,278,86,192,518,96,407,535,91,403
2110300B102,196,83,113,196,38,143,151,64,86,149,48,101,213,44,165,227,71,135
2113900B103,451,178,273,458,112,324,349,151,195,346,137,209,505,123,376,494,135,341
2107100A104,214,102,112,226,61,146,154,74,77,157,84,73,216,66,146,213,72,127
2113100B101,433,42,391,454,28,418,325,66,257,315,41,274,516,42,467,519,55,450
2113100C103,412,89,323,446,40,400,288,56,230,285,54,231,512,50,460,514,63,429
2113100D104,269,48,221,293,22,263,197,48,144,191,42,149,313,32,274,312,35,260
2113100B104,164,27,137,178,10,167,95,13,80,91,11,80,169,9,160,168,12,148
2113900C102,592,171,421,601,88,493,434,135,287,420,118,302,653,93,554,658,125,508
2112700A102,753,299,454,782,128,635,515,201,305,507,178,329,949,160,779,908,215,664
2112700D101,270,69,201,276,33,234,178,32,144,175,35,140,292,37,252,315,44,258
2107100A111,466,222,244,479,108,353,359,188,161,363,193,170,505,142,359,505,177,312
2103300A102,348,101,247,352,41,308,244,70,172,240,62,178,378,46,331,366,82,279
2103300B101,588,172,416,587,88,475,432,111,312,428,108,320,647,104,533,672,147,491
2103300C102,322,97,225,330,60,252,226,79,145,222,77,145,350,69,274,354,80,257
2105900A111,1231,444,787,1230,376,780,966,431,514,955,369,586,1342,469,849,1357,444,842
2105900F102,1057,385,672,1063,263,747,820,381,424,814,308,506,1416,401,994,1408,470,879
2105900G102,475,199,276,479,137,315,321,144,172,318,127,191,506,165,331,516,192,285
2111700A137,1185,298,887,1184,315,792,902,382,504,892,313,579,1318,417,874,1287,418,825
2111700C105,617,225,392,616,217,363,376,213,150,374,180,194,672,275,384,676,302,349
2111700A122,593,351,242,598,357,185,398,295,98,391,279,112,652,443,192,697,462,212
2116900A104,270,114,156,278,74,194,209,97,106,205,82,123,270,67,198,261,70,175
2102500B103,368,177,191,389,97,279,278,149,126,265,141,124,432,91,335,425,123,281
2102500C102,187,117,70,202,63,136,105,61,44,102,55,47,183,48,133,152,65,83
2105900G103,841,333,508,853,226,572,582,259,309,572,237,335,902,275,608,908,325,530
2111700B123,569,111,458,567,93,459,424,121,290,421,94,327,663,129,529,615,163,444
2106700A188,505,242,263,498,226,249,445,272,169,447,245,202,600,330,262,594,295,286
2106700C183,296,217,79,292,199,73,206,163,40,201,149,52,314,236,72,312,226,78
2106700C137,469,250,219,468,191,263,348,207,139,348,178,170,499,244,252,493,253,233
2106700B143,518,320,198,508,273,196,425,270,143,420,247,173,529,323,192,548,332,195
2106700A174,224,145,79,223,130,83,125,91,30,124,87,37,200,126,71,198,120,76
2106700A187,780,500,280,788,442,286,538,407,121,534,362,172,765,502,248,765,499,245
2106700C129,289,179,110,286,142,119,241,154,82,236,128,108,329,187,135,335,185,140
2106700A200,764,523,241,761,462,247,703,512,183,694,451,243,1111,772,315,1091,751,311
2106700C167,573,376,197,579,329,208,377,288,84,373,270,103,503,324,164,505,331,155
2106700C151,545,351,194,546,298,205,442,326,105,438,307,131,594,377,197,594,388,186
2106700B139,498,257,241,487,204,258,435,216,217,436,190,246,572,278,286,605,294,302
2106700A181,538,332,206,532,298,206,490,340,143,482,316,166,607,383,215,604,379,213
2106700B211,540,337,203,546,293,188,377,286,80,374,258,116,540,344,176,556,350,185
2116900B101,289,130,159,298,83,209,240,106,128,232,85,147,322,83,237,291,88,197
2113100A104,361,55,306,387,35,346,271,62,198,269,53,216,400,40,357,394,45,335
2101500C126,316,148,168,323,152,149,176,102,69,167,91,76,365,198,159,379,204,155
2106700A156,335,224,111,336,182,135,283,203,77,279,179,100,374,242,124,374,247,117
2106700B202,604,325,279,603,267,277,544,322,211,540,271,269,664,358,292,674,347,307
2101500C133,358,113,245,361,96,246,225,90,130,218,69,149,418,132,279,416,165,241
2101500B128,935,211,724,940,177,706,625,195,406,603,154,449,1127,259,846,1122,326,751
2117700B105,310,121,189,314,70,234,234,106,122,233,93,140,360,81,275,367,98,250
2117700A107,401,183,218,411,112,290,251,123,126,247,93,154,448,121,322,432,139,271
2117700E103,938,379,559,950,197,724,607,282,310,595,219,376,992,205,773,1017,276,670
2117700D101,843,344,499,854,216,612,589,274,303,577,229,348,968,245,712,971,273,651
2117700A101,155,107,48,166,79,82,123,77,44,125,77,48,179,85,91,156,81,59
2117700D102,424,183,241,432,95,326,290,121,165,286,101,185,502,110,386,499,148,320
2117700B102,555,237,318,570,113,445,371,168,199,367,118,249,632,124,502,599,182,402
2106700B117,625,329,296,623,241,327,542,311,220,538,260,278,680,334,331,688,342,324
2106700C215,398,223,175,396,168,191,340,207,128,338,185,153,430,232,185,450,253,181
2106700A172,407,275,132,409,229,152,322,251,59,320,223,97,453,287,154,454,303,135
2101500A110,612,130,482,616,110,478,449,150,287,446,119,327,670,145,515,655,181,450
2101500B117,1172,335,837,1178,323,770,881,384,470,859,288,571,1380,458,894,1411,502,841
2104100A101,348,136,212,356,83,265,237,89,142,232,83,149,396,91,299,384,108,257
2104100C104,776,326,450,774,223,516,543,247,276,533,214,319,861,224,624,864,273,542
2114300B102,696,259,437,699,158,526,534,197,325,526,185,341,766,195,566,766,237,507
2114300X001,0,0,0,0,0,0,0,0,0,0,0,0,0,0,0,0,0,0
2106700C185,170,76,94,169,56,103,132,53,75,127,45,82,187,67,116,187,67,117
2106700C125,598,286,312,606,204,368,488,203,281,488,187,301,619,224,387,642,252,376
2106700A158,561,206,355,561,152,379,445,177,264,439,148,291,583,213,366,588,196,380
2106700C160,327,135,192,322,102,206,279,122,155,280,108,172,385,150,232,388,156,231
2115500H102,377,202,175,384,112,259,277,145,128,268,133,135,445,118,323,429,163,248
2102100C101,595,299,296,595,248,328,484,263,217,479,224,255,717,327,382,687,291,378
2105900H107,639,204,435,643,156,465,525,180,334,518,144,374,710,195,508,697,205,467
2105900A106,447,238,209,456,199,228,305,161,136,304,152,152,501,244,244,495,234,220
2105900A105,1137,477,660,1144,363,728,892,425,443,875,368,507,1214,434,762,1189,457,677
2105900C101,1204,434,770,1200,308,847,1017,442,561,995,367,628,1441,418,1005,1422,472,897
2117700E104,656,263,393,670,164,483,470,212,254,458,173,285,716,176,529,702,197,483
2117700B103,466,172,294,469,87,370,304,121,174,300,89,211,518,96,417,519,132,372
2101500A119,400,111,289,409,99,289,237,80,152,232,58,174,427,124,297,418,146,257
2101500C131,830,330,500,843,321,464,442,227,203,436,188,248,903,405,479,923,439,447
2121700E103,443,147,296,441,113,315,307,105,198,299,85,214,517,138,373,516,132,370
2121700D101,192,37,155,196,18,174,153,30,123,153,22,131,217,21,195,220,32,183
2105900A112,239,182,57,246,170,71,155,119,34,151,108,43,268,187,77,232,160,61
2105900A102,1023,645,378,1059,540,452,662,468,184,648,423,225,1126,638,465,1063,614,382
2105900A138,654,291,363,655,207,391,473,239,221,470,208,262,715,261,432,760,294,393
2121700A102,446,144,302,450,84,341,339,111,220,331,80,251,461,92,361,478,115,336
2121700E101,963,301,662,981,189,764,748,261,475,735,186,549,1054,213,831,1047,247,759
2115500A104,349,193,156,353,162,179,276,183,89,272,163,109,431,185,242,435,167,239
2122300B103,420,160,260,417,99,298,333,124,200,332,109,223,515,125,377,534,148,349
2102100D103,767,289,478,768,198,547,641,265,362,629,209,420,851,244,595,858,262,568
2102100B103,866,395,471,867,213,618,651,284,345,638,219,419,958,264,678,965,363,566
2111700C112,511,177,334,510,171,292,389,221,157,382,185,197,507,204,289,524,223,279
2111700C135,1242,291,951,1235,357,812,998,365,623,980,285,695,1350,458,871,1294,396,860
2111700A114,355,132,223,357,134,195,248,142,100,238,109,129,420,185,224,430,193,216
2111700A118,305,264,41,307,269,32,170,147,19,171,141,30,354,320,32,370,333,34
2111700A128,728,272,456,740,276,411,520,295,215,506,240,266,811,352,439,816,369,410
2103500B108,327,129,198,330,95,223,279,91,182,275,87,188,379,121,254,366,135,222
2104100B101,273,137,136,278,100,168,174,100,71,172,94,78,280,95,183,270,105,156
2104100C102,178,58,120,179,32,142,123,34,86,121,25,96,193,31,161,192,45,129
2123500B104,156,52,104,159,31,119,128,51,76,128,44,84,197,43,147,208,44,138
2123500A104,398,101,297,405,39,357,307,74,226,305,35,270,451,48,396,457,77,354
2103300A101,449,124,325,455,75,362,361,104,244,362,101,261,475,84,383,489,100,362
2111700C125,1223,425,798,1218,429,704,911,443,453,887,361,526,1343,554,759,1363,582,725
2111700A131,1395,435,960,1402,400,891,767,391,359,756,318,438,1324,448,840,1341,516,763
2105900F103,731,253,478,738,141,565,569,219,333,558,180,378,768,169,588,763,242,489
2105900F101,1276,459,817,1310,289,946,960,366,562,944,330,614,1378,352,1005,1349,447,852
2117700A104,336,162,174,335,108,211,235,108,125,236,101,135,338,110,220,351,116,204
2120700C103,513,104,409,531,49,465,399,65,324,399,42,357,558,58,493,570,76,464
2120700C101,649,161,488,669,84,574,495,112,379,493,82,411,744,103,635,724,122,577
2120700E101,742,199,543,772,115,627,514,172,329,511,126,385,805,134,656,805,143,607
2120700B101,454,124,330,464,57,396,356,96,259,356,66,290,534,73,454,538,98,405
2103500B107,476,157,319,476,101,349,353,124,222,347,122,225,502,120,372,514,154,335
2103500A104,911,345,566,919,197,675,664,255,381,659,223,436,983,238,729,987,343,604
2117700B101,438,220,218,451,161,278,275,151,118,271,140,131,447,160,281,413,153,248
2112500F101,638,185,453,654,94,529,447,139,302,444,109,335,748,125,606,778,152,557
2107300B106,1533,808,725,1528,632,801,1419,823,580,1401,692,709,1732,782,914,1780,800,909
2107300D106,237,175,62,241,143,80,197,148,44,196,134,62,302,192,100,292,189,84
2120700B102,398,96,302,410,56,342,324,86,234,323,74,249,476,72,398,485,77,375
2120700D102,558,100,458,574,59,501,388,78,304,392,62,330,599,68,525,611,72,514
2117700C106,714,299,415,718,161,531,504,233,260,490,190,300,815,183,619,842,238,542
2103500D106,1028,269,759,1034,161,820,763,232,510,758,201,557,1124,200,908,1142,274,829
2103500D105,1108,342,766,1121,262,792,797,333,450,789,284,505,1239,329,890,1243,354,849
2103500D108,663,352,311,666,303,302,371,252,103,365,221,144,764,395,345,780,377,350
2117900A103,728,405,323,739,359,348,503,321,175,499,277,222,733,360,361,708,326,347
2120700A103,600,149,451,605,61,532,447,109,326,442,85,357,656,74,576,663,111,522
2120700E103,395,97,298,401,57,331,281,80,189,278,62,216,438,70,364,438,73,351
2107900E103,699,189,510,709,112,569,497,148,341,496,129,367,763,134,619,782,140,615
2107900A103,648,236,412,651,127,493,499,186,304,491,141,350,763,165,585,777,191,541
2115500H104,405,211,194,411,146,256,317,179,131,314,149,165,487,158,326,468,173,281
2114300C102,697,277,420,703,200,482,537,227,300,533,216,317,732,180,548,731,202,503
2103500A103,1178,397,781,1175,241,884,868,277,572,857,239,618,1345,311,1018,1344,421,888
2103500C103,469,168,301,468,121,330,323,133,178,323,128,195,496,143,348,488,163,313
2102300E101,417,123,294,428,80,324,299,132,158,296,116,180,546,105,432,549,132,389
2121900C102,459,94,365,459,92,347,303,119,180,293,94,199,527,118,397,529,143,355
2111700C106,556,228,328,560,212,312,335,181,148,337,149,188,649,286,351,658,326,311
2111700A104,407,168,239,397,172,199,264,148,114,259,121,138,427,212,205,446,220,207
2111700A108,646,369,277,663,376,239,373,264,102,369,252,117,734,468,249,757,487,242
2115900A102,164,34,130,176,20,153,141,25,106,143,28,115,213,25,186,213,28,178
2115900D102,251,60,191,263,29,230,148,48,99,149,36,113,239,27,209,237,35,200
2115900A101,347,85,262,365,33,324,213,60,150,208,48,160,384,56,325,379,59,315
2115900B103,262,51,211,281,25,251,153,36,113,156,37,119,293,26,263,293,33,254
2121500B102,900,256,644,904,174,686,746,256,478,734,191,543,1092,235,839,1114,258,797
2121500B101,980,327,653,993,196,757,728,269,446,720,204,516,1154,242,898,1143,265,816
2117900C101,701,340,361,714,288,396,604,350,249,595,273,322,780,317,450,763,300,425
2121500D104,127,44,83,127,32,91,105,42,63,104,35,69,166,46,118,163,47,109
2104900B105,615,239,376,621,140,453,531,217,304,525,195,330,710,184,514,727,218,477
2117900C105,819,291,528,830,202,585,603,223,361,588,178,410,905,223,667,921,258,623
2117900E101,596,240,356,598,156,428,472,213,250,462,160,302,672,174,493,647,214,425
2101500A121,1559,378,1181,1570,396,1072,1198,524,651,1173,399,774,1918,585,1296,1911,589,1237
2101500A109,1202,322,880,1204,309,809,735,302,408,727,231,496,1289,400,858,1322,440,808
2101500A116,632,155,477,632,149,448,408,153,245,406,115,291,694,197,486,686,217,447
2112300D103,242,71,171,241,39,193,163,43,117,164,40,124,255,42,210,261,52,197
2112300D101,603,182,421,616,107,486,448,163,277,450,108,342,695,123,562,668,142,514
2110900B102,792,153,639,822,78,724,599,135,455,594,92,502,920,98,814,924,109,781
2111500A106,533,172,361,552,75,460,400,151,234,393,128,265,583,89,485,583,114,450
2111500B110,429,128,301,456,47,389,275,87,180,271,78,193,459,57,391,462,74,372
2111500A105,585,160,425,607,70,516,455,144,295,457,124,333,731,117,604,729,131,573
2107300F103,524,255,269,523,147,352,446,225,207,444,177,267,584,179,395,604,248,332
2107300A101,834,463,371,833,374,411,766,479,274,746,378,368,894,436,441,902,431,437
2107300E102,1288,719,569,1286,496,708,1188,676,479,1167,560,607,1446,611,804,1484,711,710
2107300B108,597,322,275,591,238,308,524,309,200,515,259,256,631,280,334,663,303,327
2107300E101,818,452,366,827,362,422,829,505,304,818,426,392,1097,514,564,1098,521,533
2121900E101,334,92,242,333,81,242,175,54,113,166,45,121,366,95,260,365,118,225
2115900C101,484,144,340,517,50,458,286,76,205,282,61,221,512,62,444,512,80,420
2112700A101,278,119,159,286,55,218,207,85,116,205,76,129,283,56,222,277,71,193
2123500C110,180,62,118,185,34,145,118,37,79,117,29,88,224,46,174,218,51,152
2110900A103,550,75,475,575,42,524,437,59,373,439,31,408,611,50,557,608,50,548
2110900A101,349,66,283,368,28,330,285,53,223,282,42,240,409,35,370,416,47,345
2121900C101,548,173,375,551,155,377,354,160,184,350,134,216,688,238,436,702,282,386
2110900B101,517,92,425,548,42,495,367,55,296,364,42,322,634,54,575,624,68,538
2121900D102,869,218,651,887,204,663,552,232,304,536,189,347,957,256,689,951,303,612
2121700F101,435,133,302,446,66,368,354,116,234,351,96,255,523,81,437,513,119,378
2117700C101,925,318,607,929,210,698,733,303,419,724,236,488,1037,233,796,1059,248,777
2117700B104,839,385,454,865,215,631,598,271,314,591,223,368,993,244,737,960,307,594
2112300B102,412,183,229,414,96,289,304,140,159,306,101,205,498,120,364,512,156,304
2104900F104,228,188,40,233,185,44,159,134,22,162,130,32,300,249,51,227,175,51
2104900C102,626,286,340,637,185,417,474,212,250,463,166,297,692,230,446,692,247,407
2104900B104,543,200,343,541,113,408,421,149,267,422,120,302,626,150,468,647,185,440
2101300E104,390,103,287,411,60,346,233,63,164,233,67,166,420,61,357,399,82,311
2108100B101,544,151,393,550,131,390,341,137,190,333,114,219,607,145,449,620,158,420
2115900D103,271,44,227,293,12,278,143,20,119,141,17,124,265,15,248,266,21,241
2112700D102,229,75,154,239,22,209,124,30,93,120,27,93,266,25,238,277,50,209
2103500C108,494,188,306,489,131,322,371,161,201,369,152,217,533,163,358,555,192,335
2103500B101,500,247,253,501,213,262,352,203,142,348,179,169,525,246,271,505,234,257
2103500B104,412,131,281,411,90,305,314,114,197,309,94,215,484,119,360,477,143,327
2113900D101,448,164,284,456,101,344,315,113,198,307,93,214,497,107,388,474,120,345
2101700H101,687,311,376,681,191,468,584,246,334,582,201,381,758,227,523,761,249,498
2112300D102,547,175,372,548,66,455,382,113,257,384,99,285,637,79,547,659,142,472
2115500E101,371,167,204,383,108,259,279,125,148,272,119,153,411,106,301,417,125,269
2102100F104,486,234,252,479,175,281,419,198,213,415,150,265,572,233,330,576,230,324
2105900D102,563,241,322,567,143,406,399,156,233,389,137,252,572,163,404,547,220,315
2103900A102,395,131,264,401,72,316,290,87,197,291,96,195,402,77,321,404,92,288
2103900C102,441,152,289,448,102,335,299,107,184,291,104,187,439,106,332,417,103,308
2107900A104,789,258,531,786,143,620,605,188,406,598,130,468,875,175,690,884,195,654
2110500A102,367,174,193,373,124,239,279,110,167,278,109,169,372,124,241,355,121,215
2110500B102,354,112,242,356,70,279,250,87,157,249,83,166,377,74,298,380,82,285
2107300B102,607,382,225,595,315,248,701,439,252,695,387,308,859,460,385,856,449,384
2107300C109,728,479,249,727,391,294,606,413,176,600,376,224,768,444,307,762,434,287
2107300A105,441,341,100,440,307,104,387,303,75,384,288,96,440,328,103,411,291,108
2101300B102,220,53,167,229,37,185,165,51,114,166,47,119,264,43,217,280,49,207
2101300B107,383,71,312,404,41,359,225,41,179,227,40,187,434,44,387,425,60,356
2101300D101,236,77,159,245,73,160,147,70,75,142,58,84,253,77,170,269,64,178
2101300A102,350,107,243,373,62,307,240,90,148,232,86,146,366,61,303,348,83,253
2105100C103,267,62,205,280,18,243,176,44,131,176,29,147,281,21,258,279,28,238
2111300D107,288,111,177,288,62,203,230,95,130,228,79,149,291,85,200,286,105,172
2107900D104,466,156,310,469,91,366,395,127,263,392,95,297,575,122,448,564,130,420
2104900C101,741,279,462,751,189,530,618,242,363,613,199,414,839,242,584,847,248,570
2105900A120,1803,818,985,1814,654,1042,1385,734,626,1367,636,731,1936,792,1103,1938,794,1023
2100100D103,369,93,276,383,47,328,252,67,182,250,52,198,426,52,371,409,76,326
2100100E101,479,95,384,502,43,450,362,74,284,357,50,307,574,49,522,561,79,466
2101300E101,502,136,366,508,83,418,271,112,154,266,86,180,504,82,419,506,107,387
2101300B104,333,107,226,355,57,292,151,59,91,150,53,97,353,57,293,333,84,240
2111500A104,222,66,156,252,30,214,158,59,94,156,58,98,267,50,213,266,55,199
2111500B103,332,115,217,339,51,279,225,91,130,228,76,152,350,55,292,349,64,270
2112100A106,614,145,469,639,69,552,481,131,336,475,90,385,714,85,621,740,106,598
2112100B101,124,43,81,141,28,109,68,20,48,70,21,49,147,31,114,127,29,95
2108900C102,640,228,412,643,97,523,470,175,286,466,154,312,748,120,618,791,189,559
2108900B111,635,283,352,646,124,499,408,155,245,402,142,260,750,152,587,752,235,476
2111300C105,1002,390,612,1013,233,723,834,362,455,828,264,564,1207,334,850,1232,372,814
2101700H102,569,416,153,573,340,211,419,282,132,418,251,167,646,403,235,558,334,203
2101700G102,643,365,278,651,239,384,470,263,197,469,215,254,692,271,410,654,280,352
2103900B101,674,169,505,678,92,568,530,125,397,525,127,398,717,103,610,735,125,582
2103900B102,281,50,231,277,29,239,216,36,177,213,34,179,295,33,260,317,37,269
2117700A106,341,171,170,349,96,248,243,126,110,239,113,126,376,103,271,349,128,209
2112100B106,275,64,211,294,27,260,167,44,121,164,34,130,327,33,291,329,47,267
2112100E105,1046,276,770,1070,148,892,812,207,592,809,150,659,1204,182,1012,1241,205,990
2100900F103,1052,445,607,1066,281,758,773,351,401,764,295,469,1328,382,933,1276,378,844
2111500C106,181,74,107,197,44,149,120,33,86,125,36,89,205,36,169,202,39,155
2107300A103,368,305,63,368,282,67,335,276,49,328,255,73,377,304,66,341,263,69
2102300A101,505,106,399,522,86,415,380,143,225,374,113,261,609,95,504,631,108,467
2104900C104,800,294,506,789,186,574,679,284,388,672,204,468,900,243,645,929,267,636
2111700B119,270,58,212,269,51,213,203,66,133,201,52,149,327,73,253,301,87,212
2107300F104,612,382,230,610,290,284,547,362,163,539,324,215,649,334,302,646,353,269
2118700D103,359,123,236,361,83,261,243,86,153,243,70,173,364,80,279,366,94,257
2100900D101,761,253,508,763,117,620,549,177,355,546,158,388,799,136,653,838,184,604
2110700B009,447,142,305,446,77,349,305,115,180,302,90,212,476,99,367,486,136,325
2110700E031,443,128,315,444,69,362,300,92,204,296,72,224,445,83,357,447,116,315
2123500C114,172,34,138,175,10,164,137,25,109,138,12,126,192,12,179,192,26,163
2110100C104,520,234,286,526,128,379,358,144,204,351,119,232,576,140,426,578,163,366
2101300D102,379,150,229,424,133,273,217,107,106,209,99,110,418,133,276,393,119,244
2101300D105,278,78,200,286,62,212,180,73,103,180,61,119,309,68,236,318,68,235
2101300C105,537,158,379,560,91,452,337,140,195,334,113,221,638,105,524,638,143,464
2101300E103,354,78,276,367,49,308,223,59,163,223,56,167,356,48,304,366,60,288
2101300A104,299,54,245,324,44,271,153,39,112,154,32,122,329,45,279,333,43,266
2110700F037,188,56,132,190,31,154,133,43,89,131,35,96,215,42,172,213,57,149
2110700A001,364,132,232,366,75,282,229,87,137,225,83,142,373,91,278,365,119,232
2114700A104,321,50,271,344,33,308,271,82,176,260,35,225,406,38,367,393,38,345
2114700F108,210,28,182,230,7,220,193,28,163,186,15,171,257,8,249,245,20,220
2112100C103,848,238,610,889,122,740,647,239,389,637,186,451,975,146,818,979,172,763
2112100B108,494,126,368,512,53,449,364,113,243,360,83,277,574,65,505,575,93,469
2112100C104,464,146,318,493,69,404,338,130,198,332,89,243,526,81,437,526,103,390
2112100E103,360,107,253,370,46,312,240,82,152,239,54,185,419,58,356,430,80,327
2101300E102,271,64,207,273,30,238,184,56,125,177,42,135,318,35,280,332,58,256
2101300B101,155,61,94,163,47,115,89,41,44,88,38,50,188,54,134,174,55,116
2101300B106,45,21,24,44,10,34,29,11,16,28,10,18,44,10,34,41,16,25
2110900B103,601,98,503,637,59,569,471,97,360,470,68,402,712,73,635,705,70,611
2105900A101,967,489,478,977,370,541,585,340,221,583,289,294,1033,442,566,1047,469,491
2109300E001,529,237,292,532,199,293,396,230,158,394,179,215,528,227,286,534,222,284
2109300E003,1106,460,646,1114,357,698,825,396,411,828,290,538,1229,451,754,1222,477,696
2109300C004,1259,449,810,1273,329,877,968,409,546,963,287,676,1395,417,949,1404,467,874
2110700A005,291,71,220,299,32,259,188,46,139,186,43,143,310,41,266,307,66,229
2110700F040,464,115,349,475,63,394,299,95,195,298,74,224,483,78,400,482,107,359
2111500B104,357,129,228,383,45,329,237,73,160,238,67,171,378,55,317,377,63,306
2111500C104,179,68,111,184,37,145,112,49,60,112,51,61,161,39,122,162,37,123
2110700D027,838,246,592,843,178,620,642,280,350,635,203,432,867,222,627,917,228,608
2109300D004,1425,647,778,1431,558,815,1081,546,520,1073,433,640,1733,759,947,1687,724,902
2109300C006,1055,393,662,1061,270,741,803,377,405,800,291,509,1167,342,801,1180,409,714
2110700A007,455,135,320,466,78,380,341,100,230,335,80,255,583,117,462,554,150,395
2110700E033,573,157,416,582,96,467,382,130,243,382,105,277,622,124,491,626,151,443
2100900F101,611,246,365,617,154,442,412,181,222,406,143,263,672,185,481,659,184,447
2100900C104,782,272,510,789,117,648,578,178,394,567,130,437,839,138,691,855,200,614
2105900G101,1095,393,702,1103,226,832,811,296,499,802,247,555,1162,273,875,1151,379,726
2100900E104,822,283,539,816,141,645,611,201,404,602,187,415,897,172,713,940,216,672
2100900F102,800,332,468,816,199,573,533,225,298,531,191,340,910,247,645,927,258,595
2100900D102,1194,478,716,1198,211,949,905,308,586,901,222,679,1355,264,1077,1351,374,918
2123900E102,574,344,230,578,285,261,476,305,166,470,271,199,651,366,275,607,329,265
2110700D024,618,162,456,625,112,496,441,150,282,438,113,325,652,140,505,647,151,471
2110700B008,402,170,232,410,143,261,274,147,122,273,140,133,443,177,263,405,156,237
2110700C022,286,185,101,287,169,102,203,147,51,200,133,67,308,202,99,295,164,99
2123900A101,652,330,322,643,242,365,552,298,238,545,261,284,671,295,365,669,299,351
2110700E034,592,219,373,610,146,445,412,179,218,406,145,261,640,182,451,611,204,384
2109300F006,752,256,496,756,141,577,588,225,353,585,159,426,839,182,638,867,272,547
2109300B003,973,585,388,975,534,401,728,446,262,720,378,342,1167,701,447,1110,631,432
2109300A009,437,176,261,443,160,241,161,85,71,161,72,89,533,224,289,555,202,312
2109300G006,1094,371,723,1093,231,805,906,348,532,905,243,662,1303,321,955,1338,423,855
2109300F001,867,325,542,866,237,594,665,274,368,662,206,456,961,301,644,963,339,586
2109300H006,1492,606,886,1500,433,982,816,425,369,810,323,487,1338,479,824,1376,551,741
2110700C016,548,154,394,557,100,434,396,155,237,389,126,263,591,129,453,602,147,418
2111300E103,639,215,424,636,136,464,539,185,346,535,137,398,794,227,556,768,247,504
2111300C104,810,357,453,808,223,536,636,318,304,635,264,371,903,298,588,912,318,563
2111300E102,983,306,677,975,226,700,875,286,587,872,244,628,1189,364,812,1133,340,778
2105500E101,356,100,256,362,62,287,250,79,165,249,75,174,356,68,280,364,74,262
2108100C104,429,91,338,426,76,340,291,74,211,294,62,232,516,90,422,504,103,390
2108100A107,455,145,310,459,129,313,327,154,168,319,124,195,536,150,377,539,159,347
2108900A110,812,310,502,820,180,621,557,224,319,550,191,359,875,201,665,895,234,618
2108900B110,351,135,216,363,70,285,260,103,152,252,100,152,401,81,317,394,106,276
2108900B108,863,384,479,876,201,643,592,266,312,584,236,348,934,226,695,934,293,595
2116100A104,460,243,217,474,209,233,264,146,109,255,129,126,504,242,249,489,232,234
2116100C105,591,180,411,608,109,481,383,123,244,375,105,270,667,131,529,652,176,457
2111300C103,715,400,315,723,285,383,550,332,206,547,289,258,874,403,445,844,378,414
2111300A106,899,332,567,907,199,665,749,302,440,747,223,524,978,257,706,1000,286,681
2104500D103,541,125,416,549,54,476,380,101,273,385,65,320,571,61,503,582,79,471
2112100D101,339,122,217,363,66,290,279,107,164,270,85,185,382,75,305,350,84,258
2100900G102,563,322,241,563,192,345,364,193,161,360,153,207,657,245,400,614,258,315
2100900A102,497,299,198,504,235,239,319,176,134,312,162,150,497,254,234,453,202,220
2116100C102,843,341,502,850,278,535,679,338,334,658,267,391,993,353,625,996,355,595
2116100B108,783,298,485,796,207,550,627,279,336,618,236,382,897,255,625,910,302,559
2116100A101,392,230,162,402,206,177,283,186,90,273,164,109,405,222,176,387,203,163
2117300B105,690,286,404,697,175,502,510,174,330,512,160,352,787,202,576,787,224,543
2117300A106,611,318,293,613,210,381,453,240,206,448,211,237,719,252,454,702,258,409
2123500B105,546,157,389,549,97,433,365,109,249,365,90,275,573,112,450,578,112,434
2123500D101,748,217,531,773,76,679,498,136,355,495,97,398,821,90,722,802,158,606
2123500A106,471,133,338,479,79,391,339,121,203,334,77,257,524,95,423,511,99,392
2123500D106,862,204,658,883,107,761,701,186,491,701,135,566,1117,149,956,1093,176,888
2123500A107,273,98,175,284,54,225,198,88,102,199,57,142,313,66,244,289,73,204
2123500C109,160,55,105,158,39,112,126,54,70,123,40,83,168,46,119,172,40,120
2108900A102,639,298,341,641,168,442,452,221,220,448,197,251,679,189,478,687,227,424
2123500A109,722,220,502,726,140,553,524,203,306,523,135,388,770,164,586,781,160,571
2102300C101,392,127,265,398,96,283,323,154,160,310,119,191,454,98,348,461,121,308
2111500B102,310,103,207,314,35,267,229,106,115,229,93,136,347,55,287,346,67,259
2123300C101,632,268,364,639,215,410,455,221,227,447,207,240,693,252,435,672,222,410
2122500B102,431,167,264,439,97,333,265,120,135,256,107,149,479,114,362,455,134,308
2123300A102,355,123,232,365,67,285,239,90,146,240,82,158,381,77,297,390,100,256
2121100D105,589,231,358,590,175,383,459,209,244,460,159,301,723,240,471,727,257,436
2121100B101,691,228,463,695,156,512,559,204,344,559,161,398,822,206,604,822,244,541
2121100F101,833,257,576,825,232,552,719,246,465,711,201,510,942,297,631,959,267,652
2123300A103,507,160,347,515,80,417,320,96,214,315,78,237,517,89,421,525,126,371
2123500D105,512,138,374,519,60,450,322,99,217,322,68,254,548,70,473,538,99,422
2122100G101,545,140,405,551,118,407,419,149,269,413,129,284,595,132,451,619,148,424
2122100G102,395,130,265,393,109,275,261,101,156,261,94,167,407,116,288,399,130,262
2123300C102,325,103,222,330,76,246,188,57,127,184,50,134,333,84,246,332,80,234
2122100E101,448,129,319,450,113,317,286,107,168,285,95,190,471,123,339,487,132,323
2122100F101,266,51,215,271,44,218,177,36,137,180,40,140,298,50,245,288,55,228
2122100C101,854,300,554,872,254,591,573,251,311,567,212,355,952,285,655,941,318,581
2111900B104,154,55,99,166,24,140,127,67,57,122,55,67,171,22,147,169,38,127
2111900B103,161,71,90,168,42,121,116,53,60,116,45,71,182,46,132,178,48,121
2119300B103,301,113,188,306,72,223,204,113,90,205,99,106,297,77,213,310,79,211
2119300B104,188,92,96,207,64,138,146,77,67,145,75,70,205,69,133,178,65,108
2119300A102,281,95,186,291,43,244,205,77,128,200,74,126,265,44,219,267,62,196
2119300A110,282,104,178,288,56,220,208,85,116,206,67,139,284,61,217,293,75,207
2121100D102,688,251,437,686,171,485,571,226,335,564,173,391,773,215,546,775,256,487
2121100A105,506,215,291,519,172,330,456,196,255,453,158,295,742,270,463,701,274,404
2120900B113,569,246,323,565,165,350,434,224,197,430,178,252,594,204,366,631,229,352
2120900B101,709,311,398,717,231,421,579,307,255,572,260,312,941,358,554,967,364,546
2116100C103,505,156,349,511,92,397,359,139,207,357,106,251,515,103,406,519,143,362
2116100B106,713,229,484,728,159,548,537,191,332,522,161,361,793,188,597,783,222,535
2105100F101,415,87,328,435,33,392,285,79,200,282,49,233,456,42,410,453,48,382
2100900B103,428,143,285,444,61,357,337,86,248,332,72,260,486,76,401,514,111,362
2114100E103,662,164,498,666,134,504,480,186,288,466,148,318,748,153,578,776,188,525
2114100A104,989,268,721,994,198,764,728,249,450,715,214,501,1230,245,966,1225,285,868
2114100F102,887,227,660,892,199,659,671,258,400,655,204,451,1033,254,756,1033,289,689
2100700D102,252,80,172,255,37,213,208,57,148,208,54,154,259,37,221,254,54,195
2100700C103,171,61,110,173,28,140,138,52,83,133,43,90,177,28,148,171,42,126
2122100X002,0,0,0,0,0,0,0,0,0,0,0,0,0,0,0,0,0,0
2114500A119,491,333,158,501,322,157,322,234,80,319,226,93,498,346,144,454,293,146
2121300D102,437,130,307,443,108,313,303,134,167,301,103,198,471,126,336,474,138,313
2101900A106,380,164,216,386,84,283,254,121,124,250,117,133,432,115,311,432,139,274
2101900A118,790,265,525,801,141,632,583,229,342,582,207,375,866,168,688,897,202,661
2101900A108,358,152,206,362,82,270,236,92,138,233,85,148,403,104,295,399,127,259
2101900A105,373,151,222,375,78,286,283,123,153,285,110,175,442,105,333,425,127,287
2101900C109,246,129,117,253,93,150,176,101,73,174,99,75,262,106,152,251,105,135
2100100G102,729,195,534,746,122,593,501,165,326,495,110,385,722,119,593,743,140,559
2100100C102,483,147,336,490,96,365,337,96,234,336,74,262,539,109,421,566,123,406
2115700A102,842,346,496,846,221,588,621,222,392,617,201,416,913,244,656,905,251,618
2115700C101,886,292,594,882,163,676,656,223,410,648,205,443,915,178,719,930,222,671
2114100F103,518,219,299,524,229,281,373,200,168,365,178,187,606,271,329,597,276,289
2109300B002,904,507,397,910,440,414,573,336,218,567,292,275,1024,553,445,1008,524,426
2109300A005,659,344,315,673,289,342,453,243,206,451,206,245,690,335,338,677,327,311
2109300A004,660,376,284,664,331,296,461,261,190,456,222,234,740,411,314,716,384,300
2109300H001,998,339,659,1001,241,702,746,313,423,738,223,515,1048,294,733,1068,340,686
2109300C002,841,403,438,846,367,427,564,345,212,560,279,281,880,431,428,874,389,438
2109300D002,1073,434,639,1082,391,647,825,387,431,827,266,561,1287,524,742,1253,478,730
2109300F003,1240,396,844,1234,267,918,970,383,559,970,271,699,1445,361,1061,1465,440,973
2109300F004,1043,343,700,1053,243,748,845,344,484,833,229,604,1120,301,791,1148,348,737
2109300H007,768,299,469,771,191,536,712,245,453,704,191,513,1074,289,766,1082,367,668
2109300H005,1292,665,627,1299,565,677,889,500,372,876,400,476,1726,847,850,1671,821,786
2109300F002,806,234,572,808,130,646,593,209,369,586,147,439,853,160,678,871,237,599
2110700D023,725,160,565,730,96,615,517,151,364,512,106,406,821,132,682,822,162,635
2110700D025,401,228,173,406,202,183,239,145,87,235,138,97,448,253,186,433,213,179
2110700F042,410,115,295,419,64,341,256,80,171,254,74,180,400,74,320,404,99,280
2123900E101,680,418,262,673,295,340,511,318,186,502,275,227,676,341,323,649,360,272
2123900G101,838,410,428,828,327,446,778,422,348,770,355,415,924,427,479,925,398,501
2120900A100,607,234,373,615,137,444,532,210,307,527,169,358,752,195,540,756,253,472
2122100A101,840,259,581,858,223,608,551,224,314,540,205,335,938,251,675,924,275,610
2109300A008,714,364,350,719,313,363,464,245,207,462,213,249,833,408,404,819,390,388
2109300E005,773,350,423,769,272,436,523,272,243,525,203,322,814,332,455,851,351,440
2102700B101,478,186,292,488,111,354,382,164,202,369,141,228,562,132,421,558,159,374
2112900A101,178,73,105,186,37,144,141,45,91,138,42,96,184,38,142,171,43,123
2122900C102,360,119,241,362,63,285,258,89,164,262,73,189,378,70,301,388,92,278
2102700B102,526,207,319,536,135,375,389,185,192,387,128,259,608,159,438,611,174,403
2102700A101,823,338,485,841,250,567,648,314,322,643,243,400,977,296,669,935,287,617
2116300C102,699,257,442,707,139,543,525,175,339,519,154,365,849,175,656,851,223,584
2121100D103,614,270,344,619,219,352,461,250,203,453,180,273,706,283,406,720,283,393
2109300A001,351,144,207,352,89,254,266,122,135,258,96,162,351,101,246,341,135,200
2115700A108,565,219,346,565,106,430,439,162,270,428,143,285,587,115,463,604,159,414
2115700C107,309,104,205,307,70,229,230,87,138,230,78,152,312,75,235,307,77,223
2114100D101,587,131,456,596,89,480,399,96,292,379,91,288,650,98,540,664,123,497
2122700F101,653,186,467,650,132,504,487,182,298,481,134,347,725,174,546,707,225,466
2122700D109,784,259,525,779,236,496,652,318,318,640,273,367,928,334,575,943,336,560
2118300D102,726,236,490,742,142,561,544,147,383,539,127,412,813,169,628,830,193,573
2118300C102,546,194,352,565,111,433,366,144,217,365,127,238,587,125,454,574,148,385
2118300E101,776,234,542,790,137,642,511,165,329,501,127,374,817,151,662,782,176,584
2118300C104,633,234,399,644,114,502,442,199,234,435,154,281,658,127,522,669,178,434
2118300C103,823,289,534,823,180,612,584,262,301,579,192,387,882,208,663,879,229,605
2109500E102,668,190,478,691,91,591,397,121,263,394,111,283,670,97,569,664,124,517
2109500C109,306,114,192,324,64,252,207,87,117,206,86,120,322,67,252,304,88,210
2122700B108,247,145,102,248,144,90,138,96,39,137,86,51,293,190,97,294,174,102
2101900B103,385,208,177,392,144,223,247,151,94,247,135,112,414,169,234,411,175,211
2101900B114,431,240,191,429,176,229,272,164,102,271,141,130,433,195,226,436,190,216
2101900A115,479,267,212,479,183,272,326,180,141,325,153,172,498,210,279,485,220,249
2101900B109,489,235,254,495,166,312,322,170,143,323,163,160,511,188,315,498,191,293
2120500D102,525,281,244,540,173,353,412,223,183,403,211,192,560,171,379,532,205,300
2100500B102,1245,481,764,1243,293,878,969,441,506,962,343,619,1406,366,1009,1442,386,978
2101900C113,550,232,318,556,136,405,347,168,169,341,150,191,591,160,424,592,196,382
2122700E104,413,126,287,414,90,305,306,110,180,305,97,208,443,116,321,444,148,278
2122700C111,911,275,636,904,230,593,783,356,410,777,285,492,1062,333,701,1123,363,692
2108700B101,560,142,418,587,74,497,451,112,331,440,94,346,658,85,565,658,108,520
2122500C104,190,57,133,190,17,169,121,48,68,118,30,88,194,19,173,203,43,147
2122500C101,469,151,318,468,64,398,364,125,235,357,96,261,476,70,403,475,113,345
2122500E104,351,113,238,356,69,270,264,97,163,261,86,175,381,81,291,412,90,276
2123300C104,398,117,281,407,79,322,295,122,171,291,103,188,416,88,326,400,92,302
2118300A101,592,205,387,593,135,433,406,211,187,397,157,240,660,162,488,675,169,455
2118300B103,412,143,269,417,80,330,269,100,161,268,79,189,445,91,351,423,111,299
2108500D101,715,280,435,720,182,510,508,201,295,497,167,330,751,206,534,754,231,461
2108500B103,237,88,149,242,61,177,216,76,134,217,59,158,310,92,213,315,96,200
2100500F102,421,148,273,423,80,327,386,125,256,384,106,278,541,112,421,545,133,391
2100500F103,281,118,163,281,60,214,240,85,153,239,80,159,338,79,256,327,99,218
2118300B102,936,336,600,953,208,716,679,351,312,661,239,422,1037,243,783,1007,268,685
2118300B101,583,224,359,598,163,410,426,211,191,425,159,266,661,195,458,640,183,419
2118300E102,534,153,381,541,62,463,345,101,236,342,69,273,571,71,494,568,119,424
2104500C103,322,62,260,331,30,294,244,41,200,246,26,220,370,36,332,373,42,315
2101900A107,712,308,404,725,151,559,454,175,267,451,161,290,777,179,591,771,263,488
2101900B101,380,195,185,381,154,214,256,150,103,253,134,119,441,194,241,430,177,237
2101900A101,558,322,236,572,216,324,379,234,136,378,224,154,616,257,345,598,276,287
2101900C103,350,159,191,360,90,256,244,124,116,241,114,127,398,113,279,383,127,239
2101900C108,411,200,211,415,132,265,271,155,114,271,144,127,445,157,281,438,170,256
2101900A109,319,150,169,322,78,235,199,88,106,199,78,121,328,93,233,320,113,199
2101900A119,490,208,282,500,123,365,367,177,177,366,163,203,568,157,403,556,172,359
2116500B101,706,323,383,724,182,519,547,245,291,542,239,303,837,217,608,832,246,552
2101100A104,164,78,86,169,44,122,114,53,58,116,48,68,184,48,134,176,59,112
2101100A103,202,80,122,206,46,153,178,82,90,178,69,109,247,56,185,257,67,174
2118300D104,380,114,266,377,72,294,280,93,174,283,76,207,417,85,328,426,93,311
2118300D101,584,206,378,597,111,450,386,128,246,379,99,280,576,117,446,594,149,391
2122100D103,207,81,126,209,64,139,118,42,74,119,41,78,214,68,145,210,81,124
2101900B115,607,299,308,615,206,383,421,241,170,418,202,216,667,246,410,660,257,376
2101900A121,582,240,342,581,132,424,397,182,208,400,165,235,593,152,431,609,175,402
2101900B119,423,172,251,427,109,303,289,130,150,284,118,166,476,135,335,484,153,317
2114700D103,182,50,132,193,26,161,162,61,98,158,46,112,213,29,182,216,36,159
2114700D105,195,40,155,204,16,187,189,52,135,177,37,140,218,17,201,205,27,178
2114700F104,470,127,343,490,74,405,414,134,267,405,91,314,557,83,468,562,94,422
2116500A102,247,106,141,256,62,192,191,77,111,188,70,118,270,55,212,268,63,194
2104700A101,182,132,50,187,141,43,114,92,22,112,89,23,187,145,40,184,140,42
2122700A112,623,303,320,628,298,286,390,245,138,388,225,163,786,429,337,788,399,347
2116100A103,575,284,291,579,231,318,352,221,124,346,198,148,667,288,365,662,291,338
2111900B102,254,106,148,267,61,203,202,91,106,197,79,118,291,66,222,290,80,203
2122700C104,684,346,338,682,338,293,544,354,181,533,310,223,768,436,309,782,408,328
2118500F105,1177,425,752,1173,331,759,875,437,415,864,347,517,1283,449,806,1309,514,748
2122700F111,451,98,353,447,85,341,383,104,278,381,82,299,603,139,457,594,146,435
2123100A103,593,197,396,620,119,485,418,170,243,418,129,289,742,148,583,716,160,530
2122700E107,916,391,525,914,342,518,639,350,272,631,301,330,977,427,529,983,446,493
2122700E102,950,355,595,959,210,711,664,269,380,660,225,435,1031,269,746,1023,416,574
2122700C105,518,228,290,509,207,264,443,249,188,441,228,213,544,259,271,569,261,273
2122700F102,977,301,676,976,249,654,718,315,386,711,256,455,1161,359,773,1202,398,734
2122700A104,530,220,310,529,226,278,428,254,168,424,225,199,583,286,288,570,255,295
2122700D110,662,154,508,658,146,477,496,179,312,485,143,342,722,193,518,715,186,507
2104700G104,844,264,580,848,239,586,660,246,398,641,195,446,1075,329,732,1059,374,650
2104700G102,442,212,230,442,206,198,96,62,32,96,56,40,608,308,269,663,326,280
2109500C107,271,81,190,288,47,231,157,68,86,156,53,103,297,52,241,291,64,216
2102900B114,878,277,601,890,186,654,670,318,335,661,242,419,1041,241,777,1070,265,742
2102900A105,1018,316,702,1031,190,803,736,244,469,718,204,514,1150,233,902,1144,286,818
2102900C103,941,365,576,950,239,675,827,390,429,825,302,523,1389,381,987,1354,429,874
2102900A107,1139,375,764,1156,238,875,888,340,533,877,250,627,1272,287,968,1255,334,877
2102900B108,1432,454,978,1438,330,1056,1014,478,515,998,343,655,1627,412,1195,1620,419,1149
2102900B111,983,357,626,1004,241,708,998,439,537,982,346,636,1571,427,1114,1574,471,1021
2118500G101,1200,369,831,1203,394,742,875,408,448,860,308,552,1442,574,845,1401,478,886
2118500C105,723,229,494,724,188,490,587,249,322,578,190,388,788,253,519,786,275,489
2101900C102,410,177,233,407,95,295,252,116,133,249,116,133,434,116,312,451,139,285
2118500D101,1041,425,616,1033,349,626,846,420,395,841,337,504,1285,524,737,1293,570,679
2119700C101,430,197,233,432,122,295,315,148,166,317,128,189,473,119,349,474,135,315
2119700A102,582,241,341,584,143,427,466,205,250,457,178,279,665,163,494,663,191,442
2120900A102,401,125,276,404,69,309,325,104,215,321,89,232,432,88,335,450,120,312
2120900D123,713,346,367,710,243,415,528,307,201,525,246,279,766,305,443,773,329,407
2101900C116,529,236,293,538,142,382,352,180,157,355,158,197,593,172,415,585,206,363
2101900B105,358,189,169,359,143,196,204,126,75,203,111,92,377,166,203,372,158,200
2102900D103,773,313,460,790,204,558,614,261,341,608,212,396,861,242,606,834,273,519
2102900D114,291,110,181,291,78,201,199,89,102,198,68,130,375,110,260,373,114,243
2119300C104,353,154,199,356,94,251,245,131,108,242,124,118,323,94,225,319,100,210
2108300B105,642,212,430,662,161,482,483,181,294,466,159,307,655,168,479,622,149,460
2120900G132,738,334,404,746,249,449,524,301,202,520,249,271,750,288,442,744,292,414
2120900F121,586,284,302,589,198,352,484,245,229,482,213,269,597,232,351,587,252,313
2122700A107,343,125,218,349,137,191,279,155,121,275,130,145,388,177,202,368,147,211
2108300A107,655,199,456,653,105,527,526,140,366,510,145,365,667,113,545,679,146,508
2108300A103,436,131,305,446,82,347,350,105,233,342,107,235,456,89,359,457,96,339
2108300A106,515,161,354,514,74,412,377,91,276,370,93,277,486,75,399,510,111,369
2101900B102,444,248,196,458,169,269,240,145,90,233,125,108,460,186,264,439,196,220
2109900B102,449,186,263,453,136,308,287,141,143,285,120,165,589,183,402,562,185,368
2121100F102,879,330,549,875,270,551,700,306,379,689,245,444,1042,362,660,1069,359,652
2121100B105,607,230,377,611,167,413,477,218,243,471,171,300,658,203,447,652,226,405
2118900C102,288,90,198,301,57,239,218,76,137,215,52,163,317,48,267,320,52,255
2118900B102,251,49,202,268,25,241,212,42,167,199,37,162,301,21,280,306,29,271
2121100C103,612,265,347,624,217,366,462,233,218,454,186,268,678,265,400,678,263,376
2108300B103,448,212,236,455,152,280,323,147,168,310,136,174,457,162,286,432,153,259
2108300C106,485,150,335,492,81,393,389,112,270,377,104,273,500,88,406,500,110,372
2102900D106,856,282,574,864,160,668,604,227,344,603,183,420,962,195,750,971,255,669
2123700B106,400,201,199,408,120,276,344,207,129,336,195,141,463,134,321,464,151,291
2115300A104,568,254,314,573,141,420,415,198,209,413,190,223,617,143,465,613,160,440
2117500E101,432,194,238,443,93,339,354,165,177,346,143,203,533,113,415,545,138,369
2117500A103,265,123,142,274,65,204,200,101,96,202,99,103,284,68,214,268,75,190
2118500F103,860,363,497,864,296,515,700,338,347,695,266,429,958,398,541,958,434,489
2108300B108,611,269,342,618,196,393,479,216,255,463,184,279,640,216,412,622,200,387
2108300B110,757,249,508,769,148,598,621,201,403,602,209,393,821,167,644,809,190,589
2119500B102,829,320,509,856,150,682,587,262,309,578,246,332,900,174,716,914,212,662
2118900B101,96,23,73,105,12,89,80,21,57,77,14,63,100,9,90,103,12,85
2116100B107,759,238,521,762,171,557,581,256,315,572,193,379,840,207,621,866,237,589
2122700A115,469,149,320,463,127,309,344,158,184,341,130,211,484,159,316,493,170,302
2117300B101,718,306,412,738,162,556,550,204,332,538,168,370,798,179,610,776,229,530
2117300A105,216,168,48,218,159,53,165,136,28,162,122,40,229,170,56,186,121,60
2117300C104,752,346,406,749,220,506,595,269,316,589,228,361,863,260,592,859,277,556
2108300B101,237,96,141,240,78,148,166,70,94,159,58,101,205,71,129,203,59,132
2108300C110,906,300,606,912,192,690,734,272,445,713,233,480,946,211,722,942,222,682
2115300C101,278,146,132,290,75,203,190,108,78,196,99,97,297,79,215,294,88,199
2115300B102,414,202,212,430,103,318,283,152,130,277,132,145,482,102,376,477,129,328
2115300B105,216,99,117,218,63,154,145,82,60,141,77,64,228,60,167,227,64,154
2111100N146,511,288,223,512,272,207,452,291,155,446,247,199,568,329,230,573,324,246
2111100V127,1260,611,649,1257,558,632,876,496,368,869,428,441,1468,736,704,1469,734,693
2111100H155,205,126,79,209,117,83,139,103,36,137,92,45,248,152,90,246,162,81
2111100I150,71,46,25,70,38,30,35,25,10,35,24,11,82,54,28,82,55,26
2111100D136,1027,570,457,1021,512,474,912,571,329,901,463,438,1179,663,504,1189,675,493
2111100L148,216,204,12,221,208,12,158,152,5,159,144,15,226,207,13,223,205,12
2111100G122,438,311,127,438,307,109,434,349,81,429,301,128,480,372,102,482,366,110
2111100J130,210,139,71,204,105,88,137,104,31,136,89,47,204,127,72,202,129,62
2111100K105,830,662,168,830,665,102,544,514,27,535,489,46,705,623,70,709,632,65
2111100M123,905,744,161,918,728,118,736,641,87,728,612,116,975,805,148,986,821,141
2111100K146,826,423,403,840,369,429,610,365,233,600,307,293,904,428,457,904,443,437
2111100S150,897,379,518,889,372,477,886,427,448,886,375,511,1084,499,573,1096,482,603
2122700C112,1327,475,852,1327,410,825,1065,525,528,1062,433,629,1646,608,1002,1667,645,952
2122700F114,650,186,464,645,165,445,523,214,306,521,149,372,682,209,461,685,216,442
2122700B101,508,305,203,517,304,159,295,231,61,290,208,82,502,337,145,517,309,170
2117500E102,221,105,116,228,59,164,199,92,99,196,83,113,270,71,197,260,73,177
2111100L135,531,285,246,532,288,205,453,306,145,448,253,195,575,365,207,581,357,212
2111100B149,582,254,328,590,193,362,433,219,201,424,174,250,642,263,364,641,274,332
2111100J147,610,415,195,619,372,222,423,315,99,414,282,132,629,389,218,627,412,188
2111100N134,769,618,151,773,610,127,614,518,86,605,479,126,910,719,164,915,724,173
2111100N117,542,462,80,545,432,95,363,304,53,362,292,70,592,453,127,590,465,107
2119900C110,1037,238,799,1045,112,903,778,184,579,780,143,637,1157,150,994,1189,189,948
2119900E101,296,107,189,303,58,238,254,80,169,250,67,183,332,75,254,306,82,217
2105700D101,396,90,306,412,50,348,251,56,187,245,44,201,439,56,381,429,87,327
2120300E102,348,83,265,369,42,319,257,55,199,257,40,217,420,39,378,416,47,349
2105300C103,344,53,291,364,34,324,228,62,161,230,45,185,366,34,330,355,52,297
2103100A111,493,165,328,512,128,361,299,129,165,296,96,200,533,140,384,528,136,344
2106300C101,394,196,198,439,101,329,265,143,113,252,118,134,478,99,376,472,117,341
2103100A110,348,116,232,351,90,251,222,86,126,220,71,149,371,99,268,353,95,244
2113300B103,361,144,217,400,63,319,216,77,130,209,72,137,342,63,273,339,88,224
2113300C105,280,91,189,298,42,249,181,67,109,179,66,113,297,49,246,298,64,226
2108300C104,996,271,725,1003,127,849,844,231,595,821,196,625,1109,149,949,1111,214,872
2108300A105,532,148,384,536,87,426,394,111,276,381,105,276,557,96,450,578,111,436
2120300A101,898,205,693,919,136,756,651,216,425,652,165,487,1117,162,940,1108,177,874
2120300B102,650,186,464,666,96,561,482,123,355,483,88,395,786,125,658,783,129,631
2119900D109,462,112,350,473,63,397,333,81,239,333,62,271,542,87,448,552,92,427
2119900A111,124,29,95,125,12,113,87,16,70,88,16,72,135,16,119,130,22,108
2114900A102,689,274,415,703,139,539,554,202,332,545,169,376,737,170,554,738,191,494
2114900B102,519,217,302,542,150,371,394,184,195,387,164,223,544,139,395,546,160,347
2103100E105,585,128,457,591,79,485,415,120,286,412,83,329,623,88,525,653,107,487
2117500C102,394,167,227,402,78,316,333,141,188,326,123,203,488,95,389,493,119,355
2118300A105,617,204,413,627,131,467,433,167,249,424,115,309,685,155,518,725,166,479
2119900C105,952,224,728,958,90,835,748,168,563,751,122,629,1064,122,927,1102,180,870
2119900A102,837,208,629,841,117,704,669,184,476,672,143,529,975,163,804,975,171,773
2119900D103,344,84,260,358,35,311,237,52,181,237,32,205,368,43,320,370,62,289
2119900D101,354,140,214,370,103,251,264,117,144,257,102,155,396,129,259,368,105,237
2103700B903,1189,234,955,1194,231,900,962,351,579,940,243,697,1466,332,1111,1393,351,996
2116700E101,1157,436,721,1171,257,859,948,385,543,939,304,635,1322,331,967,1331,351,923
2111100N108,746,730,16,749,726,14,539,517,16,540,503,37,794,761,22,793,760,26
2111100L159,136,134,2,139,137,2,94,90,3,94,85,9,138,131,4,138,130,6
2111100N101,672,587,85,674,555,105,519,465,48,513,438,75,686,569,112,689,576,104
2111100N104,778,749,29,785,750,21,585,565,19,580,527,53,782,720,48,781,728,37
2111100M149,470,335,135,476,299,169,292,216,68,288,204,84,487,296,184,488,307,165
2111100F172,698,362,336,699,325,322,572,339,221,564,274,290,723,375,327,721,371,328
2113300A102,392,161,231,405,105,275,292,159,128,286,146,140,411,123,278,420,115,282
2113300B102,445,135,310,492,54,420,283,96,182,282,96,186,457,58,391,463,89,349
2119700C102,476,236,240,480,142,315,393,200,185,383,166,217,543,147,383,543,170,348
2119700B102,625,255,370,636,129,488,485,205,267,478,158,320,703,138,545,704,169,501
2114500A106,303,160,143,302,146,148,153,96,51,153,97,56,320,170,147,301,153,143
2111700A115,397,186,211,390,182,198,260,159,94,258,139,119,410,213,194,409,231,173
2103700C305,353,184,169,362,194,151,233,175,55,232,161,71,477,282,189,469,279,178
2103700C301,620,368,252,630,370,201,487,344,136,482,322,160,888,587,275,954,611,290
2114500A122,822,288,534,824,199,596,691,262,417,678,239,439,920,256,652,916,304,588
2114500B113,657,385,272,663,376,258,415,261,148,412,244,168,677,420,246,637,353,261
2114500A118,1042,307,735,1047,199,789,742,255,481,730,224,506,1034,232,780,1070,293,733
2102900C104,639,256,383,640,172,445,434,209,215,425,160,265,639,189,443,624,208,397
2106900E101,312,155,157,317,98,212,222,123,95,221,112,109,401,120,278,375,119,246
2111100M110,619,606,13,624,611,5,402,400,0,399,386,13,585,552,19,583,558,8
2111100Q134,509,375,134,510,327,167,376,288,86,374,269,105,560,407,146,562,412,136
2111100L161,457,440,17,463,445,13,275,266,8,276,253,23,420,399,14,420,398,12
2111700C131,696,196,500,692,195,464,502,204,284,496,172,324,714,236,468,693,251,425
2123100A101,322,143,179,339,87,241,190,97,89,181,66,115,367,98,263,364,106,217
2108300B111,720,223,497,728,129,574,527,157,356,516,150,366,752,141,601,755,165,560
2100300C101,781,212,569,801,157,608,548,193,344,538,152,386,937,193,726,946,212,672
2114500A104,291,211,80,293,189,93,190,140,46,189,131,58,292,203,85,266,185,74
2114500A110,721,233,488,730,158,553,535,190,341,532,178,354,771,192,572,759,232,509
2113300A108,238,70,168,258,24,231,181,55,118,175,48,127,269,29,239,268,52,210
2113300A101,362,171,191,375,80,278,220,122,98,217,110,107,364,90,268,357,117,223
2119300C111,201,84,117,206,33,166,132,49,79,127,39,88,202,36,163,202,60,135
2119300B108,138,64,74,142,45,92,83,48,35,89,44,45,163,57,104,158,52,99
2113300E102,136,57,79,144,44,97,80,45,31,83,47,36,163,56,106,155,44,105
2114900D102,590,244,346,601,127,445,480,189,284,472,160,312,627,165,454,636,193,403
2114900A101,315,126,189,315,71,229,248,92,148,247,71,176,315,69,242,313,82,215
2114900C101,551,185,366,560,121,405,413,155,246,407,135,272,573,117,446,568,130,395
2120300D102,400,94,306,412,62,341,298,65,228,300,55,245,475,84,388,474,83,376
2104500A101,509,104,405,518,51,444,399,90,307,400,66,334,552,59,484,583,68,472
2104500B103,297,91,206,300,64,225,249,107,138,245,85,160,349,80,266,331,65,261
2114500A102,334,231,103,331,216,89,281,213,61,281,208,73,399,286,101,395,252,118
2114500C102,470,380,90,478,363,95,319,264,52,316,260,56,539,434,97,477,373,92
2108300B106,178,95,83,185,73,102,106,54,52,100,48,52,153,64,86,139,56,75
2108300C102,686,222,464,699,115,550,561,168,375,543,166,377,733,129,590,742,168,536
2119700D103,131,66,65,132,43,83,104,44,55,104,46,58,153,53,98,153,55,92
2119700E101,600,250,350,606,134,444,472,203,258,466,170,296,684,175,492,682,197,455
2114500C120,422,250,172,427,236,171,309,214,91,306,194,112,488,297,183,463,258,186
2111100Q136,273,164,109,271,135,125,175,113,57,174,105,69,251,144,102,252,149,92
2111100J111,516,353,163,526,318,183,358,278,73,349,243,106,569,361,196,571,381,172
2111100C103,595,456,139,596,424,144,404,322,77,400,303,97,624,435,173,627,448,163
2111100M166,518,469,49,515,472,33,293,258,33,292,252,40,469,396,64,470,402,62
2111100K110,397,325,72,400,301,83,264,229,32,261,216,45,385,295,83,386,300,66
2111100L111,306,260,46,304,258,31,238,227,9,236,216,20,348,322,22,351,317,23
2111100L112,352,324,28,351,326,12,261,247,13,258,231,27,391,362,25,393,366,20
2111100I120,333,217,116,339,188,132,241,169,68,239,155,84,348,185,158,343,189,143
2111100G142,179,118,61,175,121,50,160,113,46,158,102,56,192,131,55,195,118,69
2108300A104,267,85,182,272,46,216,204,60,130,197,53,144,278,50,223,276,62,202
2108300B104,316,116,200,322,77,229,240,91,143,229,94,135,325,83,236,324,85,222
2104500A103,497,109,388,509,48,444,383,89,290,377,53,324,588,60,521,592,76,487
2111100L115,96,74,22,96,68,18,77,63,13,75,59,16,98,78,14,99,84,14
2101100B104,477,175,302,493,105,374,364,134,216,364,111,253,568,121,439,569,149,400
2123100B106,385,87,298,401,41,353,254,52,193,251,43,208,502,53,443,503,74,414
2114500C107,810,254,556,816,201,570,675,241,422,667,223,444,1006,289,696,1034,299,684
2111100L108,389,364,25,394,370,19,260,245,12,258,230,28,343,313,23,341,308,24
2111100M146,561,456,105,570,452,54,480,444,32,480,432,48,664,576,70,666,576,73
2111100K134,481,318,163,477,275,166,358,270,79,357,248,109,471,319,143,474,322,139
2111100M129,294,274,20,297,284,12,172,163,7,170,161,9,283,266,12,282,271,8
2111100J135,714,338,376,711,269,415,594,340,248,589,284,305,819,366,435,820,382,407
2111100J119,552,311,241,555,260,273,404,264,136,402,229,173,584,293,284,587,301,272
2111100O142,453,244,209,453,181,236,293,169,111,290,149,141,458,176,269,454,192,224
2111100A134,492,221,271,497,138,337,323,151,162,320,131,189,537,182,344,541,204,312
2106900B101,288,106,182,292,50,228,193,57,127,191,52,139,327,55,267,346,72,255
2111100J101,592,466,126,602,411,161,380,305,64,372,289,83,586,408,161,581,414,145
2111100J104,739,558,181,743,481,233,522,410,99,518,384,134,831,585,225,826,587,207
2111100J123,378,194,184,381,166,194,292,167,115,287,145,142,410,200,195,410,213,179
2111100A143,12,1,11,12,2,10,8,3,5,8,4,4,12,3,9,12,3,9
2111100N144,531,264,267,532,245,248,455,273,176,448,234,214,563,297,256,564,295,249
2111100N125,743,387,356,736,365,338,658,406,244,657,345,312,786,469,308,793,423,354
2111100H130,0,0,0,0,0,0,0,0,0,0,0,0,0,0,0,0,0,0
2111100J155,243,96,147,245,66,172,180,71,105,179,66,113,259,64,190,258,69,178
2113300D105,261,90,171,311,19,277,145,51,91,139,47,92,271,20,246,260,57,184
2121300A101,801,214,587,803,148,621,513,179,321,507,161,346,887,178,689,915,234,620
2121300B102,322,162,160,327,145,169,184,105,78,184,97,87,366,174,186,362,176,168
2108300C109,746,218,528,744,133,587,630,177,438,623,176,447,807,153,643,823,169,623
2108300A110,583,208,375,584,109,454,443,155,276,427,132,295,561,111,442,560,143,392
2113300A106,312,81,231,340,26,308,220,80,136,216,62,154,328,29,297,335,55,269
2111100O128,771,448,323,783,389,373,641,427,205,629,373,256,896,461,422,889,474,379
2119900A104,272,79,193,281,31,239,219,70,147,218,35,183,322,43,274,327,65,238
2119900C103,555,224,331,566,152,380,454,203,242,451,169,282,699,223,459,693,195,431
2111700B141,1490,381,1109,1501,366,1050,1120,484,601,1103,395,708,1943,562,1347,1877,621,1199
2123100G103,150,61,89,149,30,114,131,42,89,131,34,97,194,41,150,206,54,130
2115100D104,124,55,69,126,41,84,87,32,54,87,30,57,138,50,88,128,50,78
2115100A107,919,346,573,917,231,654,726,280,430,730,242,488,1005,287,706,1001,320,664
2115100D105,914,407,507,914,281,567,731,378,332,731,297,434,1152,406,712,1183,438,683
2106900D102,493,238,255,511,152,343,370,184,182,366,152,214,549,159,385,520,155,342
2106900E102,268,110,158,277,47,217,228,74,150,222,59,163,334,55,273,342,81,238
2106900C101,551,193,358,554,94,455,401,120,275,397,101,296,612,99,512,611,126,481
2111100J114,861,509,352,867,448,355,668,469,192,659,432,227,975,564,395,976,584,366
2111100E161,370,129,241,367,121,230,342,147,190,340,130,210,426,161,260,432,154,273
2111100E155,783,428,355,782,394,338,600,405,183,595,348,247,850,518,319,852,513,315
2111100B155,575,304,271,579,285,261,443,294,143,434,252,182,632,359,256,628,372,232
2104300E103,405,171,234,405,88,306,332,186,134,331,144,187,468,104,360,472,128,326
2105500E102,442,104,338,447,57,379,356,85,257,351,79,272,483,69,408,487,85,382
2104500B102,838,153,685,857,87,751,624,121,495,623,93,530,957,104,844,968,103,825
2115100C112,1096,562,534,1108,445,587,829,498,305,826,442,384,1200,544,623,1178,512,609
2115100A110,538,195,343,533,126,384,432,159,258,430,128,302,640,173,458,650,199,439
2119100B102,624,146,478,643,119,487,447,166,273,438,117,321,771,147,610,764,165,561
2119100D101,635,207,428,662,156,479,468,225,232,452,160,292,689,163,516,671,202,437
2109100A102,567,283,284,585,226,314,483,305,165,472,227,245,629,250,362,638,247,332
2109100C102,481,228,253,484,156,309,417,219,189,404,183,221,544,176,363,522,203,301
2120500C104,348,149,199,352,103,228,245,114,123,240,109,131,377,115,254,388,131,234
2120500C103,201,129,72,200,108,80,146,105,39,146,98,48,258,144,109,259,155,93
2104500C104,295,100,195,304,57,228,211,77,132,209,47,162,320,66,248,327,65,227
2107500B101,266,71,195,264,37,218,176,39,136,175,46,129,249,35,211,268,51,205
2119500A109,251,80,171,263,27,226,157,48,107,157,40,117,293,34,255,315,57,239
2104300A101,596,243,353,612,123,458,445,221,214,440,194,246,675,141,521,684,177,476
2104300D101,289,129,160,296,66,226,221,107,109,216,100,116,377,85,291,353,105,244
2108300C108,651,190,461,658,121,518,528,166,350,518,152,366,700,136,556,704,144,533
2119300A103,264,64,200,278,24,253,212,56,155,207,52,155,341,32,308,344,57,285
2121300C104,1335,394,941,1353,324,981,836,342,487,824,272,552,1483,386,1073,1465,424,978
2109100B103,315,143,172,313,87,204,286,154,114,285,131,154,346,98,239,360,128,205
2109100D103,335,121,214,348,82,248,256,103,144,251,82,169,373,88,278,374,102,243
2109100D101,372,134,238,376,75,283,301,134,155,291,101,190,399,80,313,395,112,267
2107500B104,233,75,158,233,35,191,162,36,121,162,50,112,268,40,224,285,66,201
2103700C306,260,139,121,260,139,113,147,107,38,146,96,50,341,199,139,340,208,126
2103700B807,667,164,503,667,152,486,505,183,313,493,125,368,797,209,576,772,237,504
2103700B704,884,272,612,893,278,582,627,279,335,616,228,388,970,343,616,922,350,548
2103700B806,1211,303,908,1211,292,857,928,425,478,908,279,629,1417,397,1000,1364,430,894
2123100B101,531,198,333,552,91,449,340,138,198,339,104,235,640,110,524,617,156,431
2123100B109,220,69,151,247,28,213,161,47,110,155,30,125,312,37,271,291,59,214
2123100D107,325,72,253,329,23,299,247,57,188,244,43,201,409,30,375,440,61,353
2115100B101,1112,582,530,1106,442,566,813,503,284,805,441,364,1247,569,633,1271,559,637
2115100C114,377,235,142,386,185,172,277,184,86,274,167,107,404,216,175,383,204,155
2115100D101,396,143,253,400,73,314,357,133,219,358,119,239,489,102,381,490,149,329
2115100B110,971,380,591,961,266,647,887,358,515,883,290,593,1138,369,750,1165,392,738
2115100B111,880,343,537,874,241,587,802,346,438,791,280,511,1100,336,742,1124,357,727
2115100D102,673,275,398,668,184,463,601,251,342,601,221,380,717,223,485,713,248,449
2115100D103,877,334,543,881,211,614,724,334,375,722,255,467,1065,295,746,1094,348,709
2115100B109,1016,383,633,1010,250,712,885,407,459,881,309,572,1173,331,821,1200,379,783
2100700D101,569,212,357,565,127,416,400,144,246,401,136,265,566,126,431,572,142,404
2114500A116,988,421,567,990,293,643,676,302,361,671,276,395,1049,359,669,1060,423,595
2114500C115,277,87,190,278,53,216,229,84,141,229,87,142,309,69,237,309,92,210
2114500B131,574,322,252,578,289,248,437,269,153,428,251,177,628,353,258,617,322,264
2115100A104,1074,517,557,1076,382,638,868,427,411,864,389,475,1272,509,738,1243,513,692
2100300A102,647,150,497,664,93,542,414,109,298,406,88,318,775,114,645,799,150,586
2107500C102,272,95,177,275,57,214,189,61,126,187,57,130,285,59,224,282,75,201
2111700C114,471,192,279,472,175,267,275,156,117,272,127,145,532,229,291,539,266,256
2114500B120,631,204,427,625,153,439,451,160,284,448,143,305,659,188,459,676,205,450
2114500B122,405,125,280,408,63,334,310,84,221,304,75,229,469,85,382,467,139,324
2114500A120,552,168,384,554,113,419,399,105,287,382,90,292,568,135,425,577,164,393
2114500C123,776,278,498,772,241,486,632,287,337,619,239,380,860,311,534,875,294,551
2114500B118,706,384,322,720,338,354,488,280,194,485,270,215,840,438,390,785,409,359
2114500A124,515,168,347,513,112,378,363,136,222,354,117,237,535,136,390,548,167,361
2114500C112,980,304,676,980,197,756,741,260,472,730,231,499,983,228,744,983,289,671
2114500C113,823,279,544,826,181,611,553,199,343,550,182,368,823,210,602,827,266,540
2114500B134,719,225,494,715,174,511,519,188,330,516,159,357,728,205,512,744,218,500
2109100C101,615,257,358,632,164,423,515,254,244,505,199,306,628,166,448,619,207,385
2109700A103,79,46,33,79,34,39,45,25,15,46,21,25,98,42,56,97,43,46
2100700A101,273,76,197,275,38,233,200,53,145,201,50,151,278,37,239,275,50,220
2100700E102,245,70,175,247,29,215,170,32,133,166,30,136,239,27,211,236,44,187
2109500D104,355,94,261,366,32,324,264,62,192,255,55,200,385,36,345,402,70,310
2109700D101,436,208,228,434,118,303,337,157,174,335,131,204,455,134,317,457,139,298
2120500C106,465,228,237,474,178,277,362,188,165,361,163,198,584,226,349,575,227,316
2120500A102,685,311,374,688,204,454,559,281,260,549,238,311,788,224,544,811,253,512
2109500D108,155,28,127,168,6,157,113,22,89,112,24,88,164,7,156,174,15,155
2109500A110,270,60,210,283,39,244,186,49,133,187,50,137,308,44,264,297,44,253
2100700C102,264,71,193,260,50,201,199,67,131,194,60,134,273,51,219,293,50,229
2114500C108,1042,252,790,1043,189,827,820,209,606,806,184,622,1149,241,898,1154,264,865
2119300A104,96,31,65,102,12,85,56,28,27,53,17,36,95,12,80,100,21,72
2119300A101,297,112,185,305,56,245,181,79,100,178,66,112,317,64,251,310,83,222
2119300C108,199,76,123,212,32,174,176,91,83,177,78,99,237,40,195,229,62,162
2122100F102,777,173,604,782,134,618,556,169,381,547,143,404,891,158,719,904,192,663
2104300C103,522,235,287,525,107,399,342,168,159,341,153,188,572,120,444,580,167,378
2109500C101,231,29,202,238,17,220,139,30,106,136,23,113,242,18,224,247,19,228
2109500A101,684,208,476,709,135,562,478,202,268,476,186,290,767,187,573,751,196,536
2109500E106,337,90,247,355,46,303,182,51,125,188,48,140,372,49,322,370,56,307
2109500C111,289,147,142,295,102,186,207,97,106,209,97,112,329,109,216,326,118,203
2109500C106,142,39,103,143,18,124,94,19,75,95,17,78,156,21,135,156,32,122
2109500D101,641,171,470,687,89,582,415,133,276,402,113,289,706,93,605,686,117,544
2103700B705,489,133,356,492,115,356,379,144,229,375,109,266,533,144,382,509,174,322
2115100D108,1119,376,743,1113,221,838,980,371,587,980,302,678,1368,320,1017,1429,402,966
2115100D106,809,270,539,811,161,611,751,282,455,746,230,516,1073,237,819,1110,299,778
2115100A103,744,501,243,754,455,233,431,316,102,427,302,125,634,425,189,588,348,212
2115100C102,368,137,231,364,81,268,305,111,188,314,98,216,391,99,286,401,125,265
2109700B103,55,45,10,58,43,13,41,34,6,42,34,8,79,60,19,59,40,19
2120900B105,479,195,284,483,130,336,399,161,226,390,136,254,512,158,347,494,179,305
2109700H102,404,175,229,413,113,289,304,111,185,305,100,205,467,128,336,468,128,328
2121100C101,798,331,467,800,237,506,695,344,341,693,259,434,859,288,550,885,326,502
2121100B104,1018,421,597,1027,326,650,847,408,417,830,327,503,1127,398,709,1124,416,645
2121100G101,582,309,273,582,255,295,431,258,161,431,220,211,635,305,316,640,301,289
2105700B101,193,46,147,207,35,161,132,40,87,129,31,98,225,40,181,236,46,162
2119900E108,705,230,475,728,119,590,466,141,315,462,107,355,799,156,634,757,178,550
2119900D102,297,74,223,298,40,253,223,52,164,226,48,178,358,57,298,356,63,283
2109500D103,122,47,75,134,32,98,78,26,50,76,24,52,122,36,83,120,38,70
2109500B102,291,82,209,314,39,266,159,40,119,154,38,116,324,43,273,309,60,237
2109700H101,490,181,309,499,87,394,393,126,261,396,87,309,569,87,471,575,112,423
2107100A109,557,240,317,575,94,461,385,162,206,381,178,203,579,107,465,580,126,429
2107100C109,280,185,95,301,111,180,210,126,80,209,129,80,327,88,236,330,133,175
2117100E101,408,90,318,434,70,348,274,74,191,266,51,215,456,76,375,457,78,356
2117100A102,619,97,522,653,56,575,458,101,351,446,56,390,701,62,628,711,85,593
2117100A103,130,24,106,135,21,112,68,9,58,67,8,59,121,19,101,122,17,100
2117100B101,531,73,458,555,45,495,380,88,284,375,60,315,584,48,530,592,63,510
2117100D101,408,70,338,430,42,382,305,87,215,306,43,263,458,45,410,450,60,378
2107100D102,471,234,237,503,99,389,323,220,102,324,217,107,463,81,375,463,128,319
2117100C102,236,57,179,252,30,218,174,36,133,173,32,141,270,33,235,254,49,201
2107100D107,561,247,314,575,122,439,408,175,217,410,191,219,594,140,449,589,150,421
2107100B112,500,223,277,507,108,385,329,153,169,328,153,175,480,95,381,482,121,340
2107100A107,447,199,248,466,108,340,331,180,146,325,175,150,476,128,337,480,147,306
2107100A101,343,160,183,352,96,241,274,130,143,274,153,121,381,130,246,377,138,231
2116900C101,456,172,284,471,95,367,370,142,216,349,113,236,488,90,393,459,110,333
2110300F101,283,122,161,284,90,182,189,74,111,186,65,121,301,98,200,298,99,183
2110300A102,465,215,250,471,162,294,347,170,169,345,145,200,545,191,349,517,188,307
2110300F103,560,239,321,559,150,388,428,183,237,426,145,281,627,173,448,608,203,384
2110300D102,293,126,167,300,91,187,225,114,108,223,99,124,326,104,215,317,106,198
2112700C103,189,69,120,202,29,169,133,51,79,132,50,82,261,39,220,240,53,187
2115900E101,232,73,159,242,35,202,135,45,82,134,41,93,229,29,200,229,38,187
2117100A101,164,46,118,170,18,147,135,32,102,128,27,101,198,22,174,200,43,145
2117100D102,510,92,418,545,78,460,363,106,253,358,69,289,613,89,522,590,83,493
2117100C101,496,74,422,526,43,470,362,70,286,350,40,310,564,47,512,575,64,478
2102500C105,188,98,90,197,57,133,121,70,51,120,67,53,182,45,134,174,57,111
2102500A105,226,113,113,242,69,168,137,77,58,126,67,59,149,36,111,139,43,92
2110300E102,152,56,96,158,32,117,127,59,66,128,58,70,169,36,130,161,46,110
2102500C103,361,177,184,360,95,251,258,153,102,257,140,117,379,86,287,396,117,258
2102500A103,536,204,332,556,110,429,362,171,188,353,154,199,591,98,486,612,133,460
2103300D103,598,210,388,604,139,446,503,188,309,497,167,330,650,159,483,647,173,442
2103300B103,388,209,179,394,166,212,255,133,120,255,123,132,406,181,218,384,163,194
2123300B102,542,189,353,560,102,437,353,113,229,350,85,265,573,116,448,583,151,383
2123300B105,448,155,293,453,96,348,295,132,154,292,110,182,433,100,329,423,114,294
2123300A101,628,195,433,650,111,526,451,149,287,449,128,321,691,129,556,663,161,484
2101500C130,981,348,633,974,328,589,628,290,318,617,240,377,1007,401,589,1028,449,548
2106700C219,393,262,131,403,230,152,404,277,121,400,246,154,635,384,244,609,350,242
2122500F101,545,231,314,552,141,399,411,199,206,399,167,232,603,166,433,571,186,365
2122500F103,519,230,289,518,143,353,366,155,202,361,130,231,602,180,410,613,197,360
2123300B101,274,117,157,277,66,196,188,74,109,186,67,119,284,75,202,277,94,171
2106700A109,506,481,25,513,476,23,347,328,16,349,324,25,581,547,25,561,521,31
2106700A203,3,3,0,3,3,0,7,6,1,7,6,1,15,15,0,13,13,0
2106700A155,542,481,61,545,476,47,412,381,25,406,362,44,628,558,58,634,547,70
2106700C223,631,339,292,631,275,323,566,318,237,560,287,273,765,372,379,764,385,360
2106700C238,584,316,268,586,280,266,498,311,174,498,294,204,875,488,371,864,444,401
2110500C102,460,128,332,472,65,398,332,82,248,329,74,255,482,67,411,481,91,379
2123300B104,275,98,177,280,59,217,194,74,118,194,69,125,291,67,222,280,78,193
2103500C102,1168,358,810,1171,268,845,969,383,569,958,325,633,1259,325,916,1271,357,866
2111700A125,262,88,174,269,82,169,190,94,90,189,78,111,328,118,202,319,134,175
2111700B122,1352,352,1000,1359,354,919,1099,497,577,1077,393,684,1771,557,1177,1739,596,1079
2110500C101,346,102,244,349,63,281,268,78,187,264,71,193,357,64,291,357,73,279
2106700C236,348,166,182,349,130,194,337,199,132,336,169,167,546,249,283,552,249,285
2106700B138,496,363,133,489,323,130,456,352,102,454,329,125,590,433,148,591,417,168
2105900B104,709,277,432,705,168,500,503,227,266,493,181,312,716,195,508,728,258,431
2110500A101,225,92,133,223,56,161,144,40,101,143,34,109,221,55,161,223,63,146
2111700C124,1099,291,808,1103,299,731,815,329,473,796,246,550,1163,375,765,1135,386,712
2111700A103,548,362,186,541,349,148,439,355,78,433,334,99,749,538,191,829,592,202
2111700B105,481,116,365,480,112,348,346,103,239,344,85,259,552,151,394,526,167,348
2106700B210,686,396,290,676,322,299,544,356,180,536,291,245,813,467,328,815,458,340
2106700B229,365,221,144,368,210,124,351,266,78,350,248,102,400,248,143,411,262,140
2110500B101,379,114,265,384,71,299,290,72,212,288,71,217,390,74,312,396,82,306
2106700C233,482,287,195,480,240,206,404,266,133,400,232,168,563,335,215,552,317,218
2106700A168,558,417,141,560,360,176,507,370,133,499,332,167,649,445,191,639,443,173
2106700B151,380,236,144,375,197,156,300,189,109,299,165,134,366,219,141,374,220,148
2106700B217,429,224,205,430,165,228,311,169,135,308,139,169,425,204,211,438,220,200
2106700B147,519,303,216,512,273,203,438,305,127,432,278,154,522,322,190,526,317,198
2106700B190,542,385,157,549,351,151,402,294,106,397,273,124,579,421,144,570,409,146
2106700C209,611,323,288,608,272,305,520,337,170,513,304,209,778,412,353,755,383,356
2106700A177,314,240,74,312,222,70,253,210,42,250,197,53,337,271,61,338,285,48
2106700A148,531,470,61,551,447,53,461,423,33,463,410,53,608,520,65,626,531,70
2114300C101,637,267,370,640,200,413,489,215,271,488,193,295,667,183,479,667,198,449
2111700B135,776,224,552,773,217,505,513,231,273,500,182,318,897,298,579,898,326,533
2106700B132,401,284,117,407,257,112,338,251,79,335,240,95,476,341,123,472,331,127
2106700C121,231,162,69,243,154,78,153,114,37,151,104,47,275,194,76,274,199,61
2106700B152,563,282,281,554,233,290,492,231,255,495,211,284,593,292,295,610,283,318
2106700A199,440,292,148,438,256,149,313,249,58,309,228,81,520,348,158,517,341,158
2106700A205,429,264,165,425,216,173,520,382,131,520,349,171,773,464,289,788,485,278
2106700A191,316,195,121,316,160,128,426,312,108,424,270,154,645,391,238,659,412,229
2106700A183,582,373,209,580,297,224,423,296,120,423,271,152,705,439,241,728,476,225
2106700C127,491,308,183,490,248,209,370,227,132,360,206,154,564,338,214,557,332,207
2106700B140,507,315,192,510,253,217,388,256,130,388,231,157,548,314,220,549,333,199
2101500B122,932,212,720,940,217,693,861,370,481,837,258,579,1467,402,1051,1392,414,946
2106700A116,448,279,169,442,214,182,367,243,118,368,222,146,482,283,186,481,280,189
2106700A146,542,382,160,543,367,131,355,303,48,351,295,56,594,449,131,596,459,126
2104100A103,390,201,189,395,142,224,311,164,142,311,151,160,441,152,275,460,172,243
2104100C101,109,35,74,109,19,89,80,19,59,79,16,63,123,19,104,112,28,84
2111300F105,742,367,375,753,266,432,590,309,264,581,243,338,849,354,473,833,326,464
2121900B102,334,55,279,350,43,300,244,73,164,229,63,166,394,27,358,388,40,321
2121900B104,94,19,75,98,13,85,52,16,33,51,14,37,102,10,91,104,15,77
2112300B101,733,293,440,741,185,521,557,224,314,550,166,384,830,213,604,814,229,538
2115500E103,711,360,351,722,219,473,535,264,259,524,241,283,796,222,565,810,277,476
2115500A101,410,186,224,410,102,299,291,118,168,291,101,190,438,98,338,435,135,288
2115500D103,546,257,289,560,151,390,420,208,201,411,200,211,617,152,461,624,196,389
2107900D101,525,140,385,529,66,448,398,116,273,398,90,308,577,80,490,594,104,466
2101500A104,1079,208,871,1079,194,829,799,261,521,786,202,584,1248,273,955,1218,309,869
2121700B103,182,111,71,190,107,80,128,85,42,126,72,54,201,116,84,168,88,78
2121700C105,865,306,559,883,188,669,688,232,448,672,171,501,1011,225,776,990,268,683
2123500B110,636,187,449,644,121,494,496,162,326,498,124,374,761,160,589,762,153,574
2112500D104,387,78,309,400,33,353,314,62,248,315,49,266,454,44,404,461,64,379
2113700B101,557,189,368,569,117,437,433,151,277,432,135,297,660,129,524,636,137,481
2112500D106,432,112,320,450,52,391,301,83,209,301,64,237,522,69,450,493,92,394
2113700A102,908,300,608,915,204,674,690,285,387,698,233,465,1111,278,809,1159,272,811
2123500A103,491,130,361,504,57,433,352,92,252,355,69,286,577,72,495,589,102,443
2123500B107,631,175,456,635,96,525,535,131,394,537,103,434,806,135,662,795,151,618
2123500C107,416,122,294,429,59,358,297,79,211,297,53,244,437,67,365,424,85,322
2123500C111,292,81,211,293,35,252,185,58,120,186,31,155,302,39,259,302,57,233
2105900E104,149,42,107,151,26,118,123,42,79,116,34,82,173,34,137,176,45,122
2105900A114,1898,906,992,1914,822,953,1442,803,600,1428,728,700,2038,989,1001,2039,873,1024
2117700E105,595,206,389,611,103,483,403,156,242,397,124,273,653,110,531,668,155,479
2117700E101,306,155,151,306,95,196,213,120,90,213,113,100,342,107,227,349,122,196
2113900B101,279,92,187,289,58,218,228,79,144,227,87,140,312,61,247,302,68,228
2113900C103,129,43,86,132,16,105,108,41,65,103,39,64,140,17,119,148,32,104
2105900H101,378,131,247,379,98,270,328,126,198,327,109,218,441,128,309,426,138,277
2105900C102,500,207,293,505,127,340,389,164,220,384,156,228,526,154,359,552,201,305
2122300B104,283,112,171,287,82,190,180,71,103,177,64,113,309,89,212,315,92,199
2122300D101,266,88,178,270,47,217,180,59,113,179,55,124,293,52,239,287,62,215
2120700D101,570,125,445,583,66,489,444,99,334,439,72,367,655,84,558,698,98,543
2120700A102,491,150,341,500,98,385,352,126,222,349,93,256,551,120,423,549,113,400
2112500D102,607,157,450,618,91,515,396,98,292,396,66,330,691,117,569,671,124,533
2113700A101,514,220,294,519,141,349,363,144,216,361,125,236,616,173,429,612,175,397
2112500F103,173,52,121,175,26,144,153,41,106,147,33,114,203,35,165,202,43,148
2112500A105,542,132,410,557,77,470,399,109,278,387,85,302,660,104,550,642,111,515
2112500C110,651,164,487,663,99,544,489,133,351,486,83,403,726,125,592,725,128,569
2112500A104,556,136,420,568,59,494,466,97,354,461,61,400,648,77,562,655,111,512
2112500F107,527,153,374,541,100,425,339,99,233,338,89,249,623,132,485,601,125,458
2113700C104,902,317,585,924,158,720,659,223,421,649,177,472,1054,185,845,1067,242,755
2112500C109,652,174,478,659,116,509,456,136,310,457,106,351,676,138,523,701,128,527
2112500A108,491,146,345,499,86,400,362,119,231,362,95,267,565,111,447,546,117,413
2108100C107,695,158,537,706,124,558,464,168,280,460,129,331,805,140,653,794,168,584
2103500D103,918,332,586,922,217,644,649,271,363,639,228,411,935,251,665,958,316,597
2122300A102,252,77,175,253,46,197,184,62,117,177,48,129,293,53,234,298,62,223
2102100A101,552,211,341,562,114,428,441,178,254,436,131,305,616,140,466,619,192,406
2107900C103,728,254,474,730,154,560,592,193,388,591,150,441,878,202,668,856,206,626
2111700A119,284,230,54,288,222,51,130,113,15,126,106,20,321,266,51,342,292,45
2111700B101,744,151,593,746,124,588,517,154,350,510,117,393,918,182,723,878,236,614
2101500A107,366,91,275,369,97,251,228,81,138,222,67,155,422,132,282,415,132,267
2101500C135,795,252,543,800,245,498,547,273,260,535,206,329,895,328,546,921,355,515
2101500C137,1088,324,764,1089,317,704,812,372,424,802,292,510,1219,424,772,1237,458,725
2101500A115,1199,322,877,1202,315,824,843,391,437,834,309,525,1427,446,955,1428,481,880
2121700D104,701,259,442,709,176,484,495,232,256,492,177,315,793,211,562,830,227,541
2110100E113,536,246,290,541,195,318,412,217,190,407,189,218,606,252,344,602,267,320
2110100C105,326,134,192,328,59,262,199,78,120,195,63,132,329,58,266,320,84,222
2110100A101,433,193,240,440,115,301,293,109,167,292,101,191,457,128,322,436,148,274
2117900A104,743,316,427,745,191,513,512,223,275,509,185,324,829,215,598,847,286,516
2117900C103,838,378,460,846,264,544,611,330,269,594,237,357,1010,318,676,1002,365,592
2121500E101,633,203,430,648,124,497,474,176,288,467,138,329,710,151,549,695,184,481
2121500D102,506,175,331,508,93,401,382,152,215,376,117,259,554,107,442,537,132,384
2121500A101,1659,562,1097,1686,374,1252,1236,467,738,1219,355,864,1956,478,1453,1896,537,1289
2110100D106,474,298,176,481,257,202,274,180,93,270,167,103,472,270,197,464,278,171
2110100A102,327,139,188,332,92,232,217,93,118,215,75,140,356,108,246,345,135,203
2108100A104,316,101,215,325,76,241,202,66,132,204,57,147,360,83,274,343,104,228
2110700F038,598,164,434,612,101,496,376,152,211,363,121,242,587,117,465,568,141,413
2110700E030,400,98,302,409,40,352,263,83,177,258,56,202,401,48,346,412,88,301
2104900A102,611,269,342,614,145,435,464,199,259,461,163,298,683,187,483,700,241,424
2104900F103,618,278,340,621,196,373,451,249,189,451,204,247,646,237,389,663,234,396
2108100B106,316,64,252,317,53,254,190,61,125,189,47,142,364,60,299,361,68,277
2117900E104,676,187,489,683,108,565,486,129,344,482,111,371,847,132,711,832,182,638
2121500C101,1024,281,743,1027,185,791,908,310,580,904,250,654,1379,277,1073,1436,313,1021
2121700B104,389,152,237,399,107,280,312,119,189,310,94,216,454,127,322,436,132,288
2108100A106,403,98,305,403,55,334,272,71,197,262,51,211,461,62,393,460,104,334
2123900H102,666,325,341,670,238,391,596,277,312,597,248,349,743,311,419,732,316,398
2123900H103,783,309,474,784,234,505,677,288,383,669,228,441,884,313,555,893,307,568
2110700C017,462,126,336,466,76,371,314,104,208,311,76,235,489,97,384,500,119,353
2123900B102,364,193,171,367,149,185,287,154,128,283,135,148,382,183,188,386,177,189
2108100C102,420,112,308,422,75,319,232,80,149,236,68,168,464,83,367,502,118,330
2108900B103,656,289,367,665,151,495,429,179,243,428,159,269,680,162,511,664,210,435
2105900H104,1350,524,826,1360,363,918,1024,410,587,1007,347,660,1468,448,991,1494,519,876
2100900A103,767,318,449,775,197,539,517,221,284,516,187,329,797,224,557,815,227,523
2121700F103,720,284,436,730,239,455,520,221,292,519,180,339,787,271,500,801,235,504
2102100E102,508,284,224,501,221,252,426,241,182,428,214,214,554,270,271,554,256,264
2108900A101,631,258,373,645,151,464,411,181,221,407,163,244,688,171,506,704,198,467
2108900A106,372,196,176,389,145,233,272,133,130,274,126,148,457,178,275,414,163,239
2108900B104,431,178,253,442,91,337,320,120,193,312,108,204,529,114,409,522,152,351
2110100D111,657,352,305,663,298,317,450,295,149,448,247,201,666,328,323,702,345,307
2110100B101,459,189,270,462,101,348,305,131,161,303,111,192,506,117,385,485,149,320
2110100D109,429,223,206,434,174,244,249,137,106,245,112,133,428,185,239,425,210,201
2110100B112,220,99,121,219,59,149,190,96,91,186,75,111,299,90,202,305,123,168
2110100B104,523,160,363,524,94,408,374,132,236,369,105,264,573,109,457,594,127,436
2110100C110,269,89,180,268,50,213,193,84,103,184,66,118,282,53,228,290,59,218
2110100C102,293,119,174,298,86,203,211,70,141,206,65,141,318,93,222,317,105,199
2123500D102,707,209,498,720,118,580,536,160,362,540,110,430,795,144,637,802,157,587
2123500C101,119,30,89,122,11,110,75,18,56,73,14,59,119,12,106,116,20,93
2110100B111,616,233,383,619,169,419,465,211,248,460,177,283,637,193,431,652,218,401
2110100E106,320,154,166,322,113,192,224,122,100,216,100,116,343,139,198,345,160,173
2108900C107,485,252,233,495,167,304,303,159,137,297,141,156,556,199,347,546,202,305
2108900C109,483,226,257,473,109,348,347,166,176,346,153,193,495,121,369,495,169,314
2117900D102,1353,505,848,1369,361,941,1038,477,540,1026,391,635,1602,426,1147,1644,478,1071
2104900F105,548,271,277,546,188,323,356,198,155,357,160,197,635,250,369,635,250,354
2104900D102,942,448,494,961,317,596,724,381,323,707,316,391,1212,456,737,1168,446,682
2111500B101,292,96,196,305,40,255,220,98,112,220,92,128,297,53,244,300,73,219
2109300C003,906,291,615,903,191,677,692,232,439,675,161,514,1002,245,742,1007,306,672
2110700D028,527,178,349,533,135,375,391,166,217,381,120,261,614,185,417,618,181,393
2109300B005,554,211,343,556,144,391,402,162,228,396,111,285,629,187,433,621,224,378
2100900C102,714,248,466,717,129,564,500,180,312,495,144,351,738,147,584,754,178,545
2108900B107,479,215,264,485,130,344,345,148,185,343,131,212,583,163,415,562,183,365
2108900A107,381,152,229,391,77,302,274,114,152,267,97,170,470,97,367,466,130,319
2108900C105,614,259,355,617,156,447,415,190,217,408,161,247,675,179,493,663,201,450
2108900A103,755,372,383,761,223,498,539,300,229,543,272,271,837,260,559,848,294,494
2108900A105,413,191,222,414,100,291,256,131,120,252,120,132,422,109,305,433,141,268
2105900A113,1258,564,694,1260,471,698,980,503,454,962,453,509,1358,579,749,1375,555,731
2112500E107,394,66,328,395,30,353,270,61,197,268,44,224,439,39,395,453,53,393
2103900A101,386,149,237,388,76,303,286,88,193,281,95,186,392,81,308,379,104,258
2110900C103,225,55,170,241,23,210,176,31,141,175,20,155,273,29,241,267,40,211
2118700A101,226,76,150,230,46,180,173,66,103,170,52,118,248,47,200,238,60,170
2118700C101,441,124,317,450,83,344,325,96,226,325,84,241,516,91,416,534,106,390
2111300B103,684,297,387,680,193,453,714,312,387,703,259,444,1048,351,675,1048,359,653
2111300D103,608,237,371,612,128,452,514,201,306,515,174,341,644,163,471,656,200,437
2105100A101,380,120,260,413,95,309,274,107,162,268,89,179,459,108,346,462,127,317
2122500F102,188,77,111,192,58,130,131,56,74,128,53,75,199,64,134,188,59,122
2122500A101,553,164,389,563,88,455,424,147,271,410,122,288,602,103,489,629,130,449
2112100E106,516,167,349,528,103,398,359,133,219,351,112,239,571,124,439,575,120,435
2112100B104,160,36,124,174,11,161,111,28,81,111,17,94,233,16,216,223,31,189
2122500B101,420,146,274,422,71,340,283,109,169,283,100,183,450,82,362,458,115,313
2118700C104,394,108,286,409,85,311,314,114,197,309,85,224,479,95,380,469,94,356
2105900A129,950,438,512,964,345,557,751,392,348,743,329,414,1047,425,599,1041,433,541
2105900H109,497,183,314,502,134,333,402,158,238,391,132,259,501,155,336,507,169,311
2109300B001,486,232,254,484,181,279,252,116,126,248,96,152,518,219,288,517,230,261
2109300A003,409,234,175,423,210,191,208,131,68,203,113,90,461,253,198,432,232,180
2111500C111,262,65,197,275,24,242,197,52,139,194,37,157,292,28,260,292,34,255
2112100D103,271,101,170,282,87,190,187,89,94,184,73,111,316,104,210,294,73,213
2105900H115,1216,399,817,1231,303,851,882,384,471,869,316,553,1243,353,865,1278,372,816
2105900A115,642,194,448,651,171,441,526,216,300,520,163,357,680,205,462,689,186,460
2108100A105,593,143,450,597,119,461,424,144,267,420,122,298,703,139,557,686,158,506
2107700A101,438,184,254,447,150,279,307,164,137,299,132,167,502,162,331,500,187,280
2122500C102,324,120,204,327,69,251,219,87,127,217,67,150,339,77,259,335,92,226
2122100D101,548,177,371,559,171,379,355,130,216,352,118,234,647,202,442,623,198,410
2121100C104,656,234,422,655,172,445,557,194,350,548,174,374,738,219,505,755,241,474
2118900A103,140,37,103,147,17,124,111,38,69,105,28,77,167,15,151,186,23,144
2115700C106,473,153,320,478,113,341,359,124,229,356,105,251,457,114,337,469,108,335
2122900B102,626,226,400,630,132,467,502,191,295,487,153,334,689,153,520,718,184,484
2122900D102,407,229,178,409,191,198,361,208,148,347,173,174,479,235,234,462,197,228
2122900A101,322,96,226,326,67,248,259,101,149,256,84,172,345,75,265,354,75,263
2122500E103,399,117,282,403,59,341,288,96,187,282,73,209,416,65,349,408,89,309
2110900A102,345,82,263,379,40,326,288,58,227,287,48,239,425,51,366,397,58,321
2110900A106,181,35,146,194,17,170,140,28,110,142,27,115,213,22,189,202,25,177
2115700C104,1253,369,884,1258,230,981,994,339,639,981,303,678,1352,252,1082,1362,277,1041
2115700A106,433,147,286,433,74,349,320,118,192,318,97,221,459,79,378,457,104,345
2115700C103,760,285,475,759,177,551,561,219,326,551,211,340,821,202,609,811,224,558
2118700D101,493,196,297,496,137,345,377,179,189,374,146,228,516,136,376,494,152,329
2118700A103,384,81,303,387,63,304,264,74,189,261,61,200,442,69,366,458,70,371
2112500B101,611,147,464,615,88,505,453,136,308,453,93,360,812,134,663,849,138,654
2112500D108,422,91,331,430,54,361,295,74,215,293,53,240,468,68,392,478,71,386
2113700D103,1118,331,787,1130,178,918,825,258,554,812,193,619,1286,206,1062,1305,247,1000
2112500F104,817,187,630,843,118,710,620,163,442,618,128,490,1004,161,836,974,157,796
2115700B103,403,152,251,401,95,284,288,123,160,280,109,171,389,105,273,409,122,255
2120900C114,436,227,209,441,172,258,438,240,191,428,194,234,731,318,406,675,318,343
2120900D111,732,307,425,732,220,476,634,292,327,626,247,379,949,328,603,948,346,560
2120900G134,707,271,436,708,216,458,483,257,217,482,214,268,777,273,491,777,259,487
2120900A112,363,130,233,361,66,275,299,112,179,296,88,208,435,94,332,449,140,293
2121100C102,638,256,382,637,156,440,546,209,324,534,165,369,696,194,488,717,257,419
2114100C103,394,145,249,398,121,261,265,120,137,255,100,155,473,136,328,474,166,283
2114100F101,360,218,142,366,228,129,225,163,59,223,150,73,392,248,139,393,256,128
2109500C102,146,38,108,154,12,137,87,22,62,88,18,70,180,15,162,175,35,137
2113700D101,398,144,254,415,79,319,346,122,214,344,97,247,487,94,384,469,111,334
2112500F106,369,87,282,378,50,322,277,54,219,276,51,225,456,69,385,440,74,361
2112500F102,868,199,669,878,106,742,634,132,483,626,90,536,963,134,814,990,157,787
2114100D102,807,198,609,823,136,664,537,170,358,530,147,383,915,151,755,891,189,670
2109900D104,601,171,430,602,87,487,434,165,260,428,131,297,718,95,604,763,142,563
2102900A102,541,196,345,544,122,399,277,117,150,273,96,177,526,130,387,524,153,347
2119500D104,234,61,173,242,25,213,179,63,112,180,54,126,251,29,221,268,40,222
2119500E107,603,228,375,627,83,517,427,158,261,437,165,272,627,93,524,642,146,471
2119500A107,485,171,314,499,109,367,331,134,189,328,130,198,500,121,369,526,109,392
2115700A107,1042,359,683,1054,228,765,801,312,476,789,262,527,1107,276,814,1120,296,783
2115700A105,587,231,356,585,150,395,387,176,198,380,150,230,573,153,408,603,155,408
2116700G102,701,344,357,698,249,420,560,290,261,548,246,302,788,313,461,750,270,446
2102900B104,1191,413,778,1204,273,895,1027,431,578,1017,324,693,1638,404,1216,1593,452,1097
2102900B103,1186,430,756,1200,280,857,685,303,358,670,221,449,1108,275,808,1125,311,741
2102900A112,1028,343,685,1025,211,771,755,312,427,749,242,507,1149,259,870,1177,312,804
2115700B105,775,272,503,772,123,618,633,210,411,622,187,435,828,136,678,818,183,599
2114100C104,397,83,314,406,62,332,282,75,201,278,61,217,450,66,380,441,83,340
2118100D101,616,354,262,624,217,370,511,282,223,508,249,259,718,248,461,728,258,431
2109900B104,477,196,281,485,131,335,322,137,178,320,107,213,538,159,367,533,180,328
2105100D103,386,83,303,395,33,346,226,73,146,230,51,179,463,39,420,459,51,390
2122900F102,765,343,422,776,240,505,616,271,332,597,206,391,837,273,551,825,274,501
2116300E102,685,267,418,684,156,500,520,203,304,510,140,370,755,172,563,772,201,506
2116300F101,488,226,262,500,121,345,364,187,171,363,175,188,518,127,376,518,158,326
2102700F101,1006,358,648,1017,239,757,880,325,543,879,276,603,1290,308,971,1271,330,896
2102700E101,415,124,291,426,61,354,308,91,205,295,70,225,482,71,407,478,102,360
2116300B103,520,174,346,527,87,411,368,131,224,363,108,255,633,106,516,651,156,466
2116300A102,528,214,314,534,146,355,329,150,168,328,130,198,755,292,445,754,327,391
2102700D102,474,222,252,478,149,312,357,190,158,351,149,202,572,183,380,555,195,331
2102700A102,547,217,330,551,146,384,451,179,260,444,142,302,646,177,461,632,187,427
2116300B101,853,379,474,861,219,613,631,292,323,623,224,399,1017,258,745,992,328,618
2102700F103,300,98,202,304,58,235,239,90,144,234,82,152,331,65,261,342,78,242
2102700F102,263,82,181,265,43,211,200,59,133,198,58,140,319,53,261,332,73,241
2116300A101,598,278,320,609,151,425,389,169,209,383,148,235,663,164,489,661,197,435
2104700F103,186,22,164,189,23,162,126,33,92,125,23,102,205,27,177,192,27,161
2117500B101,462,185,277,477,85,378,355,163,180,348,141,207,559,100,450,568,128,418
2120900D119,699,314,385,703,243,421,626,339,272,618,272,346,1057,418,616,1051,409,586
2120900D121,523,207,316,518,140,356,469,202,261,466,148,318,586,182,394,592,204,363
2104700H104,805,122,683,824,90,718,581,123,434,558,104,454,888,106,772,827,149,658
2104700H102,977,212,765,997,156,819,603,178,413,593,142,451,1035,178,846,983,248,709
2104700D104,407,58,349,411,51,345,306,73,226,302,53,249,432,59,364,425,69,330
2104700F102,563,181,382,571,182,380,385,149,231,378,124,254,661,226,429,634,231,386
2104700B103,618,110,508,631,92,529,464,142,313,456,105,351,654,104,543,613,128,468
2121100A101,760,254,506,756,208,519,628,235,386,620,170,450,840,257,572,830,255,552
2122100E104,198,61,137,201,44,154,151,49,97,149,52,97,233,52,180,222,69,151
2105100F104,403,93,310,425,52,369,279,60,219,274,45,229,458,46,405,457,59,371
2119500F104,878,343,535,889,141,730,557,241,300,556,241,315,876,153,716,882,212,649
2105100B104,542,115,427,559,40,509,432,111,313,430,66,364,625,57,562,622,66,534
2104700B104,347,83,264,347,72,257,242,76,157,241,61,180,389,89,288,408,105,266
2104700G105,249,76,173,248,74,153,11,8,3,11,7,4,415,136,256,460,145,260
2112900D101,199,76,123,205,35,166,150,42,105,147,41,106,228,40,186,218,50,163
2118900A102,282,101,181,305,51,253,234,65,163,225,44,181,326,42,283,294,58,233
2121100D104,477,164,313,480,113,345,372,146,218,360,113,247,514,136,370,519,160,333
2121100E102,606,192,414,604,163,412,523,180,333,520,158,362,696,210,473,698,199,470
2108500B102,194,46,148,198,15,177,144,33,109,143,22,121,216,20,194,220,30,175
2100500E101,1466,570,896,1469,309,1088,1296,522,720,1279,416,863,1723,398,1290,1732,473,1184
2108700C101,489,139,350,501,81,409,380,94,276,374,78,296,553,91,456,541,103,427
2100500C101,839,344,495,838,225,575,727,342,367,716,273,443,973,285,671,969,280,644
2100100F103,436,118,318,457,68,374,329,81,237,325,65,260,484,72,406,484,92,362
2115300A103,287,135,152,288,64,217,195,96,91,194,91,103,304,56,244,305,64,234
2108500C101,250,76,174,252,48,195,207,73,132,204,57,147,297,69,224,299,80,200
2108700D101,461,98,363,473,52,412,316,61,250,314,43,271,571,64,503,593,80,485
2109500B107,234,57,177,257,39,213,127,21,99,127,27,100,229,29,199,224,32,183
2105700A101,369,79,290,402,52,335,235,71,162,228,44,184,385,52,329,378,68,279
2108500A103,912,327,585,921,182,693,688,237,433,688,184,504,970,208,753,968,220,690
2108500B104,186,75,111,192,45,138,143,56,84,140,40,100,212,66,144,217,71,126
2106100E101,675,226,449,680,133,526,549,185,358,536,156,380,832,189,633,840,218,582
2115700C102,429,148,281,427,94,324,318,107,206,318,103,215,436,99,335,423,110,309
2120900C110,488,237,251,482,162,292,420,187,227,412,159,253,566,220,337,562,244,302
2120900G128,354,211,143,358,150,184,245,147,87,244,128,116,393,187,195,377,199,157
2120900E124,392,210,182,398,184,181,264,153,101,260,136,124,388,205,172,375,177,180
2115700B102,955,300,655,956,170,749,728,248,468,712,211,501,1035,191,829,1040,204,786
2115700C105,874,329,545,865,201,630,640,273,355,633,231,402,894,213,671,891,238,620
2105300D102,424,38,386,458,30,417,325,59,258,320,36,284,527,34,488,508,43,455
2105300A101,316,59,257,339,58,273,241,61,170,238,49,189,386,67,316,375,66,299
2119900B111,377,101,276,389,53,329,305,82,219,303,71,232,462,75,383,443,85,346
2123700B102,274,144,130,281,91,187,229,129,96,226,118,108,303,96,206,283,102,181
2104700D103,557,143,414,560,137,419,421,153,261,413,129,284,568,150,417,534,161,369
2104700D102,694,216,478,708,189,481,520,236,278,508,161,347,704,206,479,715,243,426
2104700G101,506,114,392,507,95,396,420,158,252,414,118,296,569,117,444,551,145,393
2104700A104,503,265,238,519,246,253,273,148,117,267,135,132,492,248,232,499,275,196
2104700C105,1144,204,940,1153,181,933,863,263,589,843,193,650,1228,212,994,1199,246,898
2123700C102,435,209,226,441,120,306,371,171,193,373,173,200,476,128,340,489,149,316
2118500G102,1367,442,925,1348,431,823,1045,453,578,1039,340,699,1586,622,930,1600,568,978
2109900D103,311,81,230,313,40,265,206,53,150,203,51,152,317,37,276,326,55,257
2109900D105,167,58,109,168,35,128,139,50,85,133,42,91,211,41,167,214,51,150
2114100E102,913,274,639,924,233,655,667,275,379,659,238,421,1036,270,749,1032,292,680
2108700B102,689,169,520,720,91,611,515,111,391,507,88,419,801,103,691,811,128,644
2108700A103,596,190,406,629,135,478,432,135,291,434,97,337,634,139,490,626,131,456
2108700A101,544,179,365,569,115,437,404,138,255,401,100,301,611,127,477,598,131,437
2106100B101,810,226,584,818,131,667,606,204,394,603,148,455,1071,192,867,1061,207,799
2106100D101,907,296,611,914,170,720,607,225,368,615,163,452,1044,200,833,1041,227,761
2108500E102,787,281,506,793,175,587,638,233,391,635,182,453,963,226,727,964,241,666
2108500F101,446,152,294,459,112,336,344,126,208,340,100,240,540,128,408,513,126,363
2108500F103,767,216,551,783,115,642,645,179,454,632,111,521,923,142,773,909,159,700
2101100C102,435,216,219,444,122,300,355,176,173,352,161,191,532,133,392,532,177,335
2101100B102,389,203,186,398,128,255,343,199,136,343,184,159,526,170,352,528,186,315
2101100A105,620,287,333,630,185,435,527,277,244,526,246,280,792,231,555,785,262,493
2117500C101,633,278,355,663,144,499,536,248,273,531,214,317,842,184,645,806,208,582
2105300C102,229,45,184,241,32,201,174,51,120,165,32,133,254,34,216,270,46,199
2119900E103,1119,319,800,1130,169,912,801,226,561,802,185,617,1344,243,1076,1360,271,1017
2119900B108,337,117,220,340,76,256,263,98,162,265,94,171,424,111,309,402,102,286
2102900D101,327,130,197,336,76,244,228,97,124,225,78,147,356,88,260,361,112,219
2102900A101,145,52,93,150,22,121,111,55,55,111,53,58,243,44,194,245,69,159
2118500E101,1021,314,707,1017,253,712,829,345,465,823,279,544,1234,378,833,1232,418,774
2116700C101,293,85,208,295,37,248,225,78,141,224,61,163,327,47,276,341,68,263
2106100C101,370,125,245,358,68,278,263,99,158,259,87,172,457,81,370,459,99,316
2105100B103,259,89,170,286,57,220,202,70,126,197,53,144,325,73,245,329,93,221
2105100C104,429,88,341,448,43,393,331,76,247,334,59,275,485,38,442,483,44,416
2105100A106,456,100,356,489,40,442,328,90,235,320,63,257,583,66,508,576,74,475
2104700E105,366,137,229,377,122,238,249,130,113,240,103,137,416,146,259,425,168,224
2118100B101,573,308,265,581,164,399,469,231,226,458,170,288,705,192,506,695,229,445
2118100A101,481,233,248,484,123,344,399,194,193,382,137,245,584,149,429,580,176,382
2119900D111,340,97,243,341,69,258,219,68,151,218,57,161,349,85,258,344,70,262
2119500A108,511,160,351,513,82,416,367,157,200,359,162,197,572,101,465,617,113,485
2119500C110,142,70,72,147,41,100,107,67,37,110,63,47,156,48,106,152,47,94
2119500E102,330,125,205,344,41,298,239,90,145,235,96,139,366,48,317,360,84,270
2113300C101,186,81,105,198,49,139,121,53,64,117,53,64,172,49,120,169,50,108
2100100G101,575,161,414,603,103,474,462,150,304,455,109,346,650,113,530,649,130,484
2105100B101,374,83,291,397,45,344,259,62,194,259,46,213,489,42,442,488,59,407
2105100D104,285,66,219,290,20,265,209,48,159,204,29,175,417,29,385,415,37,366
2109900C101,512,167,345,529,106,411,361,127,228,353,104,249,574,103,468,574,115,429
2118500B106,786,309,477,786,314,404,644,335,301,630,274,356,855,413,416,873,362,460
2118500A101,1349,481,868,1345,514,768,1114,527,580,1103,408,695,1717,780,913,1662,650,966
2106500A106,448,148,300,464,100,345,333,122,201,334,106,228,523,120,396,527,113,389
2106500A102,232,96,136,230,57,165,161,78,77,159,62,97,288,67,216,298,72,210
2106500C106,578,197,381,576,103,457,464,176,276,469,148,321,738,139,592,748,170,559
2106500A101,196,70,126,195,49,133,167,77,86,170,63,107,231,66,157,233,63,156
2105700C101,302,60,242,309,50,249,191,47,140,189,38,151,353,59,291,362,61,277
2120300D103,122,41,81,130,24,99,97,33,63,95,27,68,154,46,106,154,53,96
2119900B110,729,187,542,732,80,636,565,126,425,565,96,469,837,110,718,844,153,660
2123700A105,418,199,219,438,126,302,366,197,158,366,177,189,547,155,385,528,163,351
2112900B101,306,90,216,311,45,264,240,89,147,238,69,169,307,45,261,310,53,254
2102700B103,530,190,340,536,94,418,416,171,236,412,124,288,574,104,459,598,150,403
2114700D104,260,52,208,275,39,235,213,55,152,211,37,174,287,40,246,272,35,232
2103100B106,582,138,444,590,90,487,398,92,299,396,81,315,646,102,538,628,118,482
2102900A106,1046,335,711,1058,208,806,646,223,400,635,181,454,1165,252,895,1163,300,819
2102900D102,727,280,447,735,158,542,524,206,305,526,183,343,759,180,565,756,235,484
2116700D101,854,265,589,855,126,691,710,240,451,699,188,511,922,156,748,969,205,725
2117300B107,772,299,473,787,167,597,573,207,359,567,171,396,834,181,641,844,219,595
2122700E112,362,214,148,365,213,135,217,163,50,214,146,68,437,284,147,424,261,149
2119500E105,392,182,210,426,91,335,254,129,118,232,125,107,465,108,357,400,122,278
2119500B106,478,192,286,502,80,414,321,134,181,323,136,187,527,92,431,506,126,369
2119500D110,232,79,153,237,50,173,183,78,99,182,79,103,253,60,188,278,54,205
2122700B105,309,244,65,318,257,48,217,190,26,214,181,33,432,371,56,400,322,70
2122700F112,248,88,160,254,73,170,207,98,106,207,83,124,422,143,273,410,158,236
2111100L140,275,268,7,280,273,4,173,167,2,169,158,11,250,242,5,249,241,7
2111100S144,670,307,363,667,304,336,544,291,249,534,253,281,719,380,328,719,366,344
2111100F153,908,426,482,904,400,443,672,383,280,653,319,334,881,428,434,887,433,429
2111100Q119,906,444,462,917,379,489,701,408,284,692,342,350,1053,461,574,1052,479,528
2106900F103,128,56,72,129,26,102,103,30,72,102,24,78,148,28,120,142,38,102
2111100G129,193,121,72,192,104,73,161,113,46,158,91,67,187,119,66,187,115,65
2111100G126,569,359,210,564,349,193,509,373,134,497,323,174,594,392,195,593,393,192
2111100L136,747,478,269,742,461,219,652,508,132,643,450,193,821,575,225,827,580,236
2111100L146,776,423,353,770,447,269,660,467,184,650,404,246,820,535,272,826,534,276
2111100E180,663,361,302,658,343,277,486,317,161,483,273,210,670,396,259,670,394,260
2117500D101,359,175,184,370,82,278,277,139,132,276,124,152,396,89,303,381,111,254
2103100C106,695,170,525,702,113,567,529,148,375,521,127,394,782,131,643,763,148,587
2111100D135,590,353,237,581,319,223,475,328,139,471,292,179,639,401,230,641,409,215
2111100J152,494,229,265,498,152,326,340,169,161,336,135,201,516,158,353,516,176,314
2111100E183,642,340,302,644,317,276,505,302,199,497,255,242,655,374,272,660,367,283
2111100E178,690,303,387,688,277,374,582,308,268,579,255,324,743,353,373,748,351,384
2119500C104,194,77,117,197,40,149,141,73,64,142,70,72,216,49,164,222,54,159
2119500C108,368,196,172,397,86,294,261,136,114,263,157,106,369,89,275,341,116,200
2119500C111,650,238,412,662,102,536,467,178,277,464,167,297,753,129,616,799,172,585
2119500C109,288,131,157,307,53,251,169,82,85,173,85,88,302,57,244,273,81,188
2119500C103,512,268,244,522,154,363,493,301,176,482,275,207,564,180,382,506,178,319
2111100I145,164,88,76,165,73,82,96,65,27,93,55,38,176,85,85,177,92,75
2111100E157,216,107,109,215,105,94,177,101,71,174,81,93,245,119,121,245,126,115
2111100F169,369,202,167,375,191,160,318,211,105,312,183,129,398,235,163,398,232,155
2111700B138,1123,320,803,1121,327,738,916,429,468,892,312,580,1441,492,927,1402,510,850
2111100M105,435,424,11,439,425,8,292,285,4,285,268,17,430,411,11,429,404,5
2114700B101,886,187,699,913,91,810,683,164,496,685,113,572,1083,105,971,1096,143,892
2111100G161,486,323,163,483,331,143,433,319,111,427,286,141,511,363,140,513,350,159
2111100S128,697,339,358,692,323,341,560,315,243,557,267,290,707,384,314,712,378,324
2111100V113,1757,651,1106,1762,610,1070,1700,814,879,1689,667,1022,2566,1134,1391,2578,1112,1412
2111100A125,843,353,490,848,280,541,658,337,311,652,280,372,861,322,530,862,334,507
2111100L156,657,565,92,654,541,85,531,458,70,525,425,100,705,585,106,706,594,102
2111100G147,747,480,267,746,468,220,653,488,154,639,430,209,758,523,226,763,513,236
2111100G120,595,421,174,602,409,150,509,403,104,505,373,132,599,462,128,599,452,139
2111100S160,1757,680,1077,1736,700,980,1526,812,702,1518,653,865,2372,1145,1198,2389,1069,1283
2111100S168,574,275,299,579,256,288,487,277,204,476,231,245,757,417,332,757,409,332
2111100V126,1174,425,749,1170,426,680,875,443,418,864,377,487,1361,608,726,1369,612,710
2119900D104,525,108,417,532,42,468,409,70,325,409,51,358,591,57,523,627,87,502
2119900D105,632,189,443,636,121,497,508,164,337,503,126,377,697,157,531,686,145,510
2119900A110,334,89,245,349,33,307,255,50,197,250,43,207,381,43,335,369,70,289
2119500A104,848,294,554,846,188,634,690,277,402,683,264,419,945,231,706,1013,207,764
2119500A103,500,177,323,509,105,385,352,163,177,349,161,188,526,120,398,553,115,413
2119900B109,454,92,362,456,34,414,332,61,264,332,43,289,495,45,446,499,72,420
2119900C111,282,92,190,288,42,231,229,62,161,225,38,187,339,60,271,339,78,240
2105700A102,430,65,365,459,52,396,309,66,236,304,47,257,518,60,455,501,66,410
2105300B101,352,76,276,391,63,320,217,67,147,210,39,171,405,66,336,377,76,291
2106300D101,517,324,193,535,154,349,403,229,168,406,214,192,590,159,420,597,204,350
2119900A108,1206,313,893,1223,185,990,888,238,637,889,195,694,1301,237,1042,1325,238,1013
2120300E101,416,109,307,426,66,350,290,97,188,286,64,222,510,77,426,509,84,396
2111100O127,587,385,202,591,344,224,484,363,111,482,328,154,727,437,277,726,456,246
2111100M102,1013,991,22,1017,996,14,762,746,12,759,715,44,1013,983,22,1015,988,17
2111100E139,578,390,188,580,384,160,350,274,72,343,236,107,661,472,171,657,472,170
2111100D141,681,307,374,678,276,376,580,312,261,578,274,304,717,330,376,713,317,372
2111100I109,397,283,114,392,248,119,261,198,53,256,185,71,388,253,117,389,269,106
2111100A118,389,181,208,384,122,243,258,143,108,253,122,131,424,169,247,427,196,202
2105700C102,284,78,206,311,63,241,203,54,148,204,53,151,376,78,295,345,84,246
2105300D101,306,44,262,322,42,270,214,53,159,210,46,164,377,49,323,387,50,315
2118500H103,935,315,620,926,305,565,725,326,381,721,264,457,1048,420,610,1037,387,626
2118500E102,1468,507,961,1471,436,932,1149,494,636,1142,411,731,1508,551,922,1522,571,890
2114700A105,115,24,91,116,12,104,78,23,55,77,12,65,127,13,114,123,17,106
2111100G155,748,513,235,748,471,235,601,456,139,593,394,199,790,536,233,794,554,216
2111100C131,374,237,137,378,216,148,287,201,83,287,178,109,389,247,134,389,254,127
2111100E162,273,140,133,274,136,113,143,98,43,142,89,53,303,216,82,302,210,82
2111100L147,470,452,18,472,457,6,309,299,8,306,286,20,519,490,23,520,495,16
2111100I149,0,0,0,0,0,0,0,0,0,0,0,0,0,0,0,0,0,0
2113500C101,275,85,190,284,48,230,202,53,144,189,47,142,299,47,249,301,56,227
2117300B103,616,282,334,626,162,437,501,224,268,491,189,302,720,192,512,721,226,459
2119900A106,1409,350,1059,1428,219,1156,1159,323,814,1144,256,888,1648,304,1321,1672,289,1304
2105300F102,330,42,288,347,32,305,203,48,154,198,25,173,401,37,360,420,48,343
2119900B112,429,101,328,439,55,373,322,82,233,321,65,256,486,74,407,479,79,386
2100300D102,409,102,307,416,62,343,306,88,216,303,69,234,477,74,398,472,100,353
2119500B107,419,164,255,431,82,335,286,135,141,283,118,165,444,93,345,453,107,325
2119500B104,423,168,255,457,85,357,325,134,182,322,131,191,462,95,361,449,107,319
2111700A138,972,308,664,978,301,612,725,359,349,706,296,410,1044,379,643,1033,410,588
2123100B103,521,144,377,541,74,442,354,110,239,353,75,278,680,98,564,714,124,535
2123100G101,849,289,560,865,184,654,635,238,390,624,175,449,934,207,714,955,213,679
2123100D104,400,110,290,438,57,375,248,72,174,241,49,192,506,68,435,478,86,374
2115700B106,836,259,577,828,174,622,683,204,465,680,178,502,921,201,707,959,211,704
2115700A103,746,348,398,755,227,497,587,294,273,580,269,311,837,257,571,802,259,509
2123100D106,393,154,239,407,108,288,325,151,169,319,105,214,424,117,301,412,109,277
2122700F108,1054,299,755,1049,220,775,800,305,486,793,236,557,1148,290,838,1154,361,751
2122700F109,379,102,277,373,79,277,289,131,155,281,91,190,418,107,305,418,126,280
2120100C101,182,68,114,184,42,132,157,67,83,157,64,93,221,52,166,232,61,150
2105500F101,478,126,352,499,80,404,360,106,242,351,97,254,504,91,406,492,97,370
2113500A101,887,202,685,945,120,798,640,146,481,628,112,516,1096,131,952,1110,145,902
2106500A105,255,109,146,261,65,179,191,88,99,189,72,117,298,67,228,300,64,219
2100300E102,671,172,499,681,113,539,406,129,269,396,106,290,815,143,657,822,176,602
2122700D101,1100,449,651,1110,304,753,837,391,430,832,327,505,1279,415,840,1287,559,668
2113500B101,251,58,193,269,38,225,145,39,103,143,32,111,291,39,250,289,39,236
2105500A102,274,75,199,278,41,232,208,68,138,209,56,153,311,51,257,305,63,232
2122700F103,699,172,527,701,132,530,538,188,341,534,162,372,767,175,578,771,209,529
2105500F102,221,62,159,223,38,174,155,58,91,149,45,104,215,42,168,229,46,160
2117500D102,544,227,317,572,109,438,480,213,252,471,177,294,688,134,542,717,164,499
2113500A102,305,107,198,327,65,255,225,75,144,217,69,148,413,77,331,388,84,283
2113500D101,447,131,316,463,76,365,351,112,223,343,86,257,528,83,434,561,94,414
2113500D102,272,95,177,280,50,221,200,55,142,189,45,144,287,49,234,282,61,207
2122700A105,969,349,620,963,323,586,843,401,436,837,339,498,1205,476,707,1212,470,689
2122700E109,816,302,514,815,238,545,664,344,313,656,283,373,1067,365,685,1056,424,593
2113500C102,384,109,275,410,62,344,250,74,167,238,60,178,437,62,373,403,71,329
2109500B105,287,74,213,318,43,270,169,47,119,164,42,122,301,33,266,295,44,239
2109500B109,233,37,196,250,16,229,115,27,88,104,24,80,258,13,244,266,24,233
2111700C141,429,136,293,435,133,268,368,182,179,365,140,225,532,194,326,529,210,300
2109500E105,279,76,203,304,29,260,191,50,135,193,43,150,307,30,273,314,46,251
2109500E108,202,69,133,227,31,194,135,44,89,130,36,94,229,32,196,201,41,157
2109500A108,773,175,598,814,88,703,572,134,424,570,131,439,850,100,733,874,132,692
2118500B105,1399,457,942,1398,398,915,1175,530,622,1151,377,774,1679,589,1059,1664,601,1020
2118500A104,1331,526,805,1331,483,727,1106,602,478,1088,496,592,1611,716,844,1664,695,874
2116700F101,565,291,274,574,186,357,411,224,176,407,179,228,697,254,427,669,249,373
2116700A104,163,57,106,168,30,130,123,46,76,117,33,84,171,35,133,174,42,124
2102900C102,656,302,354,666,209,431,422,202,204,416,165,251,729,248,469,701,265,401
2108300A101,324,87,237,333,37,277,237,50,181,235,51,184,309,37,266,324,59,245
2119300A108,121,64,57,127,28,97,69,34,32,70,35,35,98,23,74,89,36,51
2119300B109,199,91,108,204,68,127,153,91,60,148,74,74,181,66,111,175,57,111
2119300B107,163,69,94,172,39,129,107,54,52,108,52,56,161,40,119,154,47,102
2117500B102,291,96,195,300,44,244,216,84,129,214,78,136,358,53,300,391,68,304
2103700C308,556,269,287,559,253,251,376,231,138,370,205,165,596,314,263,640,350,255
2103700A703,972,336,636,975,320,588,712,359,344,698,278,420,1072,407,642,1080,447,587
2122700D102,804,355,449,798,302,436,599,349,232,590,309,281,909,404,478,950,434,452
2111100M171,850,818,32,853,808,33,513,495,16,511,474,37,716,677,34,717,679,32
2111100G158,825,410,415,820,411,366,706,419,281,690,351,339,894,505,381,902,494,388
2111100N102,557,375,182,570,299,234,404,277,115,400,253,147,620,353,255,620,380,217
2111100A124,806,341,465,808,270,505,599,340,250,592,271,321,837,338,492,835,360,454
2111100S139,1236,692,544,1240,656,526,890,581,285,883,514,369,1222,750,447,1222,770,422
2111100E166,517,246,271,520,226,268,426,240,175,422,198,224,528,262,250,531,267,246
2111100I123,1006,557,449,1017,495,490,697,429,258,691,361,330,1007,492,498,1009,516,468
2113500C103,416,155,261,435,71,345,263,77,176,261,72,189,476,74,393,467,107,328
2115100B102,677,278,399,678,184,470,596,273,307,587,227,360,790,242,537,780,273,489
2115100C103,987,383,604,983,225,715,879,345,507,877,302,575,1181,309,850,1206,391,771
2115100D112,991,423,568,980,311,612,877,439,423,871,365,506,1191,429,733,1222,434,730
2103700B805,986,253,733,992,240,697,646,291,338,635,219,416,1078,304,756,1040,334,672
2106300F101,375,199,176,397,93,284,255,150,102,249,135,114,423,91,325,452,118,303
2106300G101,345,184,161,391,95,281,225,124,98,219,113,106,375,83,289,365,99,250
2107500D103,154,49,105,157,26,131,84,26,58,81,27,54,154,25,129,149,36,113
2103700B913,752,302,450,757,305,401,485,288,191,478,245,233,836,385,434,842,397,412
2111100O129,1050,584,466,1051,454,553,769,485,272,758,409,349,1062,532,510,1061,550,478
2111100F183,375,124,251,375,126,235,322,144,177,316,110,206,432,171,257,433,164,260
2111100V129,1222,389,833,1226,378,802,1127,442,672,1127,351,776,1706,638,1047,1709,601,1086
2111100V103,532,158,374,536,121,395,412,143,258,405,113,292,527,151,370,524,158,351
2111100B177,902,320,582,914,276,599,901,435,452,893,345,548,1357,525,818,1359,515,808
2100300E103,400,85,315,409,43,349,264,67,195,261,45,216,450,50,393,456,81,352
2115100A108,914,339,575,928,209,677,723,299,412,722,239,483,1044,270,760,1040,326,693
2115300C102,272,112,160,285,40,239,192,81,106,194,77,117,282,41,234,282,49,221
2106900E104,176,44,132,174,24,148,133,34,96,132,26,106,203,27,175,222,31,187
2100300C102,911,204,707,936,148,750,658,235,409,638,166,472,1129,188,922,1138,211,860
2100300A101,609,191,418,623,164,434,390,153,224,386,131,255,751,207,530,741,196,506
2100300B103,292,76,216,305,53,243,190,54,136,188,40,148,352,63,284,338,75,249
2104300B105,398,176,222,406,106,269,331,190,134,329,153,176,453,125,314,482,131,307
2104300E104,533,203,330,553,96,441,405,206,184,402,182,220,625,111,507,620,149,449
2120500D103,699,341,358,709,232,455,543,331,205,536,269,267,774,242,519,761,264,466
2120500B105,720,390,330,727,288,393,566,360,201,555,317,238,789,332,436,802,332,421
2123100D105,379,108,271,404,70,329,288,90,197,281,72,209,492,88,402,466,90,369
2104300B103,469,181,288,466,93,355,378,193,172,380,162,218,536,110,419,568,136,403
2111100J113,811,483,328,813,408,347,610,403,194,604,355,249,861,477,366,868,498,344
2111100D130,702,393,309,701,385,259,589,413,162,580,373,207,765,464,280,775,474,271
2111100I107,643,443,200,645,397,210,483,377,96,476,343,133,662,429,218,666,451,192
2111100L143,257,213,44,253,203,35,223,203,18,219,192,27,302,259,38,303,260,38
2111100K104,440,293,147,441,305,104,260,236,22,260,225,35,321,259,56,322,264,52
2111100G157,959,534,425,957,527,383,801,540,249,785,461,324,990,615,362,997,599,373
2111100D129,385,229,156,392,206,167,330,218,107,330,202,128,435,257,169,435,255,173
2111100M133,736,719,17,740,721,10,534,527,5,532,513,19,706,685,16,707,686,13
2111100M163,224,172,52,221,165,38,211,182,24,207,176,31,256,215,39,257,214,42
2111100M140,254,192,62,249,179,49,237,203,29,234,197,37,292,237,49,296,239,50
2111100Q127,412,269,143,415,254,142,273,204,63,270,190,80,415,249,163,414,252,145
2111100C143,139,72,67,143,46,88,94,61,31,93,50,43,154,62,91,153,68,84
2111100C126,677,548,129,686,542,97,380,309,66,374,291,83,662,530,120,661,536,101
2111100V115,797,382,415,801,320,432,598,350,238,593,292,301,848,395,423,852,424,383
2111100J143,80,34,46,80,30,48,57,25,31,57,23,34,81,30,51,82,29,53
2104300D105,160,85,75,164,61,93,116,61,50,115,61,54,159,61,94,166,55,89
2121300C101,330,113,217,339,94,238,184,78,105,183,70,113,381,114,264,357,123,228
2121300D103,458,301,157,465,300,155,284,189,90,280,183,97,486,327,155,460,297,149
2121300B103,762,257,505,774,222,523,551,294,245,539,238,301,966,300,649,953,315,595
2111100H106,618,446,172,616,410,157,532,442,80,523,419,104,642,496,134,646,502,124
2111100J105,367,226,141,367,204,148,290,192,93,284,180,104,420,239,177,419,252,157
2111100F186,1147,759,388,1157,721,357,827,642,173,813,558,255,1209,808,353,1218,836,335
2111100S156,554,328,226,551,319,201,411,292,112,410,268,142,570,358,198,569,356,188
2111100C137,602,356,246,609,328,230,488,354,130,480,305,175,676,434,226,676,436,213
2111100D108,834,441,393,847,415,358,665,444,214,654,376,278,841,496,328,841,490,329
2103700C501,459,193,266,460,190,235,330,202,116,316,166,150,511,242,257,522,256,246
2103700C102,723,314,409,732,297,382,528,344,180,509,260,249,873,406,448,881,443,402
2103700B910,243,105,138,245,104,129,151,96,54,143,72,71,253,122,128,249,129,116
2111700C138,656,202,454,655,214,391,437,207,221,433,176,257,793,307,469,791,308,459
2103700B909,930,312,618,933,331,546,740,352,379,725,277,448,1039,423,599,1023,417,574
2119300A111,120,73,47,127,42,80,83,42,41,84,43,41,134,49,83,118,55,58
2113300A103,435,151,284,461,59,384,312,130,176,306,116,190,494,74,412,515,115,370
2106900C102,541,219,322,546,126,400,442,167,260,439,136,303,580,130,445,594,142,429
2106900A103,353,163,190,366,99,258,254,121,129,245,107,138,393,103,288,373,106,254
2116500A101,308,138,170,317,83,228,233,122,95,222,104,118,330,93,228,325,114,196
2119300B102,224,93,131,244,53,187,142,66,75,134,53,81,197,47,147,176,53,121
2111900C106,29,7,22,35,0,34,24,3,21,24,4,20,34,3,31,32,3,29
2119700A101,458,198,260,473,111,348,350,144,193,341,121,220,516,116,397,514,141,338
2111100G106,520,395,125,512,378,88,438,369,64,434,343,91,571,481,85,574,473,90
2111100B169,691,306,385,693,261,386,526,277,238,523,233,290,738,312,406,741,322,397
2111100M121,602,495,107,603,480,87,471,414,51,468,406,62,617,521,82,617,523,78
2118300A102,450,158,292,452,101,333,292,135,148,291,100,191,496,119,369,504,128,338
2111100L144,223,213,10,228,215,8,174,167,6,173,160,13,246,235,8,246,235,8
2111100O133,849,413,436,851,277,523,652,377,265,645,310,335,948,405,525,948,432,475
2111100D106,654,343,311,656,316,303,579,402,166,569,335,234,754,438,299,758,437,306
2111100E142,620,340,280,613,319,256,522,367,148,513,318,195,692,429,250,694,430,246
2120100E101,224,70,154,224,40,179,157,62,94,156,51,105,248,44,203,252,57,184
2115100C109,1011,471,540,1016,350,595,828,476,329,819,379,440,1327,523,772,1332,525,754
2104300B102,308,158,150,308,58,241,208,97,102,206,75,131,337,65,268,318,112,197
2104300B104,484,211,273,495,106,369,325,149,168,327,146,181,518,115,394,520,144,345
2111100C101,681,578,103,682,556,103,561,485,73,560,462,98,724,589,124,726,593,118
2111100V119,1232,496,736,1240,426,744,987,493,481,978,410,568,1667,800,846,1666,804,826
2111100G165,414,234,180,411,220,157,345,232,104,342,205,137,416,252,153,411,237,168
2111100B168,943,425,518,955,391,525,740,419,310,733,371,362,1048,511,523,1048,534,479
2111100E182,1416,661,755,1407,666,694,1271,723,539,1250,603,647,1721,889,807,1725,846,854
2111100B161,102,35,67,102,29,70,73,40,32,72,34,38,109,38,69,109,45,62
2111100Q131,397,201,196,404,151,237,318,171,147,316,138,178,428,192,229,428,193,223
2111100G145,990,670,320,989,654,265,888,692,188,876,623,253,1138,837,282,1144,826,305
2111100D132,1269,783,486,1261,729,480,1081,738,320,1068,629,439,1331,832,469,1330,833,461
2111100O134,887,372,515,886,256,602,770,393,359,768,337,431,1104,402,676,1104,454,600
2111100D101,459,275,184,465,249,180,298,194,97,292,162,130,464,289,166,464,288,169
2104300C101,720,348,372,726,210,490,530,292,217,529,264,265,816,243,564,790,255,506
2104300D102,148,54,94,149,34,108,105,42,61,106,40,66,177,42,132,190,42,137
2111700A126,1049,431,618,1045,405,569,746,432,302,738,368,370,1217,548,642,1254,617,588
2119100A101,289,40,249,293,31,259,186,46,137,183,33,150,387,44,340,375,53,310
2119100D103,481,142,339,499,113,369,326,115,205,317,95,222,576,129,439,555,155,382
2118300E103,498,145,353,504,86,406,371,120,238,372,97,275,558,102,452,538,118,410
2101700B103,399,214,185,404,151,227,266,138,126,265,114,151,438,177,252,435,170,242
2101700D101,716,361,355,723,205,476,539,242,284,538,205,333,790,243,532,804,290,470
2116900B104,287,125,162,297,78,210,255,111,138,247,103,144,328,79,243,321,87,205
2116900D101,447,125,322,458,81,368,372,121,243,354,102,252,510,82,423,521,86,406
2115900A103,231,46,185,245,15,227,125,28,93,124,25,99,216,19,195,217,25,190
2112700B102,361,127,234,370,65,300,262,91,167,259,92,167,427,76,349,419,87,324
2103500A102,298,170,128,298,161,115,186,132,51,186,119,67,375,225,143,365,195,157
2104100A102,514,189,325,515,136,364,357,142,208,347,123,224,558,145,403,567,148,386
2102500D104,202,90,112,206,48,153,136,56,78,133,58,75,213,41,169,216,57,151
2102500A101,118,58,60,122,33,88,84,42,39,82,42,40,121,27,93,116,36,78
2102500C104,252,87,165,272,49,215,144,41,97,140,37,103,300,45,250,298,58,234
2102500D102,274,146,128,290,91,182,202,105,88,196,100,96,316,86,222,309,102,190
2111700A101,455,246,209,456,279,150,415,275,137,412,255,157,614,417,187,621,389,220
2111700B132,1556,451,1105,1564,467,982,1196,609,557,1171,444,727,1984,703,1233,1979,719,1169
2107100D106,459,173,286,483,98,371,298,143,149,297,151,146,492,104,381,487,120,352
2104100B103,315,160,155,319,100,206,201,104,92,200,95,105,355,104,245,347,132,194
2106700A128,602,412,190,597,352,207,473,351,115,470,319,151,650,430,207,646,428,204
2106700C109,390,183,207,395,139,233,324,161,162,327,151,176,435,189,239,445,198,236
2106700A117,516,436,80,512,395,90,452,377,68,452,368,84,579,478,93,578,468,101
2106700A135,487,401,86,507,372,111,333,282,47,326,264,62,534,408,116,531,415,102
2107700D101,453,127,326,458,87,357,291,114,166,284,90,194,533,96,430,524,132,366
2113100A102,450,54,396,468,28,432,339,68,266,321,60,261,496,39,457,495,50,438
2113100B103,191,13,178,199,10,186,140,22,117,137,13,124,215,11,200,213,15,192
2113100D102,222,46,176,234,33,191,158,54,102,157,42,115,253,41,209,256,51,199
2113100D103,167,31,136,180,22,153,128,37,91,122,29,93,189,26,160,186,31,150
2113100D101,282,50,232,290,35,248,201,62,133,200,55,145,298,36,259,296,40,248
2113100A103,32,6,26,35,2,33,23,5,18,23,2,21,31,2,29,32,2,30
2107100C104,483,300,183,526,173,337,357,252,100,354,253,101,527,173,345,524,226,272
2111700B121,871,231,640,869,192,628,641,242,386,627,171,456,959,252,690,944,322,592
2116900C102,219,74,145,220,46,171,213,74,138,204,63,141,259,49,209,249,55,194
2102500A104,331,156,175,336,97,219,239,122,115,233,113,120,303,83,211,316,96,205
2111700A111,454,257,197,455,241,189,289,191,94,288,171,117,516,306,201,539,346,176
2106700A118,448,280,168,456,232,205,358,229,125,353,214,139,516,305,202,504,316,176
2106700A104,269,110,159,273,101,156,215,104,105,215,93,122,292,128,161,290,124,162
2106700A171,495,306,189,499,233,236,384,231,148,383,215,168,545,299,234,543,303,227
2106700C237,513,252,261,516,202,267,395,225,163,387,192,195,552,265,268,569,261,281
2106700A184,232,129,103,232,129,71,130,113,16,124,97,27,252,174,69,254,169,73
2106700C156,498,326,172,499,264,195,376,284,86,375,253,122,535,339,181,540,345,176
2106700C143,429,301,128,437,271,135,329,252,69,329,237,92,485,339,135,472,336,127
2106700C228,482,262,220,481,217,228,383,251,126,384,217,167,564,306,245,561,290,253
2106700B125,503,338,165,506,293,173,428,308,117,420,283,137,554,368,173,553,376,161
2106700A136,529,336,193,530,268,204,419,300,108,413,268,145,574,346,213,598,385,200
2106700B135,594,383,211,595,351,171,439,330,103,435,307,128,591,405,161,598,393,180
2113100C101,469,85,384,485,43,437,305,64,234,300,46,254,529,33,490,521,52,448
2113100A105,106,12,94,110,13,96,89,19,69,86,13,73,129,12,115,128,13,103
2101500A111,997,308,689,1002,302,645,693,297,377,677,246,431,1237,442,774,1240,476,715
2101500C123,431,147,284,438,151,254,258,124,124,255,102,153,407,167,230,413,172,222
2113900C101,170,48,122,173,23,148,120,31,87,123,36,87,183,24,159,178,34,142
2117700A103,284,121,163,285,74,208,177,89,83,179,86,93,276,71,204,267,81,180
2106700C232,521,278,243,517,221,269,400,242,152,399,207,192,553,284,259,547,283,251
2106700B222,540,287,253,545,238,271,447,242,200,444,211,233,616,330,273,612,316,275
2106700B191,445,236,209,448,188,233,359,201,153,355,168,187,552,284,258,531,268,250
2106700C225,526,244,282,527,179,316,461,216,237,449,176,273,596,248,336,599,265,320
2106700B104,435,253,182,436,199,200,335,204,120,333,179,154,441,253,177,445,257,174
2106700B146,551,304,247,551,252,253,521,315,195,519,291,228,846,458,371,850,464,363
2106700B204,604,280,324,604,229,332,510,279,222,514,242,272,631,297,321,641,291,330
2106700B157,356,229,127,355,202,126,227,184,41,223,163,60,363,237,117,364,238,115
2106700C161,381,242,139,377,189,150,289,185,98,284,169,115,381,223,145,396,244,138
2106700B212,558,297,261,560,231,276,512,330,169,503,295,208,639,334,290,638,321,297
2105900B103,1042,378,664,1050,240,770,773,279,473,754,242,512,1130,293,824,1103,371,698
2117700E102,267,167,100,274,136,124,152,98,53,151,92,59,271,137,128,259,118,116
2117700D103,882,332,550,883,194,654,586,237,338,572,185,387,1020,225,777,1084,269,734
2106700A179,326,309,17,328,307,13,212,203,6,213,202,11,340,322,15,337,315,18
2106700A182,545,255,290,543,203,307,441,225,211,435,181,254,584,275,299,592,287,293
2101500B133,1219,347,872,1219,333,770,923,439,464,908,347,561,1509,506,959,1595,557,940
2115500D102,692,339,353,690,209,454,540,296,233,523,256,267,783,217,557,800,268,491
2102100C104,425,278,147,425,219,181,288,191,92,288,163,125,487,273,200,462,257,177
2105900H105,864,345,519,865,256,558,659,309,329,648,269,379,941,317,605,958,343,553
2115500E102,567,282,285,576,210,351,433,227,201,430,198,232,670,225,441,658,228,408
2122300A103,415,155,260,420,91,316,315,111,197,312,91,221,495,106,378,495,129,335
2122300A101,278,109,169,281,70,205,192,80,110,188,70,118,309,76,229,301,85,203
2122300C103,309,124,185,308,72,223,223,83,132,217,69,148,327,76,245,326,100,214
2102100E101,547,297,250,553,237,283,430,258,165,420,216,204,591,281,296,571,260,286
2111700A132,644,250,394,642,272,318,543,293,240,538,270,268,757,373,364,777,363,380
2111700C139,490,189,301,494,178,277,298,166,120,296,122,174,549,232,302,568,263,277
2111700B112,792,216,576,788,208,530,598,239,344,585,183,402,813,255,542,806,280,496
2111700B129,457,102,355,459,89,351,332,129,198,331,91,240,555,127,421,528,155,359
2122300D102,263,94,169,265,48,205,187,55,126,183,46,137,293,55,232,305,69,208
2122300C104,437,147,290,438,85,334,291,110,179,292,99,193,461,90,362,472,118,330
2121700B101,562,178,384,569,102,453,416,133,273,412,108,304,649,121,522,639,155,466
2104100B102,362,186,176,367,135,220,233,130,95,229,116,113,400,139,257,384,151,216
2123500D104,853,219,634,859,108,724,652,145,490,649,105,544,975,137,823,997,171,773
2111700C109,423,147,276,427,134,263,318,168,142,312,143,169,445,165,271,451,193,241
2118700A105,508,151,357,507,115,378,412,160,248,403,120,283,558,120,432,557,123,415
2118700A104,136,25,111,134,14,112,97,30,64,93,20,73,165,16,145,188,23,146
2118700B102,652,191,461,660,118,512,522,229,276,511,184,327,731,125,596,750,158,546
2120700D103,464,96,368,486,45,424,318,65,247,315,59,256,530,55,467,540,73,434
2103500C105,1352,593,759,1343,501,762,1081,560,503,1069,501,568,1443,601,817,1446,585,804
2103500C104,482,145,337,492,102,371,366,121,238,362,105,257,511,119,386,496,139,346
2112500E101,519,121,398,520,76,415,369,108,255,364,79,285,555,95,446,583,93,458
2107300D102,695,356,339,703,227,439,617,327,272,612,273,339,811,286,509,822,359,433
2120700C104,239,84,155,252,33,216,199,65,133,195,45,150,262,38,223,240,60,172
2120700A101,489,166,323,503,105,387,342,129,210,350,86,264,559,128,426,528,126,380
2120700E102,347,109,238,349,59,285,233,65,165,237,55,182,367,68,297,357,78,265
2103500A101,616,333,283,617,314,255,412,272,135,407,251,156,617,350,254,602,304,277
2121500D106,30,16,14,29,7,21,18,10,8,18,10,8,32,9,23,31,14,15
2117900D105,1120,474,646,1129,345,732,892,441,435,868,317,551,1229,379,831,1237,418,759
2117900D103,996,424,572,1011,334,642,726,322,387,721,252,469,1092,361,717,1071,368,661
2117900C102,800,405,395,810,342,434,604,337,248,595,256,339,862,368,482,840,350,455
2114300B101,581,212,369,583,156,407,461,212,239,448,170,278,628,190,431,635,190,420
2114300A102,695,251,444,700,169,500,522,206,313,516,181,335,757,178,568,772,195,541
2110900B104,380,71,309,389,42,339,286,48,238,282,35,247,419,51,365,426,49,361
2121900A101,294,46,248,308,33,267,190,51,134,186,47,139,345,31,308,334,46,266
2111700C119,427,164,263,428,163,222,308,166,133,299,128,171,485,220,250,514,235,250
2112700C101,130,39,91,127,13,114,77,21,54,79,19,60,148,16,132,152,27,125
2115900B101,149,44,105,159,13,138,98,21,74,99,20,79,159,15,143,161,19,140
2112700C102,237,82,155,257,42,207,173,74,94,170,62,108,348,59,283,337,66,253
2112700B101,289,127,162,294,82,205,183,97,82,181,96,85,315,90,222,307,81,210
2121500D103,176,62,114,177,37,130,139,46,91,142,39,103,197,44,150,206,49,139
2104900D103,601,255,346,600,142,441,500,198,291,500,148,352,711,192,512,709,239,449
2117900E103,810,320,490,812,219,552,617,258,347,615,207,408,915,250,650,929,292,597
2101500B135,1115,258,857,1113,291,762,850,334,501,835,241,594,1523,472,1028,1495,444,1002
2101500B130,964,224,740,962,250,658,894,331,556,893,251,642,1357,427,906,1333,400,882
2111500A110,200,66,134,208,27,179,123,44,74,123,34,89,183,21,157,183,30,144
2107300D105,268,157,111,267,98,147,199,133,62,194,118,76,277,113,155,285,144,128
2107300A104,440,299,141,436,256,170,371,267,96,372,235,137,508,313,191,475,292,174
2107300F101,459,194,265,465,121,332,382,163,210,375,141,234,489,138,347,489,176,304
2107300A106,633,254,379,644,155,443,532,238,278,524,203,321,618,165,436,663,217,409
2115900E102,351,111,240,367,45,313,185,52,133,183,46,137,389,45,342,387,49,332
2112700D105,313,106,207,323,56,254,238,98,137,236,88,148,406,73,327,437,80,318
2121900A102,365,80,285,375,62,301,202,83,108,201,72,129,397,41,350,382,56,310
2102100D102,773,302,471,765,217,503,722,316,400,718,253,465,930,298,610,976,306,624
2102100E104,434,307,127,443,306,110,322,251,66,315,225,90,420,309,98,368,229,124
2102100D101,761,366,395,763,313,412,630,341,280,625,279,346,841,382,445,821,330,467
2121700B102,706,270,436,725,201,490,520,224,287,515,168,347,854,249,590,849,245,554
2112300B103,343,137,206,343,88,250,229,85,135,228,77,151,388,100,286,364,106,248
2104900F102,247,116,131,243,80,149,196,94,97,186,82,104,255,96,154,263,97,153
2101300D103,317,104,213,333,85,242,157,61,95,157,49,108,330,85,243,313,82,225
2115900D101,183,47,136,191,21,166,102,28,71,101,23,78,200,24,175,199,27,169
2112700A103,241,119,122,240,47,181,181,92,87,181,89,92,291,60,224,280,87,180
2121700C104,399,167,232,412,123,285,280,125,147,281,116,165,439,135,303,399,134,260
2115500A102,383,173,210,397,92,288,303,102,198,296,88,208,433,91,336,422,130,278
2115500H103,286,179,107,287,101,176,209,110,89,203,94,109,352,114,234,331,153,162
2102100A103,321,129,192,325,73,246,263,102,158,261,77,184,390,97,289,383,127,246
2102100F102,511,242,269,507,180,303,412,208,192,414,159,255,557,219,326,558,217,316
2105900A136,488,226,262,489,165,296,344,182,154,338,142,196,479,182,286,481,200,249
2107900B102,686,227,459,694,121,549,550,179,357,537,123,414,740,143,588,741,165,545
2107900B101,411,158,253,414,111,278,292,127,153,284,105,179,470,139,317,478,122,319
2105900E102,673,211,462,683,136,499,521,179,332,512,149,363,749,174,560,769,217,509
2107300C101,316,186,130,317,142,157,259,156,94,259,139,120,332,162,164,329,169,149
2107300C107,823,522,301,829,434,357,742,487,237,728,416,312,928,520,394,897,500,365
2107300B105,404,225,179,408,158,227,347,205,133,345,183,162,401,169,223,406,192,194
2107300D108,310,182,128,311,133,165,277,174,99,274,144,130,325,150,171,318,164,146
2100100E104,675,210,465,697,164,506,493,195,287,486,127,359,741,176,556,736,167,536
2101300C103,287,104,183,298,68,219,179,76,95,176,69,107,301,70,226,299,84,200
2105100E103,484,100,384,496,46,439,382,109,263,382,68,314,523,61,456,519,67,432
2107900E101,693,229,464,702,135,547,559,183,365,550,148,402,816,173,635,808,181,596
2104900B102,880,380,500,877,225,622,734,326,398,738,261,477,993,290,690,985,340,620
2105900H116,157,69,88,156,43,94,119,48,68,118,42,76,143,47,90,162,61,83
2111500A107,269,107,162,288,58,222,151,54,92,151,58,93,300,79,218,295,81,202
2121900E102,443,207,236,456,205,243,211,103,105,206,87,119,510,242,261,529,266,219
2121900D101,136,53,83,136,52,82,90,43,45,92,38,54,164,68,94,171,79,83
2104900A101,1076,416,660,1063,272,737,939,371,553,934,305,629,1248,368,857,1297,390,858
2111500C108,187,65,122,197,26,170,135,40,91,134,40,94,217,32,184,214,34,168
2111300E106,961,300,661,951,228,638,866,293,547,849,211,638,1097,356,716,1092,323,736
2117700C103,450,220,230,458,134,312,254,122,128,246,112,134,463,135,323,448,156,267
2112100B105,355,87,268,373,32,330,234,71,161,238,48,190,407,38,365,414,63,336
2112100D104,522,166,356,531,112,401,410,156,248,409,124,285,615,141,466,626,126,469
2110100D101,407,246,161,408,215,176,300,195,101,297,171,126,414,232,176,412,236,161
2104900E102,1319,608,711,1326,390,857,1054,485,553,1047,403,644,1506,509,964,1520,552,894
2103500B109,648,360,288,649,329,261,380,243,129,379,229,150,649,368,261,659,331,284
2123500C108,268,57,211,274,18,252,191,62,122,191,35,156,283,21,259,282,40,233
2110700E032,277,62,215,284,21,254,201,48,149,199,44,155,330,30,296,339,66,255
2110100B103,535,182,353,538,126,395,409,163,236,403,147,256,601,156,438,600,184,398
2110100B109,174,78,96,174,49,112,101,56,42,102,48,54,155,47,103,170,52,94
2110100B102,261,89,172,263,53,200,175,61,112,174,47,127,262,56,202,270,64,187
2110100C101,457,215,242,457,143,296,284,134,145,283,124,159,475,151,315,487,184,271
2101300C104,380,137,243,406,92,300,234,110,121,230,104,126,422,97,317,407,113,270
2101300E105,332,42,290,354,29,317,202,47,149,198,33,165,332,27,302,337,31,291
2108900C104,571,285,286,581,165,392,391,198,185,387,176,211,657,196,449,652,230,376
2108900B101,445,205,240,446,131,302,299,135,160,292,129,163,494,152,336,489,160,307
2112100A101,255,57,198,268,26,236,179,34,144,181,33,148,288,30,255,293,41,242
2112100A104,609,182,427,627,82,521,436,137,293,436,101,335,688,99,577,722,132,536
2108900A109,934,372,562,948,274,633,719,316,392,716,286,430,1040,318,705,1078,292,719
2111300D104,958,305,653,958,226,617,740,295,431,733,237,496,1050,344,677,1071,320,710
2101300D106,429,138,291,451,101,331,301,139,154,289,115,174,480,109,360,481,117,334
2101300B108,187,61,126,191,27,159,100,44,55,102,39,63,209,30,177,211,54,148
2101300B103,272,84,188,285,48,237,175,61,113,173,54,119,303,51,252,281,70,211
2101300A103,260,54,206,268,19,248,131,24,106,130,23,107,292,20,271,287,46,238
2110900C104,274,40,234,284,20,251,207,36,165,205,27,178,306,25,276,339,28,279
2100900G101,978,405,573,975,272,648,674,295,367,669,237,432,1117,347,750,1127,323,747
2123900A102,858,522,336,864,453,358,797,519,265,784,456,328,1017,605,393,951,519,402
2100900A104,213,76,137,215,39,165,153,49,100,151,40,111,196,39,153,205,49,143
2110700B015,248,105,143,255,87,154,147,78,66,144,71,73,259,104,149,258,93,140
2123900G102,742,318,424,731,241,437,718,390,319,709,319,390,992,390,580,1034,382,613
2112100E104,525,148,377,551,85,447,358,113,243,355,95,260,618,104,504,619,109,482
2109300E006,461,214,247,457,147,278,316,165,141,319,111,208,546,203,328,566,243,290
2109300E007,608,305,303,621,258,327,467,294,159,463,238,225,909,450,437,891,434,406
2109300E004,424,212,212,431,181,225,282,141,133,279,105,174,525,224,288,515,218,268
2110700B013,213,40,173,213,25,182,158,52,104,156,31,125,194,28,164,197,33,157
2109300F005,825,275,550,827,198,597,658,237,405,651,161,490,904,249,640,910,284,588
2111300D105,683,201,482,673,145,427,495,190,293,490,141,349,677,208,440,727,199,493
2111300B101,808,299,509,808,195,565,674,254,412,672,202,470,877,255,607,908,260,618
2116100B102,373,112,261,382,74,301,245,95,145,238,85,153,413,86,324,401,107,285
2111300F101,431,212,219,430,126,276,322,171,139,320,137,183,467,163,293,465,183,263
2111300A102,396,191,205,397,117,253,330,169,153,327,144,183,422,148,263,429,162,242
2112100D102,298,93,205,306,54,244,214,89,116,207,66,141,340,65,272,336,68,258
2116900D102,219,73,146,222,29,179,180,50,129,172,43,129,248,30,210,268,51,188
2119900A105,256,105,151,263,75,175,163,76,81,159,61,98,230,77,148,218,64,137
2116900A102,587,226,361,600,153,422,484,192,276,480,172,308,667,159,494,674,159,464
2102300F101,431,125,306,435,87,338,300,147,134,294,112,182,504,97,402,505,124,359
2111500C107,431,115,316,444,44,388,334,104,225,332,91,241,531,68,456,528,81,425
2123500C113,151,49,102,151,27,121,101,39,61,99,28,71,166,33,131,165,37,119
2111300F102,505,244,261,509,155,331,423,200,217,419,158,261,561,201,352,540,211,314
2111300F103,772,386,386,776,234,496,549,277,264,548,219,329,871,311,542,855,343,477
2114100B102,530,170,360,546,161,376,316,120,186,311,110,201,581,168,410,554,182,364
2119300C107,429,144,285,437,68,352,286,124,159,285,102,183,410,72,332,431,98,315
2123300C103,424,177,247,435,133,289,290,145,136,286,119,167,482,160,315,476,150,286
2121100E104,418,132,286,423,111,295,340,105,226,335,83,252,462,135,322,450,131,309
2100900A101,762,392,370,763,277,461,595,318,269,589,245,344,808,318,481,749,282,436
2100900E102,530,231,299,534,129,387,360,150,204,354,115,239,543,144,393,533,162,343
2121100D101,435,164,271,439,101,316,338,132,196,333,101,232,461,119,333,468,157,283
2115700A101,722,274,448,728,175,514,556,270,262,547,224,323,759,209,542,750,222,508
2114500C110,1266,364,902,1258,260,951,940,307,610,929,261,668,1368,330,1023,1385,378,979
2100100F101,768,226,542,788,140,626,553,175,366,547,132,415,887,157,720,872,187,652
2100100B102,619,174,445,644,160,452,335,120,209,332,90,242,546,138,398,552,111,411
2123900F102,1011,500,511,1006,344,581,854,460,365,839,386,453,1109,453,628,1142,489,602
2109300G008,994,309,685,1003,153,811,684,198,472,686,165,521,1098,195,883,1118,324,743
2109300A010,83,34,49,82,32,47,48,26,18,47,19,28,172,76,94,164,66,98
2109300E002,535,230,305,543,199,313,422,246,169,420,184,236,601,250,337,593,238,327
2123900C102,770,433,337,771,267,455,614,338,258,600,277,323,832,339,475,825,409,383
2105100E102,218,67,151,229,35,191,165,61,98,160,44,116,264,34,229,263,41,212
2100100A104,412,88,324,427,30,384,300,50,246,296,39,257,472,33,433,469,71,382
2116300D103,596,297,299,605,193,372,414,229,170,407,181,226,628,212,395,626,226,347
2112900D102,453,148,305,469,81,373,339,111,221,329,78,251,459,82,368,461,86,356
2112900B102,253,77,176,268,43,220,190,44,145,191,40,151,304,51,249,289,52,235
2112900A103,301,108,193,316,54,253,265,88,170,261,70,191,356,63,286,346,72,259
2115700A104,557,191,366,557,82,461,404,132,262,399,117,282,578,86,488,578,132,429
2115700B104,418,184,234,423,120,285,280,136,127,277,116,161,442,142,293,421,155,253
2122700C110,603,337,266,600,357,196,301,256,42,295,216,79,402,271,122,406,235,153
2118300A104,305,100,205,307,54,246,210,70,130,207,48,159,350,66,280,346,83,244
2109500C104,271,97,174,279,68,193,165,78,86,169,71,98,298,78,210,312,81,206
2101900B107,335,154,181,328,107,204,216,108,102,214,99,115,332,120,205,351,125,208
2108700A104,469,150,319,478,78,388,308,71,234,302,63,239,530,89,437,534,113,393
2100500D102,1073,426,647,1080,254,778,911,370,520,897,295,602,1223,315,889,1212,341,824
2105100C101,161,31,130,172,16,152,137,25,109,135,12,123,201,14,185,200,15,179
2101900C107,326,186,140,334,116,200,181,118,57,180,107,73,360,139,214,346,160,170
2122700E101,738,305,433,740,267,445,484,247,233,481,209,272,825,345,470,806,360,421
2122700E106,1031,318,713,1028,232,747,762,277,474,758,221,537,1122,303,800,1119,380,703
2110300C103,208,83,125,209,53,144,157,71,85,154,59,95,243,64,175,239,74,157
2100500F101,598,229,369,597,123,450,525,182,335,515,155,360,752,169,570,753,203,520
2100500D101,798,258,540,799,138,629,693,205,476,687,153,534,933,177,743,956,213,711
2122700D104,485,188,297,489,148,321,366,164,198,358,129,229,515,182,325,511,212,277
2101900B121,454,203,251,454,148,288,297,148,141,298,140,158,497,178,309,510,175,308
2101900C104,528,212,316,531,115,392,400,177,219,399,153,246,576,140,428,599,186,394
2118300C101,338,152,186,337,85,244,222,108,110,214,82,132,335,90,242,322,110,193
2101900B116,399,203,196,404,143,247,275,174,98,271,147,124,423,163,253,415,167,229
2120500C101,718,395,323,730,245,463,530,321,196,525,256,269,848,279,557,858,308,496
2120500D104,364,227,137,371,151,203,283,191,86,278,166,112,395,161,228,383,166,198
2116500D101,473,214,259,476,115,349,376,170,201,372,150,222,554,133,418,551,166,367
2114100B104,397,148,249,398,138,245,286,125,150,279,110,169,420,139,273,420,150,254
2118500D103,1059,287,772,1051,228,774,893,311,564,875,228,647,1292,349,925,1284,391,864
2122700D108,826,225,601,829,208,589,681,286,387,672,226,446,1101,328,760,1059,324,713
2122700B110,680,444,236,684,445,179,442,363,77,435,343,92,741,539,178,758,492,215
2123100A106,296,89,207,314,64,246,206,80,118,211,66,145,343,72,269,324,66,251
2101100C104,299,163,136,299,102,192,224,121,100,221,100,121,349,85,262,349,115,216
2104700A103,519,489,30,534,499,27,280,256,21,276,245,31,556,525,26,566,531,26
2104700A105,282,196,86,286,188,88,152,112,35,152,106,46,278,191,82,288,205,72
2102900C105,570,201,369,577,133,418,421,168,243,411,123,288,588,149,431,580,167,394
2118500C101,685,198,487,675,171,478,565,206,342,558,162,396,728,225,494,718,232,470
2122100B102,711,205,506,714,169,516,498,172,319,482,154,328,796,195,589,809,224,546
2122100X001,0,0,0,0,0,0,0,0,0,0,0,0,0,0,0,0,0,0
2101900B117,348,164,184,348,115,218,271,144,117,266,120,146,384,139,237,392,143,228
2102900B113,943,319,624,953,221,697,760,324,419,750,236,514,1252,318,919,1231,339,854
2102900A111,706,292,414,719,187,487,407,212,182,403,170,233,836,240,573,844,277,506
2102900C108,822,289,533,833,197,615,649,249,384,643,215,428,919,236,676,886,255,608
2109900C103,314,124,190,316,80,223,283,112,165,279,98,181,373,86,283,384,96,263
2102900A103,622,240,382,624,186,382,487,265,200,472,219,253,917,306,577,990,292,599
2102900D111,578,214,364,590,141,421,370,154,207,362,115,247,602,158,432,598,177,388
2102900B109,1268,415,853,1277,279,944,1008,383,602,983,283,700,1472,352,1095,1488,388,1028
2102900D107,1088,339,749,1092,207,838,880,324,525,866,235,631,1291,269,1001,1313,326,929
2118500B102,1187,408,779,1180,397,717,1049,472,563,1052,406,646,1512,615,868,1497,562,882
2119300C110,293,72,221,305,22,282,185,38,143,183,43,140,314,25,288,320,53,265
2106900A102,252,98,154,250,54,194,180,62,114,176,53,123,295,61,234,291,69,222
2106900B102,544,224,320,547,109,409,412,163,241,407,132,275,607,119,478,637,152,447
2108300A102,363,117,246,376,50,323,277,84,192,270,90,180,375,52,322,349,82,264
2121100F105,667,143,524,660,125,508,592,171,415,587,138,449,787,168,609,806,155,623
2121100A102,556,311,245,563,277,255,444,254,172,443,233,210,800,430,354,771,392,337
2121100F103,499,172,327,504,138,320,407,186,211,400,156,244,578,182,379,608,185,383
2119500F108,804,320,484,817,119,676,540,229,298,553,237,316,772,125,640,778,191,568
2102900X001,0,0,0,0,0,0,0,0,0,0,0,0,0,0,0,0,0,0
2109900E102,190,79,111,191,49,134,138,60,74,133,45,88,241,58,178,240,71,156
2123700C101,360,175,185,367,103,254,340,204,131,321,180,141,464,128,329,463,146,301
2115300A101,384,172,212,408,108,295,250,152,94,257,157,100,454,135,317,452,151,284
2119500D102,446,168,278,467,57,398,308,120,177,292,105,187,483,65,413,478,110,357
2119500E101,399,166,233,436,61,372,301,111,177,292,131,161,452,70,382,405,107,296
2119500B105,627,188,439,648,87,554,438,188,244,433,179,254,684,101,581,694,124,570
2116100A105,391,112,279,397,86,292,274,82,187,267,73,194,412,98,308,421,105,298
2122700B109,494,294,200,499,265,168,362,279,78,360,250,110,640,400,208,685,405,227
2114700F106,106,16,90,112,13,97,88,25,56,86,23,63,122,14,107,117,11,106
2117300B102,806,351,455,817,165,624,612,241,359,613,217,396,962,200,747,962,287,639
2117300C102,866,357,509,866,207,626,636,298,321,630,253,377,1006,248,743,1023,289,708
2117300A103,620,321,299,620,205,378,510,252,251,506,216,290,684,235,430,690,249,398
2108700C102,447,135,312,469,63,400,328,76,251,322,57,265,478,65,410,456,92,350
2115300A102,472,220,252,495,137,350,319,175,140,312,156,156,500,106,391,498,120,359
2111100H146,726,375,351,735,299,405,539,327,202,535,277,258,802,357,433,798,391,373
2111100Q103,990,613,377,1002,527,421,761,510,236,752,443,309,1043,587,434,1046,617,388
2111100C122,555,357,198,555,332,176,454,352,97,452,320,132,634,442,180,638,447,166
2111100L141,382,293,89,387,300,65,285,243,38,281,229,52,474,391,72,476,397,69
2111100S119,1035,575,460,1033,562,409,895,590,300,879,494,385,1078,675,384,1089,670,403
2111100D121,620,316,304,625,278,307,489,306,172,485,251,234,692,342,325,688,355,314
2122700E108,634,207,427,641,144,474,453,171,274,447,133,314,665,178,478,651,233,396
2122700D111,529,215,314,529,197,300,313,163,146,312,142,170,556,242,302,563,242,291
2122700F115,459,166,293,461,155,259,405,225,173,404,180,224,657,268,367,689,262,381
2122700B102,227,161,66,230,162,61,122,95,26,119,85,34,256,194,60,238,177,60
2122700E105,446,168,278,444,106,322,310,118,184,305,103,202,465,132,326,466,190,259
2103100B107,749,218,531,758,154,576,534,155,369,519,114,405,801,170,619,802,181,562
2111100H118,686,429,257,686,371,265,569,411,147,560,364,196,705,427,264,706,431,252
2111100G121,577,342,235,570,329,208,542,376,160,531,327,204,627,422,198,624,408,211
2111100B183,1376,552,824,1389,503,808,1143,596,529,1128,463,665,1529,644,853,1539,646,850
2111100Q105,1131,675,456,1131,554,527,903,589,290,898,520,378,1311,759,526,1314,792,485
2107500A101,241,129,112,243,109,124,154,90,61,153,81,72,272,124,143,282,113,140
2105300C101,364,67,297,376,40,328,204,46,157,204,38,166,410,43,362,425,71,329
2114700B104,217,24,193,225,17,199,200,46,150,196,23,173,250,19,226,296,17,233
2114700D101,580,153,427,600,84,505,470,172,285,450,100,350,644,89,550,636,106,494
2114700A102,480,111,369,499,61,434,408,106,291,405,82,323,609,73,534,570,87,483
2118300E105,253,88,165,259,49,201,184,83,95,176,62,114,268,55,211,261,67,181
2106300B101,326,183,143,363,101,248,264,156,93,252,130,122,377,97,276,364,106,240
2111100K144,559,326,233,560,291,249,472,317,148,461,282,179,616,354,255,615,376,226
2113300E106,98,35,63,103,27,72,78,39,36,76,37,39,123,37,84,122,29,89
2106300E101,372,222,150,395,110,269,324,216,106,299,168,131,388,99,284,376,122,238
2114900C102,615,201,414,608,107,480,499,171,319,495,138,357,663,121,534,655,140,468
2119900D115,272,129,143,282,78,187,178,73,97,177,66,111,295,97,190,280,95,156
2103700A405,640,237,403,641,251,341,440,239,198,427,188,239,636,279,344,644,276,343
2116700A103,532,192,340,546,92,430,415,133,275,411,105,306,570,110,450,580,143,404
2109900E104,423,124,299,431,69,349,317,89,224,315,77,238,546,76,464,550,98,439
2111100I133,1065,472,593,1082,286,739,825,411,391,813,314,499,1164,324,824,1162,376,725
2111100S142,626,340,286,632,309,281,600,386,207,591,332,259,818,466,341,824,470,330
2119700E102,532,243,289,535,130,389,401,186,211,399,162,237,568,125,429,564,138,401
2103700B702,777,226,551,783,218,504,630,301,312,618,220,398,842,275,545,851,298,504
2114500B125,841,211,630,838,138,668,634,178,451,630,152,478,882,170,702,900,214,668
2111100B160,538,238,300,538,199,304,433,243,186,425,195,230,567,253,300,565,260,282
2111700A133,870,398,472,872,401,393,682,414,251,670,352,318,1008,539,442,1063,568,447
2123100G104,576,173,403,584,89,488,441,133,299,437,89,348,622,98,521,613,125,477
2123100G106,639,235,404,652,121,516,504,181,313,499,142,357,734,142,584,733,180,509
2111700A117,502,212,290,515,189,292,295,188,96,291,160,131,550,235,303,556,279,254
2119300C109,242,81,161,258,28,227,188,59,127,183,54,129,298,36,260,285,67,216
2113300A107,177,48,129,184,19,160,102,43,57,102,38,64,144,17,125,154,27,123
2114900D101,634,232,402,641,127,491,506,186,306,499,161,338,705,142,552,695,168,487
2119700D102,228,127,101,229,81,144,171,100,70,172,90,82,254,80,173,254,95,146
2114500A112,923,306,617,924,218,669,689,239,441,680,207,473,973,266,693,984,306,645
2104500D102,276,86,190,287,34,244,224,54,169,222,45,177,332,42,286,318,61,238
2111100C108,730,636,94,734,632,86,558,509,43,553,478,75,839,698,125,836,706,109
2111100L113,667,586,81,665,587,48,509,478,26,503,451,52,787,710,58,789,704,67
2119300C105,267,99,168,273,62,202,202,103,90,206,105,101,295,74,216,303,77,212
2111900C107,141,57,84,148,29,113,113,51,62,110,50,60,152,39,113,152,42,109
2111900B101,315,116,199,359,43,304,258,112,139,248,84,164,373,50,321,368,65,293
2111900A106,159,70,89,167,36,128,125,54,70,117,57,60,185,47,138,182,50,127
2113300E103,395,146,249,417,79,330,244,108,128,243,93,150,445,96,346,434,108,315
2113300D107,351,125,226,380,76,295,260,119,133,254,104,150,396,91,302,379,91,279
2113300C102,184,61,123,197,30,161,112,55,56,108,53,55,197,35,159,200,43,147
2111100A105,1196,707,489,1204,603,563,860,618,225,853,554,299,1264,705,534,1263,727,487
2123100A102,225,103,122,232,49,177,134,64,67,133,41,92,225,50,172,215,68,132
2111100N137,143,141,2,142,138,2,102,99,3,100,95,5,139,134,5,138,133,4
2111100L157,498,484,14,496,479,5,338,332,5,336,314,22,484,471,8,485,472,9
2111100N105,588,557,31,582,544,32,421,401,16,418,379,39,633,592,31,636,593,31
2111100L104,631,599,32,636,607,22,446,428,16,439,408,31,621,584,26,621,591,18
2111100E171,510,287,223,514,280,204,448,304,138,442,257,185,566,335,220,567,328,228
2111100N130,861,537,324,861,528,241,673,489,181,667,439,228,882,600,266,886,594,273
2111100V116,878,371,507,876,317,517,688,337,341,675,285,390,1016,421,576,1017,431,558
2111100Q107,971,596,375,977,552,358,769,538,221,752,458,294,1044,641,384,1041,657,354
2111100F158,299,120,179,294,108,166,241,128,109,236,99,137,311,136,169,312,135,169
2111100E158,504,257,247,504,245,241,439,279,152,434,229,205,516,294,212,520,287,220
2111100D115,941,562,379,937,515,375,740,510,216,728,436,292,1047,651,376,1052,653,363
2111100V108,1321,404,917,1329,376,899,1182,421,746,1167,350,817,1868,628,1213,1880,625,1215
2111100M103,1058,1039,19,1068,1048,13,806,789,14,799,744,55,1107,1070,22,1107,1074,22
2111100A128,620,301,319,625,229,371,473,273,190,470,231,239,715,294,407,712,316,364
2111100A121,750,386,364,755,287,437,540,323,199,538,282,256,804,359,432,804,392,368
2111100N126,528,181,347,511,176,302,451,184,264,444,147,297,612,257,343,617,227,384
2111100N148,350,345,5,353,342,3,200,198,1,196,188,8,295,283,6,292,282,5
2111100H114,8,6,2,8,6,2,12,7,5,12,7,5,12,8,4,12,8,4
2111100B170,633,297,336,627,268,333,477,278,189,474,229,245,640,304,321,644,320,305
2111100I153,1188,649,539,1204,511,616,821,523,275,816,440,376,1309,625,655,1304,680,577
2121300C103,390,169,221,398,125,262,304,165,136,301,139,162,607,204,396,586,249,321
2108300B107,236,142,94,245,126,105,140,81,53,139,85,54,210,114,91,190,87,88
2113300D103,222,93,129,235,37,190,140,82,57,135,72,63,236,43,190,234,66,157
2119900C106,790,199,591,807,84,699,603,125,472,607,97,510,896,112,772,912,158,704
2119900D110,898,215,683,922,104,776,714,190,509,710,145,565,1001,138,845,1026,169,802
2120300C101,736,182,554,758,82,652,610,147,444,601,99,502,849,94,752,851,111,710
2120300C102,659,161,498,669,82,576,517,152,349,523,105,418,733,99,629,734,100,603
2115100B103,1026,459,567,1026,353,612,862,454,389,854,379,475,1109,433,652,1107,419,648
2111100C109,308,275,33,310,270,38,215,195,17,212,186,26,294,243,46,293,240,43
2111100E168,422,172,250,422,159,240,298,132,161,296,116,180,427,185,236,430,187,238
2111100F156,1016,486,530,997,432,508,729,418,301,720,341,379,961,489,453,963,491,434
2101100B103,702,347,355,728,205,499,539,299,231,538,263,275,976,273,692,974,319,606
2104300D107,366,193,173,382,99,270,258,152,95,254,142,112,395,105,285,369,130,217
2109700E102,502,207,295,504,108,384,393,159,224,395,127,268,594,137,454,606,143,445
2104300E105,482,158,324,505,74,414,346,127,199,351,108,243,629,95,524,635,127,486
2104300C104,516,249,267,523,107,388,388,199,178,387,183,204,584,125,449,590,184,366
2108300B109,415,170,245,418,149,251,334,158,172,315,129,186,433,163,263,423,126,277
2111700B120,831,179,652,841,156,653,662,228,425,654,174,480,1040,229,798,974,278,671
2119100D102,375,110,265,378,76,288,284,110,169,274,91,183,438,79,356,443,101,323
2119100A103,435,85,350,442,68,359,323,98,218,314,72,242,554,92,456,559,109,422
2119500F102,265,98,167,290,39,242,168,71,91,165,68,97,330,49,278,325,71,237
2119500C102,215,126,89,224,77,142,203,121,74,203,120,83,266,99,165,234,93,128
2119300A114,510,199,311,526,93,422,363,176,186,361,162,199,554,108,440,546,150,380
2109100B102,409,166,243,416,125,268,378,194,175,367,162,205,462,140,313,458,147,288
2100300B102,566,112,454,583,73,494,331,75,251,327,52,275,637,83,546,624,104,497
2103700A604,242,131,111,242,128,89,203,148,51,201,142,59,303,185,110,327,198,116
2103700B912,424,155,269,428,142,265,275,143,124,271,108,163,477,181,288,469,205,247
2115100A106,1293,610,683,1296,441,762,1067,601,449,1061,533,528,1618,629,943,1625,648,908
2115100B104,759,249,510,762,156,581,677,241,419,672,196,476,911,213,686,920,252,647
2100700C104,279,87,192,284,53,219,204,74,128,202,59,143,302,56,242,313,62,232
2114500C114,522,128,394,515,81,417,397,123,272,396,105,291,519,95,418,534,123,399
2114900B101,588,202,386,596,146,421,475,178,287,471,164,307,618,151,456,624,177,402
2114500B121,573,153,420,574,110,436,460,182,272,460,148,312,624,141,474,637,161,462
2114500B117,760,187,573,760,136,597,605,191,403,597,159,438,821,171,639,837,193,618
2114500C121,433,201,232,431,184,212,350,196,143,344,177,167,447,220,216,463,198,239
2114500C122,493,151,342,492,139,334,425,170,247,420,141,279,556,181,369,558,162,382
2115100D107,7,4,3,7,3,2,5,2,3,5,2,3,8,4,3,10,5,4
2109100D102,405,136,269,403,79,300,367,140,210,360,117,243,427,85,335,443,115,306
2109700G102,368,148,220,378,95,276,273,88,183,272,84,188,446,98,343,431,95,313
2109700D102,599,251,348,606,147,430,495,193,292,484,155,329,729,168,553,729,194,515
2100700B101,517,205,312,519,148,351,377,156,211,374,154,220,526,148,369,516,139,358
2114500B127,595,159,436,593,110,458,467,186,272,465,155,310,629,136,484,648,162,465
2100700C101,220,65,155,214,41,168,175,50,122,168,49,119,216,40,175,224,44,176
2119300B101,319,131,188,333,78,250,208,104,98,206,96,110,332,85,244,314,92,215
2119300A109,421,177,244,441,111,321,288,115,169,290,121,169,455,125,325,435,130,289
2119300C114,395,137,258,413,73,334,286,117,166,284,103,181,422,82,337,405,100,305
2109700G101,539,184,355,536,93,433,401,131,257,395,104,291,621,94,523,627,117,493
2104300A104,321,143,178,322,78,218,201,102,89,198,94,104,338,86,241,376,101,233
2104300C102,120,66,54,123,35,83,87,46,38,86,38,48,142,42,99,133,50,76
2119300B105,406,172,234,420,96,307,280,133,144,277,124,153,427,108,312,426,127,279
2120900B103,549,214,335,544,131,391,468,197,267,465,154,311,666,185,470,671,229,419
2109700C101,522,230,292,527,123,379,393,156,232,394,133,261,565,146,410,566,150,402
2104300A105,553,215,338,560,128,402,433,224,200,431,188,243,619,148,462,648,157,460
2107500A103,92,69,23,91,65,24,44,28,15,44,28,16,91,66,24,86,54,26
2121100B103,305,116,189,302,88,205,228,78,148,224,61,163,334,108,223,326,115,203
2105700D102,312,92,220,316,61,238,210,75,134,205,50,155,338,68,265,365,89,239
2109500D106,483,138,345,538,48,472,326,96,223,312,96,216,539,58,477,523,71,428
2109700C102,579,245,334,577,137,415,468,215,246,468,177,291,621,169,442,625,173,432
2107100D109,207,131,76,226,71,148,119,83,32,122,88,34,168,34,133,169,42,123
2107100B101,310,168,142,320,94,208,215,131,77,210,119,91,285,77,203,281,99,168
2117100E102,496,68,428,518,54,453,348,71,267,345,54,291,550,59,487,556,59,478
2117100C103,400,92,308,419,60,352,283,79,202,276,48,228,415,61,352,405,73,320
2107100C106,229,142,87,269,69,195,195,115,69,200,121,79,321,89,230,317,135,172
2110300C101,692,279,413,695,175,477,556,247,294,549,198,351,809,212,582,813,250,522
2110300D101,806,285,521,813,189,582,617,228,382,610,190,420,897,215,668,899,241,618
2107100D101,314,201,113,343,103,230,206,144,55,206,149,57,284,71,206,279,85,186
2102500D106,236,133,103,234,81,143,186,104,80,180,92,88,282,76,200,281,92,181
2103300C101,557,174,383,561,105,440,437,137,297,431,119,312,638,127,504,639,151,461
2110300E103,239,75,164,237,54,161,198,81,112,195,63,132,267,65,195,296,67,205
2113900B102,576,202,374,584,140,425,434,183,246,430,158,272,644,151,487,631,151,460
2123300B103,317,119,198,318,76,232,220,97,122,218,85,133,327,86,237,337,95,214
2113900A101,1091,358,733,1104,198,848,736,266,456,730,231,499,1116,197,901,1150,248,837
2106700C154,355,160,195,348,117,208,262,123,134,258,113,145,392,161,226,395,161,226
2106700A180,380,217,163,382,200,140,291,204,84,286,178,108,458,295,149,463,266,180
2106700A139,495,278,217,497,227,233,397,246,140,389,213,176,546,307,228,542,313,219
2101500C125,451,140,311,456,126,308,284,127,154,280,93,187,505,165,332,502,194,290
2113900D103,427,136,291,430,79,336,318,104,206,316,87,229,474,85,385,479,102,359
2106700A166,577,302,275,571,229,302,466,260,194,458,220,238,571,280,278,585,295,274
2105900B102,1183,479,704,1188,321,795,1015,473,516,995,392,603,1409,437,944,1437,522,821
2105900H117,1274,403,871,1271,351,863,996,423,556,973,335,638,1458,457,982,1447,421,973
2114300A101,633,242,391,636,162,461,532,196,331,528,174,354,678,166,508,658,182,464
2111700A107,511,320,191,510,314,153,352,272,77,349,256,93,651,451,184,710,487,194
2111700C118,734,213,521,733,242,451,583,271,300,569,195,374,851,327,509,831,305,496
2106700C196,436,274,162,436,234,158,295,219,71,289,188,101,435,273,147,456,285,150
2106700A201,429,278,151,428,251,151,345,266,73,344,236,108,441,297,136,430,282,137
2106700B192,604,298,306,601,243,325,531,281,244,528,246,282,650,320,319,646,307,324
2106700C126,445,302,143,438,254,142,386,273,107,380,249,131,479,318,153,480,296,173
2106700C103,569,429,140,557,384,138,504,397,102,501,358,143,667,509,149,645,461,175
2106700C124,563,417,146,554,370,157,487,373,113,482,351,131,593,435,150,576,411,158
2106700C173,592,310,282,588,259,294,561,319,237,557,276,281,784,416,353,772,394,363
2106700C128,483,351,132,486,327,110,317,264,51,311,249,62,479,366,101,483,364,110
2106700C231,493,231,262,488,181,286,429,213,213,432,189,243,557,243,309,562,251,303
2106700C178,403,209,194,400,166,197,363,193,167,357,155,202,454,231,209,466,227,220
2106700B114,428,244,184,438,208,196,381,249,125,375,215,160,475,275,190,473,267,187
2106700B130,691,375,316,691,286,348,546,318,215,540,278,262,709,359,336,720,371,322
2106700A121,360,261,99,363,224,109,277,213,57,273,187,86,448,316,115,448,317,111
2106700A161,531,470,61,533,442,66,414,370,38,406,353,53,587,496,79,593,513,67
2106700A185,494,322,172,495,322,127,386,326,52,382,305,77,602,459,130,592,446,129
2106700C155,313,181,132,316,150,157,241,150,88,241,133,108,397,221,174,379,212,162
2106700B200,402,207,195,412,168,203,312,187,125,303,149,154,398,206,182,396,191,189
2106700C105,623,463,160,616,433,116,391,343,43,387,339,48,545,435,96,561,430,119
2106700C221,454,249,205,447,214,190,367,220,134,365,194,171,459,250,192,487,243,219
2101500B134,895,214,681,887,202,651,692,220,469,686,162,524,1032,280,739,1010,313,669
2106700B150,491,243,248,495,191,273,403,213,186,399,194,205,527,254,263,531,257,258
2106700C162,529,384,145,532,325,168,370,270,93,368,245,123,636,433,186,632,449,162
2112300C103,248,87,161,251,45,187,171,61,107,164,52,112,291,55,229,310,71,208
2121900B101,419,66,353,427,43,377,250,60,186,237,43,194,470,38,426,463,64,366
2112300A101,917,294,623,926,169,723,756,274,460,755,183,572,1048,195,841,1039,230,764
2105900A103,510,289,221,516,238,251,315,179,132,315,171,144,542,277,255,516,269,220
2121700A104,1005,350,655,1010,247,710,805,336,452,794,244,550,1076,279,776,1125,288,755
2123500B109,193,62,131,192,46,134,144,66,74,143,57,86,267,71,187,297,59,197
2112500D105,521,110,411,546,48,487,399,74,314,398,57,341,604,61,538,581,87,487
2112500C103,338,63,275,348,29,316,259,45,209,259,34,225,402,38,363,392,52,338
2113700B103,447,128,319,456,74,358,324,93,221,323,69,254,456,71,375,487,82,365
2113700B104,751,220,531,765,137,595,587,219,352,581,171,410,864,158,689,881,165,673
2123500B102,180,39,141,179,28,147,111,31,78,112,24,88,203,35,165,208,30,169
2105900A139,675,256,419,681,198,433,541,260,266,528,222,306,694,233,445,709,242,423
2117700E107,223,85,138,226,32,183,152,47,99,153,44,109,235,33,197,250,62,166
2113700B102,490,164,326,500,96,384,350,97,249,345,78,267,535,99,429,525,112,397
2112500D107,507,157,350,523,93,409,342,98,242,342,78,264,560,115,436,547,119,400
2112500C106,353,86,267,362,42,306,256,67,187,249,49,200,469,64,397,475,80,372
2112500B102,599,169,430,627,95,519,419,98,310,416,86,330,648,112,530,606,124,471
2112500A101,550,122,428,568,75,459,428,99,322,428,76,352,611,95,502,635,96,502
2112500B103,861,217,644,878,147,707,599,178,399,597,143,454,1021,195,813,1010,179,794
2107900C102,799,241,558,814,133,647,588,195,379,586,147,439,970,176,779,983,197,743
2101500C127,636,219,417,641,206,396,406,190,203,403,163,240,724,277,435,729,310,397
2101500B114,842,164,678,844,141,666,646,189,438,629,135,494,1048,213,821,1019,260,724
2110100D104,362,226,136,377,207,159,212,136,70,209,124,85,391,226,162,362,219,135
2110100C106,260,87,173,267,63,196,164,71,92,163,57,106,254,61,191,253,66,176
2110100C111,335,155,180,338,131,195,226,122,98,225,115,110,381,150,225,382,144,218
2110100B105,461,142,319,467,103,351,332,139,191,324,107,217,472,116,353,469,131,327
2117900A102,1137,468,669,1152,318,803,793,356,425,783,281,502,1276,350,913,1244,413,789
2117900B103,1034,414,620,1039,270,741,776,383,374,766,297,469,1278,330,936,1254,406,811
2107900D103,338,128,210,341,72,259,238,108,122,233,77,156,409,94,308,392,103,277
2110700G046,282,120,162,285,87,178,150,76,69,145,57,88,282,104,172,293,106,159
2110700G044,287,102,185,289,72,207,171,91,73,169,66,103,276,82,192,265,86,174
2109300G004,510,166,344,506,97,392,377,131,238,371,107,264,522,115,399,528,162,349
2104900A104,872,329,543,867,221,617,698,308,375,695,236,459,920,267,643,930,276,632
2108100A101,523,141,382,528,108,389,357,141,211,355,121,234,583,120,449,602,148,409
2108100A103,566,149,417,582,109,448,365,146,208,361,116,245,666,125,531,653,160,460
2108100B103,257,56,201,254,44,199,145,47,93,146,30,116,320,55,259,332,66,244
2123900C101,892,426,466,886,301,521,763,373,370,758,320,438,937,378,537,955,398,524
2108100C103,641,150,491,645,136,471,486,166,301,478,138,340,725,154,554,750,160,536
2108100B105,551,135,416,558,132,413,424,162,254,423,122,301,625,146,474,599,142,444
2108100C108,416,75,341,423,74,340,270,81,185,267,55,212,492,84,404,470,81,376
2108900B102,507,245,262,514,142,361,328,160,160,317,140,177,574,165,404,548,194,337
2108900A104,476,178,298,488,97,380,337,141,181,336,128,208,601,125,472,586,155,426
2105900A143,333,170,163,335,150,163,198,117,75,198,96,102,342,172,163,342,155,160
2121700A101,388,101,287,394,50,340,264,67,193,260,50,210,448,59,388,431,87,344
2100900B102,816,294,522,823,155,638,582,205,364,573,167,406,875,183,681,898,217,629
2110100E107,411,189,222,410,150,239,296,153,140,295,142,153,406,171,227,415,182,215
2110100C103,340,153,187,343,102,226,238,114,121,232,98,134,348,105,236,349,127,205
2123500A105,262,72,190,279,27,248,180,52,127,177,37,140,318,34,282,288,56,232
2104900D101,165,81,84,168,54,102,108,53,48,108,45,63,175,65,106,174,67,97
2111500C110,204,56,148,217,20,192,131,31,96,132,37,95,262,31,229,262,34,218
2111500A101,292,107,185,313,51,250,211,81,121,208,70,138,310,63,243,305,67,223
2109300G001,446,141,305,449,89,347,316,108,199,313,89,224,499,114,379,497,148,333
2108900C103,412,206,206,411,117,279,264,134,121,260,112,148,500,151,345,488,179,292
2100900G103,756,358,398,759,226,494,509,260,241,502,203,299,823,271,537,799,269,489
2109300H004,917,333,584,917,227,646,714,264,429,713,195,518,1077,308,749,1084,371,674
2112500F105,965,217,748,987,128,833,656,180,461,658,139,519,1139,170,957,1139,179,921
2112500A107,561,158,403,574,100,459,458,155,297,458,130,328,656,131,517,642,127,487
2112500C102,373,113,260,381,48,323,261,78,173,256,63,193,449,65,379,443,95,327
2110100B110,645,255,390,644,175,448,462,231,227,457,192,265,684,205,472,686,245,418
2105900E103,720,241,479,720,160,521,541,200,325,537,160,377,731,187,531,748,225,480
2113700D106,259,102,157,259,47,205,201,67,131,191,57,134,290,59,227,288,84,194
2111300A103,764,367,397,768,276,439,591,325,254,584,265,319,932,395,516,919,351,527
2105100E101,210,52,158,232,34,193,150,45,101,155,43,112,243,25,217,244,33,202
2111500B108,70,28,42,72,14,56,54,20,34,55,15,40,65,8,56,66,11,51
2122500B103,284,140,144,287,96,183,204,94,101,203,90,113,300,107,189,286,107,159
2123300A104,342,85,257,338,37,286,201,61,135,200,35,165,326,40,280,359,65,266
2110700E035,268,148,120,278,124,142,199,121,77,198,105,93,320,163,152,284,145,130
2109300A002,636,362,274,649,306,299,444,263,167,436,208,228,766,406,339,754,394,310
2109300D006,546,257,289,545,195,313,355,191,151,354,162,192,583,239,329,594,259,302
2112100A103,379,79,300,400,40,354,253,72,180,250,52,198,438,48,387,437,57,372
2112100C101,192,58,134,221,32,177,131,54,74,126,42,84,243,39,199,228,42,171
2108100A102,293,74,219,299,54,235,216,73,140,214,67,147,353,63,285,347,82,247
2122500C103,305,109,196,308,55,244,232,98,130,225,84,141,312,60,247,321,81,213
2123300A105,241,90,151,238,43,186,167,64,96,164,51,113,244,49,192,259,72,165
2107700C102,431,120,311,438,103,315,277,98,167,273,83,190,535,121,404,533,132,371
2121100A104,504,161,343,507,110,367,391,140,240,386,121,265,530,130,390,547,155,361
2122900A102,474,115,359,479,45,419,375,102,264,374,73,301,575,57,509,600,102,474
2112500C108,530,97,433,544,57,469,391,61,324,386,48,338,656,80,568,675,84,563
2112500E103,563,131,432,584,70,497,445,103,332,444,86,358,725,101,614,723,116,573
2122500A103,383,185,198,392,139,230,277,144,128,270,126,144,403,157,239,383,142,221
2102700D101,623,267,356,630,162,443,470,208,239,457,167,290,728,193,525,715,227,455
2122900C101,192,61,131,194,26,161,155,51,103,155,42,113,225,32,190,229,53,168
2118700B103,558,211,347,581,145,418,379,165,207,376,134,242,597,142,449,563,161,379
2112500C104,568,165,403,578,115,442,437,124,301,433,100,333,648,148,489,651,131,479
2114100B103,466,153,313,469,137,313,356,143,206,348,120,228,504,147,352,511,162,321
2118500D106,890,360,530,896,256,552,606,316,272,597,249,348,961,345,583,1012,433,524
2109900D101,382,119,263,388,75,305,276,66,204,271,55,216,377,68,305,384,74,288
2102900D105,1099,330,769,1112,189,871,905,326,562,898,255,643,1349,253,1070,1378,326,980
2118500C102,1045,351,694,1044,258,745,891,327,545,881,255,626,1233,373,843,1217,452,735
2119500E106,308,149,159,328,61,262,227,96,128,220,103,117,330,67,261,298,93,196
2118100E101,570,267,303,583,153,419,484,220,255,471,194,277,705,205,495,704,230,446
2116700G101,864,412,452,869,244,584,723,368,342,716,284,432,1008,320,668,983,338,588
2116700F102,693,319,374,711,215,472,501,275,222,495,225,270,798,270,517,745,250,466
2105100F102,446,96,350,467,42,417,294,82,205,295,43,252,512,35,469,506,42,446
2100100C104,592,145,447,609,95,488,436,133,296,433,104,329,658,104,546,664,117,524
2116300F102,337,162,175,340,101,227,272,125,137,269,107,162,383,113,265,368,121,232
2122900E102,568,259,309,587,168,404,492,241,242,467,177,290,638,191,440,603,207,367
2122900E101,272,128,144,282,102,174,201,103,97,201,79,122,289,108,178,264,96,160
2116300F105,532,230,302,541,134,379,423,202,205,417,145,272,612,152,446,616,174,406
2109900E103,555,211,344,564,130,422,438,160,265,429,142,287,715,138,572,705,153,533
2117500A101,353,171,182,369,99,262,286,139,142,283,135,148,378,102,273,355,104,241
2120900B109,356,166,190,350,134,191,275,135,136,268,114,154,383,168,205,388,159,211
2118900C101,275,79,196,298,39,251,225,62,155,226,58,168,310,32,275,315,44,248
2104700D105,255,46,209,263,42,218,196,52,144,192,32,160,278,48,228,253,54,197
2104700F101,172,31,141,174,23,150,116,26,90,114,20,94,184,26,157,168,36,132
2104700E102,671,258,413,671,243,394,470,219,236,466,194,272,746,292,430,780,318,403
2104700E103,766,236,530,781,219,530,516,224,279,509,171,338,811,248,546,806,275,490
2121100A103,478,175,303,475,120,331,400,161,232,395,131,264,495,140,346,501,166,314
2119900E104,519,192,327,531,110,401,341,147,184,342,121,221,677,167,498,654,172,437
2119900A112,208,48,160,218,24,190,182,33,146,183,28,155,244,33,210,230,38,190
2114100C102,389,96,293,390,85,293,274,90,181,267,77,190,448,88,356,453,104,332
2104700E101,441,246,195,447,243,181,263,158,95,262,140,122,481,278,188,503,290,182
2104700A102,313,296,17,322,304,12,172,164,7,173,164,9,330,315,11,332,316,14
2116300C101,726,289,437,727,167,524,553,245,292,544,182,362,837,202,611,860,242,558
2116300D101,772,350,422,778,233,512,619,319,283,607,252,355,856,268,569,836,279,514
2100500A101,732,334,398,737,238,455,581,291,285,577,225,352,845,300,526,821,270,512
2108500B101,614,171,443,630,81,529,432,112,314,426,80,346,638,96,532,634,103,480
2108500C102,687,213,474,693,122,543,591,197,373,584,128,456,858,148,702,854,186,622
2109500A112,387,70,317,420,36,371,259,42,212,263,45,218,427,41,385,423,57,360
2106100A101,359,119,240,372,75,293,267,118,143,264,97,167,401,88,308,407,99,279
2100500E103,728,255,473,732,144,548,604,230,359,599,175,424,821,178,625,841,204,601
2114500B124,641,162,479,636,111,502,524,166,349,515,128,387,700,142,549,723,171,527
2115700B109,522,188,334,526,122,384,409,147,255,406,136,270,547,131,409,546,139,382
2119900D106,443,78,365,453,33,411,360,68,287,354,46,308,542,48,489,554,67,468
2115300B101,466,192,274,494,110,370,311,192,114,311,169,142,604,167,428,603,195,387
2105300B102,306,30,276,329,35,287,172,39,131,170,20,150,353,37,312,351,31,301
2104700C103,382,152,230,391,141,233,251,115,130,246,107,139,400,156,234,407,174,207
2119900C112,169,22,147,171,10,159,128,18,107,126,12,114,199,14,184,207,19,183
2120300E103,260,56,204,267,29,235,204,49,152,205,38,167,290,44,243,286,49,224
2104700G106,582,138,444,602,138,447,449,164,278,448,144,304,661,166,487,621,170,434
2104700D106,253,40,213,250,36,205,181,41,139,178,35,143,256,41,211,250,46,197
2104700C106,639,191,448,647,166,453,478,187,282,468,155,313,692,194,482,694,230,427
2116700C105,204,58,146,206,40,161,139,33,102,139,22,117,212,46,165,217,42,170
2106100F101,887,295,592,897,184,695,585,238,337,571,182,389,987,203,774,985,222,718
2108500C103,842,304,538,857,178,634,658,236,402,651,200,451,1013,222,778,992,247,686
2101100A102,249,136,113,253,97,149,226,123,102,221,95,126,303,116,182,292,116,163
2120300C103,188,36,152,195,7,184,106,15,89,104,12,92,200,11,185,200,17,177
2119900C104,964,317,647,970,217,711,704,267,426,703,207,496,985,262,706,976,228,693
2119900B106,549,126,423,552,65,469,377,88,281,374,63,311,586,83,494,609,96,480
2119900B103,281,62,219,288,22,263,235,48,182,233,39,194,322,30,292,313,49,262
2119900B104,323,88,235,331,50,274,233,68,160,233,54,179,351,63,285,339,66,263
2118500B101,515,199,316,508,194,291,399,204,187,391,169,222,592,267,314,579,243,319
2106100C102,545,176,369,553,103,439,344,118,223,343,83,260,572,118,447,565,133,409
2113300E104,154,64,90,165,36,125,90,51,39,90,44,46,171,43,126,163,46,111
2120900F119,345,189,156,345,138,183,219,124,90,216,109,107,353,161,183,346,168,161
2109900A104,446,180,266,459,113,326,333,107,214,329,97,232,553,128,413,547,152,358
2102900C101,720,289,431,717,184,497,544,268,263,536,208,328,845,237,590,863,276,531
2104500D101,549,127,422,557,52,492,421,95,317,416,68,348,620,62,553,623,86,508
2116300E103,763,289,474,765,148,587,541,189,339,539,155,384,907,175,712,904,235,615
2116700C102,774,312,462,783,172,572,647,261,371,642,204,438,805,202,588,806,229,541
2122700A106,551,199,352,554,175,349,413,199,210,407,185,222,560,210,342,556,218,318
2108300C101,709,276,433,717,167,510,628,239,382,603,236,367,753,188,547,759,209,500
2119500C106,184,80,104,192,30,158,135,52,80,133,59,74,211,37,174,200,56,142
2111100O117,703,617,86,707,589,101,566,523,37,563,482,81,730,633,87,727,645,74
2111100L150,52,49,3,51,50,1,41,39,2,41,39,2,43,42,1,43,41,2
2111100E148,944,453,491,930,474,418,854,485,358,847,422,425,1024,555,454,1037,535,491
2111100N141,491,213,278,474,217,233,421,226,191,418,193,225,537,279,250,545,263,274
2106900F104,400,181,219,404,99,291,322,135,187,315,110,205,465,111,350,462,126,315
2111100K141,180,126,54,176,110,51,140,115,23,139,105,34,191,131,59,192,133,53
2111100G156,757,338,419,746,346,362,665,370,289,662,304,358,902,497,392,908,458,437
2111100H105,668,505,163,677,461,163,599,522,72,589,483,106,715,562,146,712,557,141
2111100H110,671,480,191,679,431,209,609,481,118,596,438,158,718,501,192,717,500,201
2111100H141,681,474,207,681,438,194,593,489,102,590,441,149,761,538,206,766,546,197
2119500D101,666,283,383,687,118,553,489,192,277,484,198,286,741,140,594,723,192,510
2119500B101,625,231,394,651,107,523,464,215,235,455,190,265,689,126,555,710,155,517
2111100K131,506,373,133,509,340,152,342,285,52,341,254,87,518,375,133,516,380,119
2111100F145,1108,524,584,1107,490,570,860,470,381,853,388,465,1170,592,559,1173,580,562
2111100F155,395,140,255,385,156,212,340,163,177,337,131,206,452,213,231,454,196,249
2111100V110,1291,394,897,1285,405,824,1064,429,629,1058,337,721,1448,572,856,1456,544,892
2111700B110,856,267,589,858,277,537,658,300,345,639,229,410,926,348,563,900,356,520
2111100V107,622,174,448,624,161,438,563,203,353,557,168,389,804,259,540,806,257,538
2111100H113,357,171,186,347,168,160,336,211,119,339,189,150,402,243,150,403,228,166
2111100F184,783,307,476,782,321,413,598,350,238,592,299,293,916,491,412,918,484,409
2111100J107,447,328,119,448,297,132,291,224,58,285,211,74,506,342,152,505,349,131
2111100O121,623,502,121,619,464,139,492,408,81,485,378,107,666,521,136,666,521,127
2111100V132,541,206,335,540,162,351,451,226,219,442,169,273,640,250,383,643,246,384
2111100G103,542,438,104,541,432,69,478,444,30,473,412,61,570,490,70,573,492,68
2111100F166,636,289,347,640,266,337,605,292,307,606,236,370,798,324,460,800,323,464
2119900E111,865,284,581,872,168,680,632,228,390,629,179,450,1029,235,781,1004,236,720
2119900A103,936,237,699,957,122,815,755,169,574,753,133,620,1101,168,922,1076,193,852
2120300D101,765,219,546,786,135,620,546,158,370,545,113,432,910,149,750,906,165,698
2120300A102,413,91,322,423,48,360,331,92,233,327,61,266,516,71,442,514,74,421
2120300B101,407,88,319,423,56,363,326,72,246,324,49,275,517,69,441,516,71,422
2120300E105,155,38,117,162,32,129,145,44,100,146,36,110,197,40,156,195,41,138
2111100H144,728,374,354,734,284,405,473,268,193,468,226,242,745,307,423,744,340,378
2111100K133,532,388,144,527,366,123,380,320,53,375,299,76,560,411,135,566,423,123
2111100O109,854,658,196,862,618,221,662,553,98,655,500,155,900,664,223,899,680,187
2111100C106,1023,820,203,1033,772,221,731,598,123,721,554,167,1075,830,234,1071,831,218
2111100F151,1109,500,609,1102,461,596,969,517,445,952,417,535,1206,597,590,1209,583,608
2111100D120,1023,615,408,1044,549,428,720,506,203,712,448,264,1128,702,400,1125,721,364
2119900E112,342,98,244,345,43,283,231,66,159,228,47,181,368,56,303,388,76,281
2118500H101,1353,538,815,1361,481,776,1068,568,479,1054,432,622,1646,710,897,1652,707,881
2111100I138,1,1,0,2,0,2,0,0,0,0,0,0,0,0,0,0,0,0
2111100E173,495,333,162,484,299,143,323,257,61,320,240,80,509,347,142,511,366,120
2111100F167,648,380,268,648,359,256,442,295,137,431,251,180,674,402,257,674,408,243
2108300B102,216,133,83,222,110,104,139,69,62,136,73,63,209,108,98,181,88,83
2117300C101,436,168,268,449,97,339,325,129,189,323,110,213,488,108,373,495,127,347
2120300E104,86,25,61,83,18,64,77,36,40,76,22,54,109,24,83,109,24,79
2119900B101,385,105,280,395,33,341,279,78,194,279,53,226,409,42,357,426,80,315
2111700A135,753,250,503,757,228,452,533,298,229,519,232,287,962,350,580,1009,408,544
2111700C121,572,217,355,566,217,305,367,191,173,357,163,194,645,291,340,663,308,334
2103100D103,328,94,234,335,66,248,209,77,132,206,61,145,362,76,277,383,81,257
2122700F110,491,134,357,489,97,382,355,132,220,349,111,238,524,123,399,503,156,343
2122700C102,816,433,383,816,412,328,482,336,140,474,304,170,819,479,312,846,460,335
2105500A101,325,92,233,331,50,262,255,96,154,253,85,168,362,63,291,373,78,272
2106500B106,225,81,144,231,50,178,165,56,107,164,49,115,271,59,209,260,64,191
2113500C105,191,67,124,212,35,173,142,37,104,132,30,102,221,35,185,196,43,146
2113500D103,481,130,351,503,61,430,331,93,232,318,70,248,578,65,506,587,93,455
2119700D101,539,276,263,547,153,376,476,237,233,478,200,278,599,172,420,597,203,373
2122700F104,1096,397,699,1102,346,705,873,434,426,866,350,516,1411,521,869,1388,547,793
2118100C101,559,272,287,568,130,425,475,230,237,453,193,260,684,161,517,681,195,447
2113500B105,476,153,323,515,73,423,349,110,220,339,88,251,558,75,473,559,104,399
2109500E107,333,66,267,375,24,343,206,41,159,201,36,165,381,25,352,382,40,322
2106500A103,192,87,105,202,50,143,134,63,70,131,52,79,244,58,183,235,65,160
2109900C102,673,249,424,691,158,524,484,191,286,476,148,328,730,155,569,697,168,503
2108300A111,896,211,685,915,116,777,679,193,468,657,165,492,939,126,804,940,155,762
2103700C311,470,220,250,471,209,227,340,213,122,334,178,156,511,258,241,530,283,224
2103700A605,926,356,570,929,362,514,730,419,295,717,324,393,1027,455,554,1020,466,519
2103700C103,623,259,364,625,244,345,361,200,157,360,168,192,750,332,405,762,373,365
2122700D202,0,0,0,0,0,0,0,0,0,0,0,0,0,0,0,0,0,0
2111100V120,1060,483,577,1060,445,536,928,550,364,916,446,470,1422,722,671,1423,723,662
2111100N110,449,437,12,453,436,5,352,344,5,353,327,26,462,447,13,464,450,9
2111100O124,466,281,185,473,248,202,356,248,103,350,221,129,508,290,209,510,302,189
2113500A104,214,26,188,224,16,205,132,26,104,128,20,108,233,15,217,243,16,220
2103700C303,318,217,101,318,204,88,136,107,27,134,99,35,312,222,82,340,246,80
2107500A102,231,121,110,235,105,126,143,79,64,141,74,67,244,109,133,236,97,127
2107500D102,109,34,75,113,18,93,73,24,47,74,24,50,107,17,89,108,25,77
2111100N145,472,468,4,477,471,3,105,102,3,104,97,7,155,144,6,155,149,4
2111100H123,240,137,103,242,110,117,181,110,66,175,92,83,262,124,132,264,132,118
2111100B162,976,361,615,986,294,655,806,373,417,796,301,495,1086,407,661,1089,433,623
2111100I147,40,16,24,41,16,24,24,11,12,24,7,17,44,18,25,44,18,24
2111100G159,0,0,0,0,0,0,0,0,0,0,0,0,0,0,0,0,0,0
2100300D101,976,237,739,981,166,781,691,226,448,688,179,509,1149,204,930,1148,237,872
2115100C110,1160,653,507,1173,524,587,927,608,299,914,500,414,1660,823,801,1573,765,743
2106900A101,385,180,205,398,75,307,301,113,182,291,99,192,425,77,342,410,116,273
2120500C102,327,188,139,329,125,189,215,111,98,212,104,108,367,144,217,364,170,169
2100300B101,696,172,524,709,113,576,453,145,302,446,111,335,737,123,607,719,152,546
2104300E101,231,107,124,233,54,168,149,69,77,150,59,91,266,64,197,277,80,171
2109100B101,325,169,156,331,104,208,317,212,100,304,161,143,380,121,252,372,155,192
2121300D101,293,98,195,297,70,213,189,89,100,186,78,108,327,85,236,326,107,205
2111100M131,342,281,61,348,272,55,265,241,21,266,231,35,386,326,52,388,332,46
2111100H116,606,371,235,609,307,250,533,386,137,523,323,200,663,404,245,661,399,245
2111100M138,916,656,260,925,652,189,811,693,113,805,641,164,985,799,176,983,792,179
2111100K149,1,0,1,1,0,1,2,1,1,2,1,1,3,0,3,3,0,3
2111100C125,516,413,103,521,394,107,364,283,72,363,264,99,582,463,109,584,453,113
2111100C102,485,360,125,488,339,123,348,265,79,346,247,99,479,343,123,478,353,116
2111100C133,931,593,338,938,602,296,734,546,178,717,468,249,981,650,310,980,662,295
2109700B102,287,140,147,286,92,179,174,97,75,170,90,80,321,116,199,324,121,188
2109700E101,459,238,221,472,125,325,335,163,168,332,126,206,514,147,358,487,153,310
2121300B101,667,212,455,671,152,471,412,163,236,404,134,270,732,184,523,770,232,480
2111100H102,630,500,130,636,485,118,562,503,50,555,472,83,728,581,125,730,598,112
2111100A139,498,269,229,502,198,275,309,190,110,306,163,143,504,211,275,504,237,234
2111100O131,521,322,199,523,259,233,384,258,112,381,212,169,562,286,262,563,319,220
2111100C138,425,269,156,433,241,152,377,282,90,375,230,145,458,300,147,458,294,148
2111100Q122,592,504,88,597,495,90,446,391,54,446,364,82,628,511,107,624,517,94
2103700C309,564,250,314,569,244,292,385,231,144,377,200,177,593,287,295,595,307,267
2103700C201,738,341,397,741,341,327,543,344,191,535,298,237,875,465,384,927,486,393
2111700B134,532,197,335,542,196,314,289,141,138,282,112,170,594,250,334,581,266,301
2106900D103,423,193,230,430,117,303,343,164,176,339,140,199,492,130,360,479,134,328
2111900D104,192,103,89,203,43,154,163,96,64,157,84,73,233,51,181,232,67,156
2111100C136,428,267,161,415,238,151,336,229,103,336,193,143,449,285,150,450,288,147
2101100C103,280,155,125,285,112,166,259,146,107,256,142,114,380,109,266,377,128,231
2111100B173,921,404,517,928,309,572,853,464,378,839,372,467,1250,508,719,1252,553,656
2111100V101,700,381,319,704,349,299,514,358,150,506,308,198,764,456,287,765,466,262
2111100J145,757,311,446,755,239,488,597,303,284,584,254,330,800,291,502,803,302,475
2111100I111,874,584,290,870,509,294,734,536,190,724,482,242,951,610,313,953,617,306
2111100N128,232,188,44,231,170,57,147,125,22,146,123,23,271,209,55,273,213,51
2111100F181,1063,608,455,1066,583,411,902,578,312,895,506,389,1144,683,448,1152,671,460
2115100A101,749,266,483,762,156,571,567,192,367,566,176,390,930,218,694,946,278,630
2115100A102,821,493,328,834,431,364,615,411,194,617,394,223,909,514,377,827,438,364
2111100K132,262,141,121,263,99,147,159,107,49,160,90,70,267,136,129,272,140,120
2111100K111,280,220,60,277,189,75,181,151,28,181,144,37,264,187,67,263,203,55
2111100K113,252,212,40,253,197,47,181,154,25,179,145,34,228,164,55,223,168,48
2111100K142,0,0,0,0,0,0,0,0,0,0,0,0,0,0,0,0,0,0
2111100O126,590,436,154,592,380,192,443,347,86,438,299,139,623,391,223,622,406,201
2111100E141,347,178,169,344,164,151,269,165,99,268,128,140,363,193,156,365,192,160
2111100B172,1331,558,773,1316,492,744,1200,695,482,1183,587,596,1759,870,847,1769,884,827
2111100G146,830,598,232,832,604,188,730,588,133,722,528,194,863,671,174,867,663,185
2111100I142,1,0,1,1,0,1,1,0,1,1,0,1,2,0,2,2,0,2
2111100F182,1190,657,533,1190,586,510,935,616,300,918,533,385,1226,700,492,1226,720,467
2111100E144,769,440,329,774,409,304,599,412,169,583,357,226,853,519,314,852,531,290
2111700C101,472,168,304,473,166,263,299,150,147,297,126,171,499,208,275,522,223,269
2119100C102,512,145,367,528,123,387,336,120,208,329,90,239,574,120,447,572,124,419
2119100A102,571,135,436,587,114,454,363,143,214,356,106,250,638,122,510,638,138,463
2107100C101,371,177,194,388,106,265,236,124,108,236,122,114,382,104,270,381,140,218
2107100C105,127,90,37,139,47,88,107,67,36,105,69,36,118,21,96,119,35,80
2107100B109,183,76,107,188,31,156,124,56,66,125,57,68,181,31,148,181,42,132
2111700B116,1110,266,844,1123,262,784,726,337,372,710,249,461,1198,335,837,1167,361,759
2116900A101,648,266,382,671,174,470,595,285,303,552,221,331,717,173,531,696,181,473
2106700A175,400,201,199,400,175,205,319,179,135,307,146,161,436,201,225,440,202,228
2106700B101,495,246,249,484,201,256,390,225,155,388,189,199,522,263,250,526,252,262
2106700B142,785,429,356,780,328,413,697,404,286,693,352,341,834,428,392,830,445,365
2107700B101,393,86,307,400,67,317,273,97,168,275,87,188,480,76,396,471,92,357
2110300E104,192,74,118,194,43,143,144,53,88,142,47,95,222,50,169,223,64,145
2110300C102,299,98,201,301,64,226,226,71,146,222,54,168,356,77,276,353,88,254
2112700C105,194,75,119,201,33,165,126,30,93,129,30,99,229,39,189,215,50,162
2107100D104,486,176,310,509,85,402,326,158,159,318,148,170,526,100,417,523,123,380
2111700B109,765,195,570,768,207,526,607,248,352,597,190,407,839,264,562,801,264,513
2107100D103,374,192,182,412,122,273,240,100,131,234,115,119,331,88,236,330,102,212
2106700B163,625,319,306,627,250,327,589,354,217,579,305,274,797,391,382,812,390,386
2106700A126,408,355,53,409,333,64,306,256,39,299,244,55,485,400,81,478,414,62
2113100D105,76,3,73,78,1,77,55,7,48,54,5,49,67,2,65,66,2,60
2106700C195,481,293,188,484,249,213,369,228,129,365,206,159,518,292,217,500,289,201
2106700C142,722,564,158,714,509,149,693,554,131,686,527,159,845,672,162,853,689,155
2106700B120,304,163,141,299,136,137,265,166,97,261,142,119,323,178,138,337,172,156
2101500A105,566,127,439,565,120,416,501,173,318,495,126,369,702,180,510,694,200,466
2101500C132,725,262,463,741,245,458,407,193,200,403,167,236,816,317,485,811,358,424
2106700B165,598,365,233,603,315,232,444,320,117,434,279,155,600,368,215,607,378,212
2106700B141,533,297,236,534,221,251,461,267,177,453,246,207,590,312,259,597,315,264
2106700A176,459,222,237,457,182,242,403,193,197,397,161,236,460,231,221,471,235,225
2106700C114,485,259,226,486,216,233,383,230,147,380,204,176,525,275,237,530,266,246
2106700A113,447,275,172,454,229,177,419,303,104,419,273,146,631,384,222,650,395,229
2101500C121,887,321,566,891,310,520,533,282,235,523,231,292,956,394,542,979,431,510
2102100E103,311,189,122,310,159,116,231,175,56,225,153,72,372,215,138,391,188,159
2122300D103,341,134,207,350,91,253,271,123,137,268,110,158,447,119,324,421,126,283
2111700C107,944,346,598,956,319,558,693,357,327,673,280,393,1038,410,599,1067,471,541
2111700B136,1329,325,1004,1320,308,927,918,400,493,902,295,607,1471,410,1031,1456,458,941
2111700C122,1133,413,720,1131,425,627,860,438,404,841,375,466,1185,519,639,1207,535,619
2104100B104,173,68,105,176,48,119,116,49,64,115,36,79,161,40,119,157,46,105
2111700A106,442,295,147,449,299,110,342,272,66,337,256,81,628,467,143,680,488,162
2105900H102,846,281,565,858,219,589,690,282,383,676,238,438,912,267,629,926,276,592
2112500A102,437,118,319,453,54,387,284,75,202,282,58,224,553,76,471,532,102,416
2113700C101,626,202,424,635,94,517,476,155,309,465,117,348,673,114,554,665,135,501
2107300B101,782,429,353,774,367,371,773,439,314,761,371,390,888,453,422,893,424,441
2107300E108,593,352,241,592,277,276,510,312,179,498,275,223,643,328,301,650,333,289
2107300C108,775,377,398,774,297,442,547,308,231,541,250,291,663,279,373,674,283,368
2120700B103,669,167,502,674,76,584,559,142,406,565,108,457,780,98,673,792,133,618
2121500C102,1420,417,1003,1423,314,1046,1191,403,772,1181,308,873,1753,430,1298,1761,426,1261
2117900E102,1170,488,682,1183,350,779,839,412,401,825,315,510,1283,383,880,1289,428,798
2117900C104,649,357,292,650,274,339,487,306,171,480,249,231,677,291,372,678,304,331
2117900B104,1096,470,626,1106,335,718,810,390,407,804,291,513,1278,391,866,1283,440,782
2102300B101,399,125,274,416,103,300,296,133,153,290,113,177,495,122,367,492,137,332
2102300H101,418,151,267,427,104,313,300,153,136,290,122,168,488,105,381,472,140,323
2111700A110,327,164,163,327,152,167,223,149,69,225,142,83,410,212,195,409,242,160
2117900B101,1288,503,785,1292,321,903,935,445,472,923,329,594,1446,363,1056,1493,457,950
2112300C101,928,297,631,943,167,727,701,230,450,692,159,533,1124,206,900,1147,248,825
2107300F106,449,242,207,452,154,276,425,242,170,426,202,224,544,201,331,555,252,273
2110900C102,308,46,262,319,16,294,241,34,199,240,23,217,327,19,305,344,30,296
2104900F101,264,209,55,273,194,68,181,148,30,179,134,45,309,234,71,247,175,64
2113900D102,414,122,292,416,72,329,302,102,200,303,100,203,479,81,394,483,95,377
2102100B104,554,229,325,564,110,427,450,175,263,446,133,313,668,147,504,675,226,419
2102100F103,674,263,411,673,212,427,548,262,276,541,199,342,712,251,447,733,230,470
2105900B101,550,265,285,552,208,303,449,251,192,444,211,233,702,301,384,712,308,354
2107300D109,361,269,92,358,233,109,248,184,59,249,176,73,347,238,103,328,220,95
2101300A105,328,70,258,344,50,290,147,39,99,145,46,99,409,60,347,396,66,327
2103900C101,405,118,287,409,61,333,273,86,183,268,86,182,393,63,328,390,80,304
2104900B101,650,247,403,649,136,483,568,242,322,563,185,378,687,166,509,711,210,475
2100100A105,339,56,283,345,32,308,250,54,193,248,37,211,410,38,370,409,48,356
2101300B105,158,64,94,162,44,115,97,49,48,98,46,52,163,45,117,158,51,101
2111300F104,548,262,286,555,173,349,366,206,151,361,165,196,590,218,361,573,220,335
2111300C101,596,263,333,595,143,431,583,241,326,573,170,403,776,220,546,763,271,477
2107300D103,318,148,170,312,98,193,291,123,162,285,106,179,350,121,220,387,147,214
2103500B105,570,282,288,572,222,297,390,232,151,381,217,164,585,259,309,605,271,296
2111700A121,390,251,139,397,250,110,220,175,39,221,164,57,464,330,121,501,351,129
2123500C112,216,41,175,227,18,207,167,20,145,165,13,152,240,21,218,231,30,198
2107300E109,588,375,213,588,305,257,504,316,180,498,288,210,639,354,275,620,349,250
2100900E101,663,270,393,658,156,480,477,214,252,469,173,296,694,181,505,695,196,466
2105900A135,301,151,150,303,113,181,197,121,72,192,98,94,293,122,169,276,129,138
2108900A108,377,206,171,380,145,217,267,153,111,260,138,122,416,167,240,413,160,217
2112100A102,293,95,198,311,45,260,212,62,147,212,50,162,385,61,322,360,77,278
2111300D101,233,72,161,237,57,160,226,74,150,223,55,168,271,80,184,291,67,209
2111300D102,499,229,270,493,161,304,353,146,203,353,115,238,509,195,303,510,185,305
2101300A101,405,119,286,415,43,359,219,67,147,224,69,155,381,40,335,393,87,282
2101300E106,388,62,326,412,36,369,239,63,171,231,42,189,410,36,370,409,49,345
2118700D102,423,140,283,435,103,315,336,137,190,330,119,211,459,104,350,447,111,319
2110700A003,803,244,559,819,135,651,561,189,359,551,160,391,895,180,703,897,241,612
2110700G049,437,148,289,438,95,319,323,136,179,316,119,197,459,121,330,473,140,303
2105900A140,849,373,476,853,285,531,622,323,278,610,267,343,916,344,560,893,361,493
2123900D101,987,476,511,991,322,592,810,436,355,805,352,453,1148,446,673,1177,490,634
2116100C104,348,102,246,364,66,283,233,97,132,233,94,139,412,82,323,408,104,285
2111300A104,461,236,225,474,145,316,335,158,171,325,123,202,501,178,320,455,194,258
2102300D101,462,89,373,473,70,397,333,105,209,326,91,235,603,84,517,587,96,472
2102300G101,428,118,310,428,79,341,301,96,192,298,79,219,545,94,447,535,129,392
2111500A109,110,30,80,110,9,98,80,18,61,79,18,61,108,6,97,108,9,93
2122100B101,432,115,317,438,68,354,288,88,192,286,72,214,457,74,376,460,117,318
2119300A112,414,170,244,421,96,309,325,157,162,325,141,184,461,116,336,469,134,310
2111900A104,460,174,286,485,92,377,384,174,197,377,146,231,545,107,433,543,122,408
2119300B113,271,95,176,270,54,206,218,79,135,216,66,150,301,67,229,327,77,230
2100700A102,654,237,417,654,156,474,518,187,324,512,176,336,674,159,508,668,164,488
2114500B103,439,250,189,447,230,185,384,226,155,380,216,164,504,292,200,492,261,206
2114100A101,386,153,233,392,143,239,279,115,159,273,100,173,437,150,281,422,162,248
2109300H008,574,188,386,574,130,418,560,194,361,560,156,404,812,213,583,829,251,536
2109300B006,686,402,284,685,356,299,436,256,173,433,216,217,809,462,333,778,430,315
2120900B111,525,213,312,518,105,390,453,177,260,452,153,299,611,144,455,622,221,380
2105100C102,282,48,234,292,20,267,186,47,134,187,30,157,303,19,282,304,29,268
2100100B104,460,99,361,478,53,414,322,72,248,321,59,262,520,57,458,518,78,417
2102700C101,620,240,380,627,142,465,490,202,276,483,173,310,726,169,549,719,204,484
2116300B102,970,398,572,971,310,628,804,356,431,798,304,494,1192,381,796,1187,359,777
2102700C102,757,271,486,766,144,579,636,254,367,637,204,433,901,177,705,939,237,639
2122700A103,410,191,219,406,185,193,306,178,127,302,157,145,406,214,183,412,203,191
2122700C103,500,260,240,491,249,198,355,233,116,353,212,141,522,307,200,547,293,223
2109500D109,192,51,141,211,14,188,129,37,91,118,28,90,195,16,177,194,24,163
2101900C112,485,235,250,483,132,335,343,171,156,335,151,184,554,167,379,551,214,323
2122700D112,1057,335,722,1046,320,665,878,379,487,870,315,555,1107,403,685,1113,386,684
2101900A114,136,75,61,138,57,75,46,23,22,45,22,23,147,66,78,141,62,72
2101900C106,465,236,229,471,124,329,327,159,153,326,148,178,488,142,338,485,195,269
2101900A110,467,252,215,472,164,287,259,158,95,259,139,120,488,187,292,475,207,250
2108500B105,643,208,435,655,139,495,497,186,300,497,139,358,679,174,497,689,187,449
2101900C114,531,229,302,538,124,387,323,158,153,319,147,172,527,136,379,550,181,337
2101900C117,399,155,244,411,95,297,274,121,147,279,110,169,421,109,304,436,128,285
2116500E101,468,190,278,480,115,348,375,173,199,367,155,212,539,142,388,533,159,354
2119700B101,288,136,152,303,84,204,233,119,109,233,104,129,347,79,261,345,97,231
2122700C107,954,322,632,951,308,595,747,332,410,744,273,471,1029,392,620,1014,375,605
2118500E103,731,268,463,731,222,443,573,269,286,562,214,348,777,293,459,803,315,448
2118500A103,1352,486,866,1328,455,800,1140,526,592,1130,429,701,1515,626,861,1521,595,872
2122700B107,371,231,140,378,215,137,241,170,65,239,162,77,453,290,151,450,286,143
2123100A107,219,84,135,230,57,168,149,61,84,149,55,94,290,74,213,284,72,190
2118500B104,634,225,409,635,195,389,480,239,233,476,183,293,772,294,460,786,303,453
2116700E102,678,287,391,685,172,486,552,229,311,542,171,371,768,218,537,750,227,492
2101100C101,455,206,249,470,143,313,343,175,163,345,162,183,531,146,380,529,158,356
2120900E126,445,236,209,444,171,245,280,170,101,278,144,134,494,216,265,489,227,235
2109900D102,213,66,147,214,38,172,163,45,117,164,36,128,224,37,185,231,44,172
2119300C106,281,106,175,296,50,236,196,99,95,195,93,102,293,55,233,299,76,203
2120900C116,706,288,418,701,211,450,721,315,393,721,253,468,914,318,578,932,329,559
2120900F127,770,309,461,763,220,496,706,333,356,700,261,439,998,335,641,1032,356,621
2120900F131,350,199,151,354,136,197,269,163,101,265,141,124,374,164,202,363,182,161
2120900A114,81,37,44,80,28,50,89,41,45,88,34,54,137,54,82,132,53,75
2121100G103,693,322,371,707,277,399,565,287,262,563,249,314,818,353,454,776,333,419
2121100B102,767,278,489,789,172,587,587,215,355,579,164,415,820,200,610,793,262,503
2102900C107,1021,391,630,1060,268,730,706,322,355,698,278,420,1114,311,778,1104,335,697
2116700A102,179,64,115,183,35,143,130,57,70,130,44,86,187,41,144,186,46,133
2123700A101,285,149,136,293,80,200,232,126,103,228,124,104,301,82,213,308,102,182
2119500D106,335,117,218,342,51,286,193,81,107,197,85,112,335,55,278,343,72,262
2116100B104,359,115,244,363,82,272,259,93,164,252,76,176,440,107,329,435,124,299
2122700B111,336,189,147,339,188,126,178,137,40,176,131,45,340,214,117,345,197,126
2106500B104,248,97,151,259,47,200,217,88,123,224,69,155,308,60,245,302,80,210
2106500C105,325,101,224,339,54,278,255,97,152,248,71,177,374,60,309,370,76,282
2106500C104,434,126,308,442,75,356,313,99,211,315,63,252,529,90,430,543,102,419
2117300C105,381,199,182,386,118,252,269,134,132,265,113,152,444,139,295,430,159,250
2111100G163,502,282,220,499,280,174,391,274,112,377,231,146,510,319,176,511,310,185
2111100F152,1066,465,601,1060,430,578,881,442,431,878,385,493,1141,527,599,1142,505,620
2111100A129,932,414,518,940,265,634,643,338,287,634,259,375,969,320,632,966,367,554
2111100K140,227,190,37,226,180,34,151,131,19,151,125,26,234,192,36,234,195,33
2122700B103,226,152,74,227,142,73,121,83,34,121,74,47,287,199,83,286,194,78
2107500C103,226,178,48,235,182,48,110,91,17,108,82,26,232,182,49,192,136,53
2114700A101,493,140,353,511,86,420,417,144,263,407,108,299,557,91,463,527,98,414
2111100J120,702,383,319,707,319,355,499,315,177,498,280,218,719,358,346,713,366,323
2114500B123,611,245,366,614,202,382,410,190,214,399,166,233,634,239,384,626,238,371
2119900C102,898,227,671,899,149,724,768,213,539,760,153,607,1039,205,820,1055,185,818
2103700B901,566,112,454,576,96,449,401,150,240,394,98,296,631,124,498,599,152,426
2103700B907,535,133,402,536,107,399,407,144,253,400,100,300,637,148,480,615,191,408
2109900A102,518,202,316,525,163,347,394,177,216,389,148,241,633,186,438,635,174,423
2111100S146,695,363,332,698,345,302,527,354,168,521,306,215,704,424,262,702,432,247
2103700C204,717,367,350,719,341,318,520,343,165,508,288,220,813,440,352,858,493,327
2114500B126,554,194,360,551,145,375,373,145,224,368,129,239,535,164,361,552,181,350
2106900F105,259,118,141,265,38,225,198,74,122,199,62,137,312,42,269,287,82,201
2111100D142,769,373,396,776,331,415,653,371,269,644,309,335,877,410,453,877,414,428
2111100M147,415,343,72,417,306,65,356,319,33,351,303,48,483,398,74,482,407,64
2111100K112,352,257,95,350,257,75,219,175,39,216,158,58,400,309,82,404,325,67
2113300D106,202,89,113,212,39,163,155,85,66,150,67,83,225,49,173,226,67,146
2111700A120,333,213,120,334,208,107,213,154,57,211,137,74,379,261,112,401,283,106
2113300C106,190,49,141,209,20,187,126,39,82,123,34,89,197,22,175,194,33,159
2113300B101,640,210,430,677,94,570,437,168,259,429,148,281,740,119,616,742,162,561
2104500A102,304,70,234,307,32,271,228,57,167,224,39,185,366,40,324,354,50,299
2104500A104,213,50,163,225,20,198,160,48,108,159,26,133,254,24,226,244,34,199
2104500C102,668,153,515,685,63,606,516,103,406,518,77,441,790,78,707,778,107,642
2104500B101,430,105,325,442,64,370,310,72,236,309,65,244,466,72,391,446,67,368
2111100I110,185,106,79,187,86,81,116,88,24,114,75,39,187,117,59,189,124,56
2111100D116,1007,552,455,1018,469,498,884,583,288,865,478,387,1194,614,555,1202,642,516
2111100N136,303,265,38,306,270,30,188,169,16,182,158,24,302,264,35,301,255,36
2111100O139,39,23,16,38,17,16,28,17,8,28,15,13,59,23,31,59,22,32
2111100H112,616,362,254,613,327,251,598,398,191,589,353,236,713,428,271,715,424,272
2111900B105,148,69,79,151,38,112,136,70,64,135,57,78,178,41,137,176,47,121
2111100N106,682,664,18,681,658,16,508,495,10,506,469,37,721,703,11,721,703,8
2111100A135,609,307,302,618,259,336,435,249,174,426,199,227,660,296,348,661,315,312
2121300A103,451,179,272,461,140,299,263,136,118,259,122,137,597,197,386,593,228,334
2113300D102,422,191,231,438,118,300,315,164,139,315,157,158,442,137,298,440,135,277
2111100V105,1166,370,796,1165,323,793,962,365,580,956,285,671,1294,421,844,1304,419,851
2111100E167,673,402,271,671,376,236,579,411,154,563,360,203,911,613,282,905,618,256
2115100D110,437,280,157,446,261,138,268,215,48,267,192,75,338,221,101,325,176,124
2104300A103,304,129,175,310,63,238,219,94,121,222,81,141,365,76,284,358,98,247
2111100Q123,886,836,50,892,842,36,602,572,24,599,532,67,845,764,67,850,781,51
2111100C113,292,222,70,293,205,83,218,162,53,215,150,65,330,216,108,330,221,95
2111100E169,1118,463,655,1111,414,629,942,495,433,924,393,531,1167,558,595,1174,537,621
2111100D126,1126,625,501,1126,538,506,877,562,298,862,486,376,1210,657,516,1216,691,488
2109700B101,464,229,235,478,157,293,359,186,163,354,150,204,520,192,315,516,192,291
2104300E102,416,155,261,433,83,334,326,143,178,327,118,209,486,96,383,489,113,354
2115100D109,1167,569,598,1166,421,642,1022,578,412,1014,511,503,1459,603,799,1513,607,798
2119300A107,229,96,133,243,50,185,165,66,99,164,64,100,231,53,173,227,65,146
2119100B103,537,135,402,550,100,410,379,135,234,368,113,255,579,109,458,586,135,419
2119100C103,318,78,240,321,46,267,234,66,167,233,49,184,405,52,351,398,76,309
2120500B104,679,400,279,672,318,326,529,350,175,526,318,208,744,399,333,752,434,298
2114500A134,634,182,452,629,121,481,481,131,345,471,117,354,651,144,497,666,177,471
2114500A113,648,185,463,647,123,493,530,202,321,521,176,345,668,151,507,686,187,481
2107500B102,300,122,178,303,79,220,208,78,128,210,68,142,306,79,225,295,94,198
2103700C307,292,150,142,295,135,142,175,117,53,170,101,69,371,192,173,379,222,146
2103700B706,1441,476,965,1440,481,880,1082,528,535,1057,431,626,1666,637,1001,1645,658,927
2103700B906,746,222,524,747,204,511,582,240,330,572,194,378,863,271,582,833,307,505
2103700A502,610,232,378,608,230,334,431,244,173,423,193,230,666,290,362,681,305,345
2103700A803,852,259,593,859,244,564,843,383,440,813,266,547,1490,490,973,1464,543,864
2115100C105,692,221,471,693,123,538,570,222,338,566,181,385,785,161,611,809,216,574
2115100C106,678,221,457,683,112,549,581,197,372,573,161,412,792,148,633,803,219,566
2107500D101,227,86,141,233,61,160,121,37,84,119,37,82,217,58,155,226,63,148
2111700A113,353,140,213,355,131,199,250,140,103,248,130,118,441,189,241,451,215,217
2115100C107,1216,485,731,1226,329,858,1032,435,579,1033,353,680,1542,466,1055,1516,512,966
2115100B105,1394,738,656,1395,561,746,1299,772,502,1286,664,622,1683,761,880,1650,746,830
2103700B905,1143,287,856,1144,253,822,844,344,482,836,249,587,1331,345,963,1303,409,847
2103300D102,249,94,155,250,50,195,211,85,125,207,76,131,295,62,230,279,84,193
2107100B106,522,263,259,549,115,418,387,205,169,383,195,188,557,111,439,554,148,380
2110300B101,709,250,459,710,166,516,589,223,351,580,169,411,835,200,625,833,223,575
2102500B104,294,168,126,293,118,164,190,110,78,185,102,83,310,110,194,312,114,183
2102500B101,214,83,131,215,55,150,146,62,82,142,61,81,221,49,169,242,54,180
2101500A118,850,168,682,852,165,658,643,189,441,620,140,480,947,220,717,903,236,644
2101500B127,1181,285,896,1181,251,851,806,354,423,784,246,538,1527,396,1099,1538,475,1002
2101500A103,1210,225,985,1220,229,921,873,317,529,852,228,624,1352,309,1019,1315,321,943
2101500A113,1030,333,697,1043,291,690,765,371,375,753,291,462,1429,476,926,1437,576,809
2103500C109,716,269,447,707,245,427,629,286,327,620,233,387,892,344,536,888,311,553
2111700B107,446,122,324,441,129,282,362,167,186,355,127,228,485,168,306,488,168,297
2111700B140,919,266,653,919,249,612,661,360,290,650,263,387,1167,375,770,1150,425,692
2106700C218,517,261,256,510,214,274,418,244,167,414,203,211,572,289,276,569,279,278
2106700B231,517,284,233,515,243,231,379,242,129,381,211,170,550,315,222,551,295,237
2106700B232,469,243,226,470,199,247,393,213,172,389,161,228,536,256,272,527,254,261
2106700B170,509,287,222,506,230,241,386,231,147,393,197,196,575,301,262,568,302,250
2105900A119,990,450,540,998,350,548,626,343,268,618,307,311,958,390,534,1002,401,516
2104100C103,380,129,251,387,88,275,248,106,139,244,96,148,367,76,284,378,91,248
2106700A103,442,219,223,446,179,237,378,219,156,377,191,186,493,249,237,494,253,231
2106700A150,514,457,57,522,434,54,451,405,41,449,392,57,554,476,63,562,487,61
2106700B121,425,278,147,422,243,156,349,239,107,347,218,129,451,293,150,444,297,138
2106700B118,497,320,177,494,274,178,461,338,118,451,309,142,574,364,195,584,373,193
2106700C217,556,306,250,553,234,276,511,323,176,506,276,230,746,385,341,763,400,331
2111700B118,1321,354,967,1328,362,873,900,428,445,888,334,554,1586,514,1035,1573,533,966
2106700A178,378,258,120,381,231,129,271,196,67,263,179,84,408,282,118,395,271,116
2106700A102,480,309,171,483,266,172,400,270,126,399,255,144,538,341,181,548,336,193
2106700B159,503,279,224,501,216,244,421,246,168,417,212,205,543,286,248,544,291,240
2106700C184,163,102,61,164,80,74,140,104,33,138,87,51,174,101,63,174,107,59
2106700A143,337,260,77,333,233,82,223,171,49,221,167,54,349,255,86,370,269,92
2106700A111,447,334,113,446,278,140,385,288,94,378,272,106,599,405,179,599,418,164
2106700C176,587,318,269,586,275,269,522,325,188,511,279,232,637,358,262,634,328,280
2101500B125,1250,339,911,1254,330,813,910,437,453,896,321,575,1479,476,963,1538,517,934
2102100A102,662,260,402,660,155,487,550,217,318,550,171,379,712,187,519,705,231,468
2123500B108,170,67,103,172,38,124,110,47,63,112,39,73,200,49,144,207,53,128
2105900A146,1190,403,787,1202,312,838,897,376,513,892,321,571,1261,371,872,1239,385,804
2105900A128,710,323,387,719,259,411,541,280,250,526,243,283,735,301,418,728,301,386
2121700E102,451,192,259,459,132,299,328,148,174,325,121,204,500,153,334,503,162,305
2122300C101,235,116,119,235,68,155,163,89,70,161,75,86,248,73,167,238,82,139
2112500B105,700,172,528,716,110,583,491,151,326,494,116,378,850,150,687,862,145,667
2112500E104,566,181,385,575,112,424,398,146,235,398,126,272,547,124,406,560,124,395
2113700A103,604,255,349,614,162,438,488,229,245,483,193,290,769,224,535,740,235,476
2112500A103,506,163,343,514,90,405,367,130,233,360,96,264,558,112,437,554,126,396
2103500A106,518,147,371,524,113,392,372,128,239,369,101,268,565,136,423,558,146,394
2111700C136,1065,383,682,1066,398,597,786,403,368,776,323,453,1111,483,606,1116,494,583
2101500A108,1089,289,800,1097,281,750,731,294,417,716,222,494,1173,361,790,1172,391,729
2117900A101,128,44,84,131,27,100,102,34,67,101,23,78,139,28,110,138,37,96
2121500E103,565,187,378,567,120,426,457,149,295,456,119,337,669,156,506,660,182,455
2105900A107,1005,565,440,1008,478,439,665,394,241,656,368,288,1036,556,447,1064,527,439
2112300C102,478,149,329,481,93,370,384,144,232,380,101,279,541,107,428,543,116,402
2110700B010,282,82,200,282,39,240,199,56,140,194,52,142,307,51,254,299,79,215
2115500C102,827,503,324,856,407,404,631,397,223,622,350,272,892,405,474,872,380,433
2104900C103,867,301,566,867,173,677,709,219,475,702,183,519,973,221,746,978,267,697
2110100A111,434,192,242,437,131,292,291,140,143,285,125,160,460,152,303,455,182,255
2117900A105,1073,476,597,1082,324,707,826,407,397,813,320,493,1242,376,847,1237,443,741
2108900C110,509,244,265,512,142,357,321,148,158,320,144,176,569,165,399,551,192,340
2108900B105,562,225,337,575,108,450,381,124,244,380,114,266,675,133,535,667,188,460
2100900C103,683,259,424,706,140,537,511,187,311,510,158,352,739,163,566,736,188,504
2108900C108,569,226,343,585,154,412,449,206,227,443,192,251,669,185,475,674,184,454
2111500A102,270,85,185,268,41,221,214,82,126,217,67,150,313,66,241,314,77,231
2120700C102,387,134,253,401,73,325,277,82,191,278,77,201,440,88,351,394,99,292
2123500C104,363,118,245,371,87,280,253,97,151,248,65,183,377,96,278,353,80,261
2110100E105,621,361,260,630,316,278,455,302,149,454,271,183,714,402,297,699,387,283
2110100D102,286,209,77,291,207,72,186,149,31,186,145,41,310,232,75,296,209,79
2110100A114,818,290,528,830,213,581,591,250,325,580,198,382,910,258,634,929,289,586
2109300C001,650,248,402,648,188,420,517,225,281,513,164,349,696,234,445,719,253,425
2110700B014,322,152,170,328,118,193,208,111,89,200,97,103,330,138,183,310,132,164
2112500B104,384,94,290,391,51,325,310,85,215,309,54,255,475,72,395,489,82,377
2113700C102,455,132,323,460,55,387,327,79,237,323,58,265,502,69,429,512,91,394
2110900C101,416,91,325,431,50,372,339,76,259,334,62,272,533,69,459,524,72,436
2111300A107,449,194,255,449,125,288,358,171,180,353,133,220,466,157,297,488,163,298
2111300E105,605,209,396,596,130,426,518,195,319,511,149,362,727,210,498,719,234,458
2112100B102,100,40,60,123,11,109,67,14,51,60,16,44,145,14,129,114,31,80
2105900A108,944,412,532,949,323,556,685,382,282,663,331,332,963,376,565,984,384,531
2110700D026,244,55,189,247,34,205,155,39,112,154,26,128,240,40,196,247,48,183
2110700A002,379,99,280,378,48,319,245,87,152,243,73,170,372,57,310,384,88,275
2112100E102,159,46,113,164,25,137,97,19,78,93,14,79,172,28,144,167,31,134
2105500D101,455,129,326,460,66,382,319,100,214,316,80,236,479,78,397,467,102,355
2122500A104,350,130,220,357,74,270,242,100,136,240,92,148,389,87,295,396,105,258
2115700B108,449,164,285,448,100,334,382,123,253,380,117,263,521,120,396,519,140,362
2114100D103,418,77,341,424,51,362,295,84,205,286,59,227,525,62,458,519,81,412
2105500B101,450,117,333,455,62,380,361,94,264,359,80,279,517,80,432,516,101,397
2120900D113,1157,435,722,1156,297,798,1091,489,572,1079,365,714,1780,531,1213,1819,589,1143
2122900B101,398,112,286,404,44,350,306,77,222,307,64,243,438,50,384,445,89,340
2115700C108,554,240,314,552,159,364,377,178,194,376,164,212,522,159,354,522,166,325
2113700D102,347,144,203,358,76,278,276,109,164,271,103,168,420,99,318,391,125,259
2112500A106,705,197,508,716,121,578,526,154,366,531,117,414,760,147,604,747,147,570
2119500D108,275,100,175,297,48,247,161,67,84,158,64,94,252,45,207,235,52,181
2114100E101,315,81,234,321,55,250,242,71,165,238,55,183,356,62,286,372,76,256
2108500D103,372,84,288,378,46,324,291,67,219,289,43,246,434,65,365,433,71,331
2102700E102,510,181,329,521,89,403,367,130,231,361,99,262,593,105,474,615,153,417
2120900F123,467,258,209,466,200,248,384,221,154,370,182,188,487,234,246,457,228,216
2120900D115,546,252,294,541,184,341,496,232,261,493,204,289,598,229,361,579,237,324
2120900E118,345,169,176,343,110,217,220,123,93,218,104,114,390,143,240,384,166,202
2104700H101,573,125,448,581,94,467,325,98,219,326,82,244,587,104,472,569,143,406
2104700B102,850,456,394,866,456,387,475,299,168,474,264,210,903,503,389,897,518,355
2119500C105,400,158,242,426,77,331,281,111,162,269,110,159,430,87,338,432,102,305
2119500D111,594,251,343,606,116,479,424,196,217,420,195,225,641,135,503,629,166,446
2108500A104,199,49,150,199,31,163,173,47,125,171,33,138,240,38,200,240,40,191
2108500E101,413,131,282,428,77,342,303,83,214,292,71,221,469,78,388,472,85,358
2105100D102,147,45,102,155,25,128,105,34,68,105,26,79,196,29,163,201,40,152
2115300B103,217,76,141,217,23,191,131,37,90,132,40,92,222,19,199,221,28,183
2108700A102,330,121,209,340,76,248,258,101,149,251,79,172,357,83,267,348,87,247
2108500E104,310,88,222,312,53,244,257,77,171,263,46,217,376,63,310,392,76,286
2119900E105,839,237,602,834,143,662,633,179,446,628,131,497,939,193,735,958,190,720
2120900G130,425,235,190,429,170,237,310,171,126,307,129,178,458,205,244,441,215,203
2105300E102,377,65,312,395,51,342,249,63,186,244,40,204,474,61,411,453,74,376
2108500D102,727,210,517,732,131,570,572,177,377,563,139,424,841,157,676,842,165,637
2105100A107,182,55,127,196,39,153,134,51,79,132,34,98,188,36,151,189,42,139
2114500A115,447,202,245,452,145,287,289,136,148,281,123,158,477,175,294,471,200,254
2119500C112,153,48,105,166,14,148,101,34,67,102,31,71,185,18,166,186,34,146
2119500F101,271,107,164,275,35,229,193,74,115,182,71,111,264,38,222,280,66,197
2120900E122,410,301,109,410,263,130,308,240,65,303,211,92,456,317,133,405,275,116
2116700D102,745,254,491,754,120,596,624,262,356,625,172,453,802,148,641,828,195,600
2106500B105,684,262,422,699,168,515,542,212,314,541,194,347,820,203,612,788,214,559
2112900C102,224,82,142,228,33,186,142,54,81,147,50,97,212,32,174,211,46,158
2103100E106,522,107,415,529,51,459,351,87,252,350,65,285,622,63,552,629,99,491
2117300B104,764,339,425,759,231,508,614,268,337,605,225,380,826,256,560,826,255,549
2103100C107,492,141,351,495,81,395,344,114,224,341,86,255,546,93,444,556,122,389
2111100J108,791,500,291,793,428,295,642,452,179,635,411,224,844,499,321,847,522,289
2111100L145,494,488,6,497,482,5,302,294,7,302,277,25,460,440,11,463,448,8
2111100H131,375,293,82,383,265,78,315,283,30,316,274,42,406,321,78,402,327,65
2111100G154,682,420,262,680,381,248,515,384,121,510,339,171,680,438,229,684,450,214
2111100C110,492,475,17,495,477,9,352,339,7,348,328,20,484,468,8,489,471,9
2111100C128,160,84,76,161,77,73,138,89,46,132,79,53,188,112,72,188,112,70
2111100I124,385,237,148,383,195,174,249,147,100,246,129,117,472,228,238,471,237,222
2111100D122,758,367,391,761,319,395,601,382,203,592,318,274,803,403,370,803,408,363
2102700D103,389,118,271,386,52,321,290,95,191,291,61,230,438,60,372,459,98,339
2111100G144,712,523,189,706,516,152,625,516,104,619,472,147,771,615,146,773,592,174
2119500D103,480,202,278,489,91,375,332,163,160,327,154,173,495,103,383,517,131,352
2119500C101,311,130,181,325,52,267,164,55,103,162,51,111,292,52,238,277,73,200
2114700F109,92,15,77,98,5,87,82,17,65,78,7,71,116,6,109,119,12,102
2111100B124,704,318,386,703,280,393,567,327,229,560,282,278,806,375,416,802,390,390
2111100G111,619,492,127,611,461,106,585,508,66,574,471,103,704,583,107,708,577,118
2111100Q114,806,334,472,813,273,489,663,336,309,657,283,374,936,397,522,935,415,482
2111100V117,772,345,427,769,339,395,597,340,247,590,293,297,837,442,378,845,439,378
2119900B107,321,131,190,320,98,206,273,124,142,274,107,167,344,123,213,341,98,212
2113500B103,288,88,200,312,46,258,174,33,136,167,30,137,342,47,290,340,60,248
2111100A108,922,489,433,925,351,527,688,451,224,675,368,307,959,437,508,950,452,458
2111100A119,653,324,329,652,225,386,470,283,175,464,220,244,688,296,377,686,305,333
2111100N147,114,84,30,113,75,34,68,58,9,68,55,13,113,82,31,113,81,29
2111100O112,558,305,253,564,241,307,366,250,111,361,227,134,603,298,298,601,319,249
2118500E104,379,180,199,387,151,214,318,174,136,315,139,176,426,198,220,417,210,191
2116700D103,405,157,248,405,92,301,331,160,166,332,120,212,465,120,341,458,127,319
2114700B102,321,78,243,333,35,290,238,71,164,237,38,199,342,35,303,337,52,270
2119900B113,213,55,158,216,23,187,153,33,114,151,21,130,250,33,215,247,46,196
2119500A110,385,123,262,421,46,362,263,94,161,255,86,169,385,47,334,390,72,299
2114500B135,600,142,458,598,112,464,449,153,293,446,132,314,629,137,483,642,142,481
2123100B102,335,85,250,343,46,292,256,85,167,252,50,202,441,62,376,435,74,357
2119500B103,632,225,407,658,87,560,449,173,263,444,178,266,734,107,621,727,157,559
2119500A106,845,325,520,856,180,654,606,249,337,607,229,378,930,216,707,953,221,696
2122700D105,630,248,382,629,190,415,440,203,232,433,158,275,702,248,443,694,296,376
2106500B103,274,111,163,287,64,212,207,88,116,208,70,138,313,74,235,295,82,205
2105500B102,311,93,218,314,45,264,234,70,161,229,60,169,304,49,253,290,68,219
2105500C102,128,42,86,128,27,96,103,36,66,102,31,71,137,33,102,138,33,95
2117500A102,390,169,221,392,94,287,308,153,149,314,142,172,429,104,321,439,110,313
2116700A101,1047,376,671,1053,220,798,906,343,551,891,264,627,1209,287,908,1204,306,869
2102900D108,674,253,421,691,173,494,476,218,252,471,152,319,804,219,574,776,237,508
2119300B111,180,74,106,182,62,117,154,87,65,151,66,85,212,78,132,205,60,140
2103700C302,645,333,312,644,345,246,468,303,148,462,287,175,720,435,267,760,438,285
2122700A102,1034,373,661,1043,341,657,788,379,399,778,326,452,1167,447,705,1132,447,652
2111100K126,302,250,52,310,231,71,178,143,34,178,129,49,314,224,86,314,231,68
2103700A412,709,234,475,720,248,411,579,296,269,557,221,336,830,333,473,846,328,462
2103700A417,0,0,0,0,0,0,0,0,0,0,0,0,0,0,0,0,0,0
2103700A801,773,161,612,770,160,569,605,246,345,584,181,403,889,216,659,846,227,599
2111100K127,783,483,300,795,398,370,603,422,166,592,366,226,810,449,349,810,462,317
2111100C123,387,243,144,392,219,151,274,186,83,272,163,109,427,269,141,428,286,128
2120500A103,143,98,45,144,96,39,113,92,21,113,86,27,140,102,34,135,90,40
2120500A105,188,123,65,188,98,83,165,108,54,163,94,69,234,136,94,231,148,77
2115100D113,618,270,348,627,203,386,569,281,281,559,239,320,672,247,408,669,244,394
2111100D104,568,349,219,568,330,199,425,284,134,419,246,173,567,363,190,565,362,190
2111100D137,624,288,336,634,253,345,510,295,203,503,252,251,716,342,358,720,355,344
2109700A102,305,143,162,295,101,183,209,110,95,212,92,120,324,119,201,339,123,207
2121300D104,594,239,355,593,200,367,322,175,139,321,144,177,686,250,421,695,270,387
2111100N131,701,263,438,680,274,363,639,291,340,633,225,408,821,412,394,828,368,450
2111100O137,1011,547,464,1022,451,534,868,581,272,852,465,387,1098,546,541,1097,547,524
2111100F187,701,409,292,708,367,269,509,339,160,502,277,225,699,415,265,701,415,256
2111100V131,926,374,552,928,339,534,740,369,362,736,307,429,1144,499,626,1148,517,595
2111100V104,1428,541,887,1425,530,821,1418,707,688,1398,590,808,2128,918,1159,2130,922,1156
2111900D105,318,160,158,334,92,228,247,143,101,236,116,120,340,84,250,335,102,223
2111100G108,446,347,99,443,352,66,364,313,51,355,286,69,446,365,76,449,362,83
2111100S153,1056,456,600,1050,481,505,912,514,391,907,443,464,1441,782,637,1458,751,685
2111100Q109,1118,526,592,1117,468,602,858,486,359,844,408,436,1166,575,579,1167,575,543
2111100J150,403,265,138,402,224,161,310,203,103,305,169,136,443,265,174,445,268,167
2111100L142,384,306,78,390,302,71,322,263,54,315,247,68,369,290,70,369,292,72
2111100I112,731,445,286,736,374,307,611,408,191,603,375,228,789,456,316,786,469,286
2120100A101,205,72,133,209,48,154,146,64,81,146,58,88,236,55,179,230,61,164
2111100D140,924,494,430,920,448,408,767,467,287,758,398,360,1011,541,460,1012,529,439
2111100J137,622,254,368,628,198,403,438,247,182,433,200,233,662,266,386,663,286,353
2111100I115,408,328,80,415,330,70,294,249,40,290,237,53,533,404,119,534,411,111
2111100L117,729,497,232,723,468,174,570,456,106,563,415,148,780,563,195,781,554,197
2111100B133,975,451,524,982,359,580,806,424,365,798,342,456,1052,433,602,1057,454,585
2111100M104,438,422,16,439,423,8,289,282,2,286,273,13,411,389,13,413,393,9
2111100B151,1115,514,601,1119,456,601,874,532,327,862,430,432,1222,570,623,1226,580,613
2120100D101,212,63,149,219,44,169,161,64,91,158,58,100,248,50,196,251,52,181
2104300D104,259,116,143,266,55,205,187,104,79,182,96,86,300,64,234,282,84,192
2111100Q101,1027,684,343,1026,610,367,760,552,195,752,491,261,1050,672,359,1050,684,329
2111100A127,556,298,258,561,235,300,424,257,154,416,216,200,664,330,319,667,343,293
2111100K122,702,619,83,711,589,110,525,468,53,518,436,82,742,625,108,739,615,102
2111100V102,1373,484,889,1388,442,888,1119,542,558,1102,412,690,1776,715,1032,1774,688,1035
2111100M142,1048,814,234,1058,790,175,941,809,114,925,755,170,1134,919,193,1139,930,181
2111100Q112,851,407,444,855,306,522,650,351,283,650,293,357,855,360,485,853,371,446
2111100V112,18,7,11,18,5,13,18,5,13,18,6,12,29,13,15,30,13,17
2111100A107,550,306,244,548,228,294,393,272,112,385,220,165,616,317,283,616,337,247
2119100B101,660,167,493,665,145,491,491,192,284,483,156,327,743,163,569,776,176,540
2101700E101,724,310,414,722,194,498,553,242,306,549,195,354,767,221,536,787,239,527
2107100B103,319,142,177,341,71,262,242,131,106,240,118,122,366,88,273,368,119,231
2103300C103,557,210,347,561,149,399,383,156,220,375,144,231,607,170,432,586,173,396
2106700C150,357,261,96,366,234,107,278,207,65,274,195,79,412,307,94,408,302,88
2107700C101,380,102,278,380,88,281,232,82,146,231,65,166,367,80,282,358,88,259
2106700A164,332,294,38,334,282,40,289,248,38,287,232,55,360,309,47,357,314,41
2106700B123,735,362,373,720,311,376,632,337,294,624,292,332,775,386,382,812,365,437
2106700C140,731,600,131,728,576,113,641,550,88,638,542,96,764,635,112,761,631,122
2106700A120,286,267,19,289,264,18,253,243,10,250,223,27,362,334,24,354,327,24
2106700A189,336,161,175,333,137,175,310,151,153,309,133,176,352,173,175,363,179,180
2106700A123,482,292,190,487,256,203,426,288,130,419,251,168,545,335,199,538,327,197
2117700C104,665,281,384,681,172,492,476,220,247,468,194,274,748,188,552,739,216,483
2106700C157,427,308,119,421,270,105,260,217,40,259,212,47,476,351,111,493,334,142
2106700C230,417,259,158,418,226,156,384,231,152,379,207,172,536,339,187,531,313,204
2106700C229,311,140,171,309,109,190,265,119,143,264,114,150,387,164,218,381,164,210
2105900A130,805,397,408,804,315,426,612,349,248,612,288,324,885,395,468,901,400,439
2106700C152,660,266,394,649,226,391,570,242,325,570,207,363,707,300,397,716,277,428
2106700A204,350,237,113,348,202,123,323,235,83,324,197,127,479,292,172,479,313,154
2101500C128,510,143,367,513,138,340,329,127,193,326,106,220,554,180,362,554,196,339
2101500B115,573,162,411,577,160,364,453,198,244,447,152,295,606,205,383,628,219,375
2115500C103,357,185,172,367,132,219,295,153,128,286,135,151,425,142,278,434,151,248
2115500A103,496,206,290,500,104,378,370,184,186,360,138,222,535,101,429,549,150,374
2111700B131,584,179,405,593,158,394,401,166,226,397,140,257,697,221,461,688,266,400
2111700C102,835,252,583,829,282,480,692,312,371,679,236,443,921,371,528,929,352,541
2111700A124,559,250,309,559,227,286,349,206,137,351,180,171,644,305,321,677,356,292
2111700A130,572,192,380,585,185,346,420,206,206,420,176,244,609,231,360,612,254,334
2111700B137,1114,292,822,1125,286,774,856,360,476,836,270,566,1401,421,952,1357,456,851
2122300B101,261,118,143,264,80,178,187,90,96,186,76,110,329,98,228,310,110,191
2123500C106,293,66,227,294,29,256,189,38,148,187,29,158,308,34,269,320,47,256
2123500B101,778,244,534,774,158,587,601,206,390,597,172,425,846,192,640,851,182,625
2111700X001,0,0,0,0,0,0,0,0,0,0,0,0,0,0,0,0,0,0
2105900H103,1153,379,774,1168,264,841,910,352,539,896,277,619,1270,331,922,1259,381,834
2112500D101,754,187,567,778,106,651,591,148,432,585,119,466,875,138,727,858,149,679
2115500C105,251,105,146,254,58,182,211,98,108,208,87,121,286,60,221,306,82,201
2110900A105,136,32,104,147,10,136,89,19,66,88,8,80,163,12,150,147,22,125
2111700B111,596,166,430,595,167,395,466,217,240,449,159,290,654,215,427,637,227,391
2111700C117,765,254,511,761,273,422,596,298,284,582,255,327,806,342,442,830,337,451
2115900B102,404,82,322,422,28,386,266,68,194,270,46,224,424,26,395,425,41,375
2121900A103,273,51,222,274,37,232,141,27,108,143,24,119,315,22,289,303,37,249
2123500A101,83,29,54,88,25,51,40,26,13,39,15,24,55,18,33,67,13,37
2110900A104,159,33,126,166,15,149,124,20,102,119,16,103,168,17,151,163,21,139
2101300C102,252,78,174,270,56,210,187,81,104,186,81,105,283,59,222,270,64,194
2107900D102,242,86,156,244,43,195,192,74,116,191,61,130,289,56,229,283,68,203
2107300F105,448,333,115,452,284,137,337,252,74,338,232,106,477,322,143,450,301,132
2107300F108,863,460,403,862,313,507,713,394,306,699,317,382,837,329,496,843,385,433
2107300F102,276,218,58,280,196,74,237,194,38,236,190,46,315,232,81,280,206,70
2107300C110,468,281,187,470,219,225,404,252,141,394,221,173,519,260,247,514,267,225
2101300D104,193,97,96,196,74,113,96,58,35,94,55,39,183,70,109,188,73,97
2104900F106,362,169,193,360,136,198,325,177,145,326,162,164,369,160,200,374,137,217
2117700D104,453,170,283,466,92,371,251,115,134,246,97,149,500,97,401,476,125,342
2103500C101,647,261,386,650,232,383,487,231,253,481,191,290,690,275,406,677,255,403
2111700A123,389,216,173,387,217,139,315,223,86,310,205,105,462,294,157,492,310,165
2100900D103,919,436,483,937,293,614,743,371,364,740,291,449,1055,360,685,981,336,608
2110700G048,400,173,227,412,126,260,267,129,134,259,112,147,434,158,265,442,161,235
2110700C021,538,169,369,551,120,402,372,154,208,365,130,235,602,158,430,611,166,401
2112100B103,72,14,58,86,8,78,43,11,31,43,5,38,96,10,86,82,10,72
2101300C101,355,106,249,367,69,285,201,82,117,197,62,135,352,67,279,362,81,257
2110700C019,453,140,313,447,79,353,311,111,194,309,76,233,485,103,375,496,135,336
2110700C020,331,120,211,331,79,245,208,82,124,202,61,141,350,99,249,341,112,218
2111300B102,855,366,489,858,241,579,716,308,400,714,253,461,991,328,647,980,332,618
2111300E107,584,131,453,584,99,357,345,117,219,337,86,251,423,110,285,497,100,358
2119900B102,154,28,126,156,10,143,127,18,108,126,15,111,179,14,165,180,24,156
2100900E103,767,295,472,767,135,606,530,179,341,527,148,379,797,155,631,808,212,555
2111500B107,376,137,239,395,51,336,243,72,163,245,70,175,415,66,345,406,75,314
2123500C103,57,3,54,56,2,53,25,0,25,25,1,24,61,2,59,67,2,65
2100700B102,152,41,111,150,26,120,114,34,80,113,29,84,156,27,127,163,28,128
2122100A102,103,27,76,105,23,76,89,30,57,87,20,67,126,29,94,131,32,89
2105500C101,376,111,265,382,60,306,246,85,155,237,66,171,424,76,340,433,94,308
2109300C007,597,325,272,607,278,289,397,252,137,398,197,201,674,347,309,664,333,289
2120900C108,652,253,399,648,167,444,554,229,317,554,172,382,778,234,529,797,268,495
2121100C105,645,277,368,646,234,368,581,341,228,574,278,296,883,360,506,900,346,501
2101900B108,438,217,221,436,128,299,312,159,152,312,140,172,435,140,292,423,170,246
2100500F104,744,300,444,744,169,543,660,247,401,655,191,464,830,207,612,822,236,558
2108500E103,215,37,178,220,17,191,166,36,127,163,17,146,269,26,242,271,29,228
2108700D102,562,136,426,567,67,492,415,98,315,410,75,335,619,74,542,633,101,513
2122700C108,179,69,110,177,60,111,162,93,67,161,80,81,208,82,124,206,87,113
2108500F106,297,69,228,301,26,269,227,38,183,221,29,192,321,38,278,322,46,254
2101900B110,526,256,270,519,204,275,346,214,129,334,181,153,519,227,273,563,205,307
2118300D106,261,90,171,272,59,199,191,82,99,190,73,117,311,73,233,315,77,209
2116500C101,513,230,283,527,143,374,394,172,216,392,156,236,572,110,457,567,134,408
2109500B104,298,57,241,306,21,271,161,34,124,158,35,123,310,32,273,326,49,260
2104700B101,791,449,342,801,441,330,458,260,184,449,240,209,836,487,331,862,510,308
2104700C104,514,121,393,527,101,408,439,149,287,433,116,317,579,121,445,564,149,384
2102900B112,452,147,305,457,94,335,343,154,180,339,108,231,555,127,414,575,146,391
2108300A108,441,133,308,447,63,363,339,105,217,327,109,218,468,71,388,479,100,354
2118900A101,160,46,114,174,28,144,154,53,98,153,46,107,189,24,164,185,27,151
2111700C137,566,161,405,564,150,369,442,186,249,432,142,290,597,190,391,611,217,362
2102900B110,1079,403,676,1094,279,758,707,352,335,693,261,432,1208,339,846,1204,362,784
2115300C103,305,118,187,311,64,242,212,124,79,211,94,117,342,70,266,340,79,249
2119500F103,357,127,230,370,65,300,206,75,127,206,80,126,370,71,296,364,79,281
2117300A102,449,230,219,454,157,274,354,201,149,350,172,178,482,173,299,474,171,280
2117300C103,991,395,596,1004,244,714,886,349,523,882,276,606,1224,307,891,1262,336,872
2111100F170,422,251,171,430,242,160,268,185,76,265,161,104,459,287,164,460,290,148
2111100J148,681,418,263,691,365,273,561,397,159,562,357,205,733,447,270,733,474,239
2111100M148,469,459,10,470,460,8,378,375,3,376,356,20,475,465,5,475,467,6
2111100K137,180,169,11,180,171,3,133,127,5,134,122,12,269,253,15,267,248,14
2111100G109,803,602,201,805,609,136,677,578,94,673,536,137,882,729,140,882,721,152
2111100H121,341,210,131,340,184,133,301,224,70,297,201,96,383,231,142,390,253,125
2111100D139,1013,546,467,1024,489,455,832,547,268,813,461,352,1128,639,470,1130,632,463
2111100M139,566,459,107,566,431,82,587,515,65,578,486,92,868,688,162,867,696,149
2111100L154,368,358,10,370,352,7,253,244,7,249,223,26,367,349,14,365,350,10
2111100H109,339,238,101,345,209,111,316,243,69,314,217,97,406,273,121,405,281,116
2101900B118,349,173,176,352,77,265,242,102,130,238,97,141,390,95,292,382,154,221
2114500C109,553,179,374,546,158,367,529,207,321,527,176,351,714,231,477,714,210,489
2114500C129,493,159,334,496,145,332,337,162,167,331,138,193,497,175,316,499,161,323
2114500B116,447,258,189,444,236,187,252,165,82,251,158,93,454,267,180,432,240,184
2106900E103,251,82,169,261,49,207,212,58,150,212,55,157,320,58,261,324,60,254
2106900B103,270,83,187,278,41,221,185,44,140,187,44,143,301,44,253,321,55,256
2106900F102,258,112,146,258,50,202,207,84,120,202,71,131,302,56,244,303,79,211
2111100A136,414,238,176,412,171,219,302,204,91,296,167,129,433,195,222,432,223,181
2108300A109,1002,277,725,1005,151,821,771,253,506,747,213,534,1065,170,881,1077,210,837
2114500C119,333,193,140,331,160,145,244,154,84,242,139,103,337,185,143,346,184,139
2111700A102,355,244,111,360,252,76,263,215,37,262,203,59,446,346,87,487,356,107
2113300C107,325,121,204,337,52,272,227,105,119,221,86,135,350,63,283,357,90,256
2114500A117,74,25,49,75,16,57,42,18,24,42,17,25,79,20,59,78,25,52
2119900D107,199,56,143,196,24,168,177,38,134,179,29,150,244,36,206,238,49,189
2111100M107,257,251,6,258,251,3,157,153,4,158,147,11,255,244,7,255,246,5
2111100O115,924,502,422,927,383,501,679,439,220,655,346,309,897,422,462,899,446,424
2111100K114,543,416,127,548,378,144,428,341,74,426,307,119,616,463,126,619,475,111
2111100C115,956,730,226,958,708,221,662,529,127,659,480,179,996,723,256,1000,739,235
2111100A123,878,528,350,873,438,401,575,365,203,563,320,243,911,467,424,915,496,389
2111100B166,616,319,297,620,268,310,457,264,181,451,215,236,658,287,357,664,307,320
2111100N142,911,460,451,899,446,409,874,570,302,865,478,387,1044,645,387,1049,613,418
2111100K128,559,311,248,566,235,296,380,234,135,373,207,166,543,235,293,544,258,255
2121300A102,597,150,447,605,116,465,395,154,235,392,121,271,743,156,574,743,183,524
2111100O135,646,382,264,646,271,353,467,305,156,461,267,194,654,292,353,654,324,307
2119900B105,660,157,503,667,74,568,523,135,377,517,102,415,773,104,658,802,131,628
2111100E177,291,153,138,292,124,149,249,141,103,248,122,126,331,147,179,332,143,179
2111100B163,990,540,450,990,465,474,679,437,231,675,374,301,1007,543,434,1009,567,409
2101100A101,206,108,98,208,72,124,156,101,52,153,77,76,239,85,147,242,91,136
2104300D106,366,169,197,370,79,279,254,130,120,252,129,123,405,89,311,406,121,261
2115100C108,322,130,192,321,76,234,263,135,124,261,114,147,411,110,295,413,141,260
2115100B107,1195,613,582,1203,493,601,890,560,301,882,473,409,1451,679,719,1464,629,747
2115100C104,398,131,267,401,60,329,329,109,214,327,81,246,401,68,328,408,112,286
2115100D111,1026,484,542,1016,345,615,944,462,457,931,387,544,1221,469,725,1227,490,686
2114500A121,374,103,271,381,60,306,278,80,192,271,78,193,396,73,317,399,103,283
2109700F102,502,235,267,507,124,362,431,179,246,432,154,278,629,155,467,642,192,426
2104300D103,282,138,144,297,77,213,218,119,88,211,112,99,371,98,270,341,111,217
2119900D108,377,115,262,381,58,313,269,63,203,269,59,210,398,72,323,388,86,292
2119900E107,157,42,115,162,32,125,117,39,78,115,30,85,171,40,129,169,32,127
2107100B105,394,220,174,412,143,258,270,171,93,270,148,122,353,101,249,356,127,210
2107100C110,230,143,87,265,85,175,154,92,58,152,101,51,232,62,169,226,90,128
2110300F102,204,82,122,208,52,148,148,69,77,144,54,90,222,57,162,213,67,138
2110300E105,141,46,95,141,29,102,110,42,67,113,37,76,150,32,114,156,38,110
2102500D101,105,53,52,116,37,75,76,29,42,73,30,43,119,32,84,106,34,70
2101500B126,898,182,716,894,162,693,627,200,410,611,126,485,1022,224,783,1000,264,700
2101500B124,1163,296,867,1167,306,794,851,359,472,837,273,564,1322,416,883,1316,425,835
2106700A169,437,311,126,427,252,164,360,277,71,356,251,105,498,313,179,495,332,155
2111700B115,1429,307,1122,1433,294,1050,933,376,525,924,277,647,1710,422,1256,1652,466,1130
2106700C192,507,249,258,501,194,286,454,247,205,456,214,242,611,277,327,612,287,317
2111700B125,906,246,660,908,261,578,577,281,278,563,217,346,1042,357,660,1030,356,635
2106700B187,532,237,295,532,185,306,455,234,213,445,203,242,533,236,287,537,227,299
2106700A152,677,496,181,676,417,209,532,416,109,528,378,150,755,534,204,749,546,179
2101500B121,1674,417,1257,1672,420,1159,1121,413,694,1105,323,782,1946,587,1326,1931,614,1245
2111300A105,653,298,355,654,191,421,533,249,271,522,189,333,672,234,425,674,244,405
2102100C102,603,302,301,613,217,366,475,264,199,475,228,247,681,267,398,669,275,358
2112500D103,329,57,272,337,16,313,237,36,199,235,25,210,368,21,344,372,45,320
2110300B103,470,165,305,473,97,342,404,157,244,404,117,287,583,125,446,609,159,412
2112500E106,810,183,627,824,100,690,665,186,466,664,133,531,935,132,785,978,149,765
2117900B102,599,344,255,612,293,291,374,239,125,375,206,169,632,306,315,601,288,286
2110700C018,648,150,498,654,100,530,464,159,300,458,124,334,671,126,538,679,139,512
2110700B012,317,97,220,322,62,251,225,89,132,226,80,146,358,82,272,347,96,242
2108100B102,170,37,133,172,24,145,130,39,89,131,35,96,205,28,175,192,41,149
2107700A102,324,113,211,326,89,221,203,100,100,195,84,111,383,100,275,390,120,244
2108100B108,344,92,252,349,74,266,251,102,145,249,85,164,412,86,321,400,101,283
2108100C106,268,57,211,273,48,209,185,50,133,183,39,144,351,62,280,363,69,263
2110700G045,369,123,246,374,100,259,238,101,130,236,86,150,409,129,273,403,118,262
2100900B104,795,281,514,799,162,610,594,181,394,587,158,429,907,202,693,920,220,659
2111500A108,464,163,301,481,79,377,348,135,200,352,115,237,534,101,429,533,118,399
2110100A108,504,218,286,505,173,309,321,159,158,317,133,184,492,185,297,498,192,280
2110100A110,634,209,425,640,162,448,451,197,249,440,161,279,683,193,478,699,204,462
2123500C102,148,57,91,153,27,123,101,44,55,99,25,74,157,31,124,144,40,98
2109300D001,602,285,317,611,226,340,406,221,172,404,171,233,617,261,337,634,271,313
2110700F041,213,45,168,215,24,189,130,31,95,126,26,100,216,29,186,210,40,168
2109300F007,440,133,307,443,82,333,326,126,190,327,94,233,438,95,330,460,126,303
2112100C102,319,82,237,332,52,272,199,70,121,192,51,141,364,62,300,362,59,295
2112100C105,181,72,109,195,48,143,109,45,62,105,42,63,199,53,145,179,48,126
2123900B103,375,237,138,382,196,166,299,202,93,292,169,123,467,271,189,428,244,171
2112100A105,742,224,518,759,100,627,523,151,357,521,127,394,839,121,703,874,165,658
2122500E102,431,165,266,437,91,335,290,125,151,289,112,177,431,97,330,420,120,280
2118700C103,341,101,240,349,70,265,240,83,153,240,72,168,381,73,303,382,83,280
2119500A105,331,177,154,348,125,203,213,129,73,208,133,75,314,125,183,291,100,172
2119500E109,253,105,148,270,49,209,142,51,88,140,63,77,238,48,187,241,59,163
2119500A101,286,106,180,292,92,194,197,100,92,197,94,103,268,92,174,267,60,201
2115700B101,514,196,318,517,116,389,430,187,233,419,177,242,585,135,445,569,161,391
2102900B101,280,109,171,283,67,200,199,83,109,194,67,127,307,81,220,309,96,196
2118500H104,787,295,492,772,253,471,581,264,296,573,204,369,826,329,480,843,343,469
2102900C110,833,357,476,848,236,574,637,319,297,626,260,366,896,272,607,879,304,523
2116300F104,397,165,232,399,89,291,312,147,157,306,123,183,456,101,344,466,126,313
2116300F103,575,231,344,587,130,433,397,159,228,394,134,260,635,141,484,630,166,439
2104700D101,591,156,435,602,167,415,442,165,263,435,135,300,632,191,431,613,183,404
2120900A104,377,155,222,372,100,259,330,139,186,331,120,211,414,128,280,413,149,250
2121100E101,894,419,475,904,362,485,764,418,328,751,333,418,1074,479,574,1059,450,556
2119500E103,732,291,441,772,109,652,523,219,288,518,218,300,740,115,622,712,175,520
2116300E101,671,289,382,682,172,484,477,209,249,465,164,301,739,186,536,714,216,454
2114100A105,377,141,236,380,129,230,242,112,125,236,105,131,438,142,283,456,156,263
2109500B103,287,68,219,312,38,270,146,30,113,149,32,117,289,29,258,287,40,234
2108500A102,336,122,214,342,89,238,241,84,146,240,78,162,376,96,273,374,95,249
2100100D104,408,154,254,414,111,294,283,116,162,286,87,199,425,113,308,406,116,278
2117500E103,268,120,148,280,54,219,207,88,112,207,85,122,317,62,252,302,80,216
2116700C104,624,204,420,628,108,492,466,157,304,462,129,333,684,135,535,713,159,520
2120900F125,227,108,119,223,93,113,168,103,59,164,85,79,246,117,121,249,103,133
2102900B102,844,287,557,847,206,599,655,286,355,647,232,415,984,263,702,994,271,679
2105300E101,323,59,264,341,42,294,222,50,166,215,29,186,373,45,326,367,63,294
2103100D106,354,95,259,364,59,296,249,64,180,251,62,189,436,74,358,421,88,308
2118500F102,893,323,570,893,251,593,701,288,400,696,243,453,987,340,630,987,390,566
2122700A109,881,433,448,883,412,397,520,368,144,515,329,186,974,528,417,1000,508,433
2122700A113,331,157,174,335,155,145,221,134,87,216,113,103,326,179,137,339,166,152
2111100K147,1005,596,409,1005,477,487,716,489,212,715,424,291,1097,617,457,1099,644,416
2111100C111,897,860,37,899,852,32,643,618,17,639,577,62,880,817,47,880,826,36
2111100S125,1126,581,545,1129,587,505,974,567,400,964,491,473,1356,743,596,1358,720,618
2111100I146,647,321,326,649,244,365,457,252,195,453,222,231,737,325,398,731,348,353
2111100Q137,726,431,295,724,394,289,525,348,164,523,303,220,754,442,292,757,454,267
2111100E165,897,479,418,900,472,378,649,410,229,637,349,288,948,556,382,950,561,366
2111100O111,654,477,177,664,442,206,500,401,91,493,363,130,707,492,199,706,503,181
2111100Q125,1285,616,669,1288,498,695,1027,613,390,1015,510,505,1442,705,699,1441,730,654
2111100G148,347,219,128,352,225,108,320,244,72,316,220,96,397,280,108,399,283,104
2111100V118,831,387,444,832,333,431,653,384,250,647,338,309,877,449,407,879,459,386
2111100F161,630,240,390,626,235,361,534,249,281,532,218,314,655,286,360,658,266,373
2111100H138,1081,703,378,1088,612,415,696,498,184,687,443,244,1078,658,398,1077,680,358
2111100I154,1099,588,511,1096,492,541,855,586,254,843,482,361,1298,721,538,1307,749,503
2111100A113,846,442,404,854,351,471,654,398,247,645,332,313,845,387,446,848,410,405
2111100K129,577,446,131,579,411,119,444,382,55,441,369,72,574,434,124,578,458,104
2111100K119,583,367,216,587,317,246,426,308,103,419,270,149,585,332,239,588,344,227
2118500E105,813,286,527,820,257,517,628,304,316,622,245,377,888,339,534,874,336,509
2108300C107,421,93,328,422,53,365,338,77,250,329,74,255,450,59,389,453,70,376
2119500F105,474,216,258,495,81,403,277,111,155,276,118,158,491,89,397,459,134,314
2111700C113,523,208,315,535,197,302,381,190,184,375,152,223,579,249,319,578,279,281
2105500D102,151,39,112,158,29,124,112,39,70,108,32,76,150,31,117,142,28,111
2106500C103,634,208,426,642,114,497,455,179,269,458,131,327,735,136,587,770,169,563
2122700A108,674,331,343,682,295,344,534,315,213,522,270,252,762,383,365,750,392,335
2109500B106,354,74,280,384,47,333,194,48,142,185,48,137,362,37,323,363,44,302
2103700C416,543,212,331,539,225,282,393,205,183,383,165,218,668,315,340,676,311,336
2122700B104,289,238,51,296,253,34,189,168,18,189,159,30,346,309,34,321,265,47
2111100C105,351,337,14,350,334,4,253,240,12,251,230,21,328,302,19,329,309,15
2120500B102,283,147,136,287,89,187,239,132,106,240,109,131,385,125,252,381,151,210
2111100J149,540,410,130,540,385,131,341,270,66,341,252,89,594,391,192,594,402,173
2111100M170,714,684,30,715,679,28,472,462,7,471,432,39,683,641,33,683,654,21
2111100L151,529,297,232,525,293,200,466,313,148,460,255,205,605,362,235,603,352,236
2111100F180,1077,553,524,1087,535,479,850,542,287,836,455,381,1211,674,496,1213,686,488
2111100S116,685,282,403,678,289,367,622,325,293,613,270,343,868,401,444,874,372,485
2111100Q124,575,460,115,576,432,135,405,349,52,400,318,82,608,449,147,607,456,136
2111100J117,453,261,192,457,227,211,334,207,120,329,186,143,443,225,213,447,236,201
2111100S143,799,283,516,791,290,472,675,296,374,672,244,428,932,387,528,936,374,548
2111100D109,334,216,118,334,200,115,264,192,69,259,165,94,359,250,103,358,252,99
2103700A504,398,181,217,399,184,189,275,181,83,274,159,115,457,238,210,464,244,203
2115100B106,352,214,138,352,189,139,308,203,94,306,185,121,377,223,143,361,188,152
2115100C113,565,324,241,558,244,278,477,309,158,480,284,196,657,322,319,644,319,297
2111900A105,224,100,124,232,61,166,181,92,88,179,83,96,248,60,183,248,69,172
2111900B106,85,38,47,88,20,65,54,24,30,54,20,34,76,16,59,75,18,54
2111900C103,30,23,7,30,13,17,18,13,5,15,10,5,26,8,17,25,11,12
2111900A103,227,120,107,231,76,151,176,95,78,179,88,91,269,72,195,273,74,185
2120100B101,171,71,100,177,48,125,150,68,81,147,58,89,193,52,140,174,57,117
2111100A114,681,347,334,693,246,415,471,261,187,463,235,228,695,316,363,699,327,341
2111100F106,635,321,314,634,296,319,663,399,256,656,353,303,968,516,433,968,525,418
2111100F154,760,288,472,752,326,388,671,312,353,664,264,400,846,394,439,856,377,474
2111100Q113,403,179,224,408,115,268,316,153,157,311,125,186,420,149,265,417,157,248
2111100I140,75,52,23,74,43,29,60,40,18,60,37,23,86,57,26,86,51,29
2111100M124,741,593,148,739,572,112,576,505,60,562,480,82,750,651,90,752,652,82
2111100E164,767,265,502,760,249,479,665,305,354,661,267,394,893,395,481,902,385,504
2111100M143,472,363,109,467,338,97,484,416,65,479,392,87,665,524,132,671,533,132
2111100G164,1074,637,437,1063,635,359,842,608,223,828,524,304,1072,697,342,1075,684,366
2107100B104,318,172,146,331,86,238,252,155,90,249,132,117,354,84,270,355,117,224
2116900B102,90,22,68,98,12,85,77,24,50,73,12,61,104,11,93,96,15,81
2101700C103,521,308,213,522,234,262,407,242,153,404,213,191,607,291,306,582,259,295
2115900C102,307,68,239,338,34,290,170,41,124,170,30,140,303,30,271,303,39,251
2106700B201,460,205,255,461,158,281,396,194,197,395,168,227,539,228,303,540,231,296
2106700C191,611,410,201,610,323,224,509,392,111,506,343,163,658,423,213,679,442,210
2110300A103,215,87,128,215,57,143,154,78,75,153,65,88,223,62,157,235,71,145
2111700B133,929,213,716,930,209,675,642,238,380,629,186,443,1034,275,743,992,298,664
2106700C170,345,247,98,345,192,128,290,219,67,289,201,88,389,248,134,393,267,116
2101500B119,561,173,388,563,180,346,430,167,249,427,141,286,567,215,340,571,218,329
2101500A123,1147,292,855,1148,296,775,804,372,403,789,288,501,1421,442,949,1439,461,906
2102100C103,269,130,139,267,101,153,217,115,101,217,91,126,312,130,175,317,125,174
2111700C110,693,246,447,702,249,397,481,251,216,475,207,268,749,313,417,757,328,396
2111700B130,697,161,536,694,152,503,592,218,356,580,157,423,931,243,672,907,273,604
2111700B108,1070,263,807,1067,308,705,799,303,486,785,241,544,1129,381,729,1085,345,703
2111300B105,958,387,571,963,218,686,747,342,387,741,252,489,1047,286,738,1072,339,695
2111300E101,253,82,171,247,53,174,231,87,139,228,62,166,272,72,193,301,73,213
2111700B106,655,171,484,651,177,441,519,217,295,508,165,343,740,237,493,713,242,457
2117700A102,377,208,169,381,156,207,239,139,94,237,133,104,402,166,226,384,155,207
2112500C105,358,91,267,370,46,320,237,70,159,240,49,191,393,56,335,375,68,300
2107300D101,439,215,224,434,155,259,369,197,167,364,157,207,469,181,280,486,201,265
2121900B103,116,16,100,120,22,96,66,16,49,62,14,48,123,19,103,118,15,98
2121700D102,944,292,652,946,166,746,690,208,467,692,160,532,1040,192,833,1050,246,767
2105900A110,1056,510,546,1068,387,610,777,435,321,757,367,390,1179,484,667,1181,512,586
2105100E104,97,26,71,109,19,89,65,24,36,64,21,43,119,17,102,119,21,95
2110100D103,381,218,163,378,163,193,190,111,74,189,104,85,383,179,198,402,215,166
2104900D104,694,388,306,696,271,390,502,280,213,493,227,266,708,310,384,672,308,336
2107300A102,449,264,185,443,207,222,441,284,147,440,253,187,513,256,252,498,260,231
2112100E101,146,54,92,155,23,126,125,44,80,125,43,82,180,29,148,168,41,122
2110700G050,235,88,147,238,65,159,149,69,74,149,69,80,236,77,153,248,77,143
2110700A006,358,137,221,363,100,249,250,111,131,243,97,146,364,118,239,366,120,216
2123500B106,617,177,440,629,121,486,494,180,304,490,138,352,719,153,554,724,139,538
2100900B101,978,341,637,980,164,780,744,265,464,735,216,519,1029,191,824,1068,249,760
2114100C101,559,138,421,564,108,438,401,145,250,393,122,271,662,122,531,670,147,484
2100700E101,375,130,245,384,71,304,279,82,192,277,74,203,417,75,339,399,93,297
2114100B101,418,130,288,426,119,303,284,114,166,278,93,185,442,122,317,420,136,277
2109300G003,521,143,378,524,78,424,377,109,256,373,85,288,595,103,482,605,157,429
2110700D029,147,53,94,145,41,99,113,47,65,112,35,77,160,53,105,160,51,100
2109300G002,538,174,364,547,104,425,424,150,267,421,103,318,629,138,483,617,190,412
2109300G007,649,223,426,650,143,490,498,181,309,495,129,366,749,189,553,730,242,479
2120900F129,533,245,288,536,169,324,418,198,202,413,171,242,638,236,385,658,260,356
2109300A007,149,89,60,148,80,54,83,54,26,81,53,28,155,94,55,159,86,60
2116300D102,769,329,440,778,195,555,601,309,283,594,251,343,860,225,619,841,263,537
2122700E110,755,440,315,760,431,277,426,302,111,420,279,141,872,556,293,880,519,306
2101900A111,413,186,227,412,138,257,240,136,99,238,119,119,412,152,253,422,147,256
2101900C105,475,245,230,483,137,332,295,177,108,290,148,142,513,160,348,494,207,275
2122700B106,388,259,129,399,271,110,238,160,73,235,147,88,459,339,113,435,297,121
2122700F105,868,248,620,865,178,635,710,269,430,702,226,476,1173,294,858,1191,374,771
2122700F113,1076,305,771,1075,279,732,938,414,505,925,325,600,1391,434,930,1396,433,901
2102900C111,238,75,163,240,59,174,201,70,128,197,65,132,255,68,185,252,64,181
2109900B103,395,192,203,398,151,227,314,161,142,309,139,170,449,188,247,471,183,236
2122700D107,197,69,128,200,43,144,164,63,99,159,45,114,205,53,146,211,78,120
2109900A103,135,66,69,139,37,99,108,39,65,105,31,74,161,40,121,145,51,91
2119500F106,407,166,241,422,74,341,250,101,147,248,101,147,444,85,356,435,109,311
2122700F107,607,204,403,609,153,436,499,187,309,499,161,338,651,193,451,639,236,384
2111100H126,454,264,190,455,201,226,331,209,115,327,184,143,425,212,202,423,229,175
2111100B157,1374,684,690,1379,607,718,1082,630,425,1070,524,546,1516,754,733,1515,784,672
2111100I130,359,164,195,363,111,240,213,115,96,212,91,121,392,143,244,390,149,217
2111100H111,417,253,164,419,236,147,383,274,103,373,243,130,479,298,163,482,300,164
2122700A114,452,136,316,446,137,298,424,183,234,417,143,274,502,179,319,483,163,311
2111100G123,248,158,90,243,171,64,227,167,59,224,151,73,263,193,65,261,188,69
2103700B902,640,160,480,640,134,477,404,152,244,399,119,280,612,151,452,594,188,385
2111100L119,773,543,230,779,528,151,578,478,96,569,436,133,817,605,185,823,624,179
2104500D104,161,46,115,163,31,128,116,47,67,116,32,84,165,34,129,163,28,124
2104500C101,407,137,270,405,80,311,339,106,225,336,87,249,471,100,365,470,96,339
2111100O114,723,403,320,728,323,382,523,320,193,512,282,230,692,336,352,690,346,325
2111100S126,885,392,493,881,393,451,711,400,310,702,347,355,943,470,460,943,448,481
2111900C111,38,29,9,42,10,32,31,20,11,32,22,10,42,14,28,42,16,25
2114500B119,403,95,308,401,59,326,293,87,205,288,70,218,478,83,387,491,109,369
2111100N107,676,661,15,681,659,11,529,518,11,527,483,44,754,724,17,749,728,10
2109700F101,514,240,274,523,119,377,395,166,221,394,138,256,600,147,443,615,165,411
2109100A101,401,205,196,405,146,231,334,176,154,321,138,183,399,147,242,397,164,210
2100300D103,669,168,501,686,119,559,490,134,351,486,106,380,818,147,667,772,168,592
2115100A109,1342,439,903,1345,255,1034,1073,412,638,1078,345,733,1533,334,1174,1570,428,1101
2114500C106,173,66,107,172,48,119,125,51,74,125,52,73,205,65,138,201,74,125
2114500C128,506,154,352,504,123,353,377,146,224,373,130,243,527,150,367,544,155,369
2109700A101,451,251,200,467,161,282,359,187,160,349,158,191,546,203,332,526,230,273
2119300B110,332,158,174,339,119,208,236,143,90,239,135,104,303,116,181,296,100,178
2122100D102,36,6,30,37,6,30,23,8,15,23,6,17,38,6,32,36,6,30
2117100B102,325,98,227,354,84,266,230,84,140,224,58,166,400,96,302,362,89,268
2106700C120,558,366,192,549,331,177,497,364,128,492,325,167,632,432,188,647,401,231
2106700C118,466,254,212,461,172,260,357,220,130,355,185,170,483,222,253,502,261,228
2106700A130,326,310,16,330,305,16,254,243,9,252,232,20,332,310,19,334,313,19
2106700A173,449,279,170,450,266,126,268,216,47,262,200,62,475,343,116,484,349,115
2101500B123,1521,398,1123,1534,404,1026,1305,534,747,1285,372,913,2071,660,1372,2064,686,1300
2106700C222,336,222,114,338,174,142,239,165,65,234,148,86,359,206,145,352,220,123
2105900D103,335,155,180,344,82,243,255,106,140,249,91,158,379,104,269,372,158,196
2111700C133,671,177,494,669,189,433,479,218,258,475,171,304,685,230,440,677,228,422
2106700A101,362,217,145,360,169,165,284,197,83,284,176,108,364,204,149,377,225,139
2106700A167,402,237,165,403,205,171,346,221,122,342,191,151,438,263,164,432,243,172
2106700B182,519,317,202,511,278,188,479,303,168,471,283,188,495,331,151,492,321,158
2106700A149,347,304,43,358,295,42,272,247,22,271,243,28,376,319,48,375,319,45
2106700B137,514,312,202,515,271,208,471,297,168,465,266,199,563,348,206,552,324,220
2106700B155,529,361,168,527,299,198,402,301,99,399,272,127,585,371,203,584,392,174
2106700B127,543,301,242,533,266,218,453,293,154,448,260,188,614,362,240,636,327,297
2106700C187,497,215,282,491,168,290,484,224,255,482,196,286,622,262,346,643,262,360
2111700A116,393,146,247,395,140,232,247,146,95,241,114,127,457,188,261,459,208,234
2106700B227,495,260,235,491,215,238,399,262,131,399,220,179,549,293,236,567,282,251
2106700A106,267,201,66,276,170,94,187,135,46,186,127,59,261,174,83,261,183,68
2106700B167,323,182,141,321,150,146,262,171,89,259,151,108,362,207,146,373,207,155
2102100A104,572,174,398,563,75,475,453,140,299,446,96,350,600,90,503,624,154,460
2108100B107,488,114,374,493,102,375,355,115,230,358,88,270,592,122,464,575,128,431
2110100B106,546,279,267,553,248,290,356,220,132,353,187,166,568,274,288,543,252,270
2117900D101,704,264,440,706,163,512,538,228,298,532,170,362,787,183,592,801,237,527
2107900A101,306,112,194,313,83,219,232,106,123,226,76,150,311,90,216,302,75,211
2107900B103,219,101,118,223,62,154,162,74,86,156,58,98,267,81,182,249,82,155
2112300D104,225,56,169,226,33,181,163,56,107,160,39,121,255,38,213,271,44,210
2109300B004,768,465,303,760,383,323,500,313,179,495,258,237,869,493,354,875,491,332
2110700F043,529,185,344,531,128,385,393,186,194,381,150,231,567,163,397,567,175,360
2121500D105,458,145,313,456,87,351,339,112,222,332,91,241,529,112,409,525,139,369
2108900C106,572,295,277,573,160,379,429,223,199,421,202,219,643,192,438,651,240,368
2110100C109,437,215,222,444,168,254,269,166,100,266,140,126,447,172,263,444,177,241
2121500D101,305,96,209,312,57,246,255,94,156,251,71,180,426,82,341,412,91,305
2113700A104,308,142,166,312,105,200,248,123,122,240,98,142,357,121,232,333,107,211
2111300C102,513,226,287,520,106,396,468,175,286,464,135,329,612,148,456,595,212,374
2112100D105,510,166,344,524,118,384,304,139,156,301,114,187,506,125,373,516,106,379
2122900D101,416,209,207,430,181,237,320,173,143,314,143,171,479,211,264,436,171,252
2113700D105,352,128,224,352,65,277,270,104,161,267,75,192,411,76,330,406,98,292
2111900D103,242,130,112,252,54,190,203,112,85,199,99,100,301,73,225,302,98,182
2122900C103,224,85,139,228,45,180,181,66,111,182,55,127,261,50,205,257,54,189
2104700F104,744,311,433,748,286,393,276,123,149,273,117,156,967,407,508,1083,455,502
2112900A102,186,78,108,187,39,142,140,57,79,136,48,88,172,37,131,173,42,119
2109500E104,311,63,248,321,30,287,209,65,142,204,53,151,355,34,320,372,41,324
2109500A111,162,26,136,170,15,152,110,10,99,109,15,94,158,14,143,161,16,142
2119900E110,141,55,86,149,40,104,150,56,90,148,48,100,211,66,142,192,54,126
2114500C125,409,275,134,413,255,137,303,207,88,299,192,107,516,347,158,484,307,156
2123700B101,226,83,143,230,41,183,172,73,99,172,69,103,247,43,202,271,59,199
2104700E104,494,185,309,499,167,315,352,178,163,344,150,194,483,174,299,491,199,264
2104700G103,385,141,244,400,127,253,279,120,153,278,114,164,412,142,257,414,163,223
2118500E106,239,73,166,232,62,151,183,74,106,184,63,121,239,80,152,254,84,157
2119500D105,296,86,210,307,22,272,224,75,147,221,73,148,310,25,280,340,56,267
2120900A116,414,201,213,417,158,232,339,197,141,340,162,178,511,222,278,498,214,266
2100100D101,390,68,322,401,48,351,264,46,214,257,31,226,418,49,369,407,51,354
2118500H105,543,192,351,549,180,332,462,214,237,460,168,292,649,261,376,638,248,372
2114700D106,128,35,93,132,18,112,103,33,69,97,23,74,112,15,96,105,19,86
2111100L160,265,252,13,267,257,4,190,185,4,189,176,13,292,272,12,291,274,9
2111100A115,705,350,355,720,252,433,497,286,198,497,237,260,769,315,449,771,341,393
2111100Q116,828,455,373,842,355,445,621,376,234,614,314,300,872,414,444,867,454,381
2111100I148,325,155,170,326,126,190,373,241,126,368,210,158,611,345,249,610,349,231
2119500A102,481,208,273,495,101,378,329,153,161,329,165,164,514,116,392,514,136,350
2111100H148,670,332,338,675,245,388,460,285,165,454,241,213,715,321,380,720,342,345
2111100G112,1083,838,245,1100,814,198,986,850,129,973,796,177,1199,983,195,1198,988,189
2119900E109,296,81,215,303,39,260,207,55,145,207,42,165,369,57,310,355,69,276
2111100M173,641,564,77,646,566,70,539,488,50,535,465,70,696,601,89,702,608,86
2102900A108,477,194,283,481,130,331,324,140,174,322,124,198,526,156,363,509,171,322
2111100J141,475,196,279,473,146,311,309,148,157,303,106,197,506,178,319,504,205,280
2122700B112,47,33,14,47,32,9,30,26,4,30,22,8,61,47,11,66,46,16
2118500F101,563,209,354,560,189,344,387,204,176,381,150,231,636,258,368,629,254,354
2119300A105,308,77,231,334,28,294,189,69,116,185,50,135,309,29,273,329,52,252
2103700A503,261,82,179,259,75,179,205,92,112,204,67,137,272,88,182,261,102,154
2103700C304,465,252,213,473,267,173,350,245,101,342,225,117,551,347,193,563,341,201
2103700C202,560,237,323,567,235,293,417,252,161,409,215,194,630,297,318,642,312,295
2122700E206,0,0,0,0,0,0,0,0,0,0,0,0,0,0,0,0,0,0
2122700E201,0,0,0,0,0,0,0,0,0,0,0,0,0,0,0,0,0,0
2111100S135,912,595,317,908,578,269,599,449,133,591,403,188,909,597,294,913,601,283
2111100N115,446,325,121,446,279,150,320,233,80,320,215,105,459,266,182,459,282,156
2111100B158,972,354,618,969,300,637,830,360,461,827,288,539,1121,385,723,1128,390,718
2115100A105,857,439,418,867,369,438,756,443,291,750,417,333,1033,495,510,1004,439,523
2111100H103,821,588,233,822,594,189,760,637,119,753,588,165,906,726,167,912,714,178
2111100K117,565,373,192,570,334,181,398,303,87,387,274,113,582,399,174,578,406,157
2111100M169,292,281,11,288,278,4,346,336,3,342,328,14,477,458,15,476,457,10
2111100N139,78,77,1,78,78,0,61,60,0,60,57,3,78,74,2,79,78,1
2111100G140,562,438,124,561,416,93,482,403,73,472,363,109,596,485,94,598,481,106
2111100E152,885,382,503,875,372,462,769,392,367,765,293,472,1017,509,494,1021,463,545
2111100I156,316,174,142,320,132,177,236,130,101,233,106,127,325,143,175,325,150,166
2111100S166,736,263,473,730,282,412,604,289,309,598,216,382,784,355,420,789,314,468
2111100C145,172,100,72,173,86,78,138,88,48,138,84,54,187,97,82,188,105,75
2119300B106,361,92,269,378,47,323,247,64,174,248,62,186,378,53,321,390,66,313
2111100N103,731,707,24,737,701,19,596,576,17,593,551,42,766,730,27,770,739,21
2111100A141,14,7,7,14,5,8,21,15,5,21,15,6,36,21,14,35,20,12
2111100L139,894,429,465,887,439,343,846,521,308,833,463,370,1170,692,459,1176,675,489
2111100S130,814,355,459,806,338,441,664,334,320,656,270,386,815,403,403,815,392,414
2111100I143,62,33,29,63,25,36,44,35,9,44,31,13,69,32,36,69,33,33
2111100H160,857,528,329,865,455,357,695,497,184,687,437,250,1060,655,380,1056,670,344
2111100E160,659,322,337,650,278,338,578,332,234,569,281,288,720,341,371,724,337,366
2113300C103,482,188,294,500,92,403,339,182,143,329,146,183,516,108,406,501,135,358
2111100M137,500,320,180,496,309,112,422,321,94,420,304,116,501,360,131,507,359,140
2111100F171,697,282,415,695,269,395,542,277,262,535,213,322,815,389,410,814,375,426
2101700D103,432,210,222,436,130,287,310,162,140,307,144,163,509,163,340,507,179,311
2107100C103,371,221,150,391,125,256,279,174,102,279,172,107,394,110,279,391,146,222
2115900D104,87,20,67,94,3,87,40,6,33,40,4,36,104,4,100,104,3,96
2111700B117,590,214,376,594,188,358,357,171,177,351,135,216,713,268,427,730,323,377
2106700A170,299,195,104,302,159,120,218,158,56,218,151,67,310,180,119,324,190,116
2106700C113,600,425,175,593,380,171,524,389,129,521,365,156,639,460,168,640,431,195
2106700A144,519,460,59,513,441,54,350,321,27,353,307,46,524,458,59,532,465,60
2106700A134,281,246,35,279,223,47,231,198,31,232,192,40,300,242,54,303,260,37
2101500A106,522,122,400,522,111,395,382,129,245,373,104,269,600,152,442,579,176,387
2106700B199,494,273,221,499,217,249,407,243,158,403,215,188,549,291,251,533,285,238
2102100F101,440,250,190,443,198,224,329,205,118,328,182,146,512,251,250,490,233,232
2101500A117,1367,311,1056,1367,346,925,1050,465,562,1025,320,705,1636,502,1100,1641,476,1087
2117900E105,736,451,285,752,396,307,442,307,127,440,273,167,794,430,345,777,393,331
2121500E102,653,218,435,656,121,501,514,181,312,512,151,361,812,161,638,828,190,585
2101500C102,1089,284,805,1092,276,758,654,263,377,643,189,454,1190,360,809,1186,391,744
2111500A103,191,78,113,194,31,155,140,59,79,137,58,79,197,43,152,195,47,137
2111500C102,343,101,242,361,47,309,248,80,164,248,66,182,367,45,313,366,55,300
2107300A108,706,357,349,711,222,447,550,298,243,536,257,279,719,241,461,741,310,395
2112300A103,620,261,359,637,190,417,442,211,220,438,166,272,739,226,501,703,211,455
2112700D103,217,119,98,221,71,142,133,77,55,134,72,62,251,83,164,223,80,135
2121700F102,949,336,613,956,195,723,718,264,433,712,182,530,1040,223,804,1050,282,718
2104900E101,430,205,225,433,121,288,361,155,200,360,136,224,456,147,301,458,173,263
2110100E108,496,220,276,496,181,280,339,202,133,336,186,150,527,223,290,544,229,292
2107300D104,423,188,235,426,138,269,363,196,163,358,167,191,467,164,295,477,179,283
2111300D106,630,219,411,622,138,379,459,183,259,448,124,324,596,188,372,648,205,400
2111300B104,738,341,397,735,238,437,519,245,264,516,199,317,853,330,498,866,315,512
2109300A006,718,417,301,719,378,302,508,316,185,502,272,230,813,473,323,792,429,321
2123900B101,519,271,248,514,181,305,486,264,213,474,227,247,564,232,321,560,259,284
2120900F117,730,317,413,720,224,455,814,413,393,805,312,493,1100,394,681,1116,422,644
2122700A110,865,318,547,861,317,508,694,340,345,685,278,407,935,399,524,909,366,518
2122700D114,503,250,253,506,237,242,302,200,92,299,182,117,738,393,330,728,380,317
2122700D103,412,127,285,416,91,307,308,119,180,307,99,208,463,121,333,459,154,285
2102900C112,487,203,284,492,135,338,325,170,148,321,149,172,578,171,399,559,190,348
2101900C115,683,320,363,697,199,466,450,235,201,445,213,232,726,230,481,735,266,428
2102900C113,464,152,312,468,103,351,357,144,206,351,102,249,511,123,383,503,134,353
2118900C103,149,56,93,161,27,133,132,45,86,122,37,85,186,25,161,168,35,130
2115300C105,378,150,228,401,71,318,242,124,111,252,120,132,462,89,369,463,107,345
2111100V124,551,277,274,555,261,270,499,296,197,491,244,247,731,397,320,731,406,305
2111100H127,297,220,77,296,204,86,188,144,41,187,128,59,299,205,88,295,212,73
2111100N135,138,81,57,138,91,38,115,94,20,112,85,27,205,159,42,207,164,34
2122700A101,536,156,380,540,142,364,420,214,199,415,168,247,560,177,370,567,177,355
2111100S152,596,297,299,588,283,274,481,277,198,475,227,248,680,390,278,684,378,297
2113300E105,318,137,181,331,70,246,233,125,101,229,116,113,327,80,242,337,96,216
2101900B106,451,211,240,449,162,260,314,183,122,316,172,144,456,183,263,473,172,278
2103700A414,441,168,273,444,171,242,302,161,132,300,133,167,499,220,268,504,226,255
2114500B132,477,167,310,482,160,297,389,190,197,380,169,211,515,197,311,512,169,328
2111100I125,334,211,123,336,193,131,212,153,55,207,137,70,353,199,145,353,206,132
2111100O136,624,369,255,635,306,303,389,256,127,381,213,168,573,269,293,571,279,268
2111900C110,98,38,60,106,30,74,73,35,37,75,33,42,90,27,62,86,30,52
2111100I141,721,383,338,724,324,348,454,281,158,446,245,201,838,442,373,835,476,326
2111100N143,895,464,431,899,439,393,830,509,308,818,439,379,1007,558,432,1015,555,440
2111100I152,905,423,482,908,320,518,682,402,269,674,343,331,969,434,517,971,448,485
2113300C104,240,111,129,259,46,200,149,53,95,148,53,95,251,52,194,246,77,152
2119900A101,222,72,150,228,51,171,162,55,105,164,45,119,261,69,189,243,57,179
2111100C134,644,396,248,645,351,250,482,350,123,476,300,176,653,386,256,655,415,209
2104300B101,527,257,270,543,127,398,398,228,162,392,199,193,672,161,502,624,206,403
2103700A804,850,210,640,850,191,609,629,253,363,621,181,440,932,245,670,913,282,596
2103700A701,583,171,412,583,155,392,439,185,247,432,138,294,613,190,411,611,217,365
2103700A419,396,138,258,393,142,225,303,160,137,297,133,164,408,169,230,411,171,223
2119300A113,329,136,193,331,64,261,212,100,108,209,89,120,306,65,238,306,90,207
2120500D101,186,115,71,187,86,89,114,83,26,114,72,42,169,90,75,173,104,63
2103700A602,441,144,297,446,145,269,365,184,172,360,151,209,613,231,368,611,239,343
2107100B108,374,198,176,386,91,286,305,157,137,303,151,152,387,73,311,391,107,269
2102500D105,72,29,43,77,14,58,51,17,34,49,16,33,62,9,52,68,15,47
2106700A196,408,267,141,412,221,151,371,271,93,366,242,124,558,352,188,554,360,171
2106700C226,342,222,120,345,194,123,271,181,79,271,164,107,346,216,119,345,207,122
2101500B116,769,221,548,775,208,530,534,216,297,520,168,352,867,277,577,856,310,517
2111700A105,279,147,132,282,156,110,188,133,50,178,115,63,343,212,125,351,212,127
2106700A198,388,245,143,386,211,135,330,240,79,321,216,105,496,321,160,502,316,167
2106700C165,550,374,176,553,325,187,379,290,83,370,264,106,572,381,176,578,392,165
2111700C127,768,221,547,770,224,495,589,245,336,566,201,365,817,281,519,810,294,484
2106700C163,466,194,272,459,141,295,408,168,238,402,142,260,520,196,314,533,211,309
2106700B185,683,316,367,691,258,387,595,308,277,592,251,341,761,352,395,760,338,404
2106700C148,384,258,126,384,216,137,301,222,75,297,216,81,445,284,151,451,298,139
2106700B203,602,292,310,594,184,363,459,244,212,455,192,263,623,250,361,644,298,334
2111700C128,750,277,473,751,291,413,494,231,246,482,192,290,810,363,431,813,366,416
2106700C198,362,246,116,363,197,141,259,199,53,250,171,79,363,231,124,349,229,110
2106700A192,534,328,206,530,284,214,442,274,166,438,241,197,663,424,230,647,407,229
2106700C227,598,359,239,598,316,244,647,416,222,645,375,270,1125,657,440,1117,625,452
2106700B133,452,310,142,443,269,124,307,232,68,308,209,99,415,293,108,435,299,120
2106700C175,522,314,208,514,248,223,439,296,134,437,266,171,582,340,228,590,342,229
2115500D104,349,207,142,347,159,174,258,145,111,254,134,120,333,143,184,326,141,171
2102100A105,183,74,109,181,44,128,147,54,89,144,38,106,184,51,130,189,63,122
2123500C105,153,37,116,159,25,132,89,20,68,88,13,75,172,30,141,166,27,133
2111500B105,243,103,140,248,50,186,164,75,81,165,68,97,276,60,214,277,67,196
2109300D005,1191,514,677,1201,459,674,928,460,447,921,354,567,1494,647,813,1489,596,813
2123900F101,915,372,543,909,260,567,807,384,406,794,295,499,1021,356,637,1091,379,666
2123900D102,713,370,343,718,259,408,619,319,290,601,261,340,805,343,443,802,364,406
2112500E105,637,162,475,639,93,517,469,140,319,467,82,385,666,112,540,707,122,532
2113700C103,372,146,226,378,77,282,279,100,170,276,86,190,422,99,318,417,103,280
2111900C108,184,72,112,192,39,147,163,94,67,166,93,73,229,54,174,227,60,161
2104700H103,709,237,472,714,221,479,445,174,266,435,151,284,748,249,491,730,275,435
2115300C104,377,167,210,396,88,288,215,101,108,214,100,114,348,70,276,348,78,258
2119500E104,311,161,150,349,52,294,238,113,119,237,113,124,367,60,306,305,106,193
2104700C101,354,139,215,360,118,225,233,97,128,230,86,144,344,123,212,353,148,181
2118500F106,202,64,138,197,54,127,162,61,98,159,49,110,231,79,145,242,84,148
2105300A104,292,62,230,316,51,253,201,57,142,195,23,172,359,58,295,371,70,269
2113300E101,268,111,157,282,66,208,182,88,90,182,84,98,328,88,237,320,90,217
2111900D102,93,39,54,92,16,70,71,40,26,69,36,33,98,37,60,97,37,55
2122700E103,419,154,265,428,108,304,277,110,163,277,98,179,452,135,310,442,176,249
2111100G150,391,201,190,384,191,117,262,178,83,261,170,91,373,205,157,384,207,171
2111100C129,903,647,256,909,592,270,730,572,146,721,505,216,969,685,269,971,682,254
2111100D138,1191,659,532,1199,624,512,1003,657,327,989,552,437,1375,813,535,1380,815,522
2119900C113,91,27,64,93,15,75,90,20,69,90,11,79,119,23,95,113,25,88
2111100O107,965,805,160,974,758,194,835,729,98,826,682,144,1250,1055,179,1248,1054,171
2111100J122,631,371,260,630,317,292,420,271,147,412,238,174,617,318,294,617,327,258
2111100C104,465,369,96,467,345,107,262,212,46,260,198,62,414,286,124,410,286,114
2111100K123,805,715,90,814,700,103,618,548,62,611,527,84,860,737,113,861,742,101
2105300F101,229,39,190,239,37,195,134,36,96,132,17,115,247,38,205,243,39,201
2118500H106,477,168,309,471,120,328,354,159,188,350,127,223,535,168,360,535,209,317
2111100H125,368,202,166,370,157,195,253,169,77,247,144,103,349,154,187,351,169,165
2113500B102,116,28,88,119,24,91,71,18,48,68,12,56,124,24,99,131,18,106
2106500B102,472,147,325,471,67,385,352,120,226,350,94,256,561,92,463,564,105,439
2111100K136,110,89,21,112,89,22,77,60,16,76,58,18,118,80,37,118,83,27
2106300A101,305,169,136,335,86,240,201,130,67,189,116,73,364,84,276,340,102,236
2111100L158,357,339,18,355,344,5,249,246,1,247,233,14,335,330,3,334,326,4
2111100H120,980,584,396,989,484,438,851,588,246,841,518,323,1009,571,417,1015,601,384
2111100J140,229,150,79,233,135,76,163,113,47,163,104,59,245,161,77,243,161,71
2111100I135,337,139,198,346,93,236,264,146,111,260,115,145,387,125,253,389,136,231
2111100C130,62,47,15,61,37,21,48,38,10,47,33,14,64,45,19,64,45,18
2111100C142,519,402,117,524,407,95,469,383,84,468,365,103,741,579,153,741,586,138
2111100B132,867,340,527,859,288,537,769,371,382,764,316,448,1010,410,582,1014,422,565
2111100O113,532,402,130,535,377,145,408,318,88,403,286,117,590,397,181,588,411,156
2111100H145,564,269,295,567,199,346,423,213,192,418,179,239,551,194,349,549,211,312
2111100Q139,340,171,169,340,134,182,260,135,119,255,112,143,367,150,207,372,164,190
2111100N124,3,1,2,3,1,2,0,0,0,0,0,0,8,5,3,8,6,2
2111100F185,823,517,306,831,488,269,532,394,124,523,352,171,785,535,234,789,551,214
2119100C101,432,103,329,439,73,354,304,86,206,298,69,229,571,102,463,576,136,408
2106700A138,706,395,311,695,316,333,616,353,253,611,327,284,778,400,368,781,393,373
2106700B158,462,290,172,467,260,171,328,246,79,328,226,102,491,307,167,486,301,169
2106700A165,281,152,129,286,139,141,253,147,103,253,140,113,366,205,159,343,193,147
2101500C136,594,159,435,603,154,423,439,165,261,437,145,292,648,197,443,629,214,394
2101500C124,772,289,483,781,298,444,448,211,224,443,186,257,821,365,445,816,373,420
2106700B207,592,321,271,591,269,272,461,284,170,457,244,213,670,362,288,662,345,299
2121700C103,195,47,148,204,26,168,173,43,125,168,36,132,219,29,185,228,39,171
2111700C108,354,112,242,351,111,218,240,104,132,234,87,147,399,148,242,400,158,225
2111700C116,746,249,497,752,268,430,557,285,262,547,229,318,850,355,475,848,350,463
2111500C101,258,60,198,270,22,244,184,68,114,177,45,132,338,45,292,336,52,271
2104900B103,340,167,173,355,116,211,240,120,115,238,100,138,381,144,226,372,145,207
2100100A102,235,43,192,247,11,230,192,32,158,186,27,159,291,13,275,279,37,240
2107300C106,408,208,200,412,162,223,348,216,121,343,193,150,409,176,223,421,181,220
2107300C102,362,264,98,363,238,110,286,226,57,283,209,74,446,308,132,412,273,128
2123500A111,266,53,213,270,20,246,198,39,154,200,29,171,305,25,278,302,41,258
2100900C101,485,183,302,499,93,384,359,129,223,352,108,244,497,103,386,507,127,343
2110100E112,386,208,178,391,162,214,245,150,91,241,141,100,404,190,210,390,206,177
2119300C102,335,111,224,345,60,274,212,79,124,219,77,142,360,69,284,368,84,273
2111900C109,106,52,54,107,30,77,65,33,31,69,34,35,108,32,76,109,33,73
2100700A103,121,32,89,121,12,107,94,24,67,91,18,73,142,14,127,143,24,115
2121100E103,701,272,429,693,223,444,627,306,314,619,239,380,795,283,503,786,279,481
2111900C112,172,84,88,185,58,126,137,82,53,139,78,61,209,63,144,205,77,121
2111900C105,108,45,63,113,25,87,87,36,50,87,28,59,116,20,96,114,21,88
2109300G009,758,288,470,758,195,529,568,237,309,564,169,395,887,263,609,898,319,538
2123900G103,684,266,418,677,197,441,611,280,314,604,229,375,761,263,483,788,265,499
2110300E106,338,127,211,337,84,237,274,120,144,270,99,171,380,98,278,387,110,256
2100500B101,792,346,446,792,213,548,693,330,351,687,249,438,898,262,621,871,274,562
2101900C111,139,70,69,139,46,91,110,51,56,107,42,65,158,58,99,146,56,86
2117300A104,557,255,302,564,168,371,436,213,219,432,171,261,610,189,411,611,193,392
2111100L134,561,324,237,556,302,222,507,337,168,498,301,197,644,390,232,644,393,236
2111100N113,297,285,12,298,285,7,229,221,7,227,210,17,307,290,9,309,294,6
2111100S164,699,369,330,709,344,332,572,359,205,567,294,273,827,484,330,831,469,348
2103100D105,330,69,261,327,34,285,216,56,157,210,37,173,380,41,335,382,62,303
2105700B103,301,47,254,309,16,283,230,40,188,222,31,191,336,18,314,353,46,276
2111100N150,12,12,0,12,12,0,13,13,0,13,13,0,19,19,0,19,19,0
2111700C104,824,389,435,828,385,371,537,350,175,536,320,216,971,523,421,1025,560,416
2111100L164,311,222,89,312,196,93,251,205,43,239,182,57,338,250,81,340,263,67
2111900A101,322,112,210,336,64,255,159,81,73,159,75,84,426,102,318,423,120,290
2111900B107,293,116,177,306,63,237,220,106,102,217,102,115,317,72,241,312,87,219
2111100V111,874,349,525,876,319,513,714,356,338,707,284,423,1002,418,566,1003,418,561
2111100N112,387,376,11,391,378,9,277,267,5,271,257,14,372,357,9,370,362,5
2111100A131,748,367,381,755,304,418,559,321,236,556,263,293,835,385,440,831,406,403
2111100A130,420,169,251,424,99,312,295,133,155,291,109,182,446,99,338,452,119,299
2111100Q115,848,450,398,852,370,432,686,416,256,673,356,317,928,453,451,931,483,413
2114500A114,624,191,433,623,139,456,449,165,277,448,150,298,602,156,436,615,176,418
2107100A102,75,26,49,78,10,65,48,22,25,49,25,24,76,9,66,76,15,59
2107100A113,555,213,342,576,99,453,393,171,209,394,168,226,542,89,442,543,121,401
2110300E101,86,40,46,84,23,60,58,25,33,57,21,36,80,22,58,77,29,46
2102500B102,253,105,148,264,51,203,172,85,86,169,65,104,275,44,225,276,67,201
2106700C115,327,246,81,330,240,63,250,218,32,247,207,40,327,265,57,320,251,66
2106700A163,402,310,92,408,289,93,240,199,37,241,190,51,464,362,95,449,345,93
2101500A120,1362,289,1073,1365,285,1019,996,328,639,973,236,737,1457,366,1070,1420,391,976
2106700B219,475,230,245,471,176,258,393,231,157,390,188,202,524,247,264,537,242,272
2111700C130,945,286,659,939,290,593,768,331,423,749,261,488,1066,386,658,1063,403,616
2106700B172,367,199,168,368,170,178,304,184,113,298,157,141,392,220,168,382,205,171
2106700B105,450,285,165,449,231,190,373,247,124,367,213,154,505,299,196,503,327,166
2106700B188,542,297,245,538,232,288,452,222,229,448,192,256,563,294,263,564,309,246
2106700C177,584,359,225,582,289,238,432,331,96,428,296,132,586,354,214,590,363,200
2101500B132,1308,343,965,1314,380,840,993,471,508,983,360,623,1540,536,970,1554,511,965
2101500C110,1086,378,708,1097,336,704,597,270,318,591,237,354,1326,480,825,1338,571,718
2115500H101,596,331,265,612,207,381,416,221,186,410,196,214,594,185,403,576,225,318
2105900A122,240,138,102,246,119,116,172,105,60,171,92,79,291,155,132,267,144,114
2102100B102,498,182,316,504,121,361,385,165,213,381,130,251,571,154,405,581,171,388
2101500A114,1421,337,1084,1414,315,1012,1159,479,657,1143,361,782,1656,447,1176,1674,504,1090
2111500C103,500,146,354,530,46,465,345,112,223,340,91,249,548,52,491,544,59,454
2110700B011,418,131,287,419,83,315,275,97,169,272,82,190,445,106,328,474,126,304
2105900H112,765,245,520,774,185,555,571,234,325,560,185,375,830,226,593,819,240,545
2120900A106,912,362,550,918,268,597,754,329,410,741,264,477,1077,365,691,1080,373,663
2118500C106,517,184,333,520,154,323,343,187,144,340,137,203,597,220,361,613,235,349
2115700B107,762,281,481,766,182,562,567,220,332,567,199,368,811,199,605,792,217,556
2109900A101,178,96,82,182,74,106,124,62,52,124,57,67,196,74,121,176,74,98
2122900A103,128,37,91,130,29,101,100,33,65,99,29,70,147,34,113,141,30,111
2122900F101,404,172,232,393,87,284,331,133,187,326,128,198,443,105,328,471,145,292
2105700B102,204,34,170,225,25,192,143,38,104,142,32,110,235,27,205,218,32,177
2120900C118,793,369,424,802,269,474,629,337,275,625,290,335,1049,407,611,1052,423,568
2115300B104,293,128,165,310,85,219,196,104,88,192,91,101,305,77,227,304,81,216
2111900A108,180,70,110,188,33,147,132,58,71,126,55,71,187,41,143,186,54,127
2111100I126,645,277,368,648,177,439,442,221,212,437,167,270,704,204,482,707,226,445
2111100F163,686,307,379,689,298,353,588,284,301,577,232,345,711,330,376,714,310,394
2111100G107,603,453,150,603,453,108,489,420,67,482,388,94,611,508,93,618,502,104
2111100V121,957,425,532,948,426,492,759,393,356,757,332,425,1051,506,530,1055,493,537
2111100K148,507,305,202,500,253,229,389,262,122,390,229,161,512,284,217,510,294,194
2123100D110,334,133,201,344,93,241,264,115,145,263,85,178,383,107,270,384,101,250
2122700C106,270,138,132,270,114,135,141,106,30,142,102,40,310,153,148,323,169,134
2113300A105,115,37,78,127,14,111,81,36,45,81,39,42,129,16,112,121,26,95
2122700E111,372,213,159,372,207,145,248,185,58,246,157,89,446,278,159,445,261,161
2122700C101,423,181,242,417,157,234,315,190,121,310,149,161,442,194,238,456,205,226
2103700C101,566,254,312,570,234,285,405,254,139,398,208,190,680,322,338,719,366,312
2119300C103,280,111,169,288,63,220,194,82,109,191,71,120,272,66,204,267,75,185
2103700A418,970,371,599,971,377,515,766,441,317,757,344,413,1101,493,579,1132,506,569
2111100G119,485,307,178,487,312,140,460,340,116,455,319,136,529,386,136,534,380,153
2120500B106,1085,487,598,1092,332,727,988,487,485,986,410,576,1362,432,912,1368,467,860
2100300E101,292,59,233,297,45,248,168,41,121,165,37,128,337,53,282,326,57,262
2111100M159,160,121,39,160,124,27,149,133,16,149,121,28,235,188,38,232,196,33
2111100S167,628,259,369,615,277,315,531,270,259,526,218,308,712,360,339,722,330,387
2111100E181,805,409,396,803,416,345,708,452,245,706,400,306,903,514,376,907,520,374
2103700A601,370,147,223,366,143,203,232,126,99,230,106,124,373,165,201,377,177,186
2111100O143,18,10,8,18,5,13,19,15,4,19,11,8,20,9,10,19,8,9
2111100G143,889,663,226,889,661,168,799,675,113,790,634,156,918,756,147,919,738,163
2111100G160,427,197,230,420,165,228,371,213,149,365,171,194,461,232,220,464,231,219
2111100S140,789,310,479,778,324,418,666,357,298,654,280,374,856,418,428,867,398,454
2106700B209,551,257,294,542,213,288,505,287,214,502,245,257,626,309,303,645,298,332
2106700C207,598,401,197,593,329,214,483,357,119,481,328,153,662,434,212,657,418,215
2106700A114,388,258,130,395,226,129,236,182,50,235,170,65,414,275,127,420,279,127
2106700C186,533,337,196,534,292,190,424,312,99,420,292,128,645,407,217,655,401,228
2121700C101,202,54,148,204,24,176,151,33,115,147,24,123,229,28,200,225,46,177
2112500B106,545,126,419,555,69,469,394,93,295,384,58,326,611,88,515,625,99,494
2107300A107,474,363,111,470,324,111,431,347,78,423,331,92,516,381,121,502,343,133
2101500C134,1344,371,973,1347,392,874,936,443,473,918,332,586,1552,538,983,1557,537,947
2107300E110,478,296,182,483,236,224,409,293,100,397,250,147,499,262,229,485,263,205
2110700G047,291,128,163,292,102,177,203,111,86,201,96,105,340,138,194,328,128,182
2110700F039,339,116,223,349,69,271,287,117,163,281,104,177,382,90,287,370,112,240
2108900C101,500,215,285,494,171,308,431,199,230,426,181,245,559,202,350,569,172,371
2111500B106,291,101,190,312,40,264,201,63,134,197,54,143,321,52,266,317,64,242
2102700E103,385,134,251,399,85,306,324,118,198,321,88,233,450,98,348,439,110,309
2118500D104,590,160,430,586,137,415,446,145,293,442,106,336,653,190,450,658,197,437
2102900C106,588,237,351,602,146,418,408,176,214,398,145,253,684,184,485,677,221,423
2120900E120,280,146,134,278,96,170,185,105,80,183,91,92,276,108,163,271,125,134
2111100G124,925,547,378,920,514,352,816,582,223,799,481,318,1015,666,335,1017,652,342
2111100S165,603,258,345,599,270,310,516,285,231,511,238,273,740,413,319,743,389,350
2111100B175,849,366,483,852,313,512,797,396,395,791,330,461,1111,467,629,1120,462,623
2114700F105,244,38,206,254,17,228,217,57,151,209,32,177,259,17,238,291,26,229
2113300A104,112,42,70,127,22,99,83,50,33,75,44,31,111,22,86,104,25,73
2111100N149,105,103,2,108,107,1,85,83,1,83,76,7,119,117,1,119,118,1
2111100G141,585,422,163,580,418,116,519,436,80,513,387,126,624,507,109,626,493,127
2113300D104,236,85,151,272,40,224,176,70,103,176,65,111,239,41,196,224,53,160
2111100I151,742,376,366,735,309,387,551,364,174,549,321,228,846,451,373,844,469,338
2111100F176,669,299,370,674,270,362,508,286,221,501,242,259,653,316,319,662,318,331
2115100B108,588,211,377,583,133,413,531,204,316,532,173,359,665,176,473,700,208,465
2120500A106,848,422,426,866,290,540,673,385,275,674,329,345,975,343,617,959,369,558
2106700A193,616,295,321,610,256,318,509,268,236,499,223,276,732,379,340,735,363,355
2101500A102,463,92,371,464,94,353,320,104,206,313,63,250,543,131,405,522,136,369
2106700B168,484,297,187,487,269,193,398,273,120,389,239,150,527,340,177,508,308,188
2106700C164,639,362,277,643,275,318,499,305,180,491,263,228,603,309,277,605,320,262
2106700B166,467,250,217,464,227,204,427,237,188,425,198,227,544,311,226,550,274,269
2112500C101,188,63,125,193,38,144,115,46,68,115,33,82,228,52,169,236,53,158
2108100B104,407,104,303,410,87,305,265,88,171,260,81,179,537,113,413,547,128,381
2110100A116,499,270,229,502,212,267,353,221,127,353,199,154,524,242,273,514,252,237
2110100C107,527,277,250,532,196,313,322,182,135,316,162,154,536,202,323,536,230,271
2110100A112,436,167,269,436,139,287,346,153,186,340,123,217,450,157,290,442,154,277
2111500B109,281,111,170,292,40,244,187,84,97,189,69,120,307,53,247,305,63,230
2102900D104,436,143,293,438,91,317,261,124,127,256,99,157,522,121,388,546,141,372
2121100G102,397,180,217,392,148,213,316,172,139,314,145,169,407,172,222,428,170,224
2100500A102,789,297,492,801,163,594,603,268,318,600,210,390,907,204,683,916,239,630
2111100G149,389,257,132,392,252,121,350,275,73,343,239,104,408,295,109,410,290,115
2111100L118,1018,595,423,1009,597,365,925,660,257,920,592,328,1141,766,358,1149,738,386
2111100V106,664,366,298,673,326,293,484,311,156,476,275,201,739,413,307,741,425,280
2111100O105,841,700,141,847,681,154,613,541,67,610,522,88,901,735,158,900,743,140
2111100F179,772,376,396,783,362,371,606,393,205,603,345,258,833,451,363,834,459,345
2111100C135,622,390,232,620,350,241,526,361,158,521,317,204,723,454,258,725,449,259
2111100E145,772,413,359,780,380,346,574,367,201,568,318,250,829,470,338,834,471,334
2117300B108,766,323,443,773,201,544,596,265,323,589,221,368,840,225,603,849,244,575
2119500F107,344,115,229,355,51,296,212,104,105,214,99,115,354,56,296,369,72,284
2109900C104,212,80,132,215,58,152,135,55,75,137,46,91,224,56,165,211,57,150
2111100O130,652,363,289,657,305,332,481,324,149,476,284,192,704,363,330,700,373,300
2111100S129,727,328,399,717,319,366,608,353,246,605,317,288,860,469,378,859,469,371
2111100A140,982,514,468,988,377,556,713,431,254,700,358,342,1052,454,582,1052,498,515
2111100O119,691,582,109,702,568,109,575,510,60,568,479,89,764,647,107,762,650,97
2111100Q132,519,294,225,521,230,264,354,221,125,349,191,158,534,271,255,535,289,228
2111100K116,90,64,26,88,52,33,56,46,9,55,36,19,76,46,30,78,49,20
2111100H117,959,486,473,959,448,452,841,500,328,827,402,425,1037,560,461,1035,539,477
2111700C140,743,220,523,735,246,450,548,253,288,535,203,332,834,325,496,819,308,486
2106700B169,366,201,165,368,149,187,310,170,135,305,149,156,392,178,207,389,180,196
2106700C211,408,265,143,414,213,178,297,203,88,295,182,113,417,237,172,402,248,146
2106700C159,353,236,117,355,183,145,281,188,87,274,169,105,361,199,157,360,204,143
2106700B108,417,266,151,414,211,171,351,248,99,341,213,128,466,293,160,463,295,154
2101500A122,729,176,553,732,154,525,505,201,291,498,159,339,835,215,601,860,260,549
2106700B111,434,330,104,439,304,115,309,224,79,306,207,99,531,398,124,503,379,114
2117900D104,785,268,517,782,194,551,639,256,367,636,212,424,937,234,688,968,260,668
2107300C105,339,203,136,335,162,157,309,196,106,304,168,136,363,189,168,366,189,160
2111300A101,330,168,162,333,100,209,236,125,103,234,101,133,347,124,213,346,139,187
2121100G104,488,296,192,499,257,206,312,213,92,306,186,120,542,307,220,534,287,202
2117300A101,321,169,152,324,110,194,238,130,103,236,105,131,321,114,200,319,119,183
2111100M172,148,135,13,149,127,13,100,92,7,100,86,14,172,153,16,172,155,13
2118500C103,792,318,474,784,242,484,642,322,310,630,228,402,835,318,497,861,371,456
2111900C102,295,110,185,314,60,251,237,92,141,234,79,155,362,72,288,356,82,265
2111100F164,777,270,507,779,259,480,663,296,359,663,230,433,822,326,485,823,306,507
2104300A102,293,139,154,302,69,222,199,83,114,196,77,119,300,71,226,277,90,185
2103700C203,634,298,336,628,278,298,504,312,181,493,264,229,728,369,340,774,413,324
2106700B119,321,213,108,325,194,108,264,190,73,260,165,95,387,269,109,376,244,120
2106700C188,379,238,141,373,181,172,296,207,81,296,191,105,387,213,168,394,246,138
2106700B113,612,470,142,608,416,135,544,452,82,538,418,120,679,520,139,674,524,132
2106700C210,566,248,318,558,194,326,490,241,244,476,181,295,631,275,344,655,278,360
2108100C101,364,87,277,365,80,263,233,96,131,231,74,157,429,95,325,443,98,318
2110100B108,418,174,244,420,134,266,317,175,138,314,146,168,440,156,276,438,164,258
2111500C109,283,71,212,292,29,259,198,73,119,198,57,141,285,45,236,285,51,223
2120900E128,310,145,165,309,106,189,255,140,112,253,110,143,372,146,222,362,151,202
2118500F104,619,226,393,618,169,414,490,210,270,478,170,308,671,225,433,674,269,384
2114700F103,241,70,171,247,30,210,221,70,145,213,44,169,276,33,240,280,51,208
2122700F116,2,0,2,2,0,2,6,4,2,6,4,2,3,0,3,3,0,3
2111100K135,19,14,5,19,15,3,15,12,3,15,11,4,24,21,3,25,20,5
2111100E154,721,371,350,711,327,347,589,358,223,583,304,279,732,399,325,739,395,330
2119900D113,206,78,128,208,52,146,130,42,85,128,37,91,239,71,163,238,63,154
2111100D113,532,413,119,532,391,118,363,287,70,360,258,102,526,385,128,526,389,117
2122700D106,519,189,330,530,131,378,363,170,185,358,126,232,553,162,382,538,213,307
2103700A411,337,127,210,336,131,171,275,160,111,272,134,138,360,164,184,380,165,190
2111100E175,544,285,259,538,287,209,382,246,130,375,218,157,502,322,174,503,314,177
2111100B156,1036,525,511,1052,430,544,804,495,293,789,396,393,1149,584,544,1150,575,517
2111100D114,750,402,348,736,366,334,617,375,228,614,320,294,792,425,355,796,428,344
2107100C102,306,163,143,312,91,209,222,123,97,221,129,92,300,91,205,300,105,183
2112700D106,178,61,117,185,37,145,125,63,59,130,45,85,228,47,180,223,45,173
2106700C224,681,355,326,686,304,339,724,447,264,713,385,328,1183,626,534,1147,572,548
2111700A136,677,200,477,677,183,447,469,221,238,460,171,289,692,223,454,692,259,409
2106700C193,343,144,199,341,122,205,295,147,146,292,126,166,369,155,208,372,148,217
2106700A145,532,326,206,538,271,232,474,311,157,467,287,180,551,328,211,551,339,198
2106700B195,548,388,160,544,338,159,400,307,89,396,275,121,584,414,154,592,421,153
2106700C174,536,338,198,537,273,217,419,284,115,407,247,160,557,341,198,554,348,180
2107300D107,303,192,111,304,165,109,265,193,66,262,172,90,316,189,115,326,176,128
2110700E036,275,79,196,278,51,218,182,64,114,178,50,128,275,60,212,279,70,193
2109300D003,860,354,506,857,302,526,678,335,337,678,251,427,968,383,571,952,369,547
2121100F104,345,123,222,343,100,228,316,108,205,313,88,225,403,131,267,405,131,258
2100500C102,879,369,510,884,225,615,697,340,333,697,285,412,1056,296,745,1028,312,688
2104700C102,247,185,62,251,188,60,127,93,32,127,89,38,254,195,57,253,198,53
2102900A104,641,229,412,642,155,462,455,176,265,454,131,323,681,180,491,683,196,456
2123700C104,177,108,69,177,72,96,137,87,49,135,71,64,178,73,101,175,73,91
2119500D107,176,59,117,182,22,157,142,49,86,140,48,92,183,25,157,189,37,146
2111100G162,105,47,58,105,43,55,85,41,42,84,38,46,135,62,71,135,63,72
2111100B134,1381,645,736,1391,562,764,1204,700,483,1204,574,630,1865,880,944,1867,908,892
2103700B904,1424,280,1144,1437,257,1113,1054,358,673,1030,262,768,1580,330,1227,1480,375,1065
2111100E176,324,167,157,325,172,128,229,153,71,223,135,88,370,227,137,370,225,133
2111700A112,453,243,210,463,222,210,264,174,85,256,152,104,485,266,210,498,308,177
2111100H124,155,124,31,158,111,34,92,82,8,91,79,12,197,154,37,198,160,30
2111100B153,60,22,38,62,22,39,43,19,24,42,15,27,63,26,36,63,28,34
2111100E163,895,293,602,892,294,565,738,305,426,728,243,485,961,378,576,968,343,614
2119500E108,192,50,142,197,17,179,119,27,85,119,25,94,197,19,178,206,31,173
2101700F102,643,265,378,641,167,440,538,245,288,534,192,342,732,206,513,770,222,522
2106700C213,300,197,103,299,157,124,244,178,64,244,162,82,342,198,136,337,208,118
2106700C180,734,339,395,734,270,414,680,352,325,675,285,390,836,383,438,851,381,449
2111700C142,0,0,0,0,0,0,0,0,0,0,0,0,0,0,0,0,0,0
2106700A132,504,322,182,500,289,175,406,272,123,402,258,144,522,345,168,526,341,174
2106700B103,435,228,207,431,184,222,386,232,148,383,196,187,460,245,207,458,242,208
2111700C115,478,221,257,486,214,228,252,150,91,250,125,125,511,262,234,533,288,222
2106700B186,533,244,289,530,191,304,443,221,214,440,177,263,580,263,307,578,253,315
2106700A190,507,284,223,501,219,232,395,253,132,391,225,166,532,285,231,562,317,223
2106700B156,576,287,289,566,225,311,509,264,239,500,220,280,601,295,299,590,283,300
2101500B131,1171,337,834,1181,340,758,840,389,431,820,299,521,1268,439,800,1281,458,763
2110100E110,330,150,180,331,108,212,254,130,123,250,105,145,344,129,211,343,151,182
2108500F105,255,80,175,265,34,222,200,67,128,203,45,158,287,42,242,288,49,219
2122700D203,0,0,0,0,0,0,0,0,0,0,0,0,0,0,0,0,0,0
2111100M162,263,209,54,265,210,38,234,205,26,232,191,41,284,247,37,285,245,38
2111100D131,456,267,189,451,247,167,368,247,116,359,215,144,463,295,153,466,295,155
2111100G167,354,209,145,351,192,130,263,193,66,256,173,83,364,236,118,367,241,112
2119500C107,161,56,105,182,29,151,110,45,64,110,42,68,199,35,164,181,38,141
2111100H115,412,256,156,413,226,161,350,250,89,341,214,127,409,248,151,410,259,138
2111100L138,460,243,217,455,230,182,376,234,134,371,195,176,476,303,163,481,289,184
2118500G103,1069,438,631,1060,389,574,780,441,317,769,364,405,1132,512,591,1163,513,608
2111100G117,1111,820,291,1105,813,239,924,752,162,910,698,212,1137,909,209,1142,898,229
2122700D113,513,235,278,511,183,296,424,244,168,420,198,222,781,329,436,799,387,377
2111100S132,1060,626,434,1056,611,390,813,570,230,801,506,295,1202,798,380,1201,783,388
2111100B159,1529,686,843,1534,589,867,1373,763,591,1349,612,737,2056,933,1063,2063,956,1032
2111100J144,644,266,378,640,206,416,511,245,258,502,213,289,637,232,395,639,239,384
2106700B128,385,241,144,384,207,164,357,233,120,350,205,145,445,270,174,425,252,171
2111700C111,647,263,384,649,249,348,477,275,188,478,229,249,735,331,386,762,370,359
2106700B184,560,305,255,552,254,265,499,290,206,498,240,258,610,336,262,601,315,271
2101500C117,792,182,610,789,198,553,585,219,356,577,169,408,846,254,581,828,246,555
2111500C105,210,62,148,216,27,183,165,66,89,166,53,113,245,38,200,245,42,196
2109300C005,655,249,406,657,151,457,496,198,288,491,145,346,673,182,472,712,247,418
2122700C109,2,0,2,2,0,2,0,0,0,0,0,0,3,0,3,3,0,3
2122700F106,771,239,532,771,164,562,619,264,340,598,217,381,925,239,671,936,319,584
2122100E102,301,57,244,305,47,246,200,66,133,203,54,149,312,50,257,315,57,241
2111100K118,511,471,40,522,479,34,350,325,20,346,310,36,460,406,43,461,410,37
2111100E185,281,172,109,283,161,94,185,139,40,184,126,58,295,202,84,296,205,79
2111100M164,26,15,11,26,16,8,22,14,8,22,12,10,33,22,7,34,22,11
2111100J153,247,120,127,248,79,159,147,75,70,147,57,90,240,70,165,241,83,145
2119900C101,238,78,160,238,52,175,185,81,97,182,50,132,268,70,193,271,62,190
2119300B112,161,63,98,172,51,117,116,68,48,115,55,60,193,63,129,183,51,127
2109500C103,116,39,77,122,16,103,94,34,56,92,25,67,139,19,118,133,34,96
2106700A157,623,343,280,596,287,269,513,299,200,513,258,255,633,372,250,655,370,271
2106700B112,401,255,146,398,209,162,346,231,109,340,204,136,436,267,159,432,263,158
2112900C101,177,65,112,184,33,143,164,59,103,164,43,121,209,39,165,216,44,153
2102900A113,733,261,472,745,158,565,592,235,345,582,174,408,866,200,657,839,244,569
2111100G116,864,649,215,865,651,168,770,641,122,763,590,173,899,730,158,907,718,177
2111100H152,121,82,39,123,77,39,98,87,11,97,69,28,128,96,32,128,94,28
2103700A406,156,70,86,154,72,75,149,98,49,147,90,57,221,116,101,222,118,99
2111100N109,507,494,13,501,486,7,365,353,11,357,332,25,521,492,21,522,496,18
2111100L152,292,166,126,290,160,107,232,162,68,228,132,96,332,203,124,333,199,129
2103700C310,472,226,246,472,216,218,347,219,118,345,196,149,590,308,267,621,336,255
2111100A111,752,380,372,751,282,422,556,351,190,551,301,250,807,386,407,806,413,356
2111100Q104,263,188,75,276,176,88,149,107,39,147,101,46,360,251,103,360,252,93
2111100E143,554,318,236,549,308,184,402,291,104,401,251,150,566,377,176,569,386,171
2111100H147,561,279,282,554,212,306,404,242,154,403,203,200,562,253,294,559,272,255
2110300A101,546,262,284,560,179,352,403,196,195,393,149,244,659,217,431,631,237,359
2106700C201,337,157,180,331,123,194,291,160,126,291,143,148,382,159,218,392,170,212
2106700A195,424,241,183,424,209,180,379,245,122,374,225,149,486,286,188,492,284,194
2106700C235,331,185,146,329,149,157,240,166,67,239,146,93,349,177,162,360,184,158
2102900D110,983,332,651,991,230,738,916,392,502,903,275,628,1462,363,1087,1416,387,998
2111100N111,313,302,11,315,308,2,261,250,9,258,234,24,325,314,4,323,317,4
2111100O123,444,329,115,450,299,136,311,241,68,309,219,90,447,304,138,447,310,118
2111900D107,215,107,108,233,43,185,160,88,72,160,78,82,244,45,197,241,55,180
2111100G169,312,187,125,307,191,70,264,189,73,256,170,86,306,202,99,313,197,110
2111100H162,499,263,236,499,210,243,374,234,125,368,200,168,551,283,253,551,296,234
2111100L149,28,27,1,28,27,1,19,19,0,17,17,0,22,22,0,22,21,0
2106700B208,460,201,259,454,156,267,476,245,228,465,198,267,647,279,357,671,281,374
2106700B218,547,277,270,545,211,292,481,269,205,480,235,245,617,299,301,630,314,298
2106700B197,415,277,138,410,231,154,291,217,69,286,200,86,425,268,148,429,281,134
2106700B174,331,287,44,336,266,51,190,164,23,190,155,35,339,289,44,321,277,37
2102100F105,371,174,197,371,137,197,319,177,135,319,142,177,412,173,220,430,162,240
2120900A110,523,207,316,528,136,360,423,156,260,416,113,303,602,181,408,616,209,373
2119500D109,127,52,75,141,20,119,93,47,41,89,37,52,120,19,100,110,28,78
2116300C103,633,245,388,634,135,476,478,188,275,472,150,322,816,182,618,819,228,552
2111100G151,430,251,179,430,253,147,341,254,84,338,222,116,435,289,131,436,289,135
2111100M141,364,285,79,366,272,76,308,265,33,302,251,51,399,335,58,403,339,57
2111100M145,39,38,1,39,34,3,30,30,0,30,29,1,35,33,2,36,34,2
2111100K125,206,159,47,205,142,56,133,107,22,131,95,36,190,132,55,190,140,40
2111700A109,426,219,207,430,221,181,253,156,89,240,132,108,498,289,198,514,304,191
2107100C111,247,118,129,254,59,186,164,83,78,164,78,86,244,48,193,245,65,169
2106700B224,715,330,385,713,274,399,612,321,286,606,270,336,803,391,398,815,375,423
2106700B102,624,413,211,621,348,205,520,377,133,508,333,175,670,448,204,670,420,221
2106700A197,495,307,188,489,258,195,442,306,132,441,275,166,529,328,189,535,335,184
2106700A133,403,340,63,404,325,61,370,317,49,369,300,69,483,391,79,485,401,76
2106700C138,576,455,121,578,411,124,552,453,94,544,433,111,679,537,132,650,497,145
2101700E103,566,305,261,574,186,361,440,231,194,436,204,232,635,220,403,613,245,346
2104900E103,398,163,235,405,111,274,310,136,165,309,112,197,447,140,299,443,143,286
2121100E105,142,32,110,142,24,113,114,31,83,114,19,95,165,32,132,165,34,126
2111100J151,12,8,4,12,6,4,10,8,2,10,8,2,18,11,7,18,10,8
2111100H161,1,1,0,1,0,1,1,1,0,1,1,0,2,1,1,2,1,1
2103700C401,722,165,557,718,187,475,563,252,302,559,180,379,759,233,508,755,215,504
2106700B223,543,259,284,543,199,305,481,277,196,479,237,242,678,313,351,678,306,354
2106700B183,420,246,174,413,207,185,370,227,141,365,196,169,489,288,193,475,267,196
2106700B205,700,309,391,693,252,392,627,321,301,618,272,346,800,366,426,819,347,454
2102100B101,236,77,159,236,38,187,167,54,110,165,34,131,247,45,197,264,67,182
2112500E108,417,79,338,420,32,378,312,58,248,314,47,267,481,43,435,484,65,417
2111100S161,582,310,272,583,305,254,467,299,157,459,245,214,613,371,235,617,359,240
2111100C141,436,293,143,441,287,140,274,215,55,269,193,76,407,280,115,408,295,106
2111100C148,34,22,12,34,21,11,21,17,4,19,13,6,31,15,15,31,16,14
2111100J138,186,99,87,187,66,113,144,81,54,144,74,70,239,97,137,237,106,122
2111100Q126,450,197,253,443,149,274,336,156,171,330,129,201,461,160,290,462,179,254
2111300E104,730,262,468,726,173,509,611,204,400,611,166,445,867,272,578,830,285,526
2107300B103,425,244,181,418,171,214,355,217,126,350,172,178,440,199,228,466,226,212
2111100S141,1208,668,540,1204,606,509,935,636,285,928,530,398,1287,781,486,1288,781,474
2103700A415,251,108,143,253,118,104,202,134,65,201,119,82,327,179,135,353,171,157
2106700B213,316,169,147,315,122,176,224,145,74,220,128,92,335,160,168,338,176,151
2106700B226,493,248,245,498,190,263,387,225,154,382,195,187,534,259,262,539,254,265
2106700C153,396,221,175,399,159,215,324,192,126,319,162,157,428,208,211,433,229,190
2106700C200,551,270,281,552,207,306,493,262,219,493,218,275,624,280,331,638,295,326
2106700C212,510,305,205,503,265,201,387,269,111,381,230,151,528,327,186,529,329,173
2120900C112,697,293,404,698,222,426,573,270,291,568,224,344,754,278,455,774,279,449
2104700D107,832,300,532,847,284,528,584,279,295,570,230,340,919,334,565,921,364,511
2112900C103,309,101,208,313,44,260,272,86,179,272,78,194,370,54,311,388,72,294
2103100C103,21,3,18,22,2,18,15,6,9,15,5,10,20,2,17,25,2,17
2111100E179,715,264,451,708,282,390,574,294,274,572,225,347,735,363,361,736,332,392
2106500A104,251,80,171,247,45,193,179,74,100,176,54,122,305,64,238,304,76,222
2111100H150,2,0,2,2,0,2,2,0,2,2,1,1,3,0,3,3,0,3
2111100E184,547,250,297,552,259,251,466,270,189,455,229,226,640,341,288,644,336,299
2111100Q117,776,363,413,782,286,458,644,363,272,635,295,340,834,345,469,830,355,443
2101700C102,204,97,107,207,56,142,180,89,91,177,74,103,216,63,150,215,74,134
2106700A194,473,301,172,475,266,184,393,275,115,387,243,144,533,344,181,517,334,172
2106700C132,511,358,153,514,319,160,357,263,87,356,239,117,485,335,141,478,330,134
2101500B118,487,156,331,490,158,298,414,182,226,408,156,252,616,237,365,630,246,352
2106700B106,512,290,222,517,225,253,369,225,137,366,193,173,524,287,224,528,294,213
2118500G105,377,120,257,376,111,239,343,166,170,345,132,213,613,224,378,612,216,381
2120900G136,753,343,410,756,233,468,601,292,290,600,233,367,814,294,501,819,327,457
2102900C109,779,236,543,787,140,618,607,211,386,604,146,458,908,178,718,914,221,655
2111100S131,859,518,341,852,501,297,626,458,160,617,412,205,843,556,265,845,563,255
2111100K130,462,385,77,467,370,90,386,341,43,382,320,62,475,405,67,475,407,62
2111100B154,759,390,369,769,324,379,511,300,201,505,251,254,785,400,366,792,414,346
2111100I144,81,30,51,81,22,55,64,32,30,65,27,38,89,32,56,86,34,51
2106700B179,684,375,309,683,319,313,589,371,214,583,328,255,735,416,297,723,392,315
2106700C194,536,279,257,535,225,278,465,269,190,469,222,247,605,308,285,602,303,281
2123900H101,571,236,335,568,167,373,484,208,268,481,175,306,627,218,399,635,228,391
2112100B107,316,88,228,331,39,282,226,54,167,225,39,186,362,47,313,354,64,287
2111100D144,387,215,172,390,194,166,335,233,95,337,203,134,443,249,179,444,258,171
2111100A142,224,107,117,221,72,136,162,84,72,161,68,93,221,83,132,224,93,121
2111100M130,293,264,29,301,271,23,190,177,12,188,167,21,304,258,40,305,266,32
2111100B182,545,215,330,539,187,325,444,219,218,436,185,251,547,231,306,555,231,306
2111100C124,822,482,340,825,439,348,708,476,217,700,413,287,949,572,358,958,596,329
2111100H154,163,90,73,165,77,82,113,76,34,110,65,45,201,95,100,199,104,90
2106700C199,404,207,197,402,174,201,340,181,155,329,152,177,435,226,200,433,211,209
2101500B129,1097,251,846,1097,280,728,804,332,454,790,253,537,1193,371,791,1218,351,795
2122700E209,0,0,0,0,0,0,0,0,0,0,0,0,0,0,0,0,0,0
2122700A111,359,107,252,356,105,224,265,112,150,262,93,169,361,128,224,370,120,232
2111100I122,335,163,172,337,121,209,241,142,94,233,107,126,344,134,207,343,153,180
2106700C205,490,320,170,493,267,193,415,285,123,409,258,151,575,349,213,577,352,210
2106700C216,284,162,122,282,137,127,254,142,109,256,124,132,308,183,119,305,176,122
2105900H113,440,170,270,436,110,300,287,127,157,283,101,182,443,128,306,454,159,270
2111100V125,704,270,434,710,269,406,519,274,239,517,226,291,749,333,406,756,319,418
2122700B113,86,54,32,87,53,23,43,36,7,43,33,10,74,52,18,75,49,23
2111100S118,919,455,464,909,428,415,781,503,271,770,406,364,986,577,393,987,578,392
2111100L110,17,12,5,17,12,5,47,37,10,47,33,14,94,66,28,93,64,27
2106700C239,845,452,393,832,363,425,743,472,260,735,388,347,1016,533,467,1011,526,463
2107300B109,198,124,74,198,93,91,165,101,58,165,90,75,214,109,99,218,117,89
2111100N138,38,37,1,38,36,2,40,40,0,40,36,4,51,47,4,50,48,1
2106700C203,591,297,294,587,249,291,476,265,205,476,213,263,650,337,296,664,319,320
2106700B164,387,221,166,386,166,196,296,171,115,289,146,143,378,205,168,379,217,155
2111100M144,293,237,56,288,217,47,304,264,35,298,249,49,371,298,60,375,308,61
2111100A126,782,355,427,799,296,481,624,326,289,614,279,335,837,339,488,841,370,455
2111100N127,57,42,15,60,40,20,47,39,8,45,32,13,72,53,17,73,55,17
2111900C104,34,14,20,40,7,32,33,16,17,32,14,18,40,7,32,40,11,27
2106700C189,430,322,108,420,295,99,253,219,29,251,209,42,386,322,57,386,328,55
2106700B129,408,196,212,407,147,227,349,177,160,339,156,183,425,195,219,443,207,221
2101500B120,773,185,588,779,202,538,528,203,317,524,154,370,845,263,571,819,253,540
2103700A410,573,200,373,572,221,312,455,238,208,447,178,269,629,279,338,628,263,341
2111100O141,0,0,0,0,0,0,0,0,0,0,0,0,0,0,0,0,0,0
2114500B129,54,16,38,53,9,40,27,9,16,27,11,16,45,9,35,48,13,33
2103700A403,802,314,488,807,328,424,600,361,230,586,285,301,889,413,458,892,413,446
2103700A402,923,312,611,928,317,557,785,423,349,763,327,436,1164,456,688,1145,469,637
2106100A102,648,185,463,649,115,517,505,196,303,498,154,344,767,156,596,765,178,544
2111100D110,557,370,187,567,352,187,444,315,126,442,275,167,659,446,200,661,452,189
2111100K145,891,509,382,899,438,431,670,432,231,660,384,276,895,492,390,895,509,366
2111100M175,0,0,0,0,0,0,0,0,0,0,0,0,0,0,0,0,0,0
2111100V114,897,238,659,898,251,614,723,245,473,715,207,508,1071,379,685,1077,346,718
2111100M150,279,196,83,275,186,67,287,221,63,284,208,76,338,250,79,339,255,77
2103700A408,950,332,618,950,346,520,746,422,305,733,322,411,991,421,543,1023,421,546
2111100K139,0,0,0,0,0,0,0,0,0,0,0,0,0,0,0,0,0,0
2106700C208,440,174,266,428,125,277,373,143,226,374,117,257,455,166,282,481,182,289
2106700C190,565,328,237,570,287,241,458,322,128,457,288,169,672,411,243,666,386,256
2102900D113,419,96,323,422,64,329,233,89,131,229,74,155,473,81,381,508,90,388
2111100K138,137,81,56,137,64,70,98,57,38,97,49,48,139,69,65,139,75,59
2105700C103,101,40,61,116,55,59,50,16,32,48,18,30,104,50,53,90,31,53
2106700B216,533,244,289,529,201,290,441,248,187,438,213,225,572,273,289,574,249,311
2106700C171,419,274,145,425,235,165,308,229,73,308,214,94,410,273,127,413,281,119
2106700B225,553,306,247,557,244,272,398,245,150,396,220,176,594,320,260,594,319,254
2122700E204,0,0,0,0,0,0,0,0,0,0,0,0,0,0,0,0,0,0
2122700F118,522,175,347,520,154,351,417,179,232,414,148,266,599,207,387,584,216,352
2111700C134,822,245,577,822,268,508,671,307,357,654,241,413,911,346,549,890,336,525
2106700C197,303,180,123,301,145,131,243,158,82,242,138,104,337,198,131,338,203,123
2111100E159,408,208,200,416,188,205,341,198,138,338,164,174,448,240,201,449,233,207
2122700B115,0,0,0,0,0,0,0,0,0,0,0,0,0,0,0,0,0,0
2111100J154,0,0,0,0,0,0,0,0,0,0,0,0,0,0,0,0,0,0
2111100H153,0,0,0,0,0,0,0,0,0,0,0,0,0,0,0,0,0,0
2111100C139,24,9,15,24,7,16,15,7,8,15,6,9,34,12,20,34,14,19
2106700B215,544,242,302,543,191,313,482,266,210,476,215,261,576,257,308,582,245,321
2111100C149,10,1,9,10,1,9,11,1,9,11,1,10,13,1,11,12,1,10
2106700B181,727,415,312,728,334,342,577,340,231,567,305,262,780,419,349,784,418,354
2101500C129,616,202,414,616,192,382,417,217,180,407,168,239,643,239,390,666,266,366
2110100E111,343,180,163,344,151,172,207,143,63,204,119,85,359,181,171,362,181,165
2110100E109,395,166,229,402,136,251,285,139,144,277,115,162,446,173,267,434,177,245
2111100C144,69,36,33,67,27,38,54,31,23,54,28,26,78,40,38,80,40,39
2111100D145,345,174,171,345,161,169,274,174,96,267,139,128,358,193,161,359,191,159
2111100V128,964,362,602,964,351,546,752,404,338,740,317,423,1114,516,578,1116,506,571
2111100M174,1,0,1,1,1,0,0,0,0,0,0,0,0,0,0,0,0,0
2106700B196,451,286,165,453,224,186,341,241,92,338,222,116,524,323,187,528,329,179
2109300H003,62,24,38,63,16,46,46,15,27,45,12,33,92,27,64,86,32,53
2122700A116,1,0,1,1,0,1,1,1,0,1,1,0,2,0,2,2,0,2
2120500A101,284,194,90,286,179,88,236,183,46,230,173,57,309,215,85,310,201,92
2111100V122,0,0,0,0,0,0,0,0,0,0,0,0,0,0,0,0,0,0
2106700B189,466,322,144,476,272,168,347,239,103,343,222,121,527,341,172,509,343,151
2104900A103,706,334,372,706,220,443,589,299,277,580,246,334,747,267,463,759,282,435
2101900A113,446,195,251,446,122,300,338,189,141,339,163,176,486,148,325,515,170,311
2122700D116,2,2,0,2,1,0,3,3,0,3,3,0,1,1,0,4,3,0
2111100B184,21,6,15,21,1,20,17,6,11,17,3,14,21,1,20,21,1,20
2106700C144,492,394,98,496,362,104,325,266,52,327,261,66,578,459,106,563,447,99
2106700B221,471,213,258,465,180,262,379,210,166,375,173,202,477,227,241,479,216,255
2110700A004,147,25,122,149,13,133,107,22,83,104,18,86,183,19,162,187,28,150
2111100G166,144,87,57,144,84,45,142,101,37,141,86,55,165,106,55,164,110,47
2111100H132,223,183,40,226,182,29,180,163,14,177,156,21,239,205,32,241,209,30
2103700A802,570,151,419,568,136,396,417,189,219,408,137,271,699,195,489,698,227,437
2111100B185,324,164,160,325,133,178,243,138,97,239,116,123,369,181,181,372,189,171
2105900H114,393,134,259,386,100,270,301,119,176,298,101,197,393,116,273,393,124,258
2109300F008,69,16,53,69,9,59,46,11,35,46,8,38,81,13,68,79,18,61
2111100O138,302,174,128,308,137,166,210,141,65,210,118,92,306,142,157,305,148,136
2122700E208,0,0,0,0,0,0,0,0,0,0,0,0,0,0,0,0,0,0
2111100H133,84,69,15,85,62,15,81,71,7,82,69,13,98,78,18,96,77,14
2115100C101,7,1,6,7,0,6,22,11,11,22,8,14,7,0,6,8,1,6
2106700B206,549,275,274,545,219,287,454,265,182,448,219,229,576,278,288,580,279,285
2109700D103,142,76,66,141,54,79,103,52,50,100,49,51,155,58,95,155,55,91
2111100C150,9,4,5,9,3,6,10,4,5,10,3,7,12,7,5,12,7,5
2111100H157,18,13,5,18,14,3,33,28,4,33,26,7,25,21,4,26,22,4
2111700B139,2,2,0,2,2,0,3,2,1,3,2,1,4,4,0,4,4,0
2106700A140,402,261,141,403,220,159,329,226,98,321,200,121,428,259,160,422,260,152
2111100H151,1,1,0,1,1,0,0,0,0,0,0,0,2,0,2,2,0,2
2106700A115,561,526,35,571,537,24,407,392,10,397,358,39,588,556,27,568,528,35
2106700A151,389,250,139,390,192,164,332,241,86,325,215,110,426,253,162,423,262,149
2111100L153,75,40,35,75,40,30,59,37,21,59,33,26,76,48,27,75,47,27
2107100D110,190,90,100,201,50,141,127,90,35,127,93,34,166,44,116,166,58,102
2111100Q138,493,327,166,496,283,172,287,216,65,285,195,90,516,339,156,518,348,141
2101900A116,407,207,200,408,144,243,263,157,99,261,138,123,412,160,242,418,166,227
2111100V130,271,92,179,270,97,160,232,104,125,230,85,145,323,124,193,323,116,200
2111100V109,92,22,70,92,25,63,131,54,73,131,43,88,197,62,133,198,61,135
2106700B198,619,269,350,611,228,345,489,248,234,485,205,280,614,275,328,617,259,345
2101500A112,732,195,537,742,172,520,487,184,289,483,143,340,770,216,538,775,259,480
2111100G104,464,346,118,467,343,85,374,319,50,366,284,82,463,363,86,470,370,87
2106700C182,513,273,240,504,207,252,420,248,163,415,218,197,515,259,241,530,268,245
2122700A202,0,0,0,0,0,0,0,0,0,0,0,0,0,0,0,0,0,0
2122700D204,0,0,0,0,0,0,0,0,0,0,0,0,0,0,0,0,0,0
2122700E205,0,0,0,0,0,0,0,0,0,0,0,0,0,0,0,0,0,0
2111100K150,0,0,0,0,0,0,0,0,0,0,0,0,0,0,0,0,0,0
2111100M167,0,0,0,0,0,0,0,0,0,0,0,0,0,0,0,0,0,0
2106700B110,451,274,177,452,230,177,380,251,123,380,224,156,464,274,175,485,287,176
2111100J146,0,0,0,0,0,0,0,0,0,0,0,0,0,0,0,0,0,0
2103700A409,694,269,425,689,276,359,565,333,226,551,262,289,783,362,404,804,368,404
2111100H159,200,94,106,196,70,113,160,99,61,160,79,81,231,110,114,227,116,103
2103700A603,307,108,199,310,99,183,214,108,104,208,89,119,325,122,194,334,140,178
2122700A118,4,2,2,5,2,3,7,3,4,7,3,4,5,2,3,4,2,2
2105900A150,0,0,0,0,0,0,0,0,0,0,0,0,0,0,0,0,0,0
2111100H156,0,0,0,0,0,0,0,0,0,0,0,0,0,0,0,0,0,0
2111100B181,119,50,69,121,48,72,107,64,43,105,54,51,136,62,72,138,67,71
2106700C220,316,185,131,316,166,132,251,169,82,251,152,99,379,225,147,370,214,148
2111100D117,687,367,320,690,333,332,583,381,199,581,336,245,790,450,330,793,446,325
2122700A204,0,0,0,0,0,0,0,0,0,0,0,0,0,0,0,0,0,0
2111100M168,139,111,28,140,104,16,125,122,3,122,111,11,163,147,12,166,147,12
2111700X002,0,0,0,0,0,0,0,0,0,0,0,0,0,0,0,0,0,0
2122700F117,69,35,34,71,30,37,45,22,23,43,18,25,82,40,41,78,43,34
2106700C179,432,267,165,426,236,152,312,220,92,310,197,113,443,292,138,438,272,149
2122700D206,0,0,0,0,0,0,0,0,0,0,0,0,0,0,0,0,0,0
2122700B114,0,0,0,0,0,0,0,0,0,0,0,0,0,0,0,0,0,0
2122700F119,0,0,0,0,0,0,0,0,0,0,0,0,0,0,0,0,0,0
2101900A122,9,5,4,10,1,9,7,5,2,7,3,4,7,1,6,6,3,3
2111100G168,86,29,57,80,31,47,79,44,35,74,36,38,92,47,42,94,44,48
2122700A205,0,0,0,0,0,0,0,0,0,0,0,0,0,0,0,0,0,0
2111100M160,141,107,34,139,100,28,114,102,8,112,96,16,144,117,24,144,119,22
2111100H158,0,0,0,0,0,0,0,0,0,0,0,0,0,0,0,0,0,0
2111100J142,6,3,3,6,2,4,4,2,2,4,2,2,3,3,0,3,3,0
2122700B204,0,0,0,0,0,0,0,0,0,0,0,0,0,0,0,0,0,0
2122700D115,0,0,0,0,0,0,0,0,0,0,0,0,0,0,0,0,0,0
2122700D201,0,0,0,0,0,0,0,0,0,0,0,0,0,0,0,0,0,0
2122700F201,0,0,0,0,0,0,0,0,0,0,0,0,0,0,0,0,0,0
2111700B142,14,6,8,15,3,12,0,0,0,0,0,0,18,4,14,17,9,8
2122700E113,0,0,0,0,0,0,0,0,0,0,0,0,0,0,0,0,0,0
2120900G138,0,0,0,0,0,0,0,0,0,0,0,0,0,0,0,0,0,0
2122700B202,0,0,0,0,0,0,0,0,0,0,0,0,0,0,0,0,0,0
2122700D207,0,0,0,0,0,0,0,0,0,0,0,0,0,0,0,0,0,0
2111100L163,273,253,20,276,253,19,181,171,9,176,154,22,219,202,15,220,204,16
2111100I155,36,15,21,36,12,21,26,13,13,26,11,15,44,9,35,42,11,30
2111100C146,0,0,0,0,0,0,0,0,0,0,0,0,1,1,0,1,1,0
2111100K151,0,0,0,0,0,0,0,0,0,0,0,0,0,0,0,0,0,0
2122700A201,0,0,0,0,0,0,0,0,0,0,0,0,0,0,0,0,0,0
2111100C147,1,1,0,1,1,0,3,3,0,2,2,0,4,4,0,4,4,0
2111100C151,24,14,10,23,11,11,15,13,2,15,10,5,21,15,6,20,15,4
2111100V123,2,0,2,2,0,2,2,0,2,2,0,2,2,0,2,2,0,2
2111100M165,0,0,0,0,0,0,0,0,0,0,0,0,0,0,0,0,0,0
2111700C143,0,0,0,0,0,0,0,0,0,0,0,0,0,0,0,0,0,0
2111100L162,8,8,0,8,8,0,8,8,0,8,8,0,15,15,0,15,15,0
2111100L155,10,7,3,12,8,2,7,4,3,7,4,3,11,4,7,11,4,7
2122700B205,0,0,0,0,0,0,0,0,0,0,0,0,0,0,0,0,0,0
2122700E203,0,0,0,0,0,0,0,0,0,0,0,0,0,0,0,0,0,0
2122700A203,0,0,0,0,0,0,0,0,0,0,0,0,0,0,0,0,0,0
2122700A117,5,1,4,5,0,5,6,2,4,6,2,4,5,0,5,5,1,4
2122700B203,0,0,0,0,0,0,0,0,0,0,0,0,0,0,0,0,0,0
2101900C110,3,1,2,3,0,3,2,0,2,1,0,1,5,0,5,5,2,3
2111100K143,0,0,0,0,0,0,0,0,0,0,0,0,0,0,0,0,0,0
