GEOID20,Tot_2019_gov_roff,D_2019_gov_roff,R_2019_gov_roff,Tot_2019_ag,D_2019_ag,R_2019_ag,Tot_2019_ltg,D_2019_ltg,R_2019_ltg,Tot_2019_gov,D_2019_gov,R_2019_gov,Tot_2016_pres,D_2016_pres,R_2016_pres,Tot_2016_sen,D_2016_sen,R_2016_sen,Tot_2016_sen_roff,D_2016_sen_roff,R_2016_sen_roff,Tot_2020_sen,D_2020_sen,R_2020_sen,Tot_2020_pres,D_2020_pres,R_2020_pres
220850006-2,557,89,468,539,47,492,532,66,466,553,92,455,644,63,571,592,88,492,253,23,230,720,57,650,745,54,683
220850006-4,55,13,42,49,11,38,53,16,37,56,12,40,86,7,77,76,27,46,16,5,11,89,11,77,89,6,83
220850005-8,137,48,89,137,37,100,138,39,99,142,48,93,212,65,142,198,60,135,99,18,81,177,49,126,180,51,126
220750001-1,335,174,161,283,98,185,271,138,133,316,188,123,405,170,227,410,165,235,234,99,135,539,142,375,558,180,373
220750008-3,106,60,46,94,25,69,100,22,78,102,41,56,211,91,114,190,75,110,85,31,54,170,42,119,178,56,116
220750008-1,502,220,282,487,106,381,506,103,403,493,223,265,739,226,484,737,206,518,421,91,330,668,168,479,691,199,480
220010007-4,487,45,442,509,19,490,509,20,489,515,41,474,723,31,674,702,35,663,353,28,325,753,26,701,764,33,717
220010006-1,453,341,112,307,182,125,318,195,123,342,238,102,700,496,189,661,332,302,248,164,84,478,286,141,531,378,144
220010006-5,202,60,142,193,29,164,195,24,171,193,47,146,267,69,196,253,37,214,166,34,132,217,34,178,231,48,182
220010006-3,273,146,127,319,134,185,313,124,189,323,157,166,412,195,203,384,135,236,226,112,114,324,119,185,350,165,178
220750006-2,420,160,260,382,76,306,388,67,321,386,136,240,553,97,438,526,102,418,279,44,235,583,122,447,586,133,449
22019000405,897,305,592,922,131,791,924,129,795,908,295,609,1540,231,1211,1478,201,1235,560,93,467,1229,234,945,1230,257,926
220850003-6,141,12,129,165,18,147,167,18,149,168,24,142,200,14,181,199,19,180,108,11,97,171,10,157,177,13,162
220850004-1,353,284,69,333,226,107,347,250,97,358,273,74,586,453,120,539,381,148,199,143,56,537,375,131,554,417,127
22019000407,470,145,325,500,78,422,507,70,437,511,162,340,794,99,668,758,94,652,258,52,206,606,87,497,616,111,493
22019000408,514,178,336,506,90,416,508,71,437,513,157,353,813,105,653,804,111,670,272,58,214,722,108,582,735,125,588
22019000601,231,67,164,246,29,217,245,29,216,244,65,178,394,40,343,376,47,325,141,25,116,615,54,546,625,60,554
22019000262,333,88,245,280,32,248,278,35,243,285,78,207,422,32,370,399,29,362,164,37,127,685,72,593,702,93,603
220750003-1,1026,327,699,1032,95,937,1043,99,944,1005,305,688,1430,189,1186,1382,164,1179,1057,102,955,1249,91,1112,1271,136,1119
220750002-2,543,172,371,567,58,509,569,59,510,544,172,366,690,86,583,682,66,601,462,46,416,710,92,592,714,118,583
220750002-1,537,171,366,556,56,500,561,57,504,538,170,362,685,84,577,676,64,595,455,45,410,709,93,585,713,120,576
220750006-1,113,91,22,85,41,44,86,38,48,89,63,23,248,147,87,228,131,87,78,51,27,287,141,136,280,150,125
220750004-2,412,118,294,439,47,392,448,44,404,428,125,293,708,104,580,677,97,557,376,50,326,679,67,587,694,81,599
220750004-1,234,67,167,246,23,223,254,24,230,241,72,164,394,56,329,362,46,305,210,25,185,375,32,331,388,45,336
220750008-2,199,91,108,196,44,152,199,46,153,194,81,108,375,71,289,349,71,265,200,53,147,366,81,265,398,79,309
22085002-6A,350,46,304,354,15,339,353,19,334,358,41,316,358,17,331,346,34,308,195,14,181,382,17,364,390,22,368
22103000502,808,229,579,730,81,649,728,74,654,737,202,524,1115,127,945,1103,129,954,487,45,442,1178,138,999,1190,168,1006
22103000S25,246,187,59,221,139,82,217,141,76,237,176,58,368,247,116,347,212,126,171,107,64,446,277,135,488,323,150
22103000906,390,199,191,327,116,211,325,108,217,338,168,167,571,202,353,536,180,346,233,89,144,685,193,465,710,247,453
22055000034,836,257,579,731,136,595,734,122,612,737,207,528,1196,250,901,1148,191,933,421,87,334,1348,331,956,1388,394,965
22055000008,744,388,356,589,237,352,583,230,353,605,296,307,985,463,505,938,319,595,391,161,230,1093,433,619,1155,526,614
22055000025,287,79,208,230,39,191,229,25,204,231,57,173,431,71,340,409,64,326,144,34,110,518,111,380,527,120,395
22055000092,804,331,473,693,185,508,691,152,539,690,262,426,1106,339,715,1070,238,815,469,126,343,1163,377,730,1175,447,707
22055000109,942,215,727,812,95,717,815,85,730,820,165,649,1047,126,887,1016,119,874,425,58,367,1274,176,1071,1273,196,1053
22055000081,325,115,210,303,61,242,301,50,251,314,95,214,443,72,326,442,61,368,223,41,182,448,86,350,441,102,321
22103000114,700,224,476,550,72,478,570,68,502,573,176,396,952,131,779,935,117,801,409,52,357,949,101,815,978,146,810
22103000C05,274,119,155,266,57,209,272,58,214,281,109,171,453,111,308,445,91,346,222,56,166,324,51,259,325,76,239
22103000403,696,353,343,584,188,396,587,160,427,597,307,287,987,236,687,945,213,687,391,115,276,893,232,616,931,292,611
22103000C01,453,160,293,402,63,339,407,61,346,405,132,270,545,88,425,541,49,478,306,41,265,502,93,392,499,98,385
22103000C11,459,199,260,428,75,353,423,68,355,433,169,263,441,68,346,423,66,347,195,22,173,786,192,560,815,236,553
22103000118,680,244,436,604,93,511,608,88,520,613,192,411,735,96,598,735,91,632,294,39,255,779,103,658,771,124,625
22103000205,855,224,631,772,71,701,782,73,709,779,190,582,1251,115,1102,1228,128,1080,465,34,431,1520,156,1324,1536,180,1341
22103000914,378,304,74,297,182,115,288,162,126,326,230,92,586,377,196,522,308,198,191,119,72,838,526,277,923,637,271
22103000S06,595,274,321,483,151,332,489,140,349,502,222,271,923,296,598,885,289,565,378,107,271,1037,335,649,1107,429,659
22103000504,526,139,387,483,56,427,486,39,447,485,118,367,652,80,547,640,64,574,339,32,307,797,89,693,795,90,683
2201100012B,453,83,370,414,21,393,415,32,383,419,58,358,589,31,547,585,45,528,199,29,170,632,28,590,645,36,605
22055000039,444,263,181,349,172,177,343,158,185,355,207,143,861,338,447,846,302,511,270,135,135,1039,523,426,1073,612,413
22055000038,619,232,387,506,134,372,506,121,385,519,184,331,874,251,569,867,189,657,440,117,323,957,323,601,959,347,584
22103000505,761,200,561,693,86,607,695,74,621,685,170,505,989,130,819,991,125,851,530,66,464,1130,122,976,1160,157,986
22103000A02,778,389,389,713,181,532,724,159,565,744,351,383,1125,277,782,1080,252,801,436,102,334,1097,269,765,1134,354,762
22103000C09,699,284,415,557,122,435,567,110,457,583,232,347,901,177,674,888,169,691,455,93,362,793,184,576,826,219,581
22103000501,344,132,212,285,44,241,281,34,247,289,95,187,436,85,345,410,83,315,170,30,140,575,105,453,585,98,483
22019000702,235,96,139,243,39,204,241,46,195,250,91,153,440,94,334,413,71,337,117,26,91,629,109,498,652,155,480
22019000761,269,70,199,272,32,240,279,30,249,274,77,196,460,38,410,433,42,381,126,13,113,667,79,575,683,78,603
22019000370,751,372,379,669,223,446,669,198,471,671,302,365,1076,371,668,1062,341,702,373,140,233,816,234,555,843,290,533
22019000562,145,36,109,148,20,128,149,19,130,148,36,111,256,17,234,235,34,197,62,10,52,440,73,358,439,54,378
22019000364,784,519,265,747,386,361,731,364,367,761,482,274,1036,550,453,1007,454,524,379,231,148,961,459,458,975,478,459
2201900371N,460,312,148,406,210,196,402,203,199,422,263,154,529,274,231,501,230,253,159,82,77,574,278,246,591,320,254
22019000308,435,427,8,340,308,32,345,308,37,379,368,10,583,556,9,556,459,80,203,189,14,383,320,28,428,403,17
22019000260,626,161,465,616,70,546,618,70,548,611,151,460,861,79,766,832,72,748,291,37,254,1367,118,1221,1368,131,1215
22019000307,221,217,4,205,182,23,195,174,21,214,203,10,349,326,15,331,250,72,109,100,9,204,169,17,235,224,4
22103000415,364,140,224,371,54,317,381,45,336,378,136,239,465,88,348,442,65,371,251,40,211,490,99,384,488,112,357
22103000314,617,241,376,507,111,396,509,107,402,517,198,312,890,154,707,848,152,685,372,70,302,1100,208,845,1128,250,864
22103000S19,212,172,40,190,126,64,194,122,72,203,149,48,378,258,107,340,212,121,131,92,39,434,289,118,484,351,124
22103000902,205,100,105,201,65,136,196,61,135,208,97,104,446,127,298,431,134,283,144,49,95,463,140,297,503,188,307
22103000305,500,261,239,399,143,256,399,134,265,410,222,185,674,257,393,645,227,399,296,91,205,636,227,379,649,255,371
22103000818,332,286,46,295,226,69,292,217,75,305,250,51,588,441,123,552,386,144,193,158,35,560,424,115,594,471,112
22011000001,225,26,199,204,5,199,205,3,202,205,16,186,335,14,317,318,28,282,114,22,92,396,8,377,406,14,390
22011000017,303,34,269,305,25,280,307,31,276,313,59,251,376,35,338,358,31,323,145,14,131,379,28,347,377,20,351
22103000106,885,274,611,682,107,575,704,73,631,704,240,460,516,68,425,511,59,446,173,21,152,1316,186,1087,1344,233,1072
22055000100,638,132,506,554,79,475,557,69,488,561,121,439,824,102,695,810,88,704,387,48,339,952,143,784,962,151,795
22055000094,877,321,556,740,181,559,737,162,575,750,247,496,1221,293,853,1188,227,936,542,133,409,1294,387,866,1312,411,863
22055000011,812,496,316,649,324,325,643,305,338,674,394,274,1106,571,483,1067,493,549,430,214,216,997,518,437,1043,580,437
22055000006,1182,381,801,1092,241,851,1088,232,856,1089,330,752,1403,294,1068,1350,243,1074,695,166,529,1704,409,1255,1719,454,1248
22103000604,475,109,366,392,36,356,394,31,363,397,105,289,722,58,640,706,67,624,272,25,247,886,97,767,903,87,808
22103000814,502,424,78,433,351,82,425,317,108,451,391,57,841,639,180,776,557,201,281,230,51,729,547,162,767,606,152
22103000M09,435,179,256,355,94,261,361,87,274,359,145,212,613,123,458,587,104,469,254,58,196,619,123,475,651,168,462
22103000M10,591,221,370,489,98,391,487,89,398,490,187,296,892,130,700,869,115,731,320,50,270,937,167,720,959,212,714
22103000409,747,384,363,600,179,421,603,169,434,613,294,309,1059,316,698,990,293,670,370,114,256,1220,399,762,1249,459,769
22103000M05,460,249,211,349,113,236,359,125,234,364,186,175,544,185,323,529,161,349,256,100,156,655,221,408,681,269,403
22055000103,1139,329,810,913,147,766,906,128,778,926,240,678,1306,265,1006,1251,196,1022,483,101,382,1675,309,1294,1707,394,1259
22055000101,1356,272,1084,1148,141,1007,1147,119,1028,1157,206,943,1501,177,1282,1437,150,1257,689,89,600,1936,295,1588,1960,345,1592
22055000115,716,183,533,651,105,546,651,96,555,657,154,496,953,159,756,922,114,788,346,59,287,857,125,689,878,183,669
22055000065,219,168,51,169,105,64,169,103,66,174,131,43,454,256,142,432,230,168,116,77,39,476,324,123,482,343,124
22055000091,1036,284,752,910,166,744,904,141,763,883,217,663,1299,222,1015,1274,171,1081,616,91,525,1274,266,952,1278,317,922
22103000811,715,329,386,639,191,448,646,172,474,652,277,357,1022,262,710,994,252,720,421,122,299,1167,349,781,1187,370,794
22103000806,754,383,371,629,214,415,630,185,445,632,307,325,1155,328,770,1107,294,794,568,161,407,1153,333,785,1165,362,776
22103000C08,232,175,57,216,101,115,216,99,117,229,145,78,356,205,127,346,178,163,140,60,80,318,163,129,340,199,126
22103000703,566,381,185,448,239,209,450,237,213,480,312,155,734,397,306,669,316,323,325,171,154,873,468,381,906,502,385
22103000807,588,194,394,504,78,426,522,74,448,511,177,324,837,154,642,807,142,653,369,60,309,891,168,693,928,236,673
22019000310,335,226,109,346,163,183,348,146,202,354,231,120,496,233,236,479,184,276,209,90,119,394,176,189,388,185,192
22019000465,265,70,195,269,32,237,270,25,245,281,65,213,444,42,384,426,37,379,139,26,113,459,35,398,471,57,397
22019000402,290,113,177,299,47,252,296,42,254,297,97,192,578,83,462,557,73,465,171,40,131,563,88,435,576,96,469
22019000311,254,234,20,188,163,25,186,158,28,205,192,9,345,311,24,319,244,65,101,91,10,210,171,30,226,197,19
22019000321,400,375,25,372,303,69,364,298,66,391,359,31,564,482,75,550,405,132,191,161,30,333,271,46,375,347,21
22019000165,530,161,369,619,96,523,622,86,536,630,164,462,919,138,738,902,123,755,303,42,261,1015,148,834,1016,170,822
2201900313E,85,82,3,82,78,4,80,75,5,81,75,6,152,142,9,157,137,17,5,5,0,59,42,13,71,57,11
22019000314,499,283,216,438,154,284,443,134,309,449,238,208,709,232,419,692,196,470,317,136,181,497,179,279,510,215,273
22019000469,444,100,344,430,42,388,431,35,396,424,85,336,698,68,611,688,75,593,223,47,176,937,76,819,940,105,822
22019000361,512,469,43,425,367,58,417,337,80,454,405,46,697,596,89,669,503,158,184,160,24,632,508,91,693,616,68
22019000318,294,187,107,241,120,121,230,117,113,244,153,87,461,224,211,447,193,243,161,82,79,265,150,96,280,170,95
22019000464,599,174,425,655,69,586,659,68,591,663,162,500,932,97,798,904,90,798,315,52,263,1094,91,969,1138,134,983
22055000037,1068,258,810,856,141,715,846,134,712,869,189,675,1433,236,1133,1367,168,1162,553,97,456,1974,346,1563,2027,433,1564
22055000030,530,177,353,467,83,384,469,67,402,470,153,316,775,169,574,742,116,605,310,53,257,833,193,601,863,232,614
22055000032,852,341,511,779,192,587,776,162,614,787,290,491,1205,344,820,1172,267,882,558,139,419,1182,337,793,1199,377,790
22055000124,813,205,608,670,87,583,674,81,593,680,161,517,1000,194,762,961,162,773,432,86,346,1138,219,870,1174,264,885
22055000005,467,301,166,365,174,191,354,164,190,393,230,161,588,341,241,555,252,289,304,171,133,697,376,291,737,443,287
22055000122,599,160,439,540,82,458,549,75,474,545,127,415,874,184,670,829,140,661,379,79,300,920,150,749,940,185,750
22055000002,690,222,468,603,121,482,603,108,495,607,171,429,985,206,751,953,167,751,424,88,336,1007,179,788,1035,217,803
22055000027,377,182,195,317,101,216,316,108,208,337,166,171,572,195,367,535,136,383,216,79,137,713,259,408,736,292,439
22055000051,379,363,16,272,229,43,264,219,45,299,272,26,640,572,48,578,394,164,184,166,18,451,359,55,498,443,43
22055000099,601,351,250,443,181,262,431,177,254,468,238,228,806,384,403,759,288,441,301,153,148,766,324,395,842,430,397
22011000003,196,50,146,179,25,154,180,37,143,183,50,131,265,22,240,246,38,207,79,8,71,298,40,248,301,39,262
22011000019,148,26,122,134,15,119,133,8,125,137,28,109,186,9,173,176,9,166,74,8,66,218,8,206,233,17,215
22011000025,418,168,250,490,134,356,487,141,346,504,198,297,663,186,444,634,160,457,282,79,203,515,132,344,564,190,354
22011000026,306,241,65,305,211,94,304,215,89,312,228,78,482,350,115,411,268,125,152,117,35,389,256,97,430,313,104
22011000028,269,242,27,274,213,61,274,214,60,291,252,36,362,328,29,309,248,45,145,131,14,422,337,65,472,411,49
22055000093,398,153,245,346,94,252,349,86,263,352,113,231,692,219,425,667,176,470,248,53,195,768,278,454,794,322,448
22055000086,1154,233,921,1029,110,919,1028,89,939,1015,190,822,1558,197,1303,1521,161,1327,747,95,652,1683,241,1399,1664,273,1367
22055000102,1122,222,900,955,122,833,956,104,852,959,192,759,1465,159,1238,1412,145,1205,492,86,406,1628,251,1339,1670,286,1343
22011000014,377,84,293,343,35,308,340,34,306,349,66,281,390,36,345,386,47,334,137,29,108,464,34,418,473,42,426
22011000027,190,64,126,174,33,141,182,41,141,187,64,117,286,59,208,277,49,216,152,29,123,232,46,180,243,50,188
22055000073,330,110,220,293,67,226,289,38,251,300,94,205,431,91,325,428,54,371,266,58,208,451,98,348,450,96,345
22055000057,357,322,35,259,208,51,259,204,55,287,257,29,528,447,59,470,312,140,161,139,22,474,361,70,522,445,61
22103000A01,513,222,291,455,102,353,456,92,364,462,165,294,651,166,458,611,151,447,275,78,197,815,192,607,844,239,597
22103000312,677,272,405,606,129,477,619,117,502,624,209,414,982,216,720,935,221,681,334,48,286,1054,275,738,1074,340,717
22103000S02,318,119,199,260,72,188,267,65,202,272,120,145,539,125,382,524,121,391,278,66,212,535,113,398,544,135,393
22103000412,775,244,531,603,56,547,610,58,552,608,173,427,1137,130,948,1115,105,994,506,41,465,1045,111,908,1050,144,880
22067000053,249,130,119,181,56,125,182,61,121,196,79,117,305,130,172,274,94,178,141,56,85,323,108,200,353,154,198
22067000014,360,355,5,247,212,35,259,222,37,280,263,17,494,470,12,439,383,40,160,154,6,497,418,53,538,495,35
22031000005,242,204,38,192,126,66,197,144,53,215,168,45,374,287,81,360,252,104,220,158,62,348,220,78,366,272,88
22031000063,276,248,28,230,177,53,227,196,31,245,217,28,388,327,49,357,283,69,177,145,32,347,254,52,371,302,61
22049000006,326,46,280,257,23,234,268,37,231,270,37,231,420,30,382,396,64,325,164,17,147,528,37,483,538,52,486
22067000042,678,44,634,590,6,584,574,6,568,602,25,574,710,17,690,668,43,621,266,8,258,1074,31,1028,1080,26,1053
22031000032,238,170,68,197,103,94,202,113,89,207,125,79,291,178,107,280,166,111,163,107,56,327,154,152,329,173,156
22031000048,117,51,66,119,41,78,117,41,76,128,58,69,166,49,117,162,53,109,99,32,67,199,64,126,192,65,124
22067000050,400,227,173,382,141,241,376,144,232,400,176,221,529,260,264,499,245,251,233,119,114,607,254,333,646,303,336
22067000048,162,78,84,121,29,92,117,23,94,129,34,95,191,80,109,163,56,106,79,26,53,223,61,158,249,90,159
220570007-1,116,26,90,103,7,96,102,4,98,103,20,80,133,13,115,123,14,107,73,2,71,176,17,146,179,23,153
22055000096,509,134,375,456,75,381,453,72,381,438,111,327,756,136,587,721,95,613,301,49,252,778,155,600,787,192,582
22055000104,852,190,662,742,98,644,756,78,678,732,148,581,1075,135,892,1051,106,922,444,63,381,1057,145,889,1083,188,881
22055000128,732,197,535,589,88,501,579,72,507,599,144,455,973,120,817,937,89,835,398,51,347,862,126,703,890,162,710
22055000063,270,220,50,210,153,57,208,149,59,220,180,39,326,250,60,316,184,122,124,96,28,340,249,74,348,283,65
22055000020,640,561,79,515,387,128,500,370,130,547,464,78,787,622,147,740,480,236,314,240,74,780,593,145,842,697,136
22103000308,458,165,293,383,69,314,386,50,336,395,133,262,557,74,467,550,79,465,310,44,266,584,77,499,590,90,489
22103000609,30,5,25,22,3,19,24,3,21,22,5,17,34,5,26,35,9,26,14,3,11,73,22,51,68,14,54
22049000005,274,186,88,200,123,77,201,122,79,213,143,70,289,175,109,265,158,105,150,101,49,298,178,115,315,199,116
220570010-7,123,41,82,109,14,95,111,20,91,117,40,73,169,27,132,157,34,105,44,6,38,167,25,126,171,29,140
22057010-11,157,57,100,176,16,160,174,9,165,176,59,111,260,33,216,255,38,205,86,10,76,247,28,205,255,27,223
220570002-2,1042,320,722,1008,119,889,1028,117,911,1021,362,653,1236,167,1013,1224,156,1060,708,99,609,1367,147,1199,1365,188,1161
220890006-2,875,281,594,860,109,751,864,96,768,850,282,554,1297,222,1017,1260,196,1040,511,78,433,1345,196,1108,1370,239,1108
220890006-4,218,114,104,201,69,132,199,64,135,206,101,99,347,117,215,318,105,206,123,45,78,365,112,235,377,113,258
220890006-1,739,277,462,667,122,545,674,113,561,687,226,451,1075,229,820,1024,213,795,428,108,320,1014,196,788,1051,237,795
220890001-1,457,454,3,337,301,36,347,302,45,419,406,12,536,514,13,442,395,35,177,172,5,701,637,29,799,765,16
220890005-5,468,236,232,411,133,278,413,114,299,425,220,201,795,217,547,758,206,530,238,67,171,798,215,548,838,263,562
220890001-2,569,416,153,535,285,250,531,271,260,560,400,154,791,463,303,714,402,288,314,185,129,846,462,353,891,521,350
22051000134,458,324,134,364,191,173,371,150,221,388,266,116,649,316,285,623,278,325,293,177,116,618,308,278,640,365,262
22051000084,377,155,222,322,75,247,326,58,268,326,133,192,467,124,329,445,112,325,180,46,134,515,122,384,532,147,377
22051000175,278,148,130,264,57,207,270,60,210,280,130,147,486,146,319,459,136,295,184,52,132,492,145,338,514,166,344
22051000237,820,580,240,635,348,287,650,327,323,667,461,199,1157,636,496,1104,564,517,488,249,239,1128,636,456,1172,692,467
22051000059,547,246,301,449,104,345,453,72,381,460,202,258,770,204,524,732,165,551,312,75,237,824,224,569,837,267,549
220070004-2,509,412,97,417,297,120,423,290,133,489,401,85,651,489,152,568,371,173,249,190,59,560,382,144,589,433,145
22051000046,322,182,140,260,84,176,265,60,205,271,145,126,442,142,278,411,125,270,171,53,118,469,180,272,491,218,266
2205100125B,266,174,92,225,100,125,222,87,135,233,139,90,451,219,207,409,187,211,158,81,77,446,210,224,465,250,209
220510027-K,288,136,152,217,51,166,220,42,178,233,98,134,420,130,282,388,95,284,179,43,136,430,121,293,458,137,312
22051000058,243,156,87,180,64,116,176,53,123,191,97,90,447,260,176,421,218,186,116,45,71,433,196,204,475,267,202
22051000151,898,621,277,759,413,346,753,403,350,789,523,256,1284,745,513,1229,686,496,451,274,177,1393,766,561,1440,839,581
22051000029,237,125,112,181,57,124,181,49,132,188,98,87,382,143,204,370,135,221,157,58,99,418,158,247,425,185,230
22051000083,265,128,137,226,53,173,238,42,196,234,107,126,351,88,246,331,74,253,187,50,137,332,64,255,344,86,249
220890001-3,659,443,216,629,313,316,626,301,325,662,422,233,768,399,356,733,345,380,398,222,176,707,316,380,738,371,360
220890001-5,429,423,6,290,278,12,296,267,29,349,345,3,513,504,6,429,391,24,156,153,3,601,530,35,679,650,26
220890002-5,1243,443,800,1165,145,1020,1174,130,1044,1176,386,779,1661,269,1314,1614,248,1338,752,113,639,1828,262,1516,1837,318,1484
220890004-2,802,163,639,787,48,739,801,34,767,802,166,627,1248,99,1117,1198,125,1035,417,32,385,1560,107,1416,1611,106,1488
22067000040,304,44,260,318,21,297,326,21,305,338,40,298,347,31,300,329,41,280,147,15,132,335,33,298,327,38,286
22067000013,309,282,27,214,156,58,211,180,31,225,208,17,454,424,24,405,354,42,180,157,23,289,224,47,388,320,61
22031000037,340,146,194,264,91,173,266,96,170,279,120,158,392,145,239,369,129,238,253,91,162,439,107,301,441,132,305
22031000031,252,178,74,206,118,88,199,111,88,209,129,77,313,193,120,306,176,128,146,91,55,284,162,117,281,164,117
22067000016,222,217,5,145,118,27,144,126,18,171,151,14,343,326,10,297,259,22,103,103,0,280,227,29,324,292,20
22031000053,133,47,86,103,17,86,104,15,89,109,25,84,176,43,127,168,43,123,97,27,70,242,49,191,245,49,196
220570002-3,377,153,224,321,42,279,321,46,275,327,133,191,535,127,388,506,120,372,180,35,145,535,97,415,552,125,416
220570002-4,268,118,150,244,53,191,245,53,192,253,121,128,340,89,238,323,84,231,152,34,118,395,95,291,406,102,299
2201900160W,287,63,224,332,40,292,337,39,298,338,77,255,473,28,426,459,31,423,142,19,123,598,48,533,600,54,538
22101000039,495,210,285,418,119,299,425,108,317,430,171,254,666,184,464,630,189,419,282,74,208,594,181,394,617,190,413
22101000011,266,124,142,256,75,181,252,73,179,268,115,152,377,159,206,349,128,200,148,32,116,330,117,197,355,157,193
22101000010,473,263,210,417,187,230,411,185,226,439,241,193,601,319,263,558,246,276,305,117,188,546,267,245,574,327,240
22101000013,284,190,94,233,105,128,230,109,121,253,156,92,408,223,177,374,181,177,136,49,87,330,141,166,353,176,173
22101000021,412,125,287,370,65,305,374,64,310,383,111,270,568,108,450,550,115,417,227,37,190,540,115,419,552,118,431
22101000014,362,150,212,327,76,251,329,72,257,342,125,213,483,157,315,460,127,309,222,48,174,428,106,306,450,140,306
22101000032,385,54,331,310,13,297,305,11,294,301,53,247,465,35,421,443,25,404,215,10,205,559,52,503,559,44,505
22101000030,423,66,357,437,33,404,438,32,406,427,79,344,696,47,629,653,58,582,287,16,271,627,42,567,658,54,599
22101000029,398,67,331,364,37,327,371,23,348,374,60,312,626,38,571,610,54,534,252,14,238,596,45,528,610,46,548
220570003-5,604,258,346,600,119,481,600,103,497,629,264,358,974,254,691,925,209,685,375,71,304,748,151,557,804,225,564
220570011-1,202,63,139,160,21,139,162,16,146,161,61,99,253,39,208,248,35,173,112,17,95,373,34,328,391,45,343
22031000042,41,31,10,47,35,12,45,36,9,46,37,9,73,56,15,65,44,21,39,33,6,92,44,44,99,52,47
22031000009,138,113,25,133,86,47,137,96,41,148,104,42,229,185,40,219,167,48,101,78,23,169,97,45,174,122,49
22031000026,236,144,92,204,75,129,197,76,121,230,116,111,317,148,160,295,141,152,160,68,92,448,210,221,440,209,231
220570011-2,1209,209,1000,1083,78,1005,1089,69,1020,1082,200,870,1698,121,1521,1636,134,1448,634,50,584,2068,133,1877,2141,193,1927
220570011-4,282,65,217,280,34,246,286,34,252,289,62,226,380,33,338,369,36,323,152,21,131,514,40,460,532,49,474
220570003-3,856,175,681,818,60,758,826,47,779,819,200,608,1303,137,1138,1241,157,1062,449,47,402,1122,62,1023,1154,100,1041
22057010-15,290,33,257,306,14,292,303,12,291,307,51,256,397,23,358,383,40,333,182,19,163,382,18,346,383,23,358
22011000005,460,100,360,423,41,382,425,47,378,439,83,353,601,52,532,584,56,513,201,17,184,597,52,526,635,53,578
2201100016A,167,79,88,154,40,114,160,45,115,161,63,95,201,36,154,193,44,147,73,19,54,217,47,162,231,67,160
22011000016,392,107,285,381,54,327,385,66,319,397,107,282,526,60,449,493,65,420,218,40,178,521,61,443,540,75,455
22019000322,461,422,39,422,329,93,414,321,93,433,386,47,630,487,116,618,430,170,219,171,48,398,313,67,431,335,82
2201900861E,461,234,227,421,140,281,423,146,277,428,197,231,730,201,504,696,184,497,227,78,149,912,254,623,938,326,600
2201900460W,449,117,332,467,40,427,476,47,429,466,114,351,810,64,725,787,54,716,215,28,187,945,69,852,951,81,867
22101000009,254,96,158,230,51,179,223,51,172,234,94,137,366,89,275,353,74,256,182,40,142,383,81,284,382,104,273
22101000008,282,275,7,186,169,17,181,169,12,208,205,3,336,324,9,292,229,51,108,105,3,349,293,32,363,346,13
22101000015,246,170,76,227,98,129,226,99,127,229,137,92,376,173,192,351,158,169,165,65,100,296,142,144,304,148,151
22031000035,323,91,232,282,48,234,280,53,227,289,66,221,407,75,326,406,90,310,202,36,166,554,111,429,568,127,439
22031000010,665,329,336,564,203,361,562,215,347,603,276,320,874,345,523,809,298,499,332,112,220,1126,442,664,1186,491,687
22031000049,303,117,186,270,82,188,272,84,188,284,101,176,395,120,265,384,112,262,155,48,107,525,153,353,536,154,370
22031000044,223,196,27,203,161,42,206,169,37,223,197,23,323,280,43,301,255,42,156,125,31,340,254,57,363,296,65
22031000028,210,60,150,178,23,155,177,25,152,181,41,139,251,51,198,236,47,189,133,20,113,289,51,237,284,56,225
220570001-3,631,287,344,601,139,462,612,130,482,624,281,336,954,214,697,927,222,679,343,81,262,926,167,729,943,195,734
220570001-5,513,234,279,498,119,379,495,104,391,503,224,273,767,172,570,740,178,545,277,65,212,737,124,590,763,157,596
22101000006,629,192,437,571,122,449,572,114,458,593,175,414,878,228,639,841,177,602,296,64,232,957,184,717,984,234,740
22101000033,456,91,365,391,58,333,392,42,350,401,79,317,608,84,503,583,81,494,249,21,228,626,79,528,635,87,537
22049000008,242,103,139,205,45,160,201,46,155,221,74,146,317,89,222,295,86,202,139,42,97,355,85,261,352,87,260
2204900025A,117,50,67,117,48,69,111,46,65,115,57,55,158,57,100,150,58,92,60,24,36,149,59,80,153,68,84
22049000010,417,61,356,359,30,329,362,23,339,379,50,328,565,17,531,546,52,489,210,11,199,556,15,533,560,20,536
220570004-2,426,130,296,423,34,389,423,27,396,427,141,283,680,71,598,662,95,553,271,45,226,613,54,537,627,68,547
220570009-1,367,119,248,347,53,294,345,39,306,351,126,221,549,97,434,514,85,408,234,40,194,603,73,503,651,90,553
22057010-13,337,94,243,335,11,324,337,18,319,328,96,228,461,43,399,442,52,377,237,18,219,455,29,410,463,31,425
22019000302,197,155,42,148,88,60,148,81,67,171,131,35,261,148,100,240,113,123,102,77,25,166,82,70,179,102,72
2201900371S,834,298,536,788,158,630,793,144,649,803,273,527,1423,315,1049,1375,273,1068,473,134,339,1170,248,884,1188,266,901
2201900315E,491,458,33,425,359,66,410,344,66,445,408,34,673,585,72,653,491,144,225,202,23,467,394,57,467,424,40
22019000365,957,273,684,863,106,757,873,98,775,877,252,622,1017,133,846,1009,105,891,427,72,355,894,78,789,924,143,776
22101000037,403,128,275,403,51,352,406,54,352,404,91,306,647,151,482,638,142,477,320,40,280,617,123,469,627,137,470
220070008-1,1096,342,754,1007,90,917,983,88,895,1040,350,687,1382,133,1225,1294,204,1050,458,52,406,1421,98,1285,1483,111,1365
22051000155,298,148,150,275,83,192,278,72,206,291,152,138,481,161,307,439,153,270,165,58,107,490,154,315,525,176,343
22051000136,377,260,117,276,125,151,268,109,159,284,186,95,509,240,231,487,219,256,245,140,105,488,218,247,509,262,239
220510003-K,562,317,245,450,145,305,453,130,323,473,248,221,852,360,453,793,282,479,397,144,253,915,359,502,983,439,525
220510033-K,340,318,22,269,226,43,265,218,47,300,274,24,459,397,53,388,306,67,246,209,37,443,355,68,474,401,63
220890002-4,635,388,247,540,242,298,536,231,305,571,357,203,831,384,425,779,372,385,374,205,169,997,425,527,1033,469,550
220890007-2,820,243,577,791,58,733,786,59,727,791,183,595,1214,151,1025,1167,148,1002,507,45,462,1276,145,1115,1300,183,1102
220890007-3,1066,401,665,1017,140,877,1028,137,891,1024,367,646,1473,220,1177,1439,223,1186,620,118,502,1680,291,1348,1697,320,1349
220510029-K,379,212,167,321,109,212,332,105,227,342,181,159,606,226,360,569,199,350,238,93,145,598,210,355,637,260,363
22051000060,941,404,537,844,167,677,849,132,717,844,343,494,1345,308,967,1300,268,1002,603,113,490,1390,311,1026,1425,382,1005
220510006-W,325,152,173,290,68,222,293,63,230,294,132,160,575,179,378,542,171,287,185,45,140,584,155,366,626,210,408
22051000044,601,293,308,475,110,365,494,95,399,496,222,265,826,229,533,793,209,560,383,104,279,904,260,593,932,311,601
220510017-K,706,335,371,618,153,465,621,140,481,635,296,333,990,308,623,947,255,670,503,120,383,1090,369,679,1114,424,664
22047000029,382,203,179,379,125,254,390,124,266,406,212,191,483,178,296,457,163,281,206,89,117,503,170,325,528,194,327
2201100012A,302,70,232,263,30,233,256,26,230,268,53,209,331,34,286,319,36,279,147,17,130,371,32,333,394,39,348
2201100025A,95,46,49,112,43,69,111,42,69,118,55,58,134,50,80,130,46,84,54,24,30,139,56,82,143,59,83
22011000002,60,27,33,45,17,28,43,11,32,45,20,23,49,22,25,48,19,29,19,12,7,80,26,54,87,34,53
22011000007,427,98,329,377,51,326,375,45,330,389,93,293,520,62,443,504,49,450,216,29,187,499,54,427,523,59,460
2201100025B,174,89,85,162,68,94,165,68,97,179,92,87,293,128,153,263,102,147,107,51,56,231,102,117,248,112,123
22011000030,207,76,131,206,43,163,206,31,175,214,69,140,354,74,271,337,52,281,151,29,122,264,48,206,288,64,217
22049000025,412,128,284,405,101,304,407,92,315,410,113,294,538,132,401,520,152,357,230,68,162,490,92,391,505,105,397
22019000602,252,54,198,251,32,219,253,17,236,247,58,189,372,56,311,362,45,306,155,31,124,612,85,518,597,84,507
22019000372,843,308,535,774,131,643,778,126,652,790,273,516,1192,175,949,1156,145,993,431,87,344,868,122,722,874,146,702
22051000003,455,185,270,407,80,327,419,55,364,431,189,238,608,141,429,605,108,489,314,45,269,621,156,444,618,181,428
22101000002,213,150,63,178,96,82,170,82,88,185,105,80,332,221,102,307,162,99,102,56,46,298,175,96,335,221,107
22047000018,270,142,128,352,82,270,351,80,271,347,167,177,380,113,251,354,101,246,164,53,111,346,72,261,359,101,254
220070009-1,936,282,654,910,85,825,899,74,825,935,307,621,1140,134,987,1093,182,881,418,50,368,1257,99,1125,1324,121,1198
220510004-K,667,335,332,575,162,413,578,146,432,593,287,299,1005,364,599,975,310,647,482,137,345,1016,380,595,1062,479,570
220510015-K,385,229,156,264,106,158,273,95,178,287,160,123,570,293,253,536,249,266,252,99,153,615,282,293,651,321,307
22051000199,639,361,278,522,201,321,523,177,346,536,288,244,878,352,499,828,308,502,353,144,209,967,375,569,994,407,570
22051000054,389,180,209,378,103,275,378,89,289,373,172,198,550,133,399,530,120,394,229,45,184,631,167,443,624,189,422
22051000018,584,253,331,485,97,388,490,86,404,497,208,283,843,213,600,816,174,624,346,61,285,806,208,575,845,260,570
22051000124,1006,411,595,881,151,730,906,108,798,882,334,543,1233,256,889,1220,215,986,605,117,488,1278,265,974,1306,349,928
2205100193A,440,302,138,394,209,185,388,182,206,405,273,126,668,352,291,617,329,263,216,113,103,643,329,271,674,347,312
220510001-L,636,182,454,777,45,732,792,32,760,760,225,514,1062,137,905,1003,98,788,336,42,294,1334,102,1165,1355,132,1210
22051000028,293,147,146,245,62,183,245,55,190,253,113,140,427,147,251,410,131,270,195,45,150,414,128,257,427,160,250
22051000071,973,407,566,919,140,779,935,114,821,929,359,565,1278,275,948,1245,228,1007,626,86,540,1195,197,964,1200,246,931
22051006-KB,433,306,127,300,135,165,290,118,172,331,224,100,598,250,326,558,208,328,294,95,199,658,314,304,707,382,314
220510014-K,698,433,265,534,213,321,544,177,367,580,317,257,1043,480,530,961,400,539,464,194,270,985,378,546,1078,506,556
22051000153,669,664,5,454,427,27,447,383,64,536,525,5,949,926,10,825,763,34,372,365,7,880,816,23,991,957,21
220510003-G,569,316,253,507,162,345,518,136,382,529,297,226,727,259,433,685,207,452,330,111,219,865,295,539,873,326,525
22051000211,274,137,137,245,62,183,254,62,192,253,122,128,488,138,336,471,136,319,197,40,157,481,164,301,496,195,294
220510001-G,188,84,104,155,48,107,161,32,129,162,82,77,293,77,201,282,60,213,100,33,67,336,112,212,342,130,202
2205100213C,153,150,3,93,80,13,99,85,14,106,104,1,327,300,18,297,246,38,54,48,6,364,323,18,402,386,13
22051000008,358,189,169,301,90,211,303,67,236,310,161,145,479,146,307,454,112,327,233,71,162,503,125,349,517,174,327
22051000009,481,283,198,385,109,276,388,87,301,407,195,207,743,312,389,704,282,408,247,85,162,790,332,409,834,405,411
220070002-1,277,104,173,261,18,243,268,21,247,275,104,170,365,55,298,343,45,296,137,15,122,388,43,339,396,57,335
2205100214B,497,483,14,288,260,28,289,248,41,317,297,14,791,724,54,730,632,80,213,200,13,879,748,66,957,885,60
22051000188,367,355,12,247,219,28,247,209,38,283,261,18,548,498,38,521,454,54,173,161,12,550,489,35,606,556,37
22051000210,176,112,64,151,58,93,154,55,99,158,86,66,304,143,153,287,127,147,101,50,51,321,167,140,334,174,152
2205100232B,621,527,94,505,384,121,504,354,150,520,445,72,822,605,194,789,539,238,403,302,101,832,585,210,877,637,228
22051000247,390,125,265,418,53,365,433,35,398,430,151,274,621,99,515,589,102,415,227,30,197,792,87,676,796,103,688
22051000104,473,469,4,372,349,23,375,331,44,424,420,4,652,640,5,581,539,30,295,294,1,584,527,23,694,679,11
220890004-1,751,312,439,695,157,538,696,145,551,700,268,424,996,261,703,931,240,666,383,98,285,1304,270,990,1368,319,1035
22051000063,397,178,219,329,58,271,332,49,283,337,148,189,483,85,350,466,69,386,236,44,192,571,143,406,572,166,398
22051000131,280,263,17,179,153,26,185,145,40,215,195,19,369,325,38,322,264,48,141,118,23,414,336,47,456,407,40
22051000096,270,131,139,253,45,208,257,26,231,253,119,133,336,71,247,335,63,269,155,38,117,431,66,364,422,84,330
22051000024,933,332,601,801,106,695,804,91,713,813,282,528,1151,208,886,1120,168,935,631,104,527,1136,191,918,1131,258,857
2205100197A,117,116,1,86,78,8,83,73,10,90,87,3,154,152,2,151,140,7,72,71,1,170,151,16,180,168,10
22051000040,421,203,218,344,73,271,353,53,300,358,168,190,513,125,363,503,100,397,252,60,192,573,137,422,568,155,398
22101000016,294,279,15,206,184,22,204,182,22,233,219,13,415,374,36,366,278,77,113,103,10,344,300,28,381,352,23
220570002-5,242,150,92,231,73,158,232,70,162,243,141,102,375,152,193,353,142,191,149,56,93,388,137,226,418,182,226
220570001-4,260,216,44,189,115,74,183,109,74,212,167,41,359,258,92,300,175,106,123,86,37,319,170,121,399,268,119
22057002-12,623,205,418,599,75,524,593,65,528,605,195,407,769,84,652,758,89,669,460,58,402,886,89,784,875,100,757
220570002-8,264,97,167,222,30,192,228,23,205,230,83,143,329,39,255,319,38,271,161,25,136,377,37,334,380,58,319
22057002-14,349,133,216,294,46,248,297,41,256,299,121,178,428,90,316,427,70,348,248,23,225,484,88,390,493,114,368
220570004-6,601,116,485,561,41,520,565,43,522,562,137,419,811,76,717,782,107,655,309,28,281,755,69,657,777,66,699
220570001-2,384,216,168,312,92,220,309,93,216,331,156,171,510,182,317,480,166,293,134,48,86,816,259,536,856,334,513
220570010-4,155,45,110,174,8,166,175,7,168,176,39,137,240,31,192,236,29,196,108,10,98,209,17,182,221,23,192
220570007-2,310,80,230,271,27,244,282,27,255,278,75,200,395,40,348,381,41,332,177,22,155,412,27,377,420,41,374
220570002-1,195,100,95,156,37,119,152,31,121,166,79,85,265,98,162,254,98,154,97,22,75,288,74,200,305,94,206
220570003-6,666,159,507,647,56,591,657,53,604,661,172,479,1102,134,933,1089,160,907,520,52,468,810,88,692,839,117,708
220510023-K,461,410,51,300,241,59,305,226,79,347,298,45,707,618,79,630,509,102,201,159,42,697,549,103,782,665,100
220510034-K,464,242,222,398,100,298,404,90,314,411,194,215,792,276,479,743,229,491,318,55,263,836,291,493,889,389,486
22051000043,439,204,235,383,74,309,395,69,326,397,166,228,571,148,404,552,136,405,284,61,223,601,140,448,608,176,425
220510011-G,621,474,147,452,250,202,469,234,235,487,344,136,948,587,334,865,487,344,321,174,147,947,530,360,1038,658,371
22051000081,232,82,150,196,35,161,205,24,181,214,89,120,384,83,280,363,89,263,141,33,108,401,89,294,418,116,292
22051000091,400,195,205,372,77,295,379,58,321,378,166,209,505,156,324,496,110,371,273,80,193,518,102,407,516,130,381
220890003-1,1203,490,713,1117,211,906,1130,185,945,1131,440,682,1756,351,1315,1730,299,1411,841,134,707,1439,208,1199,1444,277,1128
220890003-2,836,455,381,736,221,515,746,206,540,761,392,359,1277,406,802,1227,370,830,425,142,283,1299,391,869,1349,484,843
220890006-6,130,114,16,126,104,22,128,104,24,137,128,8,158,129,27,121,98,19,60,49,11,193,145,43,208,168,40
22049000016,102,99,3,82,82,0,78,41,37,88,88,0,139,129,6,133,123,7,80,79,1,132,121,7,129,122,7
22049000015,144,56,88,110,39,71,106,23,83,113,47,66,165,45,112,159,53,104,72,25,47,194,54,132,199,57,137
220890002-1,184,76,108,205,40,165,201,40,161,207,80,124,299,55,225,284,63,214,126,30,96,292,37,235,302,52,240
22051000074,553,310,243,451,112,339,459,91,368,468,242,223,832,313,480,809,276,517,333,90,243,813,298,483,847,357,481
220510008-G,258,192,66,222,125,97,216,112,104,235,165,67,391,222,153,366,199,160,162,96,66,439,246,174,458,277,176
22051000052,715,303,412,658,119,539,662,89,573,678,255,412,1058,219,791,1017,217,777,425,85,340,1138,247,854,1154,273,860
220510001-K,646,256,390,567,106,461,574,87,487,582,217,362,876,187,645,860,133,711,553,94,459,858,183,656,861,220,620
22051000226,686,397,289,531,201,330,541,181,360,562,315,235,1057,492,510,982,435,521,397,165,232,1002,432,505,1066,547,499
22051000055,416,190,226,381,64,317,374,51,323,390,155,231,675,155,494,636,153,464,258,55,203,657,141,490,684,193,475
22051000178,213,97,116,193,45,148,194,49,145,203,89,113,340,76,242,320,78,228,122,32,90,380,114,250,404,128,273
220510002-G,330,234,96,273,126,147,274,109,165,283,190,90,394,214,161,374,173,187,136,71,65,522,270,217,538,317,212
22053000016,435,217,218,351,101,250,350,103,247,368,170,197,597,224,354,557,161,381,154,66,88,623,208,392,662,265,380
22053000012,443,152,291,380,79,301,384,83,301,400,133,264,545,90,445,531,97,422,227,33,194,603,73,518,619,101,512
22053000023,1379,336,1043,1282,158,1124,1281,146,1135,1263,322,932,1860,204,1613,1811,191,1582,685,129,556,1830,165,1643,1851,177,1666
22051000082,567,324,243,473,156,317,468,132,336,483,264,218,861,313,511,847,282,532,335,98,237,809,328,453,829,351,451
22051000248,373,118,255,341,20,321,358,14,344,354,127,216,531,71,449,506,68,381,186,24,162,644,51,561,672,67,598
220510007-G,499,448,51,358,270,88,349,250,99,401,350,46,766,647,105,701,542,129,276,231,45,731,576,119,811,671,131
220510016-K,582,310,272,476,132,344,489,131,358,494,257,232,918,356,535,860,299,541,378,103,275,967,339,588,1024,422,588
22051000089,529,261,268,473,86,387,478,60,418,490,207,280,659,166,437,646,140,499,328,71,257,682,176,488,683,208,461
22051000015,247,120,127,199,48,151,204,31,173,214,108,105,359,90,253,350,68,273,152,28,124,411,136,261,421,155,257
22051000120,283,87,196,312,32,280,315,28,287,310,93,214,413,53,341,408,44,356,231,26,205,383,43,328,389,65,313
22051007-KB,468,308,160,333,143,190,331,122,209,361,226,131,806,327,444,739,254,461,353,117,236,670,271,351,738,372,350
22051000012,671,302,369,608,101,507,612,80,532,604,240,360,927,221,663,907,139,754,454,80,374,877,166,696,878,206,657
22051000014,319,135,184,309,48,261,308,37,271,311,138,173,418,77,322,407,72,331,227,40,187,518,117,393,522,139,370
220510006-G,291,241,50,206,128,78,203,107,96,227,180,47,378,296,75,345,257,78,159,127,32,424,280,121,484,370,107
22051000057,422,230,192,364,84,280,366,71,295,384,184,197,638,254,346,592,212,363,217,58,159,617,199,378,650,248,388
220070003-1,176,60,116,148,16,132,147,12,135,155,68,86,211,35,172,202,36,162,87,9,78,255,38,204,260,43,215
220070003-2,549,107,442,452,25,427,442,21,421,457,83,373,764,61,677,721,82,614,284,29,255,840,50,745,870,61,801
22051000204,519,222,297,473,136,337,475,110,365,489,214,268,805,231,554,780,198,573,385,104,281,729,183,525,749,225,514
22051000217,1043,780,263,858,519,339,859,470,389,899,672,221,1335,836,455,1262,727,509,584,379,205,1267,707,512,1289,778,495
220510004-W,287,135,152,220,39,181,236,37,199,237,97,131,400,110,278,374,92,236,133,35,98,466,109,317,494,128,356
22051000189,528,302,226,487,157,330,473,128,345,493,249,234,1102,360,703,1042,323,679,370,109,261,955,303,603,998,355,620
220510005-G,239,105,134,211,40,171,213,35,178,214,86,124,362,77,262,346,73,264,158,37,121,399,104,285,409,120,282
22051000115,289,264,25,203,171,32,195,159,36,233,210,18,418,374,38,366,303,49,142,125,17,451,368,52,482,422,50
22047000011,620,602,18,483,415,68,481,395,86,601,569,26,634,586,44,559,463,75,194,181,13,658,516,98,790,716,53
22047000010,684,316,368,705,150,555,701,139,562,703,286,411,781,221,526,741,190,532,360,128,232,851,175,653,867,234,616
22077000020,333,199,134,328,116,212,324,113,211,344,196,146,363,147,208,322,109,203,143,55,88,411,135,263,447,174,264
22077000019,517,235,282,488,119,369,485,104,381,502,236,264,583,137,435,561,160,390,229,48,181,702,150,531,712,159,541
22087000055,652,229,423,581,96,485,603,74,529,608,217,381,1003,190,794,957,226,713,328,49,279,1202,167,979,1265,200,1053
220590006-1,261,56,205,295,34,261,295,32,263,304,53,247,316,36,272,304,43,256,130,16,114,307,31,269,318,33,283
220590002-1,627,89,538,554,29,525,550,31,519,563,66,494,675,52,613,648,96,543,200,14,186,770,47,707,789,51,733
220590001-3,457,67,390,392,34,358,396,35,361,409,48,354,430,24,396,412,47,361,126,8,118,498,22,469,522,37,480
220910006-2,285,128,157,274,28,246,276,23,253,282,116,163,306,30,272,293,38,233,131,13,118,351,21,319,341,26,313
220790000C9,245,242,3,183,169,14,182,174,8,191,184,7,322,313,8,289,272,13,98,97,1,261,222,24,320,317,3
22079000C31,471,182,289,425,72,353,424,74,350,439,164,274,699,142,527,673,134,525,238,41,197,541,138,393,548,165,379
22079000C15,566,537,29,370,310,60,370,304,66,400,365,29,820,715,85,757,593,128,238,213,25,812,644,123,919,814,94
220790C37-A,1008,313,695,832,128,704,837,114,723,874,195,675,1156,207,920,1095,180,886,472,95,377,1267,196,1039,1258,232,1007
220790C37-B,332,104,228,275,42,233,276,37,239,281,62,219,378,66,304,355,57,289,155,32,123,419,65,344,417,77,333
22097000021,330,303,27,249,202,47,245,193,52,266,236,30,446,395,46,402,264,117,177,156,21,344,248,72,376,314,48
22127007-1A,128,28,100,129,10,119,129,15,114,133,28,105,172,20,148,169,24,142,62,5,57,161,12,148,162,10,149
22087000023,109,89,20,76,39,37,76,34,42,82,55,25,223,138,80,209,127,78,50,27,23,246,173,59,265,207,56
22087000024,427,206,221,352,75,277,370,63,307,377,188,183,709,168,504,685,189,476,216,54,162,590,128,432,634,174,450
220590003-2,253,35,218,196,18,178,201,21,180,197,29,164,294,24,264,280,33,237,103,16,87,327,18,304,346,26,318
22049000002,410,66,344,366,12,354,372,21,351,375,29,346,505,10,478,477,34,440,238,9,229,488,26,451,500,33,457
221270004-2,54,3,51,55,0,55,56,3,53,53,4,48,106,4,101,101,9,91,34,2,32,71,0,70,81,4,77
221270002-3,283,243,40,295,182,113,285,199,86,323,255,58,419,324,82,407,273,110,154,122,32,357,225,106,400,305,84
22099000010,924,450,474,831,256,575,814,284,530,854,388,460,1167,497,643,1093,327,687,601,192,409,1069,399,612,1117,476,618
22099000021,1326,425,901,1316,273,1043,1301,268,1033,1375,415,950,1746,453,1238,1640,318,1190,891,185,706,1820,420,1320,1873,506,1332
22099000024,1140,313,827,1215,171,1044,1199,158,1041,1234,307,924,1598,338,1222,1518,253,1181,864,159,705,1614,284,1284,1652,345,1273
22099000013,729,85,644,763,52,711,748,39,709,774,103,664,925,52,863,872,57,750,527,45,482,1008,29,957,1041,40,994
22051000020,191,79,112,168,27,141,173,15,158,176,69,104,270,55,198,262,47,211,125,18,107,315,86,218,325,99,219
22051000025,925,392,533,830,152,678,848,104,744,846,346,491,1164,268,845,1152,214,918,655,126,529,1057,178,857,1071,239,817
22051000190,640,313,327,606,170,436,608,137,471,629,288,338,1072,293,737,1025,279,724,435,125,310,1001,264,698,1052,317,715
22051000202,352,154,198,316,80,236,315,69,246,329,137,189,494,133,348,459,115,319,218,60,158,562,143,391,585,168,411
220510030-K,236,176,60,183,96,87,185,80,105,203,139,62,338,190,144,313,154,156,143,66,77,300,136,145,337,185,149
22051000051,593,225,368,525,83,442,530,59,471,537,205,326,888,156,692,869,132,715,330,51,279,897,161,704,926,212,694
22051000073,811,359,452,745,127,618,756,107,649,769,302,463,1135,314,768,1102,282,797,472,106,366,1010,251,732,1040,307,721
22051000187,791,788,3,668,612,56,663,571,92,740,721,12,1293,1259,17,1195,1112,49,534,526,8,1167,1093,41,1221,1181,34
22051000201,543,536,7,414,385,29,416,367,49,480,466,9,869,850,6,749,681,44,329,325,4,871,813,31,956,912,31
22051000234,839,524,315,700,278,422,702,231,471,721,408,303,1160,517,608,1113,436,644,505,198,307,1211,542,606,1275,658,594
220510005-K,760,241,519,692,74,618,708,45,663,706,224,480,963,116,812,949,90,855,598,54,544,876,84,783,880,124,738
2205100213B,381,216,165,296,108,188,299,91,208,322,163,153,633,263,345,592,240,336,252,85,167,659,288,339,713,357,343
22051000053,476,204,272,432,74,358,437,64,373,437,184,249,707,145,527,676,133,529,277,51,226,735,146,561,757,187,557
2205100214A,175,125,50,148,52,96,145,53,92,151,94,56,288,148,138,263,130,131,75,34,41,298,141,146,319,164,151
2205100193B,458,329,129,414,192,222,423,179,244,430,271,154,729,364,346,684,326,339,227,111,116,870,443,402,911,475,417
22109000060,516,130,386,505,61,444,514,53,461,507,127,367,762,81,672,738,101,615,225,32,193,964,65,859,969,68,888
22109000063,359,74,285,330,27,303,323,33,290,341,92,245,513,56,449,478,53,412,178,25,153,601,40,541,619,40,576
22109000045,336,81,255,298,17,281,301,26,275,309,61,244,475,52,405,461,42,404,224,23,201,414,55,353,408,55,344
22109000083,674,189,485,644,59,585,648,62,586,645,174,463,941,80,832,911,85,806,367,31,336,860,85,754,879,95,766
22109000065,443,215,228,337,112,225,344,111,233,372,169,202,568,221,332,538,194,328,204,83,121,665,203,425,695,244,448
22109000041,517,252,265,482,135,347,481,135,346,506,221,276,826,249,541,779,239,510,299,86,213,896,253,593,931,313,598
22109000046,540,295,245,529,199,330,530,185,345,539,291,243,737,335,382,684,288,370,275,95,180,724,279,421,771,325,424
22109000034,706,656,50,544,428,116,554,436,118,631,562,61,1070,941,112,930,759,137,285,256,29,938,703,170,1110,928,162
22109000029,351,130,221,341,55,286,341,50,291,341,101,233,654,122,509,617,123,462,187,25,162,594,88,463,614,118,481
22109000021,386,128,258,342,57,285,338,45,293,346,112,228,608,119,464,570,115,431,200,22,178,593,112,446,620,130,478
22109000031,428,311,117,355,213,142,357,210,147,394,284,100,608,427,175,538,342,173,197,125,72,615,356,228,690,445,235
220450012-1,640,365,275,548,232,316,542,223,319,568,307,253,864,433,417,801,316,349,331,123,208,840,378,408,920,479,418
220450009-1,706,277,429,642,193,449,637,191,446,666,237,426,885,320,546,787,208,489,405,140,265,835,220,572,886,312,563
220450011-2,510,254,256,445,161,284,439,162,277,467,226,240,721,327,388,649,205,343,278,84,194,720,310,388,813,422,378
220450010-1,687,413,274,641,288,353,625,287,338,690,408,278,864,476,363,806,326,349,337,158,179,880,406,436,937,493,431
22109000025,489,136,353,505,65,440,511,71,440,510,126,376,781,122,615,757,109,617,335,52,283,757,127,593,759,139,604
22109000054,122,57,65,116,23,93,117,27,90,125,53,71,196,49,141,176,34,110,56,9,47,242,24,197,264,46,213
22093000008,660,232,428,687,110,577,701,108,593,693,260,429,841,171,659,826,201,614,304,81,223,995,172,808,1003,193,806
22093000013,859,836,23,741,666,75,744,653,91,824,774,43,945,886,44,858,760,72,454,431,23,931,789,98,997,930,58
22093000003,821,504,317,704,257,447,733,270,463,745,424,310,1029,416,592,970,387,566,480,183,297,1009,368,611,1065,457,602
22093000002,524,304,220,452,153,299,468,156,312,472,250,215,647,252,380,623,239,366,308,108,200,658,225,412,672,263,400
22093000009,824,218,606,841,30,811,856,31,825,829,268,552,984,85,884,952,131,806,465,61,404,1192,51,1123,1217,51,1157
220910002-2,248,177,71,215,94,121,223,103,120,239,166,73,321,169,149,312,146,150,155,76,79,211,88,107,238,108,127
2207117-18A,520,274,246,380,140,240,391,105,286,391,206,181,627,201,380,623,179,424,270,88,182,731,247,456,725,294,406
22071014-19,377,321,56,277,203,74,276,177,99,283,248,32,491,345,110,480,315,157,272,209,63,510,362,130,491,365,109
22071007-42,194,135,59,175,90,85,179,68,111,179,126,49,233,116,95,235,97,137,171,99,72,259,130,122,253,152,98
22071008-13,212,211,1,138,125,13,143,123,20,158,157,1,251,240,4,238,222,6,90,90,0,312,272,16,359,342,13
22071004-17,581,333,248,433,141,292,446,100,346,453,256,193,715,245,420,705,226,467,341,137,204,723,222,484,728,281,433
22071009-28,221,220,1,130,123,7,138,126,12,150,148,2,300,289,9,286,264,12,104,99,5,396,352,14,445,434,10
220710002-4,497,491,6,283,250,33,290,235,55,344,332,8,654,635,7,556,480,45,236,229,7,737,669,29,826,792,19
2207109-44E,556,542,14,485,452,33,488,425,63,503,495,8,777,743,20,760,701,47,403,388,15,589,532,31,655,627,24
22071008-26,417,406,11,314,285,29,328,282,46,337,328,9,454,414,26,448,402,37,230,220,10,398,344,39,425,385,31
22071008-24,298,284,14,249,214,35,256,190,66,266,253,13,352,301,37,334,283,39,222,202,20,326,268,40,325,271,39
22071014-16,461,362,99,373,231,142,382,190,192,385,294,87,633,387,191,621,357,255,367,246,121,588,380,193,576,395,162
220710011-9,649,478,171,471,284,187,490,234,256,492,357,132,801,479,259,790,409,367,455,275,180,786,441,328,771,480,273
22071014-26,291,290,1,196,174,22,207,172,35,220,213,4,408,401,5,376,329,37,153,148,5,457,391,28,536,513,19
220710005-3,337,295,42,254,201,53,254,175,79,269,234,35,431,332,80,406,295,99,209,162,47,510,392,100,500,404,87
220710005-2,179,144,35,160,97,63,155,74,81,161,116,45,219,134,72,200,112,81,102,67,35,285,185,89,291,202,83
221270004-3,323,96,227,365,66,299,362,75,287,376,98,275,462,97,350,409,102,299,179,33,146,455,62,381,470,79,388
22097000029,674,264,410,624,173,451,629,173,456,634,223,410,828,248,562,795,220,559,365,138,227,899,256,615,911,288,611
22097000033,927,443,484,810,287,523,797,263,534,830,364,466,1138,444,667,1108,350,729,417,167,250,1254,445,774,1279,496,765
22097000034,610,199,411,551,130,421,554,119,435,564,171,388,728,168,532,694,149,530,283,78,205,753,161,569,771,190,574
22077000015,715,328,387,637,103,534,656,94,562,700,302,394,872,138,717,824,170,635,283,59,224,853,87,750,906,134,770
22087000051,199,86,113,182,44,138,189,27,162,192,70,120,304,69,230,289,76,199,105,32,73,322,66,244,332,52,278
22087000022,223,108,115,181,53,128,183,37,146,188,89,96,377,159,200,362,152,194,123,40,83,392,159,220,406,190,207
22087000015,213,155,58,156,64,92,154,48,106,166,107,57,355,194,152,326,165,147,81,34,47,411,199,193,442,252,176
22087000041,372,153,219,326,57,269,332,47,285,337,119,211,590,110,468,564,118,431,166,32,134,760,166,569,774,188,577
22087000040,224,127,97,162,57,105,164,45,119,176,93,80,297,105,184,279,95,174,84,36,48,318,81,219,353,117,226
22087000031,281,127,154,217,50,167,226,30,196,229,107,119,481,80,379,457,94,347,110,22,88,474,81,377,496,100,390
22077000008,1056,1048,8,823,717,106,858,757,101,965,945,11,1346,1317,16,1189,1041,104,593,566,27,1118,952,108,1244,1172,48
22077000011,305,285,20,243,190,53,268,205,63,280,260,19,393,349,41,354,281,66,190,168,22,310,229,65,345,302,42
22077000013,451,257,194,440,147,293,447,135,312,471,235,235,1078,328,746,1035,359,653,217,98,119,534,161,360,546,177,363
22087000053,212,85,127,159,25,134,170,22,148,179,76,99,278,48,228,259,57,196,85,15,70,326,54,256,332,66,264
22071009-16,347,335,12,263,234,29,264,220,44,269,252,14,417,364,28,396,332,43,235,218,17,404,362,32,399,368,24
22071009-32,34,33,1,41,34,7,38,30,8,41,40,1,94,78,12,88,72,12,20,19,1,90,74,14,105,94,11
2207109-41A,144,85,59,92,49,43,92,41,51,106,64,38,281,170,108,248,119,121,88,47,41,318,148,152,357,190,165
22071013-14,422,408,14,288,242,46,297,227,70,300,278,21,557,471,42,530,428,86,230,210,20,547,445,83,549,485,53
220710002-7,391,390,1,219,206,13,219,188,31,231,225,6,898,861,12,878,817,34,173,169,4,731,664,22,792,762,16
22053000006,358,150,208,366,61,305,365,58,307,374,112,256,664,138,504,644,113,514,310,52,258,511,79,408,540,101,429
220710014-9,427,280,147,293,144,149,310,97,213,317,212,104,510,243,233,510,164,345,309,130,179,426,162,259,436,223,207
2207115-14B,336,308,28,253,196,57,252,173,79,263,226,33,409,320,76,398,306,85,203,159,44,457,384,60,473,408,51
220450014-3,909,194,715,826,112,714,811,117,694,843,178,659,1227,197,999,1144,162,874,502,75,427,1360,183,1141,1408,224,1174
220450003-3,624,193,431,543,111,432,547,115,432,557,172,382,839,212,611,798,173,557,383,85,298,881,191,659,891,221,660
220450001-1,528,513,15,436,370,66,421,370,51,469,447,19,837,789,36,714,539,126,228,219,9,688,574,64,771,699,52
220450002-3,497,176,321,428,107,321,421,101,320,434,148,284,685,206,467,621,141,423,293,80,213,644,141,478,680,185,490
220450013-1,604,116,488,560,53,507,542,61,481,565,115,446,876,115,739,805,85,621,358,42,316,838,91,714,878,116,749
22105000071,659,375,284,545,175,370,563,176,387,596,341,245,880,362,495,832,311,489,379,148,231,884,321,522,897,376,510
22105000149,980,312,668,871,56,815,890,48,842,882,239,640,1367,122,1190,1336,149,1154,612,63,549,1339,116,1183,1338,128,1185
22105000122,740,227,513,601,62,539,595,68,527,598,158,431,885,96,759,851,101,713,306,20,286,1221,194,980,1246,218,999
22105000041,388,242,146,313,89,224,315,58,257,326,185,135,531,150,354,526,134,380,237,60,177,509,120,376,515,133,358
2200305-4-O,223,53,170,259,31,228,258,36,222,262,63,192,368,28,333,360,45,301,136,18,118,332,22,306,330,18,308
2200305-4-C,298,100,198,332,57,275,341,64,277,343,111,231,554,105,438,519,109,397,210,48,162,561,96,454,572,111,456
220030005-3,194,37,157,226,28,198,225,29,196,225,47,175,327,29,293,312,48,258,98,14,84,356,36,312,363,28,334
220030002-2,340,92,248,376,32,344,375,34,341,371,95,272,472,34,419,467,38,423,173,38,135,486,33,446,495,47,439
220290005-6,521,44,477,516,31,485,519,18,501,528,53,467,594,25,565,538,59,471,253,20,233,617,10,591,645,17,621
220290001-3,549,109,440,530,77,453,530,71,459,541,116,422,654,114,532,636,140,489,343,52,291,636,77,552,637,82,552
22033002-36,1146,595,551,1025,350,675,1015,321,694,1025,514,504,1245,469,720,1221,445,756,757,315,442,1543,488,1018,1542,531,951
22033001-45,414,412,2,300,258,42,320,244,76,336,324,6,483,473,4,439,407,25,278,271,7,536,492,24,544,525,14
220330001-5,697,681,16,465,389,76,486,367,119,530,507,17,1079,963,71,995,864,104,529,504,25,912,806,66,958,881,54
22033001-78,679,628,51,612,493,119,603,466,137,629,572,53,898,762,122,880,712,158,472,403,69,903,739,132,943,815,109
22033003-51,302,159,143,258,96,162,255,83,172,262,143,118,383,110,240,372,110,250,222,78,144,409,131,267,413,141,256
22033003-17,1030,500,530,952,218,734,957,167,790,950,388,550,1242,302,831,1224,254,939,828,201,627,1249,262,960,1238,348,854
22033001-31,920,899,21,624,566,58,624,547,77,672,655,17,1050,993,40,971,848,96,497,477,20,1163,1030,79,1288,1207,54
22033001-86,817,806,11,589,512,77,598,462,136,646,618,18,1014,974,16,915,837,55,561,549,12,946,857,53,970,913,38
22033001-49,941,396,545,815,190,625,828,155,673,830,326,495,1015,247,720,1021,224,776,721,194,527,1180,260,892,1150,292,828
22033001-13,237,229,8,172,148,24,174,138,36,181,170,11,321,290,19,305,266,30,172,155,17,387,324,52,413,359,43
22033001-24,576,566,10,398,353,45,408,340,68,449,438,10,761,718,32,693,606,70,344,324,20,752,655,61,807,742,50
22033001-42,1194,672,522,1007,359,648,1019,281,738,1007,544,460,1367,472,776,1370,402,937,874,337,537,1541,446,1058,1503,505,955
22115004-3C,19,14,5,12,6,6,13,6,7,13,9,4,44,27,14,43,22,18,9,7,2,67,49,13,65,49,16
221150007-4,32,4,28,25,2,23,27,5,22,26,2,23,50,3,44,45,3,38,15,1,14,48,3,41,50,3,44
22097000001,689,267,422,597,159,438,584,151,433,625,226,395,772,274,486,698,199,485,340,140,200,878,261,595,941,324,607
22097000022,621,539,82,483,333,150,488,338,150,545,438,99,855,655,171,795,455,303,286,231,55,803,528,220,873,668,172
22097000010,538,248,290,479,176,303,476,179,297,494,221,271,742,275,455,713,232,464,255,103,152,770,282,450,804,340,454
22097000011,596,514,82,476,355,121,483,364,119,521,437,84,789,643,128,700,449,229,295,241,54,642,447,161,707,583,115
22097000024,995,591,404,864,378,486,873,383,490,922,487,432,1236,612,597,1151,469,653,467,274,193,1217,511,675,1297,614,655
22097000020,654,487,167,540,301,239,539,314,225,581,391,189,858,544,297,804,417,357,303,199,104,832,506,298,874,571,285
22097000035,1202,730,472,969,439,530,977,439,538,1060,605,451,1455,782,636,1334,545,748,634,330,304,1461,695,701,1531,814,683
22033002-20,252,213,39,193,113,80,191,106,85,198,166,31,308,209,90,289,192,90,171,121,50,362,218,132,395,261,132
220330002-9,398,380,18,347,288,59,346,253,93,372,354,18,519,466,44,498,431,56,357,329,28,432,357,65,455,396,56
22033002-19,344,300,44,308,245,63,304,222,82,316,267,48,478,391,76,457,358,92,246,201,45,466,386,65,494,433,58
221150003-5,275,38,237,250,23,227,270,29,241,275,37,234,376,22,349,332,44,281,150,10,140,387,16,369,403,20,378
221150005-2,221,26,195,214,18,196,211,19,192,218,26,181,304,13,284,281,35,239,81,5,76,313,5,299,334,10,323
22115001-5A,44,7,37,57,8,49,59,10,49,58,10,48,60,7,52,59,3,53,24,7,17,61,3,51,66,5,57
22037000012,675,443,232,484,227,257,493,238,255,539,355,181,714,381,314,645,315,318,396,222,174,775,366,377,809,434,360
22037000011,267,161,106,237,114,123,233,114,119,242,154,88,341,166,164,329,144,181,178,84,94,296,121,165,320,161,154
22037000005,894,367,527,848,213,635,840,196,644,843,309,529,1042,281,740,1001,283,702,520,155,365,1191,283,879,1225,331,879
22037000006,771,502,269,639,229,410,637,252,385,695,435,259,926,372,524,882,366,493,478,188,290,1022,340,654,1030,373,649
22037000010,453,292,161,399,196,203,392,195,197,418,261,155,549,296,240,522,254,258,309,161,148,522,262,236,575,328,233
22065000010,210,135,75,179,84,95,183,86,97,192,107,82,251,125,121,224,106,113,103,42,61,264,137,115,281,160,112
22003005-12,62,41,21,54,34,20,53,33,20,55,36,18,87,60,22,78,47,25,24,18,6,91,55,32,100,67,31
22065000025,313,113,200,303,53,250,306,56,250,316,79,232,367,75,289,352,99,242,134,24,110,385,55,318,396,81,308
22065000024,15,11,4,15,12,3,11,8,3,14,11,3,15,11,4,17,12,4,4,4,0,6,2,4,5,2,3
22065000001,246,70,176,215,37,178,213,35,178,233,54,179,217,44,173,205,43,161,103,17,86,297,69,225,295,60,232
22065000003,191,33,158,196,6,190,200,10,190,207,9,198,244,3,237,236,9,227,0,0,0,265,11,253,264,6,251
22065000004,123,15,108,116,6,110,115,6,109,119,12,107,108,10,98,104,14,89,35,3,32,138,7,129,134,11,121
22127007-2A,184,31,153,222,32,190,224,29,195,234,39,191,277,33,242,269,44,221,78,17,61,281,28,241,288,28,256
221270001-4,37,5,32,27,1,26,27,1,26,28,2,26,44,4,40,45,9,34,9,1,8,36,0,34,37,0,37
221270002-2,10,5,5,20,7,13,17,10,7,20,13,7,30,7,20,30,9,21,11,0,11,24,8,14,24,10,14
22097000018,967,577,390,781,382,399,789,371,418,843,492,348,1208,618,571,1099,461,616,411,233,178,1203,516,652,1270,617,636
22097000045,307,125,182,282,68,214,283,74,209,293,96,196,545,167,357,541,142,373,160,60,100,429,116,289,431,133,289
22097000052,475,94,381,452,42,410,454,40,414,460,67,392,759,69,674,737,72,657,312,28,284,578,54,502,577,61,512
22097000047,335,103,232,343,56,287,343,54,289,352,85,263,647,115,514,623,100,509,237,50,187,437,79,348,447,90,353
22097000051,437,308,129,341,195,146,338,190,148,371,255,114,760,461,275,683,329,321,212,128,84,479,242,197,518,308,195
22097000026,594,411,183,468,245,223,471,237,234,505,328,177,775,433,327,718,322,378,311,166,145,662,351,270,734,476,239
22115002-2A,163,19,144,146,8,138,146,10,136,147,17,127,206,8,194,206,15,186,110,9,101,212,10,199,213,8,203
221150001-2,299,274,25,261,191,70,262,207,55,287,243,44,496,399,83,444,331,89,191,164,27,404,304,72,445,364,64
220450008-2,714,160,554,758,114,644,753,115,638,749,173,571,977,127,822,940,128,736,462,62,400,877,134,719,899,159,724
220450009-4,892,136,756,861,80,781,862,88,774,868,131,733,1046,129,890,1005,112,841,587,67,520,1030,133,875,1066,165,891
220450003-1,433,130,303,399,89,310,386,80,306,398,126,270,622,157,443,606,126,414,256,59,197,579,132,413,600,161,426
220450009-2,1112,211,901,1016,111,905,994,117,877,1031,190,834,1323,215,1092,1222,167,954,623,99,524,1437,157,1253,1491,205,1271
22121000020,428,168,260,338,82,256,338,70,268,342,134,207,411,104,295,407,114,290,245,69,176,557,150,382,556,155,391
22097000013,423,117,306,397,57,340,392,62,330,401,103,296,558,84,465,532,84,433,191,36,155,561,94,460,576,101,472
22097000014,943,359,584,894,227,667,891,224,667,909,330,577,1192,300,864,1152,253,878,463,157,306,1186,275,889,1220,308,906
22109000073,400,76,324,361,26,335,369,33,336,379,86,285,544,45,479,516,68,410,174,13,161,587,38,534,605,48,555
22121000021,409,165,244,398,78,320,401,74,327,386,170,211,544,98,431,521,103,401,283,69,214,504,77,416,521,94,417
220710017-2,294,257,37,221,158,63,227,138,89,246,208,35,351,280,51,330,244,79,188,158,30,375,276,90,397,314,77
220710009-6,550,543,7,355,318,37,373,295,78,402,393,8,798,777,12,740,682,42,256,253,3,853,771,44,950,911,27
220710015-6,314,295,19,313,241,72,304,209,95,318,271,40,437,404,19,413,365,35,173,164,9,394,342,37,416,378,34
22071009-36,340,335,5,268,235,33,272,221,51,285,277,8,450,440,8,434,409,21,158,155,3,499,463,17,534,511,14
2207109-43C,523,513,10,434,397,37,430,364,66,451,441,7,592,567,15,563,500,52,372,360,12,523,480,25,546,518,19
2207109-34A,245,240,5,170,157,13,168,152,16,179,176,0,393,380,7,370,340,15,156,153,3,358,336,8,394,383,6
2207109-44L,363,360,3,308,287,21,313,257,56,327,320,4,468,455,8,453,427,19,267,260,7,380,352,16,422,403,14
2207109-41C,200,71,129,95,34,61,110,33,77,136,48,87,379,203,164,315,118,188,114,31,83,406,181,203,482,251,230
2207115-19B,286,283,3,195,175,20,208,177,31,220,211,4,394,386,3,361,331,24,160,155,5,425,395,10,500,483,8
2207115-18C,405,321,84,306,208,98,307,177,130,321,264,57,505,279,192,493,257,227,270,163,107,601,391,189,594,408,170
2207109-36B,403,399,4,302,277,25,304,260,44,328,323,4,587,573,4,540,501,25,218,214,4,575,519,20,644,622,13
2207115-14G,524,491,33,338,278,60,348,262,86,382,352,26,726,665,49,648,535,90,212,177,35,638,545,45,836,787,40
2207115-18E,766,620,146,574,396,178,586,343,243,610,499,110,925,585,302,899,501,392,553,359,194,954,635,287,978,685,279
22071017-19,437,242,195,359,132,227,375,116,259,366,190,176,591,175,363,571,160,391,257,92,165,761,306,440,753,345,386
220710004-5,212,202,10,132,115,17,136,108,28,149,141,5,279,251,8,265,226,20,126,120,6,297,247,33,331,302,23
22097000046,308,90,218,284,44,240,283,46,237,296,74,221,557,107,437,528,90,429,174,30,144,412,61,334,436,88,345
22065000002,118,24,94,120,16,104,126,17,109,132,21,106,153,30,121,145,28,116,65,6,59,161,27,131,162,26,133
22065000015,339,330,9,256,213,43,266,242,24,286,273,10,448,435,6,381,307,41,154,148,6,365,305,35,385,364,10
22065000023,64,11,53,66,10,56,66,13,53,67,9,58,73,10,63,72,17,55,36,6,30,64,2,61,63,4,59
22065000005,55,11,44,65,4,61,71,4,67,72,11,61,94,3,91,92,11,81,50,4,46,78,2,76,75,2,73
220330002-2,812,730,82,802,608,194,776,539,237,829,725,101,1098,868,195,1064,828,214,703,569,134,1065,841,196,1137,955,165
22033001-23,579,569,10,375,331,44,380,340,40,412,400,8,746,722,13,712,637,52,341,330,11,803,701,62,867,810,40
22033001-17,212,199,13,157,134,23,156,120,36,169,154,13,318,276,28,305,251,48,157,142,15,290,228,45,320,270,45
22033001-41,830,459,371,720,260,460,722,194,528,723,386,335,951,366,512,941,339,576,606,233,373,1142,390,721,1119,439,640
22033001-52,992,572,420,853,337,516,864,295,569,873,496,372,1141,413,640,1113,400,677,725,273,452,1250,502,716,1250,539,680
220710004-9,799,636,163,584,336,248,598,268,330,612,478,131,934,474,349,935,451,452,507,322,185,912,475,391,887,506,352
220710004-8,406,350,56,307,222,85,310,187,123,317,261,56,443,313,99,427,288,128,273,221,52,564,416,117,544,416,112
22071005-16,241,200,41,202,134,68,206,116,90,209,173,36,329,194,90,322,214,97,200,132,68,304,203,95,291,207,78
22071015-12,197,189,8,137,115,22,141,105,36,150,132,18,246,221,23,232,200,29,84,74,10,237,205,20,268,231,32
220710012-2,397,376,21,281,234,47,288,206,82,303,275,27,465,389,54,457,376,75,250,221,29,533,449,66,559,498,55
220710009-8,393,390,3,279,266,13,284,233,51,300,291,8,502,486,3,456,419,19,182,176,6,552,508,25,602,587,11
2207115-18F,858,714,144,647,483,164,654,425,229,684,580,100,946,711,199,907,628,265,523,375,148,1041,793,211,1087,873,190
2207109-40A,373,362,11,282,252,30,297,251,46,309,300,8,531,495,27,498,435,52,242,228,14,485,417,38,540,495,37
2207109-44F,498,497,1,398,371,27,401,357,44,422,416,3,654,634,11,606,560,32,335,331,4,666,608,34,726,706,16
2207109-44Q,368,367,1,291,271,20,296,269,27,311,303,4,523,514,7,504,455,41,222,216,6,517,479,24,563,541,16
2207109-44O,352,347,5,231,208,23,247,217,30,262,256,5,575,558,14,526,476,35,177,171,6,619,548,35,751,731,16
220710003-8,491,485,6,310,280,30,314,270,44,339,327,9,771,710,35,706,637,45,223,216,7,764,668,47,860,802,51
22071004-21,360,231,129,283,95,188,296,73,223,300,179,118,497,167,279,476,127,335,232,79,153,520,149,358,513,188,314
22071017-11,365,362,3,219,203,16,223,197,26,252,244,5,415,401,3,369,348,17,158,154,4,486,439,22,569,551,14
22071008-28,379,342,37,321,248,73,319,224,95,339,291,44,445,339,83,429,319,100,267,223,44,376,279,77,385,304,72
22071013-11,441,423,18,312,273,39,303,228,75,333,309,21,545,482,41,513,424,77,266,249,17,699,609,68,741,678,50
22071009-25,510,506,4,344,311,33,354,302,52,391,382,6,647,622,7,606,559,31,284,270,14,693,617,24,844,812,21
22071017-20,618,362,256,467,178,289,485,131,354,489,299,186,818,271,467,800,216,567,344,140,204,938,300,602,966,383,563
220450001-3,323,186,137,304,103,201,305,108,197,320,155,165,532,221,281,502,161,299,230,90,140,445,197,224,477,250,220
220450004-3,640,523,117,539,354,185,534,371,163,584,450,129,947,736,196,885,533,288,306,216,90,742,502,178,816,626,177
220450006-1,388,230,158,313,131,182,304,157,147,331,199,131,534,292,224,501,214,256,175,79,96,542,265,243,586,331,249
220450004-4,621,344,277,498,196,302,486,200,286,525,262,256,942,453,466,875,344,459,356,137,219,872,390,424,919,471,429
22033003-55,873,853,20,667,562,105,695,555,140,732,703,26,924,782,115,891,727,151,577,495,82,1071,951,91,1098,1017,68
22033001-34,971,441,530,883,185,698,893,155,738,895,350,541,1154,262,814,1150,212,923,818,200,618,1438,343,1075,1378,368,984
22033001-47,1361,726,635,1122,335,787,1149,288,861,1146,579,564,1573,509,960,1562,416,1122,1123,338,785,1487,340,1124,1460,421,1013
22033001-54,1432,1216,216,1119,793,326,1126,755,371,1180,975,205,1642,1240,350,1599,1185,382,1027,768,259,1732,1247,410,1828,1386,415
22033003-23,866,535,331,715,290,425,735,260,475,740,404,335,1119,571,486,1076,498,556,743,391,352,991,420,552,982,478,469
22105000072,565,401,164,459,216,243,440,196,244,464,283,177,738,372,345,699,352,324,300,145,155,765,352,366,803,449,342
22105000125,588,354,234,493,180,313,497,167,330,520,279,240,968,397,530,937,385,530,270,110,160,947,358,552,991,412,564
22105000001,332,258,74,229,126,103,256,155,101,277,208,66,409,282,123,378,220,88,166,90,76,435,285,122,456,312,127
221150005-1,654,101,553,628,49,579,628,47,581,641,95,542,994,67,901,957,108,831,314,28,286,1036,59,963,1072,66,996
22115004-3G,126,63,63,120,36,84,116,40,76,124,53,66,205,83,113,200,72,110,43,20,23,165,54,104,170,56,113
2210500124A,380,113,267,321,36,285,331,31,300,331,79,251,544,62,473,526,69,440,171,21,150,625,55,556,625,71,546
22105000151,870,248,622,742,47,695,756,50,706,748,203,529,1164,103,1020,1127,107,981,375,31,344,1354,121,1190,1365,145,1201
2210500137A,535,146,389,503,47,456,505,50,455,501,146,352,745,101,621,724,105,604,331,39,292,700,80,610,705,96,602
22115007-4A,107,11,96,104,8,96,103,5,98,103,10,93,175,9,161,169,19,148,56,5,51,173,5,164,184,5,175
221150008-2,286,49,237,297,23,274,294,40,254,309,44,258,432,32,386,415,41,362,151,16,135,445,31,400,459,54,394
221150001-1,239,89,150,280,76,204,281,70,211,290,109,176,506,153,334,475,120,338,140,46,94,430,124,291,458,151,305
221150001-3,578,281,297,521,152,369,526,166,360,554,236,313,927,339,560,889,280,571,328,112,216,831,296,492,867,332,521
220610003-3,257,99,158,245,60,185,245,57,188,251,87,161,373,92,267,354,109,242,132,37,95,417,123,271,427,132,285
221270003-3,169,39,130,187,14,173,181,13,168,189,37,152,262,28,225,245,47,187,126,15,111,256,31,220,266,40,226
22097000007,323,58,265,288,28,260,292,25,267,296,47,248,385,45,327,367,47,315,139,21,118,513,36,471,519,43,476
22097000019,478,452,26,315,246,69,321,264,57,354,328,25,636,562,60,550,361,167,225,199,26,586,437,108,662,579,70
22097000012,551,531,20,360,301,59,361,310,51,416,383,26,746,697,39,654,499,125,246,235,11,690,546,98,738,671,55
22033003-14,402,123,279,373,61,312,375,54,321,376,95,281,832,97,697,813,111,682,410,49,361,749,131,604,756,168,576
221150002-3,432,40,392,409,18,391,411,25,386,415,42,364,561,18,530,546,46,495,235,9,226,584,30,544,613,28,577
220610003-1,382,236,146,314,145,169,297,133,164,327,185,139,463,250,203,432,241,182,185,111,74,516,247,240,529,281,239
220610003-4,383,129,254,332,69,263,332,59,273,337,102,235,501,125,361,479,120,353,205,59,146,589,133,440,607,158,441
220610011-3,73,65,8,59,53,6,60,55,5,61,57,3,104,86,15,91,68,18,28,25,3,85,64,10,104,93,10
22105000070,772,334,438,666,135,531,680,129,551,672,249,414,1012,231,734,992,228,733,396,99,297,1033,197,807,1069,220,823
22033001-65,464,325,139,384,193,191,388,169,219,393,257,135,627,292,272,615,303,286,372,213,159,662,338,308,658,368,270
22077000012,504,241,263,467,139,328,469,132,337,487,243,240,518,171,340,502,153,340,311,102,209,562,174,379,576,190,374
22087000052,525,306,219,439,144,295,434,132,302,453,225,221,794,251,521,750,247,484,296,106,190,829,261,528,881,310,555
22087000050,576,482,94,435,268,167,434,254,180,494,397,90,819,538,265,763,477,262,279,187,92,866,507,297,932,621,287
2207109-45A,48,9,39,43,4,39,47,1,46,45,8,37,71,0,69,71,7,64,36,1,35,99,8,87,93,8,84
22071007-21,428,427,1,231,210,21,255,212,43,287,283,4,510,488,10,455,420,25,218,213,5,585,531,27,643,604,26
22071004-18,563,314,249,415,120,295,426,83,343,428,228,197,687,209,422,673,170,494,394,150,244,741,194,533,749,261,467
2207104-17A,359,201,158,305,70,235,319,51,268,326,171,149,435,127,266,442,103,335,228,81,147,527,157,357,512,190,297
22071014-15,310,216,94,253,130,123,261,105,156,267,194,69,403,203,176,401,149,249,246,122,124,431,194,230,410,200,199
22071014-14,324,192,132,224,71,153,231,43,188,238,135,100,414,177,203,407,110,295,253,93,160,412,160,250,404,190,207
220710016-1,289,250,39,226,182,44,223,151,72,230,199,31,364,285,56,348,252,88,182,145,37,386,292,85,385,312,67
220710011-2,474,455,19,301,267,34,312,231,81,327,307,17,589,493,49,564,466,91,239,219,20,634,517,75,654,576,56
22071014-11,257,176,81,184,99,85,197,75,122,202,137,65,355,202,130,350,168,180,199,116,83,401,193,196,404,251,143
220710009-3,400,393,7,262,225,37,274,231,43,293,285,8,523,491,22,490,432,43,205,195,10,611,545,39,670,625,32
22071015-16,355,301,54,261,192,69,265,170,95,277,233,43,542,398,121,523,353,157,292,206,86,551,422,111,560,439,108
22109000016,505,128,377,513,69,444,509,67,442,516,119,397,782,94,664,766,83,661,294,37,257,678,81,580,677,102,562
22109000015,528,126,402,508,51,457,505,48,457,511,106,394,785,89,665,748,88,646,340,22,318,745,77,651,733,89,636
22109000058,218,52,166,183,22,161,187,20,167,190,61,126,300,36,256,284,43,193,126,15,111,360,31,315,383,29,352
22093000014,322,317,5,296,263,33,295,253,42,319,301,15,413,376,31,362,308,46,200,182,18,333,299,24,360,334,19
22093000015,314,277,37,295,233,62,284,214,70,311,279,27,362,288,71,323,251,66,205,162,43,320,251,58,346,299,47
22093000017,574,355,219,548,225,323,562,224,338,592,375,215,705,312,371,657,295,346,327,161,166,673,246,404,715,292,408
22093000018,683,384,299,630,233,397,640,233,407,676,380,286,707,279,411,670,277,386,405,186,219,682,257,410,721,292,425
220710002-1,406,314,92,309,197,112,318,161,157,320,243,71,612,390,179,593,342,232,245,173,72,500,275,216,498,289,185
220710017-4,288,274,14,214,183,31,211,163,48,231,214,14,348,301,30,315,263,44,172,158,14,367,312,41,376,332,37
22109000056,224,37,187,175,16,159,180,16,164,182,27,154,268,25,237,262,24,224,111,6,105,336,24,309,345,22,319
22097000025,663,640,23,494,421,73,489,435,54,578,542,36,967,904,53,849,626,192,332,306,26,839,640,132,958,866,56
22097000032,644,248,396,544,144,400,548,152,396,570,202,368,800,266,515,742,194,531,269,100,169,876,248,607,920,292,616
221270003-2,178,31,147,196,20,176,192,25,167,204,40,162,283,16,262,275,41,230,135,9,126,246,16,226,250,20,227
220610006-1,775,395,380,684,162,522,698,148,550,711,270,436,1169,316,758,1144,310,797,483,135,348,1129,308,761,1130,357,728
220610004-1,223,36,187,222,17,205,228,21,207,229,31,198,320,38,275,305,37,259,133,12,121,338,39,291,339,44,287
22009009-1A,202,135,67,176,85,91,179,85,94,199,120,78,219,117,96,205,92,110,127,84,43,235,99,119,258,122,128
220090010-2,496,353,143,373,188,185,375,174,201,432,290,134,652,358,283,581,272,278,250,145,105,634,338,267,685,419,245
22039003032,134,63,71,112,26,86,107,33,74,125,53,71,165,45,116,140,30,104,56,6,50,145,40,103,152,44,104
220090002-5,182,75,107,200,34,166,199,28,171,212,74,138,243,38,198,223,40,176,121,31,90,235,21,203,249,41,205
220130007-2,148,90,58,129,57,72,130,58,72,139,80,59,193,102,87,178,102,75,107,68,39,197,100,92,209,115,90
220130005-3,133,24,109,125,12,113,126,10,116,125,18,106,162,13,148,162,22,139,89,6,83,192,26,165,190,26,164
22039003031,152,42,110,127,28,99,124,32,92,139,42,97,237,39,196,229,33,188,68,13,55,202,41,157,211,53,154
22039001120,243,226,17,114,90,24,118,87,31,166,148,18,286,257,24,239,171,57,87,75,12,211,161,35,260,226,27
22039001110,425,425,0,300,246,54,293,268,25,385,373,9,524,507,8,481,366,90,167,162,5,387,310,35,458,431,14
22109000027,237,57,180,197,20,177,192,13,179,197,52,145,344,16,311,335,26,291,115,6,109,370,49,314,384,42,339
22109000017,429,90,339,412,39,373,411,33,378,419,95,321,630,68,532,617,75,524,238,22,216,653,61,572,667,84,570
22109000018,686,226,460,649,118,531,652,113,539,648,219,420,936,174,727,907,165,712,350,61,289,1073,219,812,1069,234,816
22109000071,241,171,70,199,123,76,196,127,69,219,160,59,344,240,95,317,202,98,100,74,26,348,207,117,365,244,119
22109000053,353,146,207,310,72,238,312,63,249,327,128,195,490,121,359,454,106,312,152,31,121,581,92,458,632,141,479
22071008-15,648,638,10,507,465,42,518,466,52,542,529,10,706,669,23,675,625,31,381,371,10,736,676,28,807,769,34
2207109-41D,193,143,50,145,90,55,162,86,76,165,121,40,325,205,104,291,125,162,133,84,49,365,172,169,407,205,199
2207107-28A,379,378,1,272,241,31,290,242,48,299,291,5,452,426,20,413,373,39,206,200,6,432,384,24,504,470,18
2207109-43M,332,332,0,209,197,12,207,194,13,221,220,1,620,613,3,582,544,23,143,143,0,581,524,32,654,637,5
2207109-44M,363,341,22,367,344,23,366,310,56,383,366,17,411,367,37,400,344,44,333,309,24,333,272,52,348,294,47
220710015-8,213,208,5,170,148,22,172,125,47,187,183,3,250,237,11,243,217,20,122,117,5,295,270,15,321,312,8
22071009-45,314,119,195,243,60,183,246,50,196,251,107,140,439,77,356,438,76,356,205,38,167,582,116,439,581,139,439
220710013-3,399,362,37,270,213,57,282,184,98,293,261,29,433,338,65,423,294,120,250,214,36,385,287,77,393,317,69
22071007-35,534,519,15,418,371,47,427,353,74,435,420,14,658,623,23,616,563,45,321,309,12,692,619,41,739,683,39
220710006-8,347,324,23,266,227,39,277,199,78,285,261,18,433,361,39,434,346,76,273,234,39,412,336,60,402,327,64
2206300035A,404,150,254,343,71,272,344,70,274,356,129,223,600,124,452,581,126,436,301,88,213,536,105,422,559,117,428
220710007-1,455,415,40,289,238,51,304,215,89,310,278,31,591,458,89,581,442,119,336,286,50,550,440,95,546,454,84
22071ZZZZZZ,0,0,0,0,0,0,0,0,0,0,0,0,0,0,0,0,0,0,0,0,0,0,0,0,0,0,0
2207109-44P,644,603,41,513,458,55,509,407,102,541,514,24,751,662,75,734,625,104,498,463,35,742,618,99,784,675,104
22071015-18,263,201,62,208,126,82,219,98,121,224,175,49,334,205,107,317,160,148,149,89,60,338,208,98,376,269,103
2207115-15B,311,217,94,237,144,93,242,116,126,248,183,61,352,177,152,339,156,175,212,106,106,329,186,126,340,213,120
22071007-9A,187,184,3,149,137,12,149,126,23,157,154,3,272,261,5,246,223,10,86,85,1,231,204,10,275,269,5
22071007-33,323,287,36,252,206,46,257,197,60,257,230,26,371,301,54,361,277,74,186,160,26,384,284,81,406,330,72
2207115-15A,371,286,85,305,199,106,309,169,140,313,242,71,513,361,127,503,339,149,252,172,80,438,288,130,471,342,117
220710015-9,249,244,5,199,172,27,200,161,39,213,202,8,325,296,20,306,264,36,137,120,17,339,299,20,397,368,24
220450010-4,940,270,670,854,136,718,851,159,692,884,242,637,1225,246,955,1135,183,790,506,76,430,1263,234,1003,1335,256,1068
22107000011,242,68,174,333,37,296,321,36,285,324,66,256,309,33,271,284,36,244,186,25,161,336,29,306,341,43,296
2210700011A,56,31,25,68,33,35,76,32,44,77,51,26,89,41,45,77,43,33,79,41,38,91,35,49,99,43,54
22039004030,430,82,348,412,29,383,411,46,365,426,79,343,495,52,436,470,60,402,184,11,173,543,53,483,562,56,503
22039003030,409,221,188,323,112,211,319,121,198,356,174,178,525,182,319,465,121,320,123,43,80,508,169,309,557,215,324
22039004001,349,48,301,333,16,317,325,32,293,348,54,290,477,24,439,446,44,387,102,10,92,503,31,454,518,29,487
22039001060,143,43,100,162,22,140,162,20,142,162,50,112,188,12,169,177,15,155,93,6,87,156,12,136,164,24,137
22039001091,217,122,95,162,52,110,173,63,110,201,107,90,265,135,122,230,83,131,102,53,49,154,56,80,181,82,92
22009009-2A,211,105,106,178,48,130,179,50,129,187,95,91,240,73,158,220,59,158,133,46,87,246,67,172,264,92,170
220130003-5,46,16,30,38,9,29,40,9,31,42,11,31,54,17,37,53,14,39,31,10,21,64,12,52,67,15,52
220130003-6,26,13,13,20,4,16,20,7,13,22,10,12,25,5,20,24,5,19,17,2,15,31,9,22,31,8,22
220130003-2,302,227,75,248,147,101,250,163,87,267,183,81,354,245,101,329,225,92,187,123,64,311,219,84,315,224,87
220130007-1,189,110,79,166,86,80,174,88,86,189,106,83,221,126,93,188,104,80,144,84,60,192,92,94,210,107,100
220130007-3,181,97,84,161,78,83,167,77,90,176,95,81,212,99,110,203,95,108,132,74,58,233,101,131,248,118,130
220130007-4,392,244,148,351,193,158,353,207,146,374,223,148,457,251,197,442,232,200,283,165,118,510,282,217,517,299,217
22107000017,197,61,136,207,37,170,203,44,159,233,60,173,264,58,202,226,58,166,125,35,90,234,49,182,238,55,180
22107000010,201,72,129,188,49,139,192,50,142,200,68,132,208,59,149,207,68,139,110,40,70,219,43,174,220,46,174
220090010-4,505,468,37,352,257,95,346,251,95,422,378,43,580,490,80,514,401,94,242,216,26,505,371,91,574,482,83
22009010-2A,380,96,284,354,21,333,355,17,338,343,70,269,444,28,407,423,44,373,234,23,211,433,40,387,439,44,393
220130003-1,255,224,31,209,178,31,200,165,35,230,205,24,327,275,45,296,250,45,129,108,21,253,213,32,300,263,29
22039002020,224,70,154,204,46,158,210,48,162,213,68,144,300,58,241,282,47,229,77,9,68,346,55,273,373,75,297
22039002040,388,196,192,295,89,206,297,91,206,308,128,179,424,139,273,401,118,277,122,60,62,477,157,301,508,187,320
22017000040,227,225,2,161,136,25,156,139,17,176,170,5,344,332,8,298,263,21,140,138,2,298,276,14,320,310,6
22017000094,724,423,301,565,237,328,572,241,331,600,307,291,1039,546,464,977,507,443,456,206,250,913,498,387,925,532,376
22017000151,132,23,109,115,10,105,117,17,100,117,20,96,173,39,134,164,32,130,112,14,98,215,45,167,220,45,174
22017000145,34,17,17,33,12,21,33,13,20,35,16,19,50,22,27,46,22,23,24,13,11,55,16,38,58,20,38
22017000030,816,776,40,593,454,139,600,467,133,656,621,29,1013,939,57,962,854,86,557,529,28,906,789,76,958,867,77
22017000003,414,412,2,283,229,54,275,239,36,313,311,2,544,531,8,513,492,7,277,275,2,473,447,9,508,490,9
22017000025,614,582,32,380,295,85,375,311,64,414,384,23,905,821,64,822,686,110,298,280,18,903,792,67,961,883,57
221150001-4,47,26,21,45,18,27,43,16,27,44,21,23,72,27,37,69,21,45,16,7,9,75,35,31,90,49,37
220610006-2,92,32,60,93,15,78,94,13,81,96,22,74,108,13,90,108,15,91,56,14,42,117,8,109,122,19,103
220610001-2,242,203,39,199,127,72,192,127,65,206,147,57,350,245,97,322,221,99,135,100,35,316,206,98,337,239,91
220610002-1,381,367,14,282,233,49,272,226,46,299,272,25,574,511,53,506,435,54,191,165,26,472,370,70,513,446,56
220610005-4,463,131,332,439,41,398,441,46,395,450,98,351,559,55,483,541,75,459,226,29,197,651,86,555,659,115,532
2210500137C,940,295,645,859,78,781,854,58,796,846,226,614,1284,117,1138,1240,137,1083,521,59,462,1345,95,1200,1359,114,1217
22105000123,685,345,340,548,132,416,554,118,436,568,265,300,961,278,655,905,251,616,312,99,213,1014,260,719,1041,305,722
22071011-17,348,345,3,195,179,16,211,188,23,230,219,3,479,465,8,417,379,25,145,140,5,556,497,27,631,604,11
2207109-43A,614,606,8,475,432,43,494,427,67,510,498,11,738,702,24,698,627,50,335,315,20,717,639,41,818,781,35
2207109-43F,308,300,8,251,229,22,251,209,42,261,248,10,357,331,23,333,296,32,171,156,15,407,385,20,424,406,18
22071007-26,443,439,4,299,277,22,309,274,35,324,314,4,507,477,16,475,413,41,250,239,11,454,416,19,507,483,13
22071008-30,435,430,5,319,292,27,326,275,51,339,331,5,597,560,26,567,499,45,244,233,11,633,574,37,681,642,29
22071009-19,407,390,17,247,231,16,253,227,26,261,247,11,481,445,14,469,411,43,196,190,6,522,470,32,557,523,24
22071012-17,524,507,17,362,308,54,371,295,76,391,383,8,667,603,41,634,535,68,265,248,17,633,524,69,693,622,53
220710003-1,767,612,155,532,344,188,547,279,268,555,421,124,1026,630,332,997,558,420,487,325,162,962,564,371,977,639,311
220710001-2,212,184,28,162,129,33,160,109,51,160,142,17,304,240,46,297,219,62,142,118,24,312,249,54,293,233,48
220710010-6,418,397,21,307,278,29,323,259,64,337,315,21,561,489,47,543,472,57,312,296,16,516,424,63,569,511,51
22039001150,331,71,260,295,17,278,300,32,268,323,85,235,397,53,335,375,45,324,141,29,112,387,30,345,407,51,353
22039003060,253,233,20,199,156,43,199,157,42,245,213,31,251,203,40,228,148,73,94,78,16,271,200,59,314,254,52
22039003040,520,134,386,497,73,424,486,84,402,519,129,386,656,114,525,607,101,494,227,46,181,657,95,543,703,117,577
22039001130,431,80,351,391,26,365,386,29,357,407,85,320,488,36,440,442,33,402,178,24,154,433,28,388,452,34,415
220090005-1,449,119,330,404,32,372,406,21,385,431,89,341,585,33,528,531,55,459,233,46,187,573,37,515,585,43,532
22071004-15,618,394,224,472,229,243,484,173,311,493,329,161,784,276,414,777,241,524,362,158,204,810,337,458,809,368,425
220450010-3,896,189,707,876,105,771,863,108,755,895,188,699,1187,162,995,1125,162,847,529,70,459,1199,172,996,1226,183,1031
22023000013,202,58,144,194,14,180,192,20,172,204,65,137,250,20,226,256,15,235,94,22,72,286,27,249,290,34,249
22023000017,156,49,107,160,16,144,158,20,138,160,56,104,181,23,152,180,12,166,106,26,80,146,21,123,141,21,119
22017000127,262,52,210,216,18,198,215,24,191,222,35,187,330,52,270,319,44,274,209,26,183,365,54,307,363,59,301
22017000125,735,368,367,606,211,395,601,198,403,631,289,337,1104,431,654,1004,396,586,456,206,250,996,360,608,1047,405,628
22017000052,486,476,10,292,248,44,287,253,34,320,307,12,717,680,25,644,587,43,235,226,9,724,654,47,783,737,30
22017000077,734,246,488,608,133,475,595,121,474,607,191,410,972,215,712,940,204,725,533,116,417,968,245,695,969,263,690
22017000122,1605,1397,208,1281,935,346,1266,947,319,1332,1155,170,1931,1561,324,1841,1484,327,1108,930,178,1760,1380,330,1810,1486,307
22017000084,373,320,53,284,200,84,280,201,79,300,253,46,476,376,92,458,365,87,275,230,45,440,344,85,449,363,81
22017000047,681,447,234,561,274,287,563,300,263,577,362,215,915,514,373,891,499,370,452,261,191,841,483,335,847,502,331
220150002-6,221,157,64,109,54,55,109,58,51,127,80,46,379,258,114,355,232,118,93,59,34,424,280,120,467,329,130
220150003-4,541,305,236,430,126,304,438,140,298,466,214,248,750,407,318,678,362,303,332,180,152,851,418,413,913,461,429
22009002-2A,176,47,129,200,27,173,205,23,182,213,52,157,225,39,179,213,31,180,86,14,72,237,27,203,250,30,217
220130002-2,209,160,49,195,116,79,206,139,67,218,152,62,286,195,91,259,155,98,108,74,34,183,109,64,207,130,64
221270001-3,159,39,120,155,21,134,155,30,125,154,31,123,185,34,145,162,29,126,75,9,66,211,39,166,218,51,165
22097000004,790,182,608,692,73,619,693,75,618,706,142,562,941,137,790,892,120,753,358,56,302,1089,134,940,1125,161,957
220710005-8,230,222,8,166,157,9,168,140,28,172,166,2,299,273,14,284,243,24,135,130,5,351,311,20,367,345,18
2207107-27B,272,272,0,159,151,8,157,138,19,168,164,1,328,316,8,316,285,20,119,118,1,485,454,14,519,508,6
2207115-18B,478,439,39,335,284,51,345,270,75,347,317,26,639,561,68,611,513,86,237,197,40,741,642,69,777,693,77
2207109-43N,252,248,4,198,185,13,195,176,19,203,198,4,397,387,7,371,352,12,161,158,3,423,404,10,454,441,11
22071007-41,280,199,81,239,116,123,252,100,152,252,179,73,347,177,146,333,156,175,204,107,97,494,249,235,492,284,201
22071009-30,394,333,61,289,211,78,291,188,103,298,253,44,575,383,114,542,363,171,244,162,82,510,283,206,533,325,170
22071008-12,583,576,7,361,334,27,368,316,52,411,402,5,772,740,10,695,641,31,255,246,9,787,694,29,940,909,18
220710008-2,389,370,19,326,297,29,323,269,54,326,305,15,498,429,28,473,418,38,340,321,19,496,448,38,465,428,32
220450003-2,677,190,487,623,122,501,623,125,498,650,174,467,871,180,665,832,148,614,390,68,322,771,175,559,803,212,578
22071009-44,368,364,4,286,262,24,295,257,38,315,311,1,375,363,11,356,332,23,239,235,4,397,365,14,413,398,11
2207109-44J,327,305,22,248,214,34,254,206,48,264,245,18,472,429,34,452,387,59,227,202,25,452,391,39,494,454,34
220710013-5,447,400,47,310,243,67,308,202,106,318,271,46,494,387,75,475,337,124,266,221,45,459,351,93,449,350,84
2207109-40C,240,225,15,208,183,25,213,166,47,226,212,11,313,289,22,300,256,41,148,136,12,319,267,38,357,314,34
220710017-5,385,366,19,259,211,48,273,201,72,278,246,31,509,445,35,472,385,66,235,216,19,512,436,59,510,451,53
22071011-14,483,482,1,265,239,26,273,241,32,310,303,4,685,679,3,615,575,24,196,190,6,847,774,23,929,906,13
220710006-1,291,237,54,225,164,61,230,136,94,242,201,41,414,277,108,407,253,134,248,176,72,508,364,122,494,368,119
220290005-3,231,38,193,262,20,242,258,21,237,272,37,231,293,21,265,264,32,224,103,12,91,377,16,360,384,13,371
22065000007,177,28,149,175,12,163,177,11,166,190,20,170,212,17,188,210,28,181,84,3,81,203,16,182,201,21,178
220030005-5,157,22,135,174,15,159,174,18,156,176,30,146,218,10,206,208,24,172,82,12,70,246,3,241,247,3,243
22071009-10,558,547,11,372,346,26,388,332,56,401,392,6,739,693,16,677,612,40,286,271,15,758,675,39,824,769,39
22071015-15,420,397,23,280,238,42,284,206,78,299,280,18,534,467,47,502,427,61,200,169,31,637,551,49,746,683,50
2207114-24A,475,420,55,351,264,87,353,226,127,356,311,42,564,418,93,543,377,160,321,267,54,532,403,122,523,408,101
220710015-5,235,228,7,166,145,21,167,132,35,178,173,5,276,260,12,241,209,26,100,95,5,326,276,37,346,306,27
2207117-13A,281,281,0,172,158,14,183,162,21,190,189,0,358,352,5,318,300,12,132,131,1,325,306,10,382,375,3
22071008-21,350,329,21,280,225,55,287,190,97,288,265,22,401,304,72,393,294,90,262,215,47,299,241,46,304,256,40
22071007-15,368,363,5,273,255,18,278,234,44,289,287,2,460,420,15,429,390,30,234,223,11,453,412,27,468,436,22
22071013-12,289,277,12,201,178,23,203,147,56,210,203,7,377,324,27,359,297,54,194,182,12,415,378,30,416,388,22
220710013-9,329,256,73,248,158,90,249,116,133,252,179,73,491,289,164,483,274,205,243,165,78,428,256,162,418,276,138
220710005-1,146,116,30,131,81,50,132,65,67,127,95,32,217,146,64,212,130,80,107,73,34,233,152,70,230,165,63
2207115-17B,361,280,81,301,186,115,302,165,137,311,240,70,456,280,156,447,261,178,203,125,78,554,369,171,565,388,165
22109000049,237,194,43,192,132,60,187,131,56,213,170,40,310,244,58,284,200,73,113,88,25,274,187,68,315,254,58
22109000090,501,95,406,515,41,474,516,35,481,505,100,403,668,50,589,653,50,593,320,25,295,642,61,567,636,74,549
22109000069,739,179,560,750,72,678,752,62,690,764,172,588,1038,115,884,1012,84,906,493,50,443,874,93,763,866,102,752
22109000001,452,212,240,397,114,283,394,104,290,404,166,233,660,209,421,639,189,422,214,69,145,780,225,513,809,262,532
22017000039,217,216,1,166,135,31,163,141,22,184,183,0,295,286,4,282,265,5,125,124,1,304,284,8,318,311,1
22017000079,410,309,101,354,227,127,353,226,127,358,259,92,530,338,175,502,325,169,209,137,72,550,375,162,564,403,152
22017000091,938,531,407,736,271,465,733,284,449,748,369,371,1436,642,749,1376,597,755,609,226,383,1384,706,634,1401,757,619
22017000129,757,381,376,568,212,356,574,214,360,573,280,290,1186,457,653,1144,438,665,454,183,271,1122,511,577,1112,544,539
22017000106,728,509,219,524,262,262,518,280,238,552,354,189,943,593,336,910,552,336,439,283,156,932,567,333,965,609,343
22017000031,401,393,8,262,199,63,259,219,40,305,296,8,604,565,17,550,491,41,274,260,14,523,462,38,539,482,36
22033003-30,894,291,603,910,145,765,923,121,802,916,281,632,1697,245,1411,1649,280,1346,1001,136,865,1508,233,1241,1521,288,1220
22033002-16,879,873,6,662,578,84,664,523,141,722,705,11,983,951,17,928,849,61,633,618,15,1080,996,52,1124,1071,38
2203301-107,478,344,134,386,221,165,387,215,172,398,285,107,530,251,212,523,255,249,288,178,110,543,260,249,543,288,241
22033001-73,1041,755,286,918,559,359,898,465,433,935,671,263,1073,716,312,1091,689,384,892,597,295,973,560,388,969,594,360
22033001-35,560,391,169,471,229,242,474,185,289,484,310,174,630,279,271,619,257,324,427,210,217,704,285,380,688,331,321
22033001-15,939,933,6,648,535,113,699,539,160,751,738,10,1113,1099,6,1020,933,63,631,619,12,1150,1029,70,1231,1182,39
22033001-16,441,438,3,339,295,44,353,292,61,394,385,6,592,571,11,543,484,48,325,316,9,604,545,41,638,589,36
22033001-11,664,651,13,507,450,57,503,404,99,557,547,6,642,627,13,587,553,28,331,327,4,784,708,46,849,820,20
22033002-18,961,417,544,826,166,660,825,165,660,833,315,511,1434,516,855,1387,487,882,824,347,477,1611,351,1217,1591,413,1135
22033002-28,939,645,294,801,446,355,800,412,388,820,547,266,1202,666,498,1160,636,501,625,370,255,1330,691,595,1364,791,551
220710013-4,514,437,77,358,250,108,371,209,162,386,315,70,586,417,125,561,362,189,356,260,96,671,457,177,640,469,137
220790000C1,99,96,3,87,72,15,87,73,14,94,81,13,184,150,30,167,127,37,61,55,6,138,100,32,154,121,25
220790000C2,318,315,3,210,192,18,201,193,8,223,219,3,409,398,6,365,305,33,162,162,0,383,343,15,424,405,11
22079000S13,868,226,642,690,86,604,694,84,610,704,166,531,1061,125,906,1007,137,844,367,62,305,1127,116,981,1133,138,975
220790000C6,540,537,3,372,343,29,374,359,15,408,405,2,651,629,7,554,506,30,273,271,2,597,532,45,639,620,8
220790000N2,269,219,50,232,132,100,245,150,95,253,179,74,397,266,120,362,223,131,154,114,40,337,196,110,368,251,111
220290004-1,164,67,97,167,39,128,167,43,124,174,59,108,216,51,159,194,51,138,84,24,60,246,76,164,249,80,168
220290005-5,403,28,375,380,18,362,397,20,377,420,37,378,500,18,479,468,31,429,192,8,184,505,19,479,521,16,499
220030002-6,200,61,139,223,31,192,222,22,200,228,75,153,303,37,254,295,38,253,111,22,89,307,20,280,311,18,292
220030004-3,272,53,219,303,31,272,298,47,251,309,77,226,388,29,344,370,38,325,119,19,100,389,28,348,404,29,371
220690001-1,322,291,31,287,227,60,285,225,60,309,273,33,436,354,69,413,334,63,147,116,31,346,242,61,376,305,57
22017000081,695,632,63,442,325,117,453,356,97,499,446,51,1146,1006,124,1011,842,137,405,348,57,937,770,121,1003,895,99
22017000073,794,793,1,533,448,85,533,447,86,593,589,1,991,975,11,904,837,34,482,480,2,1000,940,25,1032,1008,5
22017000054,568,553,15,390,310,80,376,303,73,432,416,14,826,794,23,769,704,42,362,349,13,625,568,31,682,641,22
22017000135,736,262,474,627,160,467,626,160,466,640,218,420,971,256,699,936,250,664,498,144,354,1001,271,710,1010,288,705
22017000051,665,654,11,456,392,64,453,399,54,494,483,9,877,855,15,825,770,36,451,445,6,823,764,28,868,828,26
22017000029,328,326,2,256,199,57,255,213,42,279,270,9,542,522,11,515,480,27,253,251,2,417,391,12,431,407,14
22017000057,423,419,4,232,206,26,241,216,25,263,255,8,588,583,1,541,496,29,247,246,1,522,478,21,565,546,12
220450007-2,680,169,511,636,84,552,636,72,564,646,140,500,894,109,755,865,102,701,463,58,405,805,119,670,811,123,672
220450007-4,804,186,618,750,86,664,755,86,669,771,165,598,1080,129,912,1071,123,861,553,70,483,957,142,788,956,150,785
220450007-1,450,151,299,427,81,346,428,69,359,424,129,295,616,111,469,607,98,478,344,53,291,571,96,456,586,136,441
22079000C10,189,183,6,139,118,21,139,121,18,150,143,6,233,214,16,207,174,28,78,77,1,199,169,15,229,218,11
22079000S25,715,306,409,513,151,362,520,166,354,564,227,333,772,283,463,684,213,450,212,89,123,885,282,572,922,321,573
22079000S16,620,118,502,589,64,525,587,61,526,589,95,492,815,92,712,776,98,662,284,41,243,987,84,893,999,109,878
22079000S15,556,182,374,500,101,399,492,88,404,513,149,364,683,155,506,662,159,483,308,89,219,710,134,564,716,163,544
22079000S14,192,54,138,172,24,148,168,22,146,173,41,130,232,43,183,217,39,177,109,17,92,229,24,197,241,38,203
22079000C22,165,43,122,156,14,142,153,5,148,161,36,125,196,22,163,189,12,173,91,13,78,219,25,192,231,35,193
22079000C24,406,323,83,397,272,125,387,252,135,405,295,106,531,375,148,503,335,152,258,200,58,462,301,145,489,342,140
220790000N3,309,209,100,245,108,137,245,117,128,268,165,99,482,239,229,447,214,214,133,86,47,469,200,227,496,255,235
220790000S4,481,420,61,336,250,86,338,260,78,370,305,60,573,451,115,485,336,126,293,242,51,552,413,114,602,492,105
22119000005,145,33,112,137,23,114,138,24,114,137,30,106,213,37,174,205,46,157,92,20,72,212,36,165,225,53,166
22119000018,740,656,84,580,430,150,571,457,114,641,553,84,1002,847,145,952,758,171,411,349,62,737,583,132,787,643,130
22119000015,261,60,201,239,31,208,236,33,203,242,42,200,302,56,245,299,65,229,140,36,104,386,68,315,383,66,313
22119000011,624,77,547,632,46,586,626,51,575,640,79,555,835,52,774,788,92,690,372,46,326,882,50,817,903,64,837
22119000009,488,103,385,442,57,385,450,67,383,457,85,362,669,86,570,636,122,510,260,37,223,754,68,665,768,78,688
22119000028,522,170,352,518,74,444,513,79,434,528,146,377,726,112,581,711,142,560,358,66,292,668,132,518,669,137,519
22017000087,715,563,152,545,347,198,532,359,173,568,439,124,992,738,224,925,675,234,408,321,87,965,707,231,997,759,224
2201700005B,597,576,21,380,303,77,377,315,62,410,385,21,877,820,47,796,706,76,318,302,16,777,686,63,853,774,60
2201700005A,514,496,18,327,261,66,324,271,53,351,331,17,762,707,41,702,610,72,273,259,14,679,590,56,735,664,51
22017000061,469,465,4,310,253,57,292,253,39,341,339,1,646,634,4,575,532,27,293,292,1,513,478,13,567,543,16
22017000149,237,89,148,221,45,176,219,47,172,229,80,149,340,95,242,317,92,218,188,57,131,352,102,244,364,112,251
2207300056A,519,57,462,433,31,402,429,26,403,435,46,388,689,31,647,667,52,604,237,9,228,660,26,627,680,24,651
22073000022,690,680,10,428,365,63,448,406,42,490,477,9,870,845,14,812,739,57,327,324,3,771,661,55,850,804,25
22073000053,619,88,531,534,55,479,532,50,482,539,70,468,770,59,685,749,73,668,296,18,278,893,79,799,891,93,791
22073000048,446,76,370,320,32,288,327,33,294,333,56,276,732,72,642,665,91,558,172,13,159,684,85,588,703,78,616
22073000065,103,103,0,81,67,14,78,71,7,89,84,4,176,170,3,148,131,13,55,54,1,126,104,12,144,129,5
22073000073,426,354,72,374,268,106,367,272,95,374,304,69,605,445,141,586,408,164,311,245,66,599,420,146,632,484,144
22119000031,285,52,233,275,32,243,275,29,246,277,51,226,416,52,351,410,71,334,238,28,210,437,64,366,434,64,363
22119000012,342,208,134,308,113,195,336,138,198,346,185,158,493,267,220,463,232,219,342,216,126,597,285,297,625,309,304
22073000004,906,434,472,739,258,481,751,261,490,763,350,411,1054,411,609,1028,361,650,384,146,238,1029,313,691,1072,381,684
22073000063,449,290,159,314,147,167,314,143,171,323,191,131,670,312,318,645,303,326,187,97,90,656,339,280,672,377,271
22119000033,472,151,321,458,86,372,453,90,363,471,134,332,657,155,494,641,154,477,322,80,242,530,108,415,550,124,420
22119000029,417,101,316,403,37,366,410,29,381,414,68,346,496,52,436,497,62,432,294,44,250,504,35,465,505,48,453
22079000C42,803,261,542,659,117,542,641,117,524,676,220,455,995,202,751,959,167,775,441,121,320,939,186,733,956,243,697
22079000C34,353,142,211,315,63,252,320,61,259,329,107,219,495,146,330,478,136,320,184,48,136,489,137,343,500,169,323
22079000S24,137,42,95,110,22,88,111,22,89,112,34,78,144,25,112,133,20,106,52,12,40,174,35,132,180,50,128
22079000S22,463,88,375,385,28,357,389,28,361,393,62,330,536,59,465,514,55,445,195,27,168,659,78,569,653,88,558
22017000015,438,281,157,350,190,160,341,178,163,353,228,123,722,395,261,692,389,271,295,191,104,715,410,267,742,456,259
22017000156,244,133,111,175,53,122,180,57,123,196,94,101,343,161,181,313,153,160,174,71,103,361,170,179,383,190,189
22017000142,377,45,332,332,29,303,328,24,304,341,41,297,523,31,482,495,55,439,255,29,226,542,34,503,552,45,506
22017000032,369,336,33,245,181,64,242,185,57,273,239,32,472,407,55,441,355,75,174,145,29,414,358,43,447,397,45
22017000085,630,430,200,503,283,220,515,281,234,530,338,190,918,519,375,875,501,359,441,297,144,772,438,314,780,440,327
22017000008,532,332,200,398,182,216,390,170,220,414,246,165,783,355,387,758,357,375,318,163,155,842,439,359,856,485,351
22071008-14,264,260,4,189,175,14,188,162,26,200,194,2,357,342,9,321,293,15,139,136,3,385,358,15,435,421,8
220710014-5,325,245,80,227,140,87,234,112,122,236,174,59,446,270,150,421,216,201,242,160,82,372,224,142,377,246,125
22071012-14,431,414,17,275,242,33,291,239,52,306,296,9,554,489,30,507,425,62,252,240,12,532,461,63,567,511,50
22113000001,649,97,552,652,41,611,654,34,620,660,87,568,904,71,805,890,78,795,466,60,406,1017,61,919,1050,70,965
22113000029,350,77,273,314,43,271,308,41,267,321,82,235,471,60,395,454,45,393,267,33,234,400,42,340,411,55,349
2211300057B,100,12,88,96,3,93,95,2,93,97,9,88,141,13,121,132,8,117,47,2,45,168,10,156,176,11,164
22113000051,398,77,321,369,51,318,354,43,311,377,75,297,539,78,446,524,46,440,267,43,224,568,60,487,592,92,491
22083000018,448,418,30,359,241,118,371,244,127,443,368,72,634,497,119,576,409,148,244,210,34,494,373,80,547,470,64
22083000027,364,51,313,400,17,383,410,19,391,414,26,385,453,32,412,428,44,380,203,12,191,547,38,501,561,38,520
22119000039,658,283,375,614,196,418,609,191,418,617,219,391,792,285,499,761,280,473,358,138,220,943,300,621,959,307,640
22027000001,631,236,395,494,101,393,506,107,399,536,154,376,694,231,456,640,190,434,283,69,214,702,189,505,740,240,491
220790C38-B,567,268,299,490,165,325,482,150,332,503,223,277,801,276,500,766,256,491,279,93,186,694,246,431,713,282,412
22079000C39,192,151,41,133,71,62,125,77,48,137,105,31,246,161,81,222,127,89,76,55,21,240,135,88,254,173,76
22119000006,431,356,75,315,199,116,322,225,97,354,268,85,580,425,140,550,385,150,248,197,51,586,398,162,644,485,150
22017000143,824,184,640,710,71,639,711,88,623,743,138,593,1139,173,946,1083,181,882,566,75,491,1192,206,970,1241,255,983
22017000012,530,190,340,446,88,358,448,89,359,456,134,317,757,154,558,729,156,554,373,111,262,733,195,518,731,215,496
22017000016,652,235,417,537,119,418,543,94,449,553,188,362,863,191,632,846,193,634,483,109,374,876,226,632,879,270,586
22017000060,420,416,4,296,254,42,301,270,31,329,323,6,598,589,2,559,524,24,253,252,1,499,460,21,546,525,14
22017000100,677,610,67,463,346,117,454,344,110,487,420,64,874,733,118,832,670,133,356,310,46,835,674,125,869,731,126
22035000019,240,121,119,210,69,141,216,71,145,222,78,140,232,64,165,201,63,135,99,36,63,295,104,186,294,110,181
220430007-1,181,44,137,169,5,164,172,11,161,178,42,135,227,13,205,220,7,208,117,6,111,254,13,234,265,27,236
22017000139,679,103,576,582,46,536,610,56,554,616,79,534,1026,113,878,983,125,843,424,60,364,1045,98,931,1075,116,954
22017000158,759,167,592,649,85,564,654,87,567,647,140,502,1189,156,1007,1133,155,967,545,84,461,1071,153,908,1080,166,899
22017000160,548,124,424,465,62,403,466,60,406,467,100,364,837,120,694,819,126,680,393,68,325,784,120,656,785,124,648
22017000161,311,48,263,259,12,247,259,17,242,260,38,221,435,41,380,417,57,355,178,24,154,505,40,460,514,42,462
22017000137,812,326,486,675,186,489,674,189,485,686,250,425,993,295,659,944,300,618,370,134,236,1200,309,854,1225,347,853
22017000138,158,22,136,130,8,122,133,11,122,133,21,110,265,33,224,253,31,215,109,15,94,235,23,205,245,33,206
22017000166,291,77,214,238,33,205,239,32,207,240,55,185,429,85,330,408,85,315,196,39,157,434,88,339,450,91,352
22017000034,658,637,21,419,336,83,402,350,52,458,440,17,919,859,48,832,738,66,364,348,16,811,731,53,880,821,50
22017000058,457,440,17,304,242,62,296,249,47,334,314,18,638,594,32,568,485,63,231,220,11,608,544,39,654,606,34
22017000103,854,451,403,691,234,457,702,234,468,714,349,362,1086,366,698,1054,341,701,570,183,387,911,380,510,921,422,487
22083000034,539,245,294,555,152,403,555,159,396,563,201,362,658,207,441,640,202,419,306,81,225,659,204,439,692,275,412
22083000002,375,94,281,377,43,334,387,54,333,407,71,336,491,64,418,470,81,383,232,30,202,479,63,408,490,69,416
22083000003,251,135,116,246,70,176,249,82,167,278,104,173,348,119,226,332,119,212,171,62,109,336,127,198,362,166,191
220790N14-A,137,66,71,143,18,125,144,23,121,150,52,91,239,88,141,216,34,161,126,48,78,232,62,147,242,86,143
220790N14-B,106,32,74,99,5,94,102,8,94,100,24,76,141,18,112,137,25,110,75,10,65,134,14,118,135,19,116
220790C11-B,179,174,5,146,131,15,144,134,10,155,150,5,252,237,12,225,189,23,109,104,5,237,213,9,266,249,13
22083000035,279,208,71,250,126,124,249,122,127,262,143,115,312,196,115,286,166,108,130,87,43,332,185,140,339,212,123
22017000133,647,229,418,550,122,428,550,133,417,566,184,379,876,237,625,821,227,582,434,133,301,880,232,625,902,261,636
22017000002,635,365,270,493,230,263,502,245,257,514,289,220,875,414,442,848,410,433,478,228,250,815,414,383,812,430,373
22017000089,623,279,344,466,141,325,466,150,316,479,199,279,849,282,543,815,275,522,380,136,244,826,321,485,837,354,467
22017000090,904,586,318,705,332,373,708,355,353,729,432,293,1220,654,522,1185,643,520,535,275,260,1266,747,477,1311,810,481
22017000009,344,135,209,299,66,233,304,65,239,305,105,198,472,109,341,453,111,331,247,71,176,492,114,359,499,150,334
22017000157,224,61,163,177,33,144,199,33,166,202,62,136,347,72,264,328,72,247,142,32,110,354,67,272,367,77,281
22017000023,378,360,18,237,175,62,230,181,49,261,244,17,521,475,30,468,408,46,211,191,20,480,417,40,514,472,32
22017000107,348,167,181,267,92,175,266,103,163,271,119,150,450,158,271,424,151,263,166,67,99,580,229,339,589,249,335
220690002-5,229,43,186,197,20,177,197,24,173,203,38,162,257,40,209,249,58,184,131,18,113,285,32,249,291,43,245
220690002-3,237,25,212,230,15,215,238,22,216,243,30,213,280,12,266,265,24,239,146,5,141,309,13,291,317,17,300
220690002-8,403,366,37,293,230,63,284,236,48,377,333,44,498,427,63,442,379,53,223,199,24,495,378,85,501,415,73
220690004-3,180,103,77,153,55,98,157,59,98,159,79,80,228,107,116,228,113,114,131,59,72,209,69,130,212,80,128
220690002-6,238,82,156,208,26,182,212,23,189,221,65,155,334,49,277,319,91,218,137,23,114,377,42,327,382,52,324
220690003-4,155,75,80,130,32,98,132,37,95,145,58,87,194,91,99,154,73,76,62,26,36,192,50,129,199,58,138
22041000006,551,116,435,586,71,515,608,77,531,628,100,528,779,120,651,720,150,559,322,49,273,765,75,675,802,103,697
22041000012,356,68,288,363,21,342,359,26,333,370,44,322,431,43,380,410,64,343,222,26,196,472,48,415,478,67,405
220430008-2,378,53,325,387,25,362,391,27,364,398,56,341,524,27,487,496,32,460,204,22,182,575,25,542,588,29,553
220430008-3,121,16,105,127,3,124,130,11,119,127,26,100,177,6,168,162,10,149,62,3,59,191,13,174,194,12,180
22023000004,507,90,417,555,55,500,548,52,496,549,123,416,707,53,630,689,73,603,228,61,167,730,30,681,759,48,707
22027000003,251,84,167,209,40,169,208,32,176,217,54,159,308,45,251,285,54,224,154,26,128,276,45,229,279,46,228
220210007-3,153,19,134,154,10,144,153,14,139,164,19,145,191,10,181,188,29,158,77,8,69,231,16,213,230,12,217
220210006-3,226,113,113,218,67,151,217,73,144,229,103,121,286,100,180,281,109,168,117,46,71,265,80,173,281,117,164
22027000042,230,26,204,190,21,169,201,21,180,198,26,172,257,24,229,259,33,226,104,17,87,256,8,242,264,7,257
220210003-1,109,10,99,107,2,105,106,5,101,108,9,97,112,3,109,105,10,93,49,1,48,136,4,131,138,2,136
220210005-1,193,27,166,188,24,164,190,28,162,201,39,160,282,21,259,262,36,225,119,24,95,298,24,274,296,16,277
220210006-2,218,24,194,208,11,197,212,14,198,217,25,189,291,7,275,278,27,250,155,5,150,272,14,256,272,12,260
220210006-1,129,22,107,158,18,140,151,21,130,156,28,127,226,15,200,225,33,188,83,17,66,258,22,235,264,19,245
220290001-2,211,201,10,135,118,17,142,131,11,173,158,11,275,258,14,214,181,23,104,96,8,219,170,41,269,236,30
22003005-10,395,72,323,436,31,405,431,36,395,445,76,366,506,29,472,493,47,440,246,44,202,541,26,506,547,31,515
220250009-3,176,38,138,154,8,146,147,17,130,157,37,118,189,17,169,173,27,141,81,14,67,212,25,180,218,23,192
22117007-1A,339,302,37,340,271,69,322,251,71,355,312,39,465,391,71,428,326,83,191,165,26,434,330,77,464,389,71
220290001-1,487,477,10,323,285,38,337,304,33,399,372,19,642,626,12,502,431,50,198,182,16,479,409,49,601,553,28
220290005-1,364,200,164,362,130,232,353,126,227,386,181,201,418,186,227,394,185,205,186,83,103,424,177,229,453,224,225
220290004-4,468,346,122,357,210,147,365,213,152,408,281,122,585,352,226,479,281,189,211,103,108,518,309,184,575,393,175
22017000050,546,544,2,401,336,65,396,346,50,434,428,3,633,615,13,576,544,23,345,337,8,635,585,25,652,629,16
22017000001,156,156,0,104,90,14,103,84,19,123,122,0,257,243,8,230,209,15,119,117,2,188,175,5,200,191,4
22017000037,390,382,8,225,194,31,226,200,26,261,254,5,553,534,13,499,454,37,233,225,8,507,459,25,526,503,19
22017000123,691,214,477,575,124,451,576,122,454,579,169,408,891,204,674,859,201,650,478,98,380,916,191,720,915,204,701
22027000005,437,202,235,355,129,226,358,109,249,385,162,221,490,187,287,470,179,286,223,92,131,471,180,281,486,198,281
220690004-4,374,236,138,319,145,174,315,153,162,333,191,136,481,226,245,452,219,224,208,87,121,453,198,228,456,213,231
22069001-12,398,162,236,384,82,302,393,80,313,395,147,246,443,121,293,431,134,284,259,77,182,436,77,340,441,110,324
22069001-10,446,120,326,450,64,386,456,61,395,448,116,321,605,101,481,592,121,450,267,50,217,580,72,491,584,86,481
220690003-5,327,56,271,302,29,273,300,31,269,304,58,243,383,43,338,366,52,305,156,19,137,434,32,399,442,36,400
220030002-5,104,103,1,87,77,10,88,79,9,91,87,4,111,103,7,104,87,15,44,43,1,142,119,14,154,140,8
2200302-2-A,150,65,85,138,40,98,136,43,93,138,63,75,198,61,132,190,50,137,61,20,41,242,66,165,244,65,173
220030001-1,110,63,47,146,48,98,146,42,104,154,75,75,191,69,111,179,62,112,86,30,56,192,63,121,205,72,129
22027000091,61,8,53,43,2,41,44,4,40,45,9,36,65,9,52,57,8,46,30,1,29,90,9,81,94,12,82
220210002-2,204,31,173,203,8,195,207,17,190,215,24,189,302,25,275,294,49,242,157,16,141,303,12,283,300,12,286
22073000021,498,415,83,320,210,110,331,234,97,357,298,59,592,450,129,560,412,138,235,192,43,579,383,160,607,461,139
2211900017A,108,85,23,81,52,29,78,53,25,89,66,20,122,80,39,118,77,40,51,37,14,126,76,43,130,82,45
22119000041,976,225,751,872,114,758,874,111,763,892,177,710,1374,232,1123,1316,288,1016,586,137,449,1372,155,1185,1396,194,1196
22119000026,367,215,152,291,125,166,292,120,172,316,175,140,457,248,206,449,233,209,232,122,110,396,191,199,422,215,201
22017000144,621,337,284,501,165,336,500,170,330,538,239,291,886,405,457,794,330,444,387,159,228,908,400,486,953,447,495
22017000035,356,343,13,237,178,59,232,191,41,260,243,16,566,527,34,526,475,38,174,163,11,506,435,49,541,497,37
22017000097,286,105,181,227,37,190,231,44,187,228,75,152,396,95,286,376,96,271,200,41,159,431,138,290,430,141,287
22017000146,248,68,180,208,29,179,213,27,186,220,48,172,323,70,240,298,62,232,192,49,143,360,56,301,370,68,294
22017000072,453,219,234,349,111,238,351,116,235,359,153,198,696,278,374,669,273,382,283,107,176,689,281,394,696,302,379
22017000093,630,328,302,470,178,292,466,190,276,484,229,252,844,291,521,812,288,507,379,153,226,845,395,423,853,420,424
22017000036,573,532,41,385,300,85,378,317,61,409,365,37,817,723,80,750,609,118,285,253,32,802,678,81,837,752,68
2201700136B,598,122,476,515,66,449,522,65,457,526,105,418,818,102,699,774,118,640,365,49,316,866,105,748,871,115,742
2201700136A,755,155,600,645,80,565,655,80,575,656,131,520,1036,134,881,999,158,819,455,60,395,1087,132,938,1095,146,933
22017000134,209,82,127,189,50,139,188,55,133,195,74,119,283,99,179,277,98,172,146,59,87,273,69,200,284,80,199
220450006-3,773,180,593,755,117,638,753,109,644,767,186,580,1074,168,866,1038,136,841,608,91,517,888,110,760,906,143,754
220450004-2,543,436,107,474,322,152,464,307,157,511,396,108,810,595,193,751,421,262,257,171,86,700,455,186,755,534,203
220710014-2,358,295,63,251,164,87,259,118,141,274,215,58,415,261,119,404,227,168,199,129,70,494,314,169,468,322,138
220710004-2,364,327,37,203,164,39,210,148,62,221,198,22,449,366,64,411,306,97,180,146,34,606,464,113,660,549,97
220710010-9,326,259,67,248,151,97,243,130,113,251,188,62,422,267,119,418,227,173,238,163,75,388,239,139,368,241,112
220710016-9,236,231,5,142,113,29,146,111,35,165,155,9,332,289,30,289,231,45,112,95,17,306,265,29,352,324,24
220710016-7,387,347,40,269,208,61,269,179,90,272,242,29,443,329,73,430,299,119,271,220,51,363,277,76,358,286,66
22071009-29,137,122,15,93,69,24,96,68,28,98,82,13,186,147,26,174,128,39,56,51,5,169,116,37,189,155,26
2207107-37A,210,192,18,143,123,20,143,109,34,148,136,9,370,295,31,361,301,46,106,101,5,430,358,54,445,375,58
22071003-19,526,482,44,382,315,67,389,288,101,394,360,30,670,529,91,651,497,128,364,322,42,686,536,123,678,536,124
220710007-6,292,269,23,214,183,31,216,166,50,222,205,16,363,323,24,327,285,34,168,159,9,325,276,33,331,297,27
22071008-22,309,286,23,243,200,43,249,185,64,257,238,18,370,302,46,367,297,59,229,187,42,318,261,51,331,274,53
22121000015,541,528,13,417,383,34,413,359,54,477,460,14,587,565,15,535,484,40,349,335,14,589,507,56,641,604,34
22073000030,278,230,48,159,102,57,157,101,56,175,127,41,420,332,84,389,282,93,123,101,22,371,258,87,400,325,72
22073000003,819,652,167,642,422,220,639,431,208,672,507,165,1028,703,302,980,643,319,490,337,153,983,682,259,1018,772,229
22017000069,615,441,174,467,282,185,466,284,182,482,345,132,874,540,318,814,484,315,347,216,131,778,500,254,810,541,255
22017000078,264,235,29,188,136,52,183,146,37,203,174,29,372,306,61,346,278,63,123,102,21,378,308,54,394,331,55
22017000044,329,324,5,234,190,44,234,205,29,267,260,5,510,501,5,478,440,26,220,218,2,420,384,20,459,428,19
22017000017,412,301,111,301,159,142,304,163,141,313,200,108,613,347,214,569,322,217,229,148,81,570,314,223,598,355,221
22113000002,434,131,303,414,74,340,419,78,341,443,120,320,584,135,443,553,113,424,270,63,207,670,124,532,707,164,535
22125000001,405,223,182,352,105,247,356,80,276,369,189,177,594,163,393,581,157,402,284,86,198,538,141,372,538,157,367
22125000010,583,348,235,499,218,281,507,209,298,539,308,228,643,322,309,602,277,314,398,190,208,746,303,416,768,374,382
22125000012,265,104,161,279,52,227,287,50,237,294,102,192,298,64,232,280,45,227,178,37,141,433,60,365,438,75,359
22099000028,618,136,482,626,56,570,621,56,565,627,120,502,703,103,591,670,81,549,339,49,290,827,101,695,859,122,726
22099000029,1264,393,871,1182,212,970,1164,210,954,1205,337,859,1583,374,1189,1481,283,1125,786,186,600,1815,367,1387,1897,451,1417
22015004-3A,743,275,468,537,149,388,544,145,399,570,194,371,977,296,671,912,286,610,407,146,261,1164,345,783,1218,410,786
22015004-6A,943,279,664,710,135,575,718,137,581,737,203,527,1174,242,897,1136,254,863,540,130,410,1451,281,1130,1471,314,1131
220150003-2,414,153,261,332,70,262,334,74,260,341,114,225,467,138,328,440,157,281,242,84,158,621,146,466,639,164,465
22083000001,345,51,294,324,22,302,333,22,311,346,31,315,421,30,385,392,46,338,167,6,161,474,18,445,486,27,455
22083000013,573,507,66,467,318,149,488,341,147,563,467,90,793,651,125,701,535,145,288,224,64,603,405,160,718,560,138
22073000067,155,103,52,115,48,67,116,39,77,118,65,53,384,209,158,372,195,165,117,56,61,295,180,101,314,202,104
22073000074,405,405,0,233,199,34,239,209,30,288,283,4,473,460,5,431,401,25,180,179,1,472,416,26,526,501,17
22015004-6B,901,269,632,682,131,551,686,134,552,708,197,504,1094,231,836,1052,237,805,510,123,387,1371,271,1068,1390,303,1069
22015004-5A,482,145,337,336,70,266,341,69,272,357,109,246,651,150,479,633,160,463,277,87,190,713,142,553,740,161,568
22015004-4B,979,222,757,771,110,661,770,100,670,786,173,610,1292,166,1093,1264,200,1047,581,84,497,1413,181,1211,1420,203,1202
22015004-3B,482,114,368,372,53,319,372,53,319,377,75,294,649,90,541,634,111,517,235,37,198,788,139,631,791,158,623
220150002-1,604,318,286,430,154,276,420,167,253,461,230,224,822,335,468,803,352,434,377,182,195,872,336,513,884,349,514
220150002-2,652,171,481,597,68,529,599,55,544,607,111,492,819,111,669,801,110,676,507,65,442,630,104,511,639,124,506
220150001-4,811,286,525,570,141,429,560,125,435,577,193,380,1104,275,780,1072,308,728,447,125,322,1155,289,822,1193,338,825
22017000075,781,258,523,660,125,535,655,102,553,675,196,476,1060,238,771,1032,211,813,684,172,512,963,198,748,978,270,687
22017000046,390,378,12,252,208,44,246,210,36,276,261,13,614,570,30,570,489,56,208,193,15,562,503,38,599,562,36
22121000012,83,54,29,58,29,29,57,30,27,62,37,25,99,48,44,85,38,46,56,26,30,112,49,58,112,59,53
22015002-16,490,272,218,345,137,208,342,131,211,365,179,185,795,345,417,755,319,405,311,155,156,804,392,384,834,425,393
22015002-15,283,248,35,161,126,35,150,125,25,196,174,19,532,384,125,492,318,150,151,118,33,494,312,145,544,374,150
2201502-12A,142,70,72,113,34,79,116,34,82,123,53,70,236,103,125,223,99,116,104,37,67,201,90,98,221,115,104
2201502-17A,162,94,68,107,41,66,104,40,64,119,57,61,266,136,116,249,131,114,92,48,44,277,141,121,297,158,130
22037000002,1007,465,542,831,245,586,832,226,606,851,373,476,1177,324,815,1169,324,825,618,167,451,1284,304,952,1296,349,924
22037000008,617,400,217,520,259,261,528,265,263,554,355,197,724,390,323,701,349,335,375,203,172,650,280,342,708,367,332
220430006-2,315,81,234,305,18,287,304,15,289,313,43,269,412,23,378,402,40,355,143,13,130,483,41,428,487,45,433
22035000016,275,56,219,245,16,229,252,20,232,245,35,208,245,27,217,228,33,192,104,18,86,270,36,229,275,48,226
220430007-3,473,92,381,513,29,484,519,30,489,524,74,445,674,42,607,640,54,575,267,20,247,671,39,624,710,43,661
220430003-1,214,193,21,174,130,44,171,127,44,194,162,32,326,269,50,268,188,67,94,76,18,214,154,45,273,233,37
220430008-4,386,72,314,404,21,383,401,22,379,412,66,343,565,48,506,537,51,481,196,20,176,566,32,522,576,43,529
220430002-3,153,34,119,145,12,133,143,8,135,146,30,116,216,19,192,214,33,169,94,4,90,219,9,201,220,0,217
22097000050,318,230,88,269,162,107,269,159,110,286,194,92,582,352,224,525,265,247,164,103,61,367,195,155,397,242,151
22113000053,889,196,693,805,93,712,799,94,705,827,167,659,1274,198,1054,1224,155,974,508,86,422,1407,174,1179,1437,230,1183
2211300007B,490,73,417,446,37,409,453,38,415,458,71,381,624,47,556,605,57,529,306,34,272,769,67,679,780,74,691
22055000015,326,318,8,284,253,31,280,246,34,293,278,14,381,348,25,363,296,66,164,157,7,329,284,26,330,298,30
22055000112,722,287,435,624,178,446,621,156,465,629,222,405,912,285,598,886,226,640,394,118,276,1069,285,756,1084,322,748
22055000010,392,138,254,347,95,252,348,73,275,357,124,232,542,174,362,514,115,390,220,64,156,561,155,397,595,192,389
22055000007,897,561,336,696,313,383,688,279,409,732,407,321,1080,547,509,996,385,578,513,249,264,1274,640,572,1365,773,558
22055000069,298,188,110,252,123,129,261,93,168,267,165,102,421,162,210,413,136,266,194,99,95,454,209,218,463,228,215
22055000024,646,611,35,452,396,56,439,366,73,493,459,33,934,859,50,857,627,202,270,250,20,807,676,91,895,810,69
22055000023,362,354,8,246,210,36,240,214,26,270,263,7,502,472,22,474,355,103,160,154,6,379,315,38,419,386,14
22055000022,216,213,3,163,148,15,172,157,15,195,189,5,366,354,6,329,244,78,121,115,6,272,246,6,307,300,6
22055000077,510,168,342,434,94,340,439,68,371,445,128,315,705,144,504,696,107,580,344,77,267,752,197,524,741,205,514
22055000123,750,316,434,592,170,422,587,170,417,599,227,371,897,373,496,858,302,528,364,136,228,1149,371,722,1190,447,728
22103000915,831,403,428,701,214,487,711,191,520,724,324,390,1131,319,772,1074,290,765,420,144,276,1345,406,876,1389,469,894
22103000901,519,266,253,370,131,239,375,128,247,387,182,199,817,319,467,782,309,454,298,132,166,883,342,492,926,410,499
22103000429,388,144,244,318,53,265,325,49,276,327,107,219,538,67,438,508,79,416,226,45,181,604,177,414,602,182,415
22097000030,1001,239,762,936,151,785,926,165,761,980,238,736,1264,204,1045,1163,175,967,420,113,307,1416,191,1191,1483,225,1240
22097000038,321,125,196,276,67,209,270,63,207,275,96,178,432,130,294,404,92,301,142,52,90,501,141,340,520,167,345
22073000013,441,431,10,340,294,46,349,279,70,368,357,11,532,506,12,502,460,33,265,253,12,487,414,41,533,495,32
22099000015,892,202,690,913,107,806,916,114,802,939,205,722,1205,193,989,1152,153,901,663,110,553,1195,169,999,1209,186,1016
22099000016,685,305,380,684,210,474,664,220,444,698,285,408,848,316,516,797,235,516,463,153,310,914,341,542,949,399,544
22099000014,738,300,438,729,180,549,707,191,516,733,284,448,913,313,571,864,215,591,472,132,340,937,261,645,953,292,650
22099000027,943,403,540,845,203,642,834,204,630,876,317,552,1134,378,723,1069,250,772,557,149,408,1249,397,806,1318,469,836
22035000001,385,164,221,384,90,294,402,115,287,400,138,260,447,112,332,431,101,323,239,53,186,410,110,282,413,123,285
22035000006,256,249,7,210,174,36,203,184,19,238,227,6,288,275,11,280,226,36,87,80,7,288,228,40,311,294,6
22035000015,38,20,18,28,10,18,28,7,21,31,15,16,40,15,25,36,16,17,21,7,14,32,17,15,31,17,13
220430001-3,293,54,239,316,15,301,314,24,290,323,54,266,409,45,356,403,44,345,150,13,137,422,38,376,438,27,406
220430002-5,293,47,246,327,20,307,326,22,304,337,52,282,405,29,366,380,24,347,126,4,122,413,19,386,417,21,387
220950001-1,85,34,51,93,2,91,94,2,92,94,44,50,119,15,104,110,26,84,60,7,53,152,11,137,152,12,138
22005000027,610,192,418,563,63,500,564,61,503,568,183,384,867,95,740,830,113,698,283,24,259,1144,129,987,1150,148,978
22005000043,760,231,529,730,88,642,733,67,666,733,204,521,996,115,832,959,149,781,342,38,304,1245,136,1083,1231,135,1071
22039002010,360,43,317,328,20,308,329,22,307,330,36,293,484,30,445,453,35,400,170,17,153,519,23,476,532,36,487
22039001030,335,62,273,309,20,289,306,33,273,318,62,253,432,41,388,402,36,350,154,17,137,389,26,355,421,43,378
220090009-4,455,153,302,395,40,355,399,29,370,410,131,277,521,88,418,500,92,394,326,70,256,527,56,450,546,81,455
22009003-1B,260,97,163,258,52,206,259,50,209,262,92,168,299,58,234,276,65,205,102,36,66,291,53,232,307,55,251
22111000004,538,161,377,461,84,377,458,88,370,466,114,351,691,148,531,665,167,477,338,77,261,668,133,523,694,158,529
22005000051,581,530,51,473,374,99,456,346,110,502,452,43,707,632,66,642,516,97,213,187,26,800,555,169,898,762,98
22005000028,448,327,121,357,172,185,352,177,175,362,227,129,492,257,214,464,224,211,194,92,102,663,363,266,688,405,271
22005000061,560,176,384,544,86,458,551,79,472,551,181,367,1021,136,833,1019,144,853,396,55,341,928,150,761,928,172,736
22005000002,382,122,260,372,58,314,375,53,322,375,125,249,699,94,572,674,89,576,271,38,233,618,95,518,626,114,502
22005000048,207,92,115,167,51,116,174,44,130,175,86,88,206,77,126,193,69,122,109,32,77,294,108,180,309,137,170
22005000050,381,284,97,291,154,137,284,138,146,316,221,94,425,251,167,399,239,150,174,100,74,504,279,212,536,319,205
22005000036,723,592,131,572,355,217,575,322,253,622,460,156,901,672,195,830,548,249,316,242,74,1046,637,372,1130,752,349
22005000073,232,68,164,233,18,215,238,18,220,236,67,168,288,30,251,283,46,234,119,14,105,328,23,301,342,33,307
22005000058,673,316,357,607,165,442,614,154,460,618,275,335,902,280,584,853,253,580,321,92,229,1039,314,687,1088,375,696
220950002-1,558,304,254,538,176,362,552,165,387,561,308,251,747,286,441,706,253,438,309,133,176,811,309,465,840,351,482
220950002-2,609,492,117,462,283,179,463,284,179,510,397,110,785,579,188,675,444,195,249,168,81,837,547,251,954,692,238
220950002-3,753,437,316,674,252,422,674,228,446,697,387,297,986,431,532,934,401,510,601,255,346,1001,349,623,1047,429,613
220950004-1,79,57,22,78,41,37,77,37,40,85,61,24,146,90,52,132,78,47,55,29,26,144,79,55,155,105,47
220950005-8,124,52,72,143,28,115,142,23,119,143,63,77,202,40,155,199,38,158,120,21,99,184,43,136,184,50,132
220950007-5,674,377,297,610,205,405,641,209,432,653,357,284,948,350,557,915,333,559,485,145,340,968,348,582,1023,430,575
22005000077,712,288,424,576,145,431,578,142,436,585,246,336,744,185,518,745,173,550,317,78,239,883,186,674,881,233,633
22005000066,1234,504,730,1049,290,759,1048,270,778,1057,436,619,1197,386,765,1159,347,792,602,209,393,1561,426,1107,1570,484,1068
22005000040,868,355,513,739,205,534,743,193,550,748,308,439,836,269,539,799,243,546,422,147,275,1089,299,780,1108,342,757
22005000010,954,305,649,871,155,716,879,137,742,881,310,562,1370,210,1096,1333,206,1086,576,98,478,1500,239,1212,1531,289,1208
22005000013,836,322,514,788,145,643,796,128,668,787,268,513,1181,185,953,1144,198,907,377,54,323,1572,294,1212,1575,340,1191
22005000005,733,336,397,714,171,543,708,154,554,709,273,434,1036,246,745,1000,269,705,312,90,222,1159,242,878,1181,284,864
22005000053,339,198,141,311,110,201,319,110,209,333,165,165,420,194,218,408,193,198,178,72,106,493,179,286,529,241,286
22005000004,686,287,399,653,145,508,656,139,517,672,243,426,913,200,685,872,201,648,261,61,200,1077,226,825,1093,261,807
220950005-1,832,553,279,768,393,375,778,367,411,790,524,255,1122,546,551,1076,493,570,543,244,299,1033,488,526,1070,547,516
220950006-1,793,559,234,694,377,317,698,348,350,719,477,229,845,477,344,787,402,366,387,204,183,1004,622,340,1049,694,338
220950005-4,1026,588,438,1031,453,578,1052,426,626,1064,622,422,1498,599,861,1450,565,854,717,259,458,1303,547,709,1336,610,716
220950006-4,623,582,41,512,441,71,509,430,79,540,497,37,965,818,123,874,704,154,410,342,68,681,573,75,739,655,69
22005000063,540,219,321,471,127,344,476,117,359,477,192,282,676,174,475,653,154,479,287,72,215,731,161,552,745,201,529
22005000006,1204,487,717,1052,284,768,1062,261,801,1058,430,621,1512,388,1062,1470,354,1076,640,160,480,1630,358,1236,1656,446,1180
22005000062,401,162,239,349,95,254,353,86,267,354,143,208,505,129,353,494,120,362,213,54,159,541,119,411,553,148,394
22005000034,614,309,305,600,145,455,585,143,442,609,274,334,829,223,587,770,223,528,251,87,164,1134,241,852,1165,299,854
221270001-1,220,212,8,212,162,50,201,171,30,250,226,20,328,294,24,294,221,49,141,124,17,245,196,36,287,265,19
221270007-1,83,49,34,85,42,43,84,36,48,91,49,39,111,52,58,102,54,45,42,33,9,73,42,27,76,51,25
220810005-1,109,83,26,110,65,45,114,79,35,119,79,37,155,106,46,148,105,41,63,40,23,171,132,36,174,128,44
22009002-4A,379,184,195,369,82,287,374,79,295,380,159,220,497,133,344,453,126,308,218,70,148,403,94,289,446,134,298
22107000012,289,281,8,271,198,73,270,203,67,301,268,26,301,284,13,263,214,40,246,219,27,311,246,39,373,339,23
22039003050,313,39,274,320,13,307,324,16,308,330,43,286,348,26,317,322,25,291,129,10,119,403,25,370,425,32,391
220090002-1,438,191,247,430,111,319,434,136,298,473,195,275,595,191,396,534,178,338,74,25,49,514,126,354,576,193,374
22009006-1A,396,140,256,361,39,322,370,40,330,383,103,276,450,67,372,406,67,328,199,45,154,455,37,405,475,61,412
22009002-5B,33,12,21,30,3,27,31,3,28,32,9,23,37,6,31,32,5,26,17,4,13,38,3,34,39,5,34
22107000015,333,320,13,253,215,38,273,221,52,303,275,26,416,384,31,351,309,33,159,145,14,330,272,35,356,326,26
22099000011,665,360,305,638,253,385,618,274,344,648,327,320,794,408,368,746,286,423,388,172,216,744,266,439,773,316,435
22099000005,313,74,239,277,49,228,277,48,229,287,66,221,336,77,253,310,50,246,205,40,165,306,53,250,309,53,252
22099000004,380,99,281,332,45,287,332,54,278,337,87,250,472,84,371,443,68,350,282,47,235,291,33,245,292,44,245
22099000008,670,625,45,507,366,141,487,399,88,551,495,55,862,771,83,799,520,240,332,280,52,772,605,91,888,786,81
22099000002,347,55,292,401,16,385,405,18,387,400,55,342,516,35,481,486,53,428,242,22,220,516,22,478,530,21,507
22099000001,102,34,68,97,16,81,95,8,87,93,35,58,156,18,132,154,28,122,88,14,74,178,21,153,182,19,160
22099000020,1047,423,624,1039,175,864,1021,178,843,1054,370,677,1386,436,904,1305,307,930,775,216,559,1365,414,903,1425,489,912
22099000019,420,185,235,411,97,314,410,106,304,425,176,247,566,187,347,559,121,392,317,87,230,525,170,332,551,193,341
22099000017,345,151,194,334,89,245,334,96,238,353,151,201,491,184,289,442,120,307,262,84,178,378,106,251,414,140,267
22099000018,1106,782,324,887,462,425,872,478,394,995,667,324,1396,935,427,1245,591,565,614,355,259,1232,718,446,1357,913,413
22083000031,266,100,166,241,50,191,242,48,194,251,62,189,291,73,214,274,74,199,162,44,118,343,65,275,358,92,264
22099000003,1121,328,793,1040,216,824,1021,220,801,1054,322,732,1304,362,912,1248,275,914,698,154,544,1235,283,927,1269,340,924
22083000026,131,20,111,137,9,128,134,12,122,143,16,127,180,18,159,171,28,140,66,11,55,190,17,173,188,17,166
220810003-1,252,66,186,231,34,197,227,48,179,233,54,177,332,71,257,331,101,228,151,30,121,287,42,241,292,50,239
220810003-2,199,38,161,177,11,166,176,16,160,176,24,149,250,46,204,245,50,194,118,16,102,238,22,214,248,28,218
22083000032,367,142,225,398,88,310,403,92,311,425,148,277,506,149,354,487,153,319,191,63,128,491,122,350,528,166,357
22099000023,1241,607,634,1049,336,713,1062,341,721,1155,518,633,1613,680,887,1498,482,943,748,259,489,1624,611,947,1734,774,946
22099000025,560,158,402,550,51,499,525,61,464,565,138,419,853,153,684,779,89,608,379,59,320,916,96,786,984,143,827
22099000012,100,25,75,90,18,72,95,17,78,97,22,75,147,36,106,142,20,111,62,11,51,101,19,75,105,26,75
22083000012,563,57,506,676,19,657,675,34,641,699,42,657,802,44,744,756,72,678,332,17,315,790,34,744,809,50,750
2206300001C,551,88,463,499,31,468,493,34,459,495,98,393,738,45,677,741,60,664,297,8,289,839,51,771,852,74,773
22087000044,493,459,34,282,230,52,291,218,73,333,302,25,758,651,86,664,518,109,222,191,31,591,420,108,710,612,86
220590001-1,235,30,205,241,17,224,233,21,212,242,27,213,250,7,241,245,22,220,102,8,94,275,15,257,281,10,271
22077000016,533,325,208,528,209,319,532,174,358,561,307,247,611,250,348,586,241,333,254,134,120,659,250,389,672,280,383
22097000048,248,140,108,213,88,125,212,90,122,221,106,115,440,204,234,412,161,242,130,73,57,283,120,156,305,149,155
221270002-1,83,71,12,91,51,40,93,67,26,96,76,18,146,107,37,132,96,31,59,50,9,98,53,40,117,77,40
22111000012,264,209,55,263,131,132,256,151,105,270,180,90,390,289,98,345,228,111,236,188,48,288,151,122,328,208,106
22111000011,468,211,257,389,114,275,395,125,270,410,159,247,639,278,343,596,246,333,308,139,169,530,174,335,590,260,321
22111000003,430,352,78,311,202,109,316,211,105,327,234,89,573,433,125,508,344,142,200,154,46,552,390,122,610,489,107
22111000016,270,65,205,243,38,205,241,31,210,253,57,195,379,65,306,366,77,283,175,34,141,411,59,337,412,74,336
22111000002,224,92,132,197,54,143,194,49,145,206,74,132,317,120,188,297,103,187,122,47,75,315,108,199,338,126,206
22111000022,365,32,333,379,24,355,383,29,354,385,51,333,517,34,474,496,49,444,254,29,225,426,19,398,434,31,402
22005000037,788,705,83,634,501,133,618,470,148,659,584,68,845,700,113,793,618,150,393,349,44,1061,765,248,1157,915,222
22005000065,518,463,55,418,329,89,407,312,95,439,384,49,556,459,73,517,406,97,265,232,33,702,510,163,763,606,146
22005000008,704,280,424,756,172,584,764,158,606,777,269,508,1498,319,1114,1439,306,1099,582,112,470,1107,234,846,1130,284,820
22005000033,886,278,608,838,92,746,837,86,751,843,240,600,1340,151,1138,1290,178,1075,383,52,331,1432,163,1226,1464,190,1243
22005000072,566,271,295,459,113,346,455,94,361,451,189,261,712,181,492,687,188,470,243,64,179,859,213,609,882,269,591
22005000016,857,362,495,799,180,619,798,158,640,804,295,502,1282,266,942,1262,259,979,580,135,445,1094,276,791,1103,322,765
220950003-1,374,271,103,374,230,144,370,218,152,380,266,110,509,354,146,475,303,162,281,168,113,495,305,164,516,348,154
22095004-14,569,440,129,530,326,204,529,309,220,534,378,149,767,480,270,731,443,274,325,200,125,826,521,283,847,571,270
220950006-3,683,653,30,574,479,95,586,475,111,635,577,48,945,859,73,847,728,97,365,334,31,949,812,106,1023,932,79
220950004-3,435,410,25,403,332,71,395,312,83,421,381,28,674,585,68,612,504,90,271,236,35,538,437,68,584,506,62
22063000034,477,133,344,440,37,403,438,32,406,445,114,324,666,82,564,643,109,521,210,28,182,841,66,753,854,81,756
22063000002,802,235,567,677,69,608,671,65,606,685,180,499,955,107,806,925,131,760,301,39,262,1289,127,1133,1307,153,1132
22077000010,324,184,140,382,112,270,375,107,268,410,214,195,495,160,315,484,154,322,258,80,178,396,96,286,418,133,272
22087000010,273,144,129,208,66,142,214,49,165,217,115,100,394,113,260,381,115,253,147,50,97,446,153,273,458,169,280
22005000039,298,196,102,256,105,151,257,103,154,262,155,103,327,194,130,300,159,134,150,88,62,449,239,191,466,258,196
22005000047,771,747,24,554,480,74,543,452,91,654,597,45,898,830,53,765,631,93,280,252,28,1040,852,144,1195,1106,63
22005000015,785,222,563,673,81,592,683,64,619,675,201,472,1019,130,862,995,171,794,379,53,326,1296,146,1120,1313,172,1125
220950001-2,552,550,2,469,436,33,484,441,43,524,512,8,630,617,9,541,489,33,389,381,8,548,494,37,588,560,22
220950001-3,895,870,25,694,597,97,686,589,97,732,694,34,951,902,37,832,734,70,489,460,29,880,781,64,954,901,41
2206300023B,344,131,213,287,45,242,289,46,243,293,94,195,412,30,362,386,42,334,136,18,118,575,91,469,591,99,480
2206300005B,381,81,300,384,35,349,387,34,353,388,86,299,651,51,562,617,69,523,200,10,190,747,62,662,761,63,680
2206300026B,376,119,257,408,38,370,410,45,365,418,108,307,529,43,470,505,67,421,194,17,177,623,92,507,638,104,519
22077000018,749,283,466,799,133,666,794,123,671,840,331,505,955,155,782,914,167,736,435,72,363,906,141,736,914,150,747
22055000058,232,228,4,178,152,26,176,157,19,191,183,8,326,312,11,293,229,55,85,80,5,269,240,16,300,290,8
22103000C04,323,150,173,286,63,223,281,56,225,293,128,164,452,112,297,437,87,334,238,60,178,320,83,228,328,87,232
22103000110,776,281,495,685,110,575,695,89,606,713,249,460,871,138,691,872,117,742,426,71,355,916,164,728,955,213,713
22103000922,266,147,119,235,108,127,231,102,129,245,135,106,403,167,223,370,139,222,112,38,74,444,185,238,464,225,234
22103000206,537,145,392,490,48,442,496,46,450,497,124,364,796,73,696,771,69,691,359,22,337,773,92,665,792,95,685
22103000413,666,207,459,631,77,554,627,77,550,639,188,444,858,137,682,868,101,746,499,56,443,726,86,621,742,132,585
22103000810,459,184,275,387,102,285,390,77,313,397,160,236,714,176,515,674,168,492,286,82,204,826,190,623,833,222,593
22103000112,726,246,480,546,84,462,546,86,460,552,197,351,752,96,625,739,89,638,284,29,255,953,138,798,955,154,786
22017000071,333,326,7,227,170,57,220,175,45,254,249,5,459,448,7,430,398,21,236,230,6,391,359,14,422,400,19
22017000104,963,229,734,743,82,661,750,76,674,766,142,623,1138,164,939,1128,168,955,675,111,564,1242,165,1065,1237,200,1014
22111000007,332,61,271,346,35,311,348,37,311,354,53,300,432,49,375,413,71,340,256,27,229,488,50,433,490,65,420
22111000014,188,168,20,152,112,40,151,124,27,178,158,19,285,253,27,258,213,33,174,161,13,234,169,52,259,216,30
22111000024,393,159,234,323,94,229,321,101,220,341,128,213,469,142,321,469,152,311,230,82,148,507,129,365,526,143,379
22111000006,331,67,264,358,26,332,356,28,328,353,59,291,463,34,413,461,53,400,252,15,237,472,42,418,485,59,417
22111000027,332,29,303,305,15,290,312,15,297,314,26,288,404,11,391,383,23,358,217,10,207,392,19,370,404,9,391
22017000086,551,547,4,349,282,67,355,299,56,407,399,6,777,760,11,710,652,41,366,359,7,639,593,29,670,647,13
220330001-2,657,650,7,382,344,38,386,325,61,417,407,6,893,868,12,847,756,69,335,325,10,929,806,81,1026,968,40
220330003-8,1127,1020,107,992,780,212,985,725,260,1030,909,117,1768,1446,282,1700,1321,350,942,773,169,1387,1092,255,1458,1197,240
22033002-24,478,475,3,380,351,29,392,307,85,425,421,1,580,566,7,548,514,21,365,360,5,597,555,22,625,612,5
220330001-1,534,429,105,446,276,170,462,240,222,467,360,100,596,371,165,569,343,198,405,290,115,667,373,263,658,386,247
22033001-72,856,492,364,781,292,489,791,237,554,804,441,361,1050,411,581,1033,368,640,672,232,440,1093,457,585,1109,527,565
22033001-97,451,338,113,341,230,111,334,214,120,354,286,67,569,396,161,549,367,172,291,189,102,642,450,170,660,480,169
22033001-32,828,819,9,557,500,57,595,459,136,631,625,5,898,877,7,824,755,53,490,487,3,1018,930,58,1089,1036,36
22033001-91,605,588,17,383,332,51,395,284,111,431,418,12,706,673,28,671,608,52,388,367,21,801,722,64,839,790,36
22033001-46,398,349,49,231,189,42,241,167,74,253,220,33,269,198,41,263,185,63,119,106,13,668,464,171,690,531,146
22093000016,646,567,79,631,479,152,620,393,227,685,578,96,881,693,172,771,549,200,433,327,106,736,558,139,790,655,129
22093000006,650,335,315,695,182,513,700,173,527,696,348,344,979,287,674,972,283,676,532,160,372,790,211,567,812,245,559
22093000007,427,424,3,335,305,30,342,320,22,376,359,12,565,561,3,521,486,23,187,185,2,505,445,36,542,505,22
22111000001,95,59,36,83,44,39,79,43,36,85,50,33,138,70,68,121,65,55,61,30,31,135,73,61,144,84,59
22109000010,709,260,449,698,136,562,696,129,567,708,229,473,1014,220,764,971,212,728,340,51,289,1040,182,818,1075,233,827
22109000059,1028,336,692,971,164,807,997,163,834,1018,337,665,1482,287,1158,1398,271,1093,507,96,411,1605,202,1355,1664,273,1375
22053000001,542,238,304,480,115,365,483,112,371,489,171,315,823,224,567,794,198,570,395,130,265,834,193,603,866,238,606
22053000010,723,123,600,808,54,754,808,55,753,818,140,677,1098,86,982,1079,86,977,422,49,373,1119,73,1021,1156,106,1030
22053000004,401,57,344,353,17,336,353,16,337,356,56,300,589,32,545,572,36,524,199,19,180,616,19,578,635,34,595
22053000007,532,141,391,563,82,481,555,69,486,576,164,408,831,135,683,805,116,682,347,56,291,761,110,634,773,135,623
22053000005,361,302,59,345,214,131,347,229,118,379,277,101,586,384,187,554,301,227,216,133,83,488,268,194,539,353,176
22073000066,440,412,28,278,220,58,271,222,49,286,266,19,548,480,54,537,448,75,213,193,20,509,415,63,558,499,49
22073000024,786,779,7,466,402,64,436,374,62,530,521,7,944,928,6,875,812,40,340,337,3,943,810,75,1068,1023,23
22111000028,426,82,344,357,42,315,352,44,308,374,51,323,541,71,461,515,78,425,208,27,181,545,66,464,556,84,468
22111000010,158,50,108,133,24,109,139,36,103,144,40,101,207,66,141,186,60,123,102,25,77,198,34,159,222,38,181
22109000067,453,359,94,297,209,88,298,201,97,341,265,71,545,387,150,477,319,147,180,132,48,566,367,172,647,467,172
22093000019,246,184,62,249,142,107,247,119,128,262,185,75,302,183,110,269,155,110,155,91,64,235,150,77,246,167,76
22067000032,115,58,57,92,26,66,88,27,61,95,39,55,150,62,85,134,54,78,65,24,41,158,61,93,180,82,97
22067000031,334,212,122,262,121,141,271,137,134,291,167,124,425,248,174,369,207,152,167,99,68,464,253,195,476,282,189
22067000008,176,70,106,161,45,116,159,44,115,160,61,99,216,62,147,209,72,133,111,43,68,192,53,137,192,55,136
22067000007,515,365,150,412,220,192,398,243,155,421,285,133,680,485,181,639,435,190,253,157,96,528,309,191,561,378,175
22067000029,264,109,155,241,47,194,245,50,195,255,73,182,319,89,220,311,84,218,145,51,94,325,77,241,335,87,245
22031000016,1285,257,1028,1091,126,965,1110,128,982,1122,182,930,1197,117,1048,1168,159,991,601,87,514,1069,108,949,1092,117,957
22101000044,131,129,2,68,60,8,71,69,2,94,92,2,199,186,8,171,148,15,68,67,1,148,133,8,197,196,0
2204700014A,249,236,13,219,187,32,204,152,52,238,218,15,276,244,25,234,182,45,109,92,17,230,178,42,259,221,31
22047000015,524,522,2,518,485,33,480,429,51,566,555,5,574,550,4,477,416,42,254,250,4,524,455,41,551,529,12
22047000032,757,700,57,693,521,172,700,511,189,795,695,87,750,653,90,710,553,133,350,304,46,838,647,142,857,726,116
22047000020,227,167,60,235,121,114,225,97,128,247,157,90,330,170,138,291,153,128,125,59,66,291,141,125,315,181,122
220850002-2,77,9,68,65,9,56,68,8,60,68,10,54,88,4,83,89,6,81,53,6,47,111,17,94,112,14,97
220850007-1,138,11,127,102,7,95,107,10,97,120,8,110,188,8,174,176,20,153,72,6,66,241,18,214,262,14,245
22047000006,84,78,6,91,76,15,91,69,22,99,88,9,130,109,15,122,98,19,59,47,12,109,77,31,111,83,26
22047000013,192,75,117,216,30,186,220,24,196,208,84,124,269,64,198,266,46,213,129,28,101,206,50,148,208,56,149
220850001-1,315,15,300,304,9,295,301,14,287,309,9,299,357,10,341,333,22,311,184,5,179,388,5,374,398,10,380
220850007-2,283,39,244,242,17,225,248,23,225,254,26,226,322,34,280,305,53,251,128,18,110,363,23,339,373,25,346
220850003-7,84,9,75,86,4,82,88,8,80,89,8,79,91,5,85,91,3,88,54,4,50,106,5,101,107,5,102
22085003-7X,2,0,2,2,0,2,2,0,2,2,0,2,3,0,3,2,0,2,1,0,1,3,0,3,3,0,3
220850009-3,316,55,261,289,26,263,291,29,262,302,35,266,351,45,300,337,49,282,180,18,162,356,39,312,379,43,333
220850003-4,106,4,102,112,6,106,106,6,100,117,6,110,141,7,131,142,8,134,47,2,45,152,7,137,154,5,148
220850003-2,302,26,276,272,14,258,277,15,262,281,19,262,396,13,371,388,28,358,172,5,167,441,10,423,436,11,421
220850002-1,335,26,309,328,17,311,319,19,300,324,19,301,418,25,384,407,35,368,171,12,159,450,24,421,469,27,440
220010006-7,392,103,289,434,54,380,436,55,381,441,102,336,674,102,540,656,80,566,271,41,230,563,69,478,581,81,487
220850007-4,205,27,178,184,9,175,179,14,165,183,17,162,242,14,224,225,36,187,86,8,78,256,21,232,266,21,245
220850006-3,350,58,292,368,42,326,370,57,313,375,66,301,441,56,378,416,90,312,174,26,148,426,29,382,447,22,423
220850008-2,419,247,172,355,149,206,352,170,182,392,209,175,642,317,309,604,311,280,158,79,79,507,246,233,564,300,254
220010004-2,466,85,381,428,47,381,431,48,383,430,67,362,718,100,610,685,101,568,350,66,284,682,78,594,684,81,596
220010006-2,243,64,179,244,43,201,245,33,212,246,58,188,332,51,271,323,42,272,178,26,152,299,55,236,309,60,247
220010004-4,661,100,561,646,43,603,641,37,604,648,108,534,975,67,895,959,73,873,499,50,449,1090,57,1016,1117,68,1037
220850007-5,249,30,219,221,10,211,221,11,210,226,17,204,300,8,280,295,29,264,148,6,142,328,10,318,342,14,327
22055000036,1105,353,752,892,175,717,887,172,715,908,278,623,1474,347,1080,1398,263,1100,578,123,455,1677,360,1246,1694,435,1221
22055000033,899,214,685,812,104,708,811,73,738,804,153,647,1107,165,884,1092,139,925,579,89,490,1118,135,941,1102,188,889
22055000031,679,261,418,581,138,443,578,123,455,588,195,386,922,262,615,888,189,666,358,80,278,1026,273,699,1062,345,696
22055000035,609,175,434,512,79,433,510,70,440,509,127,380,978,223,718,932,175,731,318,54,264,1114,218,858,1130,264,854
22055000113,540,273,267,413,144,269,413,135,278,420,187,233,840,356,451,806,274,504,299,111,188,861,352,481,898,400,490
22103000417,638,229,409,509,93,416,506,74,432,509,177,322,813,148,606,772,148,611,342,40,302,813,142,650,818,168,629
22103000602,585,137,448,449,32,417,466,39,427,474,102,366,861,88,756,839,92,740,334,21,313,1076,110,946,1071,109,950
22103000304,729,371,358,656,236,420,653,227,426,663,313,339,1039,395,594,996,320,644,483,170,313,1131,418,671,1161,474,665
22055000114,252,61,191,233,31,202,229,30,199,226,54,170,388,47,326,373,52,311,157,16,141,477,84,379,488,97,387
22103000809,397,271,126,350,199,151,349,181,168,366,235,121,588,297,268,546,276,255,203,115,88,638,315,289,668,345,315
22103000813,361,134,227,321,68,253,329,61,268,326,116,209,587,122,436,570,127,428,201,56,145,673,155,502,678,182,485
22103000606,640,155,485,504,50,454,511,30,481,507,131,366,885,88,767,853,100,721,336,40,296,1114,119,966,1137,129,996
22103000801,813,261,552,697,98,599,692,82,610,711,231,469,1061,156,844,1031,146,867,545,71,474,1149,178,941,1180,253,908
22055000047,522,204,318,444,117,327,444,84,360,449,172,275,668,165,457,648,114,519,339,89,250,730,221,483,732,241,472
22055000041,485,215,270,422,126,296,422,113,309,440,169,264,732,255,428,720,195,504,259,85,174,785,278,451,814,339,447
22055000048,346,143,203,276,76,200,278,58,220,281,112,165,562,180,336,549,141,383,224,69,155,541,161,353,549,200,332
22103000M01,491,201,290,431,83,348,436,67,369,439,161,275,569,93,442,569,87,473,243,35,208,620,119,491,633,145,481
22103000M12,330,141,189,283,56,227,287,46,241,288,106,179,1351,244,1020,1325,214,1081,525,95,430,444,82,353,455,108,342
22103000M11,698,250,448,576,83,493,587,65,522,590,203,381,709,132,542,685,115,558,312,46,266,888,137,726,900,176,695
22103000M07,654,259,395,539,101,438,548,84,464,555,215,333,836,166,602,826,134,670,413,63,350,753,166,558,776,188,559
22103000414,651,180,471,530,76,454,547,62,485,553,171,379,788,146,614,788,111,670,395,78,317,702,97,597,706,121,563
22071017-12,284,280,4,187,164,23,190,155,35,216,205,10,395,377,15,357,322,29,173,167,6,346,300,25,399,363,31
220710002-2,216,186,30,162,129,33,162,102,60,171,149,22,326,237,72,298,203,88,134,104,30,321,205,102,342,243,92
220610009-3,8,5,3,12,0,12,11,0,11,12,3,9,53,13,25,52,17,32,7,3,4,50,25,19,52,28,21
220610009-1,602,550,52,414,330,84,426,338,88,448,400,44,940,798,97,871,715,124,280,254,26,808,597,132,883,757,111
220610005-3,425,86,339,432,32,400,431,26,405,440,74,366,616,54,545,600,83,514,234,21,213,568,30,529,573,45,517
220610008-1,254,145,109,210,80,130,212,77,135,214,100,113,457,166,254,444,174,252,134,51,83,416,158,238,425,181,226
220610005-2,627,117,510,600,42,558,602,41,561,609,75,530,743,46,679,724,79,636,299,13,286,873,50,801,879,68,796
220610010-3,92,29,63,74,16,58,73,15,58,73,19,54,146,36,107,136,41,94,31,9,22,134,21,107,137,28,108
220610008-2,874,225,649,782,85,697,791,73,718,794,163,626,1022,121,857,986,141,835,409,54,355,1178,154,985,1176,190,964
22031000056,202,105,97,165,51,114,171,60,111,179,69,110,238,105,128,229,108,116,113,49,64,348,121,219,364,138,223
22115007-2A,472,98,374,464,58,406,463,57,406,466,88,373,744,100,620,699,98,587,196,25,171,741,96,633,765,92,664
221150006-2,97,24,73,102,13,89,103,21,82,109,32,76,153,13,137,146,15,130,55,8,47,126,7,117,143,18,124
220610012-1,389,263,126,377,188,189,380,171,209,390,228,161,642,291,288,620,279,307,279,154,125,569,235,290,585,313,252
220610001-1,433,430,3,356,305,51,357,308,49,374,364,10,715,686,15,673,627,33,310,302,8,542,477,34,584,545,23
220610012-6,79,59,20,87,46,41,85,45,40,89,56,33,144,73,53,142,76,59,64,41,23,131,74,51,132,83,46
220610009-4,85,63,22,74,37,37,75,39,36,76,54,22,152,85,60,148,79,65,56,40,16,129,61,57,139,73,63
220610009-5,25,10,15,20,7,13,18,8,10,22,11,11,54,10,34,51,11,38,14,4,10,47,14,30,49,13,33
22105000048,186,154,32,133,96,37,138,95,43,151,121,26,248,156,71,230,137,82,65,56,9,279,151,105,295,183,104
22049000022,268,133,135,236,85,151,233,81,152,239,101,135,327,115,205,315,111,200,140,35,105,325,118,203,326,127,192
22019000661,278,68,210,296,38,258,300,39,261,294,78,216,411,59,350,390,57,327,167,29,138,526,72,431,539,87,446
22019000801,573,198,375,513,87,426,519,78,441,519,158,357,783,131,627,760,102,639,259,65,194,1168,207,924,1156,226,915
2201900860S,671,263,408,618,150,468,613,144,469,633,248,381,951,209,718,919,180,721,349,114,235,1296,252,987,1293,282,990
22011000015,235,70,165,225,21,204,218,18,200,226,42,184,286,26,247,272,23,246,134,15,119,307,19,283,306,20,283
22011000004,303,93,210,288,59,229,284,62,222,297,89,200,531,129,392,497,114,362,107,31,76,532,126,377,559,143,408
22011000010,370,88,282,341,36,305,335,26,309,342,66,276,475,38,427,468,46,415,130,25,105,552,40,499,568,50,515
22011000011,512,124,388,482,51,431,479,45,434,487,97,384,652,38,596,645,61,574,186,36,150,781,58,699,778,53,717
22011000006,256,38,218,265,15,250,264,19,245,265,41,222,301,10,281,298,18,273,131,11,120,308,35,266,316,31,282
220610004-5,258,71,187,223,32,191,228,24,204,227,54,173,351,60,283,338,80,251,156,29,127,370,54,310,389,70,316
22105000114,520,172,348,502,36,466,507,40,467,498,153,344,648,46,585,637,68,545,265,16,249,628,45,556,634,46,586
22019000362,610,195,415,549,79,470,550,61,489,546,176,369,846,99,693,828,88,730,374,55,319,448,64,369,461,78,376
22019000400,376,124,252,463,69,394,473,61,412,470,153,312,904,91,781,857,102,734,235,67,168,854,135,679,876,152,708
22019000164,178,25,153,195,6,189,192,7,185,185,23,162,263,20,230,255,19,235,107,13,94,380,33,335,366,33,326
22019000337,449,195,254,444,104,340,446,87,359,453,175,274,619,128,458,612,122,479,284,75,209,329,80,233,353,108,237
22019000603,232,182,50,163,106,57,162,106,56,177,136,40,324,228,88,302,171,115,93,69,24,483,324,135,499,376,114
22055000076,600,152,448,504,81,423,509,59,450,518,136,378,813,154,620,804,101,689,440,93,347,803,139,627,804,173,609
22105000017,412,389,23,291,231,60,299,238,61,343,309,31,518,434,67,457,360,81,173,150,23,547,416,97,621,511,92
22105000109,480,363,117,395,212,183,400,217,183,436,332,103,577,342,224,529,302,200,248,150,98,556,298,230,581,332,241
22105000101,408,228,180,308,85,223,328,102,226,350,173,177,466,187,273,437,162,159,206,94,112,482,180,243,519,216,296
22115004-3J,84,33,51,82,19,63,81,21,60,85,30,55,112,25,81,106,16,85,37,4,33,107,29,78,111,36,75
22055000055,572,423,149,504,330,174,494,301,193,525,369,154,830,524,277,778,417,336,344,217,127,734,435,275,771,501,254
22055000043,431,164,267,333,73,260,335,59,276,339,112,226,645,184,428,617,132,463,288,75,213,658,203,424,672,243,415
22055000107,990,198,792,882,92,790,877,69,808,886,175,709,1234,121,1070,1195,91,1069,521,63,458,1231,148,1050,1251,170,1059
22055000071,516,179,337,407,101,306,406,110,296,416,145,270,710,161,528,686,140,535,348,90,258,905,223,652,896,247,640
22103000918,247,92,155,202,50,152,203,43,160,206,74,129,351,78,261,328,80,241,125,30,95,400,78,303,415,98,305
22055000116,666,185,481,560,97,463,563,85,478,567,144,420,688,99,546,658,82,557,250,46,204,1101,225,829,1134,273,849
22055000108,1228,257,971,1019,131,888,1028,116,912,1031,205,820,1530,153,1299,1485,131,1310,620,73,547,1709,270,1392,1731,315,1386
22103000605,295,68,227,253,36,217,258,33,225,258,61,196,448,45,388,438,64,358,194,23,171,511,44,455,513,42,463
220610003-5,268,83,185,233,21,212,239,27,212,238,57,181,282,29,238,285,31,253,158,20,138,396,44,348,394,51,337
220790N18-A,658,156,502,621,70,551,630,74,556,640,144,488,954,129,787,925,151,743,276,32,244,890,111,743,898,126,748
220790N18-B,583,137,446,551,61,490,555,65,490,570,124,438,845,114,700,823,131,664,249,29,220,790,98,661,798,111,671
22079000N17,356,61,295,294,29,265,292,24,268,298,48,249,477,29,435,445,44,394,165,18,147,505,39,445,532,47,478
22079000N16,333,73,260,289,28,261,293,28,265,298,50,247,438,52,374,417,64,348,128,15,113,448,55,377,455,53,388
22079000N15,320,82,238,281,47,234,286,33,253,293,77,213,467,37,403,449,48,390,139,18,121,459,44,395,473,64,402
22079000N19,780,196,584,707,75,632,703,70,633,734,155,571,1235,134,1061,1173,158,985,396,38,358,1166,150,974,1208,173,1007
22079000S10,1093,123,970,949,37,912,952,52,900,963,99,860,1275,49,1206,1223,83,1111,417,24,393,1437,41,1363,1460,48,1401
22079000C18,414,303,111,333,193,140,330,188,142,333,247,86,509,320,170,487,270,202,208,119,89,465,250,186,490,296,175
22079000C14,175,93,82,120,49,71,116,47,69,123,56,66,253,153,94,232,134,90,76,35,41,244,131,105,257,154,100
22079000C28,322,255,67,229,136,93,232,143,89,252,185,63,469,355,105,443,292,132,136,103,33,380,242,121,418,311,99
220790000N6,523,206,317,469,84,385,471,94,377,493,164,325,864,214,604,791,182,595,295,79,216,641,124,493,660,165,482
22049000007,37,3,34,41,2,39,40,1,39,44,8,36,73,1,72,68,10,53,22,1,21,74,0,70,78,2,73
22047000019,385,364,21,403,347,56,394,310,84,424,393,28,525,465,44,471,378,80,171,141,30,416,332,65,438,382,42
220790000C4,716,710,6,551,511,40,549,521,28,570,556,9,888,864,12,795,729,35,393,390,3,799,697,55,867,827,16
22079000C13,761,571,190,582,360,222,578,358,220,609,433,175,961,665,278,888,560,293,391,234,157,1034,663,330,1121,798,300
22079000S6B,78,38,40,74,26,48,72,17,55,82,39,43,118,46,71,107,35,66,46,20,26,123,39,79,136,49,87
22103000917,231,79,152,224,72,152,219,65,154,228,95,129,326,80,227,321,87,232,158,52,106,374,67,297,374,73,289
22103ZZZZZZ,0,0,0,0,0,0,0,0,0,0,0,0,0,0,0,0,0,0,0,0,0,0,0,0,0,0,0
22079000C26,367,196,171,286,103,183,289,92,197,299,139,159,422,159,245,411,145,256,144,54,90,433,153,265,445,179,259
2212100001A,827,329,498,725,153,572,728,148,580,727,282,442,933,324,594,878,309,547,463,169,294,1146,246,870,1186,298,878
221170007-2,643,158,485,692,33,659,720,36,684,743,181,548,1013,35,965,985,54,900,316,11,305,1075,52,995,1112,33,1064
221170006-3,347,73,274,377,26,351,382,20,362,382,71,304,483,15,457,477,32,440,210,8,202,529,28,486,543,29,511
221170004-1,299,279,20,231,174,57,232,160,72,252,214,34,397,328,57,351,261,66,87,67,20,318,267,20,360,349,4
220790000S1,370,170,200,305,97,208,305,90,215,320,140,179,435,128,300,397,111,280,146,50,96,549,152,381,560,161,394
2212100011A,213,85,128,228,43,185,233,42,191,226,100,126,248,47,185,247,46,196,150,34,116,253,53,196,261,69,186
22121000019,480,307,173,455,199,256,452,199,253,480,294,183,552,265,277,531,254,272,299,137,162,593,271,303,590,285,293
2212100002B,1114,479,635,1017,213,804,1012,201,811,1003,421,582,1241,297,895,1221,316,876,755,186,569,1247,294,920,1262,329,916
22121000016,587,332,255,531,191,340,537,178,359,528,295,228,688,240,423,656,254,392,378,159,219,694,240,433,702,277,415
22047000026,225,53,172,260,13,247,270,18,252,262,71,189,371,20,346,354,39,310,146,11,135,352,16,332,357,15,342
22047000031,383,316,67,351,211,140,346,201,145,376,295,76,390,272,112,364,242,110,197,165,32,431,294,123,435,311,118
22047000028,550,283,267,573,209,364,574,203,371,605,295,305,704,274,413,672,256,405,319,140,179,696,255,427,719,287,427
22067000001,380,318,62,263,176,87,262,186,76,291,224,67,511,367,134,478,333,127,173,139,34,449,330,102,491,380,109
22067000020,269,210,59,248,148,100,251,151,100,265,179,84,357,238,114,336,214,119,150,101,49,285,162,110,295,197,96
22019000560,287,67,220,357,51,306,354,49,305,379,80,287,490,59,426,446,58,380,108,28,80,838,83,736,893,102,786
22019000335,407,163,244,360,45,315,365,36,329,368,133,235,593,110,449,573,76,481,268,37,231,344,69,257,349,93,256
22019000404,674,277,397,695,117,578,697,106,591,689,233,444,1151,181,919,1129,148,957,421,94,327,997,160,777,988,155,797
22047000009,1069,731,338,921,450,471,943,400,543,1017,662,349,1133,619,474,1045,537,478,515,296,219,1294,615,611,1395,761,607
22031000034,403,281,122,283,172,111,300,196,104,330,234,94,380,229,139,352,199,147,198,124,74,359,178,147,379,242,137
220090004-1,235,102,133,230,45,185,234,52,182,232,78,150,333,55,268,303,65,228,106,28,78,314,57,244,323,66,253
220130001-4,52,10,42,43,3,40,41,4,37,42,8,33,57,8,46,56,15,41,45,8,37,52,11,38,53,11,42
220130004-1,389,280,109,322,165,157,327,176,151,358,233,122,484,290,192,463,273,178,240,160,80,480,297,163,511,326,171
220130005-1,366,262,104,278,151,127,283,160,123,302,193,105,450,277,164,442,268,164,218,142,76,406,239,157,394,229,159
220130005-2,292,82,210,276,46,230,281,60,221,290,77,209,387,78,307,384,106,277,229,63,166,368,80,283,387,96,286
22101000004,376,109,267,364,66,298,365,67,298,373,92,276,511,102,394,493,92,367,222,48,174,560,111,424,568,112,452
22101000007,541,411,130,457,272,185,449,268,181,485,348,132,801,504,284,750,411,295,285,157,128,758,459,258,816,532,265
22101000035,409,182,227,328,105,223,331,99,232,342,156,182,577,199,368,535,188,330,225,81,144,574,151,400,614,190,413
22031000033,615,325,290,528,207,321,523,210,313,538,244,288,784,327,444,756,330,418,328,156,172,886,332,532,922,375,529
220690004-6,140,38,102,149,8,141,149,14,135,148,22,126,244,25,212,227,22,202,92,5,87,231,10,211,244,18,223
2206901-10A,162,38,124,159,37,122,157,34,123,162,46,111,222,34,178,205,38,164,85,18,67,235,41,192,240,44,188
22015001-3A,611,238,373,443,133,310,445,135,310,466,179,284,879,258,581,851,258,575,391,152,239,757,225,501,773,270,491
2205100185B,325,204,121,280,147,133,290,149,141,289,192,93,486,227,245,443,182,249,203,117,86,572,262,298,592,281,307
22019000403,416,171,245,452,115,337,455,101,354,463,178,280,775,177,563,758,142,593,244,66,178,697,161,503,691,170,497
22019000401,367,127,240,362,61,301,358,63,295,366,112,254,648,102,510,611,89,506,165,29,136,601,138,425,609,164,429
22019000336,750,342,408,690,139,551,692,139,553,701,268,423,1142,267,814,1101,209,868,394,95,299,736,233,464,746,275,455
22019000468,494,86,408,521,51,470,526,54,472,519,118,397,873,62,785,843,61,770,264,29,235,1093,78,986,1084,81,989
22019000360,191,57,134,216,25,191,216,27,189,217,56,158,305,54,232,296,41,247,132,22,110,260,31,219,264,39,216
2201900861W,411,230,181,371,152,219,358,144,214,378,210,168,570,240,315,544,192,347,192,82,110,697,276,389,728,311,408
22019000300,751,734,17,606,540,66,588,528,60,679,660,16,1012,958,32,906,732,144,367,342,25,970,843,63,1059,998,38
22019000762,177,45,132,185,18,167,189,19,170,189,43,146,315,29,279,301,25,272,93,22,71,465,43,407,473,57,414
220570010-9,385,92,293,395,42,353,395,42,353,399,104,294,523,66,436,484,77,381,163,12,151,544,42,470,573,49,509
220570011-5,708,152,556,594,61,533,591,55,536,601,136,457,1005,96,882,968,129,805,308,35,273,1247,144,1060,1275,167,1096
220570011-3,555,120,435,465,46,419,459,39,420,468,106,356,788,75,695,741,95,623,242,27,215,976,110,835,1002,132,862
220570002-6,267,94,173,277,59,218,280,49,231,283,116,164,436,98,319,424,103,307,195,49,146,432,60,360,428,74,339
220890004-3,393,121,272,369,50,319,382,44,338,377,132,242,543,78,455,532,98,419,186,26,160,747,121,610,744,134,590
220070006-1,443,328,115,438,221,217,439,235,204,457,323,129,684,336,331,626,285,311,259,126,133,517,250,252,548,299,240
22051001-GI,374,143,231,336,38,298,331,32,299,340,107,230,585,74,493,537,91,439,227,30,197,573,65,482,596,76,511
220750001-3,390,370,20,295,228,67,336,256,80,400,371,19,494,459,31,438,343,74,324,276,48,504,410,59,536,491,34
220010001-9,374,51,323,360,24,336,355,18,337,355,40,312,606,46,546,592,48,533,296,30,266,579,30,526,583,46,524
22001006-16,123,22,101,122,20,102,122,17,105,126,32,94,187,30,153,178,24,151,107,17,90,179,15,161,180,14,163
220010001-4,580,133,447,496,51,445,489,57,432,507,103,398,828,134,672,812,86,712,382,55,327,805,108,662,819,136,667
22069001-9A,188,55,133,198,48,150,201,42,159,203,60,141,266,73,183,257,71,177,125,28,97,267,50,205,270,58,207
22069002-7A,37,27,10,29,16,13,27,16,11,30,19,11,35,16,19,33,20,13,21,18,3,34,16,18,39,18,21
220690004-7,59,7,52,56,2,54,56,2,54,56,6,50,74,2,72,70,4,66,47,4,43,81,4,77,81,2,78
220690001-5,128,126,2,92,77,15,87,78,9,95,95,0,204,201,1,193,176,15,58,57,1,166,146,12,176,170,6
22069001-11,705,431,274,651,265,386,662,253,409,681,380,293,961,378,536,938,395,519,445,199,246,873,376,450,887,431,435
220010006-6,443,440,3,326,307,19,312,288,24,347,341,2,603,596,6,586,445,118,274,269,5,455,422,18,519,510,7
220010002-3,628,95,533,579,46,533,581,49,532,586,81,505,840,90,737,839,69,759,390,47,343,907,76,814,933,96,827
220010002-2,570,61,509,545,20,525,545,18,527,551,50,500,711,40,656,702,36,650,407,39,368,776,29,735,797,34,750
220010003-7,705,144,561,549,64,485,550,76,474,558,122,435,870,117,733,845,95,741,401,67,334,934,106,811,960,127,818
220750009-2,375,183,192,400,122,278,433,95,338,425,176,239,623,215,397,577,177,374,331,124,207,742,149,577,778,175,596
220010005-2,254,64,190,257,31,226,256,34,222,259,66,192,336,49,279,323,38,282,148,23,125,394,49,334,403,53,345
220010007-2,429,69,360,364,26,338,367,25,342,377,63,314,555,65,484,529,58,465,250,43,207,631,65,553,650,83,563
220010004-6,495,61,434,447,32,415,451,36,415,452,61,390,569,35,526,561,36,519,318,37,281,612,33,566,610,43,562
22101000023,301,105,196,288,69,219,287,62,225,294,93,200,433,105,323,418,109,304,150,39,111,424,99,314,430,112,313
22119000010,86,17,69,75,5,70,74,5,69,74,10,64,98,4,90,97,13,82,53,4,49,114,5,109,114,2,112
22119000042,350,87,263,346,56,290,353,55,298,363,91,268,428,87,328,404,100,297,183,48,135,473,76,391,497,92,401
220250007-3,88,48,40,76,29,47,78,31,47,81,37,44,105,38,65,96,39,56,39,17,22,89,44,37,88,41,41
220250009-2,224,51,173,181,16,165,188,19,169,191,36,155,226,40,186,209,38,164,84,17,67,256,42,211,262,44,213
220750007-2,612,566,46,529,390,139,578,408,170,632,561,66,862,705,144,812,577,193,439,304,135,825,590,186,886,728,141
220010001-6,609,550,59,425,332,93,429,336,93,487,420,65,766,659,88,685,398,251,240,191,49,742,554,114,816,685,107
220010006-4,364,171,193,356,92,264,357,94,263,376,167,208,578,212,348,542,129,399,240,67,173,487,149,303,519,199,311
220790000C3,446,440,6,319,298,21,315,292,23,334,326,7,586,565,7,536,482,30,208,204,4,507,447,32,579,554,14
220790000C7,284,281,3,213,192,21,207,196,11,231,227,4,357,349,6,316,274,28,178,176,2,305,264,29,355,335,11
22101000043,259,91,168,242,43,199,242,50,192,247,88,155,387,77,303,365,77,277,135,22,113,397,70,312,403,79,319
22101000034,285,63,222,245,43,202,250,38,212,258,60,193,465,98,356,408,76,318,119,17,102,501,69,413,533,90,437
220010001-1,806,112,694,674,53,621,668,53,615,684,112,570,1037,98,914,1006,88,885,453,66,387,1119,62,1014,1137,80,1043
220010001-3,617,165,452,546,69,477,541,72,469,556,141,410,870,141,699,845,130,696,400,75,325,795,126,637,812,148,647
220250001-1,222,64,158,217,33,184,226,31,195,227,47,179,278,42,230,265,55,206,107,18,89,268,30,225,284,44,237
220750007-1,224,158,66,214,103,111,215,127,88,235,172,61,262,163,99,252,143,107,163,111,52,305,159,128,325,199,122
220010005-5,130,25,105,136,9,127,138,12,126,143,39,104,197,20,177,189,20,169,86,16,70,207,19,184,214,22,188
220010002-5,331,45,286,353,24,329,350,25,325,353,54,298,456,32,411,446,29,417,234,25,209,493,28,458,497,43,446
221170002-1,631,262,369,656,150,506,662,160,502,672,257,404,968,235,714,912,224,625,371,89,282,1012,240,725,1036,245,778
221170006-1,352,67,285,351,17,334,362,15,347,363,76,287,482,19,458,487,35,446,189,4,185,528,21,501,527,29,492
221170007-3,108,60,48,108,33,75,107,28,79,115,47,67,141,33,104,135,38,92,57,19,38,146,30,105,156,42,108
2206300003B,269,33,236,247,14,233,247,19,228,247,43,204,425,20,394,414,36,372,155,8,147,472,25,443,490,38,452
220010003-5,498,128,370,433,59,374,434,59,375,443,104,339,666,124,532,636,114,518,285,69,216,702,91,596,719,105,605
220010001-5,430,235,195,319,113,206,315,114,201,338,168,169,584,222,345,544,152,379,259,114,145,561,194,331,608,247,349
220010001-2,612,214,398,507,83,424,505,91,414,517,142,373,845,209,616,804,149,638,358,65,293,790,146,598,831,208,604
22063000027,735,475,260,636,329,307,630,330,300,667,438,225,1123,558,521,1054,481,540,347,176,171,1135,552,543,1187,632,535
2205300009B,395,108,287,401,59,342,403,46,357,412,112,300,694,86,584,684,74,597,346,59,287,580,72,498,603,101,495
22053000013,503,352,151,358,185,173,351,165,186,392,266,120,656,340,287,617,272,320,244,126,118,676,307,338,713,368,340
22053000008,182,132,50,183,88,95,178,72,106,185,106,78,259,122,131,244,102,137,87,52,35,272,112,141,295,151,143
220910001-1,713,449,264,629,246,383,646,270,376,687,427,250,828,399,401,778,343,377,437,211,226,863,373,442,876,421,442
220910004-1,1017,738,279,876,479,397,875,438,437,934,619,310,1076,597,465,1024,523,457,514,289,225,1014,476,476,1077,609,454
22077000001,291,112,179,278,47,231,275,49,226,315,108,207,338,106,226,319,108,203,134,40,94,381,79,290,406,102,294
22119000008,302,30,272,301,14,287,296,12,284,300,34,265,464,27,429,450,48,398,184,13,171,415,20,387,424,21,398
22119000043,580,253,327,519,154,365,520,163,357,528,211,313,736,252,466,709,247,446,342,123,219,738,252,465,745,265,476
220210004-1,105,56,49,109,46,63,102,41,61,108,56,50,130,51,78,125,55,69,64,29,35,54,8,46,59,8,51
220210002-1,184,41,143,174,13,161,172,14,158,178,20,158,211,11,195,203,17,182,100,5,95,214,12,198,216,17,194
22027000093,140,116,24,132,93,39,136,91,45,147,121,26,270,227,43,238,174,57,83,65,18,212,151,54,232,186,40
22119000025,387,384,3,278,244,34,264,249,15,339,332,6,516,501,6,497,463,21,278,274,4,421,378,30,465,442,16
22119000036,155,28,127,168,9,159,174,9,165,174,23,151,181,10,166,181,19,162,75,9,66,193,7,186,201,16,183
22123000016,540,144,396,458,40,418,455,42,413,479,101,378,542,67,466,509,69,433,274,36,238,547,38,496,595,74,521
22123000014,103,20,83,110,8,102,112,7,105,111,22,88,142,8,131,135,10,123,98,12,86,97,9,86,107,12,94
22123000018,183,33,150,151,2,149,154,9,145,157,11,146,183,7,176,175,13,158,106,9,97,236,4,228,242,8,234
2210500040A,532,316,216,426,129,297,433,110,323,437,253,181,748,251,441,715,240,436,241,73,168,817,281,491,831,319,475
2210500127A,292,158,134,220,56,164,216,54,162,217,103,113,458,155,276,442,171,251,134,43,91,469,157,294,480,161,304
22033003-60,976,486,490,840,206,634,850,189,661,856,365,489,1281,377,831,1275,340,914,832,207,625,1118,393,699,1118,468,622
22033001-27,758,751,7,494,425,69,517,420,97,558,547,8,835,814,11,779,698,53,456,442,14,827,726,59,915,871,32
22119000001,326,87,239,298,42,256,297,42,255,310,69,234,455,62,383,448,100,346,242,36,206,434,107,321,460,121,336
22033002-11,537,514,23,387,324,63,411,314,97,441,421,17,604,531,63,591,504,77,332,298,34,727,610,99,757,663,83
22033001-67,374,364,10,228,207,21,242,186,56,257,248,9,366,334,16,348,292,42,228,212,16,440,394,30,477,441,27
22033001-83,628,478,150,470,282,188,457,270,187,483,355,128,825,553,246,812,525,270,405,254,151,870,561,273,941,678,251
22033003-24,1042,999,43,980,855,125,938,780,158,1001,959,41,1246,1141,85,1209,1076,117,810,752,58,1093,964,102,1139,1019,104
22033001-20,924,858,66,698,582,116,694,547,147,751,680,70,1013,900,98,957,813,127,463,412,51,1215,968,198,1296,1089,186
22033002-23,790,787,3,629,534,95,617,497,120,664,652,11,938,909,20,874,788,65,537,521,16,984,869,61,1080,1019,38
22033001-39,691,402,289,584,206,378,592,183,409,591,300,288,709,290,369,697,253,436,490,204,286,745,294,439,733,337,378
22033001-56,1346,631,715,1213,255,958,1221,201,1020,1216,490,719,1471,344,996,1495,274,1198,1086,290,796,1849,357,1460,1805,474,1275
22073000056,740,75,665,581,29,552,593,15,578,599,57,542,1011,44,951,977,73,892,350,14,336,1061,64,981,1071,71,987
220790000N1,122,69,53,96,37,59,98,40,58,104,52,51,181,76,93,169,67,96,46,16,30,164,61,95,179,84,94
22079000C25,622,449,173,510,280,230,494,277,217,534,353,177,866,517,320,796,433,331,371,236,135,717,430,248,762,508,239
22079000N21,240,55,185,191,24,167,193,22,171,195,39,155,292,33,246,275,39,232,104,14,90,324,28,290,326,41,282
22105000016,324,210,114,312,52,260,318,54,264,328,199,126,395,92,286,371,86,251,177,31,146,403,85,300,418,105,304
22033001-80,1012,546,466,890,311,579,901,263,638,895,447,438,1308,420,742,1291,416,820,757,255,502,1285,478,759,1290,545,716
22033003-29,720,325,395,702,183,519,700,145,555,706,300,402,995,288,629,989,254,717,588,158,430,966,285,664,960,331,602
22033002-14,615,446,169,574,341,233,563,319,244,597,429,165,925,584,318,893,529,343,498,337,161,948,524,385,980,604,364
22033003-37,406,129,277,430,99,331,431,80,351,436,141,294,700,123,556,673,127,531,448,76,372,685,131,539,688,143,532
220590010-1,329,243,86,283,177,106,280,148,132,295,214,80,389,281,97,329,207,107,157,114,43,323,196,106,375,259,109
22079000C23,419,101,318,329,29,300,331,24,307,336,56,280,446,28,397,424,35,385,194,16,178,465,40,419,469,45,415
22079000C21,870,753,117,753,547,206,752,571,181,773,651,120,1187,931,232,1123,823,269,513,438,75,1076,804,225,1114,916,178
220450012-3,934,854,80,822,684,138,808,681,127,896,786,99,1297,1162,122,1156,783,209,371,322,49,1213,977,139,1379,1246,115
22105000118,1272,535,737,1116,172,944,1135,146,989,1129,437,691,1630,249,1332,1563,258,1257,560,100,460,1597,205,1334,1622,238,1368
22105000139,195,90,105,200,45,155,201,41,160,202,83,116,397,132,249,377,113,248,138,38,100,363,124,222,375,145,219
221150003-4,327,54,273,330,24,306,329,25,304,327,46,280,500,25,467,507,43,459,206,16,190,463,24,435,484,28,450
22115005-2A,0,0,0,0,0,0,0,0,0,0,0,0,0,0,0,0,0,0,0,0,0,0,0,0,0,0,0
220430002-1,59,11,48,78,11,67,77,15,62,77,20,57,92,25,64,91,28,57,50,7,43,96,13,81,93,10,81
220430002-2,208,43,165,224,35,189,222,23,199,233,41,192,278,24,246,270,34,224,144,14,130,266,19,234,275,25,247
220790000N5,400,209,191,317,76,241,328,77,251,338,140,193,578,141,409,554,130,409,206,55,151,519,143,347,535,167,348
221170004-4,452,246,206,492,150,342,492,144,348,506,239,262,712,246,448,707,223,466,198,67,131,544,199,316,572,243,327
221170006-2,322,85,237,345,25,320,350,24,326,346,75,268,544,32,492,516,46,460,235,10,225,573,29,531,581,31,546
22079000S21,393,60,333,301,18,283,301,20,281,312,43,269,478,21,453,445,33,408,208,13,195,512,31,471,528,43,483
22079000S23,342,71,271,271,17,254,271,17,254,271,35,234,357,35,314,354,36,314,136,20,116,421,37,379,428,42,384
220790000S9,86,60,26,61,27,34,54,22,32,66,42,24,88,47,36,82,44,37,25,18,7,100,42,52,115,60,54
22079000S20,508,399,109,343,206,137,348,213,135,386,279,103,575,419,147,533,359,155,237,186,51,634,436,163,681,519,146
22077000014,532,308,224,518,132,386,527,146,381,553,300,249,30,8,22,29,12,17,211,67,144,676,151,508,692,129,558
220590004-2,268,17,251,249,5,244,245,6,239,254,16,235,277,6,267,269,16,247,139,7,132,323,5,312,324,6,314
22073000018,673,661,12,347,310,37,351,298,53,396,387,9,842,821,14,739,684,41,325,316,9,740,655,41,859,817,29
22073000068,312,247,65,252,157,95,240,149,91,263,184,78,435,300,130,399,266,121,153,110,43,404,275,107,433,320,106
22073000070,335,320,15,189,162,27,189,162,27,224,212,11,533,514,15,456,410,26,127,120,7,446,353,55,527,487,26
2207300065A,204,201,3,112,94,18,117,98,19,135,128,6,293,284,0,265,249,13,108,107,1,300,262,22,305,291,10
22073000060,739,391,348,609,220,389,611,224,387,637,307,330,992,458,505,978,434,529,471,201,270,878,386,460,930,469,445
22063000038,867,468,399,606,171,435,618,155,463,678,361,311,1183,401,749,1125,435,651,363,133,230,1353,383,909,1449,501,927
2206300006A,394,111,283,400,27,373,402,26,376,407,98,303,622,42,561,607,81,509,230,21,209,641,40,583,660,52,606
22079000N28,419,92,327,400,30,370,391,26,365,407,72,332,595,50,528,563,65,484,175,26,149,648,53,580,669,58,600
22079000N12,631,168,463,651,96,555,642,86,556,660,165,490,800,147,619,778,140,617,336,55,281,805,106,677,821,126,673
22041000030,754,109,645,715,33,682,702,38,664,735,56,679,868,55,802,843,78,751,443,32,411,907,45,854,922,55,857
22113046B-4,288,109,179,240,51,189,231,43,188,246,86,155,378,130,232,351,103,233,151,42,109,371,95,247,399,142,249
2211300046A,217,81,136,234,36,198,216,35,181,234,75,158,376,92,270,362,57,293,172,34,138,253,61,178,257,70,184
22079000S26,750,118,632,566,41,525,579,45,534,586,65,516,731,44,665,676,63,603,220,25,195,888,64,803,917,80,822
22073000059,391,189,202,331,90,241,322,86,236,339,129,209,528,176,338,507,168,329,198,59,139,490,178,296,515,224,283
22113000014,698,114,584,797,83,714,784,64,720,835,163,667,1026,102,899,1000,88,892,481,94,387,1072,81,964,1135,79,1045
2211300050A,459,86,373,462,45,417,451,53,398,483,83,396,689,93,588,650,80,529,263,43,220,676,61,597,709,77,624
22113000028,407,61,346,426,38,388,424,31,393,437,79,353,597,52,515,579,55,500,312,44,268,522,27,477,529,39,483
22023000002,15,10,5,27,4,23,27,5,22,29,18,9,24,6,16,23,0,20,12,3,9,28,0,24,29,0,28
22023000001,190,46,144,265,25,240,270,28,242,277,61,214,257,29,220,227,21,204,59,17,42,460,55,393,459,44,407
22113000018,995,140,855,1040,64,976,1044,70,974,1056,129,917,1322,96,1191,1291,86,1163,604,62,542,1361,75,1248,1379,92,1259
220130007-5,98,27,71,91,19,72,94,20,74,95,32,62,252,47,201,239,63,175,110,22,88,157,40,116,161,36,124
22107000001,77,26,51,79,6,73,80,12,68,83,16,67,129,16,113,123,32,91,88,23,65,73,8,63,73,16,57
2210700002C,26,11,15,29,16,13,31,20,11,31,17,14,23,10,13,27,8,19,14,14,0,32,12,19,33,14,18
22039001100,125,60,65,127,35,92,124,33,91,127,59,66,169,55,110,163,42,117,70,23,47,109,33,74,115,41,71
22039005030,194,26,168,180,12,168,181,12,169,181,20,160,225,9,209,208,10,195,67,10,57,259,10,248,269,12,255
220090009-2,94,39,55,92,24,68,96,25,71,96,37,59,127,40,83,120,36,77,60,27,33,115,35,78,122,40,82
22125000003,725,192,533,624,60,564,638,44,594,623,138,485,649,79,549,658,72,585,440,39,401,808,72,721,818,84,718
2201504-11A,480,118,362,393,52,341,390,42,348,399,81,312,701,87,596,674,102,559,316,47,269,687,89,587,698,108,588
22083000010,66,11,55,67,6,61,70,5,65,69,7,62,71,8,62,78,7,70,38,2,36,99,4,94,98,14,83
220810004-1,180,145,35,146,91,55,139,88,51,163,112,46,253,186,62,219,148,66,116,89,27,232,152,75,247,170,72
220090004-2,689,194,495,648,78,570,647,77,570,654,162,483,817,74,728,766,86,649,286,40,246,847,76,739,877,85,778
22087000020,211,105,106,194,46,148,194,32,162,200,89,109,301,59,220,299,62,227,106,24,82,285,70,195,293,75,205
22087000014,307,183,124,249,71,178,257,61,196,263,128,135,536,187,323,515,181,322,158,55,103,563,227,307,580,256,314
22077000005,146,48,98,141,18,123,149,20,129,153,40,111,149,27,122,143,17,124,68,18,50,176,18,154,184,28,153
22087000025,244,106,138,197,46,151,199,33,166,199,77,122,384,96,274,367,93,270,122,30,92,428,121,277,431,146,280
220450013-3,908,142,766,812,65,747,798,51,747,819,128,688,1251,117,1106,1178,104,938,515,62,453,1436,131,1264,1456,160,1289
22123000001,276,133,143,202,66,136,212,63,149,222,85,136,263,107,152,241,103,135,141,51,90,292,93,193,324,116,208
22123000010,273,90,183,264,43,221,259,31,228,276,76,199,355,81,271,342,68,269,138,26,112,351,70,274,356,83,270
220590009-2,197,32,165,184,11,173,187,6,181,184,14,169,190,4,182,175,6,168,105,3,102,225,5,217,231,4,227
220590005-1,534,85,449,557,27,530,553,31,522,571,58,506,707,48,638,686,76,598,331,14,317,632,30,585,650,47,595
22087000030,389,205,184,351,49,302,352,37,315,346,174,168,664,135,500,636,151,462,200,41,159,728,160,531,758,195,540
22087000021,220,130,90,207,57,150,203,47,156,205,110,91,318,79,214,307,93,205,98,30,68,332,110,208,334,122,205
220590008-7,254,20,234,258,14,244,256,19,237,269,15,251,299,8,286,288,22,263,133,5,128,298,10,287,293,8,283
221170001-1,710,174,536,759,63,696,763,70,693,760,167,587,984,80,877,967,76,864,407,25,382,1096,66,1009,1097,64,1023
22123000011,114,96,18,88,52,36,93,37,56,108,79,29,136,98,38,120,78,41,43,34,9,104,52,50,124,70,53
22039005041,311,76,235,274,28,246,272,38,234,284,64,219,342,45,291,312,41,268,105,13,92,368,29,333,380,38,340
221170009-1,609,299,310,605,180,425,599,165,434,627,278,348,935,266,657,874,237,617,346,83,263,941,211,686,964,265,695
221170003-1,268,82,186,313,51,262,314,46,268,317,115,197,405,62,325,400,62,329,210,25,185,373,48,314,391,64,321
22063000014,722,219,503,615,51,564,616,50,566,640,214,425,890,127,738,870,194,655,307,54,253,1178,116,1022,1193,131,1041
2206300019A,252,63,189,239,21,218,242,22,220,237,62,175,389,42,339,383,49,322,120,10,110,433,24,396,448,23,418
22113000039,209,137,72,160,82,78,149,75,74,178,103,74,297,157,137,270,109,150,103,42,61,254,125,109,291,175,111
22113000012,351,209,142,323,121,202,311,117,194,352,169,175,492,273,203,464,229,220,165,98,67,488,206,259,531,257,273
22041000016,426,385,41,310,216,94,301,230,71,328,288,37,507,421,74,475,358,106,196,166,30,455,355,66,532,465,56
22037000009,541,410,131,492,270,222,496,253,243,516,360,152,703,452,234,683,402,262,509,327,182,644,350,269,684,418,253
22037000001,573,182,391,488,40,448,493,35,458,493,136,357,721,79,633,721,82,622,389,50,339,757,69,672,767,92,667
22113000006,431,77,354,455,24,431,452,16,436,463,73,389,546,55,476,534,57,468,256,49,207,625,65,554,652,68,581
22113000024,425,92,333,380,46,334,380,45,335,394,71,322,495,87,400,473,65,394,236,42,194,658,88,548,658,92,556
22041000004,503,393,110,343,192,151,335,214,121,384,276,104,479,283,187,415,220,175,172,107,65,170,44,124,171,48,123
22027000085,116,92,24,103,70,33,101,58,43,107,82,25,135,110,22,136,98,35,50,32,18,99,72,16,105,81,20
22063000025,408,95,313,389,39,350,388,41,347,393,114,278,761,104,616,738,124,592,258,27,231,629,61,550,634,88,537
22063000039,352,114,238,354,31,323,352,28,324,347,84,260,694,82,591,685,98,577,261,40,221,610,90,500,616,113,489
2206300028A,311,92,219,246,23,223,253,25,228,256,76,176,575,69,482,559,93,449,173,16,157,507,66,405,533,102,418
22063000024,888,222,666,868,87,781,867,74,793,871,242,626,1206,121,1034,1163,143,997,447,41,406,1187,145,1004,1203,185,991
221150007-2,233,28,205,229,6,223,231,6,225,230,28,199,324,18,297,307,20,282,127,12,115,366,24,331,364,20,343
221150003-2,115,30,85,103,13,90,104,17,87,106,18,87,171,20,147,159,18,138,55,16,39,184,21,160,187,23,162
22105000047,468,429,39,288,219,69,311,235,76,345,299,46,625,505,100,591,441,121,213,161,52,609,464,104,676,571,90
2210500143A,446,231,215,397,95,302,402,86,316,401,183,214,469,147,306,442,133,297,162,49,113,734,161,539,741,185,537
22105000112,591,246,345,524,55,469,537,60,477,548,202,345,733,113,608,700,126,545,226,24,202,924,140,755,952,151,792
22105000015,326,252,74,254,85,169,255,87,168,273,192,75,267,131,132,261,121,119,128,45,83,290,132,143,310,163,146
22117004-7B,153,59,94,154,33,121,152,23,129,163,64,96,209,36,172,205,43,159,92,13,79,191,41,148,202,46,147
22117004-9A,169,76,93,179,50,129,175,56,119,176,77,96,248,68,176,235,57,171,111,29,82,222,53,165,228,62,163
221170001-2,280,91,189,262,41,221,264,36,228,261,76,179,418,47,352,405,66,330,130,18,112,535,63,454,536,73,449
221170004-8,234,95,139,250,31,219,251,38,213,250,79,171,318,33,278,322,40,280,194,29,165,297,44,244,294,49,240
221170003-3,246,104,142,242,55,187,239,42,197,250,93,154,362,89,267,347,78,266,125,23,102,382,80,294,382,84,295
220210001-1,167,91,76,141,54,87,144,47,97,157,72,85,207,93,111,198,89,102,111,49,62,223,84,133,220,90,126
220210001-2,399,31,368,419,18,401,417,24,393,439,31,408,529,30,491,520,68,450,272,12,260,497,19,465,523,21,495
22115004-3K,73,24,49,77,18,59,70,14,56,76,20,53,206,57,124,178,43,123,18,1,17,187,62,111,201,74,119
221150002-2,61,12,49,57,3,54,57,3,54,60,5,55,76,7,69,75,7,67,30,3,27,104,3,101,106,3,103
220610007-2,1140,473,667,1037,198,839,1061,178,883,1074,345,721,1459,320,1036,1428,330,1070,695,138,557,1401,325,1032,1415,413,966
220610006-3,155,57,98,153,24,129,150,19,131,147,43,103,216,37,175,214,40,173,98,15,83,202,42,151,203,55,141
22105000011,440,372,68,297,188,109,336,235,101,384,321,59,472,301,163,433,241,153,151,98,53,499,293,168,557,373,176
22105000018,369,336,33,281,214,67,289,204,85,325,297,28,459,358,93,411,293,94,167,116,51,491,342,109,516,401,101
2206300002A,712,167,545,706,47,659,709,48,661,703,140,561,1146,78,1037,1118,106,980,328,29,299,1258,70,1153,1249,106,1124
22073000041,1167,213,954,999,60,939,1014,58,956,1017,124,892,1505,98,1386,1456,115,1325,577,44,533,1542,102,1401,1572,146,1409
22073000008,1058,412,646,843,213,630,841,220,621,875,289,584,1326,322,970,1273,358,896,598,150,448,1219,356,826,1272,424,836
22073000028,201,132,69,142,69,73,139,73,66,150,96,52,303,176,109,287,166,114,99,52,47,282,162,108,302,185,110
22041000024,532,497,35,421,294,127,402,303,99,468,405,56,686,600,71,632,463,134,237,189,48,589,413,130,648,551,80
22041000019,317,83,234,352,32,320,358,43,315,360,62,296,396,58,336,391,81,308,212,26,186,418,37,376,422,50,370
220430004-3,177,34,143,170,15,155,170,16,154,174,28,146,267,17,238,254,17,231,86,4,82,247,23,219,248,25,221
22113000035,300,105,195,293,74,219,287,52,235,303,96,205,414,130,275,401,90,303,186,59,127,333,93,217,349,107,235
220330003-5,470,336,134,342,195,147,335,167,168,345,227,115,455,265,155,423,238,169,140,94,46,1105,522,549,1115,585,485
22033001-61,800,787,13,532,467,65,565,481,84,606,596,7,959,915,19,907,815,69,488,473,15,941,819,65,1029,971,43
22033001-22,341,339,2,221,189,32,222,193,29,238,227,7,370,348,11,351,314,31,186,183,3,461,397,42,484,453,22
22033002-31,232,207,25,173,138,35,174,128,46,193,168,24,371,317,44,351,267,62,163,137,26,339,256,55,364,313,45
220690004-1,199,123,76,158,58,100,152,55,97,164,87,77,229,115,105,217,111,104,93,49,44,260,94,152,272,118,147
220690003-1,362,39,323,360,14,346,356,20,336,359,39,320,502,39,455,469,47,419,194,7,187,497,35,458,515,46,468
22073000011,482,460,22,332,266,66,344,291,53,376,350,26,722,689,28,652,574,56,248,239,9,636,537,61,698,652,39
22073000002,864,244,620,600,98,502,595,90,505,622,143,475,1120,202,868,1067,201,840,318,60,258,1215,190,999,1250,217,1017
22073000010,266,230,36,191,135,56,186,127,59,205,161,42,445,374,60,411,321,78,121,103,18,374,292,71,392,336,50
22073000027,232,179,53,171,104,67,173,107,66,186,134,52,345,229,103,299,191,97,111,64,47,280,158,108,329,226,95
22073000072,575,227,348,444,109,335,438,103,335,447,152,295,681,162,491,650,165,466,309,89,220,680,212,456,702,250,447
220330002-7,1007,376,631,884,165,719,894,142,752,915,306,604,1445,327,1094,1404,323,1060,806,204,602,1409,308,1081,1428,370,1056
22033002-26,728,390,338,596,255,341,592,220,372,619,348,267,917,369,527,874,340,512,522,239,283,1030,309,687,1065,402,637
22033001-38,738,694,44,512,417,95,511,372,139,538,500,37,786,704,59,756,626,93,461,420,41,862,706,116,905,805,81
22033001-94,331,331,0,240,217,23,243,211,32,271,268,3,434,425,3,402,368,21,239,239,0,498,455,24,539,515,13
22033003-57,443,358,85,294,199,95,296,183,113,308,247,61,731,418,249,702,386,284,222,149,73,907,471,405,918,539,366
220330002-1,1239,1175,64,856,734,122,864,667,197,919,858,58,1459,1332,96,1386,1211,143,842,774,68,1453,1246,157,1536,1377,130
22033001-66,730,539,191,594,337,257,591,287,304,601,418,180,964,564,331,940,501,403,551,318,233,892,435,415,908,508,379
22033001-92,497,490,7,376,350,26,385,297,88,416,409,6,610,595,14,566,529,30,339,330,9,587,542,32,634,601,29
22033003-38,1312,483,829,1143,217,926,1175,201,974,1187,408,778,1559,313,1171,1561,286,1254,996,210,786,1535,331,1179,1517,372,1119
22113000009,413,116,297,462,78,384,460,63,397,472,136,331,577,84,471,576,69,489,244,47,197,668,100,546,709,125,576
22033001-69,868,560,308,676,282,394,679,238,441,681,429,250,1101,454,533,1089,424,639,693,321,372,1044,417,602,1049,477,543
22033001-43,694,341,353,583,163,420,581,134,447,591,266,322,848,278,508,848,247,585,588,178,410,903,292,597,878,322,541
22033001-12,861,451,410,708,165,543,717,148,569,728,328,395,987,276,607,965,278,664,630,189,441,1028,314,699,1021,358,636
22105000133,464,243,221,405,118,287,422,114,308,421,217,203,673,224,434,649,218,419,263,88,175,688,194,470,696,208,475
22073000005,913,520,393,704,248,456,716,256,460,745,323,420,1114,477,593,1065,479,565,568,217,351,994,457,499,1026,538,483
22015004-8A,796,244,552,566,130,436,571,120,451,565,173,386,980,200,742,971,221,741,420,93,327,1168,266,876,1176,286,866
22069001-5A,146,142,4,110,100,10,113,105,8,119,115,4,226,217,7,206,176,21,59,59,0,212,158,19,215,201,10
220690004-5,98,12,86,117,8,109,116,3,113,118,15,103,170,10,153,163,24,139,54,4,50,191,10,180,193,8,183
220690001-8,286,273,13,254,223,31,246,220,26,268,254,14,430,393,27,400,346,45,147,133,14,419,352,42,450,413,32
22073000057,1301,129,1172,1112,41,1071,1120,46,1074,1139,79,1057,1687,64,1599,1637,118,1500,657,23,634,1659,60,1574,1665,65,1588
22073000023,541,534,7,357,314,43,364,331,33,399,393,3,714,698,5,674,609,48,244,241,3,689,619,44,755,729,13
22073000017,410,381,29,278,217,61,278,224,54,302,276,26,547,496,48,490,432,48,197,182,15,482,409,46,515,465,42
22015004-8C,224,115,109,151,66,85,149,61,88,159,79,78,337,146,177,319,138,173,105,42,63,378,203,166,391,230,150
22073000036,296,50,246,251,31,220,249,24,225,262,46,216,427,42,379,412,48,359,169,11,158,411,33,358,412,37,368
22073000037,474,112,362,417,52,365,423,47,376,419,86,333,691,90,557,670,117,544,276,37,239,651,82,549,662,101,550
22073000034,76,33,43,78,22,56,83,29,54,91,39,52,222,95,115,210,93,110,62,32,30,185,60,116,182,65,115
22073000014,657,652,5,485,418,67,475,421,54,509,497,10,784,763,12,723,671,31,395,387,8,722,653,44,787,757,15
22073000051,744,101,643,648,36,612,643,42,601,655,77,578,892,48,823,875,77,791,330,20,310,1042,43,987,1039,56,974
2211300042B,40,11,29,34,9,25,33,6,27,35,9,25,45,6,36,45,6,35,12,6,6,53,6,46,55,7,48
22113036A-1,109,65,44,76,24,52,75,23,52,84,42,42,168,77,83,157,54,97,60,19,41,130,67,47,150,92,54
22113049B-1,1211,166,1045,1126,63,1063,1127,61,1066,1145,146,994,1514,121,1354,1458,101,1243,646,55,591,1684,126,1523,1717,134,1565
220810004-3,196,190,6,102,83,19,104,91,13,131,122,7,205,199,0,190,176,3,138,133,5,193,158,24,197,167,15
22017000126,384,102,282,325,42,283,325,47,278,322,67,252,544,74,452,529,95,425,253,37,216,557,96,452,568,107,451
22017000066,844,250,594,661,136,525,661,133,528,681,181,499,1191,237,925,1130,255,858,470,116,354,1292,277,983,1319,305,998
22017000049,936,343,593,776,193,583,779,185,594,791,281,498,1342,336,931,1292,338,940,741,175,566,1198,342,812,1211,413,772
220250002-1,243,166,77,179,96,83,182,102,80,222,145,77,276,162,109,262,139,112,113,67,46,226,122,94,246,152,91
220250003-2,369,39,330,298,8,290,303,10,293,317,22,294,406,9,395,381,30,345,150,5,145,410,4,397,417,9,405
220250003-1,177,19,158,157,8,149,160,5,155,159,9,149,183,5,176,178,18,152,88,12,76,212,6,204,218,8,208
220250002-2,251,61,190,269,35,234,271,37,234,283,56,225,307,50,253,286,52,232,167,35,132,259,33,215,263,44,215
220250008-1,324,226,98,253,134,119,260,155,105,278,193,84,337,228,106,310,181,117,145,79,66,314,183,120,350,224,124
22027000051,182,64,118,152,44,108,148,37,111,155,52,101,174,62,110,170,67,102,93,37,56,216,70,138,231,81,148
221150007-5,426,59,367,386,16,370,390,14,376,386,45,340,560,32,519,526,31,487,185,8,177,608,29,566,612,33,577
22109000051,647,200,447,582,88,494,584,85,499,601,183,409,951,203,717,917,199,692,294,49,245,934,159,737,949,190,740
22109000074,161,47,114,166,32,134,166,25,141,170,46,122,225,35,177,217,34,177,71,8,63,295,48,232,297,59,233
22109000057,721,142,579,676,64,612,692,52,640,691,166,516,1043,104,898,1002,136,804,413,52,361,1238,90,1097,1283,123,1151
22109000055,472,88,384,459,26,433,460,24,436,468,80,384,689,36,637,677,47,609,255,14,241,752,43,691,746,44,692
22109000072,514,112,402,474,50,424,470,52,418,477,115,356,702,91,596,668,92,545,252,20,232,834,83,722,860,100,755
22065000020,225,221,4,192,168,24,193,177,16,209,202,5,253,250,1,222,203,14,134,130,4,224,197,18,251,239,7
220030003-2,471,115,356,475,53,422,476,54,422,482,97,382,670,60,595,649,69,571,238,52,186,750,60,667,785,69,706
22065000017,191,186,5,141,117,24,145,135,10,154,140,12,194,186,6,160,133,21,77,67,10,189,162,22,217,202,9
22065000022,201,201,0,210,168,42,200,162,38,228,203,17,249,240,6,216,191,20,109,109,0,216,184,23,238,222,14
220910005-1,949,822,127,707,482,225,688,452,236,765,627,130,949,696,236,856,582,241,383,262,121,957,660,238,1049,797,229
22077000009,638,309,329,580,140,440,584,146,438,606,283,318,707,222,472,680,209,461,369,97,272,692,174,490,724,231,479
2210500141A,351,178,173,310,67,243,311,53,258,316,147,166,566,150,388,548,140,384,181,36,145,591,135,424,595,161,416
22105000117,566,286,280,514,107,407,518,91,427,534,265,266,771,132,610,740,148,571,292,66,226,876,151,694,886,177,701
22105000121,206,88,118,217,15,202,217,21,196,213,99,111,330,40,283,313,57,249,80,6,74,368,31,325,382,37,340
22063000001,1072,278,794,934,59,875,946,61,885,944,225,710,1471,110,1317,1448,140,1277,536,48,488,1656,168,1456,1667,199,1445
2206300003A,587,108,479,565,25,540,568,33,535,568,104,460,777,38,725,768,76,671,334,12,322,929,50,857,949,70,866
22063000015,281,88,193,256,27,229,256,28,228,259,73,185,387,49,324,367,71,294,139,17,122,503,53,438,532,72,455
22063000032,625,221,404,529,93,436,526,55,471,542,189,347,810,142,649,773,184,571,318,85,233,961,151,793,996,165,818
22063000009,810,321,489,716,87,629,717,99,618,732,265,458,1135,165,939,1068,202,830,368,71,297,1257,146,1076,1305,174,1115
220610004-3,548,63,485,513,21,492,510,19,491,520,48,468,766,19,727,730,52,674,268,10,258,823,38,771,846,56,776
22105000028,342,204,138,316,77,239,325,66,259,336,195,141,414,113,290,375,116,257,139,40,99,462,111,342,482,133,346
2210500115B,285,265,20,189,155,34,210,171,39,234,221,13,302,267,32,296,240,43,130,121,9,282,232,40,285,247,32
22035000013,359,350,9,300,217,83,285,232,53,341,318,19,448,429,10,415,347,50,165,158,7,347,297,35,379,340,29
221170003-2,545,488,57,536,423,113,530,387,143,571,496,71,727,586,122,687,506,151,300,237,63,656,507,107,690,574,102
22073000079,566,563,3,322,275,47,336,292,44,373,365,7,642,625,11,599,551,34,249,245,4,612,511,63,727,694,22
22063000026,469,149,320,458,44,414,460,45,415,468,139,326,693,61,595,665,72,575,287,32,255,763,99,632,771,124,621
2206300028B,73,23,50,62,8,54,63,10,53,64,23,40,115,10,102,113,14,98,34,1,33,86,19,63,90,25,65
22079000C33,425,177,248,351,76,275,345,59,286,361,124,236,574,111,445,561,115,431,235,51,184,630,158,453,635,204,414
22041000027,216,106,110,228,59,169,226,69,157,230,83,145,309,97,199,267,96,164,150,46,104,292,85,201,316,114,201
22041000014,458,157,301,376,64,312,377,78,299,395,102,290,554,154,390,526,145,369,222,44,178,486,138,328,516,187,323
22035000018,146,49,97,95,12,83,103,7,96,109,24,85,133,15,117,109,24,85,48,8,40,156,23,132,167,32,135
22109000004,731,182,549,604,82,522,598,87,511,607,170,429,1031,144,853,995,147,800,384,56,328,1164,154,948,1207,192,991
22109000064,234,57,177,209,8,201,205,5,200,206,42,162,336,24,307,330,38,284,128,13,115,390,25,354,394,33,355
22113000025,952,199,753,899,101,798,892,83,809,919,173,744,1345,184,1115,1324,149,1132,559,81,478,1249,174,1036,1280,206,1056
22079000S18,280,219,61,177,95,82,180,100,80,207,143,64,322,224,92,260,149,94,123,85,38,322,218,93,367,272,84
22079000C20,542,521,21,407,358,49,401,360,41,434,415,18,714,669,29,644,569,57,294,279,15,571,483,59,657,598,51
220790000C5,334,329,5,244,210,34,236,217,19,255,251,3,408,393,12,367,321,35,138,137,1,429,353,53,488,461,24
22079000N27,713,136,577,736,44,692,730,43,687,744,120,620,1101,62,1014,1054,81,957,442,35,407,1186,55,1111,1208,62,1137
2201502-21A,604,161,443,483,82,401,483,74,409,481,117,363,859,158,667,823,171,632,439,73,366,882,221,648,890,257,624
2201502-18B,506,96,410,449,52,397,446,61,385,457,90,367,713,61,632,700,81,612,328,35,293,735,91,634,745,108,626
220290003-3,376,60,316,410,34,376,414,47,367,424,86,332,609,51,545,553,66,475,132,11,121,606,40,561,621,35,582
22003005-13,0,0,0,0,0,0,0,0,0,0,0,0,0,0,0,0,0,0,0,0,0,0,0,0,0,0,0
220290002-1,523,452,71,493,363,130,472,342,130,552,446,105,827,617,202,726,512,186,398,347,51,626,391,207,688,480,195
220290003-2,252,53,199,298,37,261,294,43,251,296,61,227,475,38,425,425,67,348,150,22,128,419,69,342,450,60,384
2200302-4-C,262,133,129,291,71,220,294,75,219,300,142,154,449,84,351,427,77,331,123,28,95,400,71,308,419,93,322
220030002-1,235,120,115,223,58,165,227,66,161,242,116,124,304,84,203,288,82,204,87,27,60,316,75,230,326,98,220
2201502-18G,375,104,271,290,55,235,290,53,237,296,77,217,433,76,336,417,83,328,187,35,152,562,91,457,567,109,447
2201502-18E,1061,293,768,823,157,666,830,153,677,833,213,612,1223,210,951,1182,229,935,543,107,436,1600,260,1296,1610,308,1267
2201502-21C,1197,210,987,988,86,902,993,91,902,1012,169,841,1324,127,1156,1295,150,1140,804,86,718,1347,153,1179,1358,183,1159
2201502-22C,351,50,301,297,17,280,295,12,283,298,43,255,386,30,347,368,28,338,275,19,256,378,15,363,371,19,348
2201502-21D,1219,354,865,949,186,763,946,184,762,958,264,688,1622,309,1219,1567,310,1217,787,141,646,1608,375,1196,1622,420,1173
22109000007,797,563,234,641,377,264,642,385,257,701,466,229,1131,706,401,1035,583,415,360,215,145,1046,553,444,1133,667,453
22093000005,326,223,103,319,131,188,328,134,194,327,189,136,528,259,262,499,228,260,202,84,118,510,205,283,537,249,283
22093000004,533,297,236,513,142,371,525,142,383,534,260,267,645,260,371,593,238,348,290,93,197,684,210,455,720,247,468
221270001-5,222,191,31,161,90,71,163,110,53,182,150,32,242,186,53,215,143,61,91,75,16,246,184,54,279,206,67
221270006-3,283,31,252,286,26,260,295,36,259,311,36,274,344,18,323,333,35,295,160,10,150,356,16,332,383,22,358
221270005-5,276,35,241,278,12,266,285,10,275,279,24,252,434,12,422,413,38,373,154,9,145,431,15,415,430,18,412
22097000016,525,81,444,506,27,479,505,36,469,521,81,437,696,42,650,642,49,585,197,19,178,785,28,746,820,35,781
22097000039,766,158,608,676,61,615,671,55,616,689,125,564,971,100,860,899,78,803,371,38,333,1129,118,985,1156,128,1016
22097000009,772,544,228,647,368,279,649,370,279,694,449,244,937,583,338,838,427,388,380,254,126,969,531,404,1080,683,384
22097000002,680,421,259,567,257,310,582,269,313,620,353,261,776,428,333,701,316,365,320,192,128,829,403,391,892,483,396
22041000026,83,27,56,136,23,113,137,12,125,138,25,112,172,21,145,156,28,121,100,5,95,145,11,127,149,11,134
220430006-3,170,31,139,149,17,132,147,16,131,144,20,123,270,20,237,251,28,215,79,10,69,217,19,190,233,19,207
2206300013B,503,135,368,444,42,402,458,34,424,467,112,351,618,71,534,596,85,498,248,30,218,770,74,676,785,97,675
22097000015,700,314,386,636,136,500,643,155,488,699,229,460,968,310,628,861,196,640,265,97,168,938,243,661,1029,367,652
22093000011,297,236,61,236,123,113,237,119,118,256,181,65,345,237,105,303,181,112,154,93,61,362,205,148,403,262,137
22093000010,302,175,127,273,111,162,274,106,168,287,168,114,368,171,190,354,144,201,129,64,65,389,153,222,428,201,225
2200302-4-O,368,164,204,353,101,252,355,97,258,372,163,209,518,156,351,491,126,358,184,50,134,467,121,336,492,161,326
220030005-7,330,308,22,263,217,46,260,210,50,286,255,28,490,439,42,454,379,55,137,117,20,419,313,72,477,405,60
220130002-5,34,25,9,25,16,9,24,16,8,25,20,5,48,21,27,46,19,25,23,15,8,23,14,9,20,11,9
22039001041,388,111,277,387,73,314,394,87,307,411,131,278,492,93,392,455,73,370,160,45,115,465,67,378,479,73,402
22039001040,158,96,62,130,61,69,127,55,72,149,85,64,197,117,76,164,76,86,97,57,40,181,77,95,191,90,95
22009010-3A,284,93,191,239,34,205,237,31,206,248,73,175,340,57,275,320,47,271,162,32,130,355,50,295,368,58,303
220090003-1,518,391,127,468,262,206,473,248,225,532,381,147,660,455,189,603,372,203,272,187,85,595,338,224,656,444,196
220090002-4,432,300,132,388,194,194,381,185,196,427,284,143,592,337,244,531,290,222,236,128,108,471,212,229,511,254,242
220130001-3,110,57,53,105,42,63,108,47,61,111,51,58,120,53,64,111,50,60,64,35,29,132,59,71,127,58,69
220750001-2,299,259,40,262,159,103,264,169,95,307,249,53,384,302,70,365,265,94,267,207,60,369,215,125,418,288,122
220850007-3,201,23,178,208,11,197,207,11,196,208,20,188,246,11,233,236,23,212,100,5,95,308,8,297,319,13,305
22019000338,493,221,272,495,115,380,497,101,396,510,219,288,732,190,499,700,140,542,330,95,235,453,113,318,464,155,296
22019000339,872,329,543,845,159,686,846,143,703,837,298,538,1307,233,988,1294,181,1082,530,111,419,817,148,637,833,182,632
22019000660,581,99,482,584,42,542,592,44,548,580,80,496,968,48,888,918,58,831,329,52,277,1353,69,1261,1359,63,1286
22103000410,743,292,451,635,143,492,634,102,532,646,243,399,953,209,679,924,168,736,429,91,338,877,191,663,904,233,645
22055000095,1094,207,887,957,125,832,960,104,856,951,172,774,1241,168,1030,1223,132,1067,607,72,535,1181,140,1002,1172,158,983
22103000M08,516,214,302,404,74,330,411,77,334,414,168,242,659,132,493,638,118,509,317,48,269,653,108,533,671,163,493
22103000M04,529,256,273,417,132,285,418,120,298,428,220,202,704,174,482,681,155,506,319,107,212,746,175,545,765,210,537
22103000F01,590,320,270,517,207,310,523,194,329,545,299,242,881,386,463,833,330,486,372,152,220,950,353,560,965,400,552
22011000022,436,93,343,426,31,395,425,34,391,431,78,352,509,31,461,509,41,460,211,21,190,618,30,573,630,39,583
2201100014A,262,58,204,249,31,218,249,18,231,258,56,199,337,16,309,333,27,297,117,24,93,348,17,326,355,28,316
22103000905,587,262,325,488,134,354,495,122,373,512,224,274,963,237,674,904,230,628,305,71,234,1150,320,790,1196,387,788
22103000S10,598,242,356,541,146,395,543,134,409,549,245,300,920,192,669,893,188,672,456,126,330,1078,262,777,1088,300,762
22019000662,250,74,176,264,41,223,263,36,227,265,86,179,363,78,280,342,66,272,134,41,93,510,71,418,515,96,412
22103000S22,548,246,302,475,157,318,481,151,330,483,211,268,738,218,493,713,223,479,312,111,201,805,235,552,820,269,545
22103000903,819,242,577,622,93,529,638,74,564,645,206,433,1192,169,980,1135,182,927,412,49,363,1485,191,1249,1529,264,1249
22103000406,326,115,211,361,62,299,362,52,310,369,114,251,519,68,422,508,52,440,240,32,208,545,85,437,546,98,437
22103000S24,194,174,20,162,125,37,158,123,35,177,151,20,404,315,82,351,257,81,111,81,30,391,292,80,438,340,86
22103000701,719,449,270,620,269,351,624,264,360,657,406,245,990,466,490,938,403,511,389,184,205,1181,539,584,1232,637,577
22103000805,676,227,449,530,92,438,549,74,475,552,148,395,1020,192,784,977,198,755,409,88,321,1090,200,859,1115,255,840
22103000103,724,216,508,609,62,547,612,65,547,609,193,413,641,87,520,640,61,577,313,29,284,680,65,611,679,93,579
22103000M06,591,264,327,431,99,332,433,88,345,443,177,259,829,160,634,795,135,642,373,55,318,743,180,549,758,205,531
22103000S17,528,216,312,458,99,359,459,98,361,459,194,258,765,204,526,746,204,530,318,70,248,835,210,609,856,244,609
2204900010A,120,8,112,112,2,110,114,4,110,110,11,99,144,7,136,141,14,124,93,5,88,136,4,130,140,6,132
22103000C02,358,162,196,277,51,226,283,45,238,288,123,164,473,96,357,460,75,372,259,40,219,407,77,324,411,98,307
22103000816,322,132,190,280,68,212,279,62,217,278,110,167,500,119,349,487,116,359,262,62,200,532,115,408,546,149,387
2201900316W,129,96,33,82,43,39,82,41,41,87,59,28,247,150,83,230,103,115,58,29,29,116,66,43,129,90,36
22019000363,1085,290,795,997,141,856,1008,120,888,1001,256,742,1440,180,1196,1441,148,1281,768,97,671,805,119,656,801,146,634
22019000306,781,327,454,681,166,515,686,139,547,689,284,401,1006,221,721,1003,170,802,458,101,357,591,100,477,608,164,431
22019000664,502,141,361,471,69,402,468,68,400,470,119,350,772,105,646,738,77,640,257,53,204,1067,133,893,1057,143,892
22019000461,385,148,237,360,92,268,363,85,278,364,134,227,753,237,478,716,203,501,213,91,122,667,161,461,684,191,469
22055000118,591,130,461,504,48,456,505,55,450,507,87,412,782,96,660,758,67,658,316,39,277,809,121,658,824,151,651
2201100017A,255,48,207,229,8,221,226,10,216,234,32,200,263,10,253,265,22,237,85,10,75,329,17,306,347,17,330
22055000067,675,198,477,540,79,461,535,61,474,548,135,411,908,173,677,897,121,744,392,73,319,1014,197,775,1028,243,763
22055000125,898,219,679,802,130,672,800,98,702,805,176,627,1180,190,932,1165,143,994,551,86,465,1186,190,970,1185,222,933
22055000066,206,152,54,200,121,79,198,93,105,211,146,63,340,211,94,331,168,135,163,120,43,387,251,111,392,266,112
22011000020,538,105,433,522,43,479,525,47,478,522,88,428,689,66,596,670,60,598,255,24,231,831,50,757,849,59,779
22103000503,634,145,489,555,39,516,559,39,520,557,102,451,940,76,849,923,103,808,393,40,353,1127,91,995,1148,95,1040
22055000017,543,502,41,362,299,63,351,293,58,401,360,41,763,680,71,708,521,166,188,167,21,746,601,81,831,756,64
22103000407,643,241,402,542,92,450,553,93,460,563,217,339,826,161,606,817,125,686,449,59,390,707,121,568,706,143,539
22031000060,157,143,14,106,81,25,113,91,22,115,95,20,238,182,54,221,170,49,131,95,36,221,139,53,246,202,43
220670026-1,383,103,280,345,55,290,346,57,289,353,75,278,537,85,446,502,80,419,210,41,169,484,58,418,499,69,428
22067000027,344,38,306,403,19,384,410,16,394,424,33,391,883,48,822,836,65,766,313,21,292,523,25,492,537,20,516
22031000055,213,124,89,172,71,101,180,86,94,193,104,88,243,126,111,214,93,117,129,66,63,319,152,163,330,163,162
22055000126,739,172,567,670,83,587,671,64,607,662,153,506,1022,136,853,1011,113,877,500,57,443,917,168,732,915,183,704
22055000014,446,354,92,352,238,114,352,236,116,369,274,93,648,463,158,625,380,223,222,143,79,649,436,174,692,501,172
22103000S03,519,204,315,436,74,362,440,68,372,437,153,274,811,151,629,770,150,600,373,47,326,895,179,689,912,213,679
22103000904,673,433,240,504,262,242,502,240,262,535,344,181,1038,531,461,984,486,470,339,161,178,1240,662,515,1294,755,519
22103000310,908,276,632,812,113,699,822,101,721,833,258,569,1124,180,895,1129,148,964,643,82,561,1210,210,972,1221,267,928
22103000S18,359,125,234,322,51,271,328,43,285,325,105,213,477,101,362,459,95,357,233,43,190,606,108,468,624,129,483
22103000S15,340,175,165,307,129,178,305,113,192,309,165,140,592,182,382,567,189,359,251,69,182,771,288,447,788,331,435
22057002-13,692,308,384,669,130,539,665,128,537,687,284,390,791,171,603,755,174,568,370,83,287,966,151,784,998,199,783
22057002-1A,163,89,74,126,55,71,123,49,74,134,76,56,196,107,79,182,88,80,80,32,48,220,98,112,223,106,113
220890006-7,193,88,105,191,36,155,188,28,160,188,75,111,314,82,215,298,81,208,118,31,87,289,58,215,303,73,222
220890006-8,250,141,109,214,62,152,227,57,170,229,126,101,371,84,259,364,88,270,129,22,107,372,99,251,374,110,252
220890003-3,514,242,272,478,65,413,481,62,419,483,201,278,740,117,584,723,119,586,337,54,283,545,73,445,558,113,426
22051000192,714,371,343,683,160,523,701,161,540,707,318,383,1216,382,784,1171,343,793,461,119,342,1310,374,884,1350,458,879
22051000246,185,45,140,223,17,206,220,15,205,232,57,169,402,52,340,385,44,318,143,14,129,520,35,469,542,57,479
220070002-3,448,212,236,380,98,282,383,95,288,399,172,224,546,153,376,516,138,358,230,59,171,570,143,401,576,159,406
22051000087,472,227,245,399,74,325,409,45,364,410,171,232,604,148,400,595,113,469,267,63,204,598,146,446,616,193,411
22051000103,446,185,261,364,69,295,383,44,339,391,163,225,585,137,412,578,72,500,314,63,251,526,71,448,530,105,415
2205100125A,299,216,83,274,145,129,279,130,149,279,191,88,633,308,283,600,271,303,219,116,103,487,268,192,516,311,198
22051000228,530,358,172,404,183,221,412,161,251,422,285,136,842,426,378,800,390,388,285,133,152,828,425,346,895,515,367
220890005-3,404,274,130,380,179,201,376,163,213,396,238,151,582,233,300,552,224,313,228,108,120,610,256,334,625,288,320
220890005-4,740,445,295,641,258,383,651,239,412,666,386,275,1028,497,495,988,436,530,383,177,206,967,443,482,1020,539,470
220570001-1,883,270,613,821,104,717,834,108,726,838,267,558,1184,153,992,1143,166,941,416,49,367,1453,225,1178,1493,229,1234
2201900166E,400,124,276,489,62,427,491,50,441,483,126,356,538,61,458,528,54,462,274,42,232,685,101,575,709,120,575
22101000017,335,177,158,318,122,196,307,112,195,331,161,164,429,170,249,389,159,209,166,58,108,412,161,223,441,192,241
220570004-1,712,166,546,732,48,684,727,39,688,731,169,558,1180,105,1050,1135,147,972,515,46,469,927,49,851,934,63,857
220570009-2,298,77,221,294,29,265,285,27,258,293,88,201,406,40,354,405,50,350,191,18,173,382,24,349,387,31,352
220570007-4,603,436,167,445,240,205,453,186,267,503,339,155,798,548,245,712,427,260,282,173,109,536,282,199,660,454,197
220570006-5,821,226,595,807,57,750,813,54,759,817,243,570,1165,123,1011,1115,131,963,420,50,370,1390,104,1262,1414,120,1275
220570006-1,549,151,398,539,38,501,540,35,505,541,162,377,782,82,678,752,89,645,280,34,246,936,68,844,948,79,855
22019000800,493,273,220,427,164,263,426,164,262,436,221,215,705,297,388,695,237,444,252,111,141,1026,429,562,1104,547,537
22019000760,281,60,221,282,33,249,276,26,250,282,52,229,503,59,437,476,51,411,170,35,135,758,87,651,753,75,664
22019000329,630,551,79,497,352,145,486,352,134,529,450,76,925,685,210,892,559,308,260,202,58,618,427,139,685,565,99
22019000440,720,327,393,686,159,527,682,164,518,701,293,405,1131,305,798,1045,219,808,354,107,247,1157,248,856,1196,317,854
22031000051,134,21,113,139,13,126,139,12,127,140,20,119,164,16,148,161,25,134,80,12,68,259,24,233,266,27,236
22101000022,582,125,457,499,70,429,499,76,423,500,113,381,847,113,719,817,131,670,302,44,258,918,140,752,933,156,767
22101000042,181,158,23,179,142,37,180,137,43,200,170,28,311,241,65,270,195,54,99,77,22,211,155,46,207,158,42
22019000467,569,171,398,572,93,479,579,77,502,553,152,398,890,161,702,848,123,712,204,42,162,1253,213,988,1242,215,998
2201900166W,414,152,262,470,103,367,468,96,372,477,152,325,671,138,494,655,92,545,222,54,168,826,160,644,857,203,647
22051000225,442,404,38,337,254,83,331,226,105,346,305,34,812,637,143,745,542,160,182,150,32,850,649,159,930,749,162
22051000031,539,254,285,426,75,351,428,60,368,438,184,251,640,151,456,604,127,468,271,41,230,687,177,491,690,202,459
22051000078,675,406,269,524,202,322,526,173,353,542,294,243,1066,464,564,1027,426,569,419,127,292,935,428,472,978,512,451
22051000007,460,233,227,381,83,298,385,68,317,397,181,210,646,168,436,623,149,459,262,64,198,738,239,465,756,284,451
220510031-K,207,185,22,150,121,29,150,123,27,178,162,14,306,280,23,257,218,31,127,118,9,278,224,34,341,296,34
220070007-3,160,55,105,137,16,121,135,9,126,145,50,95,195,20,171,181,33,148,60,4,56,205,16,187,215,14,197
22051000212,502,498,4,316,287,29,311,271,40,374,366,8,702,681,10,610,582,22,235,231,4,688,630,25,761,724,23
2204900020A,294,285,9,266,232,34,264,234,30,284,270,11,452,433,9,399,337,43,157,152,5,367,298,51,406,375,21
2201900162E,548,141,407,689,69,620,692,68,624,677,143,528,897,94,754,880,73,791,350,64,286,1113,145,924,1113,167,913
22019000167,409,122,287,475,78,397,472,66,406,474,129,342,755,107,609,715,94,608,276,45,231,824,130,669,838,143,677
220070001-2,695,497,198,616,337,279,628,337,291,657,449,201,874,482,364,819,462,343,361,212,149,772,404,339,821,471,331
220070001-1,408,377,31,283,242,41,280,228,52,329,287,38,451,386,53,410,343,58,182,160,22,413,345,47,481,431,46
22101000025,522,399,123,389,249,140,408,258,150,440,318,121,697,484,204,633,400,218,255,165,90,609,337,230,676,440,225
22101000024,409,138,271,363,89,274,360,84,276,366,111,251,620,174,430,602,155,435,216,39,177,631,136,469,662,183,472
22047000027,374,90,284,486,19,467,490,21,469,476,122,349,457,38,416,439,62,362,238,17,221,567,20,531,573,38,531
22051000075,372,170,202,313,73,240,324,59,265,337,143,185,517,111,373,500,110,377,216,51,165,605,161,412,614,187,418
22051000156,678,637,41,469,385,84,466,362,104,525,464,57,1159,1011,134,1058,861,143,341,299,42,1008,775,157,1118,927,182
2205100157B,0,0,0,0,0,0,0,0,0,0,0,0,0,0,0,0,0,0,0,0,0,0,0,0,0,0,0
22051000072,369,156,213,320,56,264,326,49,277,334,135,196,537,138,362,517,126,375,222,37,185,648,150,475,665,174,472
22051000182,236,135,101,237,73,164,244,64,180,249,114,135,448,179,253,426,166,242,151,70,81,384,113,253,396,134,256
220070002-2,57,14,43,55,0,55,52,1,51,56,8,47,77,12,65,74,18,55,33,4,29,63,12,47,70,10,60
220070005-2,349,178,171,379,96,283,381,81,300,404,186,213,535,169,350,499,134,350,246,88,158,442,105,328,487,150,333
22051000021,406,174,232,338,80,258,342,68,274,349,136,210,541,134,375,521,124,378,239,52,187,556,135,390,589,172,407
22051000121,567,218,349,503,86,417,515,74,441,520,189,327,782,173,573,765,122,633,413,93,320,667,103,550,661,136,512
22051000033,384,169,215,369,78,291,381,68,313,384,167,217,524,150,351,516,137,365,219,47,172,520,153,346,520,183,331
220510013-G,313,146,167,243,78,165,246,66,180,249,113,136,392,145,237,372,121,247,196,63,133,391,121,258,406,143,257
220510025-K,566,288,278,469,106,363,486,101,385,505,240,259,883,347,500,796,268,497,343,105,238,803,241,516,894,372,514
2205100197B,789,742,47,593,500,93,591,482,109,632,574,52,1067,966,77,1002,870,107,417,378,39,1034,914,79,1090,999,77
22051000183,303,174,129,264,90,174,266,67,199,299,177,116,459,174,271,399,143,236,196,70,126,403,128,241,462,185,269
220570002-7,396,367,29,306,237,69,307,227,80,346,309,31,499,424,67,433,325,87,192,156,36,454,331,90,527,443,78
220570010-1,403,119,284,412,73,339,406,59,347,419,138,280,586,99,467,554,93,427,225,39,186,620,88,518,633,76,547
220570004-5,646,175,471,626,49,577,627,22,605,626,162,454,959,88,841,930,124,786,449,37,412,981,54,898,997,68,921
22051000069,456,203,253,374,79,295,378,57,321,380,163,216,554,123,399,536,112,409,267,57,210,696,201,473,705,242,452
22051000119,461,204,257,388,79,309,390,45,345,396,167,228,554,112,397,550,103,437,301,61,240,606,129,454,609,172,427
220510009-G,434,211,223,370,103,267,369,91,278,384,182,196,734,280,425,695,245,424,262,70,192,746,271,442,791,323,459
220510005-W,602,279,323,507,87,420,520,71,449,534,245,277,974,235,705,916,207,637,347,68,279,976,219,679,1034,267,752
22051000172,330,204,126,300,108,192,316,95,221,325,188,133,721,309,394,658,236,375,226,99,127,556,213,310,589,242,331
220510018-K,114,79,35,83,38,45,81,32,49,85,54,29,199,114,76,189,98,88,72,37,35,215,131,76,232,147,85
22031000001,122,107,15,106,76,30,104,85,19,121,105,14,179,155,20,167,138,23,78,66,12,181,133,32,188,165,23
22051000203,443,257,186,380,147,233,383,143,240,400,243,150,666,233,412,617,222,369,192,80,112,796,265,478,835,317,511
22051000177,299,135,164,277,65,212,283,50,233,279,133,142,473,97,358,457,89,355,179,40,139,527,118,388,548,158,386
220510020-K,682,279,403,602,113,489,616,98,518,628,235,387,1026,282,697,978,252,701,495,91,404,1126,336,756,1167,420,735
22051000045,453,246,207,413,134,279,416,107,309,424,209,210,642,233,378,620,194,414,266,91,175,768,297,440,777,328,427
22051000005,462,186,276,392,73,319,398,54,344,401,167,230,564,123,406,550,89,458,281,46,235,659,150,493,670,179,477
22053000019,879,343,536,746,196,550,746,173,573,772,289,477,1248,329,887,1238,276,944,491,145,346,1272,297,946,1309,344,939
22053000014,649,171,478,548,73,475,547,70,477,543,137,403,780,79,668,754,62,683,319,57,262,970,95,846,982,108,860
220510009-H,340,142,198,325,62,263,336,49,287,340,131,206,484,106,358,473,92,373,216,45,171,595,143,433,622,172,438
2205100157A,837,550,287,637,310,327,630,283,347,697,457,231,1314,672,608,1224,587,576,422,216,206,1366,675,608,1437,763,657
220510003-W,326,140,186,299,43,256,309,36,273,302,143,154,572,125,424,528,114,333,161,31,130,580,99,411,605,130,455
22051000205,714,679,35,541,463,78,546,447,99,578,533,38,975,870,77,912,799,97,394,363,31,941,830,78,986,892,73
220510004-H,651,238,413,606,78,528,614,83,531,617,235,381,880,139,705,863,148,696,400,63,337,989,170,792,1002,208,773
22051000038,433,190,243,384,65,319,393,51,342,394,163,226,656,142,478,642,135,503,295,65,230,667,152,506,681,178,492
220510008-H,763,288,475,658,100,558,680,95,585,684,265,413,956,165,744,947,136,801,522,70,452,1011,162,831,1007,212,782
220890004-4,543,370,173,492,267,225,487,239,248,501,356,135,830,455,352,770,421,328,294,169,125,780,393,343,838,455,371
22051000150,1050,755,295,819,450,369,808,423,385,844,586,247,1498,868,580,1397,757,584,557,308,249,1599,918,602,1628,990,617
22051000171,53,44,9,45,35,10,45,31,14,45,42,3,93,71,22,80,55,22,30,22,8,88,61,23,101,74,26
22051000236,681,543,138,483,285,198,490,277,213,518,382,129,972,669,267,907,578,300,358,224,134,1011,654,300,1098,778,297
22051000098,674,305,369,612,134,478,625,89,536,638,305,333,882,242,598,852,188,652,496,116,380,811,188,594,821,242,561
22051000056,455,210,245,389,104,285,392,89,303,397,175,215,714,188,474,676,179,469,271,74,197,750,193,518,769,239,515
22047000003,575,533,42,499,415,84,495,388,107,572,516,48,577,501,64,527,420,89,247,210,37,580,451,87,640,539,74
22047000001,494,434,60,419,323,96,405,298,107,476,414,57,556,429,118,493,336,139,251,182,69,552,408,113,586,487,84
22047000022,1018,540,478,1008,429,579,986,381,605,1026,596,417,1259,480,747,1180,436,712,571,216,355,1208,403,763,1260,478,768
22087000011,434,271,163,362,123,239,367,91,276,367,231,131,597,190,367,588,187,382,261,95,166,583,200,354,585,214,354
22099000009,338,277,61,294,173,121,283,193,90,315,235,77,475,365,95,433,255,159,179,118,61,352,238,87,404,307,84
22051000023,283,211,72,182,93,89,190,87,103,196,126,67,526,320,182,482,278,184,121,53,68,532,330,177,565,386,166
22051000181,490,452,38,333,283,50,337,277,60,401,372,25,746,669,70,682,576,85,288,267,21,732,623,87,808,711,91
22051000184,775,302,473,738,166,572,752,148,604,770,306,447,1313,295,976,1277,284,958,479,116,363,1311,313,915,1341,353,957
220590009-4,20,4,16,15,0,15,15,0,15,16,0,16,22,0,22,22,1,21,11,0,11,17,0,17,17,0,17
22071009-23,245,241,4,161,148,13,174,144,30,183,179,3,350,339,1,325,297,19,141,140,1,317,293,7,375,357,6
22071004-23,322,180,142,287,91,196,304,68,236,306,154,148,435,155,245,442,139,298,280,90,190,388,129,257,395,142,247
22071003-12,731,699,32,563,493,70,571,462,109,606,572,31,884,750,75,832,703,106,461,420,41,789,641,84,856,739,82
2207109-44I,292,281,11,288,270,18,292,245,47,296,291,5,406,352,38,382,315,60,257,242,15,273,204,53,282,223,56
2207109-31D,385,375,10,296,271,25,307,259,48,327,313,8,426,402,12,395,375,10,256,246,10,477,429,27,532,503,21
22097000027,701,291,410,617,181,436,620,173,447,633,259,368,880,268,590,850,223,608,369,103,266,826,258,545,832,279,540
220910004-2,132,94,38,115,65,50,118,60,58,120,83,37,144,72,66,137,70,64,80,43,37,144,64,74,149,69,79
22077000007,466,325,141,428,226,202,420,215,205,448,299,145,591,378,201,568,347,214,265,160,105,537,298,216,574,364,203
22077000003,378,172,206,323,88,235,329,94,235,365,151,214,415,137,269,397,140,250,179,55,124,419,86,315,455,138,309
22077000004,196,170,26,143,90,53,139,79,60,197,161,34,232,185,43,210,155,47,107,82,25,199,120,62,251,195,53
22015002-14,277,138,139,185,60,125,185,62,123,198,83,112,415,164,235,392,150,226,162,56,106,469,205,249,492,230,259
22071009-14,279,275,4,199,189,10,204,176,28,207,205,2,357,316,15,343,304,28,196,190,6,338,304,18,331,307,13
22053000021,602,220,382,580,88,492,587,94,493,593,198,392,878,167,676,848,113,701,310,63,247,934,162,746,953,195,737
220710006-2,399,338,61,305,228,77,305,179,126,311,259,51,515,366,127,504,328,156,328,240,88,588,419,152,574,444,124
2207114-13A,513,469,44,216,157,59,215,140,75,216,177,35,1147,946,127,1071,832,205,388,310,78,757,616,121,736,622,98
2207114-18A,336,256,80,257,125,132,261,97,164,264,197,67,522,338,145,497,285,210,286,191,95,464,292,163,448,314,128
220450005-4,894,238,656,846,111,735,862,111,751,870,189,672,1126,178,899,1075,159,814,552,84,468,1147,156,965,1164,192,960
220450004-1,592,346,246,493,205,288,487,214,273,519,279,238,878,436,411,820,320,418,300,120,180,745,343,352,787,402,372
220290003-1,245,49,196,271,18,253,271,15,256,278,47,225,359,25,328,318,29,282,150,21,129,308,21,283,311,28,280
22105000105,72,26,46,47,14,33,47,15,32,50,26,24,75,14,59,73,12,44,31,9,22,89,20,61,96,27,68
22105000120,802,225,577,682,62,620,680,52,628,685,187,497,1082,94,956,1043,105,909,384,40,344,1288,129,1118,1288,140,1132
220330002-6,1072,501,571,1035,293,742,1047,248,799,1080,443,636,1631,505,1101,1579,468,1082,901,308,593,1771,516,1227,1775,565,1186
22033002-17,618,507,111,428,295,133,430,266,164,476,381,93,806,610,176,759,565,161,404,285,119,772,566,183,828,643,173
22033002-15,427,317,110,352,206,146,340,180,160,370,261,102,516,305,200,500,280,204,306,175,131,553,281,245,587,327,250
22033001-77,1087,1077,10,856,749,107,854,675,179,907,891,9,1311,1268,28,1231,1145,63,787,772,15,1345,1184,78,1449,1377,47
220330003-4,994,536,458,822,288,534,825,252,573,832,422,406,1100,395,624,1078,354,698,641,246,395,1193,405,754,1212,480,701
22033003-25,945,258,687,872,124,748,878,106,772,871,227,643,1375,183,1152,1323,198,1110,779,125,654,1448,190,1222,1456,227,1210
22037000003,432,171,261,389,80,309,393,82,311,392,156,236,555,146,398,539,135,395,260,66,194,578,111,435,602,163,425
22065000019,220,220,0,163,141,22,164,150,14,180,175,0,310,306,1,277,243,29,88,88,0,200,177,14,210,202,2
22065000006,29,9,20,29,10,19,27,8,19,31,12,19,35,13,20,30,10,20,13,3,10,30,16,9,32,17,14
2209700007A,251,109,142,206,64,142,212,57,155,231,90,139,332,117,213,294,79,204,100,43,57,347,93,246,375,126,245
221150001-9,74,5,69,65,2,63,67,2,65,65,3,62,75,3,69,76,9,67,37,1,36,104,5,97,105,10,95
221150001-7,306,59,247,317,21,296,320,29,291,325,62,259,471,68,389,446,62,362,165,22,143,532,91,406,569,120,431
22097000037,643,208,435,572,125,447,564,112,452,576,168,408,748,188,547,730,161,560,318,98,220,824,176,630,843,191,644
22121000005,233,76,157,242,22,220,247,14,233,234,62,167,293,30,253,295,34,255,187,13,174,275,32,239,279,45,230
2212100010A,217,71,146,240,23,217,239,21,218,233,85,148,243,34,205,237,39,191,175,26,149,252,26,225,255,33,221
2207109-43H,152,149,3,111,102,9,110,93,17,126,115,4,183,180,1,169,160,5,73,73,0,216,193,12,247,238,6
2207109-35A,132,132,0,107,95,12,115,100,15,120,119,0,236,233,1,219,204,9,107,106,1,150,141,5,163,157,5
22071015-14,344,296,48,255,174,81,266,155,111,276,240,33,435,293,134,419,271,132,175,121,54,499,355,127,520,383,127
2207115-12A,312,305,7,229,211,18,230,184,46,240,237,3,411,382,22,377,348,22,160,149,11,505,461,22,586,556,27
221270005-2,186,46,140,219,27,192,215,30,185,228,44,177,310,48,254,292,58,226,175,45,130,324,36,279,322,42,272
22065000026,98,26,72,65,2,63,68,8,60,73,38,35,116,12,102,97,10,84,45,3,42,124,6,111,125,8,117
22033003-21,1005,651,354,826,395,431,831,360,471,827,515,306,1553,816,652,1491,738,704,638,328,310,1317,650,629,1354,757,574
220330002-3,521,390,131,465,279,186,456,252,204,473,338,135,626,391,216,612,387,213,393,244,149,648,392,240,667,431,229
22033003-69,1051,585,466,923,283,640,926,235,691,915,466,448,966,335,553,948,302,628,572,222,350,1359,379,960,1337,482,813
22071004-14,859,489,370,692,235,457,703,165,538,723,431,288,929,295,543,925,261,650,491,178,313,1188,419,744,1166,490,635
2207109-28C,327,326,1,209,197,12,203,173,30,223,219,4,513,507,1,484,445,24,134,134,0,519,458,32,593,569,13
220710012-9,277,265,12,191,151,40,194,131,63,204,187,17,397,336,41,389,319,66,202,172,30,376,309,51,378,324,45
22033002-37,489,423,66,401,323,78,413,307,106,441,379,54,616,309,279,593,271,310,379,200,179,664,518,134,688,556,128
22033001-19,296,289,7,188,165,23,196,160,36,223,215,7,409,392,9,369,331,27,225,214,11,360,309,30,404,380,18
22033003-35,1155,520,635,1041,271,770,1050,220,830,1044,449,591,1225,379,767,1215,334,863,824,245,579,1414,406,985,1393,452,902
22033001-10,628,623,5,467,408,59,486,399,87,548,537,8,768,756,8,715,663,45,426,419,7,800,703,50,868,830,22
22033001-87,1019,732,287,847,447,400,840,396,444,862,585,272,1177,601,509,1159,584,555,647,306,341,1303,779,491,1317,840,458
2210500137D,556,138,418,514,41,473,517,40,477,510,134,375,698,53,632,686,62,623,376,15,361,808,61,737,810,69,736
22105000049,416,318,98,297,169,128,296,156,140,313,221,90,487,287,173,459,266,169,162,85,77,460,258,170,495,319,157
2210500072A,633,345,288,533,162,371,535,131,404,551,289,258,957,265,666,939,257,664,308,88,220,1166,316,812,1158,339,801
220610011-1,356,310,46,255,206,49,255,196,59,269,228,40,585,448,111,542,395,120,231,208,23,541,400,102,576,474,93
220610011-4,169,130,39,129,72,57,130,78,52,133,89,44,260,190,58,240,172,58,103,72,31,295,187,102,322,219,98
22127003-1A,81,50,31,82,21,61,76,25,51,88,42,46,143,70,67,132,58,70,59,26,33,126,45,76,132,57,74
2206300024C,807,230,577,748,104,644,746,90,656,758,200,554,1060,171,838,1008,161,820,379,61,318,1145,170,936,1185,226,933
22115004-3E,0,0,0,0,0,0,0,0,0,0,0,0,0,0,0,0,0,0,0,0,0,0,0,0,0,0,0
22105000073,533,223,310,500,89,411,496,72,424,502,203,293,684,141,509,644,150,477,240,55,185,815,131,655,820,156,651
22033003-33,1316,607,709,1170,332,838,1173,305,868,1173,502,657,1620,395,1104,1569,379,1127,898,249,649,1854,545,1268,1830,606,1181
220710009-1,582,570,12,401,354,47,409,327,82,433,412,15,697,604,56,651,535,93,360,328,32,706,597,69,803,726,64
22109000012,577,165,412,542,62,480,541,51,490,548,135,408,863,96,747,844,89,739,322,30,292,937,140,771,940,156,771
22097000028,423,155,268,412,104,308,418,95,323,422,139,281,544,134,393,536,117,403,219,59,160,501,123,366,509,132,373
221270005-3,231,44,187,240,32,208,244,35,209,254,37,213,279,37,236,255,43,207,132,24,108,274,27,236,293,49,239
221150001-5,303,77,226,303,42,261,301,46,255,306,66,236,470,68,388,458,60,384,206,22,184,385,39,330,395,51,331
220090002-7,200,188,12,151,116,35,151,114,37,173,158,15,261,223,29,232,154,54,69,57,12,198,157,27,232,190,35
220090007-3,314,81,233,285,26,259,287,31,256,293,64,228,349,56,290,330,70,247,160,38,122,379,42,321,401,60,338
22107000002,77,24,53,97,29,68,94,24,70,97,30,67,89,14,73,86,23,62,51,13,38,106,17,84,111,23,88
22039001010,224,187,37,191,131,60,201,136,65,232,177,55,304,237,61,251,149,84,107,80,27,251,156,71,285,216,55
220090007-1,587,392,195,500,251,249,512,273,239,555,349,201,808,413,377,708,339,343,280,156,124,703,304,361,801,411,363
22071007-24,198,193,5,143,129,14,144,127,17,153,148,5,501,489,7,505,476,21,87,84,3,324,291,12,351,327,19
22071007-37,423,412,11,322,284,38,321,259,62,329,313,16,481,437,31,454,387,55,215,200,15,519,458,31,568,521,32
22063000035,594,302,292,474,161,313,472,161,311,483,234,245,991,336,608,954,295,589,442,189,253,925,289,602,967,341,600
2206300005A,278,61,217,260,16,244,264,17,247,259,68,188,404,23,367,379,37,336,117,19,98,548,25,506,551,32,511
220710017-9,332,332,0,230,217,13,233,203,30,246,244,1,483,464,12,428,386,29,150,145,5,462,430,12,530,516,10
2207109-30A,241,234,7,200,182,18,199,159,40,211,202,9,286,270,11,266,231,21,126,121,5,233,197,21,283,264,13
220710002-6,242,238,4,132,102,30,137,111,26,159,153,3,372,364,5,328,296,23,97,94,3,403,352,20,495,478,13
22071004-11,399,305,94,295,158,137,300,143,157,309,227,78,481,239,183,474,222,228,201,131,70,559,281,250,553,312,230
22071003-20,290,253,37,182,139,43,183,127,56,191,160,28,378,288,56,367,262,79,188,163,25,355,267,73,362,279,74
22071009-41,484,433,51,360,291,69,368,274,94,390,345,41,669,555,103,613,454,146,278,234,44,672,491,137,765,609,148
22071010-12,263,260,3,166,148,18,172,140,32,190,186,4,365,349,5,324,303,17,149,148,1,402,366,19,433,416,11
220710001-6,326,318,8,203,178,25,205,169,36,224,213,8,429,398,10,392,345,28,182,176,6,455,411,15,518,493,18
22039005004,170,15,155,170,9,161,168,17,151,179,29,149,242,6,231,220,23,194,79,3,76,244,14,226,260,10,250
22039003020,286,190,96,221,92,129,211,84,127,245,147,98,324,158,156,309,115,176,86,39,47,313,142,154,330,170,150
22039003070,179,40,139,172,22,150,168,20,148,184,38,146,245,20,223,227,17,208,84,11,73,276,26,245,282,29,252
220130004-4,412,115,297,355,62,293,345,58,287,370,101,269,493,109,373,492,146,344,264,77,187,523,128,387,523,122,394
220130001-1,127,85,42,141,88,53,136,81,55,154,104,50,185,107,72,172,92,74,94,60,34,141,74,64,152,85,67
220130003-3,171,109,62,140,51,89,133,45,88,152,81,70,187,97,87,180,82,95,76,35,41,196,99,91,214,118,91
22039001090,80,63,17,58,39,19,61,42,19,64,48,16,104,71,32,99,59,36,36,24,12,91,57,26,101,72,27
22039002030,328,54,274,277,35,242,274,38,236,279,44,234,409,41,363,397,42,351,106,14,92,427,42,379,445,46,398
22039003051,48,11,37,41,3,38,39,4,35,39,11,27,61,7,53,64,6,54,23,2,21,69,2,65,71,5,66
220090011-1,434,263,171,409,179,230,409,162,247,434,253,181,525,236,284,491,201,279,221,94,127,483,201,270,503,227,269
22009002-2C,245,98,147,220,50,170,219,47,172,224,92,131,284,57,222,260,60,192,130,43,87,305,46,257,308,46,260
22009002-2F,183,84,99,189,35,154,188,40,148,194,74,120,185,47,134,172,45,123,94,28,66,200,49,141,208,63,142
220610002-2,87,42,45,102,44,58,101,44,57,107,42,62,126,42,75,120,44,69,59,25,34,116,46,66,120,44,72
22105000119,422,223,199,371,104,267,370,83,287,379,196,182,567,167,385,542,173,360,245,68,177,602,191,394,622,216,402
2210500120A,839,236,603,726,70,656,724,64,660,723,206,514,1213,114,1064,1188,138,1008,418,46,372,1220,82,1108,1227,94,1125
220710003-9,304,296,8,199,183,16,190,173,17,209,203,3,446,409,22,405,342,43,155,151,4,393,348,25,409,380,21
22071005-17,296,183,113,267,97,170,274,77,197,270,159,107,406,156,224,405,111,290,280,132,148,447,116,314,447,147,287
22071014-23,321,311,10,220,203,17,227,192,35,234,229,4,381,355,18,357,311,42,179,172,7,352,307,35,411,378,29
220710013-6,293,235,58,193,133,60,198,101,97,205,167,38,362,243,91,353,207,142,197,140,57,390,263,118,386,286,93
2207115-19A,764,525,239,622,315,307,640,266,374,653,437,213,788,408,349,769,350,415,504,263,241,718,306,391,748,370,370
2207115-18A,405,324,81,309,206,103,316,179,137,319,245,71,506,313,182,488,291,190,262,185,77,532,354,153,549,406,137
2207115-18D,621,603,18,467,423,44,471,400,71,489,473,12,926,816,80,886,728,128,358,319,39,914,809,59,1019,931,63
2207107-25A,331,326,5,232,203,29,236,188,48,254,250,3,335,317,7,322,292,24,175,169,6,372,346,16,387,370,10
22017000038,481,474,7,315,260,55,295,264,31,339,330,6,693,676,15,641,588,45,245,241,4,627,584,27,673,646,18
22017000013,875,329,546,709,181,528,714,165,549,727,260,462,1245,295,877,1207,299,873,577,189,388,1260,336,879,1255,360,858
22009002-3A,202,54,148,197,20,177,200,16,184,214,46,168,252,24,219,230,30,193,92,16,76,256,27,224,276,30,242
22015004-10,914,294,620,670,127,543,669,123,546,684,206,477,1264,244,967,1205,263,929,529,123,406,1300,253,1020,1331,291,1021
220710009-7,388,384,4,297,284,13,302,267,35,320,311,5,479,455,7,446,415,22,215,214,1,493,450,21,554,526,14
220710015-3,165,129,36,177,123,54,179,105,74,183,153,27,255,149,76,246,150,86,142,108,34,245,164,71,247,172,61
22071012-16,324,320,4,235,214,21,245,202,43,253,241,8,417,387,16,374,332,23,141,136,5,486,431,32,545,505,21
220450009-5,365,98,267,329,56,273,327,58,269,341,83,254,432,98,318,407,76,305,210,41,169,459,119,330,466,126,332
220450007-5,155,16,139,148,4,144,150,4,146,149,4,144,172,7,157,170,7,149,136,3,133,188,8,176,189,18,167
220450008-3,809,193,616,754,118,636,747,117,630,765,180,585,1057,174,856,998,139,789,538,77,461,976,164,795,1019,202,814
2207115-13A,397,376,21,322,283,39,315,259,56,330,316,14,498,468,24,475,413,43,245,234,11,584,520,49,625,574,39
220710012-7,331,295,36,227,172,55,227,151,76,239,206,32,428,296,95,409,268,133,227,181,46,430,310,106,436,332,82
22071011-11,365,354,11,265,238,27,270,220,50,279,268,8,491,461,16,434,382,36,209,202,7,553,508,27,575,538,24
22071005-15,621,521,100,426,284,142,441,242,199,448,368,77,729,482,200,725,434,279,443,342,101,642,424,195,617,431,164
22071009-26,167,167,0,107,97,10,119,102,17,125,122,3,229,221,5,212,197,13,90,87,3,262,232,14,311,302,6
22065000016,28,28,0,22,22,0,20,17,3,24,24,0,22,21,0,24,23,1,8,8,0,26,22,4,26,26,0
22003005-8A,31,12,19,26,9,17,25,8,17,26,8,18,51,20,30,50,16,33,26,11,15,46,12,34,44,16,28
220710009-9,334,315,19,260,227,33,258,194,64,268,250,17,434,373,30,409,348,52,255,233,22,568,498,51,558,498,50
22071009-39,398,393,5,332,301,31,332,296,36,356,344,6,573,548,16,552,499,41,264,257,7,513,475,24,550,533,16
22071008-25,491,473,18,434,378,56,431,363,68,451,429,18,579,511,42,545,458,67,278,252,26,635,558,58,661,587,55
22071007-32,272,231,41,229,153,76,230,131,99,234,197,36,303,196,84,295,171,116,180,139,41,323,179,137,320,180,135
22093000012,415,375,40,282,196,86,278,181,97,327,279,45,430,360,65,363,282,67,214,177,37,490,362,93,570,479,83
22017000074,164,164,0,98,80,18,92,80,12,109,105,2,240,232,2,216,203,9,98,98,0,171,153,11,195,182,8
22033001-89,560,257,303,515,110,405,520,102,418,509,197,306,753,178,530,742,171,561,438,110,328,597,126,456,604,165,432
22033003-10,626,367,259,546,206,340,549,189,360,558,295,260,1007,363,582,980,344,609,533,192,341,864,391,449,879,431,427
22033002-21,1009,476,533,830,316,514,846,291,555,842,439,396,1211,325,833,1193,289,885,682,200,482,1392,428,931,1383,449,913
22033003-12,997,684,313,780,365,415,790,335,455,801,497,296,1216,521,641,1162,488,638,625,274,351,1341,699,607,1400,788,583
220330001-7,580,454,126,490,291,199,490,254,236,494,371,121,665,367,213,654,334,287,432,281,151,667,376,276,635,374,234
22033001-51,432,427,5,325,275,50,349,255,94,367,362,4,565,552,8,525,488,21,318,311,7,556,499,41,593,560,23
22033003-40,1149,506,643,977,240,737,980,209,771,994,410,577,1388,342,936,1347,298,1008,868,214,654,1328,354,946,1319,412,876
22033001-93,199,173,26,153,127,26,147,118,29,160,139,21,278,221,48,260,199,55,128,108,20,272,214,44,294,257,31
22033001-99,1323,726,597,1183,408,775,1183,351,832,1197,614,579,1618,563,939,1583,502,1037,942,330,612,1864,705,1109,1869,820,990
22033003-48,923,331,592,796,151,645,803,146,657,793,260,529,1203,237,917,1187,203,959,736,140,596,1178,256,899,1165,294,847
220330003-7,1166,502,664,1094,306,788,1110,259,851,1098,451,645,1394,407,918,1369,383,962,902,253,649,1477,395,1055,1466,462,973
22033001-53,727,367,360,624,175,449,616,157,459,630,308,317,855,249,553,846,253,579,543,169,374,940,332,587,922,347,557
22033001-44,401,349,52,220,145,75,217,130,87,225,182,43,706,435,179,680,406,227,253,198,55,659,417,213,679,471,183
22033001-68,293,291,2,220,205,15,227,186,41,239,237,1,333,324,8,321,306,12,243,232,11,473,430,29,492,473,12
22033001-63,676,669,7,488,436,52,492,420,72,536,527,9,808,788,9,764,681,57,428,419,9,828,750,49,888,829,33
22033001-64,472,352,120,365,174,191,364,154,210,361,239,115,526,246,216,513,237,248,352,196,156,532,239,267,517,247,245
22033002-27,875,850,25,773,668,105,768,575,193,813,781,30,1074,987,58,1045,952,77,773,736,37,936,825,86,945,862,72
2207109-43J,244,244,0,173,164,9,175,156,19,194,192,1,294,288,1,265,252,11,136,135,1,356,329,7,385,368,10
2207109-44A,368,360,8,260,229,31,278,226,52,323,303,10,507,477,22,454,403,42,256,242,14,358,317,23,424,403,19
2207109-43L,287,284,3,198,185,13,203,176,27,209,202,6,419,404,5,407,382,18,142,132,10,399,372,10,433,418,13
22079000N24,922,178,744,856,45,811,864,42,822,874,110,759,1448,52,1354,1354,92,1232,394,34,360,1568,41,1500,1605,56,1525
22017000064,352,307,45,246,188,58,252,184,68,265,233,31,474,385,75,441,350,82,187,167,20,474,391,72,503,425,66
220450002-1,593,531,62,452,324,128,433,330,103,495,418,71,917,769,126,839,505,270,217,168,49,805,620,111,898,768,113
22119000022,529,245,284,514,137,377,513,149,364,539,217,317,739,227,488,711,223,472,307,102,205,670,250,386,691,279,393
22073000001,937,165,772,738,66,672,750,49,701,763,115,646,1016,74,914,966,94,869,467,42,425,1264,155,1092,1260,163,1077
22073000069,477,474,3,321,285,36,324,284,40,358,353,5,706,696,5,656,606,33,246,243,3,628,538,48,688,669,10
22119000002,355,103,252,314,39,275,332,49,283,346,86,257,565,105,455,537,117,413,216,36,180,460,111,339,486,126,346
22079000N10,756,265,491,720,124,596,710,122,588,725,213,508,1109,194,886,1072,201,843,420,86,334,988,183,786,989,208,760
22079000N29,262,50,212,243,19,224,246,16,230,250,38,211,378,21,348,350,28,314,149,14,135,372,23,343,383,33,347
22017000053,389,371,18,239,193,46,235,198,37,257,235,19,575,526,40,533,458,54,208,187,21,575,495,45,610,561,40
220710012-1,332,320,12,213,176,37,227,161,66,225,208,16,403,342,43,382,304,72,238,207,31,450,396,52,459,411,42
22071014-20,660,540,120,494,316,178,511,251,260,531,434,97,781,477,243,766,434,309,436,305,131,675,420,230,662,456,190
220710014-8,320,214,106,230,106,124,239,82,157,242,162,79,422,221,169,411,165,242,250,136,114,368,155,213,378,203,167
2211300042A,411,90,321,379,59,320,368,60,308,393,87,304,560,96,442,531,82,426,280,50,230,535,94,420,559,114,438
22083000028,50,6,44,42,2,40,44,2,42,44,2,42,81,3,78,76,8,68,34,0,34,74,2,72,78,2,76
22125000004,118,118,0,111,98,13,110,102,8,124,119,2,146,132,7,145,126,14,94,89,5,142,127,13,157,147,8
22125000013,326,180,146,288,36,252,297,31,266,295,154,141,410,66,341,380,88,286,194,42,152,457,40,403,470,57,403
22083000033,722,680,42,587,433,154,577,441,136,657,561,83,740,669,69,692,574,102,306,278,28,771,587,138,818,728,79
22017000022,719,259,460,558,121,437,565,101,464,585,189,391,972,265,647,954,247,694,568,138,430,865,208,642,863,241,597
220690003-9,54,5,49,51,0,51,49,2,47,54,6,47,72,3,69,64,4,60,35,3,32,82,4,78,83,4,79
220690004-9,437,210,227,401,130,271,399,139,260,402,184,217,527,208,304,503,190,304,202,87,115,529,190,318,538,215,311
220690003-7,60,56,4,35,14,21,36,22,14,45,35,10,84,64,19,70,46,21,26,20,6,72,45,20,80,58,19
22027000011,167,86,81,97,28,69,102,25,77,122,49,73,170,72,93,154,54,93,100,46,54,212,86,122,217,98,117
220210007-2,184,36,148,195,8,187,197,11,186,199,25,174,256,11,244,248,20,226,115,8,107,253,8,241,267,8,258
220210007-1,287,44,243,282,18,264,287,24,263,289,37,251,303,12,290,298,41,256,127,12,115,349,6,332,361,14,345
220030001-5,63,30,33,59,28,31,57,26,31,60,39,19,86,43,42,90,35,51,44,22,22,81,30,45,85,41,40
220030001-2,120,48,72,117,33,84,119,34,85,121,48,69,148,30,114,145,40,102,79,24,55,161,35,122,165,42,121
220250006-1,322,58,264,328,28,300,322,40,282,338,65,269,372,32,336,347,61,280,131,16,115,391,14,372,400,14,386
221170007-1,328,141,187,370,91,279,371,88,283,387,159,227,518,112,396,494,104,378,189,39,150,506,92,400,520,104,414
22027000034,290,248,42,195,144,51,187,132,55,209,180,27,294,246,45,276,216,54,137,116,21,271,187,72,297,232,62
22017000112,440,184,256,341,93,248,336,82,254,343,132,211,658,210,417,626,190,424,327,86,241,614,219,378,622,252,363
22017000027,367,208,159,308,118,190,311,113,198,317,171,144,604,249,304,586,238,335,257,106,151,571,240,308,592,273,296
22027000035,30,12,18,29,9,20,29,9,20,30,12,18,23,9,14,18,8,10,13,3,10,40,14,25,41,15,24
220690001-2,706,395,311,613,244,369,619,239,380,638,327,308,812,368,401,802,368,415,332,103,229,767,330,402,775,363,400
22017000088,708,357,351,573,221,352,568,219,349,574,260,309,1024,384,608,954,366,572,398,155,243,950,350,584,968,364,593
22017000163,1299,559,740,1089,360,729,1083,355,728,1125,488,632,1684,560,1096,1617,552,1040,891,331,560,1679,543,1099,1687,574,1101
22017000165,240,99,141,197,58,139,197,59,138,199,82,116,304,97,201,281,94,185,157,55,102,301,93,201,308,102,203
22017000102,519,195,324,434,93,341,442,96,346,443,138,303,705,194,483,699,203,479,387,106,281,652,187,447,645,197,441
22017000067,241,239,2,181,142,39,182,158,24,199,194,4,334,320,6,308,279,18,180,175,5,297,274,11,310,299,5
22017000082,568,309,259,466,174,292,463,164,299,482,236,243,778,333,412,741,308,413,391,172,219,749,350,374,788,393,384
220710008-1,353,327,26,265,239,26,262,210,52,267,253,13,428,355,43,419,341,65,250,234,16,356,286,54,365,302,53
22071009-12,357,339,18,265,248,17,259,220,39,271,257,11,435,372,34,396,337,42,263,244,19,483,436,37,461,418,32
220710014-7,431,271,160,351,154,197,358,111,247,363,229,133,557,268,253,552,193,356,315,131,184,696,349,333,654,388,247
220710004-3,356,333,23,233,209,24,235,191,44,251,237,13,503,458,23,427,367,38,163,154,9,465,388,42,548,508,34
22071007-11,416,409,7,300,280,20,308,253,55,324,316,5,440,415,11,401,364,26,191,182,9,481,428,21,545,518,21
220710012-5,349,286,63,267,176,91,281,155,126,283,228,54,398,264,107,399,240,147,225,158,67,415,284,115,395,286,101
220710005-7,343,342,1,220,207,13,220,192,28,238,234,4,447,432,3,420,392,16,137,137,0,571,526,17,624,602,11
22071007-40,672,592,80,506,381,125,514,338,176,528,458,66,712,514,140,703,494,195,384,316,68,768,537,193,776,579,164
22071005-18,318,187,131,350,119,231,356,76,280,366,205,157,495,171,281,494,152,335,290,115,175,542,143,385,536,193,330
2211300010A,404,83,321,408,35,373,399,35,364,419,92,325,548,91,444,541,90,439,235,44,191,569,82,478,585,90,488
22099000026,535,124,411,502,82,420,503,67,436,505,129,376,686,111,563,659,95,552,356,60,296,802,122,664,806,134,663
22099000006,345,85,260,388,51,337,384,47,337,395,112,283,452,67,376,421,53,340,221,44,177,517,65,436,560,76,481
220150002-8,231,224,7,118,100,18,115,105,10,143,130,10,342,315,22,319,283,32,118,112,6,401,358,25,435,397,22
22083000023,83,28,55,96,6,90,102,5,97,106,7,98,119,6,112,115,12,102,62,1,61,79,2,77,84,8,76
22073000025,468,166,302,362,77,285,355,90,265,370,110,260,550,121,425,521,146,367,243,66,177,608,142,448,628,170,455
22073000049,404,70,334,366,17,349,373,19,354,379,51,328,555,31,516,540,44,492,241,16,225,549,16,523,563,36,519
22073000031,485,245,240,355,121,234,355,121,234,370,162,204,718,261,444,677,256,404,243,94,149,622,241,362,640,269,366
22073000040,280,53,227,218,28,190,218,26,192,221,41,180,445,45,390,425,75,345,148,20,128,404,48,347,418,54,361
2201502-18F,415,62,353,351,36,315,353,36,317,356,66,290,408,35,370,403,42,358,226,22,204,542,54,487,541,65,471
22015004-3D,523,123,400,445,64,381,444,65,379,456,101,353,809,131,655,786,155,619,360,84,276,849,125,704,879,164,704
2201502-18C,639,205,434,510,98,412,518,99,419,518,145,372,839,154,649,809,155,639,386,69,317,872,160,694,897,176,712
2201502-21B,773,214,559,626,101,525,636,100,536,645,151,494,902,136,743,867,141,721,581,119,462,796,98,689,791,108,676
22015004-8E,262,49,213,204,12,192,206,18,188,205,29,176,473,30,427,464,65,394,194,23,171,412,41,362,436,52,381
22015004-8B,697,176,521,566,83,483,570,76,494,575,130,444,904,165,705,876,178,688,456,84,372,910,158,731,938,182,740
22015004-7A,487,145,342,336,74,262,341,74,267,353,111,239,651,156,475,618,160,449,279,88,191,693,137,543,723,156,561
22015004-7B,391,118,273,270,56,214,271,56,215,278,88,189,524,129,381,495,127,361,222,71,151,547,108,431,579,129,447
22037000007,299,243,56,218,145,73,220,143,77,251,208,43,344,243,94,314,197,107,174,136,38,373,232,132,407,284,115
22097000044,632,270,362,566,178,388,573,185,388,595,231,362,832,282,539,795,217,560,319,145,174,684,217,457,737,257,471
22121000017,174,133,41,126,74,52,129,73,56,139,96,43,183,116,65,175,109,62,110,68,42,224,136,79,227,143,78
22103000MD1,613,222,391,494,83,411,494,61,433,490,182,307,895,159,695,881,138,729,365,51,314,958,149,775,960,188,754
22103000405,446,119,327,469,89,380,465,77,388,479,145,333,627,99,502,612,80,525,316,63,253,584,87,470,607,118,477
22055000060,363,244,119,311,145,166,302,133,169,332,211,117,505,254,226,482,176,291,229,103,126,493,257,210,526,315,201
22055000070,421,244,177,403,169,234,400,134,266,404,205,195,591,211,309,585,198,364,323,160,163,643,276,327,655,315,317
22055000019,626,604,22,475,404,71,458,400,58,514,482,32,881,819,40,780,584,173,302,276,26,562,506,37,633,588,32
22097000040,427,145,282,379,60,319,378,71,307,396,126,268,524,106,412,465,78,372,255,46,209,589,111,456,617,135,472
22097000008,852,559,293,729,383,346,724,398,326,799,504,287,988,547,430,918,445,465,456,304,152,1032,476,503,1078,572,482
220430006-1,327,70,257,345,37,308,338,34,304,346,65,278,490,41,433,477,48,426,211,17,194,537,38,481,554,50,502
22103000C06,372,272,100,354,175,179,359,160,199,377,249,122,638,327,292,588,253,311,212,84,128,497,242,207,538,317,200
22005000001,834,329,505,776,160,616,793,138,655,796,274,522,1465,312,1096,1421,273,1121,685,149,536,993,188,782,985,210,734
22111000020,334,56,278,300,14,286,298,19,279,301,30,267,436,22,406,428,42,381,175,6,169,483,21,455,497,31,466
22005000035,663,194,469,591,41,550,589,43,546,596,147,446,908,107,777,859,128,705,278,26,252,1145,111,1006,1168,132,1022
22005000003,746,264,482,690,110,580,699,95,604,704,221,479,1318,240,1028,1288,255,998,461,99,362,1196,220,931,1216,249,932
22005000031,498,317,181,441,192,249,437,183,254,458,304,154,686,357,300,623,284,313,332,162,170,742,310,403,796,385,397
220950002-4,485,150,335,498,54,444,517,50,467,499,155,331,702,75,607,674,89,577,405,59,346,791,84,676,818,115,695
22005000017,959,517,442,742,282,460,753,264,489,769,389,374,1265,492,736,1232,453,746,444,155,289,1415,581,791,1448,666,759
22127003-1C,11,5,6,5,0,5,5,0,5,5,3,2,12,3,9,11,2,9,4,1,3,9,2,7,11,4,7
22097000023,903,872,31,572,474,98,587,524,63,675,642,30,1226,1141,53,1078,755,276,427,394,33,1056,829,143,1161,1071,58
22109000005,641,417,224,508,227,281,514,236,278,546,311,230,899,483,395,820,378,412,276,114,162,766,331,398,849,435,395
22109000014,1053,202,851,1052,66,986,1046,56,990,1055,197,852,1526,134,1358,1512,144,1343,733,55,678,1335,93,1227,1349,138,1195
22109000076,347,110,237,294,36,258,296,37,259,297,87,209,481,71,397,465,82,369,194,15,179,455,59,373,474,70,397
220130001-2,301,199,102,280,160,120,278,167,111,292,185,101,381,207,162,358,184,163,197,95,102,298,154,132,311,180,129
22083000017,374,119,255,409,76,333,408,80,328,420,97,323,471,107,353,448,117,325,243,59,184,412,71,335,435,84,351
220810002-1,304,54,250,267,24,243,277,40,237,277,49,226,352,44,304,356,62,290,170,22,148,330,27,294,347,32,310
22125000005,161,85,76,147,39,108,144,31,113,150,76,74,199,53,141,194,35,155,139,37,102,152,28,120,162,36,122
22125000006,496,263,233,484,141,343,492,129,363,494,242,250,644,211,422,632,200,421,336,125,211,645,194,443,655,213,432
220810001-1,349,81,268,317,42,275,313,45,268,316,69,242,443,78,351,440,115,318,213,55,158,432,64,350,441,73,365
22083000011,359,35,324,411,5,406,416,6,410,420,25,395,515,25,473,486,31,449,220,9,211,492,21,470,522,25,493
22097000049,384,179,205,396,144,252,389,134,255,411,172,237,697,279,401,651,216,424,289,123,166,414,162,240,458,206,248
22111000026,352,211,141,271,119,152,268,128,140,287,164,122,383,186,191,359,174,180,185,86,99,349,146,192,411,210,195
22005000009,997,486,511,921,267,654,921,250,671,950,394,553,1477,412,1003,1447,377,1030,636,213,423,1348,363,935,1354,418,911
22099000022,345,57,288,335,16,319,335,24,311,335,47,284,428,36,387,407,27,358,251,29,222,590,58,528,584,59,525
220950003-4,721,629,92,609,443,166,610,440,170,645,527,104,1142,910,210,1040,757,247,429,327,102,998,755,194,1102,906,173
220950001-5,478,433,45,395,317,78,396,298,98,437,383,45,624,503,97,546,406,123,249,205,44,663,533,93,704,598,85
220950003-2,1025,988,37,842,709,133,841,697,144,930,868,43,1319,1214,85,1166,1008,127,554,519,35,1426,1239,114,1556,1421,97
22005000025,611,193,418,603,58,545,607,58,549,609,181,426,903,133,732,872,161,687,305,45,260,1027,106,884,1045,160,868
22005000021,271,97,174,243,37,206,243,36,207,246,89,157,388,71,310,375,74,288,129,27,102,447,84,344,459,88,366
2206300021A,310,70,240,285,25,260,282,26,256,285,79,203,464,41,413,442,52,377,145,14,131,486,49,424,495,47,441
2206300001B,699,161,538,656,38,618,668,33,635,664,144,516,998,81,877,977,99,849,410,35,375,952,85,860,962,95,853
22087000013,478,286,192,373,126,247,375,96,279,388,211,173,634,256,359,608,233,356,237,77,160,747,290,427,790,318,456
22063000005,1002,217,785,903,76,827,907,68,839,904,184,718,1339,80,1217,1315,105,1180,605,47,558,1426,130,1279,1435,158,1261
2206300007C,199,66,133,171,10,161,172,17,155,171,61,107,301,22,271,300,35,249,74,1,73,280,19,253,292,25,258
220590008-6,98,39,59,93,9,84,92,9,83,91,26,64,85,10,70,80,12,67,42,3,39,120,12,107,121,10,111
22055000098,1090,259,831,881,148,733,874,134,740,892,206,680,1366,211,1107,1318,189,1100,586,111,475,1331,220,1079,1337,251,1064
22055000106,995,278,717,880,152,728,880,126,754,889,219,665,1363,223,1106,1310,162,1113,564,93,471,1575,234,1292,1610,296,1291
22103000815,371,129,242,260,50,210,269,43,226,271,98,169,454,101,332,439,100,332,153,32,121,711,143,547,728,162,554
22103000804,688,210,478,605,95,510,609,93,516,627,184,434,925,120,772,891,120,752,425,49,376,1310,228,1041,1351,293,1041
22103000303,498,187,311,452,71,381,456,59,397,472,167,304,717,120,564,717,111,596,294,52,242,798,139,621,817,171,621
22103000702,642,349,293,547,214,333,550,214,336,562,303,250,821,328,462,774,286,468,318,118,200,1017,381,584,1093,502,571
22103000401,727,332,395,612,137,475,612,113,499,610,227,371,497,85,379,481,82,391,207,41,166,1110,207,869,1130,278,831
22103000421,390,131,259,328,76,252,330,63,267,336,114,219,256,44,198,251,46,200,110,23,87,563,100,448,560,110,437
22055000120,894,213,681,752,101,651,752,79,673,757,160,595,1096,163,880,1079,123,935,537,73,464,1186,183,976,1206,239,953
22103000204,717,225,492,643,75,568,656,65,591,670,161,508,923,114,779,908,98,802,527,87,440,1131,147,957,1140,167,961
22017000140,265,102,163,214,53,161,210,53,157,227,78,147,341,104,234,320,97,218,204,60,144,334,97,228,367,114,248
22111000005,250,58,192,212,33,179,210,37,173,210,43,164,373,76,286,356,77,275,160,25,135,391,69,310,397,80,310
22111000017,263,33,230,261,15,246,263,23,240,271,34,237,462,25,414,440,39,392,203,13,190,395,19,357,407,32,373
22017000041,211,211,0,144,123,21,146,121,25,160,159,1,405,391,10,376,355,14,153,152,1,282,272,7,289,275,10
22011000009,423,77,346,370,36,334,373,36,337,374,54,314,479,45,431,464,49,406,176,32,144,561,51,497,576,48,515
22033001-76,303,243,60,162,101,61,159,86,73,165,118,46,764,434,241,712,401,267,199,149,50,711,397,263,742,456,261
22033001-90,1028,587,441,927,325,602,924,295,629,938,471,461,1420,512,808,1406,510,849,802,273,529,1190,445,703,1201,501,676
22033003-47,1217,440,777,1065,215,850,1075,182,893,1088,372,710,1520,308,1134,1498,290,1188,882,204,678,1507,274,1204,1506,343,1124
22033003-62,409,99,310,432,68,364,442,68,374,439,129,309,433,206,207,417,184,227,237,111,126,444,41,395,443,78,362
220330002-5,455,345,110,396,247,149,392,203,189,401,295,102,618,360,229,598,328,255,315,203,112,758,395,346,776,458,301
22033003-19,1180,347,833,1158,168,990,1174,129,1045,1164,313,847,1419,241,1127,1416,205,1180,1017,149,868,1427,180,1234,1396,220,1160
22033001-18,287,279,8,178,137,41,177,142,35,187,183,4,284,268,8,275,238,21,158,152,6,344,307,18,371,349,14
22109000008,832,242,590,720,111,609,729,108,621,739,212,519,1076,190,855,1034,187,823,405,81,324,1065,183,838,1116,242,859
22109000086,349,95,254,319,30,289,319,29,290,320,77,238,570,94,461,555,96,446,210,24,186,528,83,428,529,97,414
2205300008A,135,116,19,91,59,32,87,60,27,103,80,22,227,176,44,208,133,55,80,66,14,145,98,39,157,119,36
22053000002,340,68,272,315,29,286,318,31,287,317,62,253,569,57,487,547,72,467,256,44,212,596,56,534,611,61,546
22073000039,852,340,512,670,165,505,678,179,499,696,223,472,1285,378,874,1239,385,827,421,119,302,1158,291,832,1201,340,853
22085002-2A,166,13,153,136,10,126,133,11,122,136,10,122,161,12,142,147,12,132,97,6,91,209,9,198,216,10,206
220850001-2,313,64,249,297,34,263,296,34,262,301,60,240,354,46,300,352,53,297,174,31,143,372,38,329,386,54,330
220850008-1,255,35,220,254,13,241,255,25,230,259,28,226,253,23,225,244,27,214,95,6,89,342,38,299,343,36,305
220850002-6,361,30,331,331,12,319,321,14,307,341,25,316,448,24,418,430,27,399,244,15,229,471,24,437,479,30,448
220850009-2,246,38,208,224,15,209,228,19,209,234,29,205,279,33,239,265,40,223,121,19,102,324,31,287,330,36,294
220010002-1,688,94,594,588,51,537,584,54,530,608,86,522,929,94,816,868,72,783,448,64,384,1040,55,956,1062,62,990
220010003-2,551,56,495,507,24,483,511,24,487,514,44,466,756,34,711,740,47,683,360,34,326,806,29,764,809,43,761
22055000040,345,155,190,287,77,210,282,62,220,284,108,176,516,207,276,504,154,334,209,69,140,550,224,294,568,264,294
22071011-10,419,385,34,328,271,57,331,241,90,345,305,40,500,405,72,477,368,99,275,235,40,551,465,64,559,495,59
22103000309,427,187,240,384,90,294,386,77,309,391,156,226,637,135,458,600,131,447,201,58,143,795,207,566,795,230,551
22103000P01,962,272,690,766,81,685,768,56,712,764,224,529,1319,133,1152,1231,156,1049,488,60,428,1561,138,1370,1598,171,1403
22103000C10,82,53,29,89,11,78,92,13,79,92,43,48,128,28,88,122,18,101,50,11,39,142,44,92,149,59,88
22055000028,1083,208,875,866,110,756,852,99,753,870,156,710,1435,189,1210,1385,170,1189,525,77,448,1855,257,1536,1878,298,1557
22103000704,666,241,425,571,129,442,570,107,463,586,212,368,828,177,628,782,153,610,349,59,290,1027,225,773,1052,264,780
22103000116,470,117,353,404,24,380,406,21,385,401,100,300,969,129,796,958,105,839,322,39,283,573,76,486,576,104,463
22103000111,789,266,523,626,77,549,636,71,565,637,197,437,948,107,806,934,114,799,349,44,305,1184,164,978,1198,241,926
22103000420,352,122,230,361,59,302,366,56,310,371,126,241,585,55,482,583,68,502,263,44,219,611,91,492,606,107,469
22103000S20,308,187,121,231,108,123,233,101,132,239,124,114,561,150,392,518,136,374,231,49,182,607,274,310,636,312,315
22055000064,130,26,104,120,17,103,120,16,104,120,24,96,153,26,126,146,29,117,83,10,73,205,35,166,209,40,168
22055000084,772,258,514,695,158,537,691,102,589,701,219,481,988,161,759,973,132,827,529,107,422,1073,223,819,1096,254,820
22055000042,469,237,232,373,134,239,369,120,249,383,166,211,725,276,392,708,237,442,251,88,163,772,343,375,789,388,372
22055000121,576,149,427,486,73,413,493,49,444,482,111,369,680,130,520,674,86,579,397,65,332,741,119,599,748,164,573
22103000418,630,269,361,513,90,423,514,79,435,525,201,321,725,141,526,734,124,597,385,63,322,801,132,650,799,182,587
22115002-1A,123,18,105,115,11,104,121,11,110,123,17,103,157,7,146,153,15,131,57,7,50,151,8,143,155,10,143
22115004-3N,0,0,0,0,0,0,0,0,0,0,0,0,0,0,0,0,0,0,0,0,0,0,0,0,0,0,0
2210500133A,367,205,162,305,104,201,308,89,219,311,160,150,531,149,363,520,166,342,173,50,123,626,184,400,650,211,429
22115004-3A,169,42,127,199,26,173,199,27,172,209,54,152,285,47,225,265,34,217,83,10,73,265,36,219,288,43,243
2201900860N,597,136,461,550,68,482,550,75,475,554,127,423,861,94,749,830,76,740,285,65,220,1093,92,965,1122,108,998
22019000441,521,238,283,499,140,359,495,131,364,520,229,288,869,274,570,818,190,601,287,90,197,917,250,627,1000,344,636
22019000304,431,420,11,335,301,34,330,284,46,371,344,22,585,546,27,550,429,103,219,205,14,465,395,44,548,520,23
22019000261,286,63,223,259,13,246,262,21,241,266,52,213,379,32,338,374,28,338,176,36,140,610,15,591,610,27,581
22055000053,366,327,39,314,246,68,299,240,59,329,291,36,480,379,87,457,297,154,192,156,36,412,326,70,432,364,61
22103000706,775,254,521,707,132,575,711,123,588,719,244,472,946,150,758,934,156,761,412,71,341,1102,181,894,1111,194,898
221150004-1,276,38,238,279,26,253,275,36,239,290,53,236,375,45,320,356,38,308,120,8,112,402,16,365,420,43,373
22055000117,676,187,489,526,111,415,526,93,433,536,150,384,785,108,627,765,88,662,254,45,209,1025,213,780,1048,254,777
22055000079,417,112,305,376,65,311,381,43,338,382,96,285,497,82,385,495,45,446,314,49,265,601,74,510,604,96,501
22103000909,410,242,168,350,139,211,346,144,202,345,176,165,559,228,307,540,206,313,157,53,104,1245,745,463,1290,809,473
22103000603,641,125,516,513,47,466,517,30,487,515,109,403,945,65,863,908,69,819,355,23,332,1142,114,1001,1161,95,1050
22103000913,963,698,265,797,480,317,784,445,339,815,590,215,1152,627,467,1097,584,476,444,265,179,1460,822,589,1489,868,581
22103000C07,133,102,31,132,81,51,135,74,61,133,104,25,218,145,65,201,112,80,87,52,35,198,134,53,217,154,56
221150007-1,364,82,282,357,37,320,364,44,320,370,79,286,635,88,536,581,97,474,154,28,126,626,79,527,645,89,548
22103000426,354,140,214,308,51,257,309,45,264,311,104,207,497,88,377,482,91,382,200,38,162,509,115,363,540,154,369
22103000301,636,190,446,571,57,514,567,48,519,584,166,415,829,68,720,810,90,699,344,30,314,837,78,726,866,118,732
22079000C17,316,199,117,264,124,140,259,132,127,277,175,101,477,244,212,463,219,229,186,102,84,442,210,212,454,239,200
2211704-10A,187,57,130,179,10,169,180,11,169,185,47,138,281,17,260,271,34,232,109,12,97,261,22,236,262,27,230
22103000808,652,216,436,603,90,513,609,83,526,605,203,396,871,127,697,866,114,741,413,54,359,946,175,748,954,211,727
22121000003,235,71,164,195,22,173,197,17,180,192,55,135,301,46,247,304,56,245,174,33,141,261,31,228,255,35,219
22079000N25,449,64,385,413,16,397,425,23,402,432,49,383,664,22,632,642,25,600,221,14,207,751,27,706,762,35,716
22047000016,450,448,2,409,385,24,392,360,32,455,441,9,538,525,5,487,434,39,220,216,4,452,387,34,513,485,13
22047000017,357,162,195,425,71,354,421,69,352,420,173,245,526,151,359,504,133,358,262,59,203,452,91,348,471,132,329
22067000024,248,127,121,172,87,85,178,87,91,186,101,84,361,185,172,350,174,174,139,66,73,263,108,142,299,143,155
220670003-1,589,311,278,498,180,318,480,184,296,520,239,277,807,340,462,761,330,408,292,125,167,749,362,360,774,387,372
22067000045,249,48,201,251,18,233,250,16,234,268,40,228,536,71,458,498,72,420,222,33,189,432,24,401,445,26,413
2201900309W,433,430,3,332,285,47,337,295,42,379,365,11,559,520,16,522,390,102,212,203,9,384,330,32,423,403,15
22019000340,567,270,297,534,141,393,528,136,392,542,246,291,762,242,491,736,188,534,249,78,171,560,176,361,580,200,364
22019000368,1029,305,724,983,131,852,990,138,852,988,294,688,1388,195,1146,1370,162,1185,575,99,476,861,137,706,868,161,698
22047000004,488,140,348,605,34,571,608,46,562,585,175,405,681,55,612,655,88,557,293,33,260,728,49,667,731,50,671
22031000046,422,92,330,394,51,343,401,56,345,406,78,325,583,106,464,565,129,429,275,47,228,839,131,698,835,126,702
22101000012,235,179,56,189,120,69,182,111,71,208,147,60,348,221,114,317,162,132,117,71,46,256,137,98,286,165,115
22101000028,357,70,287,347,40,307,350,35,315,343,59,279,519,49,458,493,66,409,234,27,207,553,51,482,561,55,496
220690001-4,454,438,16,363,296,67,357,304,53,392,359,28,721,608,83,668,532,107,191,173,18,764,606,92,848,742,76
220150004-9,745,177,568,572,87,485,564,88,476,596,150,444,1109,174,909,1057,258,790,501,114,387,1256,149,1083,1280,164,1102
22015004-1A,583,134,449,501,80,421,496,82,414,508,103,400,797,139,641,773,157,604,330,89,241,906,129,765,926,135,784
22015001-3B,219,71,148,167,28,139,167,26,141,172,56,116,368,88,269,352,89,251,124,39,85,386,102,271,387,102,266
220150001-3,499,204,295,367,89,278,362,96,266,372,144,227,663,171,462,637,173,450,274,74,200,724,208,486,731,220,484
22019000328,679,519,160,598,381,217,587,360,227,620,467,150,979,619,327,933,517,387,361,230,131,719,454,228,752,508,226
22051000022,226,132,94,187,64,123,190,54,136,195,93,98,444,163,260,424,151,267,173,53,120,392,150,224,405,191,205
22019000463,756,214,542,748,94,654,753,96,657,756,202,544,1223,157,1012,1174,138,1007,390,78,312,1439,191,1193,1485,230,1234
22019000303,295,294,1,252,233,19,246,232,14,266,265,0,396,390,4,377,319,48,159,156,3,368,333,13,419,400,9
22019000317,404,297,107,356,183,173,356,183,173,378,255,117,667,332,302,631,256,354,174,89,85,506,266,216,536,323,207
2201900466E,627,155,472,573,56,517,578,55,523,573,122,450,1029,79,904,992,82,887,310,36,274,1318,99,1163,1341,131,1188
220570010-8,250,77,173,274,34,240,284,24,260,289,93,192,369,50,304,352,64,271,151,21,130,397,50,326,414,49,354
220570010-2,281,88,193,289,25,264,290,23,267,290,70,213,493,58,417,473,70,384,196,28,168,461,50,394,473,68,401
220570005-2,455,156,299,449,60,389,449,46,403,454,162,285,581,80,492,570,86,474,298,28,270,711,72,617,713,92,604
220890007-4,833,555,278,692,313,379,707,282,425,738,450,279,1036,592,417,942,476,435,355,184,171,1165,532,583,1269,683,557
220890002-2,262,108,154,257,45,212,264,48,216,268,105,162,425,108,299,392,95,287,141,27,114,458,134,305,498,162,334
22051000227,558,361,197,393,178,215,393,137,256,411,248,159,835,423,384,781,350,407,328,137,191,863,440,380,943,556,381
22001006-14,346,52,294,347,23,324,347,25,322,345,42,303,471,23,439,461,30,423,241,32,209,478,16,458,496,23,469
220010006-8,386,97,289,364,32,332,366,37,329,376,79,293,569,99,463,554,73,461,235,54,181,497,63,412,517,79,434
22001006-15,111,16,95,133,4,129,134,7,127,137,22,115,170,9,158,166,10,154,78,8,70,169,10,155,170,9,158
220750005-2,381,93,288,332,34,298,335,22,313,325,97,223,548,50,477,509,48,453,323,24,299,587,70,501,606,88,502
220750005-1,291,72,219,249,24,225,258,18,240,241,72,164,428,42,366,404,42,347,244,19,225,459,53,380,459,66,381
2202300016C,56,15,41,80,5,75,81,7,74,79,19,59,100,9,88,96,8,85,34,3,31,128,6,120,127,7,117
220750009-1,231,76,155,246,30,216,248,35,213,253,58,195,534,90,422,515,68,418,274,38,236,522,75,431,535,82,449
22101000001,75,3,72,78,3,75,76,3,73,77,10,67,97,5,92,91,9,67,67,6,61,112,6,106,107,6,101
22101000026,619,336,283,457,184,273,458,176,282,483,250,231,724,315,395,674,250,401,312,96,216,738,297,402,771,364,401
22119000034,209,171,38,168,116,52,163,111,52,181,144,36,281,208,63,266,196,68,143,105,38,233,168,57,232,172,54
22119000032,352,131,221,316,89,227,317,97,220,319,120,196,429,133,286,410,132,273,237,85,152,430,145,277,424,130,289
220010003-1,501,144,357,398,63,335,393,61,332,401,108,292,647,136,493,636,105,518,283,69,214,694,128,535,732,160,563
220010001-8,394,116,278,346,51,295,346,50,296,364,92,266,586,132,443,555,120,420,262,50,212,634,115,488,663,140,514
220250005-1,493,69,424,481,32,449,480,44,436,497,53,430,582,12,565,539,51,483,188,6,182,535,15,511,560,14,541
220250004-2,262,22,240,236,14,222,239,19,220,251,20,230,231,19,206,214,34,171,134,8,126,221,14,204,233,15,218
221170008-2,333,203,130,311,142,169,316,139,177,329,192,134,434,232,192,402,188,201,154,56,98,463,233,216,473,252,214
221170006-4,295,64,231,316,22,294,323,24,299,332,76,252,421,20,394,419,31,385,168,9,159,519,14,498,524,22,494
22117003-3B,182,170,12,174,142,32,170,124,46,191,170,20,251,211,36,225,181,39,105,81,24,48,0,48,56,4,50
2206300006B,361,72,289,390,20,370,387,22,365,389,80,307,628,38,577,607,82,508,201,17,184,662,15,634,668,18,639
22001006-12,308,125,183,333,44,289,332,53,279,339,103,233,473,64,397,458,59,393,225,33,192,404,51,336,406,66,333
22053000020,281,105,176,263,68,195,263,72,191,268,96,169,359,81,267,353,66,284,199,69,130,396,89,296,413,112,295
22105000045,334,220,114,296,115,181,302,101,201,311,189,122,537,191,320,518,172,327,225,69,156,460,146,288,478,197,271
22105000046,580,570,10,330,290,40,357,315,42,406,392,10,788,771,11,726,654,43,211,202,9,695,600,55,789,743,33
220910002-1,505,480,25,440,375,65,435,376,59,498,462,33,644,598,33,577,488,72,351,324,27,515,405,71,572,502,60
22077000017,1342,561,781,1352,210,1142,1363,235,1128,1381,566,808,1521,276,1215,1443,274,1145,681,105,576,1633,257,1344,1651,316,1318
22119000016,592,138,454,576,82,494,579,85,494,588,123,462,829,114,696,809,137,667,355,68,287,694,83,599,713,94,616
221150006-1,88,7,81,81,10,71,77,8,69,81,8,72,113,10,98,102,10,92,48,1,47,133,13,119,129,13,116
221150006-3,100,12,88,103,10,93,103,8,95,107,13,94,126,3,123,127,9,116,51,5,46,151,5,146,153,8,145
22027000008,276,168,108,235,127,108,243,116,127,260,172,86,344,218,119,323,190,125,144,87,57,303,176,120,316,205,104
22027000007,722,224,498,639,123,516,638,106,532,659,150,496,732,161,554,722,162,556,409,90,319,860,180,663,863,196,661
22123000002,540,151,389,436,66,370,435,65,370,461,102,358,618,119,490,602,146,445,323,72,251,591,88,495,605,108,493
22123000006,466,39,427,411,19,392,406,29,377,420,29,389,541,12,517,513,43,466,246,4,242,566,6,549,586,8,574
22123000008,228,51,177,220,9,211,221,9,212,232,25,207,375,19,346,359,27,329,166,16,150,309,10,294,323,19,300
22123000005,386,75,311,325,16,309,342,17,325,351,48,300,471,50,410,433,65,361,248,23,225,479,44,431,488,50,438
22105000002,778,699,79,450,319,131,512,376,136,568,501,67,794,663,118,723,538,92,287,232,55,936,672,189,1000,803,181
22033001-40,604,438,166,459,250,209,467,201,266,478,331,144,696,394,215,689,385,276,498,311,187,653,336,285,644,378,229
22119000014,216,62,154,165,29,136,167,33,134,169,44,121,254,47,200,254,58,194,125,32,93,309,53,247,314,55,259
22033001-85,1163,1151,12,812,712,100,855,732,123,934,917,12,1383,1359,7,1262,1165,68,703,692,11,1479,1317,83,1590,1519,43
22105000107,379,324,55,253,165,88,250,158,92,301,252,49,487,365,115,447,311,111,164,109,55,446,281,132,480,341,124
22115007-5C,94,9,85,81,5,76,82,6,76,83,16,66,141,8,133,139,12,125,52,6,46,153,12,138,156,8,148
22033003-44,591,568,23,433,378,55,440,363,77,479,451,23,927,686,194,888,620,244,497,380,117,674,597,55,716,663,52
22033003-65,693,494,199,524,304,220,525,293,232,557,381,170,549,407,114,530,367,146,299,230,69,997,523,435,1020,599,398
220790000S8,924,171,753,799,61,738,781,62,719,810,116,689,1137,127,981,1095,113,942,396,48,348,1260,97,1128,1288,113,1159
22079000N20,876,196,680,846,79,767,835,70,765,855,141,709,1111,101,973,1100,106,977,508,49,459,1196,115,1049,1203,124,1054
220790000N9,285,118,167,301,94,207,309,80,229,316,130,185,465,115,324,442,98,319,176,50,126,326,82,228,331,103,219
22105000042,258,208,50,175,82,93,176,87,89,194,143,51,424,276,137,374,223,136,101,58,43,343,203,127,397,263,128
221150002-4,199,31,168,229,15,214,234,17,217,234,38,195,307,32,266,299,36,259,142,17,125,273,27,241,284,41,238
221150008-1,247,24,223,287,19,268,286,28,258,291,48,234,343,20,315,335,31,301,128,12,116,390,34,348,403,31,367
221170004-6,193,88,105,180,28,152,185,39,146,186,70,113,280,54,215,267,60,200,101,19,82,274,56,203,283,80,202
22079000N11,286,95,191,246,39,207,250,23,227,251,71,180,373,47,303,358,60,290,181,22,159,365,65,290,360,66,285
22073000026,337,161,176,199,62,137,197,55,142,206,82,124,394,183,204,356,169,177,127,55,72,422,146,262,450,191,251
22063000016,862,288,574,768,79,689,778,86,692,804,260,538,1175,140,1007,1121,209,890,423,47,376,1539,133,1367,1592,165,1414
22063000010,577,155,422,555,41,514,551,41,510,558,127,421,874,61,798,841,110,717,294,23,271,859,50,778,880,52,818
22121000014,287,265,22,214,165,49,215,163,52,228,203,23,314,267,39,292,235,52,156,136,20,347,261,69,369,312,55
2207300001A,467,69,398,339,17,322,345,21,324,345,30,315,539,26,496,525,39,480,164,10,154,657,36,611,658,49,602
22113000021,83,8,75,64,5,59,63,0,63,68,5,63,79,11,65,79,0,79,45,0,45,97,9,88,101,15,86
22113000034,265,113,152,222,68,154,221,62,159,240,101,134,390,152,220,372,112,247,140,42,98,277,86,170,304,121,179
22113000037,403,367,36,284,216,68,292,214,78,339,283,55,598,499,83,511,317,173,168,137,31,475,303,90,577,467,94
2211300026A,321,83,238,322,40,282,322,33,289,331,63,264,408,66,330,392,53,328,199,39,160,357,41,312,373,50,319
22113000040,508,114,394,497,50,447,493,46,447,516,104,408,674,94,559,654,67,562,350,53,297,663,91,553,677,99,565
220130006-3,301,68,233,287,58,229,286,61,225,296,71,224,452,85,356,444,155,284,196,55,141,487,94,376,494,105,386
2210700002B,43,7,36,72,6,66,73,10,63,75,11,64,64,13,47,58,22,34,19,6,13,96,12,82,94,14,78
22039005010,255,91,164,248,58,190,244,56,188,250,82,165,297,60,230,274,63,204,93,24,69,315,63,245,332,83,248
220150003-1,315,148,167,247,71,176,240,76,164,264,119,145,462,169,280,432,157,265,208,77,131,515,193,314,533,196,329
220150001-1,440,157,283,332,70,262,335,76,259,344,113,227,630,141,443,593,160,417,260,68,192,684,198,455,693,234,445
22015004-3C,150,29,121,124,20,104,120,18,102,124,24,98,217,31,182,213,32,177,71,14,57,281,45,234,286,45,241
22039003071,14,0,14,19,0,19,18,0,18,19,0,19,25,0,25,23,0,23,12,0,12,26,2,24,24,0,23
22087000033,347,165,182,251,68,183,258,63,195,257,127,130,488,92,360,472,104,353,166,39,127,601,149,431,612,169,429
22123000012,167,39,128,169,9,160,164,15,149,166,37,127,205,19,185,184,23,160,114,9,105,192,12,174,206,21,184
22123000003,199,74,125,152,36,116,165,27,138,176,53,123,216,45,171,198,65,133,108,35,73,242,43,194,238,41,197
220590009-3,97,15,82,95,6,89,95,4,91,98,11,87,115,3,111,105,6,98,45,3,42,106,3,100,114,6,107
220090009-3,204,85,119,198,45,153,206,43,163,209,79,129,250,53,195,228,54,171,120,35,85,227,30,188,234,36,193
22009009-5B,342,310,32,245,172,73,250,170,80,286,248,36,458,369,73,384,261,98,313,260,53,436,285,111,487,387,80
22063000020,173,45,128,152,14,138,153,4,149,161,39,118,254,23,224,246,29,209,72,9,63,279,28,239,284,29,249
22063000011,699,258,441,623,97,526,629,113,516,659,261,394,1058,208,823,996,210,754,347,61,286,1107,184,886,1166,239,916
2206300036A,361,105,256,350,28,322,356,32,324,360,93,267,587,59,510,570,66,493,263,25,238,596,38,538,612,54,541
22063000036,671,142,529,598,45,553,601,47,554,604,119,479,935,81,820,931,125,793,480,45,435,983,83,884,987,108,857
22113007A-1,94,9,85,90,4,86,89,1,88,93,6,87,120,5,109,113,8,101,51,3,48,137,6,131,142,9,132
22041000003,370,58,312,351,21,330,351,34,317,370,31,336,432,37,392,414,54,353,181,15,166,446,50,385,481,48,431
22033001-79,470,308,162,406,186,220,410,174,236,421,257,163,834,242,541,829,216,586,522,149,373,677,270,377,682,317,332
22027000084,157,98,59,172,70,102,167,70,97,179,96,81,220,128,86,199,108,90,66,33,33,157,87,68,167,105,60
22027000092,213,48,165,219,19,200,236,30,206,229,49,180,269,34,229,266,34,229,187,22,165,217,20,197,221,29,186
22027000088,141,38,103,138,46,92,138,33,105,137,51,84,158,43,110,150,42,106,93,26,67,196,60,124,192,66,124
22063000004,620,121,499,572,32,540,581,28,553,582,117,461,1069,67,969,1045,87,939,350,27,323,1043,63,961,1035,70,950
2206300001A,275,38,237,228,1,227,237,3,234,236,34,200,384,12,359,379,15,353,157,4,153,384,12,368,390,16,366
22119000027,253,218,35,195,143,52,192,146,46,219,176,40,345,276,63,327,259,61,151,134,17,281,222,46,309,265,38
22119000017,344,83,261,318,45,273,312,44,268,314,66,245,452,74,366,449,77,368,217,42,175,384,75,304,392,89,299
220210005-3,221,43,178,252,22,230,264,34,230,261,40,220,284,33,250,265,45,217,127,12,115,262,23,230,269,33,233
22027000031,560,251,309,476,125,351,472,100,372,494,171,315,632,207,413,584,186,389,236,84,152,568,185,371,591,208,383
221150004-2,113,16,97,126,8,118,124,11,113,129,19,107,178,22,150,175,16,157,73,4,69,183,26,153,183,20,160
22115002-4E,118,37,81,109,26,83,106,33,73,110,37,70,140,32,99,137,29,106,70,18,52,136,29,104,145,31,114
2210500104A,223,122,101,181,59,122,186,61,125,195,97,98,250,86,161,227,61,122,105,26,79,314,108,176,333,135,195
220610004-4,341,66,275,315,30,285,321,28,293,317,50,267,452,47,391,435,64,359,204,21,183,451,39,400,452,49,400
22063000003,894,213,681,829,63,766,825,63,762,842,166,663,1341,81,1217,1296,127,1139,481,28,453,1460,91,1339,1476,111,1345
2206300023C,726,235,491,596,85,511,597,84,513,602,196,403,876,111,730,857,121,716,267,44,223,1103,185,887,1129,212,898
22119000035,478,211,267,464,131,333,455,137,318,481,175,296,623,201,418,610,209,398,283,91,192,686,212,459,703,233,465
22033003-70,1063,353,710,957,169,788,964,137,827,978,333,642,815,206,556,812,176,619,587,145,442,1247,166,1071,1229,229,977
22073000016,495,488,7,300,254,46,287,247,40,316,305,11,619,601,8,555,508,33,245,244,1,539,473,37,603,572,22
22073000071,795,223,572,658,69,589,664,49,615,678,140,537,1074,123,916,1069,140,923,456,62,394,1124,87,1023,1109,125,975
220430001-1,209,92,117,202,55,147,188,49,139,210,84,124,248,68,170,231,67,156,126,35,91,230,57,160,244,68,173
220330001-6,357,347,10,273,223,50,270,214,56,287,275,12,377,356,12,364,321,34,225,214,11,458,391,46,488,455,27
2203301-104,817,751,66,693,553,140,684,496,188,697,631,61,1016,849,135,970,789,164,537,448,89,1090,896,158,1155,1007,131
22033003-41,1285,547,738,1205,337,868,1219,303,916,1229,516,707,1667,451,1134,1641,418,1195,1060,262,798,1420,364,1031,1438,417,982
220330003-3,1460,617,843,1301,279,1022,1303,248,1055,1318,516,794,1610,361,1139,1603,348,1224,984,208,776,1667,320,1300,1668,401,1230
22033001-58,815,779,36,551,461,90,575,457,118,616,587,25,981,905,56,905,787,97,511,472,39,1103,922,130,1196,1094,83
22073000029,158,127,31,82,49,33,85,51,34,97,71,26,200,145,53,183,119,60,50,34,16,164,101,58,177,121,50
220150003-3,245,47,198,207,30,177,209,31,178,212,43,169,296,44,249,284,62,221,126,28,98,441,53,373,460,74,383
22033003-72,781,504,277,623,292,331,628,267,361,635,406,226,913,434,439,871,403,455,514,242,272,853,469,360,878,502,353
22033003-32,626,402,224,502,235,267,502,215,287,513,330,179,737,349,352,721,331,376,414,195,219,811,413,374,805,441,355
22033003-68,596,289,307,560,133,427,557,113,444,571,244,326,583,230,313,583,207,372,390,150,240,507,90,408,496,129,360
22033003-22,761,148,613,708,75,633,711,59,652,718,140,578,901,127,752,885,125,745,535,84,451,958,110,838,931,110,808
2203301-100,311,303,8,159,140,19,159,135,24,169,169,0,707,681,6,679,632,34,115,113,2,529,487,18,565,552,4
22033002-34,1399,870,529,1226,628,598,1227,567,660,1240,820,419,1350,484,803,1346,471,840,772,325,447,1775,772,954,1757,848,883
22033002-30,1190,1180,10,982,852,130,980,798,182,1051,1019,26,1361,1309,28,1294,1184,83,824,800,24,1429,1313,78,1514,1448,42
220610009-2,10,5,5,15,9,6,15,10,5,16,11,5,49,15,31,47,15,28,6,5,1,44,14,28,48,21,24
22073000052,835,127,708,695,46,649,698,46,652,705,79,623,1094,106,959,1040,119,902,378,49,329,1279,74,1178,1292,95,1187
22015002-3A,232,99,133,249,122,127,256,126,130,285,163,118,640,355,261,582,300,266,200,115,85,662,369,275,688,403,273
220690001-6,273,212,61,248,132,116,254,125,129,265,183,80,423,234,162,397,225,157,173,91,82,319,167,123,331,213,115
220690002-2,118,41,77,96,13,83,94,17,77,110,34,76,147,30,115,143,31,109,80,20,60,144,20,120,146,16,125
220690001-3,345,299,46,281,195,86,275,198,77,288,237,46,609,454,130,586,385,176,154,108,46,477,310,118,509,377,120
22015002-11,126,74,52,79,31,48,75,33,42,81,48,32,215,99,101,202,90,101,65,29,36,201,102,90,211,108,98
220150001-2,570,223,347,413,108,305,414,111,303,423,156,260,836,226,572,792,230,542,365,105,260,798,223,542,833,250,562
22073000050,415,84,331,384,32,352,386,32,354,394,48,346,593,55,517,579,47,525,234,22,212,594,51,526,597,56,530
2207300044A,804,146,658,701,39,662,702,37,665,720,93,626,1170,74,1056,1123,102,1012,323,18,305,1100,77,1006,1135,110,1007
2207300009A,495,304,191,356,179,177,360,184,176,361,214,147,555,289,246,523,284,228,223,128,95,596,309,272,608,331,271
22017000101,568,285,283,411,124,287,416,138,278,416,173,242,796,280,473,756,260,481,348,110,238,856,378,457,857,381,459
22113046B-3,90,27,63,83,20,63,85,20,65,86,31,55,155,42,105,145,32,105,67,15,52,103,27,73,106,29,76
2211300032B,138,121,17,106,70,36,101,60,41,121,101,19,203,175,27,175,113,52,48,38,10,185,113,36,225,175,46
22113000023,419,75,344,446,47,399,441,38,403,460,82,376,561,61,482,542,55,474,331,43,288,614,65,538,636,64,559
2211300057A,494,75,419,486,46,440,474,43,431,489,67,420,690,77,600,676,69,556,319,50,269,698,66,612,714,79,629
220810004-2,156,81,75,128,59,69,121,55,66,139,73,58,174,86,82,166,88,78,90,53,37,174,79,92,179,82,95
220810004-5,38,33,5,25,16,9,26,19,7,36,30,6,46,32,9,40,23,16,27,22,5,37,32,5,40,30,7
22017000006,108,95,13,65,42,23,67,50,17,74,58,15,158,124,32,145,101,36,45,38,7,133,107,25,145,123,21
22017000109,1008,272,736,795,135,660,798,131,667,810,217,593,1229,200,982,1206,171,1030,743,140,603,1431,239,1177,1435,322,1093
220250007-1,370,368,2,240,209,31,236,206,30,291,273,14,421,414,6,361,320,31,155,154,1,366,323,16,423,405,10
220590004-3,88,13,75,82,3,79,82,2,80,84,9,75,93,7,82,90,12,78,49,3,46,104,4,96,108,4,102
220810005-2,361,320,41,270,188,82,266,209,57,301,248,50,413,335,68,361,269,73,233,191,42,240,187,44,253,208,40
22065000021,187,183,4,163,129,34,165,150,15,175,166,4,223,221,0,184,162,11,71,70,1,209,186,14,229,222,3
22065000013,225,214,11,155,112,43,146,108,38,155,129,26,227,201,24,211,168,36,107,91,16,164,112,31,188,164,22
220610012-4,3,3,0,0,0,0,0,0,0,0,0,0,10,6,3,10,7,3,1,1,0,9,7,2,9,7,2
22105000040,154,99,55,134,32,102,138,33,105,140,74,64,281,83,176,267,79,175,81,20,61,258,85,163,263,101,160
22035000003,42,29,13,34,16,18,33,9,24,43,25,18,48,23,25,47,15,29,18,11,7,33,9,22,46,22,23
22117003-3C,215,46,169,237,18,219,241,16,225,246,54,188,327,15,306,312,21,285,122,6,116,370,19,345,369,24,345
22073000012,365,355,10,188,158,30,182,150,32,219,209,8,479,446,29,436,375,42,150,136,14,482,419,37,518,493,17
22063000017,729,186,543,606,59,547,605,65,540,619,174,445,920,126,773,871,143,709,321,52,269,1083,118,927,1100,135,950
2206300007B,767,385,382,695,260,435,683,246,437,709,370,330,881,202,629,861,211,610,241,75,166,1244,356,842,1289,406,848
22079000S27,348,43,305,314,14,300,316,15,301,321,30,289,378,18,356,354,38,309,161,12,149,449,9,433,458,14,439
22015002-19,409,334,75,230,147,83,230,148,82,258,188,68,638,457,157,583,393,171,199,134,65,681,482,175,746,560,175
22041000020,337,266,71,289,164,125,296,181,115,309,218,87,366,257,103,345,213,121,169,124,45,347,202,126,371,265,102
220150002-3,423,290,133,167,52,115,168,59,109,171,67,99,446,130,295,423,124,285,143,44,99,502,202,288,503,210,279
2201504-11C,366,105,261,291,52,239,285,53,232,301,97,203,596,118,465,575,133,429,250,48,202,600,115,460,634,133,489
2201502-18D,282,68,214,247,37,210,244,43,201,252,57,190,396,69,318,385,88,294,164,43,121,474,82,387,470,81,377
22109000052,400,160,240,294,65,229,308,64,244,325,134,182,686,197,465,617,163,388,163,30,133,766,140,549,860,205,636
22109000111,158,95,63,148,57,91,147,57,90,154,81,73,249,136,98,221,114,93,52,25,27,263,117,132,286,143,136
22109000038,420,172,248,363,77,286,357,63,294,368,141,222,666,155,487,637,141,467,195,27,168,610,129,450,638,157,469
22097000006,394,265,129,345,150,195,343,146,197,370,218,150,571,345,217,498,228,252,224,133,91,535,245,268,607,348,252
22063000030,406,144,262,339,32,307,336,34,302,349,130,218,514,46,458,502,69,416,181,19,162,686,27,641,717,52,658
2206300039A,400,120,280,441,56,385,436,66,370,444,127,311,772,117,628,738,145,571,206,36,170,810,137,629,842,167,654
22063000031,241,80,161,219,28,191,218,22,196,226,64,162,310,23,278,293,55,230,117,9,108,352,24,313,360,38,312
22063000018,815,192,623,727,65,662,727,69,658,734,177,556,1199,78,1078,1171,144,999,347,32,315,1363,93,1239,1395,97,1289
221270006-1,185,41,144,179,32,147,176,28,148,184,40,144,296,58,233,290,68,221,129,26,103,210,43,162,219,45,174
220130006-1,187,38,149,163,10,153,162,11,151,169,35,131,133,9,118,129,16,111,66,8,58,255,24,227,252,15,234
220010003-3,779,234,545,621,98,523,607,87,520,630,157,472,1042,219,800,998,151,823,444,87,357,1068,211,824,1131,265,852
220010005-4,255,58,197,245,16,229,242,17,225,256,65,187,404,39,357,385,30,349,208,34,174,427,29,385,439,33,396
220850005-3,156,39,117,125,18,107,130,28,102,133,32,101,195,37,150,192,29,156,71,10,61,196,36,150,204,44,156
2201900466W,737,167,570,776,47,729,780,52,728,777,150,624,1194,84,1088,1166,93,1057,452,48,404,1315,67,1222,1326,111,1200
22055000087,769,209,560,677,110,567,677,78,599,687,172,509,1148,174,924,1138,103,1011,618,75,543,1109,169,916,1108,211,874
22055000062,127,124,3,96,79,17,91,73,18,100,98,2,184,178,5,159,96,58,39,37,2,223,184,20,270,260,8
22103000C03,456,229,227,445,104,341,448,105,343,454,205,243,649,154,445,634,124,491,304,71,233,575,148,400,604,216,375
22103000203,1064,232,832,960,75,885,972,71,901,977,215,755,1491,127,1330,1465,143,1292,692,54,638,1585,135,1415,1579,152,1406
2201100019C,228,60,168,209,30,179,211,21,190,210,41,167,309,35,267,295,29,261,115,19,96,311,14,287,324,25,298
22103000S16,367,169,198,306,83,223,313,73,240,319,156,160,587,177,396,561,153,392,243,49,194,669,216,431,684,236,441
22103000S11,398,179,219,352,81,271,348,71,277,353,154,196,634,120,485,611,129,463,307,60,247,678,153,513,698,188,497
22103000S07,364,256,108,267,158,109,265,151,114,271,192,76,549,335,195,515,294,208,213,125,88,570,366,183,609,429,174
22055000072,217,148,69,145,66,79,143,59,84,155,90,61,612,306,235,588,277,275,101,48,53,505,327,163,517,362,139
22055000045,483,192,291,395,92,303,404,96,308,408,145,259,719,185,496,706,149,537,317,62,255,738,227,484,755,245,488
22103000601,379,114,265,334,38,296,340,39,301,341,91,233,643,72,535,634,75,539,261,30,231,656,69,558,660,101,547
22103000404,501,187,314,463,56,407,456,47,409,476,132,338,636,102,495,632,70,546,335,47,288,645,106,529,640,126,495
22103000102,576,185,391,518,59,459,519,50,469,524,152,369,822,104,685,796,91,694,311,31,280,919,90,802,934,140,784
22055000009,734,371,363,604,226,378,600,226,374,622,304,314,976,351,586,950,297,624,407,170,237,1043,358,637,1116,450,649
22055000052,331,284,47,250,189,61,247,181,66,266,221,44,448,353,82,425,266,147,151,112,39,468,346,94,526,439,81
22011000018,115,21,94,118,10,108,119,15,104,127,28,96,143,14,127,138,13,124,47,3,44,144,13,130,158,17,141
2201100018A,32,2,30,18,0,18,19,0,19,19,1,16,45,0,45,47,2,45,9,0,9,38,0,38,39,0,39
22055000089,397,96,301,369,57,312,361,43,318,369,88,280,564,78,451,556,64,485,307,46,261,510,54,440,513,83,407
22055000059,354,168,186,279,110,169,278,98,180,281,128,149,410,161,229,403,128,254,235,87,148,418,174,239,411,164,233
22103000907,211,124,87,135,51,84,137,46,91,137,65,68,313,122,175,288,99,183,102,33,69,331,114,197,355,149,200
22067000037,207,95,112,192,48,144,187,65,122,190,73,116,304,98,198,274,95,171,141,47,94,228,62,153,241,90,147
22049000009,228,147,81,149,76,73,154,84,70,168,98,67,277,143,129,258,137,115,136,78,58,327,142,155,359,196,151
22067000054,95,11,84,84,3,81,83,2,81,86,5,81,127,4,121,121,6,114,65,1,64,131,2,129,128,3,124
22055000068,306,254,52,280,203,77,268,167,101,289,231,53,508,346,107,478,270,183,189,138,51,491,330,113,501,367,104
220570003-4,560,426,134,398,231,167,400,189,211,463,341,116,787,495,269,668,377,258,290,169,121,677,383,233,758,507,233
2205100232A,402,359,43,284,214,70,290,203,87,301,254,43,623,509,94,564,428,117,180,132,48,617,469,105,672,564,101
22051000126,650,370,280,518,160,358,531,130,401,545,284,255,792,240,491,756,195,545,381,132,249,815,217,562,832,286,526
22051000102,354,214,140,306,88,218,311,60,251,314,167,143,448,141,271,440,114,317,235,83,152,447,122,306,454,149,294
22051000017,888,392,496,762,138,624,776,122,654,787,325,455,1152,237,862,1113,221,872,558,103,455,1209,249,917,1242,305,918
22051000019,340,165,175,276,56,220,272,50,222,286,124,161,404,103,281,390,91,288,207,41,166,411,104,290,429,130,290
220510021-K,307,294,13,241,186,55,239,179,60,265,245,18,440,401,32,393,327,45,199,182,17,437,368,42,490,443,38
22101000040,361,103,258,366,58,308,365,47,318,366,101,264,531,108,415,511,120,383,236,47,189,445,72,363,444,81,361
220570010-3,464,127,337,497,47,450,497,39,458,507,133,364,680,71,586,642,102,510,286,23,263,553,53,481,586,57,516
220570006-2,867,202,665,772,47,725,790,59,731,782,234,541,1084,107,958,1048,144,888,374,33,341,1372,81,1250,1391,88,1289
22057002-11,486,372,114,339,182,157,343,192,151,377,269,99,636,415,206,566,329,209,217,136,81,631,351,249,688,438,237
22019000366,434,168,266,414,78,336,415,81,334,419,144,269,665,135,501,646,118,512,227,67,160,542,105,408,542,114,410
22051000116,321,192,129,252,74,178,254,71,183,263,129,133,497,213,271,483,179,290,210,79,131,449,182,255,469,216,245
22101000019,401,74,327,371,53,318,361,41,320,372,86,283,494,61,427,473,81,378,268,25,243,492,63,409,498,80,411
22067000035,293,78,215,279,31,248,282,37,245,286,50,236,400,62,331,381,70,308,189,24,165,390,54,328,420,62,354
22019000406,404,146,258,392,65,327,388,62,326,403,133,266,794,130,619,760,109,626,235,59,176,769,145,597,787,155,607
22019000331,420,199,221,397,78,319,390,64,326,400,161,238,635,108,481,622,97,513,280,46,234,303,50,240,305,72,226
22051ZZZZZZ,0,0,0,0,0,0,0,0,0,0,0,0,0,0,0,0,0,0,0,0,0,0,0,0,0,0,0
22051000027,676,444,232,558,222,336,568,182,386,589,339,243,985,517,420,928,432,472,368,142,226,972,492,423,1048,642,395
22051000195,727,684,43,619,535,84,628,511,117,672,621,44,1046,912,110,973,813,140,424,382,42,1055,901,125,1090,957,118
220510001-H,483,201,282,423,83,340,424,71,353,431,183,245,684,129,514,651,125,501,257,51,206,722,173,524,744,214,514
220890002-3,526,171,355,508,59,449,508,49,459,514,152,357,742,96,609,715,114,585,283,44,239,862,109,726,880,148,713
220510004-G,224,190,34,159,101,58,165,96,69,176,145,30,307,218,84,288,191,89,128,93,35,311,201,87,352,258,88
22051000062,365,169,196,338,57,281,352,57,295,353,150,202,494,107,364,481,94,378,232,55,177,536,143,377,538,145,377
22047000021,399,249,150,409,141,268,403,118,285,418,261,151,533,233,289,495,223,256,224,97,127,478,180,283,513,214,291
22011000012,936,225,711,863,94,769,856,91,765,855,170,679,1182,111,1035,1164,136,1006,353,46,307,1272,80,1164,1293,112,1164
22011000021,281,76,205,285,26,259,277,26,251,293,81,209,370,47,310,356,39,307,126,24,102,363,37,309,391,39,342
2201100027A,275,57,218,290,26,264,291,29,262,294,58,233,310,22,279,306,17,283,123,14,109,318,23,290,332,34,296
22049000004,336,104,232,247,59,188,250,59,191,255,78,175,404,88,304,386,92,290,186,48,138,478,80,376,485,92,391
2201900309E,130,127,3,103,90,13,94,76,18,109,105,4,174,154,16,166,132,28,42,37,5,167,136,24,181,161,17
22019000703,212,85,127,175,41,134,176,40,136,186,75,109,347,80,255,319,67,244,88,17,71,500,129,359,513,140,370
22019000324,496,493,3,447,408,39,438,397,41,485,477,7,682,648,19,654,530,100,267,259,8,464,403,44,515,481,30
220510002-K,767,381,386,664,167,497,675,149,526,692,313,376,945,315,588,930,265,640,595,162,433,1027,328,668,1067,393,660
2205100179B,272,259,13,219,191,28,221,177,44,244,233,7,386,346,32,349,288,45,138,127,11,342,294,29,388,349,31
22051000180,460,460,0,363,332,31,363,331,32,428,413,3,743,725,9,670,627,30,296,288,8,663,604,31,735,703,24
22051000173,220,208,12,169,145,24,168,136,32,190,181,9,390,339,44,343,274,62,115,111,4,364,298,49,379,328,47
220070005-1,291,264,27,224,180,44,219,169,50,270,240,29,317,265,45,271,219,42,145,128,17,279,197,61,320,256,53
22049000017,81,35,46,64,17,47,61,14,47,67,27,40,107,31,73,98,37,59,47,16,31,126,34,89,135,41,92
22051000215,754,539,215,684,362,322,696,336,360,710,468,237,1045,542,469,1001,482,499,450,235,215,1050,535,474,1094,591,486
220890001-6,666,359,307,591,196,395,584,167,417,587,319,262,860,295,521,831,268,542,309,104,205,868,312,531,884,354,522
220890002-6,185,70,115,203,41,162,203,35,168,205,74,125,311,46,250,307,64,236,120,27,93,313,53,246,320,67,246
22051000191,747,555,192,594,327,267,603,306,297,629,431,186,1252,802,420,1138,668,431,443,285,158,1236,738,426,1347,866,457
22051000068,524,218,306,456,84,372,461,78,383,472,192,279,822,204,595,781,210,549,285,65,220,843,204,604,874,246,608
220570006-3,405,160,245,380,52,328,379,50,329,398,187,207,516,111,400,506,123,376,191,49,142,720,97,590,749,96,646
220570005-1,339,104,235,299,31,268,296,35,261,303,87,215,350,62,274,339,69,263,128,19,109,544,55,480,555,72,476
22051000122,661,263,398,559,77,482,571,53,518,578,225,347,801,139,606,798,130,650,449,65,384,806,130,659,801,160,623
22051000001,834,314,520,757,104,653,772,95,677,769,266,497,1117,172,885,1088,136,936,587,61,526,1012,142,834,1019,199,793
220070007-1,646,351,295,536,173,363,540,173,367,581,305,276,701,271,418,645,242,395,259,102,157,689,232,439,719,267,447
22051000106,291,136,155,277,47,230,281,41,240,283,121,161,416,102,301,404,86,312,177,38,139,410,94,304,421,113,303
22051000129,467,286,181,390,131,259,400,99,301,411,237,170,630,206,371,613,188,412,331,126,205,572,188,365,571,214,344
220510019-K,709,284,425,599,108,491,604,89,515,629,237,387,1002,273,687,946,186,722,485,90,395,960,215,716,1001,262,726
22051000013,698,288,410,575,93,482,594,82,512,597,244,350,982,208,715,950,185,734,486,92,394,1004,200,770,1021,248,753
22051000230,876,468,408,730,191,539,740,158,582,753,344,398,1180,370,753,1134,312,796,525,130,395,1211,428,729,1269,512,728
22047000007,463,418,45,422,341,81,425,324,101,489,429,60,579,495,69,514,410,89,234,201,33,497,395,85,541,457,72
22079000C27,373,167,206,341,101,240,343,92,251,350,150,197,542,190,318,527,156,356,208,61,147,494,165,317,515,204,302
22079000C41,781,307,474,677,140,537,687,150,537,684,237,446,912,195,684,872,181,676,318,86,232,977,225,727,982,251,717
22079000C36,1030,339,691,932,152,780,925,122,803,947,282,664,1184,213,926,1169,170,979,639,111,528,1114,196,896,1134,234,875
22079000S11,392,84,308,323,29,294,324,27,297,329,55,270,473,43,420,449,50,391,200,24,176,526,41,473,543,56,476
22087000012,221,124,97,163,44,119,173,41,132,171,92,76,322,77,236,313,73,232,110,35,75,449,135,301,457,151,299
220510010-K,371,189,182,331,93,238,330,72,258,335,164,171,552,178,350,532,147,374,302,63,239,533,176,336,563,227,333
22071008-27,348,326,22,214,190,24,231,187,44,239,229,9,436,389,33,417,357,50,160,149,11,510,449,43,523,483,40
220710008-8,290,280,10,183,165,18,184,149,35,206,192,8,352,333,1,314,297,9,142,137,5,491,451,19,535,518,11
2207109-44B,425,421,4,268,239,29,284,238,46,298,298,0,651,631,15,597,554,25,203,200,3,679,604,36,820,787,27
22071015-10,406,405,1,277,256,21,288,237,51,307,296,7,579,564,5,533,496,24,259,254,5,589,538,21,664,632,18
22071012-13,188,187,1,142,132,10,148,125,23,159,157,2,253,245,4,224,207,14,105,101,4,275,242,17,327,314,13
220710008-9,386,378,8,255,228,27,268,233,35,284,274,6,507,492,4,461,428,23,204,199,5,577,512,27,684,655,14
22071005-12,406,372,34,302,259,43,305,215,90,311,285,26,538,415,84,523,399,118,324,280,44,571,443,107,562,451,96
22071009-35,104,104,0,81,78,3,81,76,5,87,86,0,123,118,4,119,106,12,61,61,0,100,95,3,120,114,3
22087000042,365,138,227,351,36,315,363,34,329,358,138,217,507,66,419,490,71,411,190,36,154,558,61,456,579,99,475
22087000043,264,109,155,239,49,190,245,37,208,246,106,136,386,76,289,363,86,268,126,20,106,448,78,350,456,80,368
22015002-20,342,146,196,234,60,174,231,57,174,240,85,155,577,179,370,553,179,360,216,54,162,578,216,336,600,232,359
22015002-13,354,248,106,245,128,117,241,126,115,253,148,105,551,321,226,522,296,220,200,98,102,591,352,207,620,379,235
22015004-8D,116,70,46,85,41,44,82,40,42,87,44,41,190,101,83,175,89,80,60,22,38,198,98,94,211,110,94
22071009-42,610,606,4,450,424,26,454,392,62,481,472,5,830,796,22,759,704,39,344,332,12,781,703,42,899,871,22
22071005-11,261,254,7,208,179,29,203,156,47,212,203,9,325,271,34,318,261,47,178,169,9,285,222,43,283,238,39
220710004-6,165,150,15,124,104,20,128,93,35,125,113,11,223,173,31,219,168,41,113,99,14,236,183,49,232,185,42
22053000003,196,40,156,209,17,192,214,13,201,212,38,174,285,17,265,288,19,266,148,16,132,301,46,254,304,43,261
22053000018,267,61,206,236,20,216,235,25,210,237,57,174,321,57,258,322,44,273,155,29,126,402,48,348,412,47,361
2205300009A,67,27,40,106,15,91,104,15,89,106,30,76,177,29,143,169,22,142,96,16,80,139,15,121,146,22,121
22071005-13,366,314,52,295,210,85,295,170,125,300,252,47,457,314,103,445,289,147,298,218,80,506,360,134,486,363,106
22071017-16,351,339,12,238,199,39,246,208,38,258,248,9,448,420,19,424,375,36,174,159,15,588,539,20,634,599,26
220030004-2,281,35,246,284,8,276,278,17,261,286,29,257,338,7,322,329,12,312,144,13,131,386,11,367,413,13,399
22033001-48,1186,651,535,1074,328,746,1078,269,809,1071,542,528,1310,434,774,1326,383,925,976,336,640,1375,384,956,1319,448,831
22033002-25,975,834,141,819,611,208,814,574,240,864,709,151,1360,1060,267,1301,989,289,775,618,157,1230,917,265,1301,1043,236
22033001-60,990,593,397,807,327,480,797,283,514,820,466,344,1198,498,627,1177,491,658,761,329,432,1241,590,616,1268,646,591
220330001-4,282,282,0,189,166,23,200,164,36,210,209,1,338,323,5,313,285,23,186,185,1,376,351,15,389,382,2
22033003-15,1135,481,654,1044,269,775,1046,248,798,1045,425,616,1204,310,815,1197,277,887,719,173,546,1501,393,1067,1513,439,1034
22037000004,971,476,495,901,294,607,892,268,624,935,428,499,1197,448,717,1117,389,702,620,234,386,1025,308,678,1045,348,679
220290003-4,360,47,313,369,23,346,368,31,337,372,59,310,613,41,555,590,63,521,237,22,215,528,53,465,544,66,471
22097000031,535,271,264,480,175,305,477,189,288,513,234,275,669,280,385,634,221,397,231,121,110,681,270,390,711,293,410
221150008-3,282,24,258,284,28,256,281,24,257,290,29,258,337,12,324,312,34,276,173,8,165,409,23,378,422,28,393
22121000018,401,178,223,362,120,242,364,99,265,370,180,185,433,133,282,427,141,279,279,80,199,464,150,302,473,173,297
22121000022,903,523,380,779,303,476,781,285,496,809,465,341,994,421,556,928,390,527,501,234,267,1070,371,670,1097,438,640
220710010-7,252,231,21,175,137,38,177,129,48,182,165,14,340,254,45,322,230,81,179,143,36,301,223,61,306,238,56
220710007-7,307,302,5,192,174,18,187,161,26,205,198,7,450,439,7,408,360,23,141,140,1,416,366,24,503,478,19
2207115-14E,422,405,17,299,264,35,303,251,52,319,309,10,678,614,53,646,562,79,206,179,27,550,472,50,611,564,43
22071012-11,436,403,33,317,245,72,323,237,86,338,298,34,564,479,58,549,438,100,233,207,26,598,499,83,624,551,67
22033001-98,1366,761,605,1133,404,729,1138,350,788,1154,594,558,1619,647,877,1584,595,945,950,379,571,1759,741,965,1789,831,920
22033001-82,988,916,72,846,703,143,841,663,178,871,791,77,1096,919,152,1066,864,183,688,583,105,1162,969,169,1192,1020,148
22071017-14,484,479,5,315,288,27,334,295,39,357,354,2,730,709,12,673,624,30,223,220,3,665,604,34,833,792,19
2207109-44N,390,390,0,313,297,16,315,277,38,334,330,1,479,458,14,457,418,29,267,262,5,448,412,17,502,485,16
22071004-20,412,235,177,350,111,239,357,83,274,357,189,165,532,168,326,527,132,389,280,87,193,512,119,380,509,152,341
22071017-15,365,361,4,255,211,44,266,203,63,287,279,8,490,464,20,457,410,34,202,191,11,503,446,38,579,551,27
22071017-17,340,186,154,235,68,167,244,39,205,248,119,125,436,153,244,422,103,318,257,101,156,359,72,277,377,127,246
22033001-36,631,569,62,469,382,87,483,367,116,505,456,45,738,625,87,699,568,113,450,379,71,788,618,142,841,702,119
22033001-26,385,382,3,239,210,29,258,223,35,271,267,4,549,523,12,496,435,37,225,218,7,513,448,41,556,535,16
22033001-70,1111,1047,64,1025,884,141,1026,807,219,1064,991,66,1165,1009,126,1119,946,143,801,711,90,1240,1063,140,1283,1143,121
2210500122B,695,205,490,572,74,498,579,69,510,565,159,403,871,107,731,835,118,699,284,30,254,1257,135,1092,1265,160,1092
22105000006,284,277,7,163,147,16,173,152,21,195,187,8,372,351,16,302,256,24,260,240,20,379,306,42,424,387,22
22115001-4B,73,45,28,70,23,47,68,19,49,79,40,37,112,48,61,107,37,61,32,13,19,121,38,75,127,49,67
220610005-1,451,117,334,400,53,347,396,44,352,426,88,334,598,96,493,562,84,467,201,38,163,675,63,564,695,118,568
2206300026A,473,185,288,486,96,390,484,84,400,500,155,339,748,118,608,707,123,568,273,47,226,710,133,549,729,160,546
22063000041,253,63,190,271,23,248,272,25,247,273,67,203,496,56,422,477,67,398,147,19,128,459,50,401,467,77,381
22105000110,667,269,398,566,95,471,563,84,479,569,222,346,796,112,674,771,121,592,350,44,306,892,132,731,893,138,751
22087000034,74,30,44,73,20,53,75,13,62,75,30,43,154,22,121,141,29,109,18,2,16,186,49,128,196,54,136
220710016-8,383,333,50,288,204,84,296,154,142,306,257,49,423,286,96,417,255,157,273,210,63,426,273,138,414,297,108
22071016-1A,280,257,23,205,168,37,204,145,59,210,192,18,363,298,49,340,267,70,207,178,29,409,320,74,435,368,64
220090003-3,160,107,53,137,76,61,143,72,71,155,106,49,199,114,76,173,84,80,89,50,39,181,91,84,190,101,84
220090001-1,499,77,422,483,37,446,493,28,465,503,72,430,652,42,599,625,63,554,275,23,252,707,38,654,730,40,687
220130006-2,204,10,194,186,4,182,188,7,181,189,18,171,236,4,229,226,40,183,116,16,100,310,10,296,303,13,288
22039001031,265,141,124,230,87,143,227,79,148,252,133,110,324,119,196,291,83,200,107,39,68,303,100,181,343,140,196
22093000001,330,311,19,263,224,39,254,210,44,272,248,22,409,342,61,361,285,63,138,122,16,388,275,93,446,389,50
22071015-11,352,348,4,185,158,27,194,158,36,214,204,3,511,508,1,472,444,14,133,130,3,545,491,30,639,622,10
2207109-42C,471,468,3,342,324,18,344,304,40,360,355,5,678,659,15,645,595,34,227,222,5,661,599,24,725,701,16
220710014-1,375,309,66,295,206,89,296,166,130,305,261,44,435,305,115,422,259,161,230,169,61,476,302,159,437,286,149
220710012-4,289,263,26,197,167,30,200,149,51,211,190,20,373,298,53,360,266,79,209,188,21,316,252,57,320,264,50
220710011-8,328,237,91,244,141,103,249,123,126,250,180,70,366,187,150,355,139,207,190,104,86,353,171,171,356,210,138
22039001050,133,59,74,117,23,94,116,27,89,124,50,74,143,34,106,132,36,95,60,18,42,143,34,106,153,43,110
22039004011,83,14,69,90,4,86,91,6,85,96,13,83,99,5,90,87,10,76,26,3,23,115,7,104,119,9,107
22107000009,80,42,38,70,35,35,73,34,39,86,46,37,112,51,56,96,48,46,65,32,33,77,37,36,90,46,44
22039004010,228,20,208,205,9,196,201,7,194,206,19,187,252,7,241,234,21,205,63,8,55,288,15,273,301,10,291
22009008-3A,575,110,465,544,35,509,547,32,515,557,103,452,639,40,593,611,70,529,309,27,282,736,27,691,740,33,706
221150002-1,877,133,744,836,50,786,820,57,763,858,131,718,1334,118,1177,1292,125,1143,465,45,420,1178,78,1068,1231,92,1114
220710007-8,369,366,3,222,200,22,228,185,43,267,257,6,512,488,10,459,416,26,150,145,5,484,428,14,589,571,10
2207109-43E,248,244,4,135,123,12,146,125,21,149,148,1,290,279,8,276,266,7,131,125,6,291,259,19,306,286,13
22009009-4B,227,64,163,229,29,200,226,31,195,232,59,173,271,39,223,251,44,200,123,31,92,278,34,237,284,36,245
220090001-2,465,88,377,477,26,451,477,33,444,494,80,409,611,38,564,582,68,503,237,23,214,655,30,614,677,38,635
220090001-3,213,43,170,204,14,190,208,16,192,212,37,174,286,9,271,272,27,237,99,16,83,307,13,285,318,14,301
220710008-4,228,228,0,166,154,12,163,140,23,173,168,4,330,301,7,311,289,11,143,143,0,247,228,10,288,276,10
22071014-21,433,359,74,304,203,101,307,161,146,321,257,63,463,310,123,451,269,175,272,197,75,487,298,172,494,345,132
22017000083,648,421,227,507,264,243,510,270,240,539,335,201,863,501,341,827,475,335,471,299,172,757,449,279,792,493,289
22097000041,600,188,412,506,97,409,536,110,426,541,150,388,805,169,632,772,137,613,341,83,258,905,136,744,928,170,748
220710008-7,250,247,3,175,162,13,177,151,26,186,182,4,316,301,4,287,264,10,136,130,6,347,329,10,361,352,2
22071007-30,530,509,21,450,393,57,472,375,97,491,461,27,613,572,28,602,539,50,352,326,26,589,474,79,610,521,77
22071012-19,394,390,4,259,245,14,278,230,48,298,292,3,549,530,5,508,472,21,186,174,12,509,446,36,579,544,21
220710012-6,329,289,40,242,164,78,249,126,123,262,220,38,360,273,73,331,232,95,218,181,37,395,276,108,395,302,84
22071010-14,229,225,4,146,136,10,151,130,21,165,161,3,333,323,5,313,287,20,110,109,1,341,315,10,379,368,8
22065000014,114,55,59,117,24,93,114,23,91,123,35,88,148,27,118,149,22,122,88,18,70,114,38,74,121,47,74
220330003-2,823,253,570,770,121,649,770,104,666,781,236,545,1418,209,1174,1390,229,1149,839,132,707,1247,226,1004,1245,243,990
22033001-71,993,694,299,877,464,413,880,425,455,895,618,276,1039,513,493,1020,489,504,641,321,320,1099,579,495,1139,659,469
22033002-12,1167,1000,167,978,718,260,988,664,324,1029,871,157,1358,1040,282,1331,1022,287,886,699,187,1424,1074,292,1472,1179,272
220330001-3,303,282,21,235,188,47,244,180,64,257,234,21,358,311,35,343,292,46,240,218,22,419,366,35,426,376,41
22033003-11,224,185,39,168,124,44,165,116,49,173,136,36,419,286,113,399,273,112,148,116,32,359,243,99,384,284,92
22079000C19,309,223,86,223,127,96,216,117,99,235,156,79,379,246,120,354,216,130,129,71,58,378,235,126,417,294,118
220030005-2,347,61,286,396,18,378,394,20,374,400,77,320,569,24,526,541,32,494,158,14,144,603,34,550,632,31,599
22079000S28,202,26,176,166,7,159,167,11,156,169,23,142,198,10,181,189,13,171,62,5,57,231,8,215,246,14,231
22079000C32,399,179,220,349,98,251,348,93,255,360,139,220,582,200,360,553,171,362,193,63,130,573,169,382,594,200,371
22017000111,275,275,0,181,153,28,183,163,20,204,201,1,338,329,6,315,285,22,205,205,0,342,318,13,353,338,14
22073000046,508,148,360,450,64,386,443,62,381,456,107,346,759,149,579,731,149,565,274,36,238,701,112,561,720,140,570
22073000076,628,264,364,505,146,359,517,144,373,528,203,322,836,247,559,830,236,582,324,97,227,710,202,490,717,256,443
22073000035,566,232,334,460,76,384,462,85,377,484,128,353,756,216,516,718,191,514,340,89,251,689,181,488,705,219,475
22073000064,320,124,196,262,41,221,268,40,228,279,65,210,515,86,408,511,90,418,211,41,170,473,88,376,479,99,373
2211900002B,14,0,14,9,0,9,9,1,8,11,0,11,16,0,16,15,2,13,3,0,3,16,0,16,16,0,16
22079000C40,189,153,36,134,93,41,141,96,45,149,124,25,325,233,84,291,193,87,85,62,23,307,198,90,336,243,81
220710014-3,342,287,55,245,146,99,258,113,145,264,218,42,453,282,130,447,241,196,237,164,73,475,306,159,474,347,122
220710013-1,323,308,15,216,183,33,217,163,54,222,206,15,404,352,34,386,323,56,207,192,15,377,315,52,379,330,43
22113019A-1,161,61,100,170,36,134,162,29,133,176,44,132,232,45,179,221,29,185,84,21,63,279,54,205,288,68,208
22113020B-1,199,31,168,183,14,169,184,14,170,190,34,155,293,22,262,281,21,252,130,9,121,296,16,275,309,22,286
22065000009,48,22,26,33,14,19,38,17,21,37,21,16,54,16,38,47,18,28,21,9,12,67,43,20,64,40,19
22119000024,181,178,3,145,127,18,147,135,12,167,167,0,303,297,3,285,248,31,104,103,1,250,229,9,274,265,7
220790000N4,223,167,56,243,154,89,234,131,103,254,183,71,333,208,111,284,162,116,142,105,37,283,135,126,312,181,119
22119000003,136,93,43,95,52,43,101,61,40,106,72,33,212,142,70,203,131,69,76,42,34,197,119,73,215,135,78
22041000032,429,78,351,445,45,400,450,43,407,466,66,400,514,97,412,473,85,385,238,39,199,587,61,521,606,76,528
220430001-2,195,56,139,168,25,143,166,28,138,170,36,131,234,35,197,221,51,163,100,25,75,258,31,212,266,39,224
22079000S17,123,46,77,109,16,93,110,12,98,109,24,84,132,37,90,136,30,104,56,14,42,167,27,138,167,31,134
22083000008,352,68,284,360,28,332,363,27,336,378,43,335,444,57,381,428,55,370,243,22,221,496,42,449,501,59,442
22017000010,472,188,284,393,86,307,395,75,320,397,137,255,650,151,454,648,159,479,336,99,237,671,168,482,672,195,458
22017000070,788,748,40,546,417,129,548,447,101,586,539,44,1084,972,86,1024,891,106,429,384,45,1020,882,93,1054,958,93
22017000155,108,24,84,88,13,75,92,15,77,93,19,74,148,31,114,141,33,105,91,21,70,164,35,127,170,39,129
22017000132,823,190,633,685,90,595,696,91,605,705,143,555,1196,192,978,1151,184,950,503,92,411,1234,187,1019,1255,212,1019
220690004-8,135,22,113,142,8,134,146,5,141,140,21,118,190,19,167,186,36,146,75,8,67,202,20,178,206,24,181
220690002-1,109,17,92,103,8,95,109,11,98,108,14,93,156,19,134,144,23,120,73,11,62,188,28,155,193,30,162
220690002-7,217,195,22,173,125,48,176,140,36,205,175,29,253,213,34,259,208,44,137,104,33,248,181,47,273,237,31
220690002-4,229,62,167,192,21,171,197,23,174,203,47,155,267,55,208,261,65,195,150,35,115,292,40,239,293,46,246
22023000009,86,11,75,99,7,92,98,5,93,98,13,82,109,3,103,106,10,93,54,8,46,241,13,213,247,17,224
220290001-4,266,212,54,225,141,84,231,142,89,250,183,57,311,215,93,264,175,84,99,70,29,302,176,109,327,211,115
220250006-3,82,26,56,62,18,44,62,13,49,67,22,45,89,19,70,82,13,69,26,5,21,96,22,73,98,26,72
22039001160,292,288,4,179,158,21,177,170,7,251,241,8,319,311,4,263,206,50,120,120,0,213,163,27,277,260,10
221170004-3,221,156,65,208,96,112,208,105,103,213,126,83,307,158,144,284,139,133,90,38,52,318,172,122,355,236,115
22017000043,256,246,10,171,141,30,167,137,30,179,169,8,377,350,21,351,314,28,143,137,6,377,338,22,396,375,17
22017000099,211,190,21,138,99,39,139,100,39,155,130,24,348,300,37,326,261,52,118,106,12,309,263,39,324,285,28
22027000036,328,240,88,205,101,104,211,102,109,243,164,79,298,213,84,260,173,80,128,87,41,312,215,91,351,267,84
22017000059,522,518,4,347,295,52,335,299,36,372,365,6,747,715,19,656,582,53,265,256,9,665,606,32,728,691,22
22017000045,647,614,33,482,382,100,472,392,80,528,495,33,916,833,72,865,763,90,480,443,37,714,639,60,760,692,61
22017000055,302,224,78,218,110,108,223,122,101,235,160,72,416,265,144,386,255,126,191,131,60,412,285,116,433,306,117
22071007-23,695,687,8,497,451,46,504,425,79,539,528,10,855,816,24,799,715,59,385,371,14,793,721,33,873,845,11
22015004-8G,523,136,387,431,70,361,431,60,371,436,102,331,639,120,493,619,128,484,329,64,265,678,127,532,690,142,529
22035000014,148,139,9,102,80,22,106,85,21,120,108,8,133,118,8,115,85,24,58,52,6,170,130,30,177,152,21
220430008-1,41,9,32,51,6,45,50,7,43,49,5,40,59,1,55,56,7,46,22,4,18,48,2,45,50,4,46
22041000031,566,107,459,551,32,519,550,32,518,575,54,520,680,50,622,659,73,583,343,21,322,687,49,622,696,67,626
221270006-6,48,8,40,61,3,58,60,6,54,61,5,56,75,5,70,71,13,57,35,5,30,98,4,94,104,4,100
22041000001,209,51,158,191,26,165,187,24,163,201,42,159,257,33,219,238,51,186,111,22,89,283,48,232,288,48,236
22035000017,63,22,41,56,12,44,56,15,41,59,19,40,91,34,54,80,33,46,44,17,27,99,15,79,102,30,72
22009008-2A,148,55,93,143,30,113,141,29,112,143,46,95,175,29,139,166,38,126,74,27,47,220,38,174,223,46,177
22005000057,243,234,9,203,168,35,208,161,47,220,197,17,259,238,19,236,200,26,131,125,6,340,279,37,398,360,27
22095ZZZZZZ,0,0,0,0,0,0,0,0,0,0,0,0,0,0,0,0,0,0,0,0,0,0,0,0,0,0,0
22005000030,390,305,85,314,168,146,301,169,132,335,247,87,546,350,174,510,287,192,231,144,87,597,381,197,629,431,187
22005000026,1272,396,876,1231,142,1089,1225,130,1095,1233,418,809,1658,228,1384,1581,267,1267,468,94,374,2075,206,1819,2112,233,1849
22005000007,758,352,406,674,184,490,681,165,516,691,289,398,1288,335,876,1260,313,920,532,133,399,988,266,684,1010,315,679
22005000064,359,166,193,319,87,232,324,78,246,324,135,187,610,158,417,588,143,431,251,61,190,463,125,322,478,149,322
22095004-13,0,0,0,0,0,0,0,0,0,0,0,0,0,0,0,0,0,0,0,0,0,0,0,0,0,0,0
22097000036,488,408,80,400,277,123,389,254,135,438,346,89,597,464,118,554,354,183,239,196,43,606,425,139,663,518,126
22039003010,356,87,269,344,38,306,336,46,290,353,72,275,451,55,383,423,40,371,164,23,141,451,47,389,471,63,401
22099000007,851,320,531,747,176,571,725,201,524,759,278,474,995,304,663,928,216,661,526,146,380,969,271,658,1003,320,659
220810002-3,306,35,271,263,11,252,265,19,246,262,16,246,374,11,358,377,57,317,184,9,175,361,2,354,364,0,360
22063000029,594,153,441,610,52,558,608,48,560,608,150,452,874,93,755,843,107,718,361,39,322,922,72,827,944,81,846
22111000029,585,70,515,492,18,474,495,24,471,512,63,446,780,45,725,750,75,663,295,16,279,839,41,788,861,44,810
22111000023,396,51,345,329,12,317,338,13,325,343,43,299,482,27,447,463,46,414,213,18,195,550,18,523,550,27,521
22005000020,704,265,439,622,113,509,633,115,518,637,235,399,796,166,594,785,175,583,327,64,263,959,200,725,970,253,684
22005000011,1085,452,633,1057,236,821,1055,220,835,1083,399,676,1674,437,1170,1618,418,1146,561,163,398,1726,439,1235,1764,505,1215
22005000018,890,353,537,855,154,701,846,154,692,841,309,523,1310,211,1045,1270,253,971,422,80,342,1449,256,1155,1463,291,1145
220950007-2,967,550,417,978,369,609,1001,317,684,1006,552,444,1446,550,849,1391,526,837,738,247,491,1315,479,803,1323,543,761
220950007-3,311,174,137,274,104,170,282,97,185,284,154,128,410,142,249,403,142,250,198,65,133,403,156,239,410,167,239
220950007-7,353,213,140,348,168,180,355,160,195,351,213,135,473,208,245,453,202,248,239,123,116,510,227,274,511,241,266
2208700042A,427,150,277,387,48,339,399,31,368,390,118,269,725,96,599,709,112,574,214,32,182,708,100,592,726,101,619
22103000S23,216,87,129,196,50,146,197,43,154,203,87,115,292,58,223,284,55,223,155,30,125,375,93,271,375,93,275
22087000032,679,291,388,572,122,450,588,101,487,584,250,328,1093,223,811,1056,231,792,346,81,265,1096,307,761,1103,332,755
22033001-30,571,563,8,376,340,36,376,332,44,435,426,8,677,663,8,621,569,42,345,334,11,689,607,48,774,728,32
22109000035,199,54,145,180,36,144,181,26,155,180,55,124,278,58,213,263,59,192,110,23,87,298,48,239,311,57,253
22073000077,753,302,451,557,133,424,555,116,439,567,199,367,938,181,711,924,176,732,377,106,271,917,200,682,941,271,647
2201100027B,180,60,120,193,36,157,188,42,146,200,75,122,286,86,190,273,65,199,121,28,93,223,51,167,230,59,162
22055000074,411,218,193,359,149,210,360,125,235,370,184,182,590,237,295,580,191,363,294,127,167,580,232,322,601,273,314
22103000S21,346,212,134,262,120,142,264,108,156,277,156,118,572,250,289,529,229,286,153,73,80,747,408,299,777,438,321
22055000049,666,337,329,612,204,408,610,147,463,617,279,334,840,240,539,820,200,597,502,165,337,982,341,600,972,375,566
22103000416,471,187,284,362,50,312,377,46,331,387,106,277,637,96,492,634,80,545,281,34,247,610,84,507,599,104,485
22055000088,561,147,414,523,87,436,525,55,470,521,124,394,761,139,585,755,93,641,417,77,340,719,117,587,716,121,579
220710001-5,363,298,65,262,171,91,268,149,119,276,215,60,477,333,122,456,283,162,255,178,77,431,291,125,418,292,111
22055000085,827,288,539,687,133,554,688,121,567,689,207,480,1093,176,865,1071,131,920,508,80,428,1199,265,879,1225,358,842
22103000302,647,189,458,596,80,516,597,53,544,606,179,416,870,127,710,852,118,722,430,64,366,800,84,698,803,98,701
22103000817,861,304,557,728,157,571,723,129,594,732,252,470,1163,234,887,1131,199,919,570,139,431,1205,224,960,1216,278,916
22103000S01,762,301,461,597,98,499,609,80,529,613,233,372,951,163,736,913,161,744,548,107,441,1114,224,865,1136,278,836
22055000111,895,202,693,726,99,627,738,83,655,738,155,582,1129,121,965,1096,102,968,443,62,381,1166,183,964,1189,209,970
22103000910,821,257,564,693,86,607,694,79,615,706,220,479,1175,148,985,1153,188,945,565,74,491,1218,177,1015,1239,241,990
22115004-3F,2,2,0,9,3,6,9,3,6,9,3,6,13,5,3,10,2,4,2,0,2,12,5,7,13,5,5
22105000044,605,255,350,538,100,438,520,86,434,536,252,282,962,182,746,935,195,720,383,79,304,859,169,659,885,204,665
22105000145,872,307,565,722,98,624,730,99,631,724,215,499,1026,135,853,1000,155,815,324,54,270,1318,232,1046,1347,263,1056
2210500042A,242,167,75,188,63,125,200,53,147,206,127,76,332,141,178,325,125,186,138,58,80,313,126,164,335,167,163
2204900008A,35,12,23,24,3,21,26,3,23,24,0,24,45,4,41,39,4,34,20,4,16,45,10,34,51,15,34
221150007-3,132,9,123,115,5,110,115,5,110,118,11,106,164,2,161,160,11,149,62,5,57,187,5,181,193,3,187
22019000325,710,288,422,628,108,520,623,88,535,625,237,388,913,143,725,926,123,798,446,73,373,499,84,397,499,108,378
22055000046,305,108,197,290,71,219,288,54,234,293,107,182,405,102,266,393,78,303,198,62,136,456,125,306,460,139,308
22103000107,774,274,500,625,90,535,623,74,549,619,205,410,977,163,765,962,124,817,495,49,446,860,125,708,861,166,681
22055000021,408,356,52,267,203,64,267,208,59,305,270,33,576,490,71,532,357,158,192,170,22,498,385,67,579,505,61
22049000001,67,3,64,65,2,63,58,0,58,63,2,61,95,3,92,92,1,91,40,1,39,120,0,113,119,0,116
221150001-8,121,37,84,129,16,113,125,17,108,129,29,97,191,38,144,179,24,152,58,13,45,188,34,147,195,46,146
22103000802,920,443,477,723,203,520,720,174,546,730,327,393,1249,359,816,1201,338,820,451,119,332,1615,446,1102,1657,519,1104
22103000411,521,130,391,414,57,357,422,46,376,422,101,318,664,106,537,640,88,535,273,48,225,804,109,685,810,132,669
22115007-5A,140,56,84,128,32,96,130,38,92,132,56,76,191,50,134,178,45,128,68,21,47,192,38,146,213,54,156
22079000C30,437,161,276,387,65,322,393,65,328,404,135,268,594,134,435,577,117,446,246,57,189,563,134,414,581,169,406
22103000201,681,325,356,566,171,395,566,147,419,593,263,327,887,267,595,863,249,596,384,105,279,1038,312,691,1074,369,692
2212100001B,747,448,299,605,245,360,615,229,386,617,334,278,665,207,418,655,224,421,377,153,224,1163,468,673,1178,526,624
22117004-1A,440,380,60,421,294,127,398,266,132,437,344,89,658,524,124,574,400,150,228,172,56,582,405,147,623,475,128
221170005-1,537,329,208,500,218,282,509,209,300,533,289,237,680,315,352,621,262,344,245,111,134,647,303,320,674,340,316
22117004-3B,251,184,67,262,141,121,262,145,117,280,186,91,379,230,141,372,204,154,166,106,60,327,183,134,342,210,128
220790000S2,156,47,109,115,14,101,116,16,100,125,35,87,198,22,171,191,29,154,69,17,52,211,23,186,224,27,194
2212100001C,809,488,321,654,312,342,651,304,347,690,420,267,928,315,582,896,320,542,454,165,289,879,383,467,903,438,452
2204700015B,149,63,86,154,59,95,148,59,89,157,88,69,213,75,131,201,70,122,105,33,72,160,57,98,170,67,103
22019000305,527,523,4,407,372,35,398,361,37,450,438,9,653,631,12,608,476,106,242,233,9,719,625,46,822,780,28
22019000333,1058,391,667,926,153,773,933,134,799,937,305,629,1404,232,1102,1391,168,1207,653,124,529,704,181,501,697,203,474
22019000327,223,127,96,188,65,123,189,59,130,194,94,97,334,93,208,330,111,203,93,42,51,217,52,143,231,81,142
22047000012,47,37,10,49,17,32,49,16,33,49,31,18,107,52,47,99,40,56,22,11,11,75,28,45,77,34,39
220150002-9,414,253,161,267,83,184,253,93,160,284,143,141,669,356,293,634,330,284,240,93,147,681,366,301,725,415,305
220150004-2,887,133,754,723,60,663,725,66,659,734,106,626,1150,111,1019,1114,130,964,589,70,519,1353,114,1221,1383,140,1229
220150002-4,806,190,616,653,86,567,641,80,561,669,142,526,1124,182,894,1087,214,854,636,120,516,932,188,715,952,223,714
2201900320W,390,347,43,326,255,71,316,237,79,332,290,36,456,360,84,443,289,142,167,137,30,366,280,74,423,362,59
22057005-1B,282,199,83,189,81,108,193,77,116,212,127,85,395,231,155,357,161,181,123,57,66,413,197,187,462,272,177
22051000094,614,260,354,563,97,466,576,58,518,575,238,337,752,172,533,749,104,639,419,78,341,832,156,664,841,242,583
22051000080,337,156,181,297,62,235,306,57,249,310,130,175,494,99,363,471,82,370,197,38,159,536,139,374,561,168,383
22001006-13,234,34,200,237,19,218,237,17,220,237,38,195,339,30,301,341,35,302,163,22,141,302,19,281,303,21,276
220010004-5,490,76,414,493,20,473,486,25,461,498,79,416,686,46,629,671,54,609,305,42,263,787,28,743,792,33,753
220010004-1,388,74,314,318,23,295,329,26,303,332,49,282,557,52,498,529,68,460,277,39,238,626,49,561,640,45,592
22101000036,338,67,271,327,24,303,330,25,305,332,57,275,488,39,440,472,39,424,229,26,203,477,40,416,481,46,428
220250001-2,105,53,52,103,42,61,107,43,64,110,47,63,153,74,76,146,70,69,73,32,41,126,48,75,126,49,77
22001006-10,202,36,166,176,8,168,175,11,164,180,29,151,245,25,217,238,17,218,120,25,95,260,29,226,270,28,241
220010005-3,382,51,331,380,19,361,380,28,352,385,56,328,549,30,503,530,40,485,247,34,213,609,26,574,615,27,583
221170008-1,663,483,180,596,314,282,592,312,280,683,484,192,913,520,380,826,437,365,292,168,124,934,462,422,1002,574,422
22117003-3A,39,8,31,37,0,37,37,0,37,40,6,34,39,6,29,38,7,31,28,3,25,221,167,43,255,208,45
22117004-2A,299,296,3,222,190,32,212,178,34,230,220,7,330,318,6,277,239,16,89,84,5,378,279,70,431,362,59
221170004-7,237,115,122,250,66,184,252,67,185,252,115,132,384,106,263,375,106,261,130,24,106,378,75,283,404,115,280
220010003-4,647,429,218,444,214,230,446,229,217,491,314,175,809,494,292,766,364,375,368,236,132,810,414,357,886,533,343
22105000027,182,120,62,161,61,100,164,57,107,178,117,59,267,110,152,250,104,133,91,40,51,271,85,167,280,117,160
22105000141,377,223,154,282,80,202,285,70,215,294,155,138,581,213,350,568,185,373,159,51,108,557,182,349,561,211,334
220590006-2,180,50,130,176,21,155,177,30,147,177,42,134,214,28,184,206,32,164,92,19,73,207,33,168,215,43,172
220910003-1,693,559,134,589,353,236,597,347,250,648,515,129,788,536,237,742,474,245,376,254,122,792,445,310,896,603,275
22027000096,29,20,9,27,15,12,28,18,10,27,19,8,56,27,24,54,28,26,24,6,18,38,25,9,38,29,9
22033001-95,828,819,9,603,538,65,624,449,175,696,685,10,1061,1035,16,966,890,56,641,622,19,1108,1003,62,1188,1127,38
22033003-61,721,180,541,703,73,630,717,65,652,718,175,539,1218,144,1028,1177,156,1001,605,73,532,1229,104,1092,1229,127,1075
220210003-2,271,58,213,255,22,233,261,26,235,259,40,216,380,53,319,354,72,272,149,27,122,337,41,276,351,51,298
22073000055,952,160,792,798,73,725,803,78,725,815,109,705,1329,132,1162,1288,184,1084,441,66,375,1494,144,1314,1519,172,1326
22033003-18,836,587,249,794,403,391,791,359,432,823,545,274,1181,560,564,1151,506,628,654,310,344,1156,611,518,1203,709,473
220790000C8,205,205,0,147,124,23,142,135,7,159,155,0,238,231,1,211,193,12,80,79,1,247,215,21,283,274,5
2210500106A,266,138,128,252,51,201,262,57,205,266,115,145,369,100,262,349,98,229,145,34,111,433,96,309,441,112,325
22105000043,231,219,12,147,107,40,158,115,43,186,162,24,339,281,48,309,230,58,104,95,9,320,234,61,331,277,52
221150001-6,194,124,70,165,91,74,161,84,77,173,114,55,337,153,165,297,132,157,124,62,62,344,153,170,361,174,184
2204100004B,134,43,91,116,18,98,117,22,95,122,22,100,156,35,114,157,32,121,86,12,74,513,276,204,546,345,193
22035000007,251,251,0,199,157,42,212,174,38,228,211,15,272,261,5,256,221,24,97,95,2,254,200,39,307,281,17
22035000009,256,238,18,275,217,58,269,239,30,294,258,36,287,266,17,275,219,46,125,106,19,247,197,30,264,238,15
22035000010,170,170,0,139,123,16,140,119,21,167,161,6,187,184,2,167,150,12,70,68,2,184,159,17,188,184,4
220430003-3,107,86,21,90,58,32,87,55,32,97,77,19,134,103,30,110,75,30,68,53,15,99,60,36,118,83,34
22063000023,675,122,553,658,37,621,660,40,620,655,122,529,886,53,797,836,69,747,345,23,322,1016,74,916,1034,90,922
220790000N8,443,237,206,403,151,252,402,125,277,417,195,217,533,193,309,502,178,306,243,92,151,607,186,390,635,242,367
2211300021A,206,24,182,214,6,208,212,6,206,214,19,195,233,13,216,234,16,204,116,14,102,233,9,220,236,11,221
22073000033,930,225,705,822,100,722,823,91,732,835,156,678,1376,186,1126,1324,197,1106,478,56,422,1226,126,1076,1227,148,1055
2211300019B,21,5,16,23,0,23,26,1,25,26,5,21,19,1,13,19,0,18,15,5,10,22,0,22,22,4,18
22083000025,194,29,165,230,9,221,235,13,222,242,15,227,277,28,245,267,38,228,126,15,111,267,8,254,278,19,259
220810007-3,242,159,83,206,109,97,202,106,96,227,149,77,275,143,128,243,142,99,147,83,64,236,125,104,237,135,100
220590008-3,149,28,121,151,12,139,154,10,144,159,15,144,162,3,155,159,9,148,78,1,77,204,9,192,209,12,196
22123000004,121,61,60,72,19,53,75,21,54,88,35,53,89,42,47,78,37,37,62,31,31,114,39,69,126,52,72
22123000009,219,31,188,196,5,191,193,12,181,200,19,181,246,9,232,232,25,204,115,12,103,287,11,273,297,10,285
221170004-5,188,84,104,199,50,149,197,46,151,201,82,119,258,58,192,244,56,180,113,24,89,238,49,177,240,64,176
2211300019A,703,96,607,710,68,642,714,68,646,732,117,611,899,87,779,870,84,744,433,52,381,983,61,887,1003,81,910
22033001-37,742,645,97,579,429,150,578,386,192,600,502,97,952,699,192,916,635,247,494,392,102,961,668,255,990,750,222
22073000045,1128,203,925,947,91,856,964,103,861,983,141,841,1486,101,1332,1412,152,1227,511,40,471,1547,153,1363,1573,191,1354
22105000129,227,205,22,161,117,44,168,122,46,191,162,29,330,272,50,285,217,56,105,90,15,313,227,66,348,279,63
2210500129A,510,406,104,371,210,161,386,233,153,409,304,102,727,474,242,675,401,244,208,119,89,648,366,249,672,422,244
2206300007A,191,36,155,182,15,167,180,17,163,182,36,146,294,19,261,295,25,262,104,9,95,374,34,335,376,38,336
2211900025A,37,37,0,31,31,0,29,29,0,34,32,2,44,44,0,45,42,2,17,17,0,54,49,2,60,55,5
2204100004A,28,2,26,37,3,34,37,3,34,38,0,38,46,4,42,43,6,37,18,0,18,46,2,44,45,2,43
22113000016,117,9,108,117,9,108,119,4,115,122,8,113,138,8,129,136,1,134,103,3,100,141,8,131,144,6,138
22033003-71,649,175,474,597,71,526,607,63,544,614,169,444,742,119,583,728,105,620,494,71,423,593,64,524,581,98,463
22033003-16,785,213,572,719,85,634,730,76,654,737,203,532,896,144,703,890,130,754,597,85,512,775,123,649,763,141,610
22033003-27,769,491,278,678,362,316,675,353,322,701,435,256,1076,612,416,1037,595,415,524,293,231,1203,670,482,1241,756,465
22033003-67,676,227,449,662,120,542,688,103,585,690,212,478,833,165,634,811,140,659,508,98,410,712,90,616,712,120,578
22015002-5A,84,62,22,54,29,25,51,27,24,60,37,22,183,103,73,171,93,75,55,27,28,156,79,66,163,97,60
22033003-31,686,324,362,605,166,439,607,140,467,624,260,360,838,218,541,819,199,601,539,150,389,873,208,639,866,241,591
22033003-52,710,424,286,624,262,362,633,234,399,647,382,263,928,392,463,895,352,499,474,194,280,975,400,543,988,458,501
2210500149A,185,62,123,156,14,142,155,16,139,155,55,99,227,18,205,228,22,201,93,8,85,305,31,262,314,46,260
22073000047,217,58,159,254,59,195,247,55,192,254,86,168,492,136,352,467,147,316,185,54,131,365,91,265,382,106,274
2201502-17B,307,214,93,198,102,96,192,103,89,209,135,71,458,269,178,436,233,180,153,91,62,536,301,223,573,340,223
220690004-2,295,294,1,177,159,18,207,201,6,241,233,8,286,284,0,250,228,9,119,119,0,304,242,15,348,335,5
22069001-3A,36,17,19,49,22,27,49,16,33,50,28,22,79,28,41,81,31,47,48,24,24,37,14,22,41,16,23
2206901-10B,254,53,201,276,29,247,282,25,257,278,58,214,324,57,261,315,52,259,167,35,132,334,42,281,333,50,275
220690003-2,144,27,117,139,18,121,131,16,115,133,28,105,210,30,178,202,33,167,128,18,110,214,25,185,216,26,188
22069001-4A,24,22,2,8,8,0,8,8,0,8,8,0,137,85,37,129,85,38,4,3,1,44,29,12,47,34,13
22073000043,999,172,827,901,52,849,899,43,856,927,116,810,1270,95,1129,1246,112,1117,571,53,518,1278,90,1169,1281,116,1143
22073000042,477,100,377,766,73,693,768,76,692,786,116,669,1224,153,1042,1173,160,992,479,47,432,1073,125,911,1091,166,903
22017000080,393,388,5,245,213,32,249,233,16,290,287,1,551,534,14,503,461,34,247,245,2,443,396,26,494,467,18
22017000007,314,251,63,223,133,90,215,139,76,228,172,54,567,387,137,534,363,154,190,143,47,446,293,127,464,328,124
22017000110,785,196,589,607,80,527,619,65,554,615,125,485,921,133,744,899,128,764,457,69,388,1085,139,927,1082,166,894
22109000084,293,90,203,228,34,194,230,31,199,234,81,153,346,54,278,339,45,290,174,11,163,299,41,245,296,48,243
2206300008A,500,113,387,467,37,430,466,39,427,461,93,364,795,55,715,771,82,671,279,13,266,805,50,729,826,70,743
22063000006,641,130,511,637,47,590,642,57,585,646,154,490,1069,58,979,1028,109,901,370,18,352,1181,60,1083,1213,81,1119
22109000013,184,48,136,182,23,159,182,16,166,182,55,124,308,50,245,298,51,238,103,12,91,323,49,263,332,59,270
22109000009,233,76,157,207,43,164,202,33,169,206,78,127,341,70,261,323,65,247,121,24,97,357,65,276,373,73,295
22113000011,319,77,242,310,24,286,304,24,280,315,59,252,479,50,419,465,47,404,204,39,165,524,76,428,538,83,448
22079000S19,155,37,118,133,23,110,134,24,110,137,33,104,210,30,175,199,31,166,99,10,89,236,37,190,236,41,191
22109000043,533,172,361,528,74,454,530,77,453,540,179,355,805,104,671,760,101,632,311,43,268,814,101,685,833,128,694
2206300013A,321,67,254,270,14,256,268,19,249,273,37,234,505,35,453,483,63,415,135,10,125,535,46,475,561,47,506
22041000013,349,46,303,310,21,289,324,25,299,325,38,287,353,27,323,335,40,292,149,19,130,401,31,363,415,38,375
221170004-9,188,36,152,178,8,170,180,7,173,185,40,145,243,7,230,231,24,205,95,8,87,222,14,198,228,24,204
22039001171,120,32,88,110,10,100,110,14,96,116,33,83,155,21,133,146,20,122,60,8,52,127,15,109,137,20,117
22009006-2A,188,26,162,176,12,164,182,11,171,191,15,175,198,11,184,176,11,160,90,7,83,242,16,220,248,13,232
22085003-6A,24,3,21,26,4,22,26,4,22,24,3,21,27,4,23,23,4,19,21,2,19,25,6,19,25,6,19
22019000561,269,61,208,277,27,250,274,31,243,276,66,209,432,42,375,386,45,331,112,19,93,764,66,672,797,72,721
22103000108,326,94,232,302,24,278,298,22,276,305,69,233,426,58,345,420,48,366,170,23,147,414,44,361,409,42,359
22103000104,512,159,353,453,57,396,466,58,408,463,123,334,711,97,579,709,94,592,303,39,264,725,119,589,735,163,567
22055000078,836,283,553,774,163,611,774,120,654,795,237,551,1071,219,771,1052,161,879,563,119,444,1124,226,879,1146,275,850
22055000054,390,381,9,262,230,32,243,229,14,285,268,16,446,424,10,389,289,81,134,127,7,507,432,29,581,558,13
22103000921,432,172,260,417,84,333,417,71,346,422,139,283,705,132,561,681,112,558,375,73,302,700,191,486,714,222,489
22019000312,808,775,33,662,561,101,648,543,105,702,649,48,1072,951,92,1000,752,218,355,314,41,790,643,98,872,789,63
22055000004,931,551,380,739,337,402,737,325,412,773,425,341,1504,626,830,1459,514,895,613,227,386,1300,585,654,1374,680,667
22055000090,348,129,219,340,88,252,332,68,264,338,117,214,534,142,363,524,101,412,275,80,195,525,135,359,525,151,356
22055000105,944,180,764,838,87,751,839,60,779,819,146,666,1332,149,1129,1292,112,1151,580,69,511,1464,182,1254,1462,207,1235
22055000061,204,195,9,143,123,20,140,121,19,156,142,13,273,237,27,255,183,60,91,80,11,272,223,31,294,254,32
22055000018,621,610,11,441,393,48,408,359,49,496,476,20,824,783,26,757,582,150,274,260,14,732,626,44,811,778,21
22055000001,968,322,646,829,193,636,818,178,640,822,254,568,1351,345,954,1311,313,962,556,131,425,1442,319,1079,1475,367,1091
22103000916,149,87,62,139,48,91,137,46,91,144,68,69,280,80,184,271,72,195,118,36,82,288,94,185,289,87,198
22031000006,178,172,6,166,133,33,167,155,12,179,167,12,243,220,20,229,200,26,130,127,3,211,162,14,232,205,14
22049000018,206,55,151,187,45,142,191,40,151,196,60,136,330,66,251,319,84,228,114,24,90,314,49,259,317,57,256
22103000S05,845,332,513,700,160,540,705,129,576,708,283,419,1099,190,857,1072,183,865,586,103,483,1278,272,968,1306,328,954
22103000705,244,99,145,210,62,148,209,56,153,213,88,125,454,104,336,446,101,330,162,45,117,509,139,351,525,152,363
220570003-1,544,171,373,481,71,410,487,78,409,494,194,296,697,126,545,678,133,513,280,47,233,813,135,639,828,152,644
220890005-1,690,625,65,549,433,116,553,412,141,631,555,69,988,798,169,890,687,177,372,306,66,803,626,154,866,705,152
22051000032,544,250,294,501,96,405,513,73,440,512,240,271,737,156,535,704,130,560,414,73,341,687,131,541,687,153,518
22031000030,483,110,373,368,65,303,371,61,310,377,79,296,792,104,673,782,117,661,390,71,319,495,74,415,501,81,418
220570010-5,220,44,176,217,23,194,217,15,202,223,55,165,334,30,293,312,50,253,104,10,94,322,29,283,333,21,305
22019000326,635,285,350,564,133,431,573,127,446,572,244,328,842,191,598,818,156,640,399,115,284,500,104,372,502,128,359
22031000023,1057,231,826,818,114,704,807,123,684,842,173,665,1413,163,1206,1375,205,1147,579,76,503,961,102,845,987,133,832
22051000152,375,290,85,282,153,129,290,132,158,319,235,81,567,327,224,509,271,209,201,124,77,552,286,237,613,355,250
220510008-K,747,435,312,622,221,401,628,202,426,641,355,282,1100,438,623,1049,386,636,514,163,351,1120,432,648,1205,549,643
22019000369,811,333,478,810,189,621,807,159,648,794,302,488,1131,244,836,1106,213,868,387,117,270,953,225,682,974,272,668
2201900319S,142,96,46,127,54,73,120,56,64,124,75,48,263,126,127,259,100,154,63,19,44,197,81,104,214,105,106
22101000005,390,275,115,294,148,146,287,130,157,316,181,135,506,290,204,472,215,211,201,86,115,507,269,214,575,354,216
2205100194A,453,219,234,395,116,279,414,105,309,430,211,213,702,210,473,671,195,467,265,80,185,749,227,503,763,242,515
22051000200,440,437,3,301,284,17,303,268,35,355,349,1,680,668,2,608,569,27,245,243,2,657,601,23,716,690,19
220510007-W,591,268,323,525,100,425,532,91,441,526,217,304,841,199,625,793,188,521,348,89,259,981,256,660,1039,290,739
2205100216C,482,457,25,365,315,50,370,293,77,393,367,17,693,610,70,647,534,102,297,267,30,647,553,71,709,631,70
2201100016B,245,65,180,225,21,204,229,29,200,236,44,192,287,32,243,287,38,242,147,22,125,300,31,258,302,34,264
22051000231,573,380,193,448,223,225,451,195,256,463,300,158,903,444,416,859,409,431,333,157,176,846,407,396,902,493,403
22051000030,620,271,349,562,110,452,568,82,486,567,247,316,809,188,586,795,171,609,460,117,343,937,226,699,934,244,671
22051000198,540,246,294,566,151,415,589,134,455,587,259,318,1013,259,730,981,236,716,313,105,208,985,196,756,1008,244,753
22051000076,667,381,286,513,140,373,514,136,378,527,281,242,913,356,511,859,308,528,368,116,252,917,321,548,952,405,532
220510002-H,439,146,293,372,36,336,380,40,340,381,105,272,566,90,448,543,78,447,284,37,247,722,93,609,739,130,591
22051000011,449,239,210,394,119,275,393,94,299,402,200,198,702,251,413,680,212,444,235,70,165,704,209,453,749,267,465
220070004-1,212,150,62,183,94,89,186,95,91,200,129,71,257,144,103,228,117,106,98,52,46,213,109,93,250,147,103
2205100179A,548,355,193,484,223,261,485,202,283,522,344,173,1029,486,500,971,406,511,310,157,153,994,454,503,1033,485,542
220510028-K,247,124,123,186,34,152,192,21,171,193,87,106,382,102,263,360,90,262,169,50,119,384,100,265,396,118,272
22051007-KA,568,274,294,448,106,342,455,91,364,473,208,265,655,264,364,596,206,373,291,98,193,835,259,554,884,336,536
220570004-4,512,148,364,505,59,446,509,39,470,510,159,341,846,102,725,814,130,662,513,83,430,797,76,697,812,80,726
22051000099,292,162,130,222,69,153,225,54,171,232,113,118,361,119,207,355,126,223,152,53,99,472,189,271,474,195,263
2205100185A,328,136,192,310,44,266,314,31,283,324,137,182,500,108,378,473,98,356,209,33,176,546,110,422,572,147,421
22049000013,276,154,122,245,107,138,247,102,145,256,127,122,412,223,186,410,219,186,147,84,63,319,133,176,349,183,162
220510024-K,198,182,16,129,110,19,130,108,22,146,135,9,323,293,26,294,248,36,74,67,7,378,306,45,412,353,53
22051000077,564,241,323,500,100,400,508,77,431,523,223,297,874,185,645,843,158,668,397,73,324,792,149,613,820,199,604
220510012-K,783,314,469,673,99,574,682,82,600,693,258,430,938,199,703,908,167,727,587,79,508,966,204,730,984,252,718
22051000176,166,90,76,175,40,135,176,30,146,176,87,88,274,71,183,263,78,179,107,33,74,312,91,212,328,101,223
22051000066,656,295,361,588,132,456,588,89,499,606,274,327,854,182,636,827,161,660,418,96,322,903,189,684,903,218,662
22051000118,562,226,336,494,92,402,503,72,431,499,200,284,669,142,497,651,117,521,362,83,279,752,143,587,737,153,564
22051000229,437,205,232,388,95,293,389,67,322,392,169,223,634,150,450,624,122,492,320,65,255,717,208,491,722,233,478
221270007-7,139,19,120,172,7,165,166,13,153,175,18,154,218,11,207,213,19,194,95,9,86,254,8,237,258,14,244
22051000095,576,269,307,482,97,385,495,76,419,500,238,262,698,151,499,680,136,532,364,77,287,802,195,590,820,244,551
22109000061,174,59,115,167,31,136,170,24,146,176,71,103,256,35,214,241,35,198,105,7,98,311,21,282,315,15,297
22109000032,218,72,146,206,25,181,202,30,172,207,72,130,249,44,198,237,32,201,143,29,114,287,42,237,298,45,249
220450006-5,681,275,406,605,168,437,597,182,415,627,244,383,857,325,514,785,199,509,403,108,295,792,260,510,839,326,506
22109000048,335,248,87,253,145,108,260,140,120,285,184,96,468,320,139,411,248,145,142,84,58,422,249,131,492,339,136
220710006-6,544,534,10,383,339,44,390,339,51,409,400,9,655,606,18,612,549,50,286,277,9,656,587,39,728,688,31
22071007-20,506,503,3,368,347,21,366,336,30,401,395,3,673,648,5,603,538,31,240,237,3,696,631,27,759,726,13
22071013-10,331,242,89,249,155,94,251,111,140,259,183,73,434,264,134,419,215,200,218,127,91,436,265,167,423,276,137
22071003-18,492,469,23,358,311,47,354,273,81,389,365,21,702,604,58,658,562,69,298,277,21,675,573,60,735,663,50
220710007-5,345,338,7,223,199,24,231,192,39,235,231,4,491,471,8,442,403,23,161,157,4,429,390,19,479,451,18
220710001-1,373,336,37,234,197,37,243,184,59,256,234,21,565,434,89,536,384,128,205,178,27,477,364,95,507,411,85
22071017-18,373,207,166,289,84,205,303,53,250,306,152,153,438,136,275,441,108,329,284,111,173,560,177,368,550,218,317
220030001-6,148,63,85,178,40,138,174,42,132,179,76,101,292,64,209,271,63,191,96,15,81,218,42,167,232,52,175
22033003-50,750,441,309,639,261,378,646,210,436,628,349,278,1333,458,756,1318,413,863,780,303,477,1166,483,640,1172,568,577
22033002-13,546,432,114,458,289,169,477,283,194,505,389,115,822,587,204,791,527,248,463,332,131,813,557,237,843,605,215
22121000008,779,635,144,657,469,188,645,444,201,708,575,131,894,697,165,835,611,206,548,397,151,876,581,257,934,681,232
22115001-6B,50,33,17,41,24,17,41,24,17,41,24,15,54,27,20,47,23,21,9,3,6,83,58,25,82,54,24
2207115-14A,261,240,21,227,189,38,236,176,60,236,216,20,308,260,33,305,260,39,151,129,22,270,220,40,298,259,35
22071007-27,257,254,3,170,162,8,192,183,9,198,196,1,358,341,10,332,292,19,135,134,1,403,371,21,431,423,8
22071009-11,258,248,10,191,181,10,190,166,24,193,186,6,307,265,28,284,246,34,180,176,4,328,297,21,314,274,21
2207109-31B,232,232,0,154,141,13,151,134,17,162,155,1,269,254,5,257,238,9,120,120,0,267,245,7,281,274,6
220710009-5,373,366,7,250,229,21,257,206,51,284,277,7,480,460,11,457,421,25,171,167,4,527,477,21,597,574,18
220710017-8,338,327,11,226,203,23,232,190,42,243,236,6,464,432,19,429,372,37,169,163,6,529,460,44,561,526,29
22033001-84,702,692,10,530,465,65,540,423,117,579,564,14,924,884,26,879,788,69,473,461,12,876,786,47,930,879,40
22033002-22,662,657,5,505,463,42,515,375,140,561,557,2,896,866,12,834,761,48,486,473,13,912,843,50,961,937,14
22033002-33,589,112,477,602,27,575,611,21,590,608,120,485,1011,56,927,1002,88,897,619,44,575,1056,47,988,1042,63,969
22071009-21,508,498,10,337,308,29,360,320,40,391,381,9,669,637,20,620,560,45,244,240,4,743,681,29,808,772,27
2207115-13B,413,405,8,260,235,25,267,227,40,287,274,9,682,659,12,596,527,45,201,190,11,690,623,32,812,787,16
22071009-40,244,241,3,207,190,17,206,174,32,216,214,2,381,358,12,357,322,28,155,144,11,362,330,15,384,365,11
22071012-10,312,253,59,216,126,90,219,94,125,227,172,54,372,239,106,373,198,167,207,130,77,379,244,128,380,271,103
22033003-20,642,571,71,448,364,84,449,350,99,469,426,43,797,478,272,766,440,306,415,287,128,943,693,217,992,784,191
22033001-21,342,339,3,240,192,48,233,174,59,261,259,1,420,404,9,393,345,35,218,206,12,431,393,27,456,429,20
22097000043,505,114,391,443,58,385,447,73,374,454,93,360,691,113,557,662,97,545,239,36,203,786,118,646,795,128,659
22033003-34,927,460,467,819,247,572,822,226,596,830,362,463,1067,360,648,1051,329,690,559,166,393,1292,423,828,1290,480,782
22071007-14,307,306,1,218,204,14,225,194,31,234,228,3,431,406,10,390,364,16,153,150,3,454,409,22,479,454,13
22071007-18,565,537,28,438,379,59,433,331,102,448,425,20,647,563,56,609,510,81,357,333,24,681,564,83,713,615,85
220710015-2,487,422,65,393,328,65,396,287,109,400,354,41,584,429,104,571,390,163,388,310,78,608,426,157,608,439,147
22071008-23,373,348,25,310,243,67,315,230,85,325,301,23,452,376,54,440,356,82,286,244,42,374,295,71,366,297,66
220710013-2,380,351,29,267,213,54,278,188,90,285,254,31,476,390,60,450,351,90,261,232,29,470,356,96,481,393,79
220710016-5,416,376,40,301,242,59,307,208,99,308,276,32,478,373,70,477,350,124,321,275,46,502,369,122,466,360,88
22109000011,696,170,526,667,91,576,670,89,581,678,165,504,1003,158,810,963,172,745,346,44,302,1145,152,962,1170,170,984
22039001101,207,108,99,185,60,125,186,62,124,197,102,93,247,99,144,227,67,156,89,40,49,234,84,142,258,107,149
22009011-2A,147,37,110,146,17,129,150,14,136,151,37,114,184,18,166,173,25,143,93,18,75,215,27,185,220,28,189
22107000007,80,16,64,90,8,82,91,10,81,96,17,79,111,17,92,116,22,90,53,10,43,78,11,66,76,11,65
22109000087,444,160,284,393,78,315,395,72,323,400,143,249,742,127,582,718,137,557,210,38,172,751,126,597,753,148,585
2207115-19C,571,552,19,354,308,46,390,289,101,416,400,13,824,768,51,715,624,75,310,303,7,684,591,55,820,724,84
22071014-10,398,280,118,307,171,136,322,138,184,328,238,87,508,270,199,506,241,257,260,159,101,455,220,225,449,248,188
220710014-6,487,367,120,347,188,159,370,143,227,390,287,100,563,320,213,546,249,294,348,190,158,498,211,285,498,279,212
220710013-8,445,336,109,309,189,120,318,148,170,316,238,77,502,310,161,482,243,230,266,168,98,587,353,228,574,378,188
22071007-19,389,381,8,296,269,27,311,259,52,329,320,8,428,404,14,397,352,34,231,225,6,477,401,47,516,466,40
22071007-28,341,324,17,232,207,25,243,185,58,249,235,13,400,376,16,373,317,46,160,148,12,436,375,33,526,490,27
220450010-2,549,179,370,538,136,402,517,138,379,546,192,350,778,213,543,741,170,506,282,73,209,712,154,536,720,178,538
220130006-4,179,21,158,144,16,128,154,20,134,153,19,133,230,23,203,225,55,169,117,27,90,263,36,221,269,34,232
22039001080,175,138,37,127,81,46,119,81,38,151,111,38,221,146,68,205,113,78,71,49,22,155,101,43,175,131,38
22009002-5E,1,0,1,0,0,0,0,0,0,0,0,0,0,0,0,0,0,0,0,0,0,0,0,0,0,0,0
22017000063,335,241,94,261,149,112,260,153,107,267,182,83,464,297,153,442,281,156,213,143,70,475,305,157,488,325,156
220610004-6,128,32,96,125,12,113,126,9,117,127,26,99,159,20,131,155,23,128,67,8,59,152,9,143,150,16,130
220710013-7,289,241,48,234,150,84,238,125,113,238,183,55,373,268,81,372,230,137,207,171,36,365,250,110,337,243,90
22071013-16,387,348,39,289,238,51,297,216,81,299,268,30,461,339,76,455,326,111,245,196,49,393,300,81,377,292,72
22071013-13,271,260,11,182,160,22,168,138,30,180,175,4,346,295,30,334,287,36,169,154,15,347,288,52,347,297,40
220710009-4,262,259,3,182,169,13,187,163,24,208,203,4,342,330,5,335,314,16,150,141,9,424,385,12,451,441,6
22071009-31,257,253,4,197,172,25,209,166,43,218,213,4,306,296,3,280,260,18,146,141,5,256,223,12,311,299,6
22071015-13,317,306,11,217,188,29,215,172,43,227,217,9,491,461,27,459,404,48,149,135,14,495,425,37,555,516,32
2207109-41B,515,405,110,363,274,89,373,260,113,407,340,63,752,510,221,694,407,273,293,200,93,840,527,249,961,642,305
22071011-12,281,278,3,179,153,26,189,165,24,204,198,3,367,354,3,333,302,24,133,129,4,392,355,25,468,454,13
22071003-15,261,242,19,210,188,22,213,167,46,224,214,9,332,296,22,319,276,32,167,155,12,372,312,46,392,355,35
22071009-13,290,268,22,224,193,31,231,179,52,238,216,22,364,310,37,353,297,47,207,191,16,381,333,41,374,327,43
22065000011,59,28,31,62,25,37,64,21,43,72,32,40,98,24,74,91,25,64,37,8,29,59,18,33,68,28,40
2201504-11B,906,264,642,708,139,569,709,121,588,710,201,504,1210,204,955,1172,219,934,583,113,470,1228,249,941,1249,297,922
22033002-32,882,457,425,767,262,505,758,238,520,785,401,384,1049,527,478,1016,467,527,648,346,302,1122,412,675,1148,470,657
22069001-14,191,185,6,147,113,34,148,128,20,167,155,9,301,266,29,260,210,39,79,69,10,263,199,43,284,245,31
22017000115,998,220,778,835,82,753,834,70,764,845,165,675,1290,174,1062,1272,172,1087,763,99,664,1310,173,1128,1305,201,1084
22017000114,411,367,44,315,228,87,307,232,75,322,285,36,523,437,81,491,412,73,231,198,33,499,407,79,497,420,75
22073000061,415,144,271,357,70,287,362,65,297,376,98,278,608,117,456,588,114,462,233,68,165,656,112,518,659,155,483
22073000015,524,522,2,300,264,36,291,265,26,328,326,0,710,702,3,539,500,29,208,207,1,558,486,52,628,600,15
22073000075,1038,283,755,825,95,730,826,72,754,836,143,692,1363,164,1154,1339,163,1165,525,65,460,1455,156,1278,1457,213,1222
220790000S7,593,70,523,520,31,489,524,38,486,533,75,455,702,37,646,667,47,595,235,29,206,803,31,753,818,31,781
220690001-9,259,80,179,241,35,206,252,28,224,252,84,165,364,52,295,357,66,289,200,43,157,322,42,269,325,68,249
22017000014,420,246,174,295,124,171,304,126,178,310,168,136,654,279,300,619,279,318,270,146,124,593,269,286,602,288,282
22017000098,225,117,108,172,66,106,176,64,112,177,86,91,326,150,151,315,149,159,156,85,71,335,145,165,339,157,166
2208300012A,17,5,12,22,5,17,22,5,17,22,4,18,25,8,16,24,5,19,13,4,9,22,0,21,27,2,23
22017000108,389,101,288,292,47,245,299,34,265,297,69,227,463,68,371,454,82,368,252,56,196,437,46,386,445,65,365
2204100013A,43,2,41,44,0,44,47,1,46,47,1,46,63,5,57,58,8,50,14,0,14,75,0,75,75,4,71
220430004-1,396,70,326,354,15,339,356,17,339,362,59,302,486,32,443,470,34,432,174,17,157,522,46,465,536,45,485
220030003-1,201,36,165,228,14,214,229,12,217,227,41,185,311,21,280,300,26,270,133,28,105,331,14,316,340,16,321
22027000037,8,8,0,8,8,0,7,7,0,7,7,0,9,9,0,8,8,0,9,7,2,10,8,2,12,10,2
220030001-4,153,147,6,132,117,15,142,120,22,152,143,9,227,207,12,203,165,31,112,104,8,164,128,25,202,178,14
22017000021,455,179,276,373,107,266,383,89,294,388,152,234,607,144,422,592,142,442,369,113,256,620,145,456,629,183,429
220450014-1,858,143,715,761,70,691,747,60,687,771,129,634,1105,95,977,1062,99,865,484,49,435,1202,95,1077,1233,131,1091
220710006-9,459,418,41,349,269,80,352,219,133,370,330,39,534,393,106,511,351,155,347,291,56,376,284,84,374,297,71
22113046B-2,91,58,33,79,34,45,77,30,47,82,47,35,129,84,43,121,69,50,42,25,17,116,60,48,131,79,51
22125000009,334,292,42,245,177,68,242,167,75,264,218,46,325,266,54,297,219,69,188,152,36,373,274,87,378,302,72
2201502-22A,1030,164,866,820,73,747,817,76,741,832,121,706,1255,101,1124,1209,143,1052,638,78,560,1370,126,1222,1399,165,1218
220150002-7,406,160,246,322,62,260,319,72,247,335,125,209,571,144,402,551,151,396,277,75,202,506,131,370,527,164,357
220430003-2,211,133,78,216,85,131,213,93,120,222,128,94,289,172,113,274,150,115,121,67,54,245,113,109,272,151,112
22055000082,732,318,414,619,183,436,625,152,473,631,253,373,989,284,635,969,219,718,478,154,324,1038,347,654,1037,366,643
22035000005,0,0,0,8,2,6,10,4,6,9,5,4,12,0,11,13,0,13,1,1,0,0,0,0,0,0,0
22103000S08,559,262,297,457,128,329,465,131,334,475,221,250,742,219,482,714,185,518,374,93,281,889,305,537,926,368,529
22039004020,170,22,148,148,13,135,151,12,139,153,18,134,174,6,164,173,18,153,71,5,66,194,9,184,190,3,185
22005000032,628,399,229,580,229,351,578,201,377,592,339,253,861,374,455,818,342,449,468,226,242,776,303,435,813,362,444
22005000012,858,280,578,782,108,674,793,104,689,792,222,561,1252,205,981,1210,232,938,448,101,347,1385,245,1103,1412,279,1098
220950004-2,495,364,131,394,228,166,402,224,178,414,283,127,714,397,301,667,353,293,300,142,158,655,408,223,685,443,230
22037000014,613,453,160,573,306,267,570,296,274,599,403,195,761,474,273,701,414,272,424,255,169,731,394,313,765,456,297
22083000004,598,169,429,632,75,557,618,98,520,668,121,547,812,146,655,769,162,597,368,54,314,823,103,711,867,128,731
220810006-1,212,209,3,139,128,11,130,124,6,148,145,3,281,264,14,257,220,27,141,138,3,254,233,17,266,238,25
2206300024B,307,78,229,325,27,298,324,25,299,325,67,254,434,39,377,428,41,380,201,12,189,522,43,468,528,70,448
220590009-5,66,4,62,74,3,71,67,3,64,72,4,67,70,0,68,74,6,67,23,1,22,88,2,86,85,0,85
22005000055,371,338,33,308,236,72,297,242,55,350,318,26,412,350,54,353,290,50,204,174,30,455,347,90,517,443,63
220950001-4,596,498,98,506,327,179,507,306,201,558,454,99,730,537,175,671,445,205,359,269,90,768,506,234,819,598,216
220950005-7,241,129,112,226,63,163,228,59,169,230,117,110,344,97,240,330,92,230,139,37,102,412,122,272,443,157,284
22063000043,137,28,109,96,13,83,97,8,89,98,19,79,181,16,155,181,18,155,66,10,56,188,13,170,192,14,175
22063000033,237,84,153,209,24,185,212,25,187,211,68,143,360,50,305,351,62,287,139,21,118,442,71,365,456,74,372
22005000076,845,293,552,756,131,625,762,116,646,760,229,530,1243,178,1021,1196,222,946,344,72,272,1463,240,1162,1475,279,1155
22005000023,287,113,174,242,50,192,241,49,192,240,97,143,280,74,198,268,77,189,124,22,102,442,127,304,457,141,312
22005000024,193,71,122,177,30,147,176,29,147,177,67,109,246,59,173,234,59,167,93,17,76,320,76,236,330,87,239
22055000026,484,232,252,410,159,251,407,144,263,423,205,216,679,236,423,635,178,436,279,112,167,820,326,455,849,374,466
220590003-1,435,50,385,329,23,306,328,35,293,342,35,306,422,21,391,408,32,368,174,10,164,487,21,459,497,20,471
220330001-8,583,393,190,451,207,244,455,169,286,451,291,154,606,283,255,609,269,323,405,227,178,641,273,353,610,282,299
2203301-101,400,393,7,378,335,43,374,255,119,396,386,9,502,480,10,466,434,18,340,331,9,497,448,37,523,492,20
22111000019,299,47,252,261,29,232,265,21,244,268,35,232,428,54,357,400,66,324,146,18,128,484,25,452,501,31,463
22073000078,323,163,160,233,78,155,237,68,169,248,110,137,385,91,267,382,94,285,157,54,103,479,163,296,486,183,289
22067000047,143,122,21,97,35,62,93,39,54,106,71,35,154,111,41,135,88,43,58,37,21,196,118,74,202,146,56
22101000003,300,264,36,243,194,49,242,180,62,265,224,40,402,347,50,367,251,83,121,88,33,403,304,55,444,365,65
22047000014,249,153,96,249,77,172,246,69,177,246,152,91,299,91,198,282,80,198,117,41,76,288,93,185,287,101,180
220850001-3,265,75,190,227,36,191,229,45,184,243,53,189,312,64,242,296,64,228,203,44,159,279,64,204,300,78,217
22085005-8A,140,20,120,175,16,159,171,14,157,175,25,150,205,20,178,199,30,166,112,5,107,177,20,157,181,22,159
22055000075,388,195,193,311,120,191,303,104,199,316,153,159,493,162,300,488,131,343,223,57,166,562,222,313,559,247,298
220850009-1,271,150,121,210,95,115,207,94,113,224,109,113,318,134,178,278,109,160,121,50,71,359,173,176,385,203,181
22103000S09,444,165,279,362,66,296,361,52,309,367,129,234,517,88,400,499,88,402,345,73,272,629,105,503,628,118,497
22055000127,649,202,447,566,100,466,568,93,475,578,149,421,973,172,745,955,144,786,388,66,322,908,226,650,920,249,651
22055000110,810,190,620,725,114,611,717,110,607,724,167,557,1040,130,869,1016,132,856,474,55,419,1196,203,962,1212,249,935
22055000083,956,314,642,814,167,647,818,131,687,826,254,566,1257,208,966,1225,154,1027,631,129,502,1259,274,919,1289,309,941
22105000104,496,166,330,437,52,385,433,52,381,434,140,290,655,88,564,634,57,354,259,35,224,644,72,482,656,82,568
220610008-3,74,58,16,71,42,29,70,44,26,74,56,17,136,84,41,127,83,40,49,37,12,124,68,37,123,79,38
220610010-5,123,121,2,85,77,8,85,79,6,95,93,2,177,170,6,157,144,10,59,57,2,166,136,13,180,175,4
220610010-1,324,321,3,232,206,26,220,200,20,247,239,7,456,423,30,419,364,41,167,157,10,450,343,51,491,457,27
221150004-3,64,21,43,72,3,69,73,3,70,74,19,55,117,12,105,116,15,101,46,8,38,109,19,85,111,20,91
22019000330,644,618,26,485,408,77,468,397,71,510,478,28,932,820,89,877,638,205,222,197,25,683,559,89,780,711,61
22105000074,625,275,350,493,114,379,507,117,390,541,248,283,864,236,590,829,207,598,328,90,238,918,234,654,942,273,652
22103000911,579,152,427,522,65,457,536,47,489,524,134,384,911,133,751,894,121,758,369,51,318,1116,136,940,1144,168,960
22079000N23,601,102,499,552,16,536,553,23,530,578,63,512,825,29,775,778,46,714,304,14,290,887,25,846,898,21,862
22103000115,630,200,430,520,63,457,530,62,468,537,167,370,732,91,619,729,88,627,304,41,263,596,42,541,604,67,525
22121000004,359,102,257,302,58,244,306,60,246,302,91,209,302,47,235,304,55,243,185,41,144,413,56,345,416,75,338
22117004-11,322,71,251,329,25,304,330,16,314,331,65,266,440,26,408,434,52,378,208,19,189,468,16,436,476,22,451
22047000024,467,270,197,447,198,249,445,183,262,470,281,187,588,272,305,532,237,282,226,110,116,555,225,309,586,263,315
22047000023,133,123,10,117,98,19,110,84,26,131,112,17,173,148,23,157,126,29,63,54,9,140,110,16,168,139,21
22067000012,244,233,11,178,143,35,181,156,25,193,176,17,319,287,20,283,236,38,144,129,15,271,210,44,292,267,18
220130005-4,90,6,84,93,1,92,100,0,100,102,6,95,126,1,125,116,20,92,54,2,52,145,4,139,143,0,143
220430005-3,176,37,139,183,12,171,185,18,167,191,31,159,254,13,232,231,16,207,79,8,71,285,19,266,295,23,270
22101000031,457,85,372,478,29,449,465,32,433,455,69,379,664,61,592,646,60,577,338,17,321,668,58,601,671,73,594
22031000004,141,133,8,108,89,19,114,101,13,120,113,7,156,145,9,141,124,16,73,69,4,189,156,14,193,177,16
2201502-22B,467,67,400,391,25,366,393,17,376,393,46,346,521,26,464,514,45,462,345,32,313,515,48,457,506,50,445
2201900319N,149,117,32,122,69,53,126,66,60,131,88,43,223,128,88,216,104,105,54,29,25,198,124,64,198,134,59
220510010-G,775,365,410,646,112,534,655,74,581,656,315,336,951,204,708,906,198,686,453,79,374,1101,258,809,1125,330,772
22051000079,389,171,218,361,65,296,374,48,326,372,155,216,504,98,374,493,86,397,245,52,193,588,115,453,595,141,437
220010007-3,700,69,631,630,23,607,630,32,598,635,58,577,962,46,902,935,50,872,409,25,384,999,40,944,995,43,943
220010005-1,207,65,142,186,23,163,180,21,159,189,46,143,293,37,245,272,42,226,149,29,120,315,38,269,325,40,281
2202300016B,269,58,211,349,18,331,352,29,323,353,68,277,363,19,334,350,35,310,170,36,134,365,17,339,367,20,346
220250004-1,133,47,86,112,29,83,113,33,80,122,38,82,142,42,97,136,51,83,54,24,30,150,34,110,153,44,108
2210500045A,435,380,55,285,179,106,289,184,105,334,266,65,635,454,164,578,388,168,190,127,63,628,404,172,699,523,168
2212300003A,131,24,107,107,9,98,105,11,94,105,12,93,122,12,110,120,25,95,64,3,61,148,19,128,147,19,127
220210004-2,227,172,55,202,123,79,193,130,63,225,166,57,362,247,101,334,213,106,134,95,39,297,176,101,351,235,105
22033003-56,874,374,500,769,227,542,775,176,599,787,325,459,773,192,528,774,166,590,554,136,418,1160,291,853,1152,351,776
22033003-58,470,244,226,504,221,283,500,196,304,501,276,225,703,127,555,697,133,554,452,94,358,574,217,343,565,221,335
22115001-7B,0,0,0,0,0,0,0,0,0,0,0,0,0,0,0,0,0,0,0,0,0,0,0,0,0,0,0
220790000N7,90,26,64,100,14,86,100,9,91,105,23,81,121,7,104,121,14,106,58,10,48,113,20,89,117,25,87
220590008-2,138,24,114,126,0,126,124,7,117,126,14,111,158,4,151,150,19,130,67,1,66,163,7,154,168,4,164
22073000062,455,309,146,325,154,171,320,152,168,341,207,134,597,307,267,571,302,252,179,91,88,551,300,227,578,359,207
2202300016A,272,76,196,345,30,315,347,29,318,352,90,260,466,36,415,462,36,422,214,30,184,372,10,343,381,24,353
2211300008B,196,24,172,202,12,190,196,9,187,203,26,177,275,17,251,257,20,233,119,10,109,306,15,283,309,24,284
2211300025A,165,26,139,163,14,149,158,18,140,166,24,142,226,20,199,220,24,194,119,10,109,204,11,188,212,18,189
2203902010A,66,11,55,54,3,51,51,4,47,55,9,46,68,5,63,60,4,54,24,5,19,81,3,78,84,3,81
2202300005N,267,64,203,347,35,312,345,44,301,356,90,264,462,37,406,452,32,410,145,13,132,389,19,359,407,27,379
22123000007,133,17,116,128,10,118,128,10,118,132,17,115,173,11,155,160,15,143,106,3,103,183,15,165,194,17,175
22039005020,199,56,143,195,33,162,202,51,151,208,74,130,240,35,202,212,31,178,70,14,56,247,36,201,263,41,221
22009004-2A,257,60,197,253,22,231,260,17,243,261,53,207,301,13,276,283,28,246,132,18,114,303,13,272,305,16,281
2206300040A,680,189,491,674,75,599,673,79,594,671,187,475,1076,116,916,1047,127,898,361,36,325,1132,149,956,1143,171,950
22027000041,183,58,125,121,27,94,128,33,95,130,42,88,192,42,150,189,46,141,99,17,82,203,19,183,209,24,181
22117004-10,225,59,166,252,22,230,250,28,222,258,66,189,307,29,275,299,28,270,163,17,146,298,25,263,299,22,277
22105000147,469,132,337,414,44,370,412,46,366,414,105,303,762,94,641,732,108,591,252,36,216,755,85,643,781,101,665
220610011-2,115,37,78,99,12,87,101,18,83,99,28,70,151,25,119,151,31,117,77,6,71,129,23,106,131,23,102
22119000013,121,30,91,103,8,95,97,8,89,108,20,88,174,21,150,174,32,142,82,20,62,174,23,145,181,25,154
22041000002,253,26,227,225,8,217,236,16,220,247,12,235,310,12,294,300,25,275,138,10,128,360,8,344,366,13,349
220430007-4,115,31,84,105,8,97,105,11,94,109,16,90,98,7,90,93,7,84,33,4,29,162,8,148,166,6,158
2211300005A,252,31,221,240,13,227,234,14,220,239,29,209,351,18,323,343,24,315,157,14,143,404,17,368,416,24,387
22033001-28,599,584,15,424,361,63,427,349,78,461,445,16,722,681,26,679,595,61,385,369,16,764,654,77,846,802,36
22033003-63,588,363,225,510,230,280,513,197,316,519,333,176,501,299,170,488,276,198,258,179,79,754,293,441,759,355,384
220150001-5,343,114,229,256,49,207,254,53,201,258,80,175,476,116,328,472,125,332,201,48,153,577,124,435,591,149,431
2203301-102,448,399,49,276,207,69,287,205,82,297,253,43,610,346,192,583,323,222,157,117,40,782,539,199,804,612,171
220610003-2,426,92,334,411,57,354,415,55,360,423,92,329,583,84,484,566,103,455,273,51,222,655,87,534,667,114,540
220690003-6,310,39,271,300,18,282,295,30,265,300,41,258,417,21,388,392,48,337,182,18,164,437,16,420,441,18,418
220690001-7,451,210,241,415,132,283,417,117,300,423,187,234,576,182,374,572,180,388,310,92,218,526,149,361,530,186,338
220690002-9,497,72,425,429,31,398,428,23,405,446,55,388,648,77,565,614,123,485,255,24,231,655,58,589,663,58,604
22073000054,988,204,784,852,86,766,843,82,761,871,119,751,1328,158,1125,1278,192,1060,448,58,390,1488,126,1342,1510,159,1337
22073000007,1087,400,687,973,206,767,976,212,764,979,301,675,1324,265,1017,1261,283,963,600,132,468,1353,307,1027,1347,325,1000
22073000009,868,527,341,680,292,388,676,285,391,723,363,357,1198,586,580,1132,555,558,458,233,225,1145,580,518,1220,680,522
22027000087,144,140,4,113,83,30,128,83,45,143,121,20,254,228,26,233,170,54,115,104,11,209,160,45,248,201,38
220910006-1,560,213,347,532,74,458,544,73,471,566,230,332,732,133,587,700,127,434,344,77,267,768,80,617,770,90,670
2206300008B,124,23,101,108,6,102,109,8,101,111,25,84,197,14,178,188,20,164,59,4,55,193,22,162,194,20,171
22115002-3A,107,7,100,88,5,83,87,8,79,85,4,76,172,7,161,165,15,147,42,0,42,125,3,117,134,5,127
22109000085,585,99,486,528,28,500,534,27,507,533,102,430,754,48,692,742,43,689,434,31,403,556,34,518,547,51,489
220030005-9,373,189,184,385,127,258,389,138,251,406,203,197,552,191,335,530,173,339,186,73,113,603,164,414,625,192,423
220430006-4,106,19,87,96,9,87,96,8,88,97,13,84,127,14,111,123,14,107,59,6,53,155,13,136,162,19,142
220130002-1,195,194,1,152,131,21,175,155,20,207,195,6,327,320,5,278,252,18,122,121,1,254,217,29,281,254,20
22085002-4A,80,12,68,63,0,63,60,0,60,67,0,66,84,10,73,80,13,63,48,4,44,106,12,88,112,19,93
22019000367,475,163,312,407,56,351,409,51,358,410,111,299,758,112,617,742,105,621,241,38,203,598,99,473,599,122,463
22019000161,366,68,298,380,20,360,388,16,372,391,58,328,457,42,395,445,41,398,202,28,174,720,45,638,729,39,672
22103000A04,277,105,172,289,54,235,289,42,247,290,109,178,431,70,327,416,60,345,165,27,138,434,94,318,443,107,327
22055000013,630,327,303,555,247,308,542,232,310,568,294,269,872,398,444,855,335,509,439,184,255,730,305,393,776,356,410
22055000012,784,344,440,720,236,484,711,212,499,725,290,433,1046,330,679,1032,308,701,550,185,365,929,256,643,955,290,641
22103000101,696,224,472,583,69,514,584,64,520,596,176,413,846,114,694,835,120,690,298,40,258,1062,112,925,1073,154,910
22055000119,455,84,371,399,39,360,397,29,368,402,68,329,604,67,526,595,48,538,270,33,237,721,69,638,724,79,637
22055000080,535,125,410,456,46,410,466,22,444,470,100,369,665,73,549,662,42,611,401,58,343,674,87,574,661,102,544
2204900005A,60,3,57,47,0,47,47,0,47,47,2,45,94,3,89,90,4,86,25,0,25,115,5,107,118,9,109
22051000105,156,73,83,140,36,104,141,28,113,140,57,83,249,53,179,236,44,190,107,34,73,242,63,169,244,76,164
22051000133,360,343,17,245,200,45,247,191,56,281,253,22,443,400,33,380,315,54,194,168,26,486,420,45,522,473,44
22067000021,222,126,96,186,74,112,190,82,108,204,94,110,362,177,172,335,171,159,132,73,59,357,136,201,393,205,180
220570010-6,167,57,110,167,34,133,178,30,148,178,75,102,283,49,229,268,55,198,124,26,98,288,35,236,302,45,254
22019000334,505,221,284,432,83,349,434,76,358,432,137,290,705,184,489,685,148,514,284,63,221,445,122,309,445,122,309
220510026-K,324,291,33,245,189,56,246,179,67,279,241,33,436,358,65,393,300,74,221,187,34,486,364,93,541,439,95
22051000092,338,158,180,307,53,254,316,33,283,324,145,175,430,92,314,427,64,358,248,48,200,472,96,374,476,134,330
220070007-2,210,46,164,181,13,168,184,15,169,188,51,137,256,14,234,250,41,202,89,10,79,293,25,259,300,31,265
22051000086,332,155,177,278,66,212,282,50,232,287,140,141,432,110,300,416,110,290,198,58,140,463,112,336,465,130,316
22051000235,247,204,43,207,138,69,211,128,83,214,169,44,364,228,121,351,209,134,147,96,51,391,228,145,415,258,147
220070004-3,213,126,87,163,67,96,159,66,93,185,106,75,256,112,136,214,84,124,97,33,64,254,90,154,278,123,152
22051000010,396,156,240,339,52,287,337,41,296,342,133,205,546,114,405,535,106,416,242,43,199,609,126,464,632,166,462
22101000018,311,306,5,242,224,18,236,220,16,273,267,5,418,404,11,378,335,35,139,131,8,363,298,39,400,369,25
220570004-3,265,88,177,236,15,221,240,14,226,251,70,181,463,49,396,449,60,370,313,50,263,448,68,364,450,66,376
22057010-12,341,91,250,324,29,295,328,35,293,338,93,241,467,54,399,445,68,352,191,21,170,447,43,373,468,53,407
220510022-K,320,316,4,203,183,20,214,181,33,254,249,5,450,438,2,418,370,27,216,208,8,455,416,20,506,485,10
22051000196,685,627,58,550,458,92,548,434,114,578,515,51,1128,978,131,1000,808,158,409,342,67,1088,898,138,1156,1022,121
22051000039,534,215,319,458,75,383,468,64,404,476,180,293,654,114,510,633,97,527,314,64,250,684,99,564,698,145,533
22051000016,305,133,172,268,53,215,278,40,238,279,105,170,425,94,307,421,86,323,204,24,180,425,97,305,433,109,314
2205100216A,583,538,45,456,392,64,449,361,88,478,434,35,731,602,116,664,518,136,312,261,51,676,528,110,743,610,122
22051000037,416,207,209,395,95,300,397,71,326,406,178,223,574,124,412,552,106,424,286,58,228,617,144,466,614,149,448
22051000061,446,186,260,404,92,312,414,77,337,419,168,247,656,156,455,635,134,484,309,65,244,773,200,537,797,237,551
2204700013C,139,133,6,142,119,23,139,104,35,157,145,12,180,160,17,162,133,25,74,68,6,172,132,29,183,155,21
220790000S5,112,26,86,100,12,88,102,22,80,109,23,86,139,29,107,123,22,96,53,11,42,162,26,133,177,29,148
22051000128,421,288,133,360,135,225,372,125,247,377,240,131,576,212,323,561,203,343,229,86,143,599,232,347,625,275,343
221270004-1,68,14,54,72,9,63,72,13,59,74,20,54,101,8,91,98,13,84,63,2,61,84,14,65,88,14,74
220710017-1,297,254,43,206,171,35,212,136,76,222,212,10,384,290,69,369,265,95,217,191,26,520,434,73,490,416,61
22077000006,305,177,128,309,90,219,297,77,220,321,179,140,368,120,233,346,125,219,144,50,94,419,113,290,432,124,298
220710006-4,291,281,10,212,199,13,214,187,27,217,210,7,384,348,15,377,331,29,198,192,6,431,394,25,417,388,22
220710010-3,545,513,32,364,312,52,360,289,71,381,349,31,743,673,43,698,577,87,271,249,22,864,722,93,951,843,93
22033001-74,1045,445,600,833,155,678,851,118,733,839,341,493,1160,274,805,1155,230,903,762,183,579,1373,344,1007,1337,414,894
221270007-2,130,9,121,176,3,173,178,3,175,178,8,170,236,5,229,227,8,215,171,5,166,228,0,227,228,0,228
22105000106,408,222,186,310,82,228,315,85,230,330,171,157,476,155,315,450,158,233,192,64,128,488,121,316,523,160,353
22109000110,173,79,94,156,41,115,157,36,121,156,64,91,321,78,229,307,78,220,111,38,73,276,69,196,284,82,193
2207109-43G,331,327,4,290,263,27,294,263,31,307,302,5,342,330,4,339,314,25,222,210,12,314,301,8,341,330,8
22071004-22,395,222,173,313,105,208,337,73,264,341,178,163,447,168,241,450,149,294,291,121,170,400,138,250,405,165,228
22033001-14,1042,1034,8,715,647,68,749,606,143,822,812,10,1125,1096,18,1068,988,63,688,672,16,1246,1116,70,1345,1275,47
22033002-10,848,655,193,759,478,281,744,410,334,778,605,171,1107,713,360,1068,656,393,784,521,263,1031,656,354,1068,705,341
220330001-9,616,404,212,536,265,271,547,220,327,550,346,204,829,402,384,825,387,413,480,232,248,747,370,352,737,406,312
22071015-17,398,333,65,297,195,102,310,170,140,317,262,51,526,311,180,518,285,224,244,146,98,504,329,156,485,332,143
22071009-17,371,370,1,253,239,14,274,244,30,292,288,3,495,474,1,455,418,26,191,188,3,488,452,12,579,556,10
22033001-33,492,339,153,440,217,223,447,196,251,444,289,154,596,274,274,596,266,308,363,191,172,620,279,323,622,313,290
220330003-6,733,142,591,685,30,655,689,29,660,694,131,562,1392,113,1238,1350,165,1169,778,57,721,1117,90,1004,1110,98,994
22105000108,460,236,224,411,111,300,415,118,297,423,197,225,546,178,351,517,156,308,218,59,159,664,180,440,684,204,477
22115005-1A,51,9,42,44,0,44,43,0,43,46,5,41,74,5,69,70,2,66,28,1,27,80,10,67,80,8,70
220610007-1,188,76,112,176,33,143,179,24,155,180,47,132,236,41,186,232,35,193,144,27,117,196,14,178,189,21,160
220710016-4,406,362,44,294,239,55,296,220,76,308,276,31,533,412,79,515,373,123,270,229,41,548,455,74,534,456,58
22127006-1A,99,53,46,101,38,63,102,39,63,110,47,62,150,59,90,138,52,83,34,16,18,136,51,72,138,51,84
22115004-3M,9,9,0,10,10,0,9,8,1,9,9,0,43,13,24,39,12,23,14,12,2,60,26,23,65,36,29
22107000005,149,141,8,112,92,20,117,97,20,126,112,14,163,152,11,143,119,22,130,125,5,163,131,22,170,147,21
22109000020,413,203,210,348,119,229,349,120,229,370,173,194,662,241,387,625,209,393,252,78,174,604,219,351,642,256,369
22071009-33,488,485,3,330,313,17,345,311,34,365,362,0,704,688,12,636,577,35,250,247,3,704,642,32,790,769,16
220710017-3,409,397,12,285,245,40,285,219,66,312,297,12,492,449,31,441,391,41,237,225,12,507,424,52,553,493,45
22071005-10,271,265,6,177,165,12,182,161,21,184,183,1,301,276,10,284,260,16,168,165,3,317,282,14,319,299,14
220090008-1,115,27,88,104,10,94,102,12,90,102,25,77,120,9,105,117,11,104,70,11,59,147,11,133,152,10,137
22039003052,20,0,20,17,0,17,17,0,17,15,0,15,29,0,25,30,3,26,11,0,11,19,0,19,20,0,20
22115001-6A,36,24,12,35,21,14,34,21,13,36,24,12,44,18,23,42,16,25,18,8,10,34,11,21,37,13,24
220710008-6,390,387,3,304,291,13,298,271,27,308,304,1,514,471,12,483,442,23,239,233,6,604,559,12,594,559,19
22017000024,476,220,256,337,108,229,340,88,252,352,157,194,645,235,379,619,219,388,373,129,244,656,228,412,665,282,362
220130003-7,10,10,0,10,7,3,10,7,3,11,8,3,7,7,0,7,7,0,2,2,0,11,9,1,13,13,0
22015004-4A,843,215,628,641,112,529,633,102,531,652,171,475,1307,222,1049,1276,256,1005,602,124,478,1404,242,1136,1425,281,1116
22071009-15,379,364,15,280,253,27,282,235,47,292,274,17,470,395,35,437,378,44,267,248,19,562,512,40,534,485,39
2207109-38A,237,232,5,181,172,9,191,172,19,192,191,1,293,290,3,276,262,11,165,162,3,232,226,3,258,256,2
22071017-13,318,318,0,192,183,9,203,172,31,224,221,2,403,386,4,362,333,18,168,167,1,453,403,23,540,531,6
220330003-1,1012,282,730,1007,102,905,1020,89,931,1015,278,733,1873,194,1622,1838,246,1563,1122,136,986,1712,169,1515,1700,190,1492
22073000038,379,93,286,366,48,318,347,43,304,374,64,310,644,83,528,608,101,501,199,29,170,596,82,501,607,97,498
22119000004,178,176,2,139,113,26,139,125,14,161,158,2,355,340,7,317,289,23,169,166,3,304,278,18,308,288,14
22017000026,375,196,179,323,105,218,326,94,232,331,159,166,568,200,329,554,181,360,320,123,197,495,186,292,491,216,265
22065000008,238,150,88,201,92,109,215,106,109,230,127,98,275,125,146,238,105,122,87,30,57,271,130,121,295,175,117
22017000068,596,267,329,453,127,326,444,115,329,478,190,285,803,302,467,764,250,503,485,168,317,735,270,452,750,323,415
22017000056,762,236,526,607,111,496,603,109,494,616,181,429,1081,253,781,1040,257,768,512,111,401,1057,302,722,1055,337,704
22017000128,1174,285,889,877,107,770,883,110,773,884,205,676,1281,161,1067,1255,149,1095,718,94,624,1453,182,1262,1450,249,1186
220290004-2,499,222,277,457,132,325,446,133,313,470,172,293,690,217,463,637,252,374,213,77,136,654,219,416,684,242,430
22027000021,55,0,55,41,0,41,45,0,45,45,0,45,63,1,60,57,12,45,21,3,18,61,3,58,71,2,69
22017000162,573,101,472,487,53,434,487,56,431,493,74,419,802,106,684,771,121,643,390,53,337,847,92,741,855,104,743
22017000095,942,409,533,752,252,500,742,248,494,763,321,437,1091,347,709,1057,315,726,574,177,397,1036,388,630,1044,422,612
220710004-7,210,182,28,135,108,27,137,97,40,137,123,13,283,209,58,280,200,71,131,109,22,235,158,65,238,170,64
220710011-4,334,312,22,222,193,29,227,183,44,233,218,12,428,349,47,421,326,82,236,202,34,441,366,63,426,365,51
220710017-6,370,367,3,254,231,23,260,220,40,276,272,4,493,483,1,458,421,21,178,174,4,646,571,37,700,660,18
22017000048,503,150,353,423,77,346,427,65,362,427,132,290,664,127,502,637,113,506,381,76,305,655,128,503,663,160,482
2211300045A,275,43,232,267,29,238,253,25,228,271,60,211,336,36,295,319,27,276,167,28,139,390,34,348,411,42,362
22121000009,145,80,65,126,40,86,125,44,81,126,61,62,172,71,84,168,70,83,114,43,71,175,69,96,177,75,95
22097000003,443,312,131,352,161,191,365,180,185,385,235,146,536,296,228,450,194,246,170,100,70,539,254,265,615,336,275
22103000202,745,269,476,652,92,560,657,74,583,653,257,392,939,120,777,926,127,785,487,59,428,960,80,850,944,88,841
22037000013,228,168,60,217,123,94,215,116,99,229,155,74,288,183,100,262,163,96,156,106,50,249,141,102,276,176,97
220590009-1,424,52,372,392,17,375,393,25,368,404,27,376,427,6,419,410,18,389,184,7,177,438,18,417,451,18,429
220590007-1,475,52,423,453,23,430,460,21,439,468,30,435,553,22,529,533,31,495,230,8,222,524,14,501,537,16,515
22111000013,36,33,3,24,14,10,27,17,10,27,20,6,42,23,19,41,24,17,33,23,10,34,19,15,36,23,13
220330003-9,839,192,647,774,67,707,791,52,739,779,163,616,1277,230,1013,1251,232,1003,819,170,649,1251,131,1100,1229,143,1073
22033001-25,703,700,3,487,422,65,493,415,78,528,518,9,866,835,20,812,741,57,439,422,17,898,793,71,956,912,29
22111000015,124,33,91,110,18,92,110,23,87,118,31,87,172,51,111,158,49,104,101,24,77,102,21,76,114,25,86
22085006-4B,49,11,38,34,2,32,39,5,34,42,4,38,34,4,29,31,5,26,6,1,5,48,0,48,47,0,47
220850002-3,55,5,50,60,1,59,61,9,52,58,5,53,75,4,70,72,5,67,26,0,26,83,3,78,83,3,77
22103000S13,277,110,167,233,48,185,232,42,190,237,83,151,374,73,292,359,76,272,170,41,129,412,97,299,423,112,307
22055000016,291,246,45,204,143,61,198,134,64,213,173,40,423,332,77,395,221,156,112,81,31,449,331,87,500,401,93
220710005-9,235,235,0,173,169,4,174,159,15,187,187,0,345,317,11,320,285,25,142,139,3,232,201,19,249,231,10
22105000137,590,192,398,503,45,458,507,41,466,501,147,351,1004,101,882,975,162,790,320,35,285,955,109,813,976,122,844
22105000143,467,303,164,376,144,232,380,136,244,397,237,159,790,246,517,752,228,504,275,88,187,614,227,359,650,284,358
2201100013A,150,40,110,135,15,120,135,16,119,136,26,104,223,16,192,224,27,195,48,7,41,263,28,235,258,17,233
22103000430,598,214,384,469,77,392,461,76,385,471,160,308,880,138,698,845,125,701,355,59,296,901,163,705,913,196,693
2201900332S,270,174,96,254,111,143,247,113,134,267,167,99,504,207,263,486,174,301,132,55,77,447,228,193,462,260,184
2201900332N,210,138,72,181,90,91,179,81,98,185,109,75,405,190,187,382,165,208,111,51,60,342,159,163,338,167,159
22031000038,170,105,65,185,96,89,193,104,89,196,115,78,245,132,108,231,126,99,169,88,81,203,73,126,211,92,119
22039001020,184,36,148,150,17,133,158,19,139,164,34,130,183,26,152,172,21,146,93,18,75,217,20,191,228,32,192
220430005-2,299,64,235,309,20,289,314,25,289,317,53,261,400,22,364,394,43,339,155,10,145,414,26,372,419,19,397
220430007-2,164,25,139,195,11,184,196,12,184,195,24,170,227,16,208,227,31,191,101,8,93,250,17,231,250,16,231
22051000101,232,95,137,190,43,147,191,27,164,198,86,108,280,80,183,276,55,219,147,41,106,253,44,207,260,55,192
22069001-1A,127,60,67,125,39,86,127,42,85,130,52,73,181,71,102,179,84,88,85,42,43,178,63,115,183,66,117
22023000012,121,43,78,142,11,131,142,7,135,154,65,89,144,17,125,138,18,118,73,18,55,144,0,136,150,0,150
220250006-5,35,13,22,33,12,21,33,12,21,33,13,20,54,14,40,50,17,32,23,9,14,35,16,19,36,17,19
220910001-2,48,40,8,38,22,16,40,28,12,44,39,5,48,32,15,41,20,18,14,9,5,59,31,24,60,35,22
22033003-26,1462,388,1074,1386,174,1212,1389,154,1235,1391,359,1025,2030,278,1702,1999,289,1692,1220,190,1030,1935,247,1664,1913,278,1599
22033003-64,551,243,308,488,133,355,486,94,392,492,207,284,639,190,406,639,161,468,459,129,330,543,115,422,547,147,393
221150003-1,261,26,235,246,15,231,246,17,229,253,29,221,322,12,306,305,14,283,119,8,111,389,13,367,402,20,375
220430004-2,315,55,260,290,25,265,286,17,269,293,44,244,454,33,414,427,31,384,111,6,105,518,31,469,544,48,484
22073000020,541,512,29,318,257,61,309,245,64,344,313,31,694,609,74,635,544,78,245,219,26,654,527,97,697,601,89
22063000022,400,92,308,358,32,326,362,23,339,371,93,278,556,39,501,539,68,456,207,18,189,642,38,592,662,38,615
22079000S29,423,73,350,361,27,334,365,42,323,378,61,317,532,39,487,495,77,407,147,14,133,622,45,560,638,37,595
22113000044,384,55,329,339,26,313,340,16,324,346,51,295,512,39,459,501,29,459,235,21,214,567,59,494,582,70,505
22125000011,268,194,74,264,115,149,248,109,139,277,188,89,309,164,127,266,124,138,177,106,71,303,126,157,319,163,145
220450010-7,80,19,61,84,13,71,84,11,73,84,21,63,109,20,86,103,8,93,73,14,59,141,18,123,147,22,120
220210003-3,148,44,104,146,21,125,148,35,113,159,50,109,217,53,161,206,52,152,113,37,76,161,30,128,176,35,141
221150003-3,75,11,64,75,6,69,76,6,70,75,11,63,109,5,103,103,10,90,53,7,46,117,0,117,123,5,118
220610008-4,28,14,14,10,1,9,12,1,11,13,3,10,52,23,26,50,23,23,14,9,5,57,23,30,58,30,24
22119000040,269,96,173,245,57,188,249,58,191,245,82,156,336,83,243,325,84,239,132,37,95,393,102,290,397,108,284
22033001-55,827,491,336,734,300,434,726,273,453,735,409,316,1063,408,595,1042,392,635,635,225,410,1125,464,628,1141,520,600
2207300027A,77,74,3,54,41,13,55,42,13,58,52,6,135,112,21,122,96,21,42,35,7,112,88,17,116,108,7
22033001-75,909,465,444,805,220,585,817,184,633,824,385,438,1016,305,628,1020,270,735,808,268,540,1095,321,744,1062,372,662
22015002-10,310,118,192,250,39,211,254,45,209,256,76,177,436,75,342,414,89,319,212,45,167,398,75,305,402,99,295
22033003-39,317,265,52,245,173,72,242,158,84,253,206,47,408,288,101,386,268,111,141,92,49,422,265,133,458,321,123
22069001-13,324,318,6,246,207,39,246,208,38,280,268,11,530,501,16,465,397,48,185,178,7,387,312,30,444,409,21
220250007-5,59,56,3,44,38,6,42,36,6,46,44,2,59,55,3,49,41,6,29,26,3,48,42,2,54,50,3
220810003-3,136,47,89,105,28,77,104,27,77,107,36,68,148,29,116,137,38,99,66,9,57,185,53,130,183,41,137
220290005-4,364,132,232,332,84,248,334,96,238,366,131,232,376,113,263,334,104,225,161,50,111,388,96,282,430,132,295
2206300001D,947,214,733,810,54,756,816,63,753,824,164,651,1367,101,1229,1357,105,1225,457,38,419,1415,166,1220,1449,192,1239
2206300023A,498,252,246,424,138,286,422,138,284,431,209,221,674,187,461,658,173,460,183,53,130,805,220,552,829,259,535
220610010-4,303,297,6,215,195,20,211,200,11,223,216,6,479,447,22,445,392,33,177,170,7,383,318,34,421,392,27
221170005-2,229,59,170,253,8,245,267,13,254,277,67,207,369,17,349,355,32,318,117,8,109,445,37,394,451,26,422
22079000C35,321,115,206,287,57,230,293,59,234,307,95,211,417,75,324,402,67,329,213,53,160,375,58,306,387,70,304
220690003-8,323,113,210,313,63,250,307,56,251,316,99,212,420,115,295,394,119,272,209,65,144,413,72,330,431,92,329
22109000036,210,110,100,168,61,107,168,57,111,172,87,81,333,171,154,309,136,147,101,33,68,285,95,164,332,143,188
220430005-1,294,73,221,324,15,309,325,19,306,332,56,273,479,17,448,461,38,408,141,14,127,490,26,453,499,27,464
221170005-3,84,33,51,106,17,89,107,18,89,104,43,60,162,28,134,151,26,121,68,11,57,187,28,156,185,31,152
22019000301,553,536,17,496,448,48,479,420,59,530,512,15,689,649,27,670,552,95,316,296,20,613,541,39,699,663,34
22055000097,282,106,176,222,60,162,221,65,156,217,83,131,464,114,325,445,86,345,153,34,119,402,107,276,409,128,276
22103000408,927,311,616,816,131,685,820,123,697,823,253,560,1192,187,928,1154,155,971,569,90,479,1344,202,1083,1383,261,1068
22019000600,318,70,248,284,22,262,285,19,266,287,48,238,433,36,380,427,38,385,181,13,168,643,57,575,655,69,584
2201900162W,438,102,336,496,45,451,507,45,462,502,96,403,631,41,571,596,40,548,247,34,213,731,68,641,725,48,662
22031000059,239,204,35,174,139,35,175,147,28,189,161,24,338,305,31,312,265,43,147,128,19,288,197,50,315,264,47
22057005-1A,362,145,217,344,56,288,341,51,290,353,124,226,438,77,334,427,77,342,234,37,197,499,84,402,510,111,396
220570008-1,385,106,279,395,29,366,395,36,359,407,110,288,561,53,501,530,74,446,172,21,151,660,44,595,664,47,613
22051000127,476,290,186,383,138,245,383,119,264,390,221,165,604,238,336,583,217,359,259,97,162,673,291,367,674,302,368
220670039-2,242,219,23,202,164,38,186,145,41,214,191,22,312,251,60,290,219,68,130,113,17,272,182,86,289,220,66
22019000163,576,166,410,667,99,568,669,95,574,681,190,486,959,121,804,926,94,807,339,66,273,1019,114,883,1032,143,875
22101000041,388,85,303,366,27,339,365,26,339,368,68,296,540,50,482,512,54,444,240,21,219,526,38,477,524,40,483
22057010-14,339,74,265,378,27,351,369,23,346,373,80,292,564,67,485,539,69,458,180,16,164,517,31,470,532,33,494
22057010-16,292,83,209,268,40,228,272,38,234,279,99,179,377,64,306,363,78,281,177,39,138,375,37,306,386,66,314
22051000123,912,344,568,809,131,678,829,99,730,841,324,514,1254,232,977,1225,207,1010,666,126,540,1313,225,1063,1315,269,1031
22101000027,353,136,217,341,83,258,341,81,260,345,131,208,459,140,311,444,126,304,202,51,151,471,128,320,486,153,331
220510002-W,154,140,14,78,60,18,82,65,17,95,86,7,288,251,32,252,202,37,88,81,7,236,187,29,284,256,27
2205100194B,663,378,285,612,235,377,621,203,418,634,327,297,942,333,576,888,289,565,363,155,208,1092,372,674,1104,401,678
2205100213A,179,161,18,117,84,33,117,77,40,129,107,21,341,289,49,317,253,55,103,83,20,286,237,36,314,271,40
22051006-KA,437,192,245,358,91,267,360,78,282,360,152,204,605,250,330,552,209,326,295,94,201,500,147,320,511,174,329
220510001-W,277,156,121,225,73,152,226,58,168,240,137,103,410,190,207,370,154,167,144,45,99,422,172,211,457,216,235
22051000067,156,67,89,134,14,120,135,12,123,136,41,95,257,50,193,251,52,196,118,21,97,270,53,211,276,65,205
22051000085,490,269,221,439,114,325,443,89,354,439,239,199,614,160,416,602,148,444,292,70,222,561,159,387,558,189,358
220790C38-A,192,144,48,160,97,63,155,94,61,163,115,48,225,130,85,210,119,87,83,60,23,190,110,72,201,128,70
2204900019A,3,3,0,8,8,0,8,8,0,8,8,0,7,7,0,7,6,1,5,5,0,7,6,0,6,6,0
221270004-5,316,25,291,315,13,302,321,22,299,321,34,287,362,11,341,347,35,307,130,6,124,410,8,395,407,12,391
220710011-3,274,253,21,224,195,29,223,188,35,234,215,19,277,223,28,265,212,49,149,132,17,268,224,34,283,246,31
22071014-12,299,248,51,211,141,70,217,112,105,220,175,45,418,298,91,410,275,127,230,173,57,407,280,114,406,312,84
22033001-59,403,396,7,298,271,27,304,278,26,326,320,5,433,417,9,402,365,23,255,249,6,536,494,31,549,523,14
22115001-1B,20,14,6,26,16,10,26,16,10,27,19,8,30,20,9,27,15,8,6,3,3,40,24,11,44,28,16
220030002-3,218,48,170,230,9,221,232,12,220,229,39,188,341,21,311,332,20,310,148,5,143,394,18,368,396,16,376
2212100007B,153,85,68,135,48,87,135,44,91,143,75,68,191,78,108,178,58,119,111,35,76,189,80,107,208,102,102
22097000005,72,45,27,57,22,35,58,23,35,63,33,30,78,44,33,64,25,38,42,21,21,87,37,49,98,47,51
22033001-29,642,629,13,450,409,41,458,387,71,497,480,16,720,696,11,660,597,49,375,359,16,769,703,34,811,781,25
22033002-35,538,156,382,476,92,384,468,73,395,483,172,311,698,184,479,697,168,516,392,115,277,778,100,663,770,121,635
22071007-13,324,323,1,223,207,16,229,203,26,237,236,1,385,363,5,359,327,27,173,172,1,411,374,15,438,421,10
220710016-3,381,320,61,255,179,76,264,166,98,268,224,44,500,358,114,479,304,167,273,211,62,478,360,109,484,375,103
22105000026,348,298,50,211,131,80,212,122,90,259,222,35,455,315,133,401,268,118,156,118,38,374,226,119,418,291,122
22039001170,191,164,27,117,81,36,126,88,38,141,109,30,192,156,33,163,109,46,70,47,23,162,101,50,200,160,35
2207109-39B,187,182,5,154,137,17,157,136,21,165,161,4,256,246,9,235,216,15,121,116,5,246,220,15,271,256,13
22071008-19,558,536,22,408,354,54,409,324,85,425,405,19,678,626,33,649,569,64,270,248,22,718,645,48,765,718,34
22071003-14,278,256,22,182,160,22,184,144,40,186,179,6,308,245,38,294,230,54,175,158,17,337,284,49,318,266,42
220710007-4,268,265,3,172,164,8,167,155,12,179,177,1,353,333,8,322,291,21,134,130,4,332,300,10,372,355,5
220090002-8,247,205,42,187,128,59,194,108,86,233,193,40,313,251,51,243,182,46,102,84,18,254,170,64,295,221,62
22017000113,553,223,330,433,104,329,435,99,336,447,166,279,753,214,509,718,201,504,344,101,243,736,252,461,732,279,441
22071014-17,296,238,58,180,106,74,186,71,115,194,150,43,376,230,104,375,219,144,224,159,65,318,202,108,300,195,87
22071007-16,380,376,4,268,243,25,268,216,52,292,285,7,438,408,7,389,364,21,210,207,3,451,417,10,493,478,3
2203301-105,587,213,374,585,113,472,593,88,505,595,194,401,574,169,372,555,143,400,359,104,255,823,141,670,800,186,606
2203301-103,639,312,327,572,186,386,580,159,421,584,262,319,882,283,549,859,237,590,542,144,398,860,324,518,857,360,478
22033003-59,622,329,293,547,184,363,546,166,380,561,287,273,528,192,314,501,176,318,289,101,188,834,287,526,859,338,498
22033003-28,944,565,379,832,358,474,830,329,501,852,529,319,1034,370,607,1008,341,658,649,235,414,1105,487,593,1120,523,567
2207109-43I,294,290,4,216,199,17,217,177,40,224,213,11,365,336,19,358,319,33,175,163,12,375,336,25,397,365,29
2207109-43B,293,292,1,197,183,14,188,165,23,206,203,0,377,363,7,357,332,18,161,157,4,407,391,5,418,411,5
22017000062,696,602,94,505,353,152,488,359,129,527,446,80,938,739,181,901,696,193,395,310,85,892,721,153,934,780,139
22073000006,1073,237,836,860,104,756,856,101,755,867,146,717,1415,173,1198,1366,199,1153,558,80,478,1441,177,1225,1454,222,1212
22017000011,734,251,483,586,96,490,583,80,503,587,164,421,1059,210,776,1029,200,803,458,94,364,936,201,707,944,227,687
22071007-25,390,373,17,336,309,27,331,275,56,354,343,8,521,485,18,481,431,30,255,248,7,463,415,25,504,480,13
22065000012,233,227,6,189,170,19,183,171,12,194,185,6,280,274,0,263,245,10,76,76,0,272,245,20,287,270,9
2203500005A,16,5,11,10,2,8,10,4,6,10,4,6,16,5,11,20,4,16,5,1,4,21,5,13,22,7,15
22041000021,307,49,258,305,15,290,316,24,292,321,25,294,412,32,377,399,52,342,201,6,195,446,22,415,451,27,422
2202300005S,285,71,214,357,21,336,360,28,332,362,67,289,473,37,423,452,19,422,197,18,179,380,6,361,412,24,384
220030001-3,137,61,76,135,49,86,130,45,85,142,67,72,176,61,113,161,51,103,70,22,48,199,51,134,205,56,145
220710014-4,281,240,41,207,130,77,207,98,109,221,173,47,337,221,92,335,192,138,174,116,58,381,253,112,364,251,103
220710011-5,570,501,69,416,312,104,427,269,158,442,387,51,726,567,114,708,473,213,414,339,75,595,397,169,609,454,138
220710017-7,459,437,22,316,269,47,323,253,70,330,308,21,599,519,46,575,486,78,255,233,22,530,475,37,525,478,32
220710012-3,416,394,22,291,239,52,302,212,90,312,278,30,482,406,50,460,348,94,276,247,29,525,433,80,550,483,59
22071012-12,257,242,15,193,158,35,210,158,52,215,195,20,365,316,31,347,283,58,171,149,22,316,268,42,368,324,37
22073000058,746,72,674,637,22,615,644,26,618,651,51,599,970,37,925,927,52,869,339,11,328,1131,39,1081,1137,49,1086
22125000008,457,195,262,448,60,388,448,53,395,448,176,272,596,93,488,594,93,488,385,70,315,567,73,483,572,84,488
22103000M02,677,321,356,577,182,395,573,156,417,584,271,307,868,222,599,847,205,629,438,119,319,912,234,644,930,297,613
22005000071,1304,659,645,1045,342,703,1049,302,747,1058,502,552,1629,509,1063,1549,486,1045,583,225,358,1758,482,1215,1796,588,1161
22005000052,206,109,97,186,56,130,192,51,141,201,103,91,231,76,149,215,65,144,117,28,89,316,126,181,329,147,170
220130004-2,47,4,43,54,3,51,54,9,45,56,9,47,68,5,62,67,12,54,41,5,36,56,0,54,62,4,58
22125000002,348,304,44,281,204,77,277,199,78,299,256,43,417,300,111,386,252,125,227,162,65,377,219,138,424,288,129
22063000021,1054,361,693,881,152,729,885,137,748,893,287,602,1372,218,1078,1308,219,1058,418,63,355,1728,371,1285,1756,422,1285
22127003-1B,80,66,14,97,44,53,99,54,45,102,57,45,167,90,75,149,73,69,84,42,42,99,44,51,114,65,46
2206300011A,553,163,390,516,54,462,515,50,465,527,132,386,805,67,722,774,114,640,232,28,204,943,48,885,965,50,903
22087000054,404,218,186,338,105,233,343,89,254,357,175,176,632,179,438,590,160,404,192,68,124,764,212,515,806,242,546
220590007-2,189,41,148,196,9,187,197,16,181,203,22,181,237,11,219,227,23,196,112,4,108,212,21,184,227,22,199
22103000M03,337,147,190,280,65,215,282,59,223,290,114,175,460,98,329,451,93,349,229,55,174,446,126,293,459,149,297
22033001-57,408,285,123,308,150,158,300,139,161,310,201,105,498,239,216,493,234,241,277,151,126,481,249,222,475,270,191
220330002-8,571,125,446,608,51,557,617,50,567,616,134,479,984,53,907,974,85,872,604,41,563,938,54,868,934,59,868
220850002-4,120,40,80,122,37,85,118,43,75,130,44,86,141,48,92,138,46,88,76,27,49,128,34,94,147,44,102
2207115-14D,213,202,11,141,118,23,138,102,36,143,127,15,353,310,33,330,285,41,109,98,11,338,302,27,362,330,27
22103000105,458,172,286,359,51,308,363,50,313,367,122,244,487,59,412,481,57,419,200,28,172,595,96,470,597,109,473
22105000102,669,301,368,509,98,411,522,89,433,538,211,323,809,215,581,760,175,319,324,84,240,894,216,546,934,248,667
2210500137B,418,243,175,353,117,236,354,114,240,360,181,179,639,278,341,601,240,343,204,74,130,601,221,347,622,275,337
22019000701,145,131,14,109,90,19,107,83,24,120,107,9,206,165,27,186,130,48,75,64,11,327,235,69,368,287,63
2210500121A,681,312,369,562,107,455,569,115,454,586,256,323,1116,282,801,1069,284,743,301,65,236,1104,263,802,1138,307,811
22103000803,837,376,461,656,173,483,656,142,514,668,276,383,1218,299,847,1177,301,844,493,119,374,1292,344,894,1337,429,882
22049000003,248,30,218,234,8,226,235,6,229,234,21,213,367,14,349,353,21,331,154,11,143,341,23,309,342,20,320
22117004-5B,41,25,16,34,22,12,35,23,12,33,19,11,80,44,34,71,37,33,23,9,14,59,26,29,63,35,28
22047000025,433,107,326,539,34,505,531,31,500,534,170,353,655,43,597,610,76,512,245,19,226,653,27,600,694,35,651
22101000038,302,134,168,334,105,229,327,107,220,341,142,194,489,153,318,443,140,285,203,45,158,469,112,342,480,123,350
22101000045,391,149,242,340,66,274,342,68,274,361,117,239,566,161,394,496,118,362,167,34,133,660,140,478,699,175,520
220590008-5,85,6,79,77,3,74,74,6,68,73,6,66,78,0,77,77,4,73,47,0,47,97,0,95,94,2,92
22021004-1A,45,15,30,49,11,38,47,9,38,52,16,36,55,10,40,54,8,46,33,7,26,104,35,66,111,41,70
22113000038,285,271,14,169,129,40,165,127,38,197,170,26,394,337,45,322,207,98,115,105,10,342,245,49,409,349,57
220810006-2,189,178,11,127,97,30,131,114,17,143,129,14,242,213,26,214,174,35,97,83,14,185,146,27,203,167,28
220250006-2,74,12,62,60,9,51,62,10,52,61,11,49,81,8,73,75,5,69,35,6,29,86,13,73,84,9,74
22109000088,608,136,472,615,57,558,621,47,574,627,136,491,861,75,778,838,75,751,315,28,287,894,58,823,909,57,846
22063000012,618,266,352,502,78,424,497,79,418,508,200,306,836,136,680,812,174,622,254,49,205,991,161,802,1022,192,816
2206300007D,242,103,139,262,61,201,260,62,198,263,93,167,445,102,314,429,108,302,121,36,85,428,81,331,440,95,338
220610004-2,413,245,168,291,99,192,283,96,187,298,132,163,518,206,297,455,172,265,179,71,108,572,235,309,629,320,303
2210700004A,65,37,28,61,23,38,57,24,33,51,28,23,78,38,39,74,31,42,61,28,33,64,31,33,71,37,34
22055000029,543,154,389,460,71,389,456,62,394,466,128,336,834,164,638,783,129,640,363,74,289,865,170,650,885,192,676
22055000044,391,183,208,326,115,211,320,101,219,327,136,189,616,215,357,600,189,391,245,71,174,566,183,343,585,224,340
2201900320E,312,294,18,248,203,45,241,202,39,261,236,21,461,386,65,443,310,123,153,128,25,291,221,54,318,275,40
22103000113,136,62,74,119,35,84,121,33,88,122,55,66,310,40,248,316,31,277,151,14,137,297,84,203,297,87,202
22103000306,477,147,330,430,35,395,428,37,391,428,112,309,589,57,493,575,38,523,266,21,245,599,49,535,605,87,513
22067000023,166,34,132,145,24,121,147,25,122,159,33,124,202,35,165,184,37,147,87,11,76,208,40,161,210,44,162
22031000011,335,95,240,279,40,239,276,40,236,287,57,230,428,79,341,409,83,323,202,39,163,532,69,459,532,80,450
22019000700,242,104,138,231,46,185,230,52,178,232,89,142,396,74,312,383,72,304,122,36,86,519,105,394,535,131,393
22051013-KB,236,222,14,130,104,26,122,94,28,148,131,15,330,285,35,292,229,46,115,94,21,387,299,72,435,361,68
22051013-KA,411,184,227,310,65,245,317,57,260,320,137,182,510,129,356,491,116,370,292,76,216,576,149,419,575,168,401
220570002-9,463,396,67,313,215,98,324,221,103,372,300,66,616,474,132,561,386,147,146,95,51,589,392,162,664,487,159
22057002-10,206,116,90,168,53,115,168,43,125,178,99,79,278,116,155,254,79,160,99,29,70,297,91,201,325,115,208
22057010-10,386,110,276,349,45,304,352,42,310,360,113,240,551,76,457,517,99,395,202,26,176,449,45,368,483,55,420
22051000154,628,618,10,402,362,40,397,342,55,500,480,15,895,873,16,779,708,39,388,374,14,877,812,26,920,881,30
22051000026,720,384,336,621,193,428,630,154,476,649,333,315,981,342,594,954,252,679,427,117,310,932,291,599,949,357,577
220510003-H,404,124,280,368,40,328,365,28,337,356,113,239,573,82,456,559,66,490,256,39,217,601,71,522,611,90,512
22051000036,274,99,175,251,40,211,251,33,218,252,90,161,390,88,284,373,81,282,161,35,126,412,103,297,428,126,296
220510006-H,215,78,137,179,26,153,175,24,151,178,60,117,275,52,214,268,49,213,112,20,92,363,61,292,377,84,289
2204900017A,71,48,23,68,45,23,64,27,37,69,52,17,96,64,30,96,70,26,57,43,14,98,44,52,93,46,46
22051000002,519,218,301,474,80,394,480,63,417,485,192,289,707,130,545,703,122,576,346,55,291,710,124,563,717,153,560
22071010-11,397,375,22,265,232,33,269,217,52,291,276,12,592,510,53,565,465,86,248,223,25,538,462,46,568,513,43
22033001-62,680,672,8,506,467,39,527,457,70,552,542,9,802,777,15,762,687,51,481,474,7,705,641,44,752,718,29
22071014-25,384,347,37,284,220,64,289,187,102,299,263,35,409,330,62,371,258,99,219,187,32,446,354,80,444,363,75
220710007-2,324,292,32,220,185,35,221,159,62,230,201,28,472,372,66,446,346,82,229,200,29,405,336,57,400,342,51
22071007-17,365,329,36,287,256,31,288,237,51,293,272,15,399,333,53,388,309,70,275,253,22,425,332,75,409,327,64
2207109-44D,348,345,3,295,277,18,296,264,32,307,296,8,544,517,16,533,497,33,217,202,15,451,410,24,498,478,13
22107000004,96,94,2,77,57,20,85,70,15,95,82,13,111,97,14,101,76,18,80,60,20,102,76,19,121,103,18
2207115-17A,319,225,94,266,164,102,280,144,136,283,218,65,459,260,168,426,214,195,221,116,105,384,236,140,400,256,137
22071010-13,236,232,4,151,134,17,149,123,26,170,163,4,325,313,4,303,272,26,92,89,3,346,316,10,402,385,14
22009007-3B,12,8,4,16,4,12,15,2,13,15,10,5,12,2,9,10,5,5,2,1,1,15,4,11,18,3,15
22071013-15,349,326,23,246,203,43,251,177,74,259,243,16,408,332,49,386,304,80,211,185,26,391,329,55,391,337,50
2207109-44G,316,311,5,222,202,20,225,190,35,235,228,6,511,501,8,476,438,28,180,174,6,558,494,27,632,615,13
22071008-20,305,284,21,244,214,30,249,201,48,262,242,14,361,302,45,357,286,50,187,168,19,351,277,51,377,330,45
22017000154,65,27,38,56,12,44,58,13,45,62,23,38,77,25,52,71,22,48,48,20,28,95,27,65,108,41,67
220790N13-B,440,141,299,425,67,358,427,60,367,436,125,308,590,102,461,579,86,477,306,59,247,499,77,407,510,86,411
220790N13-A,300,91,209,268,36,232,272,36,236,276,75,201,390,60,312,375,51,315,176,18,158,364,63,287,370,68,292
22079000N22,275,46,229,268,9,259,270,10,260,281,45,235,362,17,336,346,15,318,130,5,125,375,15,354,379,15,361
22017000065,422,287,135,332,162,170,316,167,149,333,200,131,554,303,221,527,297,218,231,133,98,547,341,190,551,349,196
22017000105,473,151,322,392,82,310,393,78,315,402,122,277,645,168,469,584,154,421,276,83,193,657,128,514,677,148,522
220210005-2,60,9,51,50,2,48,46,2,44,50,5,45,68,3,63,64,9,55,36,5,31,72,2,70,77,2,75
22027000081,135,52,83,101,11,90,102,19,83,102,31,71,135,39,96,126,36,89,92,26,66,148,46,102,143,44,99
220710010-8,244,193,51,145,105,40,159,87,72,160,136,24,304,173,110,297,145,148,172,112,60,290,169,115,284,183,87
220710005-5,248,247,1,162,148,14,164,149,15,170,165,5,304,282,8,285,259,19,93,88,5,408,373,16,426,411,8
22121000006,80,80,0,40,33,7,43,29,14,53,47,4,93,90,3,73,62,10,52,48,4,91,85,5,106,102,4
22111000018,319,36,283,288,14,274,282,15,267,293,27,263,552,47,494,522,67,448,164,9,155,609,29,571,611,36,569
22005000044,643,539,104,483,369,114,480,355,125,513,438,74,707,583,119,633,463,154,300,250,50,899,666,194,947,755,179
2206300004A,428,120,308,416,31,385,415,32,383,424,116,305,733,64,640,708,98,591,256,17,239,744,44,681,746,52,682
22005000041,562,167,395,537,50,487,537,61,476,538,157,377,697,86,585,680,119,551,192,25,167,930,117,780,932,139,778
22103000422,571,216,355,440,68,372,437,47,390,453,168,282,466,71,366,448,50,392,234,23,211,746,147,572,751,196,537
22109000023,454,343,111,352,211,141,365,209,156,421,288,123,631,445,164,546,342,169,238,167,71,491,297,164,599,406,183
22103000307,659,234,425,578,74,504,588,77,511,601,182,410,1020,176,782,973,162,779,346,56,290,1007,189,773,1023,233,762
22071017-10,350,333,17,251,213,38,249,190,59,276,257,16,458,423,24,412,345,46,169,154,15,472,415,37,489,451,32
2210500111A,284,202,82,242,124,118,240,118,122,258,167,88,383,214,156,348,190,135,117,70,47,397,173,202,411,199,201
220790C11-A,99,90,9,67,56,11,65,53,12,67,64,3,140,112,27,135,104,28,31,26,5,128,100,21,149,134,14
22051000070,395,257,138,281,108,173,294,95,199,313,186,123,597,208,359,572,188,363,253,64,189,506,240,239,565,304,252
220070005-3,174,63,111,180,27,153,174,22,152,179,49,127,251,45,205,236,50,178,86,17,69,245,22,219,256,26,227
22119000038,142,33,109,122,11,111,121,9,112,120,18,102,175,19,152,171,30,140,94,12,82,199,25,171,195,25,166
220490019AI,70,61,9,66,59,7,65,49,16,67,59,8,96,81,14,88,68,17,46,43,3,82,60,20,83,61,20
2206300026C,351,89,262,346,39,307,352,40,312,354,87,266,516,38,464,473,50,408,217,16,201,587,91,487,592,95,480
22077000002,193,173,20,127,88,39,137,101,36,172,142,28,196,153,38,182,140,37,99,82,17,179,121,40,222,185,34
22115001-3B,2,2,0,3,2,1,3,0,3,3,3,0,1,0,1,1,0,1,3,0,3,4,0,2,3,0,3
22113000041,50,1,49,61,4,57,68,3,65,65,1,64,82,11,68,80,2,78,31,0,31,82,8,73,83,7,76
2211300034A,119,105,14,81,47,34,75,46,29,89,74,13,201,149,48,177,97,70,52,31,21,168,87,47,199,143,46
22113000026,428,52,376,415,36,379,422,28,394,426,57,369,564,54,503,553,55,491,258,15,243,545,61,469,551,63,478
22033001-88,397,377,20,240,193,47,230,180,50,249,226,20,698,613,67,686,559,100,312,278,34,652,562,66,696,626,54
22033003-36,730,317,413,656,158,498,675,138,537,667,264,402,915,268,579,910,230,663,649,183,466,779,168,600,760,192,553
220690003-3,81,10,71,74,8,66,70,8,62,71,9,61,107,16,89,100,31,68,46,11,35,117,16,100,121,18,102
22017000028,25,19,6,20,6,14,19,4,15,20,11,7,51,35,14,45,28,15,12,10,2,51,34,14,54,38,16
22097000017,399,80,319,386,28,358,390,27,363,403,72,330,634,45,576,588,58,519,139,18,121,609,30,564,650,44,602
220290004-3,265,247,18,189,164,25,197,171,26,226,208,17,295,258,33,271,222,44,104,100,4,276,235,28,300,268,32
22103000812,686,291,395,594,102,492,595,79,516,601,224,370,943,167,716,918,138,767,465,91,374,1003,160,820,1028,219,788
22103000419,495,175,320,466,59,407,471,53,418,486,183,303,646,106,520,650,90,554,386,60,326,607,94,494,609,109,485
2204900011A,100,18,82,82,9,73,86,9,77,86,12,74,101,14,87,91,16,75,44,4,40,102,6,96,105,11,94
22103000313,476,175,301,416,60,356,418,64,354,419,135,281,763,137,584,705,126,552,206,44,162,773,154,584,814,199,603
220070002-4,173,61,112,163,15,148,170,16,154,178,62,108,233,32,193,226,40,183,92,13,79,226,33,186,228,38,190
22051000100,230,105,125,205,44,161,208,26,182,208,105,100,285,83,188,290,54,234,183,43,140,296,56,239,295,80,208
2205100216B,674,423,251,556,280,276,556,256,300,569,381,183,876,426,412,837,367,451,465,216,249,802,361,417,817,388,422
22047000005,288,99,189,366,40,326,362,44,318,378,146,227,392,38,347,370,70,292,161,28,133,516,20,485,537,43,488
220570007-3,146,53,93,112,10,102,109,8,101,113,44,68,205,35,159,189,33,147,91,15,76,274,24,238,292,31,259
22051000088,424,214,210,345,79,266,351,54,297,348,182,165,512,121,364,503,92,404,258,67,191,543,145,389,542,185,340
220070006-3,232,218,14,190,171,19,187,166,21,201,187,13,225,202,20,192,151,34,102,85,17,183,149,24,213,187,22
220910003-2,122,101,21,103,66,37,108,65,43,116,95,21,128,91,36,125,91,29,70,55,15,135,87,44,130,86,43
220710015-1,173,140,33,177,127,50,180,105,75,180,144,33,226,146,57,216,126,84,143,106,37,190,123,51,193,139,47
22087000046,174,65,109,154,33,121,160,23,137,164,64,100,379,49,319,351,62,287,95,14,81,339,64,269,351,66,280
22071007-10,209,208,1,134,118,16,135,115,20,144,143,1,291,285,0,267,227,30,81,81,0,282,250,10,358,347,6
22033001-50,622,602,20,462,409,53,472,405,67,498,475,20,733,687,28,706,621,67,357,341,16,741,646,57,788,751,31
22087000045,268,253,15,164,144,20,162,129,33,182,171,9,313,264,37,279,217,49,81,70,11,271,209,37,313,273,33
22009005-1A,37,7,30,35,2,33,39,4,35,42,9,33,49,13,36,44,10,33,26,8,18,60,12,48,59,11,48
2207115-14F,280,247,33,236,176,60,237,158,79,239,210,28,317,231,73,317,215,97,158,127,31,284,205,73,284,213,64
22039005040,311,34,277,300,13,287,298,23,275,308,47,260,395,21,366,361,30,320,136,8,128,428,20,407,438,19,418
22039001161,41,6,35,53,6,47,49,4,45,55,10,45,54,1,51,52,1,50,23,2,21,52,4,47,55,7,48
220130002-6,4,3,1,0,0,0,1,1,0,1,1,0,1,0,1,1,1,0,4,2,2,2,0,2,1,0,1
22071009-37,293,286,7,268,248,20,264,224,40,275,270,4,478,454,18,455,424,26,188,182,6,321,286,16,353,335,11
22033003-13,665,284,381,630,144,486,630,118,512,632,235,394,612,182,396,608,162,437,400,102,298,739,154,565,757,186,555
22033003-54,233,207,26,151,118,33,147,106,41,155,134,20,291,224,62,288,214,67,131,104,27,341,269,68,352,288,58
22017000020,514,241,273,366,115,251,371,105,266,372,168,203,666,214,397,647,207,426,341,139,202,652,226,408,649,254,367
22073000019,666,656,10,406,342,64,430,366,64,460,451,7,799,770,23,740,667,48,310,301,9,765,694,40,827,797,22
22079000N26,853,157,696,837,59,778,847,56,791,865,130,726,1290,73,1178,1227,91,1107,457,30,427,1079,62,1004,1116,90,1008
22027000010,160,140,20,123,70,53,119,93,26,136,112,22,173,143,28,166,127,37,71,63,8,159,123,29,172,149,20
22017000076,508,166,342,398,74,324,405,86,319,406,122,281,731,226,473,709,218,479,351,76,275,667,226,420,685,258,412
22083000030,110,23,87,121,6,115,122,10,112,117,7,109,153,20,131,146,22,124,81,6,75,151,6,142,154,14,138
22005000045,201,172,29,143,108,35,140,104,36,160,130,29,200,174,26,181,140,33,89,64,25,298,228,56,324,281,36
22103000427,398,105,293,330,39,291,335,31,304,342,85,256,481,68,374,489,50,429,208,29,179,544,66,459,554,93,449
22103000S04,469,155,314,398,54,344,401,49,352,398,115,277,650,119,506,625,129,479,311,64,247,823,139,652,821,149,665
22109000082,151,37,114,152,15,137,151,17,134,156,37,119,238,30,205,218,29,183,67,11,56,243,15,221,256,16,240
22109000068,455,167,288,369,69,300,369,72,297,377,125,251,588,149,424,571,147,418,261,60,201,631,103,500,652,137,505
220850005-5,164,17,147,142,5,137,142,10,132,146,8,137,252,23,228,238,34,201,136,4,132,219,26,186,238,27,207
22049000011,518,73,445,446,12,434,446,8,438,446,37,409,659,21,621,638,60,570,300,20,280,626,14,606,639,20,612
22071007-12,415,400,15,318,281,37,324,253,71,332,317,15,522,449,46,505,420,77,307,280,27,479,408,56,488,434,48
22103000402,599,207,392,513,69,444,515,65,450,502,174,325,716,146,535,726,116,601,350,56,294,723,106,605,726,138,571
22105000116,564,261,303,471,110,361,476,106,370,497,208,285,657,164,479,640,154,468,264,49,215,809,166,607,839,193,637
2212100007A,438,178,260,415,52,363,425,62,363,419,165,251,517,95,402,511,109,393,348,62,286,566,108,455,564,141,415
22067000006,149,44,105,155,24,131,156,25,131,162,31,131,207,45,159,204,47,154,103,16,87,159,42,113,171,44,127
2201900316E,207,161,46,169,82,87,166,83,83,187,128,56,364,227,128,352,182,157,99,61,38,277,160,93,309,218,80
2206300004B,271,63,208,264,16,248,272,7,265,277,64,211,347,19,313,354,34,315,171,7,164,351,27,318,349,27,314
2210500120B,287,143,144,228,63,165,225,52,173,229,106,120,373,94,262,370,88,266,137,35,102,441,106,315,442,121,310
22063000019,726,242,484,649,55,594,654,73,581,670,201,460,1040,94,928,1000,173,807,238,27,211,1267,80,1150,1304,120,1162
22033002-29,545,338,207,493,252,241,497,229,268,517,339,177,842,318,485,835,306,508,511,215,296,713,313,366,713,353,333
220330002-4,582,546,36,490,379,111,487,335,152,516,472,41,811,689,106,780,632,130,365,293,72,763,648,88,795,704,83
22033003-46,750,145,605,684,52,632,694,40,654,690,130,559,1076,97,950,1044,120,909,605,54,551,996,96,893,989,104,866
22109000019,437,142,295,431,72,359,430,63,367,440,134,302,821,171,632,784,163,598,291,46,245,650,140,488,676,185,487
22023000015,58,26,32,108,28,80,109,30,79,117,58,59,118,31,83,109,19,86,37,15,22,169,35,129,175,44,129
22041000018,9,2,7,8,0,8,8,0,8,7,1,6,14,3,10,13,1,12,9,1,8,13,0,13,13,0,13
22085006-4A,68,9,59,91,7,84,91,13,78,96,15,80,129,13,115,119,21,95,40,1,39,107,7,99,119,6,113
22051000132,274,180,94,216,101,115,222,71,151,232,132,96,343,142,172,330,128,196,166,74,92,367,171,181,391,210,175
22051000035,346,154,192,309,55,254,312,36,276,319,136,182,438,99,311,431,85,337,201,39,162,430,76,341,443,107,331
2201900460E,209,50,159,206,17,189,207,21,186,211,54,153,367,33,323,342,28,301,109,20,89,449,45,396,448,48,393
220510035-K,375,174,201,323,88,235,327,67,260,341,148,192,476,154,303,463,125,329,294,68,226,460,150,293,471,181,277
220890007-1,242,91,151,243,60,183,240,60,180,246,94,148,387,88,289,372,80,279,132,28,104,438,107,319,446,114,324
22051000130,270,165,105,248,86,162,252,64,188,253,153,99,365,128,218,343,100,238,171,67,104,372,136,228,376,147,221
22051000034,495,214,281,408,69,339,415,53,362,417,162,252,632,132,463,616,110,497,300,48,252,675,125,531,687,172,502
22051000117,586,239,347,519,96,423,529,85,444,539,209,325,824,187,585,790,149,618,391,87,304,819,154,632,854,204,634
220510007-H,419,181,238,382,66,316,384,45,339,390,163,224,547,118,395,539,105,430,280,51,229,601,118,462,616,155,447
220710016-6,516,482,34,381,327,54,384,287,97,390,363,26,643,545,68,610,491,106,320,290,30,662,558,88,668,574,80
220710016-2,368,302,66,260,174,86,264,145,119,273,212,53,477,298,131,456,258,183,259,181,78,436,271,148,445,307,130
22109000089,670,117,553,630,35,595,632,32,600,644,126,505,888,64,799,864,73,773,354,18,336,1031,58,952,1059,86,962
220130002-4,12,9,3,13,6,7,12,7,5,13,8,4,20,15,5,17,9,6,6,2,4,12,9,3,15,11,4
22017000004,692,625,67,503,368,135,495,397,98,527,467,59,876,771,88,827,710,101,392,332,60,903,772,108,923,808,104
220130002-3,3,0,3,1,0,1,1,0,1,1,0,1,0,0,0,0,0,0,0,0,0,0,0,0,0,0,0
22005000078,748,298,450,594,123,471,597,103,494,580,228,351,957,206,717,926,189,713,363,94,269,913,139,745,918,155,746
22101000020,420,275,145,341,158,183,330,146,184,370,213,151,507,279,219,474,236,228,179,82,97,500,241,235,540,285,246
22031000021,299,110,189,241,55,186,243,65,178,249,86,163,379,108,258,376,125,247,192,66,126,546,127,407,557,130,414
2212100013A,397,384,13,318,271,47,322,275,47,350,327,21,531,465,61,488,402,76,227,204,23,459,372,63,485,426,49
220510011-K,326,201,125,261,83,178,260,68,192,265,135,129,473,170,278,454,146,298,230,72,158,485,161,297,503,210,277
22051000042,514,278,236,395,86,309,401,57,344,402,200,201,658,205,404,628,175,444,306,93,213,729,217,493,749,258,474
2205100238A,680,538,142,563,365,198,565,321,244,583,451,125,890,607,256,841,526,294,378,247,131,768,495,240,817,564,248
220590001-2,94,4,90,82,0,82,82,4,78,82,0,80,106,0,102,102,4,97,42,1,41,100,2,96,105,0,105
22115004-3L,12,4,8,5,2,3,5,2,3,4,2,2,144,41,91,127,33,80,9,0,9,115,52,50,130,69,56
22033003-49,791,468,323,700,297,403,688,226,462,711,385,319,973,385,529,974,349,616,657,250,407,816,345,454,805,374,413
22113046B-1,304,139,165,270,87,183,263,72,191,277,115,158,337,129,203,310,98,202,146,40,106,308,94,198,345,121,219
22069003-10,71,19,52,60,8,52,65,12,53,60,17,43,78,10,68,77,21,54,47,12,35,88,8,78,89,8,81
2201502-12B,181,101,80,144,45,99,142,51,91,148,66,81,277,111,159,269,113,152,125,48,77,242,136,103,254,142,106
2207300052A,360,76,284,319,39,280,321,33,288,323,63,259,513,48,450,500,55,432,179,23,156,567,51,507,562,67,493
221170008-3,488,127,361,582,45,537,592,47,545,613,186,420,756,44,704,718,50,657,283,13,270,863,53,802,863,42,819
22103000A03,232,90,142,232,57,175,221,43,178,235,97,138,350,86,255,339,82,247,170,54,116,401,87,299,423,107,309
22019000663,199,42,157,174,11,163,175,20,155,179,38,137,258,23,228,247,26,217,81,16,65,324,26,291,333,15,313
2201100027D,91,27,64,79,7,72,78,10,68,81,22,59,130,21,103,118,23,93,59,7,52,129,6,119,137,6,131
220570006-4,335,154,181,315,33,282,309,54,255,339,153,176,458,88,363,417,98,302,130,35,95,548,70,450,613,92,514
2205100238B,614,434,180,508,295,213,500,267,233,530,386,139,778,438,296,723,368,336,372,216,156,736,416,304,773,466,300
22051000065,417,199,218,370,80,290,373,63,310,383,176,204,617,133,461,594,128,453,272,67,205,651,155,456,661,179,472
22051000093,395,139,256,375,62,313,383,37,346,382,141,240,531,111,388,532,90,432,298,54,244,544,75,466,544,103,431
22051000108,268,265,3,157,140,17,166,143,23,204,197,3,383,370,6,337,305,17,141,139,2,394,364,13,453,441,6
22071011-13,232,232,0,140,119,21,142,115,27,164,162,1,313,307,4,281,253,22,90,87,3,330,306,10,379,370,8
2207115-14C,332,278,54,212,134,78,222,125,97,225,183,42,377,264,99,363,244,113,185,127,58,439,313,106,447,337,104
22071009-38,178,173,5,137,120,17,132,115,17,141,133,8,287,271,16,267,238,22,141,127,14,222,195,17,270,256,14
220710012-8,184,152,32,152,97,55,149,82,67,151,119,32,284,198,56,270,171,96,138,108,30,230,149,78,206,139,63
22071007-29,320,317,3,229,208,21,243,203,40,255,251,1,325,316,4,309,290,16,187,183,4,323,287,22,351,325,24
22039001081,127,124,3,79,65,14,79,66,13,102,88,12,185,165,19,165,102,43,26,24,2,109,75,18,142,124,13
22039001162,104,79,25,77,44,33,78,43,35,89,56,33,126,86,37,106,54,50,34,16,18,107,61,46,117,75,42
22017000092,585,247,338,477,143,334,469,143,326,472,171,299,861,237,584,831,236,582,383,102,281,883,388,473,890,400,473
2203500005B,9,5,4,12,6,6,13,4,9,11,5,6,14,2,11,11,2,8,7,1,6,12,12,0,9,9,0
2212100010B,193,165,28,152,102,50,155,96,59,165,131,34,249,177,63,220,147,66,124,77,47,188,120,56,219,167,48
22005000014,563,157,406,522,41,481,527,51,476,530,148,378,796,88,680,772,112,633,232,35,197,1071,96,954,1078,111,950
22005000054,433,324,109,370,222,148,377,197,180,412,281,130,487,314,163,450,277,161,245,166,79,460,298,153,503,352,145
22005000042,317,222,95,245,129,116,243,110,133,249,151,98,354,224,121,337,194,136,138,89,49,440,248,182,446,271,162
220090008-3,211,44,167,187,10,177,187,15,172,186,38,148,231,8,219,223,17,205,102,4,98,258,15,241,275,16,259
220810001-2,194,24,170,182,21,161,184,34,150,183,31,150,232,17,206,228,39,182,104,24,80,225,21,200,228,21,204
22055000003,741,205,536,615,105,510,619,104,515,625,159,465,1024,177,829,999,167,808,394,65,329,1121,182,911,1157,217,935
22033001-81,569,467,102,429,277,152,426,275,151,437,329,105,958,741,186,940,678,225,364,252,112,866,600,223,894,668,200
2206300018A,16,2,14,10,3,7,10,3,7,10,4,6,25,3,22,26,6,19,4,0,4,25,0,25,26,0,26
22063000040,613,134,479,586,31,555,603,39,564,609,109,497,1012,58,901,980,101,842,321,16,305,948,64,861,965,102,851
22041000033,227,56,171,177,18,159,174,19,155,185,31,154,194,31,163,194,32,162,141,19,122,263,39,224,265,38,225
220250009-1,59,0,59,60,1,59,59,1,58,61,5,56,61,1,60,59,6,52,31,3,28,87,2,85,92,1,91
220610010-2,72,14,58,51,0,51,47,1,46,50,3,46,86,11,75,83,15,68,28,2,26,103,12,90,104,19,84
22055000056,551,534,17,385,354,31,376,335,41,439,432,7,712,669,27,614,442,145,253,244,9,589,500,42,648,601,32
2204900025B,32,18,14,27,11,16,26,11,15,27,15,12,55,24,30,52,25,26,20,14,6,47,23,23,47,24,23
22051000004,427,195,232,358,62,296,367,44,323,377,165,208,552,151,383,543,121,413,270,61,209,629,159,456,630,193,428
22051000090,474,214,260,413,71,342,427,54,373,429,175,245,615,157,426,595,123,463,301,69,232,554,140,404,574,172,391
22051000097,376,173,203,322,70,252,326,55,271,330,142,188,431,114,296,440,93,344,224,54,170,483,134,346,478,164,304
22051000064,307,139,168,266,49,217,272,36,236,275,111,160,415,86,296,403,73,323,204,35,169,434,102,314,456,143,300
220710006-7,288,287,1,214,197,17,216,184,32,217,215,1,321,305,5,315,292,16,173,172,1,428,406,14,431,413,11
221270005-1,85,16,69,106,1,105,107,1,106,104,11,92,135,1,133,126,10,115,40,0,40,104,0,99,104,0,103
22065000018,42,42,0,38,33,5,38,36,2,39,36,3,66,65,0,56,51,4,0,0,0,50,46,2,58,55,3
22039001140,333,66,267,353,41,312,348,40,308,360,62,289,380,27,344,361,32,321,136,19,117,351,15,327,366,24,335
22039004021,11,0,11,10,0,10,10,0,10,9,0,9,16,0,16,15,0,15,5,0,5,6,0,6,7,0,7
2211100017A,60,7,53,76,3,73,76,1,75,79,5,74,126,8,117,125,19,106,53,4,49,99,10,89,95,11,84
220850002-5,158,34,124,151,22,129,152,24,128,155,25,129,173,22,150,176,28,146,79,13,66,194,26,162,203,22,176
221150006-4,334,45,289,324,11,313,325,14,311,327,43,277,391,8,373,377,21,348,170,3,167,456,16,428,477,26,448
2210500122A,251,68,183,216,19,197,223,12,211,219,50,169,378,46,318,372,52,308,120,11,109,459,49,395,463,55,407
22057002-3A,83,62,21,67,40,27,69,39,30,76,56,19,122,84,37,107,67,37,38,23,15,88,52,34,101,61,36
22115001-8A,180,80,100,189,55,134,189,63,126,199,88,106,292,100,187,279,88,184,97,37,60,256,89,154,265,95,159
22113020A-2,97,17,80,111,13,98,109,13,96,112,21,91,127,27,97,122,25,94,42,10,32,165,24,134,184,24,159
22039005050,87,5,82,84,6,78,84,6,78,84,9,75,95,3,92,91,2,89,39,1,38,111,4,107,113,5,108
22041000022,130,48,82,117,17,100,120,15,105,123,23,99,184,31,151,183,33,147,76,17,59,141,27,111,146,36,110
22023000008,41,7,34,42,0,42,41,3,38,43,7,34,41,3,38,38,1,35,21,3,18,98,10,84,95,14,79
22085003-7B,12,1,11,21,1,20,23,2,21,20,2,17,23,4,19,22,3,19,3,2,1,14,1,13,16,2,14
2201900313W,214,210,4,171,155,16,165,152,13,185,178,6,273,263,5,263,215,43,88,84,4,185,161,13,195,188,2
220570003-2,390,101,289,348,44,304,345,38,307,349,94,255,524,80,432,496,84,400,197,32,165,576,50,507,581,61,513
220070006-2,333,308,25,345,286,59,342,288,54,365,326,36,414,360,46,366,293,60,193,161,32,383,304,58,419,372,41
22009002-2B,230,164,66,195,119,76,199,115,84,224,165,59,269,162,96,240,138,91,108,76,32,231,98,118,266,134,127
22035000004,50,18,32,40,4,36,47,9,38,54,11,39,46,8,38,39,11,28,25,5,20,50,9,39,51,13,38
220090006-2,0,0,0,0,0,0,0,0,0,0,0,0,0,0,0,0,0,0,0,0,0,0,0,0,0,0,0
22005000022,449,157,292,421,37,384,429,37,392,428,137,287,575,71,484,559,99,451,174,25,149,772,109,650,767,122,627
22079000S6A,345,87,258,305,48,257,306,49,257,314,70,244,450,79,360,441,93,346,207,36,171,442,65,372,452,80,369
2210500070A,268,140,128,256,87,169,257,78,179,264,136,124,326,118,192,306,113,187,111,50,61,434,154,265,445,170,261
22073000044,720,124,596,599,31,568,597,31,566,603,54,549,928,63,833,891,83,796,288,19,269,995,82,895,1007,95,887
22011000013,224,52,172,235,13,222,234,7,227,241,50,191,342,14,317,342,22,307,112,12,100,363,7,347,376,17,356
2204900013A,61,10,51,51,5,46,53,3,50,55,6,49,111,3,106,104,7,95,24,2,22,72,5,67,72,6,66
220510012-G,276,116,160,278,60,218,286,37,249,294,125,168,368,83,254,356,57,291,205,33,172,425,92,330,422,115,294
2210700005A,74,70,4,64,57,7,71,69,2,70,63,7,81,65,13,70,54,15,51,46,5,92,56,33,88,66,21
2207300051A,499,51,448,462,17,445,462,21,441,470,37,430,713,31,665,707,60,636,242,6,236,734,19,694,740,35,694
2206300005C,109,20,89,106,11,95,105,7,98,105,25,80,200,10,187,191,20,164,51,8,43,222,2,214,224,5,217
22111000008,88,20,68,79,16,63,79,17,62,82,19,63,107,16,90,102,27,75,42,9,33,132,27,102,136,29,107
22049000020,62,58,4,50,45,5,51,37,14,54,49,4,74,68,4,64,56,3,50,47,3,55,45,7,65,59,4
22073000032,1022,197,825,859,62,797,871,71,800,898,114,783,1432,116,1261,1374,139,1219,426,32,394,1332,120,1172,1359,170,1165
22015002-23,122,73,49,80,34,46,84,32,52,86,44,42,233,86,120,215,85,126,69,29,40,208,71,131,217,90,124
220610003-6,56,15,41,57,4,53,57,3,54,59,9,50,67,4,62,62,5,57,25,3,22,103,5,96,106,5,101
2204900006A,37,37,0,28,25,3,26,21,5,33,32,1,42,42,0,38,34,2,20,20,0,40,35,2,46,44,0
2201900315W,284,173,111,253,103,150,252,91,161,258,157,100,375,143,211,371,125,237,180,70,110,270,101,164,261,99,156
220510009-K,386,184,202,328,79,249,330,65,265,337,146,189,513,166,322,498,138,350,271,65,206,514,155,332,519,181,331
2201502-12C,287,200,87,153,78,75,165,82,83,182,109,72,468,270,186,448,268,171,155,83,72,561,361,174,607,418,173
22105000124,337,111,226,295,67,228,297,61,236,304,117,184,245,28,213,240,30,201,78,10,68,501,92,403,511,103,399
22071015-19,415,411,4,310,280,30,318,252,66,346,339,4,567,554,7,536,503,21,238,232,6,602,557,19,698,691,3
22097000042,209,41,168,188,13,175,184,15,169,184,29,154,236,33,196,222,30,188,123,28,95,286,40,240,300,44,249
22105000033,214,87,127,210,41,169,214,50,164,211,95,114,352,69,278,332,69,245,131,30,101,399,63,322,409,78,325
220250009-4,134,45,89,123,18,105,121,18,103,131,26,105,155,35,117,154,43,110,64,14,50,121,23,93,127,33,93
22033003-53,708,307,401,629,148,481,636,143,493,641,246,388,871,231,591,856,217,618,518,136,382,899,196,671,907,232,650
22063000007,423,127,296,349,47,302,355,43,312,358,124,234,561,58,477,547,78,456,238,27,211,602,76,509,614,83,524
2206300039B,294,66,228,270,27,243,268,39,229,274,82,191,421,35,377,396,42,345,103,10,93,494,33,454,496,43,448
22115001-4D,2,0,2,1,0,1,1,0,1,1,0,1,1,0,1,1,0,1,3,0,3,2,0,2,2,0,2
22103000207,393,140,253,407,41,366,409,48,361,412,129,274,554,68,465,553,68,478,250,11,239,602,63,515,603,70,521
220670039-1,193,61,132,209,34,175,202,36,166,213,42,170,310,67,239,303,77,225,184,27,157,240,37,199,239,41,197
22053000017,164,34,130,132,17,115,130,16,114,134,30,103,231,23,198,219,25,189,85,24,61,291,19,262,302,27,272
22051000041,437,203,234,387,71,316,397,51,346,400,180,217,543,123,389,519,88,420,258,48,210,588,152,425,598,166,420
2207109-31A,375,375,0,267,246,21,275,231,44,299,298,0,445,434,3,418,375,26,214,211,3,428,398,10,445,423,14
2207109-43K,337,333,4,261,245,16,271,245,26,276,275,1,434,423,9,414,392,16,196,187,9,501,460,22,564,541,14
22125000007,433,287,146,400,158,242,405,145,260,423,241,182,569,335,216,531,276,244,282,137,145,543,258,271,569,318,238
220810007-1,88,48,40,90,29,61,89,32,57,100,38,62,126,43,79,119,57,60,70,28,42,100,25,71,110,37,70
22115001-2A,0,0,0,0,0,0,0,0,0,0,0,0,3,0,3,3,0,3,0,0,0,0,0,0,0,0,0
220250001-3,8,0,8,7,4,3,7,3,4,7,1,6,11,0,9,11,0,10,7,0,7,12,0,12,14,2,12
22123000015,67,7,60,85,0,85,85,0,85,84,3,80,82,9,73,81,8,71,41,6,35,93,2,88,94,2,92
22033003-43,791,274,517,731,128,603,738,105,633,738,234,495,1028,189,792,1015,184,813,632,116,516,1059,196,845,1043,217,811
22103000912,152,110,42,129,89,40,122,83,39,131,109,22,236,133,91,218,104,108,108,58,50,231,134,80,251,166,80
22019000323,368,330,38,321,242,79,318,235,83,346,310,33,460,365,85,453,319,128,193,164,29,224,152,54,255,206,44
22051000174,99,53,46,95,35,60,97,37,60,102,57,45,196,76,115,183,71,104,71,34,37,193,87,97,205,103,102
220510005-H,186,78,108,182,26,156,184,22,162,188,64,119,278,48,218,263,44,213,116,24,92,339,64,268,346,74,262
22115001-4A,5,0,5,10,0,10,9,0,9,13,2,11,25,0,23,23,2,21,4,0,4,18,2,13,17,0,17
22105000127,164,88,76,136,32,104,136,29,107,137,53,83,243,90,149,232,77,146,87,26,61,235,90,131,252,119,127
22009008-2B,191,25,166,197,11,186,189,11,178,192,26,166,225,10,213,210,19,181,81,8,73,267,3,259,266,6,259
22033003-45,819,322,497,736,157,579,746,143,603,743,282,458,1168,216,896,1151,217,915,625,123,502,1057,254,768,1076,306,740
22033003-66,800,311,489,686,135,551,706,121,585,704,248,455,785,146,603,775,148,611,423,84,339,1090,250,835,1081,268,790
22051000170,619,333,286,499,141,358,528,130,398,533,263,265,838,312,502,790,272,482,317,98,219,954,313,584,975,368,588
22089ZZZZZZ,0,0,0,0,0,0,0,0,0,0,0,0,0,0,0,0,0,0,0,0,0,0,0,0,0,0,0
220810007-2,76,36,40,81,23,58,89,32,57,87,37,49,121,35,81,115,49,66,66,24,42,115,28,80,123,37,84
22029005-2B,46,21,25,33,8,25,34,15,19,36,22,14,65,22,43,61,24,37,25,8,17,56,18,37,63,20,42
22115001-8F,0,0,0,0,0,0,0,0,0,0,0,0,0,0,0,0,0,0,0,0,0,0,0,0,0,0,0
220250003-3,3,0,3,6,0,6,6,0,6,4,1,1,4,0,4,5,0,5,1,0,1,3,0,3,4,0,4
22085008-1A,7,1,6,16,1,15,15,2,13,14,1,11,12,2,10,10,1,9,6,0,6,15,2,13,16,2,14
2201900160E,313,85,228,391,42,349,395,37,358,390,90,299,532,50,454,507,46,451,189,30,159,746,58,665,766,90,670
220070005-5,13,5,8,14,2,12,10,1,9,11,0,11,24,3,20,19,2,16,4,0,4,17,0,17,16,0,16
22039004040,99,34,65,83,12,71,72,13,59,91,33,58,108,6,101,89,24,64,38,2,36,119,5,112,126,3,123
220130003-4,58,37,21,56,23,33,57,26,31,59,33,26,76,40,32,75,39,35,31,18,13,77,48,28,70,41,29
22127003-2A,18,0,18,18,0,18,15,0,15,18,2,16,15,1,14,14,0,14,10,1,9,22,2,20,21,0,21
220610001-3,59,53,6,54,39,15,60,43,17,59,50,6,172,132,26,153,115,33,29,26,3,142,93,31,150,114,29
22051000138,126,105,21,92,60,32,95,53,42,99,78,21,170,132,35,162,113,43,75,48,27,143,97,35,164,124,36
2212100013B,92,92,0,74,71,3,72,70,2,82,82,0,106,106,0,100,97,2,56,55,1,124,112,7,121,118,2
220070002-5,72,23,49,79,13,66,82,12,70,82,34,48,95,18,73,87,11,71,55,9,46,117,26,86,116,26,83
22031000022,388,87,301,305,25,280,303,28,275,316,57,255,531,64,456,520,70,434,231,29,202,701,49,625,711,76,630
220610012-2,0,0,0,2,0,2,2,0,2,1,0,1,15,6,9,14,7,6,2,2,0,6,3,3,5,2,3
220250001-4,100,9,91,95,3,92,98,5,93,100,6,94,113,6,107,103,6,96,41,3,38,87,2,82,92,1,91
22111000009,85,41,44,48,16,32,46,17,29,54,24,30,106,48,53,89,44,44,30,18,12,84,26,56,93,31,58
220290005-2,66,22,44,60,11,49,66,17,49,64,20,44,75,24,48,67,19,47,20,10,10,68,18,45,76,21,55
220250003-4,15,0,15,12,0,12,11,1,10,11,0,11,21,0,21,20,0,19,11,3,8,12,0,12,16,0,16
220610012-5,5,3,2,1,1,0,3,3,0,3,3,0,23,12,10,22,11,8,4,1,3,20,9,11,21,7,14
220090002-2,7,4,3,7,2,5,7,2,5,8,3,5,4,2,2,4,2,2,5,0,5,0,0,0,0,0,0
22039004012,47,9,38,46,3,43,45,3,42,48,7,41,45,1,43,42,1,41,9,2,7,58,5,51,67,5,62
220610012-3,0,0,0,0,0,0,0,0,0,0,0,0,0,0,0,0,0,0,0,0,0,0,0,0,0,0,0
22127004-2A,18,3,15,18,3,15,17,3,14,18,0,18,28,1,27,25,5,19,3,0,3,17,0,17,18,0,18
22115001-3D,12,9,3,9,6,3,9,6,3,9,6,3,21,12,7,18,9,9,6,1,5,26,18,8,26,18,6
22105ZZZZZZ,0,0,0,0,0,0,0,0,0,0,0,0,0,0,0,0,0,0,0,0,0,0,0,0,0,0,0
22115001-8E,0,0,0,0,0,0,0,0,0,0,0,0,3,0,0,1,0,1,0,0,0,0,0,0,0,0,0
2201502-11A,140,99,41,70,36,34,68,34,34,74,49,25,263,151,110,245,134,104,71,38,33,255,156,92,276,180,94
22115001-3C,12,0,12,19,0,19,19,0,19,18,0,18,14,0,14,14,0,14,14,0,14,11,0,11,11,0,11
22009002-2D,14,9,5,16,9,7,15,9,6,15,10,5,19,10,9,16,10,6,12,7,5,27,15,11,26,14,11
22115001-7A,0,0,0,0,0,0,0,0,0,0,0,0,0,0,0,0,0,0,0,0,0,0,0,0,0,0,0
22115001-4C,5,5,0,6,2,4,6,2,4,6,6,0,6,0,6,5,0,5,4,1,3,10,5,5,10,5,5
22115001-8C,2,0,2,1,0,1,1,0,1,1,0,1,3,0,3,3,0,3,4,0,4,2,0,2,2,0,2
