GEOID20,Tot_2016_sen,D_2016_sen,R_2016_sen,Tot_2016_pres,D_2016_pres,R_2016_pres,Tot_2018_gov,D_2018_gov,R_2018_gov,Tot_2018_ag,D_2018_ag,R_2018_ag,Tot_2020_sen,D_2020_sen,R_2020_sen,Tot_2020_pres,D_2020_pres,R_2020_pres
460110VTD-5,2369,754,1615,2370,933,1236,2269,1271,964,2152,1101,1051,2752,1143,1609,2765,1216,1464
460110VTD-8,745,201,544,716,247,415,688,346,333,663,300,363,864,318,546,858,339,495
46011VTD-10,651,155,496,616,192,380,534,229,297,522,198,324,635,183,452,623,195,411
46099000N21,610,152,458,612,169,408,567,243,316,531,208,323,690,302,388,691,193,486
46099000N11,1419,333,1086,1415,387,950,1302,575,716,1233,497,736,1665,742,923,1667,514,1117
460990NVP16,978,231,747,986,271,652,945,423,509,881,363,518,1139,369,770,1146,331,782
460990N3-14,1479,485,994,1494,579,758,1428,774,629,1355,713,642,2088,867,1221,2109,920,1119
460990NVP-6,497,138,359,505,143,342,449,186,260,425,173,252,590,186,404,591,191,388
460990N3-12,1186,388,798,1205,433,686,1080,540,521,1030,497,533,1522,593,929,1541,617,876
460990N3-16,1354,310,1044,1361,450,819,1410,645,754,1320,588,732,2037,730,1307,2061,805,1201
460990N3-17,1726,421,1305,1732,608,1017,1612,812,788,1506,729,777,2340,914,1426,2373,1016,1309
460990000N3,531,130,401,534,157,347,452,178,272,436,170,266,423,131,292,415,136,274
460990000N5,1968,478,1490,1993,581,1279,1700,674,1009,1624,639,985,2529,769,1760,2544,833,1653
4609900N5-4,869,428,441,873,508,297,829,590,233,780,541,239,991,615,376,999,637,329
46099000N15,2761,695,2066,2764,858,1727,2484,1127,1329,2349,970,1379,3018,955,2063,3043,1029,1946
4609900N3-9,2014,721,1293,2080,830,1126,1483,858,599,1428,778,650,1962,839,1123,2001,903,1023
46099NVP-07,1667,409,1258,1660,488,1041,1535,739,776,1433,616,817,1991,618,1373,2004,616,1329
4609900N3-5,993,413,580,1031,430,534,808,479,313,774,433,341,1115,531,584,1129,545,552
4609900N4-5,951,374,577,971,396,502,877,491,372,826,453,373,2971,1203,1768,3057,1260,1750
4609900N4-1,695,333,362,703,351,295,591,376,200,560,356,204,1608,763,845,1646,801,794
46091VTD-A3,279,79,200,275,96,156,260,141,112,246,127,119,292,106,186,291,108,176
46037VTD-LT,137,53,84,132,45,78,135,77,56,129,73,56,135,58,77,132,45,82
46037VTD-AT,110,17,93,107,25,79,90,46,42,88,44,44,104,33,71,104,28,76
46101000V-3,548,147,401,541,151,357,514,225,276,495,192,303,600,244,356,593,160,418
460110VTD-6,2034,612,1422,2017,757,1090,1909,1003,874,1823,870,953,2221,878,1343,2224,933,1223
46011VTD-13,265,73,192,252,90,147,243,115,126,237,99,138,261,86,175,257,91,160
460110VTD-9,697,190,507,677,234,388,620,300,311,599,260,339,749,228,521,739,243,474
46037VTD-RR,203,76,127,206,66,124,217,135,73,203,118,85,228,86,142,234,77,156
460370VTD-6,194,88,106,191,89,94,203,122,81,194,114,80,248,119,129,250,117,129
46037VTD6W3,60,27,33,58,27,28,63,38,25,59,34,25,57,28,29,55,26,29
46037VTD-FP,188,74,114,189,84,100,212,131,78,203,114,89,230,93,137,228,92,129
46099000N13,893,214,679,897,233,617,804,337,451,755,281,474,1039,337,702,1033,254,748
46037VTD-GK,194,81,113,194,75,109,198,114,83,185,100,85,210,72,138,210,79,126
46037VTD-BR,245,83,162,241,78,141,233,130,101,213,102,111,256,89,167,253,85,162
460730VTD-5,109,24,85,105,24,75,110,52,55,102,43,59,118,22,96,117,21,94
460730VTD-2,149,33,116,148,32,109,149,59,90,142,62,80,148,37,111,150,37,113
46073VTD1-1,478,136,342,469,152,286,448,225,217,424,205,219,484,150,334,490,147,335
46057VTD-CW,693,159,534,693,166,483,704,270,430,660,235,425,771,196,575,774,190,564
460110VTD-1,380,134,246,402,166,189,348,217,125,324,188,136,600,256,344,611,272,313
46011VTD-11,687,202,485,696,250,371,599,307,278,570,266,304,791,286,505,794,304,460
46011VTD-12,297,52,245,262,64,187,224,82,140,224,71,153,290,74,216,281,79,197
46083VTD-15,1099,224,875,1090,270,745,1004,386,609,964,338,626,1243,320,923,1239,344,873
46083VTD212,790,235,555,794,304,439,749,375,367,719,335,384,927,386,541,927,413,496
46083VTD-H1,924,202,722,925,261,587,788,390,385,751,344,407,1249,414,835,1262,431,782
46083VTD213,1826,495,1331,1829,710,1003,2230,1113,1104,2124,1035,1089,3557,1470,2087,3582,1602,1903
46083VTD-02,259,76,183,256,58,187,231,92,136,225,78,147,276,76,200,278,67,203
460230VTD-1,394,121,273,400,117,267,457,235,219,452,221,231,476,173,303,476,156,314
460230VTD-8,168,30,138,172,22,143,172,74,96,165,61,104,183,35,148,184,21,159
460230VTD-5,316,113,203,319,106,210,362,213,146,351,204,147,363,143,220,364,133,229
46023VTD-10,101,9,92,107,12,91,144,29,115,140,20,120,151,17,134,150,11,134
46023VTD11b,253,33,220,253,38,209,227,84,140,227,75,152,258,47,211,261,49,208
46023VTD11c,197,23,174,195,27,163,180,66,112,178,58,120,219,38,181,218,37,178
46023VTD11a,235,29,206,239,38,195,217,77,136,207,64,143,247,44,203,238,44,191
460230VTD-9,383,53,330,378,51,320,387,139,245,375,106,269,406,65,341,403,55,345
46091VTD-A4,276,102,174,277,125,137,258,155,100,242,138,104,276,121,155,276,121,146
46019VTD-14,278,41,237,280,29,239,249,73,172,240,52,188,303,49,254,305,38,261
46019VTD-13,219,30,189,225,21,192,203,57,141,196,43,153,238,38,200,241,31,203
460190VTD-8,11,0,11,11,0,11,12,4,8,9,1,8,17,2,15,14,1,13
46091VTD-A7,178,55,123,172,62,100,186,98,87,172,85,87,210,83,127,208,74,133
46091VTD-A9,189,53,136,188,62,110,200,109,86,190,104,86,231,72,159,230,60,167
460150VTD-2,431,94,337,434,86,319,397,185,203,359,127,232,459,115,344,456,79,365
460150VTD-3,468,103,365,454,93,335,432,174,253,423,135,288,509,132,377,512,113,389
46005VTDW01,324,92,232,326,87,217,286,136,146,283,132,151,324,88,236,324,92,228
460050VTD-1,691,196,495,687,189,453,609,290,307,588,275,313,746,200,546,745,204,525
46005VTD-04,94,25,69,92,23,63,89,43,45,87,41,46,77,23,54,77,23,52
46005VTD-02,802,179,623,782,173,556,737,349,373,646,417,229,845,188,657,846,177,658
46005VTD-W2,650,245,405,650,230,365,542,284,253,508,243,265,622,216,406,625,237,364
46031VTD-BU,67,25,42,71,29,36,66,35,30,66,36,30,62,25,37,62,32,29
46031VTD-LC,32,11,21,30,11,18,30,16,14,29,18,11,39,7,32,39,8,30
460150VTD-5,326,70,256,326,71,238,313,132,176,299,110,189,368,100,268,364,86,267
46005VTD-W3,625,188,437,627,212,377,507,256,242,486,233,253,577,210,367,579,220,337
46137VTD-GV,70,12,58,69,10,59,61,34,27,61,28,33,64,12,52,62,8,54
46079004301,456,119,337,457,135,306,449,199,248,434,172,262,551,162,389,547,153,385
46079004304,239,61,178,235,69,152,237,116,119,218,77,141,281,85,196,278,77,196
460990000N4,1006,303,703,1017,307,647,954,425,513,908,374,534,1134,374,760,1143,360,754
4609900N3-6,983,470,513,998,515,383,819,525,275,784,487,297,1101,592,509,1113,611,447
46005VTD-05,573,132,441,544,141,389,512,249,261,473,251,222,539,137,402,528,144,382
46005VTDW72,589,152,437,574,159,376,526,251,271,503,227,276,677,203,474,680,234,434
46079004302,508,136,372,509,134,348,435,207,224,418,155,263,537,164,373,535,162,365
46079004303,173,32,141,175,33,127,185,78,106,178,56,122,215,43,172,215,41,168
46079004309,735,215,520,720,256,388,651,405,235,610,320,290,754,313,441,751,319,411
460090VTD-4,566,178,388,531,156,337,479,292,185,451,228,223,566,201,365,564,154,403
46005VTD-01,693,124,569,685,128,526,661,227,422,622,202,420,806,176,630,799,171,607
46137VTD-CC,75,52,23,77,69,7,75,61,11,71,61,10,102,69,33,99,82,11
46079004306,334,67,267,333,75,236,312,129,178,301,110,191,368,93,275,370,87,278
460090VTD-3,724,224,500,717,208,471,654,400,246,622,310,312,714,233,481,719,223,484
460970VTD-2,125,36,89,122,38,75,127,80,47,119,64,55,125,39,86,126,37,87
460970VTD-7,183,55,128,174,40,125,200,113,85,184,75,109,195,66,129,196,49,142
46079004308,2714,943,1771,2825,1082,1570,1429,766,647,1368,694,674,1369,561,808,1368,586,749
46079004307,474,124,350,462,160,290,469,216,251,454,185,269,536,193,343,537,187,345
460970VTD-4,140,34,106,137,44,81,147,81,63,130,61,69,152,48,104,151,53,96
460970VTD-5,83,16,67,83,18,63,81,39,42,77,36,41,72,19,53,72,18,52
46057VTD-ES,470,149,321,460,143,285,467,237,221,435,209,226,530,190,340,532,185,324
46137VTD-SD,208,78,130,203,65,124,206,121,83,200,109,91,240,97,143,242,98,140
46137VTD-RD,121,43,78,122,38,74,123,72,50,121,68,53,112,45,67,112,46,64
46137VTD-ND,27,9,18,26,9,17,28,17,11,28,17,11,43,17,26,42,17,25
46137VTD-RS,54,34,20,53,36,13,62,52,9,58,43,15,56,33,23,52,33,17
46031VTD-MI,134,26,108,131,25,102,108,42,65,108,43,65,132,25,107,131,26,101
46031VTD-AR,34,8,26,38,8,26,28,11,15,26,11,15,29,4,25,29,3,26
46031VTD-LE,101,70,31,101,78,17,94,80,13,94,80,14,89,62,27,91,70,19
46005VTDW71,651,165,486,649,183,433,574,259,304,538,234,304,671,187,484,670,198,448
46121VTD-JE,74,13,61,79,9,68,80,21,55,75,18,57,82,10,72,83,9,73
46057VTD-BY,318,53,265,312,54,240,293,101,188,277,75,202,331,64,267,332,64,264
46019VTD-25,302,45,257,307,61,224,294,88,203,285,79,206,381,71,310,383,83,295
46019VTD-16,699,103,596,706,86,577,641,195,434,628,152,476,806,143,663,811,134,659
46019VTD-20,238,50,188,243,48,181,226,91,131,217,78,139,241,46,195,242,38,199
46081VTD-S2,1703,506,1197,1695,491,1020,1503,641,833,1443,596,847,1870,638,1232,1929,731,1110
46081VTD-S3,1938,534,1404,1950,620,1165,1834,819,984,1769,739,1030,2001,602,1399,2024,709,1257
46081VTD-R2,2349,496,1853,2364,507,1689,2279,810,1432,2190,730,1460,3046,870,2176,3061,875,2102
46029VTD-D3,368,116,252,364,112,229,327,169,152,304,133,171,439,139,300,439,149,278
460290VTD-3,641,158,483,642,151,464,581,232,338,551,197,354,656,179,477,656,158,480
460290VTD-5,909,222,687,909,215,647,920,387,527,864,310,554,1005,239,766,1008,249,737
46029VTD-D4,173,63,110,175,59,104,153,81,67,144,74,70,209,82,127,214,83,124
46029VTD-C2,204,75,129,199,69,119,170,93,77,170,87,83,205,80,125,211,82,118
46029VTD-A4,400,88,312,398,113,263,357,159,193,331,131,200,447,121,326,451,134,306
46029VTD-A3,319,71,248,318,93,210,277,124,152,258,101,157,319,87,232,319,96,216
46029VTD-E2,306,70,236,304,77,211,331,115,215,323,105,218,369,83,286,373,97,271
46029VTD-E4,220,51,169,217,55,152,138,63,72,127,52,75,184,52,132,184,52,127
460290VTD-2,1217,288,929,1187,249,868,1118,443,662,1039,380,659,1195,303,892,1195,284,880
46029VTD-B3,325,84,241,328,90,209,292,128,158,278,112,166,344,105,239,345,109,224
460110VTD-4,1388,503,885,1405,622,677,1327,808,499,1244,700,544,1521,703,818,1537,747,744
46083VTD-16,906,173,733,912,213,639,863,300,554,832,271,561,1098,286,812,1100,314,767
46083VTD118,1114,207,907,1101,342,683,1076,449,621,1018,435,583,1523,498,1025,1526,568,926
46083VTD-T3,631,128,503,633,176,402,544,251,286,514,215,299,746,226,520,749,247,480
46083VTD112,1169,300,869,1164,423,646,1195,618,569,1128,567,561,1849,735,1114,1855,815,991
46083VTD-L3,314,72,242,301,92,195,296,133,160,279,115,164,368,108,260,368,110,251
46083VTD-L2,309,72,237,316,100,196,305,137,162,281,114,167,364,109,255,371,109,252
46083VTD-L1,318,73,245,316,95,197,309,138,164,283,115,168,385,115,270,394,115,265
46029VTD-A2,540,106,434,525,158,335,483,199,281,452,178,274,558,167,391,560,206,339
46029VTD-B1,533,122,411,529,145,358,505,201,296,478,182,296,577,141,436,579,164,401
46029VTD-B4,90,20,70,90,25,61,86,34,51,82,31,51,127,31,96,127,36,88
46029VTD-E5,110,25,85,109,30,74,104,41,61,98,37,61,101,25,76,99,28,69
46081VTD-LD,1357,450,907,1348,449,760,1168,578,542,1138,528,610,1549,643,906,1576,676,819
46081VTD-S1,1467,466,1001,1463,501,784,1357,712,623,1297,649,648,1729,638,1091,1722,643,998
46011VTD-15,185,61,124,181,75,95,174,98,74,166,85,81,188,76,112,187,81,102
46011VTD-16,461,109,352,442,135,269,388,173,208,377,150,227,487,130,357,479,138,325
46007VTD-27,352,112,240,353,101,235,372,160,205,356,152,204,385,111,274,390,112,269
460070VTD-4,168,11,157,169,7,150,147,18,123,141,19,122,165,18,147,170,17,152
460070VTD-1,260,148,112,266,183,70,231,180,48,220,166,54,253,172,81,257,194,59
460190VTD-6,50,4,46,49,1,48,45,9,36,42,4,38,45,7,38,44,2,41
460950VTD-2,195,62,133,189,71,109,186,108,75,178,87,91,214,89,125,217,88,126
460950VTD-4,258,69,189,260,68,174,272,127,139,262,115,147,306,101,205,299,91,200
460090VTD-2,512,105,407,506,108,371,483,255,222,453,189,264,505,132,373,508,110,389
460090VTD-5,637,149,488,641,127,487,598,247,342,573,196,377,637,142,495,640,129,499
460970VTD-8,129,24,105,126,23,92,112,38,70,110,34,76,111,21,90,111,19,88
460970VTD-6,189,47,142,183,41,132,188,84,103,175,69,106,183,53,130,177,45,127
46081VTD-W3,192,46,146,191,34,140,174,55,115,171,53,118,240,48,192,241,41,185
46081VTD-WW,469,109,360,463,84,345,432,137,287,420,128,292,764,149,615,746,128,584
46081VTD-W2,225,51,174,224,40,165,208,66,138,207,64,143,299,61,238,296,51,229
46081VTD-W1,174,41,133,175,31,129,159,50,106,156,48,108,236,46,190,233,40,181
46121VTD-RO,411,306,105,412,339,47,456,414,41,433,381,52,492,405,87,498,442,51
46121VTD-BO,56,37,19,58,43,12,63,54,9,63,53,10,63,40,23,66,49,16
46011VTD-14,1253,336,917,1202,415,702,1142,555,572,1104,481,623,1355,473,882,1337,502,802
460410VTD-7,246,183,63,249,202,30,274,263,10,266,252,14,287,231,56,290,250,33
46121VTD-OK,120,71,49,119,72,44,110,73,36,105,72,33,136,89,47,138,93,42
46081VTD-NM,349,105,244,347,99,224,280,105,165,274,103,171,377,142,235,373,128,236
46081VTD-R1,758,182,576,758,206,486,695,297,386,671,267,404,672,169,503,667,159,480
46081VTD-CC,53,12,41,52,14,34,50,20,28,48,19,29,31,8,23,31,7,22
46031VTD-CD,73,37,36,74,46,22,79,54,24,79,56,23,91,55,36,94,67,27
46015VTD-D4,498,133,365,491,145,311,453,232,215,433,189,244,454,159,295,455,153,290
46015VTD-D2,485,129,356,492,149,305,450,226,216,428,188,240,558,199,359,559,192,349
46015VTD-D3,92,25,67,91,27,57,85,42,40,79,34,45,143,51,92,144,50,90
460950VTD-5,191,78,113,189,84,95,204,132,65,192,107,85,210,97,113,211,105,98
460950VTD-3,44,15,29,45,15,24,49,28,20,47,24,23,41,16,25,42,14,25
4602500VTD3,151,30,121,146,38,103,139,61,77,137,48,89,142,34,108,142,31,107
461350VTD-1,9631,3089,6542,9623,3301,5659,9012,4757,4121,8615,3694,4921,10842,3848,6994,10900,4016,6581
46077000002,544,136,408,531,134,371,517,210,300,491,187,304,634,165,469,634,174,457
46077000005,494,129,365,486,128,334,461,200,253,430,165,265,548,152,396,546,153,384
460510VTD44,597,141,456,595,152,413,552,230,312,523,201,322,632,165,467,638,164,463
46081VTD-SO,257,56,201,262,49,193,240,96,134,234,65,169,349,76,273,335,61,265
46077000004,500,120,380,498,127,337,471,208,255,451,178,273,481,141,340,477,134,330
460110VTD-2,660,277,383,700,343,293,664,445,209,614,386,228,910,451,459,933,480,418
46029VTD-C1,303,76,227,304,85,198,269,119,148,258,104,154,332,99,233,332,106,220
46083VTD-T2,581,120,461,572,165,361,501,231,267,476,199,277,656,200,456,663,218,422
46083VTD-T1,612,128,484,610,173,382,533,246,281,503,213,290,762,232,530,763,251,491
460510VTD41,533,168,365,517,165,322,495,248,236,458,199,259,541,182,359,534,173,357
460510VTD43,636,140,496,639,138,458,558,204,346,532,174,358,681,162,519,683,161,505
46121VTD-PA,262,203,59,260,220,21,275,251,21,263,236,27,325,261,64,330,300,25
46019VTD-21,229,50,179,236,37,177,189,63,121,179,61,118,277,79,198,277,81,189
46083VTD-12,389,74,315,388,84,280,357,125,229,346,107,239,438,99,339,446,115,322
46083VTD-H2,1090,261,829,1083,304,676,1023,501,515,970,437,533,1412,446,966,1424,474,906
460870VTD-4,474,62,412,465,67,379,439,121,312,411,115,296,505,89,416,504,77,421
46037VTD-RW,172,55,117,173,58,109,185,99,85,175,84,91,186,69,117,188,64,122
46037VTD-BW,180,51,129,176,51,117,177,79,97,165,64,101,184,54,130,185,56,129
46037VTD2w2,159,52,107,160,56,101,147,81,64,139,74,65,165,50,115,164,50,111
46037VTD2W3,120,38,82,124,44,74,112,62,48,102,52,50,114,36,78,113,36,74
46033VTD6-1,396,111,285,396,115,250,343,130,207,337,132,205,416,141,275,416,146,260
460650VTD-5,244,62,182,239,80,149,250,140,107,246,146,100,247,63,184,244,74,164
46065VTD-34,822,154,668,792,199,546,734,331,394,712,343,369,867,208,659,848,242,585
460710VTD-7,244,162,82,249,187,50,261,211,46,257,218,39,250,189,61,250,203,41
46013VTD-19,974,327,647,972,372,547,941,518,412,901,467,434,1098,410,688,1101,427,652
46013VTD-21,255,121,134,263,138,113,263,173,87,248,156,92,266,134,132,270,140,126
46063VTD-LA,41,0,41,42,0,42,34,8,25,34,1,33,48,0,48,50,0,50
46063VTD-CC,117,21,96,122,4,110,104,49,54,96,30,66,121,22,99,120,15,102
46013VTD-15,986,216,770,952,246,651,822,332,479,804,299,505,1004,272,732,996,283,694
46013VTD-18,261,96,165,263,110,139,259,158,98,245,142,103,254,111,143,256,116,136
460650VTD-7,119,13,106,107,16,86,91,27,63,88,29,59,128,22,106,122,26,94
460690VTD-5,105,23,82,106,23,79,116,54,61,113,51,62,132,35,97,130,33,96
460690VTD-3,184,23,161,180,23,153,163,46,116,157,41,116,159,23,136,158,22,135
460690VTD-1,135,28,107,136,29,103,126,50,74,122,47,75,146,30,116,144,27,115
460690VTD-4,128,24,104,131,24,100,125,50,74,121,47,74,146,31,115,149,30,114
460690VTD-2,139,26,113,137,26,108,130,48,82,130,45,85,128,24,104,129,24,104
461090VTD14,143,63,80,143,71,61,127,82,43,121,78,43,145,71,74,144,74,67
461090VTD12,184,80,104,171,86,79,165,106,58,159,97,62,198,97,101,193,101,90
46109VTD-10,212,119,93,205,126,76,224,160,63,218,150,68,248,161,87,247,164,79
461090VTD-4,82,35,47,84,24,53,72,46,25,69,34,35,99,46,53,99,37,61
461090VTD-5,384,184,200,382,208,157,369,250,118,356,245,111,426,237,189,430,256,165
46103VTDDG7,1357,289,1068,1383,293,957,1075,388,663,1028,362,666,1576,444,1132,1610,485,1045
46103VTDHC1,1211,294,917,1219,297,838,1105,386,689,1071,364,707,1391,409,982,1400,418,943
46103VTDJS5,1289,323,966,1288,348,865,1198,433,743,1176,411,765,1415,408,1007,1423,430,957
46103VTD5-4,1555,660,895,1571,743,671,1434,903,518,1388,852,536,1659,859,800,1675,918,705
46103VTD1-3,2514,627,1887,2519,735,1620,2285,971,1284,2183,906,1277,2785,919,1866,2797,1003,1716
46103VTD-14,63,6,57,63,4,54,51,12,37,46,9,37,56,3,53,54,4,49
46039VTD-11,202,55,147,202,56,132,198,106,85,189,82,107,235,70,165,238,68,165
460390VTD-3,296,73,223,295,76,202,277,97,177,269,93,176,331,83,248,329,81,241
4602500VTD2,411,111,300,410,105,283,411,179,224,390,158,232,430,105,325,434,107,318
46103VTD2-3,1433,424,1009,1457,432,878,1197,535,632,1148,499,649,1796,603,1193,1822,652,1086
46103VTD4-2,1246,457,789,1259,439,696,1011,498,489,972,483,489,1365,585,780,1393,621,706
46103VTD2-5,196,92,104,203,88,91,177,103,67,170,99,71,221,123,98,225,125,86
46103VTD-F1,1143,299,844,1159,295,748,896,379,499,856,328,528,1206,361,845,1216,390,784
4602500VTD1,279,73,206,273,60,191,292,154,136,279,121,158,342,81,261,340,71,263
461150VTD-7,460,126,334,450,144,285,424,199,221,412,188,224,494,162,332,493,154,327
460750VTD-1,109,9,100,109,11,93,109,35,72,102,24,78,113,23,90,116,18,96
46075VTD-M1,92,10,82,91,10,74,92,29,58,87,23,64,104,21,83,102,16,84
461150VTD-8,144,43,101,145,42,96,145,75,69,138,66,72,157,63,94,158,49,102
461150VTD-1,410,90,320,394,96,276,392,151,238,386,132,254,427,91,336,422,94,323
461170VTD-1,1382,283,1099,1392,306,1009,1325,655,650,1313,769,544,1459,345,1114,1458,389,1044
460430VTD-1,378,33,345,376,27,341,334,42,288,338,46,292,409,35,374,397,15,382
460350VTD10,403,121,282,405,133,249,388,204,181,367,171,196,421,135,286,419,142,267
460430VTD-2,305,50,255,309,51,252,295,87,204,281,73,208,357,75,282,356,67,286
460430VTD-5,315,28,287,314,29,275,314,58,254,300,57,243,335,23,312,335,23,309
460490VTD-5,104,17,87,103,16,83,97,37,60,89,20,69,116,21,95,118,17,101
461150VTD-6,118,28,90,116,33,82,104,58,45,99,43,56,116,36,80,119,42,76
460390VTD-7,187,45,142,186,37,140,165,71,90,150,60,90,203,50,153,205,42,158
460030VTD-3,421,107,314,416,101,290,392,215,168,370,182,188,421,142,279,421,96,307
46045000006,156,38,118,158,39,111,144,62,79,134,54,80,154,41,113,155,35,120
460590VTD-4,52,5,47,53,9,42,46,20,26,43,14,29,39,4,35,39,7,30
460590VTD-6,176,48,128,179,46,124,180,76,98,169,67,102,206,54,152,206,53,149
460530VTD-2,766,161,605,762,160,569,810,446,356,753,317,436,823,190,633,819,171,643
461250VTD-1,837,168,669,831,163,621,762,280,471,723,240,483,879,199,680,879,195,657
460130VTD-4,546,181,365,569,206,309,513,284,220,488,256,232,687,270,417,699,281,395
46089VTDSEL,84,12,72,85,16,64,102,29,71,97,22,75,118,25,93,113,16,94
46089VTD-L2,55,11,44,55,14,37,64,21,41,61,15,46,88,18,70,89,15,70
46089VTD-L3,48,10,38,49,10,34,57,19,38,58,17,41,75,14,61,78,13,63
46077000001,501,153,348,506,167,297,498,252,235,466,200,266,641,218,423,647,224,404
46077000003,534,136,398,530,147,341,508,241,260,493,207,286,475,133,342,475,134,329
460590VTD-7,120,32,88,117,29,82,118,60,58,108,48,60,126,33,93,126,27,98
460590VTD-5,189,21,168,182,17,153,124,54,63,117,40,77,184,26,158,182,24,153
460590VTD-8,40,6,34,39,6,31,22,10,12,22,7,15,21,5,16,18,4,14
460530VTD-3,350,57,293,352,57,273,365,126,238,338,106,232,412,86,326,415,86,323
460850VTD-7,173,125,48,171,143,15,191,179,11,184,163,21,270,221,49,273,247,18
460590VTD-9,105,8,97,105,7,92,97,20,75,95,17,78,86,11,75,86,4,82
460590VTD10,41,2,39,37,2,33,35,7,28,33,5,28,49,7,42,47,5,42
460530VTD-1,981,208,773,977,174,758,978,457,513,925,354,571,1019,212,807,1024,198,805
46123VTD-WT,102,22,80,104,17,83,101,41,59,99,35,64,94,16,78,94,17,77
46123VTD-SU,99,26,73,96,22,69,106,52,53,103,39,64,102,22,80,105,26,77
460030VTD-1,314,60,254,307,62,230,273,102,165,268,91,177,319,72,247,319,57,254
46089VTD-SW,70,9,61,68,14,54,60,20,40,57,16,41,82,13,69,83,16,67
46089VTD-E2,155,25,130,158,34,113,129,45,81,125,37,88,149,28,121,151,29,118
46129VTD-09,87,15,72,88,11,67,68,23,44,67,19,48,85,18,67,88,17,69
46013VTD-20,154,61,93,157,69,79,163,99,62,154,89,65,155,70,85,155,72,80
460170VTD-1,206,87,119,206,94,104,225,130,91,213,117,96,226,110,116,227,110,112
46102VTD-RF,98,75,23,98,70,14,116,101,12,115,99,16,119,93,26,119,93,22
46102VTD-P1,614,502,112,630,581,30,637,605,22,620,591,29,685,597,88,684,615,45
460130VTD-3,1424,412,1012,1419,469,856,1244,619,608,1197,557,640,1505,547,958,1515,569,907
46013VTD-16,340,78,262,329,88,221,293,127,162,287,115,172,382,116,266,379,121,251
461110VTD-1,270,51,219,271,59,193,226,91,133,215,75,140,265,57,208,264,53,206
46123VTD-LM,341,72,269,337,54,273,334,129,200,325,104,221,364,75,289,362,68,290
46123VTD-W3,193,50,143,195,40,145,174,80,91,170,66,104,186,42,144,186,42,141
46123VTD-W2,354,67,287,350,77,265,325,149,172,313,109,204,366,78,288,365,80,279
46123VTD-E2,224,47,177,227,40,179,215,90,121,209,79,130,223,38,185,222,43,176
46123VTD-E3,311,48,263,310,54,241,295,127,164,288,97,191,324,62,262,327,60,261
460210VTD-4,166,14,152,170,23,145,149,41,107,148,48,100,172,24,148,174,24,148
461270VTD-8,1085,260,825,1082,329,670,902,397,487,855,337,518,1144,327,817,1149,375,741
461270VTD-4,142,36,106,136,41,91,113,51,60,113,43,70,166,45,121,171,60,109
461270VTD-7,342,97,245,336,109,214,281,126,153,275,115,160,384,122,262,379,124,249
461270VTD-3,270,65,205,267,81,175,224,90,132,216,81,135,246,73,173,249,75,172
460170VTD-3,123,85,38,125,101,15,145,130,13,139,122,17,155,114,41,157,129,21
460170VTD-2,160,85,75,159,101,52,178,143,34,172,128,44,164,98,66,165,113,50
46129VTD-05,320,82,238,322,78,224,298,123,172,288,136,152,341,79,262,342,94,237
46129VTD-07,465,112,353,464,117,335,405,142,260,399,179,220,485,115,370,486,132,344
460210VTD-1,178,21,157,178,31,138,150,37,111,148,59,89,178,28,150,183,27,152
46033VTD-SD,677,155,522,680,155,492,617,227,370,601,201,400,749,209,540,755,213,525
46033VTD8-1,123,36,87,126,39,73,125,55,67,119,47,72,157,53,104,156,54,97
46033VTD7-1,219,55,164,208,51,134,203,76,118,199,69,130,242,81,161,247,80,160
46103VTD-19,536,89,447,540,63,441,463,124,329,443,103,340,598,96,502,610,92,493
46103VTD-11,56,7,49,57,5,49,51,12,39,48,9,39,84,14,70,86,10,76
46103VTD-15,382,48,334,392,58,314,352,96,243,334,107,227,434,69,365,432,67,359
46103VTD333,437,95,342,451,105,305,401,167,227,384,146,238,1060,370,690,1079,396,648
46103VTD-10,554,118,436,556,100,432,502,141,356,486,127,359,654,113,541,661,110,532
46103VTD-12,80,4,76,84,4,76,74,19,52,73,7,66,89,13,76,91,7,83
46045000004,266,73,193,269,58,183,222,99,123,204,95,109,266,70,196,268,60,199
46045000003,252,42,210,251,39,203,219,78,139,199,65,134,278,45,233,276,44,228
46045000002,437,96,341,440,93,320,374,160,208,359,135,224,439,101,338,434,93,334
46103VTD2-4,2232,819,1413,2243,794,1189,1889,1055,785,1811,957,854,2464,1093,1371,2496,1131,1236
46035VTD-C5,172,35,137,167,38,123,163,69,94,155,57,98,193,42,151,195,45,147
460350000C4,507,96,411,510,110,369,492,204,281,463,178,285,594,139,455,594,143,434
46035VTD-08,450,108,342,445,134,280,364,175,181,347,155,192,634,204,430,634,218,405
46035VTD-09,421,117,304,423,139,250,387,188,190,370,164,206,520,164,356,517,173,332
460550VTD-1,111,8,103,107,8,96,91,27,62,90,16,74,94,5,89,93,4,88
461150VTD-4,329,66,263,332,82,239,300,137,158,282,119,163,346,97,249,346,96,247
460030VTD-2,153,32,121,153,23,120,148,54,90,145,40,105,149,30,119,146,17,128
46127VTD-B2,333,83,250,336,100,217,313,158,152,299,142,157,346,104,242,349,117,222
46127VTD-B3,286,71,215,275,84,183,264,134,129,250,119,131,330,101,229,331,111,215
461270VTD-1,262,54,208,263,72,180,227,87,139,224,81,143,286,78,208,286,79,204
46127VTD-A2,120,33,87,119,40,75,108,53,54,106,46,60,126,43,83,125,43,80
46045000005,369,53,316,364,53,295,332,118,211,322,109,213,374,73,301,374,67,302
461090VTD-3,186,60,126,175,62,104,190,97,88,166,91,75,218,84,134,219,71,141
461090VTD-8,113,47,66,111,48,56,99,68,30,94,56,38,123,51,72,124,48,71
46055VTD-20,187,13,174,189,6,180,171,33,136,166,29,137,220,20,200,220,19,201
46123VTD-ID,81,11,70,80,14,62,71,24,46,68,18,50,82,9,73,82,19,62
46102VTD-PO,400,320,80,400,357,25,462,437,17,452,429,23,515,434,81,515,465,40
460750VTD-5,173,29,144,174,16,147,161,40,121,155,37,118,177,19,158,176,20,154
460710VTD-2,112,20,92,114,17,94,96,23,73,88,20,68,118,24,94,117,25,92
46071VTD3W3,143,21,122,145,17,122,120,37,80,112,30,82,132,17,115,132,13,118
460710VTD-3,109,13,96,111,11,97,94,27,66,89,22,67,123,14,109,121,8,113
46089VTD-NW,84,4,80,79,10,69,74,19,55,71,15,56,87,12,75,87,12,73
46089VTD-E1,149,13,136,158,24,129,131,36,91,130,34,96,162,27,135,161,28,127
460670VTD-1,629,104,525,623,113,479,609,180,419,582,164,418,726,118,608,728,122,593
460670VTD-7,268,41,227,265,35,223,277,85,191,271,67,204,301,43,258,304,32,271
460670VTD-6,431,71,360,433,68,350,390,133,255,380,106,274,444,69,375,445,62,376
460670VTD-4,460,101,359,460,105,337,517,198,316,503,227,276,563,120,443,563,101,457
460670VTD-5,682,138,544,674,175,461,655,302,347,625,265,360,752,192,560,756,213,529
460670VTD-2,776,133,643,767,175,547,712,250,457,676,218,458,815,199,616,816,202,594
46102VTD-P3,461,372,89,465,415,32,480,443,33,474,443,31,563,486,77,561,512,38
460670VTD-3,142,21,121,143,21,120,130,32,97,127,32,95,153,31,122,155,30,124
46109VTD-11,736,278,458,737,319,381,719,419,291,687,397,290,806,373,433,814,406,392
46013VTD-22,264,104,160,271,118,135,253,154,96,240,139,101,253,117,136,257,122,129
460130VTD-1,1197,355,842,1204,403,712,1064,543,503,1018,489,529,1333,482,851,1342,502,806
460130VTD-8,913,285,628,934,324,531,776,410,354,742,369,373,1072,425,647,1089,441,612
46129VTD-08,78,10,68,84,3,78,81,17,61,77,22,55,89,9,80,92,5,86
46013VTD-13,398,133,265,399,151,224,358,190,163,343,171,172,396,151,245,397,157,232
461150VTD-5,204,65,139,201,69,121,207,101,104,195,98,97,266,65,201,268,60,206
460390VTD-4,186,48,138,185,65,105,165,82,80,151,62,89,186,47,139,187,46,136
460710VTD-8,65,22,43,63,23,36,79,46,32,79,47,32,70,34,36,72,34,36
46065VTD-28,517,125,392,529,162,320,531,296,226,519,307,212,562,179,383,570,207,340
46065VTD-29,287,83,204,296,107,167,299,170,124,293,177,116,333,124,209,339,144,185
46039VTD-10,171,35,136,169,50,111,162,64,95,153,57,96,194,50,144,193,50,141
460870VTD-6,327,63,264,324,58,232,320,139,177,309,111,198,353,93,260,354,77,273
461050VTD-5,143,24,119,147,18,125,115,18,94,112,17,95,143,21,122,146,19,124
461050VTD-7,126,5,121,128,5,120,103,18,79,99,12,87,118,1,117,122,6,116
46093VTD-21,383,60,323,389,55,313,312,87,216,302,89,213,560,108,452,560,98,438
46027VTD-W1,411,102,309,410,121,271,368,166,196,342,140,202,431,118,313,426,123,297
46027VTD-W2,373,111,262,375,143,204,346,192,146,323,171,152,392,134,258,396,134,250
46027VTD-W3,953,350,603,943,412,472,911,547,356,867,481,386,1109,451,658,1118,519,574
46107VTD-02,243,49,194,248,42,192,227,79,144,214,70,144,248,43,205,249,43,203
46107VTD-01,272,54,218,265,45,214,253,82,169,241,72,169,291,48,243,286,48,237
46107VTD-36,0,0,0,0,0,0,0,0,0,0,0,0,0,0,0,0,0,0
46027VTDSE2,578,258,320,573,345,189,538,375,161,522,361,161,782,437,345,784,480,282
461050VTD-2,108,15,93,107,13,88,87,26,59,82,17,65,119,19,100,122,17,103
461050VTD-9,81,7,74,81,4,72,71,19,51,68,9,59,81,12,69,82,5,76
461050VTD-8,66,2,64,66,2,59,53,14,38,48,9,39,66,2,64,69,5,64
46047VTD-CA,158,36,122,163,33,122,164,43,120,159,40,119,214,39,175,215,43,168
46047VTD-JA,882,203,679,891,188,653,818,241,560,811,253,558,1055,238,817,1066,254,794
46093VTD-09,147,19,128,146,17,121,142,41,97,134,27,107,166,27,139,171,26,141
46093VTD-30,85,5,80,85,2,83,77,10,67,68,9,59,78,4,74,79,3,76
46107VTD-05,241,44,197,240,37,194,205,51,151,196,45,151,235,37,198,236,38,195
46107VTD-03,281,52,229,280,44,225,251,75,173,238,66,172,321,51,270,320,52,264
46107VTD-04,303,54,249,304,47,246,273,86,184,258,74,184,289,45,244,289,46,240
46027VTDNW1,566,269,297,578,315,219,509,357,148,494,321,173,538,281,257,542,310,218
46027VTDNW2,365,156,209,363,187,156,335,223,107,325,198,127,513,272,241,521,297,208
460710VTD-1,42,3,39,41,2,39,32,2,30,33,3,30,44,2,42,42,2,40
46047VTD-H1,422,137,285,429,121,271,358,129,218,348,140,208,470,150,320,472,160,294
46065VTD-11,1436,251,1185,1371,326,967,1241,516,709,1201,536,665,1477,314,1163,1432,365,1033
46129VTD-03,416,52,364,409,46,347,397,113,276,383,103,280,419,59,360,423,44,370
46013VTD-10,396,138,258,412,157,218,341,201,133,321,181,140,477,197,280,488,205,265
461110VTD-2,314,63,251,313,54,239,307,129,172,293,120,173,347,84,263,346,74,268
46047VTD-BE,133,20,113,138,9,122,128,31,93,129,29,100,144,12,132,147,12,131
46093VTD-ES,243,63,180,243,68,156,209,84,120,204,80,124,271,91,180,275,89,174
46047VTD-OA,128,6,122,127,5,118,129,30,97,124,21,103,160,17,143,160,20,138
46047VTD-OE,68,8,60,70,8,59,69,17,51,69,15,54,68,8,60,72,9,60
46047VTD-H2,455,130,325,458,136,298,394,154,234,391,159,232,504,151,353,512,167,329
46047VTD-H4,333,104,229,328,97,202,310,140,164,292,122,170,365,116,249,371,127,233
46093VTD-13,1053,217,836,1064,194,767,921,291,601,893,258,635,1194,257,937,1209,267,892
46093VTD-18,91,11,80,93,7,77,82,21,58,76,12,64,95,13,82,98,12,79
46093VTD-23,413,102,311,434,93,274,231,97,131,226,96,130,559,171,388,575,183,361
46093VTD-11,736,162,574,735,167,511,672,231,428,649,211,438,812,191,621,817,202,585
460490VTD-1,185,43,142,190,38,139,185,69,114,172,43,129,181,34,147,181,34,146
461170VTD-3,103,13,90,102,13,82,95,31,64,89,50,39,115,20,95,115,20,92
460990N4-11,1805,499,1306,1795,643,1035,1502,723,764,1407,620,787,2109,791,1318,2143,888,1214
4609900N4-7,1263,487,776,1276,571,618,1110,629,467,1062,591,471,1474,698,776,1493,760,698
460990NVP02,1539,347,1192,1545,433,1015,1730,682,1032,1662,611,1051,2030,609,1421,2032,637,1348
460990N4-10,940,321,619,954,368,499,797,415,370,745,383,362,1006,427,579,1018,464,528
4609900N5-2,608,303,305,621,345,217,545,387,149,521,368,153,736,453,283,744,464,251
4609900N5-1,613,306,307,630,350,221,555,395,152,540,380,160,704,435,269,717,446,240
4609900N5-3,426,180,246,422,204,168,358,220,128,343,217,126,466,264,202,471,265,180
4609900N5-8,934,402,532,926,514,346,916,633,276,877,584,293,1034,602,432,1032,659,345
4609900N5-9,523,203,320,522,242,219,432,289,133,402,246,156,517,288,229,523,299,193
460990N5-10,681,294,387,683,322,304,593,372,210,558,332,226,683,345,338,685,373,291
46101000V-4,368,85,283,370,86,264,352,154,194,333,139,194,398,132,266,393,117,271
46101000V-5,658,159,499,663,160,469,635,256,369,597,220,377,731,214,517,735,179,544
46101V-3/4B,345,98,247,340,114,210,336,157,175,324,159,165,383,125,258,372,116,249
46101000V-1,509,230,279,501,253,224,510,336,164,492,316,176,564,310,254,566,304,254
46029VTD-E1,610,183,427,612,163,398,664,307,346,622,256,366,901,258,643,905,254,625
46057VTD-HI,401,41,360,401,46,338,362,75,283,353,56,297,436,43,393,435,40,391
460990N2-14,2302,667,1635,2295,917,1251,2342,1242,1088,2231,1146,1085,3241,1329,1912,3258,1494,1708
46101000V-2,525,251,274,518,279,207,506,341,162,483,300,183,544,318,226,547,303,215
4609900N4-6,307,146,161,315,136,156,306,189,112,293,176,117,382,177,205,385,189,187
46099NVP-08,685,178,507,689,187,460,650,282,360,609,228,381,750,234,516,744,205,520
4609900N5-6,1054,403,651,1059,466,518,944,588,345,900,529,371,1167,595,572,1171,613,512
460990N3-15,1257,395,862,1261,504,643,1138,609,514,1074,580,494,1343,562,781,1346,623,690
4609900N2-7,2273,575,1698,2272,818,1309,1907,894,995,1809,830,979,2509,951,1558,2507,1048,1406
4609900N4-3,510,229,281,513,243,223,416,262,148,396,241,155,533,274,259,543,280,237
4609900N4-8,546,224,322,553,262,253,517,292,218,492,273,219,557,265,292,563,286,265
460990NVP01,755,173,582,768,183,528,650,237,398,616,220,396,835,227,608,842,220,591
460990N5-13,703,246,457,679,322,299,651,388,257,614,372,242,733,385,348,739,390,322
4609900N1-5,681,260,421,688,295,345,504,284,211,484,258,226,663,320,343,668,341,303
4609900N1-4,1028,393,635,1046,449,521,760,430,316,727,387,340,960,464,496,966,494,439
460990NVP10,1129,332,797,1137,367,684,1055,504,542,1007,451,556,1319,447,872,1325,420,870
4609900N2-1,1239,408,831,1255,532,632,1159,622,532,1122,602,520,1353,594,759,1352,621,700
4609900NVP9,1236,305,931,1243,351,801,1114,500,595,1049,446,603,1459,547,912,1467,441,988
4609900N5-7,604,233,371,603,303,260,588,374,210,566,358,208,673,373,300,667,394,257
460990N5-20,1015,425,590,1008,443,451,876,512,348,832,460,372,1081,514,567,1101,531,520
460990N3-11,974,245,729,964,356,548,905,444,457,865,434,431,1075,403,672,1076,445,603
460990NVP17,634,147,487,640,170,427,614,246,366,578,220,358,749,212,537,749,217,513
4609900N2-6,1323,402,921,1309,538,684,1220,661,543,1147,610,537,1401,608,793,1420,666,713
46019VTD-26,248,52,196,252,35,184,212,76,129,202,63,139,257,58,199,260,51,197
46037VTD1w1,288,92,196,288,93,173,276,132,140,254,113,141,288,96,192,288,109,176
4609900N2-3,1220,396,824,1231,536,616,1135,639,484,1085,600,485,1268,587,681,1281,656,589
4609900N2-9,1101,370,731,1098,478,560,1056,601,447,1011,550,461,1205,558,647,1201,606,566
4609900N1-6,1328,500,828,1326,564,662,1120,603,502,1077,568,509,1392,595,797,1402,645,720
460990N5-14,906,411,495,918,434,385,784,487,280,744,458,286,946,502,444,958,511,401
460730VTD-4,102,34,68,101,23,71,83,42,41,77,33,44,104,36,68,104,31,70
46091VTD-A8,191,60,131,190,71,106,195,124,70,181,109,72,213,82,131,208,78,126
46091VTD-A6,288,97,191,281,115,150,301,141,156,295,145,150,331,130,201,329,148,179
46091VTD-A5,177,52,125,173,66,97,165,92,70,159,86,73,199,83,116,201,87,111
46083VTD-23,533,134,399,529,130,347,495,219,261,474,181,293,640,164,476,640,161,452
46083VTD-C3,288,74,214,276,92,174,248,121,126,230,104,126,286,92,194,287,100,184
46083VTD-C2,264,67,197,271,87,167,233,114,118,220,102,118,322,102,220,326,111,204
46083VTD-C1,366,92,274,372,120,225,318,157,159,296,137,159,399,126,273,401,135,253
46083VTD114,858,217,641,852,282,501,748,394,347,710,342,368,1003,377,626,1011,405,572
46083VTD-08,217,51,166,217,62,145,208,83,125,203,80,123,246,76,170,247,68,171
46083VTD-C4,223,68,155,217,85,120,194,107,83,181,89,92,266,97,169,267,99,156
46083VTD-C5,259,78,181,263,101,140,232,128,100,211,104,107,271,97,174,271,99,157
46083VTD113,685,213,472,694,272,364,580,338,238,553,284,269,770,351,419,774,355,391
460110VTD-3,692,288,404,742,356,309,651,423,215,600,366,234,914,461,453,942,490,412
46083VTD116,690,202,488,692,267,375,555,305,246,534,278,256,811,331,480,826,349,458
461190VTD-6,138,31,107,137,32,101,140,66,72,139,66,73,145,36,109,146,39,105
461190VTD-1,146,20,126,155,20,119,146,45,95,142,46,96,178,31,147,181,35,139
461190VTD-2,90,11,79,89,11,74,76,22,53,76,22,54,90,14,76,89,15,73
46119VTD3-2,105,17,88,107,17,85,100,38,61,99,38,61,127,22,105,129,25,102
46119VTD2-2,125,21,104,128,21,98,127,48,76,124,48,76,135,23,112,137,25,108
460090VTD-1,584,114,470,579,105,439,533,214,308,516,188,328,568,126,442,570,105,460
460410VTD-6,141,30,111,142,24,114,131,67,64,127,53,74,144,31,113,144,24,119
46079004305,427,110,317,425,128,275,438,220,213,418,183,235,518,161,357,514,154,349
46079004310,648,224,424,645,242,346,602,333,262,576,290,286,756,294,462,758,302,435
46029VTD-A1,979,172,807,974,221,698,937,371,557,893,339,554,1144,269,875,1139,306,807
46083VTD-13,272,61,211,272,65,195,275,104,168,266,92,174,362,77,285,367,84,279
46029VTD-B2,859,269,590,855,295,478,766,411,342,730,363,367,954,334,620,956,358,558
46023VTD12c,32,8,24,32,8,22,30,18,12,30,16,14,41,13,28,43,6,33
46023VTD12a,41,9,32,43,9,31,40,25,15,40,21,19,36,12,24,33,4,28
46023VTD12b,31,7,24,29,7,20,30,18,12,28,15,13,15,3,12,16,3,13
46051VTD2-1,504,127,377,502,156,319,420,183,221,402,145,257,540,152,388,541,161,364
460510VTD42,315,66,249,312,81,218,286,109,176,272,94,178,329,77,252,332,86,243
460230VTD-2,185,64,121,184,50,125,186,110,74,179,93,86,201,74,127,201,65,134
46019VTD-18,122,28,94,120,23,87,104,29,73,99,29,70,124,27,97,124,25,88
46019VTD-17,371,53,318,373,51,301,327,90,229,319,76,243,410,65,345,416,60,349
460410VTD-9,67,36,31,70,33,31,66,48,18,62,42,20,75,41,34,76,47,28
46041VTD-13,87,49,38,90,56,30,102,91,11,99,78,21,95,55,40,94,59,32
46041VTD-12,139,77,62,139,87,46,163,142,20,155,122,33,168,99,69,169,108,58
46041VTD-11,45,31,14,47,33,11,55,52,3,53,47,6,53,44,9,55,45,7
46041VTD-10,40,27,13,42,31,9,49,45,4,47,42,5,55,44,11,54,46,7
460510VDT46,208,60,148,211,52,148,197,90,107,191,74,117,218,51,167,220,55,156
46041VTD-15,156,79,77,152,83,63,172,140,30,170,123,47,194,105,89,198,119,76
460410VTD-2,41,3,38,41,3,37,39,6,33,37,7,30,46,3,43,46,2,42
460410VTD-4,294,65,229,299,62,216,313,161,144,300,153,147,338,87,251,345,89,244
460410VTD-3,32,7,25,29,6,22,31,17,14,32,17,15,36,10,26,36,10,26
46041VTD-14,281,178,103,282,199,67,312,286,24,306,265,41,327,239,88,328,261,60
46091VTD-A1,229,75,154,230,90,122,239,125,109,225,117,108,242,94,148,239,98,139
46037VTD3W3,157,51,106,153,50,97,165,86,76,157,79,78,166,53,113,164,55,106
46119VTD2-1,135,21,114,132,21,107,121,45,74,119,45,74,139,23,116,136,25,110
461190VTD-5,115,15,100,113,15,95,102,32,69,102,32,70,113,19,94,112,21,89
46025VTD-W3,188,45,143,185,51,117,193,89,102,182,69,113,216,54,162,214,58,150
460390VTD-1,149,39,110,147,43,90,142,67,74,134,63,71,166,46,120,169,51,117
46103VTD3-3,857,213,644,868,275,547,862,378,475,843,358,485,1217,408,809,1217,457,721
46103VTD4-1,416,151,265,422,149,228,390,192,185,375,175,200,474,196,278,484,202,252
46103VTD4-3,902,288,614,906,303,547,781,385,389,757,363,394,1007,411,596,1024,438,547
46103VTD5-3,2141,668,1473,2147,716,1249,1915,904,985,1842,808,1034,2233,827,1406,2249,885,1290
460610VTD-3,298,66,232,296,50,236,272,124,145,251,101,150,310,66,244,309,58,245
460610VTD-5,116,21,95,115,16,98,124,43,81,118,32,86,213,22,191,213,19,193
46035VTD-C2,386,71,315,383,52,311,365,139,216,350,106,244,413,91,322,411,82,323
46035VTD-C1,287,59,228,288,62,219,258,114,143,243,103,140,366,78,288,361,67,288
460430VTD-4,334,64,270,330,69,245,299,106,192,283,94,189,284,58,226,294,62,218
46089VTDNEL,163,23,140,125,19,103,131,36,93,124,21,103,205,36,169,204,31,171
46089VTD-L1,79,15,64,66,14,46,59,17,41,61,15,46,62,13,49,63,13,49
46089VTD-E3,151,24,127,156,23,124,138,42,95,135,36,99,171,31,140,170,33,136
46089VTD-CN,77,9,68,75,9,63,70,20,49,64,16,48,74,13,61,76,13,63
46103VTD-K3,535,127,408,542,125,387,494,179,304,476,163,313,595,155,440,597,165,416
461030VTD-9,469,88,381,480,102,355,413,124,283,402,114,288,468,96,372,470,102,358
46103VTDRK4,1238,228,1010,1262,266,929,1083,323,742,1058,303,755,1467,353,1114,1478,387,1065
46103VTD3-4,2845,888,1957,2855,981,1633,2605,1292,1285,2522,1197,1325,3117,1201,1916,3123,1298,1737
461030VTD-6,458,125,333,456,137,273,427,181,239,414,170,244,497,170,327,491,183,297
46055VTD-16,210,17,193,213,17,188,185,27,154,176,30,146,223,23,200,225,23,199
46123VTD-CL,373,70,303,376,62,302,356,141,212,336,98,238,405,69,336,403,63,334
46123VTD-CF,137,30,107,143,27,108,138,49,82,132,44,88,156,28,128,160,28,128
460490VTD-3,138,19,119,137,23,109,116,36,80,115,29,86,130,23,107,130,19,110
460490VTD-6,515,98,417,503,101,372,467,190,267,448,129,319,535,105,430,529,105,408
460430VTD-3,273,53,220,276,38,225,254,70,182,241,57,184,319,44,275,325,49,273
460590VTD-2,82,16,66,80,18,60,77,27,49,75,26,49,87,16,71,87,10,74
46085VTD-12,381,70,311,373,60,293,356,149,201,334,113,221,403,80,323,396,84,306
460850VTD-4,318,86,232,321,92,216,312,136,167,304,113,191,333,111,222,336,95,233
460850VTD-6,140,31,109,138,33,100,125,56,65,119,48,71,139,40,99,138,37,101
46129VTD-02,151,31,120,152,20,122,154,55,94,150,53,97,168,21,147,169,26,141
460350VTD12,308,79,229,302,102,184,288,139,146,277,122,155,365,114,251,367,121,236
460350VTD13,281,72,209,275,92,170,262,128,133,250,109,141,191,58,133,192,66,123
46013VTD-14,260,98,162,265,112,137,260,157,100,247,141,106,273,122,151,276,127,143
46123VTD-LK,160,17,143,161,18,138,146,59,87,142,39,103,161,22,139,161,17,144
46105VTD-L1,288,50,238,285,47,219,214,70,141,201,86,115,287,56,231,291,58,225
46105VTD-L3,275,43,232,275,40,215,239,56,179,228,67,161,276,43,233,280,42,229
461050VTD-3,12,1,11,12,1,11,13,3,10,11,3,8,20,2,18,20,2,18
46013VTD-12,771,167,604,744,191,511,634,257,368,619,231,388,765,207,558,761,216,529
460130VTD-9,912,227,685,892,258,579,764,342,410,739,308,431,926,304,622,928,316,590
460850VTD-9,247,30,217,251,22,213,239,86,148,219,60,159,270,45,225,267,32,230
460590VTD-1,148,14,134,150,13,134,134,34,97,132,29,103,141,24,117,140,19,120
460590VTD-3,82,7,75,77,3,74,67,16,51,65,14,51,86,10,76,82,9,72
46127VTD-10,406,92,314,417,122,275,335,125,207,325,126,199,412,112,300,418,128,283
461270VTD-9,514,104,410,525,134,366,424,137,286,414,133,281,651,160,491,653,181,461
46045000001,433,94,339,436,98,321,417,154,258,405,149,256,476,118,358,478,118,355
460350VTD16,370,93,277,365,133,211,250,130,116,240,121,119,339,122,217,336,126,202
46103VTD-17,205,20,185,211,20,180,203,31,169,196,35,161,219,31,188,219,29,185
46103VTD5-2,1766,620,1146,1782,644,950,1546,780,738,1485,717,768,1949,827,1122,1984,854,1037
46103VTD5-1,505,183,322,511,198,263,447,231,208,432,226,206,622,273,349,643,312,302
46013VTD-17,615,228,387,620,260,328,607,356,244,578,321,257,639,245,394,639,255,373
461250VTD-2,942,190,752,934,208,664,846,354,481,811,293,518,1044,269,775,1045,279,736
461090VTD-2,443,111,332,441,110,303,415,156,255,402,142,260,512,145,367,512,129,377
461090VTD-6,60,13,47,57,14,42,58,25,33,55,25,30,81,24,57,80,26,54
461090VTD-7,478,119,359,477,129,316,467,201,261,436,189,247,516,144,372,523,164,349
460390VTD-5,177,59,118,176,58,99,171,100,69,165,87,78,213,75,138,214,74,130
46127VTD-13,1713,299,1414,1729,411,1260,1547,420,1108,1517,398,1119,2186,507,1679,2212,628,1544
460350VTD11,418,113,305,412,139,250,378,195,177,357,164,193,399,126,273,405,134,259
46035VTD-C3,659,138,521,656,151,472,652,243,400,621,220,401,591,130,461,592,119,462
460350VT-14,361,111,250,363,126,214,333,175,151,318,162,156,470,147,323,472,160,302
460130VTD-2,669,232,437,681,264,369,621,348,263,591,314,277,726,307,419,736,320,397
460610VTD-4,276,50,226,281,38,230,269,79,185,260,75,185,317,51,266,320,44,271
460210VTD-5,142,13,129,145,12,133,136,30,105,136,38,98,164,22,142,163,17,146
46059VTDM3b,119,26,93,117,27,80,111,48,59,105,42,63,116,28,88,116,31,82
46059VTD-M2,232,50,182,229,53,159,215,100,114,209,84,125,230,55,175,230,63,165
46059VTD-12,89,17,72,88,18,65,86,39,46,79,31,48,109,27,82,107,29,77
460610VTD-1,917,223,694,963,233,689,582,216,358,569,198,371,1107,305,802,1129,323,787
461250VTD-3,325,58,267,319,64,242,285,101,182,268,86,182,337,76,261,340,77,255
461090VTD-9,447,111,336,447,145,278,428,211,211,399,175,224,475,154,321,473,150,319
461090VTD-1,172,36,136,169,49,113,143,71,71,137,64,73,158,42,116,158,44,110
461250VTD-5,544,112,432,550,139,384,522,226,290,490,181,309,617,164,453,617,163,437
460870VTD-1,515,147,368,508,150,322,481,231,243,460,200,260,624,215,409,624,198,410
460870VTD-3,547,113,434,545,126,383,526,220,294,498,204,294,617,185,432,610,174,417
460210VTD-3,175,20,155,175,20,152,163,37,124,160,64,96,172,22,150,172,20,151
461250VTD-7,176,45,131,174,53,102,172,97,75,163,82,81,207,63,144,207,62,137
461110VTD-4,295,77,218,289,63,210,260,104,149,245,89,156,314,71,243,322,65,245
460870VTD-2,151,51,100,147,42,102,141,72,65,137,68,69,168,47,121,169,46,118
461110VTD-5,254,53,201,250,65,177,235,95,139,226,89,137,253,69,184,253,65,186
46013VTD-11,541,187,354,557,213,299,502,280,214,477,252,225,649,271,378,659,282,358
460130VTD-7,2022,501,1521,1958,569,1286,1699,778,900,1648,700,948,2052,639,1413,2052,665,1340
460210VTD-2,166,19,147,163,19,136,134,28,103,135,43,92,181,26,155,181,29,150
46129VTD-04,170,42,128,170,40,120,144,53,84,140,44,96,164,55,109,165,55,106
46129VTD-06,478,94,384,487,111,346,442,161,274,426,183,243,503,131,372,503,151,345
46129VTD-01,140,24,116,148,16,127,134,32,101,135,35,100,154,17,137,153,16,136
46129VTD-10,152,20,132,153,15,130,136,33,102,134,45,89,157,21,136,159,25,132
46033VTD-BR,1240,322,918,1234,305,845,1176,402,763,1156,382,774,1398,387,1011,1402,404,963
46033VTD-BG,191,54,137,194,54,132,171,70,97,165,69,96,204,54,150,211,59,150
460030VTD-7,331,82,249,330,93,206,294,143,143,276,127,149,322,93,229,327,88,231
460030VTD-5,197,62,135,201,61,128,173,93,78,164,81,83,194,66,128,192,59,132
46102VTD-BA,147,95,52,150,94,44,158,120,37,154,114,40,162,109,53,163,113,47
46033VTD-PR,355,109,246,354,96,240,346,120,223,335,113,222,462,124,338,472,129,341
46127VTD-12,776,147,629,780,199,545,627,194,426,613,181,432,700,178,522,712,209,484
46127VTD-B1,226,65,161,239,67,146,215,101,110,203,89,114,232,71,161,241,69,158
461270VTD-5,112,30,82,110,31,76,103,48,54,98,41,57,128,38,90,124,37,86
460710VTD-5,84,15,69,93,5,85,71,20,47,69,9,60,96,18,78,100,11,85
46093VTD-15,407,89,318,412,81,298,351,125,219,337,111,226,443,99,344,452,106,333
46093VTD-19,749,156,593,748,154,518,664,232,412,635,204,431,843,228,615,860,233,590
46093VTD-06,690,150,540,690,123,512,648,227,403,618,190,428,926,205,721,926,206,692
46093VTD-NW,461,100,361,475,112,316,401,143,242,380,136,244,533,134,399,548,139,385
46093VTD-08,315,65,250,314,64,232,310,114,185,301,106,195,378,90,288,381,99,277
46065VTD-33,467,104,363,468,135,296,456,228,221,445,237,208,475,124,351,470,144,312
460870VTD-5,606,163,443,598,180,376,590,300,284,552,249,303,640,206,434,639,197,429
46065VTD-24,606,172,434,625,223,354,676,421,245,667,437,230,668,243,425,679,282,377
46065VTD-32,492,100,392,482,130,320,478,228,243,465,237,228,504,123,381,493,142,338
46093VTD-17,84,10,74,88,6,81,85,18,66,80,18,62,100,7,93,99,8,90
460990N4-14,384,183,201,389,193,163,326,210,109,309,196,113,740,350,390,760,369,366
460990N4-12,1105,391,714,1108,463,568,1044,577,457,996,539,457,1389,669,720,1399,696,665
460990N1-17,1357,351,1006,1370,461,801,1108,591,506,1051,498,553,1578,610,968,1583,652,886
46005VTDW81,635,182,453,621,233,354,566,258,298,547,249,298,658,212,446,654,242,396
46005VTDW82,531,129,402,535,154,346,499,230,260,475,210,265,548,146,402,554,165,377
460970VTD-3,105,27,78,102,26,62,112,62,50,101,49,52,134,38,96,131,41,84
46031VTD-LO,76,6,70,77,3,73,74,18,56,73,16,57,101,10,91,101,8,93
46031VTD-SM,183,95,88,188,113,66,190,142,42,189,149,40,203,137,66,209,144,61
46137VTD-DV,180,92,88,183,99,67,229,184,45,221,172,49,250,162,88,256,170,79
460970VTD-1,137,45,92,137,51,76,138,73,63,130,69,61,174,55,119,174,58,111
46121VTDMNA,433,301,132,440,322,85,483,419,62,466,378,88,545,428,117,548,444,94
46121VTD-SA,306,204,102,308,215,69,336,284,47,326,256,70,374,268,106,380,292,79
46057VTD-ND,632,111,521,620,117,471,625,191,429,606,166,440,696,133,563,698,139,550
46029VTD-D1,503,143,360,497,144,322,450,212,231,418,188,230,605,165,440,604,180,413
46083VTD-21,220,56,164,222,62,148,217,96,118,211,85,126,246,62,184,249,58,180
46083VTD-26,233,51,182,221,54,164,218,88,130,206,76,130,243,64,179,241,60,181
46083VTD-B3,66,14,52,72,17,45,61,25,36,63,23,40,81,23,58,82,20,59
46083VTD-B1,86,19,67,91,22,60,82,32,48,80,29,51,94,26,68,99,26,71
46083VTD-B2,47,10,37,48,11,34,45,17,27,42,15,27,50,14,36,53,13,39
46083VTD210,1614,349,1265,1578,522,997,1516,630,881,1459,630,829,1810,608,1202,1811,694,1080
46083VTD-11,217,56,161,218,65,137,208,85,121,197,78,119,259,79,180,260,76,178
46007VTD-02,124,38,86,120,41,71,120,57,60,116,57,59,89,33,56,89,35,53
46007VTD-05,122,38,84,120,39,71,119,56,60,111,54,57,148,55,93,150,59,88
46007VTD-06,114,35,79,121,41,69,113,52,57,108,52,56,126,48,78,127,49,73
46121VTD-LA,105,10,95,107,11,90,108,28,78,101,28,73,142,28,114,143,35,104
46031VTD-MT,115,25,90,118,14,99,100,42,57,93,34,59,130,19,111,129,18,111
46083VTD211,1698,410,1288,1702,625,1006,1743,793,942,1689,779,910,2187,820,1367,2182,929,1218
46033VTD-HE,907,185,722,919,163,706,853,254,590,837,225,612,1133,249,884,1137,249,863
460370VTD-5,53,21,32,51,21,29,52,30,21,51,26,25,48,14,34,49,14,35
46037VTD5W2,62,22,40,55,23,30,60,33,26,58,30,28,86,28,58,86,27,59
46037VTD5W1,72,26,46,69,27,37,72,40,29,64,34,30,60,20,40,59,18,40
461250VTD-4,280,53,227,279,60,204,302,102,198,283,104,179,320,83,237,318,82,230
460130VTD-6,1843,503,1340,1812,572,1133,1595,790,782,1536,712,824,2009,651,1358,2008,677,1286
461250VTD-6,489,129,360,503,135,332,450,198,251,428,157,271,527,120,407,531,125,393
46103VTD2-2,95,26,69,98,24,61,69,32,34,63,29,34,113,39,74,117,41,68
46103VTD1-2,1901,551,1350,1906,590,1146,1703,802,874,1623,722,901,2138,758,1380,2159,795,1275
46103VTD-23,1271,279,992,1281,341,854,1149,414,720,1118,400,718,1373,405,968,1379,433,918
46103VTD1-1,1429,359,1070,1438,393,900,1326,554,749,1266,495,771,1791,605,1186,1801,648,1093
46103VTD3-5,348,86,262,344,102,221,316,136,179,303,128,175,417,138,279,423,153,260
46103VTD-E1,70,13,57,71,15,52,61,18,42,60,17,43,69,11,58,69,11,58
461150VTD-9,516,155,361,512,178,279,458,279,173,442,240,202,508,193,315,507,207,287
46115VTD-10,485,163,322,474,195,244,467,252,203,440,212,228,499,188,311,501,199,287
461150VTD-3,327,80,247,327,80,232,310,142,165,306,126,180,351,91,260,349,97,249
460350VTD15,568,165,403,566,175,358,536,282,245,513,273,240,619,222,397,621,231,373
461250VTD-8,567,116,451,560,139,388,528,198,324,507,182,325,611,152,459,611,156,445
46059VTD-M1,236,54,182,227,55,162,218,107,109,212,88,124,242,50,192,238,56,177
46059VTDM3a,141,29,112,138,31,100,132,65,65,125,53,72,136,28,108,132,32,98
46102VTD-CN,53,32,21,52,37,15,64,47,17,64,44,20,74,54,20,74,51,19
46033VTD-FB,140,27,113,140,20,114,142,41,97,137,31,106,175,28,147,177,26,146
46033VTD-EM,154,34,120,159,27,125,126,34,92,124,26,98,179,40,139,181,42,134
46103VTD1-4,962,260,702,957,275,620,893,388,488,852,340,512,1297,420,877,1304,471,777
46103VTD-F2,1522,341,1181,1565,330,1094,1341,520,781,1285,446,839,1833,490,1343,1879,524,1282
46071VTD4W1,76,12,64,76,13,59,60,21,36,57,17,40,86,14,72,87,16,69
46071VTD4W2,88,15,73,89,17,69,68,26,41,68,23,45,76,11,65,77,14,63
46055VTD-19,199,24,175,196,21,162,189,44,143,186,45,141,230,26,204,229,21,207
46123VTD-HM,97,10,87,96,10,83,84,25,58,81,20,61,94,15,79,95,8,84
46089VTD101,59,10,49,63,5,56,39,5,34,39,7,32,48,5,43,49,3,44
46102VTD-OG,430,332,98,432,366,33,422,383,34,413,377,36,416,351,65,414,374,35
46065VTD-21,430,131,299,453,170,244,445,273,165,439,284,155,492,196,296,510,227,263
46027VTDSE1,743,327,416,729,412,265,733,488,238,697,461,236,742,413,329,741,454,265
46093VTD-RS,321,66,255,318,58,228,303,121,177,293,101,192,353,85,268,352,91,243
46093VTD-16,353,88,265,355,98,236,304,118,182,301,107,194,355,103,252,356,110,231
460390VTD-8,253,69,184,254,71,168,261,105,146,256,99,157,308,75,233,310,70,237
460650VTD-9,91,43,48,99,55,39,117,88,28,117,91,26,127,76,51,136,88,45
46047VTD-EA,142,25,117,139,20,115,122,32,89,118,30,88,176,31,145,172,31,140
46047VTD-E2,127,22,105,130,22,98,108,29,76,104,27,77,117,22,95,120,22,94
46047VTD-E1,131,24,107,130,20,101,108,29,78,108,29,79,141,23,118,142,23,114
46047VTD-E3,128,24,104,132,20,99,109,28,76,105,28,77,141,24,117,143,24,113
46093VTD-NE,127,42,85,127,33,79,112,53,52,108,59,49,165,59,106,165,55,99
46093VTD-SS,361,85,276,359,89,241,306,135,164,292,117,175,402,119,283,406,125,260
46093VTD-00,181,40,141,181,42,122,160,74,83,156,64,92,213,52,161,214,59,147
46102VTD-KY,494,375,119,499,433,41,528,486,31,513,481,32,523,443,80,526,468,45
46093VTD-6A,133,19,114,135,21,104,132,49,82,124,39,85,153,21,132,155,25,129
46093VTD-31,258,39,219,259,18,225,227,56,170,211,49,162,265,32,233,269,18,240
4609900N4-9,902,375,527,918,438,412,733,468,248,687,411,276,938,467,471,950,474,444
4609900N4-2,755,324,431,755,351,328,663,418,234,633,389,244,829,436,393,839,443,355
460990N4-13,792,332,460,789,402,335,683,436,237,648,398,250,803,421,382,807,440,338
46019VTD-27,246,39,207,248,42,185,207,66,136,199,57,142,260,52,208,263,57,201
46019VTD-12,97,11,86,98,15,79,89,21,68,89,19,70,103,16,87,104,14,90
46019VTD-28,369,83,286,365,83,253,315,128,182,307,92,215,416,96,320,416,107,300
46023VTD-3b,168,65,103,163,63,91,162,114,48,161,99,62,183,89,94,180,89,89
46023VTD-3c,169,65,104,170,65,94,170,117,50,165,100,65,215,105,110,216,105,105
46023VTD-3a,171,65,106,171,65,97,177,120,53,166,101,65,150,73,77,149,73,72
460990N3-10,1603,381,1222,1603,596,919,1429,693,720,1350,633,717,1684,639,1045,1693,715,947
460990N5-21,458,153,305,456,201,230,426,246,176,404,242,162,476,251,225,473,264,200
4609900N2-2,1541,433,1108,1538,618,815,1463,772,686,1402,767,635,1638,720,918,1640,818,788
460990NVP12,132,30,102,130,27,94,127,46,81,117,43,74,153,50,103,153,29,120
46091VTD-A2,163,56,107,161,67,78,173,108,63,158,95,63,193,82,111,196,84,110
46083VTD-06,455,89,366,458,116,312,420,150,265,407,138,269,523,135,388,524,124,384
46083VTD215,997,206,791,982,328,594,1024,452,567,978,423,555,1334,441,893,1349,523,793
46031VTD-GV,67,4,63,70,3,63,61,11,50,60,9,51,80,7,73,80,4,76
46081VTD-DW,542,213,329,550,231,277,519,289,211,517,286,231,580,268,312,594,288,285
46121VTD-SF,333,231,102,342,274,51,330,287,41,309,257,52,343,267,76,353,299,48
46019VTD-22,182,49,133,183,42,131,158,59,96,153,59,94,220,58,162,221,61,149
46037VTD4W1,183,55,128,180,62,107,180,96,82,161,87,74,199,71,128,202,74,128
46103VTD4-4,990,435,555,997,402,464,863,495,340,828,470,358,1106,512,594,1122,557,520
46103VTD-24,994,201,793,997,215,708,895,301,577,873,276,597,1151,293,858,1167,341,793
46103VTD2-1,119,48,71,121,51,61,99,49,47,92,43,49,133,61,72,134,66,60
46103VTDN34,1080,270,810,1094,273,722,902,339,539,867,312,555,1249,347,902,1272,383,844
46105VTD-12,326,51,275,324,38,270,293,97,194,280,76,204,347,68,279,344,60,280
460390VTD-9,280,62,218,276,53,207,272,118,146,258,104,154,302,73,229,303,65,235
460490VTD-4,96,20,76,95,18,74,98,26,71,96,28,68,98,17,81,98,14,83
46035VTD-20,745,206,539,735,231,459,650,306,336,621,269,352,682,224,458,687,241,430
460850VTD-1,68,20,48,68,6,58,76,34,41,74,26,48,69,15,54,73,10,62
46103VTD4-5,826,242,584,830,242,507,714,336,370,696,305,391,1020,338,682,1034,363,626
46103VTD5-5,355,109,246,352,115,215,358,166,189,350,156,194,443,161,282,450,185,255
46063VTD-HI,114,13,101,112,7,101,106,33,72,100,21,79,122,13,109,128,7,117
460130VTD-5,423,143,280,441,162,236,393,222,163,372,200,172,530,235,295,544,244,279
46093VTD-27,139,21,118,138,12,115,121,36,82,111,26,85,126,20,106,126,16,107
461090VTD13,286,120,166,290,149,125,269,170,96,263,162,101,291,138,153,291,158,129
46065VTD-26,548,127,421,550,165,344,527,266,252,513,276,237,578,177,401,580,205,357
46093VTD-29,34,7,27,34,4,29,33,6,22,35,7,28,30,4,26,31,4,27
46093VTD-20,50,12,38,52,6,42,51,27,22,47,14,33,56,14,42,57,9,44
46023VTD-13,68,24,44,69,24,44,68,30,38,69,34,35,82,31,51,81,29,52
46031VTD-BH,60,39,21,63,57,5,67,57,8,68,64,4,61,53,8,64,61,3
46137VTD-BR,31,25,6,34,27,7,38,31,5,37,30,7,41,23,18,41,27,14
460990N5-18,1018,479,539,1028,535,402,928,605,310,877,557,320,1244,718,526,1254,732,468
4609900N4-4,778,362,416,795,377,350,648,405,226,608,361,247,883,432,451,885,435,411
46031VTD-RL,63,13,50,62,13,49,59,19,40,59,22,37,60,13,47,62,13,49
46031VTD-KN,56,46,10,60,54,6,56,47,9,54,47,7,72,61,11,75,64,11
46029VTD-C3,582,210,372,582,217,315,466,255,206,435,223,212,719,221,498,738,229,475
46029VTD-D2,482,141,341,474,146,291,401,195,200,380,181,199,524,145,379,524,148,356
46057VTD-OX,149,14,135,147,17,125,137,33,104,135,24,111,163,20,143,168,18,147
46051VTD2-2,802,188,614,788,227,504,712,324,382,668,269,399,808,237,571,797,256,530
4602500VTD5,325,56,269,321,59,237,329,144,183,314,116,198,367,69,298,365,69,289
46063VTD-RE,124,4,120,124,3,118,115,13,100,115,10,105,129,8,121,131,2,125
46063VTD-LU,88,9,79,91,5,81,77,17,59,76,8,68,92,6,86,94,2,91
46093VTD-WS,152,40,112,152,44,94,124,53,67,122,49,73,146,50,96,153,55,84
46027VTD-C2,258,155,103,256,165,74,166,140,25,161,134,27,424,287,137,427,308,104
461050VTD-4,58,11,47,59,9,49,52,12,39,52,17,35,59,10,49,63,10,52
46027VTDNE2,160,86,74,161,99,46,134,85,43,132,81,51,246,128,118,250,144,97
460390VTD-6,196,49,147,190,61,112,176,83,91,164,80,84,204,59,145,202,62,139
46075VTD-M2,84,9,75,81,16,60,79,31,47,82,23,59,88,15,73,90,15,73
460750VTD-3,18,1,17,17,2,14,20,7,13,18,4,14,20,3,17,20,3,16
46075VTD-M3,85,9,76,86,14,62,85,31,50,76,19,57,94,18,76,95,18,75
46093VTD-SE,485,110,375,482,102,337,427,187,229,416,167,249,507,131,376,506,142,350
460490VTD-2,93,9,84,90,8,81,112,30,82,106,18,88,128,13,115,126,9,116
460990N5-11,687,258,429,696,307,330,637,364,260,602,314,288,803,380,423,815,399,377
460990N5-17,617,224,393,610,265,307,560,305,249,535,306,229,646,311,335,649,322,304
460990N5-12,725,262,463,729,327,351,674,411,256,638,372,266,821,411,410,834,444,360
4609900N1-9,1189,383,806,1179,481,611,1096,591,490,1049,541,508,1302,565,737,1313,620,660
460230VTD-4,178,91,87,173,94,73,193,146,44,186,124,62,199,116,83,199,124,73
46019VTD-23,228,43,185,233,40,174,178,69,105,177,56,121,234,52,182,240,56,174
46085VTD-13,102,16,86,99,13,82,101,42,58,96,27,69,115,21,94,114,20,92
461050VTD-6,122,22,100,122,11,105,104,35,69,102,25,77,128,15,113,130,15,114
460350VTD19,442,113,329,440,129,276,406,202,199,391,182,209,532,176,356,535,188,337
46065VTD-31,880,178,702,844,231,573,823,401,413,803,416,387,842,212,630,825,245,560
461170VTD-2,72,7,65,73,10,57,67,18,48,64,19,45,78,13,65,79,12,67
46093VTD-40,36,5,31,34,6,28,35,11,24,32,11,21,36,8,28,35,5,28
46127VTD-A3,126,35,91,124,40,76,114,56,56,111,49,62,146,50,96,146,50,93
46127VTD-A1,132,36,96,131,43,83,122,60,61,115,51,64,122,42,80,120,42,78
46065VTD-30,801,214,587,815,277,479,842,471,359,826,489,337,897,285,612,900,330,544
4609900N1-3,1092,394,698,1114,474,575,906,501,400,874,469,405,1063,480,583,1066,520,520
46023VTD-6a,68,31,37,65,32,32,75,60,14,75,52,23,79,45,34,77,43,34
460230VTD6B,74,35,39,75,36,36,76,60,15,75,53,22,83,46,37,82,46,36
46023VTD-6c,69,32,37,69,33,32,74,57,15,70,50,20,72,41,31,71,38,31
46031VTD-WK,93,69,24,92,81,6,98,93,3,98,92,6,115,105,10,117,104,11
46083VTD-14,402,89,313,399,106,270,385,156,227,373,137,236,496,140,356,501,156,331
46057VTD-HZ,126,9,117,129,12,109,128,16,109,124,16,108,143,11,132,144,11,132
460410VTD-5,61,18,43,61,17,39,61,46,14,59,26,33,62,22,40,65,17,48
46033VTD8-2,305,89,216,311,96,182,307,138,165,294,117,177,341,117,224,340,120,213
46065VTD-23,490,134,356,505,174,290,497,288,200,487,299,188,566,200,366,575,232,325
460710VTD-6,117,26,91,114,31,71,106,41,62,104,36,68,118,34,84,117,33,81
46027VTD-C1,360,222,138,363,259,78,334,283,46,326,266,60,209,141,68,209,152,52
46093VTD-24,184,33,151,186,29,147,176,44,130,169,38,131,252,57,195,250,54,189
46093VTD-12,793,116,677,797,116,631,791,220,563,763,193,570,1167,204,963,1171,226,914
46093VTD-35,51,3,48,50,0,48,45,8,35,43,4,39,51,3,48,52,0,51
460990N1-10,1387,466,921,1393,549,740,1140,626,496,1078,555,523,1453,626,827,1472,659,763
460730VTD-3,143,34,109,144,33,107,133,55,75,122,49,73,143,32,111,145,34,109
46025VTD4-1,163,55,108,161,39,101,145,73,71,136,52,84,180,56,124,181,51,126
46103VTD-18,264,73,191,267,61,179,207,85,119,203,81,122,287,72,215,293,69,207
460610VTD-2,356,91,265,351,87,244,363,185,176,338,151,187,413,120,293,417,113,297
46055VTD-17,203,16,187,204,20,181,182,42,136,176,39,137,228,21,207,230,30,199
46063VTD-BU,159,18,141,163,11,140,142,34,107,135,25,110,163,18,145,166,14,148
46063VTD-FI,57,4,53,57,5,48,48,8,40,46,6,40,60,5,55,60,7,53
46035VTD-06,395,86,309,390,123,254,368,163,203,346,144,202,359,116,243,358,123,228
46035VTD-07,488,109,379,483,153,316,457,203,252,431,179,252,431,138,293,435,148,276
46127VTD-11,1008,286,722,1028,324,658,766,307,454,736,294,442,1166,356,810,1190,397,765
46103VTD3-1,681,209,472,682,236,377,614,300,299,584,263,321,746,305,441,751,332,391
460350VTD17,71,20,51,70,27,39,58,29,27,53,24,29,60,22,38,61,23,36
460350VTD18,275,78,197,274,106,153,219,110,108,215,100,115,254,92,162,262,98,153
46102VTD-MA,175,114,61,179,157,7,169,156,11,160,148,12,144,124,20,144,138,6
46027VTDNE1,317,125,192,318,150,135,270,183,86,262,162,100,278,145,133,284,162,109
46047VTD-H3,432,129,303,428,142,253,375,162,203,369,165,204,447,162,285,450,161,270
460990N3-13,815,235,580,814,316,438,715,349,359,684,325,359,853,344,509,868,358,488
4609900N2-8,1272,342,930,1248,463,720,1245,617,622,1178,563,615,1395,583,812,1400,637,727
46083VTD115,891,280,611,890,361,459,776,463,306,733,411,322,991,469,522,1000,504,474
46083VTD111,1395,317,1078,1405,454,902,1421,567,846,1367,536,831,1691,522,1169,1681,639,1022
460230VTD-7,124,34,90,127,38,87,125,61,62,119,52,67,142,49,93,141,46,94
460550VTD-4,130,6,124,135,5,129,127,23,103,124,17,107,143,11,132,140,8,132
46063VTD-PG,58,5,53,59,3,55,60,12,48,58,9,49,65,1,64,64,2,62
46103VTD3-2,3045,663,2382,3020,792,2028,2811,1087,1690,2720,1012,1708,3279,983,2296,3281,1112,2104
46025VTD4-2,160,38,122,161,46,107,155,68,86,146,59,87,170,51,119,174,50,120
46019VTD-24,346,71,275,351,74,251,296,104,191,290,94,196,363,92,271,367,90,259
46019VTD-11,69,6,63,71,8,63,63,12,50,58,9,49,75,10,65,74,10,64
46093VTD-SW,297,71,226,305,83,200,244,103,134,236,84,152,298,86,212,304,97,196
46093VTD-10,964,178,786,957,181,704,859,289,556,832,282,550,1135,287,848,1143,301,801
46093VTD-33,71,12,59,78,5,69,72,17,46,68,7,61,76,11,65,83,6,77
46093VTD-14,373,69,304,377,64,268,313,111,189,298,97,201,411,106,305,414,111,288
46029VTD-C4,276,88,188,279,78,181,245,133,109,230,117,113,378,116,262,386,118,252
46093VTD-CS,236,70,166,238,60,155,201,99,99,189,85,104,277,86,191,279,100,165
46029VTD-E3,794,162,632,798,184,579,653,225,424,633,204,429,813,185,628,817,211,594
46093VTD-41,51,8,43,52,5,46,51,13,33,45,12,33,57,9,48,56,2,52
46093VTD-25,39,5,34,39,4,34,36,8,27,30,9,21,42,4,38,43,3,40
460990N5-19,540,177,363,544,234,279,553,304,243,530,290,240,575,271,304,578,293,277
46123VTDSE1,154,22,132,155,27,121,144,57,85,136,50,86,133,26,107,134,24,108
460410VTD-8,65,50,15,65,52,8,73,66,4,69,65,4,66,51,15,66,54,10
46103VTD-AW,2601,792,1809,2837,898,1830,2022,744,1253,1992,742,1250,5715,1816,3899,5834,1951,3821
