GEOID20,Tot_2018_ag,D_2018_ag,R_2018_ag,Tot_2018_gov,D_2018_gov,R_2018_gov,Tot_2020_pres,D_2020_pres,R_2020_pres,Tot_2016_pres,D_2016_pres,R_2016_pres
060971525011,852,651,201,864,649,215,983,782,182,917,664,190
060971525013,426,318,108,434,312,122,650,478,152,513,345,119
060971522044,524,380,144,534,376,158,607,441,154,544,399,114
060971526011,573,370,203,581,368,213,752,505,232,948,609,271
060971526012,1424,972,452,1448,957,491,1711,1258,403,1487,1017,375
060971526021,666,460,206,678,455,223,786,541,222,754,497,196
060971525012,649,483,166,660,475,185,789,582,179,636,433,150
060971525021,663,469,194,676,463,213,838,621,202,691,478,171
060971525022,496,361,135,502,356,146,779,576,183,588,407,142
060971517024,533,409,124,541,413,128,525,411,103,492,362,100
060971505011,374,291,83,380,287,93,462,363,88,437,320,89
060971505012,678,495,183,682,495,187,804,601,187,744,519,174
060971505022,395,303,92,400,302,98,345,269,72,365,267,81
060971516021,698,508,190,700,499,201,797,615,172,769,548,181
060971503041,449,354,95,454,349,105,468,354,108,376,271,83
060971503042,726,574,152,732,564,168,983,790,172,842,607,186
060971502052,694,526,168,705,532,173,867,684,174,616,458,132
060971522051,440,293,147,449,292,157,538,383,147,399,274,101
060971522052,395,313,82,399,312,87,513,386,111,602,410,150
060971502053,634,473,161,642,466,176,824,621,187,830,596,186
060971503063,829,640,189,839,641,198,425,343,75,419,305,86
060971502061,408,300,108,413,295,118,476,363,101,357,258,79
060971502062,400,287,113,405,289,116,489,355,124,415,297,102
060971524022,649,407,242,660,409,251,969,666,284,1077,644,368
060971524012,1045,704,341,1062,709,353,957,687,249,1398,941,376
060971524013,712,454,258,725,456,269,778,544,223,1064,698,311
060971513091,572,374,198,586,379,207,667,449,200,592,370,184
060971505021,527,415,112,536,419,117,733,576,140,777,578,148
060971502043,677,490,187,684,482,202,845,631,196,722,523,161
060971501001,688,472,216,697,467,230,806,569,221,736,493,188
060971501003,254,164,90,255,160,95,248,161,80,233,141,74
060971516023,1111,782,329,1128,785,343,1066,815,238,988,711,241
060971506123,389,231,158,388,216,172,542,334,197,483,249,184
060971517011,848,656,192,857,650,207,972,767,181,968,696,206
060971515033,793,537,256,809,529,280,941,686,236,676,488,148
060971515043,711,509,202,728,517,211,862,659,181,679,483,147
060971515031,801,568,233,810,565,245,690,499,174,807,565,186
060971515032,639,457,182,650,462,188,794,604,170,720,514,165
060971515041,640,462,178,651,463,188,932,714,196,718,510,160
060971524011,1176,811,365,1191,806,385,1326,939,360,989,676,251
060971526013,501,351,150,506,340,166,663,496,151,609,419,156
060971526014,900,622,278,908,609,299,988,736,228,842,579,212
060971526015,375,271,104,379,267,112,448,351,91,402,290,93
060971516011,484,331,153,487,329,158,669,505,161,663,452,183
060971516012,782,541,241,793,545,248,990,723,258,924,641,249
060971516013,882,630,252,893,636,257,921,708,204,869,620,221
060971517022,526,362,164,538,364,174,687,520,154,473,347,97
060971502041,562,406,156,573,400,173,677,526,138,581,421,130
060971502042,709,553,156,721,550,171,793,630,142,917,687,178
060971502031,867,622,245,880,618,262,1106,821,266,947,656,234
060971535012,705,536,169,710,532,178,718,540,163,606,435,113
060971535014,712,533,179,717,526,191,952,684,246,820,565,183
060971535024,789,598,191,804,602,202,933,699,215,800,570,157
060971535013,618,452,166,626,443,183,750,527,206,641,428,149
060971532023,255,181,74,261,178,83,341,238,96,265,186,59
060971533012,449,300,149,463,298,165,544,376,152,468,306,121
060971510003,671,477,194,684,477,207,875,658,201,767,535,184
060971512052,933,629,304,948,628,320,1074,727,322,879,567,246
060971509015,471,380,91,477,381,96,850,679,155,593,449,103
060971509021,587,444,143,599,445,154,640,488,137,560,404,116
060971506112,289,202,87,298,206,92,423,308,107,200,139,49
060971512031,402,283,119,411,285,126,500,375,112,444,300,109
060971512032,726,515,211,739,514,225,978,611,333,640,430,156
060971512033,530,377,153,543,379,164,556,422,124,514,348,126
060971512034,690,513,177,706,515,191,930,723,184,876,604,199
060971513011,585,423,162,595,416,179,839,596,220,658,434,164
060971513102,556,403,153,562,394,168,715,526,169,502,332,124
060971513111,454,321,133,464,323,141,515,364,137,552,373,139
060971508001,467,381,86,476,384,92,579,475,91,523,408,73
060971508003,443,363,80,454,364,90,579,478,93,521,409,72
060971508004,1211,940,271,1240,950,290,1390,1119,241,1287,987,218
060971509023,449,358,91,459,362,97,638,515,105,524,413,78
060971509024,403,343,60,409,346,63,458,385,62,415,339,51
060971508002,538,456,82,545,453,92,658,545,98,565,445,70
060971507012,1041,813,228,1059,809,250,900,710,170,985,740,183
060971507013,555,475,80,566,478,88,701,592,89,526,435,61
060971507014,434,346,88,449,352,97,525,433,80,507,403,72
060971507024,576,451,125,593,458,135,632,515,102,565,433,96
060971509011,467,391,76,471,393,78,466,390,68,483,388,65
060971509022,481,387,94,491,388,103,494,388,93,434,326,76
060971507021,769,574,195,780,564,216,1254,952,268,713,516,148
060971507022,545,397,148,550,393,157,785,589,177,507,367,105
060971507023,883,660,223,905,663,242,983,741,209,903,666,178
060971506092,463,331,132,471,327,144,492,349,134,488,321,139
060971506093,451,332,119,458,328,130,589,429,144,501,350,116
060971506094,407,300,107,416,297,119,562,408,137,476,333,110
060971506101,510,377,133,518,371,147,686,496,169,572,398,133
060971506102,984,706,278,1003,702,301,1313,946,333,1024,708,251
060971506103,383,281,102,388,277,111,449,327,110,406,282,94
060971506031,862,649,213,872,637,235,1055,774,257,845,613,174
060971506021,548,391,157,553,384,169,789,581,194,615,419,153
060971506023,900,638,262,911,627,284,1203,851,324,1015,680,255
060971506113,556,400,156,572,402,170,426,322,97,341,236,81
060971506121,1324,936,388,1350,932,418,1732,1265,432,1527,1034,381
060971506011,522,380,142,528,373,155,695,504,172,595,409,137
060971506012,260,195,65,265,196,69,357,271,74,351,247,78
060971506013,265,200,65,271,201,70,597,457,125,476,334,106
060971506014,753,556,197,769,555,214,559,407,133,373,256,86
060971506114,481,332,149,496,338,158,895,640,231,924,619,237
060971506122,245,172,73,249,172,77,442,329,103,263,174,66
060971506111,446,307,139,460,312,148,413,295,106,359,241,92
060971506074,1364,900,464,1387,891,496,1714,1172,503,1408,925,388
060971506073,460,302,158,474,304,170,640,442,187,526,345,145
060971506091,722,523,199,738,525,213,1164,864,278,836,600,189
060971506071,512,367,145,525,367,158,595,431,151,508,353,123
060971513112,504,352,152,515,354,161,581,422,144,666,454,169
060971513113,535,372,163,547,373,174,1038,708,297,702,467,181
060971513115,489,352,137,502,355,147,905,618,270,489,319,133
060971512061,239,188,51,242,184,58,734,557,158,470,331,100
060971512063,519,391,128,527,385,142,877,631,216,684,470,158
060971513081,1233,868,365,1255,847,408,1202,788,387,1065,681,313
060971513104,548,394,154,563,388,175,392,242,143,325,211,84
060971513114,414,289,125,422,289,133,567,410,146,545,370,139
060971514061,603,488,115,611,483,128,702,536,150,605,444,116
060971514031,848,648,200,866,635,231,991,758,206,720,524,144
060971514042,277,225,52,279,226,53,446,343,82,358,264,63
060971514032,684,506,178,699,497,202,1016,748,253,488,350,102
060971515051,324,222,102,325,213,112,493,364,112,469,320,113
060971514052,465,358,107,476,351,125,671,483,168,508,356,100
060971514051,125,95,30,126,92,34,551,403,130,239,166,51
060971514054,334,251,83,338,245,93,354,261,84,486,328,112
060971514053,185,128,57,184,128,56,382,271,93,297,200,73
060971513092,1409,970,439,1433,963,470,1537,1040,471,1318,835,393
060971513093,837,582,255,859,577,282,1533,1121,374,598,393,167
060971530032,237,185,52,242,185,57,515,388,111,366,266,70
060971530033,479,370,109,483,366,117,464,346,102,584,431,89
060971518001,691,569,122,696,571,125,781,631,139,775,579,140
060971523003,772,582,190,778,582,196,865,674,174,816,601,167
060971523001,744,583,161,754,579,175,563,445,107,730,540,144
060971524023,636,476,160,644,472,172,839,640,172,608,443,127
060971520001,460,383,77,467,384,83,615,506,87,501,391,69
060971520002,350,294,56,352,294,58,423,350,67,384,299,54
060971522033,353,289,64,358,286,72,524,417,92,377,296,49
060971522034,526,449,77,535,445,90,728,619,88,561,443,68
060971521002,324,253,71,330,252,78,278,229,42,344,255,66
060971522014,404,337,67,408,333,75,497,414,64,414,325,58
060971522032,432,369,63,440,365,75,499,429,61,412,327,52
060971523002,605,481,124,608,478,130,677,556,105,615,471,97
060971523004,475,371,104,483,372,111,595,480,103,476,366,82
060971522011,417,327,90,420,326,94,565,450,98,535,403,91
060971522012,491,401,90,496,397,99,747,620,107,655,504,100
060971522013,495,408,87,504,407,97,663,561,91,559,437,82
060971528042,486,376,110,499,369,130,661,487,154,540,391,103
060971528032,365,293,72,372,284,88,494,382,102,459,339,80
060971528033,234,198,36,239,196,43,362,298,58,328,246,50
060971530012,605,460,145,618,452,166,814,605,178,676,481,139
060971530014,279,230,49,281,227,54,611,486,102,319,238,54
060971530013,640,487,153,650,475,175,810,604,177,668,474,136
060971513052,444,354,90,450,353,97,557,396,135,565,407,112
060971513051,563,449,114,569,446,123,808,622,162,542,390,108
060971513053,513,386,127,515,376,139,739,539,176,618,425,139
060971513061,309,221,88,316,214,102,351,236,104,331,217,86
060971513062,398,276,122,408,268,140,633,471,141,537,346,149
060971513101,228,163,65,232,158,74,365,268,86,248,163,64
060971513103,335,239,96,343,233,110,549,405,130,442,289,114
060971513012,332,254,78,336,249,87,499,356,125,481,327,108
060971513013,476,379,97,481,370,111,685,548,116,537,382,106
060971513071,743,513,230,754,508,246,1073,735,306,860,581,220
060971513073,531,357,174,542,351,191,757,531,209,561,360,154
060971513074,510,346,164,521,341,180,620,426,180,558,363,151
060971513082,591,410,181,605,404,201,759,518,218,690,468,179
060971513083,368,257,111,376,255,121,858,636,205,708,491,170
060971513063,657,449,208,663,436,227,900,616,264,863,560,245
060971513072,467,311,156,476,307,169,528,335,179,452,283,137
060971541002,671,427,244,677,423,254,779,512,244,692,425,206
060971539051,465,328,137,466,330,136,559,427,122,456,308,109
060971539033,421,320,101,430,321,109,421,334,79,407,306,71
060971539031,590,433,157,596,437,159,671,514,144,542,396,112
060971530064,610,469,141,623,465,158,1055,786,243,960,650,232
060971539053,168,104,64,169,101,68,172,117,52,171,94,63
060971527024,105,61,44,104,59,45,137,77,55,128,70,45
060971527023,630,442,188,638,436,202,911,625,266,937,617,246
060971529063,477,293,184,484,287,197,678,435,232,547,315,198
060971540003,835,582,253,851,574,277,751,526,209,682,440,196
060971529031,299,224,75,303,221,82,461,317,130,357,239,89
060971529032,483,370,113,493,367,126,768,606,144,546,411,95
060971529041,692,510,182,711,508,203,777,582,177,566,404,118
060971529043,639,464,175,647,457,190,826,571,228,636,426,160
060971538073,212,145,67,217,145,72,246,168,72,275,176,83
060971529044,554,402,152,563,393,170,658,473,165,591,398,152
060971527022,464,318,146,468,311,157,850,603,230,438,302,101
060971527011,543,333,210,552,335,217,499,325,165,665,404,214
060971529061,896,561,335,910,553,357,1248,831,391,957,601,296
060971540001,319,206,113,324,200,124,330,241,82,310,207,81
060971540002,344,237,107,339,226,113,418,294,113,385,247,107
060971539052,824,583,241,834,578,256,1357,1014,309,1086,764,255
060971528011,356,231,125,361,227,134,520,358,146,509,319,148
060971528014,521,354,167,531,347,184,915,649,242,879,568,231
060971529052,611,422,189,616,411,205,790,561,211,624,418,161
060971529053,510,352,158,514,343,171,720,510,195,592,395,157
060971529042,382,279,103,387,273,114,419,303,105,337,229,83
060971530053,634,405,229,647,408,239,757,515,224,695,456,181
060971529062,959,724,235,970,720,250,1404,1026,341,1033,700,246
060971542011,376,265,111,381,258,123,677,476,188,558,359,161
060971542012,448,298,150,454,289,165,440,285,138,383,235,118
060971542013,233,157,76,235,152,83,407,273,123,273,174,79
060971542014,378,260,118,390,261,129,510,353,149,420,265,122
060971542023,863,596,267,876,582,294,1297,882,379,991,632,286
060971542022,289,199,90,293,196,97,375,260,109,307,193,90
060971542021,465,302,163,475,304,171,520,331,171,413,237,130
060971542024,970,649,321,979,637,342,1230,822,379,1073,679,310
060971539024,352,254,98,354,253,101,642,483,142,589,423,129
060971539021,614,473,141,621,466,155,874,673,172,688,515,132
060971539022,300,224,76,305,225,80,503,386,107,375,274,75
060971539034,637,478,159,643,477,166,826,645,171,708,524,137
060971539041,678,515,163,691,511,180,671,521,136,555,412,102
060971539023,345,265,80,348,260,88,425,328,84,389,288,72
060971539032,394,306,88,401,302,99,517,409,96,484,368,83
060971538041,742,486,256,748,481,267,989,644,323,944,594,276
060971538042,669,435,234,677,430,247,877,620,241,900,564,270
060971538061,406,251,155,420,255,165,610,379,212,472,284,150
060971538063,562,359,203,575,358,217,772,556,203,584,364,181
060971538072,716,444,272,742,448,294,916,603,283,828,499,263
060971538071,1123,728,395,1138,720,418,1586,1050,503,993,647,273
060971538082,616,421,195,622,418,204,420,309,103,399,273,93
060971538091,724,473,251,734,464,270,999,667,315,750,468,227
060971538113,821,554,267,835,543,292,1118,739,341,1028,643,313
060971538112,353,238,115,367,239,128,471,306,150,394,243,120
060971538081,627,424,203,629,410,219,733,480,235,571,368,163
060971538062,184,129,55,185,128,57,283,198,81,268,181,62
060971538092,783,525,258,791,513,278,966,688,257,943,597,271
060971538093,380,255,125,388,250,138,611,414,188,477,292,145
060971538101,418,274,144,430,269,161,579,384,177,436,276,129
060971538111,850,590,260,867,581,286,1416,955,422,983,652,252
060971538102,357,254,103,367,252,115,495,361,119,431,294,104
060971538083,699,495,204,718,489,229,796,562,207,751,508,185
060971537051,283,234,49,281,223,58,363,300,49,387,281,65
060971537112,252,208,44,251,207,44,460,362,84,436,306,69
060971537111,547,441,106,549,445,104,345,274,65,404,291,70
060971537101,305,254,51,307,251,56,452,366,76,372,281,60
060971534031,639,504,135,649,501,148,712,526,165,629,460,129
060971534044,708,582,126,717,574,143,903,722,152,784,572,132
060971543041,338,261,77,344,256,88,515,400,110,443,298,90
060971543071,452,359,93,458,356,102,520,428,82,521,376,105
060971543042,397,319,78,403,318,85,336,264,68,332,233,71
060971530021,409,326,83,413,326,87,640,494,130,510,373,88
060971534032,730,624,106,731,608,123,878,730,123,769,608,97
060971534041,478,399,79,484,397,87,605,505,85,582,455,78
060971534052,612,514,98,620,515,105,754,626,112,697,546,91
060971536023,937,752,185,940,726,214,1046,833,192,945,686,181
060971536022,452,377,75,456,372,84,601,487,99,515,383,86
060971536021,588,493,95,594,487,107,682,556,110,621,483,87
060971536012,389,322,67,389,313,76,695,573,111,619,480,91
060971536011,599,491,108,606,484,122,601,492,99,516,403,75
060971530052,380,246,134,391,247,144,433,302,120,364,225,111
060971533013,613,474,139,620,472,148,918,702,185,638,465,118
060971533014,359,279,80,362,272,90,546,416,113,365,255,76
060971533021,486,377,109,496,379,117,761,592,146,605,443,113
060971533011,316,241,75,320,237,83,499,368,118,368,266,59
060971533022,553,392,161,560,389,171,1032,729,274,687,468,164
060971533023,426,320,106,431,317,114,387,301,78,382,277,69
060971532012,283,216,67,285,211,74,583,432,128,387,263,86
060971530022,611,489,122,617,492,125,585,458,106,436,322,73
060971530062,308,218,90,314,223,91,429,308,110,371,259,83
060971530051,552,329,223,564,340,224,651,415,219,515,315,155
060971530054,420,307,113,430,304,126,489,344,133,436,294,104
060971515052,421,280,141,423,270,153,553,389,152,496,323,135
060971515064,888,654,234,901,656,245,1162,875,257,1108,794,241
060971505013,365,291,74,370,292,78,411,327,74,327,248,61
060971503032,828,569,259,837,563,274,704,513,178,805,534,206
060971503031,396,292,104,402,289,113,547,421,117,402,285,95
060971503051,270,211,59,271,210,61,454,324,123,338,222,90
060971503052,569,441,128,577,439,138,721,570,134,669,503,130
060971503053,536,419,117,540,418,122,969,779,165,656,506,98
060971503054,161,125,36,163,126,37,384,308,68,352,270,59
060971503061,246,192,54,248,191,57,422,345,77,401,308,73
060971503062,363,284,79,369,284,85,513,427,79,493,391,67
060971517021,252,198,54,255,197,58,315,249,57,333,239,75
060971517023,493,388,105,503,387,116,622,503,103,648,475,134
060971518002,393,310,83,400,309,91,405,309,86,460,327,100
060971518005,317,249,68,320,249,71,322,244,67,398,285,82
060971503033,309,226,83,317,227,90,296,224,67,232,160,53
060971503034,1128,858,270,1142,855,287,1313,1074,231,1135,831,260
060971503043,537,392,145,549,392,157,866,647,195,621,431,141
060971503044,580,425,155,597,429,168,730,553,163,530,373,118
060971502032,711,511,200,718,506,212,839,607,211,774,534,194
060971501002,293,165,128,300,161,139,403,262,133,323,184,115
060971525023,408,306,102,417,299,118,484,357,112,400,267,93
060971515042,605,440,165,611,439,172,799,608,166,508,356,114
060971515061,773,570,203,784,571,213,1042,800,216,739,535,154
060971517012,560,431,129,573,433,140,684,529,136,674,484,138
060971515063,426,313,113,430,315,115,571,431,124,526,377,115
060971515062,333,247,86,338,247,91,479,362,102,299,217,62
060971518004,794,618,176,818,622,196,847,651,176,819,619,137
060971518003,406,335,71,404,325,79,512,408,96,435,322,81
060971516022,725,519,206,731,522,209,774,603,164,774,546,203
060971502051,518,396,122,526,393,133,666,534,123,562,416,116
060971502033,775,617,158,786,616,170,1063,870,177,791,602,146
060971522043,308,240,68,314,240,74,306,230,68,372,251,91
060971522041,543,421,122,552,422,130,960,765,171,790,577,168
060971522042,734,516,218,738,508,230,972,728,229,681,473,156
060552019002,240,149,91,240,145,95,354,240,108,317,197,98
060971506072,276,183,93,281,184,97,396,251,135,310,180,104
060971512051,487,328,159,494,327,167,682,463,202,556,356,157
060971507011,459,360,99,465,357,108,669,538,116,554,419,99
060971511001,555,344,211,567,338,229,795,489,286,675,381,223
060971512062,490,337,153,498,333,165,590,394,174,462,290,131
060971512041,738,569,169,754,565,189,1119,820,261,822,570,177
060971510001,541,346,195,553,344,209,715,488,214,624,391,187
060971510002,567,372,195,577,368,209,734,495,224,588,370,172
060971511002,1076,686,390,1102,681,421,1259,812,421,1114,668,366
060971511003,547,358,189,556,353,203,626,407,209,531,325,171
060971506022,558,394,164,568,391,177,763,548,202,647,434,161
060971506032,298,223,75,303,219,84,426,313,98,317,226,61
060971506033,286,205,81,288,200,88,338,256,80,302,206,68
060971506036,433,307,126,439,301,138,620,451,154,549,370,138
060971506034,723,491,232,742,484,258,896,643,235,815,532,224
060971506035,429,312,117,438,308,130,751,546,181,589,412,126
060971535011,517,368,149,519,362,157,663,463,186,538,346,141
060971512042,561,419,142,571,420,151,546,410,118,556,367,139
060971512043,223,167,56,226,167,59,413,317,80,317,213,77
060971509014,259,207,52,263,208,55,391,308,73,389,294,69
060971509012,319,255,64,321,252,69,365,295,65,316,245,53
060971509013,452,363,89,458,360,98,647,518,113,535,414,87
060971519004,341,287,54,344,289,55,457,380,66,447,348,58
060971530023,228,191,37,231,191,40,353,280,59,225,169,34
060971530024,266,222,44,268,219,49,423,333,69,290,215,43
060971530025,250,209,41,253,207,46,332,262,56,215,159,32
060971531042,175,142,33,177,139,38,251,203,40,166,123,30
060971522031,353,293,60,358,291,67,480,404,64,374,297,55
060971528031,333,256,77,341,252,89,424,310,99,364,260,73
060971528041,250,193,57,256,189,67,432,317,99,370,266,71
060971514041,360,302,58,363,304,59,535,415,108,669,491,124
060971519001,219,183,36,224,187,37,333,276,45,291,221,46
060971519002,238,200,38,243,203,40,461,387,61,364,275,61
060971519003,320,267,53,326,272,54,391,328,58,317,246,44
060971521001,379,290,89,382,286,96,701,533,145,671,493,136
060971524021,261,198,63,263,196,67,356,274,73,388,286,78
060971521003,320,268,52,325,266,59,464,393,62,446,353,54
060971530011,349,292,57,355,290,65,468,379,72,390,293,62
060971514062,367,287,80,372,277,95,560,419,129,437,318,83
060971541004,336,200,136,341,197,144,369,252,106,333,197,113
060971541001,254,173,81,260,174,86,420,288,121,313,202,85
060971541003,443,283,160,448,277,171,532,352,167,479,300,144
060971527021,513,340,173,525,335,190,694,480,204,831,534,238
060971527012,360,251,109,369,250,119,718,502,198,556,378,134
060971527013,511,342,169,524,345,179,558,390,157,525,344,144
060971529051,480,325,155,487,318,169,618,417,193,563,365,169
060971527014,365,257,108,373,255,118,467,326,128,368,252,88
060971527015,506,355,151,516,352,164,671,473,182,550,372,150
060971539042,343,221,122,343,219,124,475,323,144,406,257,118
060971538103,769,559,210,792,554,238,986,710,245,838,581,198
060971528013,405,276,129,409,267,142,731,499,214,687,437,188
060971528012,275,189,86,279,184,95,643,448,185,650,421,171
060971537054,598,462,136,608,465,143,802,616,164,643,462,127
060971529033,98,74,24,99,73,26,311,244,60,254,193,42
060971529034,272,206,66,276,204,72,342,269,66,275,209,45
060971537073,365,308,57,369,307,62,326,271,51,312,239,50
060971537071,310,248,62,314,249,65,395,296,84,364,261,68
060971537072,246,209,37,248,211,37,383,318,59,338,263,45
060971537081,264,225,39,265,223,42,356,292,51,329,256,43
060971537082,232,192,40,234,192,42,327,270,50,312,234,47
060971537091,334,280,54,338,280,58,439,355,69,392,300,59
060971537092,364,303,61,370,301,69,496,398,85,389,292,65
060971537103,413,350,63,414,347,67,484,399,72,448,348,61
060971537102,411,341,70,415,339,76,381,311,64,347,262,55
060971543044,202,160,42,204,160,44,316,239,68,281,204,51
060971531024,161,130,31,162,126,36,237,188,43,241,178,44
060971531032,370,299,71,374,292,82,421,336,75,326,243,58
060971531033,147,124,23,148,122,26,243,192,43,337,238,70
060971531041,335,282,53,339,279,60,601,475,108,489,387,65
060971531043,230,192,38,233,189,44,276,219,49,318,250,42
060971531023,296,237,59,299,232,67,505,403,84,368,281,58
060971531031,570,454,116,572,444,128,1016,774,211,641,469,124
060971530055,703,517,186,715,510,205,1014,721,262,906,613,220
060971530056,414,304,110,420,299,121,578,413,149,511,346,126
060971530063,592,440,152,601,431,170,898,665,207,721,488,169
060971530061,327,237,90,333,235,98,405,291,103,370,253,92
060971535023,631,510,121,637,510,127,749,624,107,680,514,104
060971534053,616,522,94,620,523,97,699,576,103,600,460,83
060971534042,808,697,111,815,692,123,869,745,107,738,601,85
060971534043,470,386,84,474,380,94,560,455,90,481,365,73
060971535021,474,383,91,479,381,98,590,471,101,498,377,75
060971535022,382,309,73,386,308,78,459,366,78,431,325,66
060971534034,419,363,56,421,357,64,569,494,60,476,397,49
060971532021,259,182,77,266,182,84,299,215,78,246,168,55
060971532022,425,339,86,429,337,92,684,494,175,573,391,129
060971530065,422,313,109,430,309,121,517,394,111,420,290,93
060971530066,504,375,129,514,368,146,544,415,118,434,302,98
060971531021,228,190,38,235,189,46,388,307,71,360,282,48
060971531022,208,174,34,214,174,40,356,291,51,344,275,44
060971537121,471,376,95,473,371,102,487,381,97,379,284,66
060971537122,738,577,161,745,581,164,911,728,163,754,553,139
060971537113,431,340,91,437,343,94,583,448,122,477,340,94
060971537052,485,368,117,494,369,125,572,437,119,536,385,108
060971537053,560,440,120,567,441,126,832,638,172,590,424,114
060971543061,722,601,121,722,587,135,730,604,110,591,443,87
060971543062,757,634,123,761,623,138,805,658,124,592,467,85
060971543053,444,372,72,447,369,78,583,477,92,639,455,99
060971543051,325,244,81,325,240,85,314,240,70,321,220,75
060971534061,349,292,57,350,291,59,444,374,63,392,302,56
060971534051,770,616,154,783,625,158,875,695,160,811,605,135
060971537083,179,151,28,180,152,28,272,215,45,190,144,27
060971537084,224,188,36,229,191,38,263,211,44,187,145,29
060971543043,270,203,67,271,200,71,375,289,81,291,205,63
060971543052,229,170,59,228,167,61,323,248,71,281,199,63
060971543081,506,404,102,503,399,104,544,459,77,466,375,74
060971534062,486,419,67,491,418,73,566,481,74,503,397,63
060971534063,529,459,70,536,461,75,732,625,85,628,510,68
060971534033,467,409,58,470,405,65,562,498,55,498,418,47
060971530031,319,242,77,324,241,83,491,372,109,378,273,77
060971530034,483,366,117,488,364,124,796,606,168,741,537,150
060971532011,673,505,168,688,505,183,1072,774,269,751,524,164
060816044002,490,344,146,504,349,155,576,418,149,417,313,83
060816051002,542,437,105,550,444,106,958,738,203,616,488,95
060816054005,521,402,119,525,403,122,877,696,165,752,576,133
060816051001,822,611,211,834,615,219,1106,854,235,853,636,173
060816053001,633,508,125,643,504,139,732,590,136,614,486,96
060816053002,694,528,166,707,531,176,831,656,162,764,587,136
060816054001,328,240,88,334,240,94,458,359,91,349,256,70
060816054004,524,402,122,529,405,124,686,531,136,494,378,86
060816054002,460,337,123,471,337,134,545,430,109,443,324,90
060816054003,595,445,150,613,429,184,845,655,167,779,603,130
060816055012,647,521,126,659,510,149,815,654,146,685,539,110
060816055011,506,410,96,511,405,106,739,592,132,636,502,102
060816055021,383,292,91,386,290,96,439,349,85,435,336,82
060816055022,675,510,165,679,506,173,911,719,174,837,640,157
060816056002,600,354,246,623,359,264,635,428,194,623,385,194
060816056001,500,281,219,516,287,229,555,369,174,522,324,165
060816053003,501,366,135,513,376,137,598,469,122,567,437,106
060816053004,375,274,101,385,280,105,369,297,70,411,316,77
060816050002,373,267,106,378,268,110,583,455,125,432,317,93
060816052001,457,339,118,466,344,122,599,485,99,578,434,117
060816052002,503,377,126,510,376,134,619,478,124,579,438,112
060816052003,422,318,104,435,317,118,494,381,100,473,361,89
060816052004,483,358,125,491,363,128,561,434,119,482,365,98
060816050003,1491,1032,459,1535,1039,496,1672,1236,400,1476,1016,377
060816056004,1198,720,478,1234,741,493,1665,1113,511,1257,788,389
060816050001,634,453,181,647,454,193,1091,803,263,952,696,207
060816050004,449,301,148,463,301,162,484,360,118,477,317,138
060816049001,802,539,263,834,543,291,1188,828,343,956,642,269
060816050005,374,251,123,385,251,134,420,314,102,387,258,110
060816058003,400,266,134,412,272,140,531,393,126,487,342,123
060816056003,586,351,235,604,358,246,830,566,242,606,379,188
060816057004,711,436,275,731,450,281,941,655,263,772,506,218
060816057001,677,406,271,695,414,281,811,569,221,661,416,194
060816058002,514,350,164,524,351,173,561,433,119,533,388,122
060816064001,640,472,168,653,474,179,637,482,147,632,479,124
060816057002,621,385,236,634,404,230,816,567,235,651,423,198
060816065004,563,379,184,584,387,197,676,520,139,635,452,143
060816068001,865,603,262,889,602,287,1018,796,206,938,665,225
060816057003,741,433,308,758,444,314,951,656,273,835,516,274
060816069001,548,430,118,552,438,114,640,530,97,545,437,90
060816065003,507,357,150,519,358,161,595,464,123,514,382,104
060816068002,851,612,239,865,615,250,1056,790,251,1147,831,271
060816039002,595,443,152,602,440,162,747,560,170,905,644,222
060816044001,496,347,149,509,353,156,882,625,239,523,369,127
060816045002,632,417,215,653,418,235,891,632,242,540,360,147
060816044003,446,315,131,460,321,139,1014,736,254,639,486,117
060816049002,499,339,160,520,339,181,838,567,258,585,388,167
060816047001,934,635,299,996,638,358,976,678,278,822,573,213
060816047002,344,227,117,362,236,126,583,404,167,461,329,117
060816048003,658,472,186,681,469,212,835,610,208,800,583,173
060816045001,908,628,280,936,639,297,1101,771,295,981,691,253
060816046002,489,318,171,515,326,189,680,476,192,620,406,184
060816048002,553,397,156,567,393,174,568,414,146,492,360,108
060816048001,705,510,195,728,506,222,1035,728,281,861,627,191
060816039003,382,270,112,389,269,120,411,307,98,428,301,104
060816046001,649,421,228,684,434,250,864,604,234,752,489,222
060816023002,673,564,109,681,547,134,1009,770,226,791,631,130
060816042001,236,197,39,231,189,42,341,270,68,306,247,44
060816042002,219,185,34,217,180,37,397,315,77,279,226,41
060816042003,547,450,97,543,446,97,961,730,222,649,543,81
060816041031,505,396,109,508,395,113,1119,835,253,635,505,103
060816041041,380,308,72,382,299,83,547,433,105,396,315,59
060816041042,358,290,68,360,282,78,571,453,111,460,363,72
060816041023,340,285,55,348,287,61,321,253,62,309,249,48
060816041032,500,392,108,511,397,114,843,635,195,659,513,117
060816039001,308,232,76,309,227,82,361,274,83,340,248,78
060816039004,321,239,82,322,237,85,370,273,90,235,170,48
060816039005,335,252,83,340,250,90,405,299,100,252,181,54
060816039006,202,151,51,204,150,54,405,298,99,257,184,53
060816040002,564,420,144,569,412,157,604,450,144,614,455,128
060816040003,567,429,138,574,421,153,676,510,156,623,476,127
060816040001,350,258,92,351,250,101,455,337,112,416,307,89
060816024002,947,687,260,982,700,282,1123,836,275,981,722,217
060816041022,450,375,75,456,376,80,724,542,163,685,552,106
060816041021,133,111,22,135,112,23,464,364,90,183,147,29
060816038011,735,544,191,753,541,212,1230,863,342,859,620,201
060816038022,461,319,142,471,313,158,634,445,176,510,350,133
060816038023,827,573,254,849,565,284,1089,778,288,891,613,231
060816038021,1010,720,290,1032,715,317,1147,863,262,1091,726,299
060816069002,798,626,172,812,641,171,975,804,154,856,677,149
060816019021,509,416,93,509,409,100,743,602,126,594,474,93
060816019022,324,262,62,326,254,72,450,346,98,288,231,43
060816019024,579,466,113,589,460,129,957,732,202,703,569,103
060816019011,489,383,106,495,370,125,583,452,126,515,392,98
060816019012,626,490,136,638,493,145,1086,831,237,757,593,138
060816019013,311,244,67,316,237,79,403,311,89,365,280,67
060816019023,268,216,52,272,213,59,411,317,85,581,452,108
060816020013,967,778,189,986,771,215,1161,897,246,693,539,131
060816020011,492,394,98,501,392,109,581,462,113,456,352,87
060816022011,357,281,76,364,280,84,445,351,92,664,518,123
060816022013,362,289,73,362,282,80,650,503,124,424,344,63
060816020012,250,202,48,255,200,55,558,436,111,233,181,44
060816022021,282,244,38,283,239,44,613,493,111,353,299,38
060816022022,352,303,49,348,296,52,494,401,88,412,345,43
060816001003,407,339,68,410,338,72,414,329,75,383,318,49
060816020022,410,307,103,411,300,111,780,585,182,488,365,102
060816020021,659,555,104,664,541,123,972,783,168,772,625,105
060816021001,267,226,41,269,224,45,338,272,61,274,230,36
060816021002,231,195,36,234,195,39,388,313,69,320,264,44
060816021003,180,153,27,183,153,30,380,305,65,336,277,45
060816022012,319,256,63,313,248,65,563,436,115,337,274,50
060819843001,0,0,0,0,0,0,0,0,0,0,0,0
060816023001,485,409,76,494,398,96,884,701,171,626,501,92
060816018002,714,539,175,720,529,191,953,697,240,791,587,173
060816018001,1047,788,259,1049,771,278,1620,1197,396,1296,957,288
060816018003,667,516,151,676,516,160,923,718,200,745,566,151
060816017001,430,344,86,434,341,93,492,386,99,380,297,63
060816017002,659,527,132,679,533,146,1016,794,208,774,599,147
060816024001,368,267,101,375,264,111,613,439,165,487,359,106
060816024003,516,397,119,530,402,128,722,555,150,630,491,109
060816024004,880,642,238,894,635,259,1239,882,341,919,687,194
060816086001,442,334,108,459,342,117,466,373,85,437,327,83
060816086003,693,541,152,712,541,171,1116,882,214,868,640,169
060816085011,405,324,81,412,320,92,476,379,90,594,459,104
060816087001,965,746,219,987,741,246,1059,842,201,1140,866,221
060816087002,563,430,133,570,420,150,769,598,154,495,370,94
060816087005,859,674,185,880,674,206,1064,857,184,929,726,159
060816088001,579,445,134,590,455,135,718,560,142,630,483,115
060816088002,655,487,168,665,490,175,835,661,153,677,503,131
060816088003,414,302,112,427,309,118,557,430,112,516,369,114
060816088004,548,410,138,565,414,151,733,570,148,615,447,130
060816088005,897,677,220,923,683,240,1141,883,231,960,705,199
060816070002,1280,879,401,1309,882,427,1545,1114,403,1122,776,287
060816089001,724,503,221,741,508,233,973,775,179,563,407,128
060816089003,1044,817,227,1059,811,248,1446,1137,272,1560,1182,298
060816089004,443,308,135,453,318,135,309,233,66,288,201,70
060816089002,624,498,126,625,510,115,769,608,134,939,735,160
060816096011,1563,1144,419,1596,1146,450,1913,1523,357,1599,1207,318
060816090002,745,569,176,753,562,191,1050,835,194,700,540,127
060816087003,389,301,88,400,305,95,423,335,83,421,317,80
060816087004,586,451,135,597,454,143,694,551,134,616,464,115
060816082002,767,564,203,782,561,221,815,614,186,803,591,162
060816082001,707,501,206,725,502,223,948,715,217,779,557,177
060816083001,843,597,246,863,600,263,1009,748,239,831,600,196
060816083002,461,330,131,477,335,142,803,607,178,605,445,135
060816081002,835,604,231,854,615,239,969,742,218,762,552,177
060816081001,484,357,127,499,367,132,847,654,178,694,524,139
060816080011,771,576,195,780,567,213,906,703,184,808,592,170
060816080012,274,203,71,279,202,77,613,475,124,579,421,121
060816080131,936,675,261,952,669,283,989,767,196,773,565,163
060816080251,295,229,66,298,226,72,690,512,170,541,425,91
060816080252,942,723,219,958,717,241,744,575,157,767,563,176
060816080253,261,196,65,264,196,68,924,698,214,340,264,58
060816080021,851,613,238,867,621,246,874,674,185,768,570,168
060816080022,368,268,100,374,274,100,467,355,104,557,416,121
060816080023,334,242,92,339,247,92,471,360,104,504,376,110
060816080241,839,602,237,869,616,253,1015,754,245,658,472,157
060816080132,326,239,87,329,238,91,491,381,98,472,339,108
060816080231,410,287,123,420,289,131,426,331,88,324,231,73
060816080232,729,530,199,748,536,212,876,672,189,742,528,177
060816080133,339,251,88,347,249,98,412,321,81,348,259,68
060816079002,315,236,79,315,234,81,374,297,71,396,287,95
060816080242,41,29,12,41,29,12,546,422,117,277,191,72
060816061001,667,519,148,680,515,165,875,674,185,778,598,149
060816061002,449,350,99,458,346,112,544,418,118,462,354,87
060816061003,292,228,64,298,227,71,366,284,78,344,265,66
060816077012,707,567,140,714,545,169,1115,855,235,802,637,133
060816077011,421,337,84,422,324,98,628,495,122,559,437,96
060816077021,477,373,104,483,362,121,682,537,132,554,426,103
060816077022,494,385,109,500,375,125,692,541,134,538,413,99
060816078001,612,461,151,627,450,177,832,614,200,647,483,134
060816078002,573,425,148,577,429,148,779,575,190,675,498,143
060816079001,648,481,167,649,475,174,529,386,128,534,389,123
060816079003,393,292,101,394,289,105,821,602,199,623,471,123
060816084001,685,550,135,694,545,149,975,770,184,676,519,118
060816084002,424,341,83,431,340,91,780,591,172,572,443,104
060816084003,271,217,54,273,216,57,670,508,148,490,380,90
060816085021,587,438,149,600,441,159,618,478,137,642,480,128
060816085022,402,299,103,416,304,112,743,568,165,529,395,106
060816085012,692,517,175,703,504,199,710,543,160,756,548,172
060816085013,486,367,119,492,359,133,417,326,89,485,353,104
060816075002,1364,1147,217,1385,1145,240,1184,943,222,1360,1124,169
060816085014,422,337,85,426,332,94,348,275,65,425,328,74
060816075001,607,503,104,624,502,122,1764,1403,332,637,496,105
060816076001,484,377,107,493,384,109,470,382,77,422,327,79
060816076002,281,225,56,287,228,59,368,295,61,357,283,59
060816076003,347,283,64,351,284,67,743,584,141,454,365,68
060816076004,427,345,82,431,347,84,443,361,73,420,334,67
060816063001,628,511,117,639,518,121,874,713,150,731,569,123
060816063002,444,340,104,449,337,112,587,464,113,482,366,95
060816064003,501,377,124,503,372,131,677,533,132,582,431,124
060816063003,480,380,100,493,378,115,628,502,114,567,437,103
060816062021,497,430,67,505,436,69,888,723,147,672,564,77
060816062022,465,395,70,466,389,77,673,549,111,460,379,59
060816062011,300,264,36,307,270,37,449,367,76,309,275,28
060816062012,453,399,54,460,404,56,847,687,141,565,488,49
060816060003,334,264,70,337,264,73,567,447,109,557,443,93
060816060002,605,479,126,612,479,133,600,473,115,523,416,87
060816060001,523,417,106,539,429,110,844,665,161,621,485,99
060816059021,305,247,58,308,247,61,299,244,51,357,283,53
060816059022,627,513,114,635,516,119,651,530,107,704,548,114
060816059013,286,229,57,288,228,60,362,284,70,301,241,41
060816059012,460,365,95,467,373,94,694,542,134,551,437,82
060816059011,368,296,72,372,300,72,429,337,83,418,330,63
060816058001,463,315,148,468,316,152,562,423,125,542,398,120
060816064002,410,315,95,413,316,97,409,334,73,401,299,85
060816064004,432,336,96,438,340,98,560,448,102,565,425,115
060816065001,430,304,126,442,305,137,521,407,107,418,311,84
060816065002,559,407,152,564,404,160,579,455,115,621,479,114
060816066001,504,397,107,510,393,117,682,543,133,574,439,100
060816066002,565,429,136,572,432,140,655,517,129,596,449,111
060816066003,490,363,127,497,370,127,570,449,111,531,400,102
060816067001,438,311,127,443,322,121,599,464,123,471,350,96
060816074001,930,718,212,955,724,231,1129,887,216,1011,745,212
060816067002,866,633,233,882,641,241,1016,790,206,865,627,198
060816074002,327,250,77,336,250,86,528,406,105,381,285,82
060816074003,663,506,157,685,515,170,843,671,159,795,604,160
060816072001,572,458,114,582,449,133,1128,891,211,1049,815,179
060816073002,864,665,199,874,650,224,1241,966,251,834,630,163
060816072002,703,576,127,708,564,144,1005,789,202,664,521,110
060816071002,662,503,159,667,500,167,757,586,152,716,545,142
060816071003,523,388,135,533,390,143,633,499,126,594,440,126
060816071001,356,255,101,365,257,108,402,315,80,377,269,88
060816073001,677,495,182,683,488,195,835,646,168,927,674,211
060816073003,405,291,114,417,295,122,544,423,111,379,273,88
060816070001,350,240,110,357,241,116,470,342,121,356,251,88
060816064005,319,248,71,325,254,71,432,348,79,406,306,80
060816115001,369,233,136,374,228,146,415,304,102,430,292,108
060816125001,621,528,93,627,528,99,698,588,98,599,527,45
060816115002,612,392,220,618,393,225,656,473,172,633,449,153
060816106022,435,337,98,444,346,98,536,439,86,394,298,74
060816106012,367,297,70,375,290,85,539,439,86,296,254,30
060816115003,526,330,196,531,324,207,527,387,131,554,379,138
060816114004,731,394,337,736,406,330,783,509,249,720,425,244
060816113004,650,489,161,657,489,168,748,593,143,623,477,116
060816114002,349,209,140,364,213,151,442,328,100,416,280,99
060816129001,946,761,185,957,758,199,1064,922,128,977,806,128
060816114003,690,409,281,689,399,290,883,651,212,776,506,198
060816133002,654,475,179,670,479,191,799,613,171,723,512,160
060816130002,688,521,167,696,527,169,893,729,146,824,639,141
060816114001,461,299,162,469,304,165,742,542,182,397,285,83
060816086002,377,284,93,385,292,93,612,479,119,443,338,79
060816103042,750,548,202,770,561,209,1106,850,231,889,668,178
060816090001,559,418,141,576,431,145,579,457,117,499,380,99
060816095001,1090,815,275,1104,809,295,1409,1133,249,1194,897,228
060816091001,332,263,69,333,257,76,456,360,84,370,277,71
060816095002,1511,1108,403,1534,1107,427,1817,1444,332,1610,1200,324
060816135021,1072,825,247,1083,825,258,1216,958,237,1007,754,205
060816136002,460,363,97,466,358,108,493,394,90,369,275,70
060816136003,210,169,41,210,165,45,541,427,95,405,301,77
060816136001,870,683,187,882,680,202,1094,891,183,988,753,183
060816136005,1205,974,231,1208,957,251,1266,1028,210,1055,810,174
060816136004,366,289,77,372,285,87,341,278,59,494,377,83
060816135022,628,468,160,634,471,163,817,637,168,696,521,139
060816135023,856,644,212,872,644,228,1110,875,215,994,740,203
060816135024,774,609,165,782,601,181,1001,801,190,870,660,160
060816135012,1073,787,286,1082,773,309,1223,904,286,930,679,195
060816135011,900,663,237,911,655,256,1028,795,211,914,666,196
060816137021,471,348,123,479,350,129,563,424,128,487,361,96
060816137024,218,169,49,221,168,53,321,244,72,231,173,47
060816137023,753,583,170,766,581,185,899,679,198,647,490,117
060816137022,461,318,143,464,315,149,662,499,146,547,383,131
060816137011,1057,803,254,1069,801,268,1419,1093,292,1130,825,236
060816137012,1184,769,415,1189,772,417,1463,1068,365,1428,971,357
060816138002,455,307,148,457,304,153,469,287,173,388,249,110
060816138003,539,433,106,541,431,110,782,605,152,702,519,127
060816138004,417,322,95,423,319,104,704,532,160,578,424,122
060816132004,1782,1363,419,1805,1379,426,2088,1693,345,1904,1507,290
060816134003,793,577,216,803,577,226,885,694,166,852,618,176
060816138001,321,240,81,321,233,88,371,271,92,329,232,77
060816134002,431,277,154,439,279,160,513,386,116,412,275,101
060816129002,401,314,87,406,313,93,490,419,64,418,335,60
060816128002,778,593,185,792,602,190,911,765,133,815,655,116
060816129003,415,340,75,421,340,81,565,489,69,483,406,55
060816129004,618,467,151,620,467,153,668,548,108,549,438,85
060816130001,804,583,221,811,586,225,989,808,163,1001,767,183
060816132001,928,736,192,949,747,202,1080,918,131,986,808,123
060816132003,466,319,147,472,315,157,549,441,94,415,300,82
060816126002,506,423,83,508,427,81,665,573,81,589,492,67
060816126003,415,329,86,422,334,88,606,494,101,450,352,80
060816126004,543,443,100,552,450,102,657,566,74,695,581,75
060816127001,536,435,101,546,442,104,571,469,100,548,460,60
060816127002,778,552,226,803,568,235,846,691,146,810,611,144
060816126001,499,418,81,501,422,79,560,484,64,472,398,50
060816128001,1048,780,268,1068,791,277,1174,974,180,1112,847,191
060816139004,401,327,74,403,329,74,511,426,75,446,372,50
060816139005,949,782,167,956,786,170,1187,1020,137,1244,1062,113
060816026022,843,659,184,863,676,187,1136,889,236,756,607,123
060816027003,570,453,117,576,462,114,1046,820,201,826,659,119
060816027004,636,503,133,640,507,133,918,695,193,748,589,110
060816140004,588,439,149,594,436,158,853,645,191,801,600,165
060816027002,521,414,107,526,412,114,814,639,161,586,477,84
060816029002,794,636,158,801,645,156,976,777,180,1008,767,183
060816027001,364,285,79,368,274,94,447,351,93,371,301,56
060816028002,812,635,177,813,617,196,1106,859,228,882,688,151
060816028003,374,283,91,374,277,97,407,317,82,445,340,88
060816015023,366,291,75,371,288,83,813,626,176,470,375,79
060816010003,837,687,150,859,696,163,1132,892,218,856,692,126
060816028001,420,343,77,424,334,90,625,496,118,485,385,79
060816029001,853,674,179,869,686,183,1265,973,262,1080,838,181
060816030002,369,301,68,374,302,72,465,376,77,472,369,71
060816030004,592,492,100,598,493,105,822,674,135,550,430,84
060816030001,891,730,161,907,732,175,1134,914,192,808,634,125
060816030003,317,253,64,320,250,70,438,353,74,359,267,69
060816031002,693,550,143,699,544,155,757,585,154,623,460,126
060816140002,423,306,117,431,308,123,568,421,135,449,315,115
060816031001,1260,941,319,1270,945,325,1497,1138,332,1224,904,247
060816034001,1038,720,318,1058,717,341,1114,787,307,598,389,170
060816034002,510,359,151,524,361,163,696,512,167,483,341,113
060816032004,394,308,86,397,306,91,552,423,116,482,363,98
060816033001,935,732,203,963,736,227,932,733,176,994,728,195
060816033003,1215,893,322,1232,875,357,1613,1197,391,1331,959,298
060816034003,670,485,185,682,484,198,864,619,227,975,687,228
060816034004,762,563,199,769,559,210,1081,784,273,1085,778,247
060816033002,1392,1042,350,1411,1034,377,1968,1476,448,1581,1138,354
060816032001,686,530,156,701,517,184,749,555,176,684,511,130
060816032002,388,305,83,392,302,90,475,361,101,411,311,83
060816032003,487,357,130,498,358,140,631,483,132,604,438,134
060816092021,891,700,191,903,699,204,1176,964,192,989,760,173
060816092023,475,387,88,482,386,96,697,570,113,560,438,90
060816092012,563,453,110,568,448,120,684,560,114,595,469,93
060816092013,743,579,164,759,585,174,794,647,139,731,585,114
060816092022,377,301,76,377,296,81,523,424,88,404,319,64
060816092011,607,469,138,626,480,146,752,606,132,721,571,111
060816091002,370,291,79,374,285,89,454,362,81,409,309,77
060816103022,548,443,105,553,453,100,571,483,72,410,319,75
060816093001,752,564,188,767,573,194,878,706,159,784,602,139
060816093002,1104,832,272,1133,850,283,1368,1091,247,1163,897,202
060816094001,903,688,215,930,692,238,1038,833,183,970,732,189
060816094002,942,722,220,980,753,227,1118,897,202,998,774,174
060816096032,962,673,289,972,670,302,1147,863,263,974,705,219
060816096033,877,598,279,890,610,280,1085,817,241,1014,749,219
060816096021,945,704,241,965,709,256,1079,851,207,1052,775,230
060816096031,833,615,218,843,613,230,1029,810,202,935,685,205
060816096034,431,318,113,438,321,117,634,494,126,448,320,104
060816097001,1180,845,335,1209,851,358,1383,1061,300,1163,844,256
060816098002,925,663,262,933,670,263,1111,851,238,964,663,243
060816097002,1370,932,438,1392,941,451,1664,1242,380,1533,1070,371
060816133001,955,562,393,971,586,385,1152,776,347,999,636,299
060816111003,630,478,152,634,483,151,895,675,194,639,495,109
060816098004,734,548,186,739,551,188,917,726,176,809,564,187
060816113001,631,479,152,641,479,162,753,581,156,676,501,142
060816113002,823,584,239,841,592,249,1117,838,253,892,657,189
060816113003,401,284,117,406,281,125,446,333,99,419,312,90
060816134001,652,427,225,668,437,231,709,536,159,706,509,150
060816111001,1516,1106,410,1530,1104,426,1831,1409,382,1622,1197,338
060816132002,1072,763,309,1091,757,334,1128,905,194,1042,781,188
060816118002,545,502,43,555,498,57,761,667,75,528,473,20
060816120011,400,364,36,399,358,41,637,558,72,493,458,23
060816120012,308,290,18,316,290,26,570,514,52,398,363,18
060816120021,288,266,22,289,260,29,438,375,52,378,345,20
060816120022,299,274,25,300,266,34,429,371,51,369,333,22
060816118001,453,424,29,448,412,36,662,583,62,535,497,24
060816119011,338,289,49,343,286,57,544,467,64,249,210,21
060816119021,478,436,42,478,433,45,651,553,84,353,313,22
060816119013,145,128,17,145,123,22,183,155,23,165,140,16
060816119024,464,395,69,466,391,75,637,544,81,547,447,61
060816119012,388,348,40,388,351,37,534,451,67,584,519,37
060816119022,318,297,21,315,293,22,378,332,40,452,420,17
060816119023,260,243,17,260,241,19,323,280,35,366,346,10
060816121021,288,263,25,291,264,27,436,380,47,384,330,27
060816121022,231,211,20,234,212,22,689,601,75,345,294,28
060816121011,444,371,73,452,378,74,531,469,54,480,413,39
060816121012,340,307,33,342,303,39,470,398,64,372,318,33
060816121013,69,62,7,69,61,8,145,123,19,120,102,10
060816116002,640,508,132,645,514,131,756,634,105,673,534,94
060816116001,589,485,104,597,483,114,639,540,80,585,489,65
060816117002,581,517,64,584,518,66,745,640,93,638,564,49
060816117003,425,389,36,425,373,52,632,536,74,427,380,29
060816117001,493,452,41,496,435,61,731,631,82,595,533,37
060816139001,344,296,48,350,294,56,405,356,40,329,284,29
060816139002,407,353,54,415,353,62,524,461,51,457,391,39
060816139003,583,508,75,587,508,79,665,606,50,610,522,52
060816125003,908,756,152,929,754,175,1059,924,117,1008,853,115
060816125002,503,380,123,511,371,140,627,528,87,589,458,103
060816117004,132,118,14,133,117,16,181,150,26,3,2,1
060816105001,186,152,34,187,152,35,301,248,49,230,185,35
060816105002,260,210,50,261,211,50,444,367,72,302,247,43
060816105003,143,115,28,144,116,28,272,219,43,196,159,28
060816105004,404,331,73,405,332,73,398,330,64,452,362,69
060816106021,429,360,69,433,363,70,502,429,63,516,408,78
060816106023,570,495,75,575,491,84,753,654,93,674,566,67
060816103021,436,341,95,434,327,107,987,764,199,604,428,135
060816106011,247,224,23,248,217,31,427,363,53,277,248,19
060816106013,248,225,23,247,217,30,372,317,48,493,402,57
060816107002,357,297,60,357,292,65,462,385,70,463,366,69
060816107004,675,556,119,687,547,140,913,741,158,973,751,162
060816104001,576,485,91,587,483,104,923,766,134,733,603,91
060816104002,318,276,42,318,266,52,507,426,71,462,385,53
060816104003,476,405,71,477,396,81,561,472,79,501,420,55
060816102011,132,117,15,134,116,18,231,186,38,187,154,23
060816102013,162,141,21,165,144,21,240,204,28,215,182,27
060816102014,317,278,39,321,281,40,571,487,74,414,346,51
060816102021,506,444,62,510,442,68,598,514,70,443,366,50
060816102031,158,139,19,157,138,19,265,229,28,261,222,30
060816102022,828,722,106,835,710,125,1185,1006,151,684,566,76
060816101002,313,246,67,320,246,74,406,312,83,355,259,75
060816101001,560,470,90,568,461,107,638,537,95,827,662,117
060816099001,736,563,173,750,566,184,844,643,186,726,546,146
060816100003,608,489,119,613,474,139,748,608,127,592,460,97
060816100001,959,808,151,979,807,172,1272,1087,164,992,800,131
060816100002,615,455,160,631,463,168,748,599,126,627,467,126
060816099002,988,765,223,1007,771,236,1266,1019,225,1084,818,212
060816098001,390,316,74,397,319,78,503,404,87,436,327,84
060816098003,370,276,94,377,281,96,472,379,88,424,309,96
060816110001,516,410,106,519,411,108,625,497,112,549,418,95
060816110002,525,411,114,537,413,124,712,558,138,594,450,107
060816110004,889,708,181,908,714,194,1241,975,243,1059,817,184
060816111002,1153,893,260,1173,892,281,1470,1142,300,1285,973,250
060816110003,506,396,110,519,400,119,545,428,104,422,326,73
060816102032,275,244,31,278,249,29,466,380,70,502,434,48
060816109012,281,238,43,285,246,39,380,339,32,240,204,24
060816109011,599,492,107,601,486,115,832,672,133,730,586,102
060816109022,569,460,109,575,457,118,627,520,103,453,359,64
060816107001,406,340,66,412,342,70,382,319,55,364,298,51
060816108003,202,172,30,201,167,34,303,259,41,309,254,38
060816108002,74,63,11,74,62,12,178,151,19,239,197,30
060816109021,550,484,66,549,470,79,762,647,99,589,487,74
060816108001,573,498,75,575,482,93,876,710,135,831,659,131
060816107003,333,270,63,335,262,73,472,365,95,404,308,74
060816112002,911,704,207,934,702,232,1135,922,187,961,723,184
060816112001,601,463,138,610,460,150,649,528,113,635,487,126
060816102012,384,340,44,386,329,57,546,454,74,369,312,43
060816103032,1190,856,334,1207,876,331,846,664,169,964,710,203
060816103033,746,546,200,771,564,207,1153,915,216,758,580,142
060816103035,261,206,55,266,210,56,338,268,62,311,240,51
060816103041,654,460,194,668,466,202,1027,786,221,817,602,179
060816103043,377,265,112,385,269,116,554,424,120,627,455,140
060816103031,612,441,171,631,457,174,818,651,154,660,503,123
060816103034,456,345,111,464,352,112,774,613,146,598,465,97
060816001005,431,356,75,439,352,87,500,397,93,489,382,83
060816001004,434,352,82,446,350,96,601,482,103,540,426,87
060816001001,538,441,97,554,439,115,733,590,127,601,475,95
060816001002,476,378,98,483,371,112,567,445,111,392,307,67
060816012001,477,382,95,480,377,103,885,668,204,814,650,127
060816008002,310,254,56,313,250,63,494,393,95,552,462,70
060816012002,466,369,97,471,365,106,543,408,125,448,342,82
060816011003,361,285,76,368,288,80,696,534,158,487,399,76
060816012004,495,391,104,500,386,114,760,567,174,648,496,119
060816012003,472,371,101,473,357,116,668,501,152,514,410,84
060816014001,491,382,109,499,375,124,720,538,175,470,364,88
060816013021,610,516,94,614,510,104,1041,812,212,488,418,59
060816013022,358,299,59,360,290,70,710,553,143,409,344,53
060816013013,254,207,47,254,199,55,296,236,60,229,193,29
060816016011,285,245,40,292,238,54,553,439,105,438,367,58
060816016012,464,355,109,461,350,111,613,477,132,503,394,90
060816037002,1204,906,298,1224,900,324,1683,1215,432,1347,1000,282
060816037001,1149,860,289,1166,857,309,1590,1183,380,1264,934,271
060816140001,735,531,204,745,533,212,969,721,230,770,537,199
060816140003,433,324,109,438,321,117,780,591,175,524,391,108
060816025003,559,420,139,572,438,134,909,705,190,674,534,123
060816002001,466,392,74,474,386,88,742,571,160,581,479,77
060816002002,524,429,95,529,430,99,872,673,187,600,489,91
060816003002,671,542,129,677,544,133,943,729,190,772,607,134
060816003001,654,534,120,660,531,129,918,732,168,681,537,112
060816004011,546,449,97,552,448,104,917,720,177,686,545,109
060816004012,355,296,59,355,293,62,519,395,112,437,352,64
060816004021,309,257,52,308,253,55,549,424,121,394,324,56
060816004022,470,392,78,465,388,77,794,608,173,646,527,89
060816004023,257,216,41,261,215,46,493,373,105,356,291,46
060816007011,395,323,72,398,322,76,739,559,174,484,393,74
060816005013,393,317,76,399,315,84,688,545,130,501,409,68
060816007012,251,215,36,258,217,41,532,395,125,379,319,46
060816006003,262,219,43,264,219,45,420,336,80,370,303,50
060816006001,690,561,129,695,556,139,1103,869,211,762,625,106
060816007013,258,220,38,264,222,42,419,317,96,305,258,37
060816007021,324,276,48,330,279,51,575,443,116,342,289,39
060816007022,299,255,44,305,258,47,466,347,109,324,271,38
060816005012,312,256,56,314,252,62,396,314,75,332,273,50
060816005021,723,578,145,740,588,152,820,634,172,732,598,112
060816005011,203,166,37,202,163,39,333,264,65,263,217,40
060816006002,324,267,57,326,263,63,529,410,104,442,364,66
060816013011,317,261,56,317,256,61,544,431,108,426,358,55
060816005022,409,324,85,416,329,87,602,466,127,563,460,86
060816013012,420,342,78,421,332,89,674,532,134,515,430,66
060816008003,373,305,68,372,300,72,479,382,92,469,382,61
060816009001,754,526,228,763,530,233,829,625,196,808,566,201
060750604002,313,259,54,318,260,58,245,189,51,209,156,39
060816009002,646,470,176,658,474,184,1059,801,244,798,581,182
060816011002,223,178,45,229,181,48,416,319,96,223,183,34
060816011004,469,371,98,478,376,102,814,623,173,595,477,94
060816011005,475,376,99,488,383,105,751,571,171,483,390,79
060816008001,273,224,49,277,221,56,396,315,75,440,369,55
060816008004,164,134,30,164,131,33,249,199,48,237,193,30
060816011001,283,232,51,286,228,58,505,380,118,219,184,28
060816010001,595,479,116,612,482,130,816,637,165,655,533,98
060816010004,371,295,76,379,292,87,575,451,120,455,376,67
060816010002,493,400,93,508,402,106,747,591,149,574,464,85
060816014003,325,249,76,328,248,80,572,433,123,388,309,65
060816014002,650,509,141,655,501,154,1065,816,238,801,639,135
060816015011,580,458,122,585,452,133,950,750,191,765,611,122
060816014004,445,336,109,451,335,116,826,636,183,483,382,85
060816015013,430,335,95,431,327,104,557,423,134,525,413,92
060816015022,233,184,49,236,182,54,443,331,107,384,303,65
060816015021,312,236,76,317,236,81,687,511,166,584,461,101
060816016041,737,596,141,748,590,158,1057,804,239,869,704,135
060816015012,437,345,92,443,336,107,636,489,143,511,404,84
060816016054,582,450,132,591,446,145,665,503,153,599,469,110
060816016031,855,658,197,868,656,212,1307,1005,288,926,730,169
060816017003,614,474,140,624,471,153,830,645,171,716,553,137
060816016033,220,170,50,226,174,52,666,514,143,440,336,90
060816016053,709,545,164,725,538,187,1145,885,251,837,661,151
060816016051,370,280,90,375,276,99,589,454,128,479,373,92
060816016052,302,227,75,310,227,83,358,274,79,338,262,68
060816016032,616,477,139,628,482,146,964,753,199,747,569,153
060816026021,405,318,87,414,325,89,795,621,164,516,414,85
060816026011,724,570,154,738,571,167,1294,1013,260,892,714,145
060816026012,584,459,125,591,451,140,713,553,151,680,544,111
060816025001,620,467,153,627,462,165,929,715,199,714,559,137
060816025002,517,390,127,522,385,137,786,584,196,634,493,121
060952518021,265,225,40,267,225,42,501,410,82,340,288,42
060952518031,219,170,49,223,169,54,331,239,89,220,174,40
060952518022,423,336,87,432,337,95,603,474,117,489,382,87
060952518032,347,264,83,351,265,86,557,407,141,495,381,91
060952518033,317,245,72,321,246,75,488,354,122,424,327,76
060952518041,287,225,62,291,225,66,459,341,110,380,300,68
060952518042,343,270,73,347,270,77,460,341,111,370,293,64
060952518043,321,249,72,328,251,77,480,354,115,393,305,70
060952518034,313,254,59,318,251,67,566,417,137,496,399,80
060952519021,303,245,58,308,244,64,415,341,70,375,305,59
060952519022,446,362,84,451,359,92,714,576,120,617,495,98
060952519011,533,449,84,539,453,86,683,553,117,577,483,72
060952519023,232,188,44,237,188,49,379,307,64,336,270,54
060952519024,475,419,56,490,417,73,739,602,125,665,570,74
060952519031,399,334,65,402,336,66,479,397,71,429,370,46
060952519032,545,458,87,552,462,90,925,779,139,653,570,69
060952519033,603,507,96,610,511,99,959,797,144,758,652,84
060952519012,232,189,43,234,190,44,343,280,57,337,271,49
060952519013,559,474,85,567,478,89,748,610,125,642,537,81
060952514002,493,384,109,506,388,118,689,508,161,612,458,120
060952514003,556,424,132,566,424,142,808,586,196,696,510,144
060952517011,524,427,97,531,428,103,716,575,127,533,419,84
060952517012,672,558,114,676,556,120,850,684,143,588,469,83
060952514001,777,605,172,793,605,188,1149,867,254,1060,771,219
060952517021,273,228,45,276,227,49,426,344,72,347,277,46
060952517022,213,178,35,216,178,38,254,205,43,176,140,24
060952517023,231,193,38,231,192,39,504,404,85,438,348,58
060952512001,368,314,54,373,312,61,537,423,90,406,327,56
060952512002,259,217,42,262,214,48,423,342,67,321,252,44
060952512003,206,179,27,211,179,32,246,210,34,229,189,28
060952515002,379,297,82,382,293,89,625,481,126,539,406,99
060952515003,362,305,57,366,305,61,481,391,78,412,331,55
060952510001,222,185,37,225,182,43,269,222,42,237,190,32
060952510002,311,257,54,315,257,58,381,311,63,304,242,47
060952513001,409,302,107,410,298,112,367,282,84,331,233,72
060952513002,499,371,128,505,367,138,539,402,124,449,314,100
060952513003,478,357,121,488,354,134,462,343,105,389,273,88
060952515001,205,150,55,205,150,55,440,329,100,340,247,75
060952501031,467,350,117,469,347,122,632,467,158,506,384,104
060952501032,618,460,158,624,454,170,886,634,239,710,534,146
060952501033,452,339,113,457,338,119,614,454,153,510,378,105
060952501041,403,295,108,414,300,114,527,390,125,453,337,98
060952501051,453,341,112,460,340,120,740,582,144,664,495,138
060952501053,868,656,212,882,650,232,1448,1069,362,1038,801,201
060952501042,457,334,123,471,340,131,576,424,139,508,377,111
060952501052,1007,778,229,1030,780,250,1378,1034,325,932,726,175
060952501061,481,328,153,487,332,155,572,402,163,464,327,118
060952501062,1002,774,228,1021,780,241,1385,1040,324,1180,938,202
060952521033,1036,784,252,1047,763,284,1124,866,234,839,625,175
060952521031,127,93,34,130,92,38,384,291,89,595,438,135
060952509001,306,253,53,307,251,56,455,360,83,402,332,51
060952509002,174,145,29,176,145,31,363,281,70,176,140,24
060952509003,280,231,49,282,229,53,328,272,46,327,255,49
060952516001,314,262,52,317,260,57,365,308,53,372,308,52
060952516002,367,305,62,369,303,66,492,403,75,393,328,47
060952502002,371,285,86,376,279,97,426,321,94,339,252,66
060952502003,423,325,98,426,318,108,661,499,146,537,399,105
060952503002,391,307,84,401,305,96,557,418,130,432,335,77
060952503003,206,160,46,210,160,50,289,214,66,244,188,42
060952522061,847,576,271,860,588,272,1333,922,388,1175,789,339
060952502001,408,309,99,411,302,109,706,530,160,580,426,122
060952503001,355,270,85,360,266,94,531,386,134,407,304,85
060952520001,732,497,235,742,492,250,769,526,220,678,452,177
060952520002,440,301,139,450,304,146,556,388,153,464,314,122
060952521021,1027,697,330,1042,691,351,1390,950,405,1198,801,309
060952520003,482,332,150,493,340,153,582,432,141,536,367,140
060952521081,782,544,238,795,549,246,829,608,194,869,593,222
060952521082,805,553,252,821,558,263,1058,756,271,962,648,253
060952521022,795,530,265,815,520,295,1080,746,313,838,538,232
060952521071,1004,668,336,1024,657,367,1265,871,363,1190,771,332
060952506051,358,277,81,365,274,91,522,381,133,333,257,61
060952520004,673,469,204,689,483,206,719,535,163,676,462,170
060952521052,808,537,271,818,536,282,1112,741,351,899,591,251
060952521062,667,443,224,680,440,240,746,507,223,675,445,184
060952521063,564,376,188,573,374,199,802,572,209,757,499,205
060952521042,719,434,285,734,444,290,1047,730,292,811,522,244
060952521051,850,560,290,868,555,313,1333,866,435,968,630,272
060952521061,749,483,266,764,482,282,993,679,290,861,561,248
060952521072,631,417,214,644,415,229,828,565,243,749,490,208
060952505022,693,487,206,707,482,225,996,737,234,773,541,188
060952521041,1317,885,432,1339,873,466,1716,1162,527,1141,750,324
060952521043,859,514,345,880,530,350,1214,824,363,1051,677,319
060952522041,873,554,319,883,559,324,1372,896,449,1067,678,319
060952522042,785,403,382,793,411,382,1284,715,538,874,426,391
060952522062,922,567,355,940,558,382,1410,874,499,1135,759,308
060952522051,1243,844,399,1262,827,435,1424,954,441,1228,812,339
060952522052,662,467,195,671,458,213,1686,1194,459,663,428,191
060952522053,847,589,258,858,575,283,1297,899,370,985,641,281
060952523051,500,348,152,510,350,160,827,570,234,639,430,175
060952524021,272,200,72,276,193,83,414,279,127,246,177,54
060952524023,228,167,61,235,164,71,331,245,79,343,248,75
060952524022,635,440,195,642,438,204,1008,686,297,738,508,187
060952508014,353,285,68,359,285,74,422,338,78,362,273,73
060952507011,311,257,54,314,261,53,581,476,92,446,367,59
060952507012,321,263,58,323,264,59,459,373,76,444,361,57
060952508012,215,178,37,217,181,36,329,263,56,301,246,38
060952508013,316,244,72,324,245,79,569,425,127,463,319,109
060952508011,330,262,68,337,265,72,449,341,89,380,285,67
060952510003,232,192,40,236,190,46,370,303,61,241,191,42
060952511002,350,289,61,356,285,71,552,433,112,426,319,69
060952511001,300,244,56,308,252,56,510,398,93,436,347,67
060952506011,498,379,119,504,381,123,631,491,128,609,458,123
060952506043,491,376,115,497,377,120,676,515,151,504,386,94
060952506013,230,177,53,235,174,61,366,294,60,372,287,69
060952506052,568,444,124,575,442,133,786,601,168,653,494,123
060952506012,569,436,133,575,433,142,834,647,171,797,616,147
060952506041,623,476,147,629,476,153,1021,777,226,777,596,146
060952506053,819,637,182,829,636,193,1145,885,246,952,721,180
060952506042,419,333,86,426,331,95,528,405,115,448,340,87
060952521032,725,521,204,737,512,225,1037,741,279,938,643,239
060952505011,294,205,89,298,199,99,550,368,170,389,265,103
060952505012,388,296,92,396,293,103,308,226,75,419,287,107
060952505021,606,424,182,620,425,195,808,599,195,733,525,173
060952504001,274,208,66,279,209,70,468,344,116,282,203,62
060952504002,475,359,116,481,361,120,813,592,198,494,353,113
060952504003,253,172,81,253,162,91,368,247,116,352,229,101
060952522031,478,214,264,483,216,267,424,211,202,394,171,196
060952522043,372,149,223,375,152,223,492,247,236,413,179,214
060952523062,1019,642,377,1030,634,396,1293,775,479,968,589,315
060952523052,803,442,361,808,435,373,1192,700,460,725,393,292
060952523053,814,469,345,825,460,365,1047,610,412,933,531,344
060952523061,683,393,290,690,384,306,833,506,307,740,443,257
060952523111,694,397,297,703,392,311,925,583,315,678,413,216
060952523113,442,272,170,445,268,177,605,384,210,535,320,189
060952523121,670,387,283,677,381,296,953,554,375,903,503,342
060952523122,314,186,128,318,182,136,367,258,97,335,228,87
060952523101,1041,545,496,1057,553,504,1441,846,568,1295,708,515
060952523102,610,295,315,615,295,320,752,418,320,603,303,262
060952523112,904,585,319,913,580,333,1231,811,397,998,636,313
060952524011,280,195,85,289,198,91,351,246,92,255,174,61
060952524013,282,195,87,287,198,89,406,264,133,336,204,120
060952524012,194,134,60,196,135,61,332,236,87,220,156,52
060952524014,199,137,62,203,139,64,385,275,100,275,192,67
060952525012,356,246,110,365,250,115,548,385,145,385,269,94
060952525021,162,114,48,165,113,52,229,166,61,147,106,38
060952526043,184,131,53,186,127,59,294,206,78,282,196,68
060952526052,194,137,57,199,134,65,319,217,94,318,218,79
060952526041,227,166,61,231,159,72,328,237,86,242,165,59
060952526042,320,232,88,326,223,103,598,429,154,439,299,106
060952526053,196,151,45,201,148,53,465,340,113,206,158,41
060952526051,387,293,94,398,287,111,524,383,126,495,348,121
060952522032,575,356,219,587,360,227,1437,951,459,1005,638,300
060952522033,1003,563,440,1020,562,458,856,492,346,484,282,172
060952525011,170,120,50,171,115,56,236,167,61,172,117,46
060952525022,178,124,54,177,120,57,231,166,61,299,202,79
060952526062,193,137,56,196,133,63,355,244,103,274,185,72
060952526063,317,223,94,320,216,104,431,295,125,362,240,93
060952526071,281,195,86,286,189,97,359,250,93,330,218,86
060952526072,277,193,84,284,187,97,575,407,148,443,298,114
060952526082,401,319,82,403,313,90,704,516,165,494,367,100
060952526061,439,325,114,443,319,124,650,452,182,588,401,149
060952526081,382,282,100,383,277,106,534,421,101,465,327,102
060952526112,201,150,51,203,146,57,259,188,61,175,135,29
060952526113,208,154,54,209,151,58,408,298,96,244,189,40
060952526102,436,303,133,442,300,142,650,477,159,512,348,131
060952526111,306,209,97,311,207,104,452,324,113,421,302,95
060952526101,519,335,184,526,321,205,792,533,237,612,403,167
060952527072,548,353,195,558,340,218,745,476,248,666,408,229
060952526054,179,137,42,181,134,47,266,202,58,202,153,38
060952528021,22,16,6,21,13,8,329,204,110,365,224,114
060952527021,342,216,126,345,213,132,447,290,145,365,217,119
060952527022,244,155,89,252,154,98,380,243,122,294,175,92
060952527023,283,180,103,288,178,110,378,239,122,319,187,101
060952527031,325,236,89,327,227,100,491,360,116,381,269,83
060952527032,470,342,128,470,328,142,644,472,155,554,403,115
060952527033,386,282,104,385,267,118,545,396,133,459,343,94
060952527071,561,402,159,567,392,175,926,671,226,763,541,173
060952527042,270,192,78,272,187,85,409,298,101,299,206,72
060952527041,186,132,54,187,128,59,338,246,83,251,172,61
060952527044,251,179,72,254,175,79,334,234,87,240,164,59
060952527045,331,235,96,333,230,103,582,413,152,403,277,97
060952527043,265,192,73,267,184,83,390,288,93,303,203,82
060952527073,285,114,171,288,117,171,419,200,207,333,132,173
060952527024,686,487,199,699,482,217,743,544,182,724,512,170
060952527025,417,296,121,423,292,131,477,349,117,447,318,104
060952527026,306,202,104,310,198,112,521,360,146,391,263,109
060952527051,327,236,91,332,226,106,582,414,147,374,263,87
060952527052,285,185,100,289,178,111,410,276,125,327,204,100
060952527061,549,396,153,553,377,176,892,661,219,623,447,142
060952534021,422,275,147,432,268,164,680,405,258,484,295,161
060952534042,395,204,191,402,205,197,584,320,247,504,256,216
060952534044,786,395,391,789,375,414,1104,528,553,1007,469,474
060952534043,510,258,252,508,241,267,606,319,273,504,263,207
060952534041,389,201,188,397,204,193,565,295,249,482,258,195
060952534033,1024,496,528,1038,486,552,1259,621,611,1058,489,497
060952534022,304,147,157,314,150,164,374,184,170,279,143,123
060952534023,249,120,129,251,119,132,343,181,152,255,128,113
060952534024,716,354,362,728,349,379,1120,583,509,886,424,398
060952533001,576,219,357,586,212,374,682,253,407,606,232,337
060952534031,669,321,348,678,315,363,896,435,434,744,377,319
060952534032,471,227,244,477,221,256,607,283,305,628,266,328
060952534025,597,308,289,609,297,312,1016,498,481,575,287,245
060952532011,742,329,413,755,320,435,918,414,483,700,300,343
060952532012,491,214,277,490,203,287,586,266,303,503,215,253
060952532013,565,259,306,581,256,325,738,351,373,608,276,290
060952532014,786,361,425,806,356,450,902,407,467,713,329,339
060952532031,501,247,254,514,239,275,742,357,360,809,365,381
060952532032,561,278,283,568,265,303,827,405,401,760,339,355
060952532071,1003,451,552,1020,447,573,1284,589,660,971,433,478
060952531011,159,79,80,161,78,83,239,139,94,186,99,77
060952531012,265,130,135,269,126,143,358,169,175,292,138,130
060952531013,349,172,177,354,164,190,433,202,214,297,138,133
060952531014,281,139,142,284,133,151,341,172,161,363,165,166
060952531015,393,195,198,399,191,208,554,262,273,482,222,220
060952532033,301,148,153,305,143,162,386,202,171,346,162,154
060952531016,589,297,292,600,293,307,712,356,337,551,248,255
060952532053,205,100,105,209,97,112,231,150,69,271,146,109
060952532081,414,198,216,425,195,230,611,281,311,526,234,253
060952532082,458,219,239,465,212,253,780,363,399,526,245,249
060952532083,235,113,122,241,111,130,282,189,88,351,189,142
060952532084,177,85,92,180,82,98,304,200,92,380,202,154
060952532062,518,241,277,528,233,295,1054,441,580,671,295,333
060952529033,995,382,613,1015,373,642,1193,420,736,1022,376,586
060952529044,1264,713,551,1279,704,575,1846,1070,750,1076,590,419
060952532061,717,335,382,727,322,405,955,445,492,799,349,397
060952532051,509,237,272,521,229,292,653,302,337,418,196,199
060952532052,261,123,138,267,117,150,455,210,237,192,106,78
060952529043,283,108,175,286,103,183,479,190,278,309,109,182
060952531081,611,325,286,620,313,307,859,431,403,654,342,261
060952531082,376,205,171,383,205,178,599,329,252,497,263,201
060952531083,349,187,162,352,185,167,551,300,233,478,256,188
060952531071,404,212,192,413,198,215,632,354,253,424,217,170
060952531072,568,313,255,579,299,280,660,372,271,629,335,245
060952531073,503,279,224,513,268,245,796,447,328,696,380,271
060952531074,252,139,113,255,133,122,340,223,112,305,164,118
060952531051,161,92,69,161,81,80,449,273,161,377,224,128
060952531052,193,111,82,193,97,96,688,395,271,501,277,188
060952531053,452,249,203,458,230,228,514,303,201,475,254,187
060952531054,275,174,101,277,166,111,426,250,167,258,150,91
060952531055,202,127,75,203,122,81,292,174,109,227,130,79
060952529083,338,178,160,345,173,172,498,261,225,365,188,157
060952529111,710,372,338,728,365,363,858,454,381,746,389,313
060952529123,508,266,242,519,260,259,553,290,251,404,206,173
060952533002,415,166,249,426,158,268,444,189,252,578,248,297
060952529032,593,217,376,600,210,390,712,242,451,410,144,238
060952529034,449,176,273,455,171,284,571,212,347,539,204,307
060952529041,751,284,467,766,276,490,942,348,574,829,307,471
060952529031,444,195,249,452,188,264,648,278,350,508,250,228
060952523171,1107,652,455,1131,642,489,2587,1666,869,1010,612,347
060952523172,1411,946,465,1422,902,520,1866,1264,555,904,559,280
060952523173,412,270,142,413,257,156,347,210,123,500,312,156
060952528011,104,70,34,105,67,38,36,23,12,12,7,4
060952528012,3,2,1,3,2,1,6,4,2,0,0,0
060952528013,28,19,9,29,19,10,135,83,46,186,116,57
060952528014,53,35,18,52,33,19,279,176,94,360,224,112
060952528015,15,10,5,16,10,6,97,60,35,129,80,41
060952523152,572,375,197,581,376,205,857,586,251,645,421,189
060952523153,596,389,207,603,391,212,817,541,258,672,440,195
060952523161,556,364,192,562,366,196,894,609,265,618,404,181
060952523131,306,202,104,309,197,112,433,295,124,451,290,134
060952523132,663,427,236,669,416,253,952,631,291,665,423,206
060952523141,399,263,136,404,257,147,520,337,173,437,280,130
060952523142,411,270,141,416,266,150,648,419,214,510,329,152
060952523143,445,294,151,451,288,163,632,434,184,641,412,191
060952523133,650,361,289,659,357,302,607,361,233,786,452,300
060952523134,746,407,339,757,402,355,1123,658,446,793,442,316
060952523151,476,293,183,485,287,198,612,396,202,589,371,184
060952523162,594,364,230,606,358,248,922,594,303,832,525,262
060952535013,206,101,105,211,97,114,763,449,307,289,134,139
060952535021,611,255,356,616,235,381,921,399,497,762,291,409
060952535022,497,209,288,509,196,313,698,306,381,538,211,288
060952535023,449,192,257,458,184,274,600,259,318,498,198,266
060952535012,1718,1047,671,1733,1041,692,1309,849,445,1702,1037,604
060952535011,1740,1062,678,1751,1057,694,2316,1496,798,1388,846,490
060952527053,283,181,102,288,174,114,382,248,125,294,179,95
060952527054,636,406,230,644,389,255,990,647,323,749,460,242
060952527055,421,285,136,428,274,154,641,433,192,493,315,145
060952527062,682,436,246,691,416,275,1106,702,378,793,486,254
060952529042,327,152,175,334,145,189,592,293,283,530,250,248
060952529112,686,353,333,695,351,344,780,416,354,593,305,267
060952529113,341,176,165,346,174,172,470,249,212,453,231,204
060952529114,731,376,355,740,371,369,899,477,407,826,421,372
060952529121,615,255,360,624,253,371,915,407,488,766,324,390
060952529125,486,201,285,494,199,295,576,256,308,536,227,274
060952529122,379,182,197,390,174,216,502,257,236,428,195,202
060952529124,590,284,306,609,272,337,772,391,363,682,314,322
060952531061,224,122,102,228,120,108,306,164,132,260,131,105
060952531063,481,252,229,487,242,245,721,385,309,591,298,242
060952531062,201,101,100,203,94,109,328,175,139,262,132,105
060952529131,520,234,286,526,225,301,646,340,291,549,270,230
060952529132,489,221,268,496,216,280,657,347,300,498,246,209
060952529142,438,255,183,444,234,210,710,371,312,545,269,227
060952529143,450,260,190,456,240,216,715,385,308,590,303,239
060952529081,395,210,185,399,198,201,547,275,257,409,202,175
060952529082,387,205,182,389,194,195,674,356,296,519,272,210
060952529101,425,225,200,428,214,214,660,331,314,475,237,205
060952529102,437,233,204,440,216,224,585,292,273,475,232,203
060952529103,830,432,398,838,405,433,1279,623,620,830,423,358
060952529133,363,201,162,372,201,171,587,305,269,454,224,195
060952529134,542,258,284,552,256,296,752,388,344,559,274,241
060952529141,975,529,446,991,503,488,1394,754,607,1169,613,481
060952529152,1313,727,586,1343,701,642,2356,1271,1025,999,526,409
060952529151,849,445,404,852,418,434,1010,532,454,939,487,397
060952529091,607,265,342,616,253,363,900,413,456,758,322,373
060952529092,754,339,415,768,324,444,1482,787,659,769,327,380
060952529104,389,205,184,395,192,203,721,353,349,454,230,197
060570002002,855,370,485,839,343,496,824,372,433,846,316,461
060570002001,557,270,287,551,259,292,858,389,445,641,272,308
060570009002,573,383,190,564,369,195,952,588,336,843,419,294
060570003001,497,227,270,497,217,280,534,255,266,401,140,227
060570004031,837,350,487,826,333,493,1113,459,624,900,333,502
060570003002,928,458,470,914,428,486,1121,546,554,864,361,424
060570004041,810,338,472,801,323,478,956,385,541,817,281,476
060570004042,724,322,402,712,304,408,860,421,417,627,234,351
060570004043,1119,521,598,1111,488,623,1242,594,614,1139,448,588
060570004011,522,250,272,514,236,278,477,246,215,315,132,159
060570005031,562,311,251,562,302,260,772,410,338,585,279,252
060570005023,808,450,358,797,426,371,916,481,408,646,296,292
060570005024,524,281,243,522,271,251,616,341,258,523,242,224
060570004013,991,447,544,979,426,553,1255,601,630,1232,518,645
060570009003,423,232,191,422,229,193,452,239,199,443,216,186
060570004012,910,407,503,893,387,506,1025,500,508,997,419,519
060570004014,1134,507,627,1115,483,632,1436,716,697,1121,469,584
060570008025,348,227,121,346,224,122,503,325,163,477,271,154
060570009001,904,709,195,881,671,210,985,753,204,967,637,168
060570001061,520,190,330,515,181,334,558,221,328,475,159,288
060570001074,489,178,311,481,167,314,465,183,269,460,166,268
060570001075,1151,413,738,1133,394,739,1236,508,694,1112,401,648
060570001062,539,194,345,533,187,346,685,272,400,469,144,301
060570001073,411,147,264,405,141,264,993,416,557,799,290,465
060570001053,601,233,368,589,217,372,674,275,383,694,242,391
060570001071,662,239,423,647,226,421,751,296,434,426,130,271
060570001072,802,350,452,789,330,459,1100,465,604,862,331,474
060570001024,882,397,485,866,374,492,909,393,491,797,339,414
060570001043,573,259,314,566,242,324,564,252,300,496,187,267
060570001051,459,176,283,454,166,288,545,237,296,445,135,276
060570001052,318,118,200,314,109,205,413,172,232,329,102,201
060570001021,844,372,472,835,354,481,1087,499,561,726,296,383
060570001022,931,447,484,931,427,504,1078,522,530,1029,407,549
060570001023,1195,523,672,1183,493,690,1566,723,808,1242,493,659
060570007021,1178,572,606,1165,540,625,1428,701,682,1292,559,625
060570001042,770,361,409,765,335,430,1028,483,524,771,313,404
060570001041,483,234,249,484,223,261,616,260,338,489,206,249
060570006022,380,228,152,375,217,158,613,354,237,376,185,155
060570006023,929,459,470,918,433,485,928,486,420,886,387,411
060570006024,279,155,124,278,147,131,460,264,178,367,182,150
060570006021,558,322,236,559,310,249,732,430,280,592,303,233
060570007015,821,394,427,808,373,435,980,483,471,965,422,458
060570007022,1129,532,597,1116,500,616,1232,629,580,1126,488,542
060570005041,504,294,210,502,282,220,563,328,221,488,240,199
060570005042,703,404,299,692,387,305,666,412,242,475,226,203
060570005022,514,294,220,511,282,229,559,326,219,491,226,216
060570006011,566,314,252,565,299,266,722,402,303,598,297,233
060570007013,777,447,330,778,435,343,820,501,302,695,356,275
060570008024,1029,612,417,1026,596,430,1293,823,444,1113,578,454
060570005021,378,240,138,380,235,145,403,242,153,433,239,145
060570005043,246,141,105,243,131,112,521,306,197,400,186,173
060570005044,493,296,197,491,284,207,546,325,208,480,256,171
060570005045,278,181,97,279,174,105,356,212,138,311,175,105
060570007014,548,272,276,551,265,286,709,356,337,611,256,299
060570007012,713,365,348,700,350,350,918,460,429,802,361,368
060570007011,674,354,320,670,343,327,588,306,268,535,226,249
060570008011,1063,702,361,1059,687,372,1025,691,313,912,537,269
060570007016,1142,689,453,1131,668,463,1265,771,459,1089,550,438
060570008023,654,468,186,648,452,196,855,652,180,791,515,192
060570008022,1333,978,355,1321,954,367,1591,1168,378,1426,934,341
060570008021,500,361,139,492,348,144,555,345,199,476,253,187
060570008012,1156,709,447,1138,686,452,1234,798,408,1097,587,387
060570008013,1117,671,446,1099,647,452,1522,984,509,1268,676,464
060570009004,309,194,115,303,183,120,428,251,162,310,154,121
060570012051,1046,702,344,1044,693,351,1232,909,295,892,560,259
060570012052,993,698,295,1009,700,309,1380,1000,344,1065,678,297
060570012082,533,390,143,533,386,147,723,558,145,558,372,140
060570012111,271,198,73,276,198,78,339,253,77,233,154,60
060570012112,489,347,142,493,345,148,327,246,75,329,223,82
060570012053,327,240,87,332,237,95,371,279,84,273,181,70
060570012072,652,473,179,662,471,191,1081,816,240,568,383,143
060570012092,450,336,114,458,334,124,686,527,140,484,323,119
060570012071,234,175,59,233,170,63,386,288,88,326,219,82
060570012091,339,251,88,345,250,95,548,405,129,408,279,101
060570012074,278,206,72,277,201,76,564,417,128,440,298,110
060570012102,302,219,83,302,219,83,342,255,76,321,215,80
060570012101,334,242,92,333,242,91,349,271,71,291,203,72
060570012103,338,244,94,338,244,94,390,302,80,319,214,76
060570012081,344,251,93,342,250,92,521,407,105,381,262,94
060570012073,761,567,194,756,552,204,834,631,189,770,510,194
060230007002,715,423,292,720,419,301,1051,598,421,816,427,313
060230007003,684,368,316,681,354,327,877,493,355,819,409,356
060230106001,763,459,304,760,445,315,794,485,288,646,358,227
060230107011,363,188,175,360,179,181,453,253,189,372,179,165
060230107022,807,418,389,800,399,401,1053,586,439,892,426,396
060230003004,699,452,247,709,445,264,868,556,278,643,358,222
060230004003,453,292,161,461,285,176,830,522,272,601,339,205
060230107021,202,118,84,200,115,85,289,163,119,262,131,107
060230003005,595,375,220,592,365,227,671,427,220,592,338,207
060230004001,509,269,240,515,262,253,599,347,227,589,294,253
060230004002,414,215,199,416,207,209,593,330,242,524,251,231
060230007004,407,261,146,404,250,154,477,305,160,469,271,155
060230002002,329,230,99,333,226,107,470,313,145,392,231,118
060230006003,310,201,109,309,198,111,482,325,154,458,265,152
060230006002,517,327,190,518,323,195,592,407,168,522,299,175
060230007001,511,310,201,505,309,196,770,505,243,651,369,221
060230008001,541,315,226,537,307,230,763,469,270,557,297,206
060230112001,382,207,175,390,200,190,594,310,268,493,246,210
060230112003,587,310,277,581,290,291,660,338,306,585,257,248
060230112002,465,201,264,470,189,281,678,275,377,577,234,297
060230108003,372,178,194,371,167,204,449,207,232,376,165,184
060230109011,369,175,194,371,171,200,461,207,236,409,188,186
060230108001,518,265,253,514,266,248,580,282,274,499,222,222
060230111003,352,139,213,348,134,214,485,200,265,376,138,202
060230108002,439,233,206,440,218,222,619,295,296,500,222,230
060230110003,334,127,207,330,124,206,399,179,201,390,145,205
060230109024,667,256,411,664,237,427,769,304,440,654,227,380
060230111004,262,126,136,263,122,141,447,219,212,320,106,185
060230115021,544,393,151,532,368,164,837,579,247,711,426,169
060230107012,241,135,106,238,130,108,418,233,173,226,114,91
060230107014,810,461,349,808,451,357,895,494,372,784,391,322
060230107013,253,149,104,253,149,104,428,239,178,398,196,157
060230116006,151,91,60,149,90,59,222,155,61,196,91,79
060230109021,256,151,105,261,142,119,284,141,134,262,107,113
060230109022,242,94,148,242,89,153,480,196,268,372,141,203
060230108004,298,148,150,294,136,158,546,249,285,464,204,221
060230109012,341,173,168,343,169,174,531,239,269,446,210,196
060230110002,492,210,282,494,208,286,661,301,340,816,330,421
060230109013,738,323,415,737,312,425,1163,525,594,864,358,449
060230109023,571,235,336,572,230,342,591,259,311,565,219,299
060230110001,695,282,413,706,272,434,1035,468,527,584,205,340
060230111001,323,127,196,319,121,198,430,173,239,337,124,184
060230111002,347,148,199,346,137,209,613,254,349,468,182,229
060230115013,632,497,135,627,480,147,224,159,57,229,148,49
060230116005,126,66,60,122,64,58,276,194,73,207,107,71
060230116001,258,201,57,257,196,61,351,245,90,343,200,76
060230116004,207,152,55,205,149,56,358,245,92,303,188,71
060230116003,374,270,104,372,261,111,473,332,120,423,242,107
060230115012,162,124,38,158,116,42,377,264,97,331,196,76
060230116002,181,130,51,183,126,57,243,168,62,218,119,65
060230115011,480,383,97,473,363,110,661,446,167,547,328,110
060230010023,454,423,31,457,418,39,493,438,43,411,326,32
060230010021,362,329,33,360,320,40,599,518,54,557,428,58
060230010012,633,584,49,632,576,56,891,782,67,684,519,46
060230009001,1070,948,122,1063,925,138,983,843,102,1041,795,125
060230010011,628,562,66,626,547,79,711,627,63,692,524,65
060230011031,896,771,125,889,743,146,1024,880,100,1016,739,129
060230011023,847,745,102,848,736,112,998,843,119,784,580,92
060230011022,410,350,60,415,352,63,794,652,108,653,465,95
060230012001,862,738,124,865,722,143,1157,968,144,1039,729,140
060230010022,391,355,36,394,351,43,676,582,68,473,379,36
060230009002,658,528,130,652,517,135,689,558,113,629,460,110
060230009004,674,491,183,670,479,191,874,617,232,866,566,210
060230013001,620,461,159,611,456,155,734,521,183,619,400,146
060230011021,801,622,179,800,608,192,857,628,193,720,466,162
060230012002,595,413,182,596,411,185,653,464,176,506,308,144
060230012003,432,340,92,426,327,99,826,619,173,584,382,132
060230103003,289,208,81,290,206,84,429,301,114,384,235,106
060230103004,408,289,119,405,283,122,537,384,139,413,255,111
060230008003,768,490,278,767,477,290,1023,648,343,826,480,258
060230009003,294,214,80,291,211,80,520,371,134,462,297,115
060230106002,490,328,162,490,321,169,381,239,134,342,201,110
060230001001,371,284,87,370,278,92,638,472,147,410,272,90
060230001002,373,287,86,374,279,95,566,406,119,408,265,88
060230001004,258,197,61,263,196,67,328,240,77,239,161,49
060230002004,420,289,131,421,288,133,570,385,162,432,255,116
060230002005,191,138,53,186,133,53,236,169,54,173,103,43
060230002006,324,236,88,323,229,94,415,307,97,337,216,77
060230003001,221,136,85,222,133,89,366,244,112,286,161,97
060230003002,215,141,74,216,137,79,269,179,83,234,129,79
060230002003,207,139,68,208,139,69,310,210,96,215,132,62
060230003003,222,145,77,223,143,80,358,236,107,295,160,102
060230002001,421,295,126,416,283,133,561,381,164,386,248,108
060230006004,531,370,161,531,358,173,620,436,163,640,387,193
060230005001,296,229,67,296,223,73,506,375,121,423,269,96
060230005002,344,252,92,344,249,95,470,325,128,412,244,115
060230005003,245,187,58,248,184,64,350,258,83,297,194,70
060230006001,321,225,96,316,217,99,451,308,121,339,204,101
060230006005,543,359,184,542,348,194,640,450,177,592,351,184
060230001003,263,199,64,262,193,69,291,218,66,259,164,67
060230005004,287,221,66,285,216,69,407,300,90,366,246,79
060230008002,631,368,263,627,360,267,779,475,275,744,398,272
060230103001,474,322,152,480,323,157,477,362,104,499,326,139
060230103002,329,206,123,327,201,126,328,206,112,314,176,107
060230105021,794,482,312,790,474,316,1031,657,344,846,480,301
060230101021,310,169,141,305,164,141,472,271,190,491,222,217
060230103005,191,122,69,191,120,71,277,177,92,280,156,98
060230102001,471,383,88,458,363,95,513,402,99,465,329,83
060230102002,623,511,112,616,501,115,541,407,117,481,358,72
060230102003,171,141,30,173,138,35,300,226,66,278,191,51
060230102004,160,110,50,159,104,55,473,359,104,329,191,102
060230104002,759,513,246,756,508,248,964,623,320,833,501,262
060230101023,78,52,26,76,54,22,121,96,25,66,43,14
060230101024,209,151,58,209,148,61,169,130,39,214,118,52
060239400001,338,265,73,331,256,75,444,331,90,247,179,42
060239400002,18,14,4,17,13,4,388,311,72,214,155,38
060230101022,350,181,169,347,176,171,366,200,152,289,127,130
060230105032,761,507,254,758,494,264,1052,707,309,665,374,216
060230105031,507,347,160,502,343,159,959,643,281,699,429,206
060230105042,547,384,163,534,372,162,658,442,194,671,422,179
060230105022,805,496,309,794,493,301,1099,698,375,870,501,296
060230105041,865,582,283,867,572,295,1114,752,327,984,574,310
060230105023,806,531,275,799,510,289,1103,699,379,863,499,284
060230104001,911,600,311,911,591,320,1129,754,333,932,538,308
060470003011,475,366,109,485,354,131,347,251,83,270,208,44
060470003012,167,127,40,170,125,45,281,205,68,176,138,27
060470003062,84,67,17,84,64,20,258,184,64,233,180,37
060470003063,53,42,11,52,38,14,204,151,49,145,114,26
060470003053,202,153,49,204,148,56,426,305,109,398,318,61
060470003051,480,364,116,496,353,143,899,635,240,624,502,95
060470003061,311,246,65,314,240,74,571,408,142,450,362,60
060470003013,556,389,167,561,389,172,808,525,268,605,425,143
060470003031,741,384,357,751,366,385,342,136,200,268,108,147
060470003052,214,161,53,217,154,63,792,551,225,344,275,59
060470015011,549,365,184,558,353,205,811,503,282,686,435,200
060470015031,174,146,28,176,138,38,339,243,85,233,186,35
060470015032,168,142,26,171,134,37,281,204,68,281,226,40
060470016032,176,147,29,178,142,36,267,194,61,217,170,28
060470016033,146,119,27,146,113,33,234,177,54,156,123,22
060470015021,167,138,29,169,129,40,249,184,54,229,186,26
060470015022,179,148,31,175,137,38,203,157,41,175,146,19
060470015033,158,134,24,160,124,36,263,205,47,205,174,21
060470016042,316,257,59,320,249,71,474,338,117,391,291,75
060470016041,191,152,39,194,149,45,511,359,135,315,243,54
060470016031,131,106,25,135,101,34,272,204,52,226,171,32
060470016012,100,85,15,103,81,22,162,132,26,139,116,15
060470016013,72,56,16,71,52,19,163,121,31,133,109,15
060470016011,127,101,26,130,97,33,223,163,49,174,143,23
060470014011,460,236,224,462,236,226,628,335,276,534,281,219
060470017002,223,144,79,228,145,83,403,243,149,317,185,98
060470019011,303,146,157,303,143,160,408,197,206,297,158,130
060470019014,198,154,44,197,147,50,384,277,96,272,211,43
060470019012,118,82,36,118,81,37,202,134,68,171,125,41
060470019013,180,120,60,184,117,67,332,200,116,249,167,68
060470019022,270,64,206,270,62,208,323,84,237,302,72,219
060470026012,280,132,148,286,134,152,504,255,234,407,190,192
060470026021,117,41,76,119,43,76,192,73,111,174,75,88
060470017004,376,232,144,378,220,158,462,259,187,358,199,135
060470009012,184,46,138,183,47,136,271,80,187,226,67,150
060470012002,508,271,237,523,271,252,670,368,293,564,289,242
060470012003,362,191,171,365,189,176,463,246,206,417,209,183
060470012004,724,288,436,734,289,445,902,363,516,750,308,395
060470014023,557,287,270,571,291,280,617,327,273,543,266,241
060470026022,441,195,246,450,200,250,612,295,305,520,225,272
060470026023,646,332,314,660,341,319,1250,720,511,802,396,371
060470014012,378,210,168,381,202,179,644,355,265,527,278,210
060470014021,318,165,153,327,169,158,561,304,246,450,225,195
060470014022,234,108,126,235,103,132,270,130,131,218,105,102
060470013012,352,211,141,354,204,150,553,326,209,431,227,164
060470010042,340,181,159,345,178,167,469,257,206,401,196,177
060470013013,199,129,70,201,122,79,286,179,102,272,153,102
060470011012,473,260,213,480,261,219,738,405,316,667,355,268
060470011013,514,268,246,521,270,251,689,354,320,554,282,237
060470012001,354,187,167,359,188,171,517,280,225,461,230,196
060470014024,271,144,127,277,143,134,423,226,186,381,193,169
060470013011,132,76,56,134,77,57,221,131,86,162,96,56
060470013021,186,102,84,187,100,87,270,153,107,226,119,81
060470013022,212,143,69,213,141,72,321,213,104,248,152,77
060470013023,186,133,53,185,126,59,317,204,95,299,189,87
060470010043,443,233,210,449,235,214,575,314,238,506,256,222
060470017003,298,187,111,300,177,123,659,400,230,572,344,180
060470011011,536,268,268,542,263,279,650,326,310,537,251,253
060470010063,569,294,275,577,291,286,795,452,328,670,346,278
060470010062,439,217,222,450,222,228,672,350,308,529,263,237
060470010071,262,171,91,265,169,96,495,326,156,288,185,82
060470010072,677,458,219,681,456,225,1260,852,381,541,349,149
060470010061,592,341,251,601,328,273,859,511,335,740,381,305
060470011014,537,238,299,553,244,309,720,352,354,594,269,299
060470018011,1671,932,739,1711,930,781,1908,957,907,2004,1083,789
060470010033,212,156,56,212,151,61,366,260,94,293,202,72
060470010041,247,199,48,252,196,56,402,293,98,350,245,79
060470010051,469,316,153,479,308,171,743,504,226,615,384,189
060470026011,156,84,72,156,82,74,351,215,129,180,113,55
060470017001,232,120,112,235,124,111,330,181,148,274,123,138
060470006011,303,143,160,308,135,173,452,218,220,393,179,185
060470006012,320,177,143,326,168,158,352,188,155,280,151,118
060470006013,176,104,72,177,96,81,334,187,137,281,159,109
060470007011,309,185,124,311,181,130,491,305,167,406,233,151
060470007012,202,120,82,206,122,84,397,254,131,316,185,112
060470008021,600,305,295,606,297,309,995,501,469,733,363,338
060470008022,614,302,312,625,296,329,905,461,420,721,356,329
060470006021,507,243,264,509,232,277,670,343,317,588,277,273
060470006022,357,154,203,362,155,207,590,277,294,524,216,267
060470008012,458,226,232,459,223,236,733,359,360,538,274,239
060470005031,432,132,300,442,130,312,646,203,429,511,167,318
060470006033,306,161,145,308,161,147,371,190,168,280,141,126
060470006034,123,66,57,123,65,58,290,148,134,225,114,101
060470006035,80,42,38,81,42,39,201,103,91,127,63,57
060470006014,440,186,254,446,179,267,621,277,326,504,203,266
060470006031,544,208,336,549,212,337,713,298,401,551,195,333
060470006032,321,139,182,326,140,186,524,231,280,422,168,236
060470009041,591,279,312,600,277,323,1120,548,552,833,402,379
060470008011,506,248,258,510,250,260,715,356,346,512,247,245
060470008013,516,296,220,521,285,236,866,490,357,477,254,195
060470009032,451,201,250,454,205,249,632,272,347,506,215,269
060470009042,393,254,139,399,237,162,660,389,256,514,322,170
060470010081,367,241,126,368,228,140,644,392,235,422,252,147
060470025002,563,195,368,569,195,374,663,226,425,579,182,370
060470007021,615,149,466,619,146,473,802,214,578,678,177,460
060470007023,496,173,323,499,180,319,1016,378,620,754,287,431
060470009031,416,281,135,419,275,144,715,455,236,479,308,141
060470007022,915,269,646,921,274,647,1052,343,691,885,277,568
060470010082,742,436,306,753,435,318,1105,645,436,962,553,356
060470010032,359,257,102,358,251,107,486,346,127,429,298,108
060470010083,474,310,164,481,300,181,907,589,289,618,390,174
060470003032,176,76,100,175,69,106,246,111,128,228,96,120
060470005051,535,210,325,532,204,328,752,300,435,603,252,321
060470002011,493,189,304,499,187,312,565,198,360,465,161,282
060470025001,280,76,204,284,83,201,422,126,291,356,88,249
060470002012,379,193,186,390,191,199,604,279,301,486,232,225
060470002021,345,171,174,355,168,187,506,251,246,308,163,131
060470002051,212,148,64,215,143,72,452,281,161,341,222,96
060470002041,260,179,81,264,178,86,540,339,184,322,212,90
060470002042,156,111,45,156,108,48,406,263,132,335,235,80
060470002052,221,162,59,225,158,67,399,271,117,298,216,60
060470002053,221,163,58,223,157,66,388,263,114,281,206,59
060470002043,322,227,95,325,224,101,527,335,176,465,319,112
060470020021,440,193,247,443,176,267,653,282,360,493,195,275
060470020022,366,189,177,370,180,190,532,265,247,413,191,185
060470020023,149,67,82,153,66,87,338,159,173,282,127,138
060470020024,324,177,147,336,174,162,400,202,193,351,173,157
060470020025,274,126,148,278,122,156,460,201,247,359,163,173
060470020011,296,112,184,299,109,190,401,145,245,337,125,187
060470004031,411,106,305,417,105,312,509,125,377,406,109,279
060470004032,575,181,394,592,171,421,1082,295,767,733,218,471
060470004042,829,203,626,843,180,663,1325,295,1005,890,217,622
060470004041,422,98,324,437,98,339,624,139,480,487,110,367
060470004011,192,65,127,192,58,134,540,169,360,429,158,256
060470009011,311,72,239,319,74,245,403,96,301,354,98,242
060470005042,334,214,120,336,195,141,354,209,138,246,162,71
060470005052,138,85,53,142,76,66,281,154,118,190,119,59
060470005043,255,169,86,260,162,98,535,347,180,476,295,155
060470005053,285,187,98,283,177,106,614,395,207,387,252,117
060470005041,304,188,116,308,181,127,482,297,171,480,288,168
060470021001,429,139,290,440,129,311,609,210,390,479,164,295
060470021002,117,36,81,120,35,85,228,75,147,211,76,125
060470023031,527,291,236,534,282,252,829,442,370,671,339,286
060470024032,473,225,248,480,221,259,633,301,317,507,234,248
060470024041,329,189,140,326,177,149,509,284,216,449,250,179
060470024042,127,93,34,126,84,42,276,181,88,172,122,37
060470024043,463,212,251,475,207,268,707,331,369,511,232,249
060470022011,102,63,39,105,60,45,192,117,73,155,96,51
060470022012,209,132,77,215,123,92,292,160,118,272,164,89
060470022013,158,101,57,165,94,71,353,202,137,268,163,88
060470022015,325,202,123,330,188,142,443,258,179,350,215,120
060470023011,707,264,443,724,249,475,867,322,532,745,265,452
060470022014,329,201,128,329,190,139,348,204,139,259,153,88
060470023014,654,339,315,660,321,339,1050,562,467,820,417,366
060470023013,380,220,160,387,213,174,999,583,396,508,277,200
060470023012,440,191,249,450,189,261,602,278,307,485,194,262
060470022042,369,246,123,369,223,146,557,369,179,370,240,110
060470022043,125,83,42,128,77,51,243,160,77,192,125,57
060470023051,316,194,122,318,185,133,577,356,206,324,194,116
060470023033,512,367,145,521,355,166,870,601,250,696,467,190
060470023052,513,371,142,524,355,169,1026,713,301,577,393,157
060470023041,517,346,171,524,337,187,861,550,285,643,415,188
060470023061,577,419,158,584,405,179,1041,719,298,622,440,152
060470022041,584,406,178,599,397,202,889,605,264,598,390,173
060470022031,254,185,69,256,170,86,480,340,128,306,198,82
060470022032,479,336,143,485,317,168,844,592,223,658,448,170
060470023032,114,78,36,113,77,36,219,145,71,134,82,40
060470022033,281,203,78,288,187,101,469,317,144,370,263,90
060470024031,191,132,59,192,121,71,330,207,117,246,153,76
060470021003,318,193,125,320,180,140,485,291,180,379,199,153
060470024011,414,112,302,417,109,308,564,164,388,463,124,317
060470009013,226,71,155,230,70,160,326,118,199,260,97,152
060470019021,313,182,131,311,171,140,506,294,198,393,223,142
060470010031,155,98,57,160,92,68,244,162,76,205,129,66
061110009021,364,203,161,371,204,167,411,242,156,350,185,140
061110011021,1020,591,429,1030,593,437,1321,785,512,1016,538,411
061110011022,715,385,330,723,375,348,1024,577,430,814,391,357
061110012041,815,485,330,827,478,349,1202,704,455,894,503,304
061110095004,427,228,199,430,225,205,491,276,207,432,224,188
061110093002,1397,636,761,1410,617,793,1889,930,907,1623,715,818
061110005001,529,327,202,528,306,222,734,465,259,602,367,206
061110009031,494,366,128,501,368,133,713,538,168,719,488,179
061110009032,458,290,168,465,290,175,561,344,206,471,255,177
061110009033,626,446,180,641,445,196,858,606,226,678,453,184
061110009022,821,574,247,832,577,255,956,673,263,809,525,226
061110097003,325,166,159,333,167,166,387,197,179,358,170,164
061110050062,416,325,91,418,319,99,462,335,113,405,311,73
061110050061,300,234,66,301,233,68,547,405,125,459,358,77
061110050052,431,335,96,431,326,105,705,529,169,579,446,103
061110050053,149,128,21,146,116,30,340,275,56,287,239,35
061110050051,194,152,42,194,144,50,324,227,86,275,203,56
061110050021,334,252,82,340,255,85,477,368,91,454,370,64
061110050041,2541,1807,734,2566,1758,808,4147,2983,1079,2865,1882,785
061110003022,901,516,385,909,505,404,1032,595,416,826,440,335
061110003042,356,223,133,361,217,144,642,417,206,440,282,135
061110003043,412,264,148,416,257,159,673,436,221,591,379,181
061110003024,434,288,146,440,279,161,583,378,183,546,348,165
061110003023,183,119,64,185,114,71,412,260,148,384,244,122
061110003021,871,467,404,890,464,426,1139,660,460,655,367,260
061110003031,455,296,159,463,287,176,712,461,239,548,353,167
061110003032,472,308,164,477,295,182,742,480,250,606,386,185
061110003033,506,291,215,515,281,234,808,481,319,654,380,244
061110053053,713,281,432,717,281,436,744,331,398,646,249,353
061110076073,1108,564,544,1126,561,565,1534,852,656,1300,629,600
061110076122,801,426,375,816,424,392,1058,565,474,871,423,395
061110093001,1378,653,725,1399,653,746,1449,709,713,881,436,402
061110076141,656,360,296,666,352,314,828,469,340,696,390,272
061110075151,873,387,486,881,372,509,893,389,493,768,332,391
061110077001,872,451,421,887,444,443,1206,620,564,1039,510,457
061110003041,313,137,176,318,133,185,465,219,236,310,134,150
061110023022,423,301,122,428,299,129,598,418,167,497,317,136
061110052022,1027,457,570,1038,456,582,1309,659,618,1095,499,524
061110052031,1219,611,608,1246,596,650,1551,828,688,1356,645,620
061110052033,506,244,262,519,245,274,663,360,293,573,270,267
061110052032,1200,542,658,1212,535,677,1380,690,658,1142,504,550
061110036171,494,262,232,500,266,234,769,429,327,647,335,280
061110036172,367,225,142,374,229,145,499,306,179,384,234,130
061110075112,231,134,97,237,132,105,431,238,177,361,192,138
061110075122,385,223,162,394,216,178,522,293,216,446,240,172
061110075123,719,401,318,734,397,337,880,473,385,805,348,398
061110083043,716,335,381,732,325,407,677,321,349,813,345,419
061110075111,996,542,454,1006,548,458,1298,758,513,1139,638,452
061110052041,1077,462,615,1091,466,625,1354,670,660,1260,530,655
061110052051,1582,653,929,1602,652,950,1910,896,986,1662,654,924
061110052053,1627,846,781,1655,848,807,2308,1245,1023,870,430,394
061110052021,326,153,173,328,148,180,470,218,240,412,174,215
061110095002,543,289,254,544,279,265,698,390,299,599,295,261
061110095001,336,171,165,335,161,174,279,167,109,313,157,127
061110011012,744,433,311,763,423,340,1000,619,363,819,428,316
060379201041,1170,462,708,1199,444,755,1566,676,858,1247,452,730
061110009011,1139,819,320,1152,812,340,1190,881,290,1145,779,285
061110009012,366,248,118,370,249,121,410,293,111,385,256,104
061110010021,913,567,346,919,559,360,950,602,331,769,434,275
061110010023,967,611,356,982,601,381,1338,862,453,1221,693,436
061110010024,536,383,153,538,375,163,939,646,271,685,427,205
061110010022,772,441,331,781,441,340,925,544,359,762,397,303
061110012013,163,91,72,166,91,75,614,359,244,158,82,67
061110008004,480,284,196,485,275,210,646,375,262,524,309,194
061110012011,848,512,336,862,494,368,1251,750,470,1053,589,398
061110028001,664,445,219,676,446,230,859,563,268,945,592,285
061110014021,1021,550,471,1032,539,493,1373,799,535,1118,589,454
061110015062,549,322,227,561,316,245,675,407,258,541,286,213
061110076131,716,338,378,727,338,389,1650,931,685,1113,548,501
061110076144,548,313,235,556,304,252,1247,731,485,1118,599,448
061110076113,362,270,92,368,268,100,275,170,92,346,247,79
061110076111,362,249,113,364,245,119,607,426,170,466,311,126
061110076112,386,281,105,388,278,110,642,473,161,573,399,137
061110076121,634,443,191,639,431,208,1216,849,333,800,508,237
061110076142,1176,609,567,1192,609,583,1184,660,500,1027,509,441
061110076143,545,282,263,553,283,270,796,444,337,589,292,253
061110076071,1355,665,690,1379,671,708,1678,904,740,1474,713,676
061110076101,1175,520,655,1195,519,676,1502,733,749,1216,542,594
061110076102,1388,604,784,1411,611,800,1746,841,868,1497,663,728
061110076091,1336,626,710,1362,617,745,1703,950,724,1486,720,655
061110076072,546,276,270,554,277,277,779,435,330,616,304,280
061110076132,825,366,459,841,363,478,1185,572,586,1074,473,533
061110096002,1581,879,702,1608,873,735,2019,1214,765,1940,1073,752
061110094002,361,212,149,372,214,158,576,363,195,508,274,199
061110018012,506,309,197,516,311,205,690,436,236,556,333,193
061110046001,65,29,36,66,28,38,163,67,84,136,36,79
061110004001,231,137,94,229,135,94,464,284,176,282,171,98
061110008002,1132,722,410,1150,700,450,1579,979,569,1049,671,328
061110074033,1180,716,464,1202,726,476,1513,952,538,1386,827,487
061110074051,833,502,331,850,506,344,1120,705,396,1197,721,405
061110074054,990,611,379,1006,610,396,1537,992,511,971,585,336
061110074052,467,286,181,475,287,188,628,404,206,462,277,159
061110074031,573,354,219,581,349,232,703,466,224,627,384,210
061110074032,888,549,339,905,543,362,1347,891,430,1073,658,359
061110074061,1111,687,424,1126,677,449,1383,912,438,1192,731,400
061110074053,415,258,157,422,257,165,467,304,151,341,205,119
061110011011,1204,693,511,1233,691,542,1677,951,679,1394,737,556
061110059062,441,225,216,444,224,220,368,193,166,728,378,313
061110047041,296,217,79,299,215,84,469,327,133,394,294,85
061110047151,545,393,152,550,395,155,929,666,247,830,605,195
061110056023,1078,657,421,1094,656,438,688,387,282,549,300,210
061110047152,553,407,146,554,413,141,870,626,224,711,525,153
061110047171,341,266,75,336,256,80,577,443,126,457,361,70
061110047161,399,313,86,398,309,89,529,393,127,511,407,81
061110009034,512,371,141,524,370,154,776,573,183,698,476,179
061110009035,605,419,186,612,417,195,768,542,214,637,424,174
061110092002,690,532,158,695,514,181,1346,973,350,855,612,195
061110030132,552,360,192,558,348,210,1080,765,296,749,491,196
061110030131,783,540,243,790,534,256,1075,747,311,842,558,237
061110030111,716,545,171,721,505,216,947,689,241,822,615,165
061110030101,796,579,217,806,573,233,1053,750,280,979,704,219
061110030112,459,357,102,459,337,122,744,561,157,633,494,106
061110092001,816,645,171,815,623,192,1224,890,308,1049,787,211
061110088002,433,334,99,438,332,106,636,481,143,563,435,100
061110088001,641,486,155,643,482,161,947,708,214,793,614,139
061110036143,479,325,154,486,317,169,512,353,151,429,274,126
061110036141,620,425,195,624,419,205,1036,704,308,740,469,208
061110047103,339,250,89,338,249,89,620,427,184,435,317,96
061110047101,391,292,99,396,291,105,500,369,120,459,348,93
061110045072,113,89,24,116,87,29,118,89,24,184,141,32
061110045071,62,49,13,61,46,15,136,106,29,195,150,35
061110045081,83,65,18,83,63,20,164,125,34,198,158,27
061110045082,195,152,43,197,148,49,407,295,107,186,154,26
061110008003,658,446,212,665,425,240,924,600,309,809,547,236
061110007022,565,381,184,568,363,205,715,466,242,659,427,192
061110045051,416,341,75,416,331,85,640,488,142,532,408,94
061110045041,403,316,87,400,304,96,711,531,168,570,429,118
061110045043,323,217,106,330,213,117,406,270,124,386,264,102
061110045042,242,162,80,245,160,85,390,259,120,342,234,91
061110040002,366,304,62,369,294,75,449,340,91,417,331,60
061110041012,437,359,78,437,346,91,596,476,111,601,469,92
061110041013,361,295,66,361,286,75,613,486,114,543,426,85
061110089002,426,351,75,425,340,85,621,501,115,512,414,75
061110041011,414,342,72,412,328,84,837,647,160,640,521,81
061110042002,395,287,108,392,275,117,638,452,171,481,331,118
061110089001,313,261,52,313,243,70,437,316,96,338,276,42
061110029051,1133,767,366,1146,746,400,1375,955,391,1133,752,318
061110040001,318,264,54,321,254,67,525,407,111,422,342,63
061110036162,812,354,458,818,352,466,1046,542,487,784,336,399
061110036163,436,210,226,441,212,229,620,318,290,536,272,228
061110047162,459,385,74,458,375,83,713,564,134,522,433,68
061110047172,354,282,72,350,275,75,623,463,145,661,525,104
061110045031,175,134,41,174,131,43,308,220,81,281,213,51
061110045032,249,192,57,251,188,63,327,235,86,275,210,50
061110045033,268,206,62,265,200,65,395,285,103,341,261,64
061110039011,568,485,83,569,470,99,774,625,133,684,583,75
061110039021,656,536,120,652,511,141,1118,874,225,893,734,118
061110037001,295,259,36,291,250,41,392,324,59,346,296,29
061110037004,372,328,44,367,316,51,522,435,79,465,410,39
061110037003,299,254,45,300,246,54,424,338,78,373,304,45
061110038012,218,192,26,217,187,30,381,318,59,337,296,30
061110038013,346,298,48,343,287,56,590,479,103,518,444,59
061110038021,314,271,43,317,259,58,554,438,104,469,389,60
061110091003,15,13,2,15,13,2,232,181,39,83,76,3
061110036082,557,397,160,558,379,179,790,570,205,517,369,114
061110036081,457,325,132,462,315,147,747,543,195,523,375,110
061110086012,182,142,40,184,140,44,497,366,121,498,343,117
061110086013,344,270,74,349,267,82,318,235,76,344,245,74
061110086023,197,154,43,196,151,45,301,221,72,410,302,79
061110086021,103,82,21,102,78,24,261,195,56,131,103,20
061110036132,756,524,232,760,517,243,1219,807,387,911,604,258
061110036131,486,338,148,490,334,156,636,423,201,543,358,154
061110031011,385,310,75,385,303,82,364,304,54,342,280,43
061110033021,380,285,95,381,285,96,610,451,136,477,344,107
061110033022,647,485,162,652,478,174,869,632,229,693,503,155
061110087002,741,554,187,749,553,196,1290,936,324,1217,880,262
061110037002,215,182,33,214,175,39,360,286,65,292,238,36
061110032011,186,167,19,184,162,22,368,317,44,310,270,24
061110032012,211,188,23,210,185,25,374,330,44,357,306,29
061110091001,343,300,43,345,290,55,288,243,32,238,209,17
061110091004,203,184,19,201,177,24,249,214,28,255,217,20
061110038011,212,176,36,211,169,42,371,300,63,363,293,51
061110088003,508,366,142,507,367,140,743,534,196,640,469,138
061110036142,627,421,206,632,402,230,940,646,273,811,520,246
061110033023,203,151,52,204,145,59,458,336,113,371,259,93
061110033011,506,378,128,509,367,142,664,477,173,549,389,123
061110087001,459,356,103,461,338,123,667,498,156,524,392,102
061110029013,849,521,328,851,498,353,1511,935,555,1158,700,383
061110029012,732,469,263,736,449,287,733,470,248,643,393,218
061110029011,689,443,246,697,426,271,947,607,324,749,455,255
061110033012,255,191,64,261,186,75,438,323,109,399,279,96
061110029052,885,600,285,888,581,307,1386,962,386,1164,772,324
061110038022,118,98,20,118,92,26,156,125,27,164,134,25
061110049021,422,368,54,420,350,70,671,562,93,559,490,45
061110049022,409,359,50,408,344,64,603,510,72,542,475,42
061110031022,679,503,176,682,489,193,1138,797,314,853,640,175
061110031013,476,346,130,479,336,143,772,532,231,638,462,138
061110031012,281,205,76,281,198,83,535,367,161,336,245,75
061110086022,350,281,69,353,270,83,340,255,73,259,204,42
061110086011,200,159,41,198,150,48,330,255,71,246,200,39
061110040003,303,238,65,302,231,71,475,355,113,414,323,71
061110040004,287,226,61,288,222,66,411,303,98,319,250,53
061110049013,486,367,119,490,357,133,1095,774,289,637,465,134
061110049012,592,448,144,597,432,165,782,551,205,700,508,150
061110049011,624,471,153,633,459,174,839,594,224,818,594,173
061110031021,703,523,180,703,511,192,1132,809,304,922,697,181
061110036161,767,371,396,780,376,404,875,452,407,766,324,398
061110036183,601,352,249,616,349,267,844,491,338,704,360,293
061110036151,711,400,311,720,402,318,987,572,388,761,399,321
061110036152,628,352,276,640,356,284,898,526,359,748,393,317
061110091002,32,24,8,31,21,10,311,230,70,232,185,30
061110047102,270,199,71,274,195,79,442,339,86,491,355,112
061110047111,284,208,76,286,206,80,509,333,170,383,276,89
061110047112,437,320,117,441,318,123,616,407,204,439,317,99
060290033072,370,166,204,377,165,212,652,305,335,367,146,200
060290033073,219,93,126,224,93,131,339,154,179,253,95,144
061110057001,247,174,73,249,175,74,849,594,238,807,532,203
061110056021,1068,483,585,1088,493,595,1282,629,637,1108,523,539
061110058012,1082,534,548,1099,530,569,1505,840,633,968,495,419
061110097001,244,181,63,244,175,69,386,284,96,280,206,56
061110097002,216,163,53,217,156,61,405,295,103,359,261,76
061110043051,60,35,25,60,37,23,225,91,114,113,38,64
061110044005,506,299,207,512,305,207,802,507,277,488,280,175
061110042001,595,414,181,602,414,188,787,529,236,599,405,147
061110044001,398,277,121,404,278,126,621,427,179,548,375,136
061110044002,615,415,200,621,417,204,930,625,280,646,439,158
061110044003,296,206,90,297,206,91,443,297,134,323,218,80
061110042003,465,338,127,464,324,140,688,485,183,572,391,144
061110043041,1039,662,377,1048,652,396,699,455,225,680,430,214
061110043042,244,155,89,247,154,93,894,590,292,659,415,212
061110043043,425,276,149,427,267,160,848,550,275,714,452,215
061110043044,369,241,128,370,234,136,562,367,187,426,275,119
061110044004,277,164,113,279,165,114,498,320,162,517,295,187
061110004002,529,301,228,529,294,235,484,271,207,427,239,167
061110004003,658,416,242,654,401,253,1076,705,353,1018,644,331
061110006001,211,125,86,214,117,97,337,237,95,299,180,101
061110008001,319,194,125,319,182,137,504,336,155,425,261,141
061110007013,312,204,108,315,196,119,497,339,152,461,308,133
061110007014,289,204,85,290,198,92,371,285,79,424,301,100
061110007011,392,272,120,397,263,134,636,444,180,490,338,126
061110007012,314,227,87,317,223,94,662,442,208,389,275,92
061110004004,325,275,50,325,263,62,553,455,84,430,371,38
061110006002,214,153,61,212,147,65,317,240,72,240,181,47
061110007021,502,338,164,506,324,182,628,406,213,651,421,187
061110006005,106,86,20,107,83,24,187,142,38,174,138,27
061110006004,248,201,47,246,193,53,471,345,115,346,269,55
061110006003,166,130,36,168,128,40,319,251,64,293,229,51
061110053051,1306,496,810,1322,506,816,1704,757,916,1452,554,800
061110013021,732,431,301,738,413,325,1056,655,373,757,431,284
061110013031,592,368,224,593,352,241,1054,687,346,873,516,304
061110055021,579,306,273,588,306,282,727,412,296,630,314,267
061110053052,2226,1047,1179,2251,1036,1215,1429,674,724,1194,533,588
061110053072,619,311,308,628,308,320,1142,639,479,905,456,386
061110053071,472,238,234,477,235,242,959,521,416,679,343,290
061110059063,788,356,432,799,353,446,899,457,428,759,351,361
061110073001,918,423,495,924,414,510,1313,657,629,1078,485,533
061110059101,1063,553,510,1078,543,535,1308,691,592,1116,556,489
061110054011,920,419,501,943,417,526,1050,517,503,865,372,431
061110054012,974,443,531,998,438,560,1434,716,687,1244,537,618
061110036182,424,247,177,430,244,186,613,351,242,505,260,209
061110053081,2012,1039,973,2044,1032,1012,1783,1004,737,1619,783,718
061110054031,773,478,295,787,471,316,1157,702,426,968,580,313
061110077002,518,262,256,528,262,266,921,507,394,686,345,290
061110077003,625,316,309,639,316,323,1004,546,425,678,338,286
061110078002,327,179,148,332,173,159,530,304,215,426,220,183
061110078003,167,91,76,168,87,81,574,329,234,262,135,112
061110078001,466,255,211,469,245,224,567,327,233,398,206,171
061110080041,662,319,343,668,311,357,975,479,475,787,353,377
061110080043,264,133,131,266,127,139,462,237,219,362,165,172
061110080044,424,225,199,428,217,211,547,277,257,372,175,169
061110054041,937,491,446,952,476,476,1296,678,577,1069,524,461
061110075063,595,264,331,603,265,338,801,384,393,882,384,443
061110075064,1597,706,891,1633,699,934,1523,718,780,1311,585,646
061110075062,1148,431,717,1169,425,744,1308,471,816,1126,398,670
061110080051,578,297,281,590,294,296,820,405,398,658,309,299
061110080052,360,189,171,365,188,177,490,245,232,392,185,177
061110075051,726,340,386,738,332,406,865,423,423,724,311,366
061110080042,437,231,206,441,217,224,768,388,357,491,227,229
061110079011,704,398,306,709,385,324,1074,589,450,844,438,348
061110079012,338,192,146,344,187,157,507,283,213,438,221,185
061110085022,719,375,344,729,371,358,1115,611,480,785,389,348
061110075124,346,152,194,348,152,196,788,379,395,409,173,207
061110075121,1048,460,588,1053,460,593,1446,662,749,1385,606,694
061110080011,593,287,306,607,288,319,782,394,369,664,309,314
061110080012,599,295,304,608,289,319,882,438,423,624,292,295
061110080022,913,421,492,928,414,514,1316,606,677,1118,487,565
061110052042,655,306,349,666,307,359,1031,531,470,821,391,373
061110079032,1146,545,601,1163,537,626,1569,737,786,1188,563,561
061110079031,983,426,557,999,405,594,1383,610,741,1150,465,611
061110085011,1393,617,776,1419,611,808,1502,738,730,1301,546,676
061110085012,1221,495,726,1241,492,749,1790,823,930,1531,588,852
061110079042,469,226,243,477,221,256,630,316,296,460,204,226
061110079044,830,397,433,846,390,456,1121,563,528,901,398,441
061110079043,312,150,162,320,146,174,468,237,223,337,148,167
061110081012,583,276,307,587,269,318,876,440,415,1124,503,547
061110081011,733,378,355,746,359,387,1004,513,474,688,318,326
061110082021,636,347,289,653,341,312,749,408,320,572,288,250
061110082022,489,267,222,501,261,240,667,360,295,503,252,219
061110082023,711,389,322,730,381,349,996,534,440,759,380,330
061110080021,615,281,334,626,276,350,845,378,449,715,304,364
061110080023,194,101,93,197,94,103,465,233,219,374,173,180
061110082011,664,343,321,670,322,348,939,467,450,749,345,360
061110082012,978,518,460,991,502,489,1289,662,593,898,432,413
061110084021,1821,805,1016,1863,795,1068,1226,550,647,1130,480,587
061110084022,697,304,393,713,300,413,1027,460,547,745,289,409
061110084023,415,181,234,424,179,245,609,273,325,433,171,236
061110085021,586,266,320,600,266,334,927,421,487,763,312,398
061110083021,811,417,394,824,411,413,1001,502,484,924,439,423
061110083023,1396,703,693,1420,690,730,1401,707,664,972,480,432
061110083022,500,250,250,510,242,268,683,353,317,313,163,133
061110083031,24,12,12,25,12,13,444,224,211,501,234,234
061110083032,355,177,178,364,174,190,690,354,316,615,288,286
061110083041,445,212,233,456,210,246,1203,596,579,928,419,449
061110075072,487,165,322,489,160,329,647,257,374,419,136,262
061110075074,1430,643,787,1442,639,803,2038,1027,976,1660,730,843
061110075131,873,322,551,891,319,572,1153,451,674,933,320,557
061110083042,890,415,475,906,404,502,1318,623,673,928,394,475
061110083081,1247,537,710,1272,539,733,1831,904,892,1431,596,750
061110083082,941,406,535,961,409,552,1009,486,504,821,344,429
061110084013,685,301,384,702,305,397,1162,563,575,965,409,498
061110084012,605,276,329,617,272,345,915,414,479,617,270,314
061110084024,403,184,219,413,181,232,505,229,264,380,166,192
061110083033,246,135,111,249,135,114,908,463,420,693,336,312
061110083071,286,157,129,291,157,134,530,299,218,342,177,145
061110083072,570,313,257,579,313,266,1023,538,463,598,311,252
061110075161,616,300,316,617,293,324,941,501,425,795,383,376
061110075152,641,308,333,648,298,350,1153,569,556,852,378,410
061110075071,1343,605,738,1358,598,760,1659,841,789,1431,657,704
061110075162,758,380,378,770,378,392,985,517,444,782,375,369
061110079041,712,343,369,725,339,386,946,481,439,793,353,385
061110075052,867,378,489,883,364,519,1079,501,549,938,385,495
061110055032,932,410,522,944,405,539,1039,523,493,978,424,487
061110055041,1059,515,544,1079,503,576,1323,677,614,1065,491,494
061110075061,519,236,283,524,236,288,755,330,412,664,249,381
061110075073,417,190,227,421,190,231,762,392,356,614,276,301
061110075102,1253,695,558,1275,694,581,1334,848,465,1194,681,456
061110084011,901,424,477,916,424,492,1170,590,564,990,439,491
061110079013,570,323,247,580,317,263,821,459,340,697,343,302
061110055042,905,446,459,927,438,489,1340,735,577,1147,539,524
061110052052,490,231,259,498,232,266,767,430,326,513,258,222
061110055031,134,64,70,137,64,73,677,378,285,666,334,291
061110053061,1113,516,597,1130,517,613,1245,639,575,1130,515,542
061110053062,1255,573,682,1263,565,698,1858,952,864,1564,709,756
061110053041,743,387,356,755,386,369,1123,615,484,834,429,361
061110053042,778,406,372,792,406,386,1215,686,508,885,454,383
061110053044,997,522,475,1013,523,490,915,520,388,823,440,355
061110053043,692,346,346,702,347,355,881,493,378,784,398,348
061110056022,355,197,158,361,195,166,708,405,281,593,322,227
061110056012,587,268,319,598,272,326,800,392,397,716,332,354
061110053073,1388,671,717,1414,677,737,1883,980,869,1506,724,679
061110056013,607,332,275,615,326,289,1322,777,510,1077,572,436
061110056011,450,247,203,457,242,215,1527,903,590,764,407,307
061110068003,438,249,189,450,250,200,641,366,255,482,273,174
061110070001,489,326,163,498,317,181,825,544,263,580,367,173
061110070002,600,399,201,610,388,222,825,545,263,639,403,191
061110071003,268,162,106,274,162,112,452,272,168,213,124,78
061110071004,490,284,206,499,283,216,700,409,271,384,207,155
061110072021,1940,990,950,1966,993,973,1976,1106,833,1491,749,664
061110071001,378,238,140,380,234,146,792,510,264,517,328,165
061110071002,572,313,259,580,311,269,792,510,264,506,312,170
061110064001,1132,531,601,1144,538,606,1496,765,696,1233,603,568
061110072022,899,433,466,912,445,467,914,492,404,755,373,343
061110068002,626,324,302,639,324,315,907,478,410,727,365,314
061110059061,1560,857,703,1579,865,714,1864,1105,724,1634,900,654
061110059073,809,426,383,827,433,394,1004,586,401,849,457,341
061110072012,947,457,490,968,462,506,1306,627,645,1606,774,743
061110072011,804,383,421,814,378,436,1094,559,520,920,433,437
061110059082,545,286,259,556,284,272,945,538,392,715,350,323
061110059091,791,425,366,803,425,378,1316,744,547,1133,573,513
061110059092,925,467,458,943,470,473,859,486,357,840,421,371
061110059112,385,211,174,391,209,182,552,312,225,474,249,196
061110058011,329,159,170,336,155,181,485,264,208,705,330,324
061110058013,1183,579,604,1207,568,639,1575,867,670,1385,686,611
061110058031,1579,772,807,1616,771,845,1652,892,736,1158,567,526
061110058043,428,222,206,439,226,213,723,418,292,575,309,235
061110058044,683,347,336,698,348,350,716,413,289,634,338,263
061110059012,1357,666,691,1380,655,725,1290,662,596,1119,527,519
061110059015,622,306,316,631,303,328,939,503,416,763,371,343
061110058041,385,201,184,394,203,191,477,273,193,396,212,162
061110058042,640,320,320,652,319,333,900,512,368,615,326,255
061110063011,1337,753,584,1358,762,596,1203,722,456,1479,832,576
061110063021,651,347,304,665,338,327,1237,746,461,986,507,428
061110063022,701,357,344,718,355,363,766,432,314,743,372,335
061110065001,503,272,231,513,269,244,715,388,315,634,320,274
061110065002,748,401,347,763,399,364,1071,591,455,897,468,363
061110062001,1214,632,582,1240,630,610,1598,934,632,1546,778,670
061110063012,1281,665,616,1300,662,638,1723,1005,689,1551,793,665
061110063013,774,420,354,784,425,359,862,509,336,607,340,236
061110067001,371,170,201,374,169,205,516,275,235,408,175,209
061110069002,947,525,422,961,527,434,1268,761,484,1080,588,433
061110066001,711,351,360,730,346,384,1244,616,600,926,451,423
061110064002,1200,628,572,1215,621,594,1163,661,477,1037,543,443
061110064004,411,217,194,420,216,204,633,360,261,538,287,222
061110064005,516,278,238,526,273,253,846,478,349,720,387,285
061110066002,1377,662,715,1410,657,753,1382,741,619,1298,610,613
061110067002,1023,574,449,1046,564,482,1494,867,603,1432,803,547
061110061012,780,453,327,791,444,347,712,448,250,447,255,163
061110059113,833,411,422,845,413,432,1021,579,429,820,410,362
061110059011,503,253,250,508,247,261,920,469,427,722,350,320
061110059013,784,381,403,798,376,422,730,362,348,669,309,317
061110059014,372,181,191,380,176,204,613,319,282,596,281,276
061110059071,661,365,296,678,367,311,1206,698,494,1020,560,423
061110059072,530,291,239,543,291,252,655,369,282,573,304,248
061110075101,936,465,471,952,467,485,1462,810,625,1262,650,547
061110075081,651,332,319,664,333,331,862,501,346,692,361,293
061110075103,1051,583,468,1069,580,489,1376,810,540,1076,601,418
061110062002,635,294,341,647,296,351,764,398,348,1307,616,600
061110061011,853,498,355,868,488,380,792,496,276,681,395,248
061110061022,206,115,91,211,114,97,777,487,271,460,264,167
061110061021,438,256,182,444,250,194,1020,639,355,1031,595,374
061110059064,410,215,195,420,218,202,527,308,208,468,251,187
061110069001,484,302,182,495,305,190,645,412,219,464,281,160
061110059081,640,335,305,651,330,321,873,454,394,724,353,324
061110060002,740,377,363,757,370,387,1090,572,491,764,344,367
061110060003,726,354,372,739,355,384,928,488,416,731,336,339
061110064003,461,237,224,464,235,229,560,323,230,491,252,218
061110075082,988,553,435,1005,543,462,1477,899,549,1223,671,467
061110075091,675,351,324,685,354,331,1234,738,475,948,511,393
061110075092,1064,598,466,1084,590,494,1528,936,560,1240,696,474
061110055022,403,258,145,411,256,155,709,442,248,717,438,218
061110055023,346,221,125,353,220,133,814,510,284,704,429,214
061110059111,686,367,319,696,371,325,931,534,373,766,394,321
061110074021,1358,615,743,1379,626,753,1572,833,712,1361,651,640
061110074022,1310,662,648,1331,669,662,1832,1049,747,1590,835,678
061110074023,674,323,351,683,324,359,980,541,422,724,355,330
061110058032,595,281,314,604,273,331,1069,554,493,469,210,225
061110060001,573,292,281,585,283,302,895,448,423,490,221,236
061110068001,531,271,260,540,265,275,676,358,309,594,287,277
061110018011,1109,639,470,1115,633,482,1148,720,402,1212,712,418
061110019012,631,396,235,642,398,244,973,650,296,669,427,195
061110019011,1072,699,373,1097,711,386,1365,925,417,1170,760,328
061110023021,268,218,50,265,207,58,382,277,97,285,212,50
061110025001,573,373,200,585,374,211,693,474,208,644,390,202
061110025002,836,495,341,844,491,353,1102,665,410,861,480,308
061110025004,837,524,313,847,523,324,1131,713,389,1072,605,397
061110022002,1034,739,295,1047,730,317,1481,1021,424,971,619,265
061110028003,507,349,158,511,343,168,696,483,198,513,328,143
061110028004,698,479,219,706,469,237,879,615,241,703,456,189
061110028005,253,174,79,257,171,86,362,252,100,295,190,80
061110025003,405,225,180,409,225,184,470,271,187,373,193,157
061110026002,741,510,231,744,491,253,909,627,251,738,484,191
061110028002,607,421,186,620,419,201,905,617,266,678,428,203
061110024001,415,313,102,425,315,110,674,475,181,462,310,104
061110024002,614,453,161,628,447,181,812,593,182,659,436,157
061110027001,614,418,196,624,424,200,995,676,293,677,429,198
061110027002,1159,716,443,1183,722,461,1441,939,469,1271,781,403
061110015081,1900,1214,686,1922,1208,714,2554,1607,889,1984,1202,669
061110015101,871,514,357,884,513,371,1162,729,402,858,494,310
061110016021,876,542,334,893,536,357,1071,683,358,938,549,319
061110016022,423,261,162,432,259,173,535,341,179,503,293,171
061110015063,1048,597,451,1068,590,478,1021,592,406,824,437,325
061110015072,711,410,301,723,406,317,1047,629,394,806,444,303
061110015073,558,325,233,567,330,237,865,528,315,663,383,232
061110013042,800,454,346,810,449,361,1119,672,419,1038,543,408
061110014012,1078,579,499,1096,576,520,1408,787,591,1198,602,510
061110014022,857,469,388,877,468,409,1230,707,500,1069,559,444
061110014023,708,399,309,725,399,326,814,479,316,832,454,324
061110012022,1274,645,629,1299,654,645,1651,913,704,1469,746,628
061110012023,1475,756,719,1500,770,730,1760,982,743,1659,876,684
061110012021,935,458,477,952,455,497,1244,675,544,1009,489,458
061110018013,573,344,229,582,346,236,760,474,267,583,342,211
061110094001,535,312,223,549,311,238,599,372,213,457,243,186
061110013032,1289,744,545,1302,733,569,1504,904,568,1212,706,429
061110015091,530,353,177,534,342,192,862,603,244,651,398,208
061110015092,746,480,266,757,476,281,893,615,264,626,386,200
061110015102,2,1,1,2,1,1,177,109,62,436,269,139
061110026001,356,260,96,362,256,106,410,287,110,294,202,66
061110026003,241,167,74,245,163,82,401,281,109,352,229,93
061110020002,516,346,170,524,352,172,663,460,183,511,323,151
061110020003,531,334,197,547,346,201,604,404,182,475,292,146
061110021022,466,315,151,470,313,157,514,342,161,446,290,118
061110021021,336,235,101,341,237,104,547,380,149,307,205,78
061110012012,990,534,456,1012,534,478,1168,679,457,1011,517,424
061110015061,722,415,307,742,409,333,1158,681,453,1092,556,461
061110015111,503,296,207,516,288,228,754,467,269,616,355,216
061110015112,238,140,98,243,135,108,339,207,122,333,186,124
061110015071,283,165,118,290,160,130,460,255,193,409,209,158
061110095003,251,138,113,255,132,123,334,188,140,326,153,151
061110022003,403,313,90,406,304,102,603,441,145,499,347,110
061110023011,238,192,46,241,184,57,480,360,108,421,304,83
061110022004,256,203,53,258,199,59,412,312,88,449,312,99
061110022001,217,167,50,215,163,52,397,292,95,427,292,99
061110020001,444,298,146,449,302,147,532,368,146,544,342,161
061110023012,367,301,66,364,284,80,430,327,90,336,248,56
061110023023,261,215,46,260,203,57,477,363,100,371,274,65
061110013041,488,277,211,492,272,220,695,415,260,596,312,236
061110014011,781,407,374,794,415,379,1023,601,397,812,430,321
061110096001,323,167,156,326,163,163,433,248,175,691,359,287
061090022021,787,278,509,808,279,529,715,258,443,683,223,405
061090022014,312,112,200,320,110,210,632,203,419,381,124,237
061090022023,563,201,362,579,203,376,766,298,450,590,189,358
061090012001,394,172,222,406,179,227,466,197,248,355,155,181
061090012002,459,228,231,473,233,240,681,348,307,573,251,289
061090041021,575,288,287,591,294,297,636,317,313,604,262,304
061090011001,587,249,338,605,248,357,645,264,362,508,195,279
061090011002,331,144,187,345,144,201,536,221,300,457,180,247
061090051022,561,223,338,572,221,351,894,357,518,764,271,438
061090012003,453,255,198,476,258,218,617,341,257,494,230,221
061090012004,154,76,78,159,77,82,255,123,124,162,74,79
061090011003,464,200,264,480,200,280,729,313,387,564,217,309
061090011004,196,96,100,200,95,105,227,111,110,215,101,103
061090022012,741,293,448,769,297,472,870,319,529,726,260,410
061090022013,767,290,477,792,290,502,1033,391,619,780,262,476
061090032001,785,287,498,806,285,521,889,314,557,758,243,466
061090022011,339,137,202,351,138,213,543,216,314,489,172,295
061090021021,759,302,457,778,301,477,522,224,288,439,154,260
061090021022,286,143,143,293,147,146,346,154,184,308,135,156
061090022022,203,85,118,206,85,121,335,139,187,291,108,164
061090031011,618,250,368,638,253,385,701,295,385,596,240,327
061090031021,675,269,406,696,266,430,810,347,440,794,294,457
061090031023,271,101,170,281,102,179,332,118,197,313,102,190
061090031022,419,159,260,431,157,274,465,172,281,363,118,222
061090031032,293,121,172,296,117,179,392,165,219,365,133,209
061090032002,297,118,179,305,119,186,414,149,255,327,114,188
061090032003,389,158,231,399,158,241,577,203,361,529,181,308
061090032004,260,95,165,269,98,171,490,158,319,330,103,196
061090032005,344,124,220,353,126,227,478,165,302,392,128,233
061090032006,222,81,141,228,81,147,331,115,214,273,87,166
061090031012,277,116,161,279,113,166,362,165,191,269,109,145
061090031013,307,107,200,320,108,212,466,160,296,439,145,276
061090031031,259,107,152,266,106,160,432,196,228,397,162,211
061090051014,528,177,351,539,177,362,677,213,446,565,167,365
061090041022,509,191,318,525,190,335,681,254,416,564,205,330
061090042014,402,200,202,414,201,213,222,115,101,198,88,99
061090042011,335,162,173,339,162,177,498,261,222,400,187,187
061090042012,410,189,221,417,187,230,398,204,186,373,168,183
061090042022,277,132,145,286,134,152,419,203,207,345,144,177
061090042021,193,93,100,199,93,106,300,148,144,240,105,119
061090042023,305,139,166,312,138,174,615,280,325,465,193,247
061090041011,924,302,622,951,300,651,1089,355,713,1143,343,735
061090052012,530,169,361,539,153,386,732,202,523,557,147,389
061090051021,600,207,393,613,206,407,639,200,427,520,174,321
061090021011,273,130,143,278,128,150,359,160,187,291,122,150
061090021012,205,98,107,208,96,112,407,176,219,319,122,179
061090021013,539,240,299,547,239,308,618,262,339,547,210,301
061090021014,424,176,248,432,174,258,502,188,301,383,142,220
061090051011,836,322,514,856,325,531,1112,430,653,955,343,553
061090051012,696,234,462,713,236,477,753,306,433,557,204,320
061090051013,330,97,233,336,95,241,374,109,260,425,103,309
061090052011,113,30,83,115,28,87,265,55,208,118,30,86
061090041012,468,143,325,479,142,337,739,226,492,440,128,283
061099852021,6,2,4,6,2,4,371,88,270,283,72,191
060710091292,328,229,99,330,218,112,599,409,177,319,221,86
060710091333,426,284,142,426,270,156,701,482,205,489,332,135
060710091332,148,103,45,151,100,51,273,174,88,140,100,38
060710091331,317,157,160,319,149,170,569,259,288,480,281,180
060710091341,139,50,89,141,50,91,261,105,150,210,81,114
060710091312,111,81,30,112,76,36,270,192,68,164,116,38
060710091313,160,108,52,161,99,62,333,231,92,239,170,55
060710091322,58,44,14,59,41,18,128,86,40,80,59,17
060710091321,129,86,43,131,80,51,341,225,106,205,145,51
060710091302,433,291,142,440,283,157,771,486,271,558,380,156
060710091301,298,201,97,301,193,108,575,359,200,431,292,120
060710091293,324,225,99,327,217,110,720,493,206,496,343,130
060710091291,325,225,100,330,217,113,613,421,178,465,313,127
060710091251,679,442,237,691,422,269,1098,719,356,727,468,218
060710091252,360,233,127,359,221,138,675,441,219,638,408,193
060710091242,400,287,113,405,275,130,773,509,248,556,374,146
060710091241,287,208,79,292,197,95,541,355,174,372,250,97
060710091311,86,68,18,88,63,25,193,141,44,108,75,26
060710121011,389,96,293,395,94,301,517,127,382,439,97,319
060710121014,769,244,525,784,227,557,1142,395,715,919,282,586
060710097261,337,135,202,343,136,207,435,165,257,350,134,194
060710121013,793,272,521,814,253,561,1102,418,658,965,306,600
060710097262,671,220,451,679,204,475,942,315,609,795,252,508
060710097271,298,152,146,302,146,156,561,296,236,442,193,220
060710097272,337,171,166,344,165,179,610,326,262,495,216,247
060710097141,337,109,228,342,106,236,441,165,266,445,151,274
060710097142,389,126,263,397,124,273,629,232,386,498,162,307
060710097131,513,165,348,522,158,364,779,253,509,637,168,429
060710097132,430,137,293,441,134,307,672,219,441,513,137,348
060710097134,187,71,116,187,70,117,252,99,147,236,81,138
060710097135,518,195,323,521,193,328,890,352,517,679,235,403
060710097133,222,82,140,229,82,147,324,128,193,261,90,156
060710097171,681,184,497,694,170,524,1025,311,688,783,211,526
060710097172,989,265,724,1010,252,758,1346,390,931,1155,303,801
060710097221,527,195,332,529,190,339,714,273,425,583,190,359
060710097222,528,163,365,534,159,375,864,296,549,692,204,450
060710097231,472,135,337,477,126,351,596,183,408,547,152,367
060710097232,861,253,608,869,236,633,1119,315,783,840,229,571
060710097233,894,272,622,902,256,646,1422,515,877,1219,337,821
060710097251,1012,315,697,1027,298,729,1491,516,944,1229,403,786
060710097241,1221,385,836,1244,393,851,1681,588,1064,1489,467,960
060710097253,594,217,377,602,206,396,733,290,423,662,226,402
060710097242,415,141,274,422,137,285,600,222,368,472,145,302
060710097252,465,164,301,471,157,314,781,307,456,618,199,380
060710097213,344,170,174,350,163,187,589,280,294,431,198,209
060710097211,428,210,218,435,204,231,765,365,381,544,249,261
060710097201,360,152,208,362,148,214,598,247,339,504,194,282
060710097212,328,141,187,335,136,199,568,231,324,403,153,224
060710097121,230,93,137,232,86,146,420,170,240,325,119,190
060710097123,292,117,175,296,112,184,429,171,245,345,124,206
060710097124,323,127,196,326,119,207,685,265,397,503,179,300
060710097122,479,176,303,494,174,320,705,269,416,554,184,345
060710097181,1696,574,1122,1716,561,1155,1514,611,893,1320,453,838
060710097182,933,315,618,946,309,637,1702,683,1004,1366,466,862
060710100123,569,219,350,569,208,361,908,356,540,724,251,441
060710097191,619,193,426,621,183,438,999,353,619,774,242,494
060710097192,324,63,261,326,63,263,486,115,360,380,79,285
060710097091,339,118,221,340,106,234,535,180,337,422,146,250
060710097081,381,107,274,385,99,286,545,153,388,540,153,374
060710097083,634,138,496,642,134,508,1013,227,765,866,134,685
060710097092,517,195,322,525,188,337,871,308,538,645,216,389
060710097094,366,164,202,373,154,219,686,278,399,488,189,279
060710097093,320,130,190,320,124,196,494,173,314,405,139,241
060710097143,425,146,279,423,139,284,645,243,396,483,158,301
060710095011,214,116,98,220,107,113,384,189,177,355,156,167
060710095021,310,159,151,312,154,158,512,265,232,429,193,198
060710095013,247,127,120,251,129,122,387,198,178,260,135,101
060710120013,366,165,201,376,151,225,573,253,307,408,178,202
060710120011,560,237,323,571,238,333,847,366,463,625,280,312
060710120012,295,156,139,299,150,149,439,207,216,437,194,216
060710094001,167,85,82,167,85,82,382,184,185,272,116,134
060710094003,173,107,66,176,107,69,309,194,110,283,142,119
060710094002,45,25,20,43,23,20,103,55,43,102,50,44
060710095022,308,148,160,307,141,166,398,196,198,292,132,140
060710119004,254,71,183,260,73,187,460,124,323,390,110,263
060710120022,267,128,139,269,127,142,458,234,213,307,136,147
060710120014,207,102,105,208,99,109,334,167,161,299,130,145
060710095012,222,109,113,223,113,110,349,161,180,310,149,132
060710120021,14,7,7,14,6,8,19,12,7,22,5,13
060710120025,174,85,89,176,86,90,240,123,110,177,79,83
060710120024,444,210,234,450,207,243,734,375,338,546,241,257
060710120023,165,71,94,168,69,99,358,156,189,300,131,148
060710118021,404,170,234,404,151,253,492,199,284,403,129,251
060710118011,296,131,165,301,121,180,499,211,271,403,137,236
060710118022,281,78,203,286,75,211,442,126,308,355,97,236
060710118012,789,252,537,805,234,571,1148,343,774,928,269,603
060710093001,306,98,208,306,82,224,476,135,332,355,109,219
060710112031,395,123,272,398,120,278,490,181,299,470,145,298
060710114053,294,96,198,297,98,199,382,143,227,276,90,173
060710112042,146,50,96,154,50,104,264,96,165,205,80,116
060710112043,236,80,156,241,81,160,229,79,146,244,75,154
060710112041,114,40,74,114,39,75,176,63,106,122,47,69
060710112051,323,121,202,328,122,206,605,248,346,439,140,279
060710113001,268,114,154,274,115,159,291,137,148,273,108,145
060710112062,247,93,154,251,94,157,299,124,172,337,117,202
060710112032,167,60,107,170,57,113,226,86,133,219,68,138
060710112061,163,63,100,170,65,105,205,85,119,123,41,77
060710115002,568,224,344,577,225,352,709,302,390,594,222,330
060710001031,435,225,210,443,219,224,570,298,258,444,222,200
060710001032,428,221,207,436,219,217,614,322,281,485,243,220
060710001033,580,341,239,594,340,254,783,456,317,692,389,270
060710001041,941,511,430,955,501,454,1314,739,556,1105,597,451
060710001181,901,413,488,918,404,514,1400,753,623,1061,548,467
060710001182,719,343,376,727,342,385,1420,774,628,991,505,451
060710001171,914,414,500,951,426,525,1001,499,485,763,392,330
060710001174,390,181,209,400,183,217,622,326,283,507,258,225
060710001093,810,300,510,821,303,518,922,398,513,735,321,378
060710001112,850,370,480,857,362,495,1015,466,529,973,413,503
060710001111,211,82,129,213,82,131,351,156,188,196,73,111
060710001042,517,291,226,527,289,238,837,482,345,711,387,280
060710001052,1686,824,862,1719,816,903,2149,1170,944,1719,902,745
060710001172,996,468,528,1012,451,561,1346,697,632,1318,609,663
060710001173,321,151,170,325,145,180,688,356,322,395,204,170
060710001051,676,341,335,688,338,350,1157,616,521,804,478,294
060710001043,710,381,329,713,375,338,987,559,413,681,384,263
060710001071,1207,494,713,1222,470,752,1691,750,908,1232,503,649
060710001091,509,218,291,516,216,300,736,341,389,636,268,338
060710001092,411,192,219,416,189,227,514,245,258,472,189,251
060710001094,574,253,321,584,244,340,821,371,425,653,290,320
060710001095,597,260,337,603,259,344,699,325,365,663,276,351
060710001192,577,292,285,586,286,300,915,454,441,618,325,257
060710001082,502,242,260,511,238,273,764,385,365,653,285,342
060710001083,767,411,356,778,404,374,1197,674,499,824,402,378
060710001081,599,287,312,604,279,325,677,338,326,626,270,328
060710001203,826,414,412,847,413,434,1269,678,570,933,477,422
060710001191,502,291,211,511,288,223,1223,695,504,703,384,278
060710001202,448,249,199,456,245,211,691,383,295,554,290,238
060710001204,737,428,309,744,417,327,1235,692,527,966,495,417
060710001201,252,134,118,259,133,126,491,274,211,274,140,119
060710001211,442,206,236,450,203,247,917,482,423,578,297,259
060710001222,387,187,200,394,182,212,496,259,227,487,247,220
060710001152,716,401,315,729,398,331,678,396,271,494,289,183
060710001153,688,367,321,706,362,344,1605,896,687,874,450,385
060710001154,1161,644,517,1179,633,546,423,247,170,362,212,136
060710001151,841,413,428,854,410,444,1223,631,569,870,444,383
060710001213,903,441,462,921,433,488,1553,815,715,1237,623,558
060710001214,804,363,441,813,357,456,1330,659,652,1124,540,534
060710019071,9,4,5,9,4,5,1252,772,455,744,397,309
060710001212,506,262,244,514,261,253,564,296,263,553,288,237
060710001221,718,357,361,724,342,382,948,497,435,647,318,288
060710004012,398,186,212,409,190,219,509,245,257,396,179,202
060710005014,479,257,222,484,242,242,691,372,314,442,236,191
060710004011,561,348,213,564,321,243,852,498,339,725,411,278
060710004032,534,279,255,541,260,281,810,418,378,595,288,275
060710005013,499,299,200,509,286,223,826,497,314,698,402,259
060710005011,512,302,210,516,288,228,820,483,321,607,345,230
060710005031,433,250,183,439,245,194,631,372,252,477,263,189
060710004031,361,201,160,366,196,170,477,265,203,389,218,148
060710004041,843,452,391,859,447,412,1266,674,571,908,498,378
060710004042,610,349,261,624,344,280,978,545,410,724,398,286
060710006031,250,138,112,254,138,116,458,247,197,397,217,157
060710006032,315,180,135,316,173,143,664,387,260,541,297,205
060710006043,431,247,184,438,240,198,577,335,226,467,258,178
060710006051,393,291,102,398,282,116,708,460,238,498,365,110
060710005041,290,179,111,293,172,121,395,234,151,263,156,93
060710006033,747,378,369,758,367,391,1113,565,529,856,426,391
060710006041,680,376,304,681,360,321,906,490,399,758,427,297
060710017031,496,292,204,501,276,225,688,383,288,581,332,214
060710017043,458,289,169,474,286,188,812,504,292,541,336,167
060710017032,554,310,244,563,293,270,820,447,355,628,341,255
060710017033,630,316,314,641,305,336,838,437,391,722,364,323
060710017034,256,128,128,258,123,135,534,279,249,352,178,158
060710019011,819,401,418,833,395,438,1140,570,558,931,472,413
060710019111,686,338,348,697,338,359,1122,565,549,787,399,355
060710019013,768,376,392,780,363,417,1059,518,520,851,422,381
060710019112,406,198,208,409,191,218,688,349,327,418,214,187
060710019113,706,347,359,715,332,383,1124,534,562,837,395,404
060710005042,675,294,381,686,279,407,965,430,520,815,345,437
060710122011,673,353,320,680,345,335,1103,563,525,683,347,313
060710019091,487,268,219,494,261,233,1188,645,518,594,315,247
060710122012,668,350,318,674,341,333,1417,720,676,476,244,217
060710122021,350,183,167,356,180,176,813,413,386,676,343,311
060710006042,311,185,126,311,177,134,640,363,264,478,294,164
060710006052,423,295,128,428,286,142,732,478,239,638,439,164
060710006061,561,346,215,574,342,232,854,502,332,625,378,222
060710006062,364,224,140,365,218,147,691,403,267,520,314,184
060710019012,545,267,278,549,257,292,782,398,372,676,343,301
060710005012,635,337,298,642,325,317,1094,577,500,801,411,343
060710005032,493,259,234,500,251,249,666,351,303,500,252,221
060710005033,374,216,158,380,212,168,631,371,250,492,271,193
060710005043,915,423,492,934,407,527,1376,689,661,1031,506,482
060710004014,744,336,408,752,313,439,1235,568,640,962,428,487
060710019073,470,258,212,479,252,227,1607,876,699,603,322,246
060710019072,329,179,150,331,174,157,916,567,336,423,224,176
060710066012,190,127,63,195,124,71,425,276,140,330,215,93
060710066032,651,480,171,657,465,192,1055,721,325,776,552,181
060710066041,453,355,98,458,345,113,736,534,183,624,464,125
060710044031,414,296,118,424,291,133,747,521,214,567,412,134
060710040041,646,347,299,660,337,323,954,523,407,785,424,315
060710036121,585,456,129,589,450,139,999,702,280,730,559,131
060710036111,424,342,82,430,336,94,848,631,200,632,497,104
060710036112,349,281,68,352,271,81,541,410,120,425,330,73
060710066031,632,470,162,644,449,195,950,648,279,704,490,178
060710066042,255,210,45,257,201,56,511,381,122,377,293,73
060710049021,182,152,30,189,141,48,330,231,84,266,216,32
060710067002,207,143,64,208,139,69,330,219,103,262,181,64
060710067003,189,135,54,190,129,61,299,198,93,237,164,57
060710067004,161,120,41,161,111,50,259,179,80,189,139,41
060710067001,269,211,58,275,194,81,429,289,121,363,267,74
060710070021,282,224,58,285,203,82,441,307,128,377,279,76
060710070022,164,123,41,164,113,51,318,216,94,233,169,46
060710070012,228,182,46,226,168,58,394,275,109,311,236,55
060710070011,326,265,61,331,256,75,583,422,152,452,370,63
060710124001,190,123,67,193,119,74,314,203,105,220,149,63
060710070023,338,269,69,343,257,86,619,436,166,487,385,75
060710125004,201,152,49,202,140,62,292,200,85,209,158,41
060710066011,422,287,135,425,278,147,559,364,180,449,297,125
060710066013,277,198,79,277,188,89,478,320,150,406,275,107
060710125001,181,145,36,182,137,45,293,211,75,240,186,44
060710125002,200,169,31,201,156,45,366,262,94,281,219,44
060710125003,137,115,22,138,106,32,253,184,66,192,154,32
060710071081,337,236,101,340,232,108,590,404,166,437,290,114
060710071101,415,268,147,422,256,166,679,418,245,499,301,158
060710071102,464,299,165,471,285,186,748,459,266,568,344,181
060710071051,881,495,386,895,484,411,1513,817,656,1177,634,464
060710071121,75,56,19,75,55,20,354,262,79,207,152,43
060710071122,388,260,128,394,254,140,588,382,186,407,267,114
060710073082,471,239,232,475,232,243,636,324,298,530,254,245
060710073071,740,374,366,750,354,396,1002,515,464,877,437,381
060710071042,424,204,220,431,197,234,455,227,216,364,164,176
060710071072,194,107,87,196,104,92,333,174,145,250,130,101
060710071071,311,215,96,314,212,102,569,385,167,476,308,132
060710020392,987,562,425,1000,552,448,1588,870,682,1160,617,479
060710092021,504,204,300,513,204,309,668,268,379,584,236,312
060710020401,671,322,349,689,326,363,957,461,486,584,288,272
060710020421,1087,475,612,1103,473,630,1533,738,771,1228,553,612
060710020402,998,519,479,1016,499,517,1663,850,785,1231,646,527
060710020391,866,539,327,882,529,353,1606,943,630,1012,601,359
060710023151,628,373,255,639,362,277,1192,697,471,845,513,301
060710023142,971,569,402,981,550,431,1771,994,739,1028,586,400
060710023152,675,453,222,684,446,238,1143,749,377,863,577,256
060710020371,396,235,161,406,225,181,621,377,225,465,258,181
060710020374,777,488,289,786,474,312,1392,866,495,1071,661,354
060710020372,760,481,279,773,471,302,1136,710,398,892,563,284
060710020373,447,286,161,455,279,176,720,455,252,548,360,167
060710020381,827,564,263,832,542,290,1422,933,463,1069,720,302
060710020382,918,591,327,929,580,349,1407,892,489,1127,763,328
060710023141,802,451,351,815,439,376,1382,774,585,991,552,395
060710023101,605,392,213,614,376,238,763,471,281,576,379,177
060710023111,490,304,186,498,292,206,1028,613,397,769,484,260
060710023102,947,664,283,962,638,324,1575,1014,530,1013,713,259
060710023112,468,304,164,473,294,179,819,502,302,658,406,214
060710023113,384,245,139,394,242,152,594,359,222,483,288,164
060710023081,689,497,192,698,480,218,734,478,241,547,391,131
060710023121,948,653,295,955,614,341,1207,773,411,959,642,269
060710023131,407,281,126,409,263,146,771,506,246,558,388,151
060710023132,307,220,87,314,210,104,1152,766,352,522,368,130
060710023122,781,536,245,790,508,282,1295,806,463,788,520,228
060710022042,228,175,53,230,169,61,477,331,136,339,256,68
060710022043,187,143,44,190,141,49,350,244,99,269,203,54
060710022044,318,243,75,319,235,84,586,405,164,420,314,85
060710024041,202,150,52,204,144,60,450,298,144,316,227,73
060710024042,204,170,34,204,166,38,449,319,118,302,239,48
060710027081,671,412,259,681,408,273,1596,954,611,1064,646,359
060710027082,961,586,375,973,586,387,1274,803,447,979,595,333
060710023083,485,355,130,490,342,148,1507,1029,444,629,459,142
060710023084,423,311,112,428,304,124,710,490,204,741,533,168
060710028031,160,119,41,159,117,42,346,247,88,302,230,58
060710028032,157,113,44,158,113,45,225,160,59,153,114,31
060710028033,165,130,35,167,126,41,225,165,56,164,128,30
060710028041,216,173,43,217,166,51,456,334,114,327,256,57
060710028042,91,66,25,91,65,26,281,198,74,200,149,40
060710030002,225,170,55,229,169,60,296,216,80,234,177,46
060710024061,145,119,26,144,114,30,257,192,61,212,171,35
060710024062,143,120,23,142,115,27,260,191,65,181,148,26
060710028043,172,142,30,173,136,37,393,293,92,277,223,45
060710028011,401,308,93,409,305,104,655,461,180,495,378,92
060710028012,203,155,48,206,154,52,450,314,123,330,252,61
060710028013,153,117,36,156,117,39,403,283,110,247,187,45
060710023082,195,151,44,197,147,50,402,282,106,306,223,63
060710023133,512,395,117,515,383,132,768,547,203,637,472,132
060710024051,324,259,65,326,249,77,585,420,148,444,347,70
060710024053,226,181,45,227,173,54,436,318,107,315,245,55
060710031011,221,170,51,221,160,61,335,236,90,271,202,55
060710031012,360,271,89,361,256,105,601,421,167,449,329,93
060710031013,137,110,27,135,105,30,321,233,79,232,181,40
060710031021,232,189,43,235,183,52,466,338,118,305,239,48
060710031022,128,103,25,128,100,28,256,183,64,198,155,31
060710031023,140,113,27,140,109,31,317,228,79,248,195,39
060710025041,322,257,65,326,248,78,680,495,166,507,407,75
060710025031,361,276,85,366,261,105,635,469,152,524,403,98
060710027091,769,453,316,779,441,338,2308,1314,941,922,550,325
060710034031,221,154,67,218,146,72,404,270,127,310,212,76
060710033022,262,171,91,262,167,95,376,226,142,314,204,95
060710023091,486,352,134,484,335,149,685,467,201,515,379,116
060710023092,323,229,94,328,222,106,827,555,247,396,279,97
060710023062,645,468,177,648,452,196,1081,733,319,876,641,196
060710023072,315,239,76,317,228,89,584,415,157,402,301,79
060710023073,201,152,49,202,145,57,395,281,106,288,217,57
060710029021,245,183,62,246,180,66,343,245,95,300,223,63
060710034011,329,243,86,329,230,99,650,447,189,485,358,101
060710023071,480,344,136,484,327,157,788,527,246,592,431,130
060710034042,276,204,72,278,196,82,563,393,155,391,289,78
060710034012,280,218,62,281,205,76,492,345,129,378,287,65
060710034014,314,227,87,315,216,99,574,379,178,503,364,109
060710034043,96,75,21,96,70,26,240,169,64,230,174,39
060710034051,220,161,59,221,153,68,401,268,126,321,233,66
060710034052,146,117,29,146,112,34,241,173,60,159,121,26
060710029022,244,183,61,246,179,67,454,319,127,360,262,77
060710029023,318,222,96,319,218,101,504,339,155,388,273,96
060710029024,212,159,53,213,155,58,297,209,83,242,176,52
060710029025,135,101,34,136,98,38,322,227,90,252,184,54
060710029011,205,147,58,205,141,64,320,217,94,241,171,54
060710029012,276,198,78,279,192,87,553,377,162,386,276,88
060710029013,227,168,59,227,164,63,347,248,96,249,184,56
060710030001,276,204,72,283,201,82,428,301,124,328,239,71
060710032021,142,111,31,145,109,36,388,281,98,318,238,64
060710032022,369,263,106,373,258,115,631,425,191,457,322,112
060710032023,249,168,81,250,164,86,406,264,133,295,201,78
060710034013,405,274,131,411,265,146,626,389,223,544,373,141
060710034033,211,142,69,211,136,75,301,185,106,284,194,74
060710032011,381,262,119,383,253,130,655,417,223,533,358,149
060710032012,185,127,58,189,125,64,328,208,110,264,176,73
060710032013,246,170,76,250,165,85,436,282,151,315,211,88
060710033024,130,94,36,129,90,39,265,162,95,191,128,51
060710033021,171,128,43,174,124,50,413,277,125,296,213,67
060710026061,575,448,127,581,431,150,1025,721,287,730,553,140
060710026063,483,381,102,493,367,126,923,662,238,675,511,133
060710026102,415,321,94,417,308,109,636,444,174,473,358,94
060710026111,734,560,174,740,537,203,1117,781,318,773,587,162
060710026112,385,293,92,387,279,108,858,603,242,675,512,143
060710026101,329,252,77,334,243,91,587,407,167,450,340,91
060710022041,122,95,27,123,94,29,196,138,57,166,126,32
060710025013,228,182,46,230,179,51,422,303,108,381,307,55
060710025014,181,148,33,182,143,39,359,264,86,233,193,31
060710025042,317,244,73,319,244,75,501,348,140,414,321,67
060710025032,239,182,57,241,182,59,415,284,117,346,267,59
060710026091,486,312,174,486,299,187,669,422,231,589,379,178
060710033011,433,317,116,436,306,130,687,480,188,500,377,100
060710033012,225,165,60,227,160,67,307,215,83,278,209,56
060710033013,174,128,46,175,124,51,448,312,121,346,259,69
060710026092,279,196,83,277,184,93,440,304,129,443,318,105
060710026021,427,312,115,432,303,129,705,488,201,545,405,113
060710026024,274,199,75,277,192,85,547,382,155,425,314,89
060710026041,329,244,85,335,236,99,619,424,177,461,340,94
060710026043,189,144,45,188,138,50,346,247,93,242,180,50
060710026022,338,258,80,343,245,98,631,431,185,464,349,91
060710026023,469,357,112,474,344,130,877,608,249,673,502,134
060710026042,338,256,82,341,250,91,533,375,143,377,281,77
060710026044,334,254,80,333,244,89,495,352,133,357,268,73
060710026062,386,296,90,387,290,97,863,609,242,665,505,125
060710033023,359,252,107,360,245,115,676,451,206,428,307,93
060710026083,636,471,165,640,453,187,1055,708,330,739,542,166
060710026082,579,418,161,584,410,174,1031,668,338,752,545,173
060710071111,638,341,297,644,325,319,1032,556,449,839,438,352
060710071112,421,224,197,424,214,210,504,272,219,410,216,172
060710071041,288,141,147,295,136,159,462,231,218,377,168,186
060710071043,645,317,328,654,306,348,1054,532,509,863,386,429
060710071061,366,179,187,372,173,199,458,235,213,363,169,172
060710071062,206,108,98,208,107,101,368,200,159,258,129,114
060710071063,327,172,155,332,170,162,583,316,252,440,219,195
060710071064,374,191,183,379,187,192,516,274,228,417,202,188
060710071044,324,155,169,327,148,179,403,202,194,319,142,154
060710100102,285,146,139,285,144,141,488,232,253,324,147,159
060710100101,307,150,157,312,141,171,434,198,230,365,173,183
060710100161,457,221,236,462,212,250,864,422,428,646,300,303
060710100093,402,163,239,404,156,248,795,334,447,527,208,300
060710100163,422,208,214,433,201,232,635,340,278,494,235,221
060710100162,188,96,92,191,88,103,448,251,190,284,150,113
060710100421,551,286,265,558,271,287,927,451,455,684,323,323
060710100342,505,121,384,515,112,403,743,178,545,591,143,425
060710100422,520,266,254,523,250,273,999,504,473,697,327,337
060710100413,466,193,273,475,184,291,780,342,420,670,256,377
060710100412,522,282,240,524,271,253,1009,507,474,714,398,275
060710100411,366,158,208,365,147,218,648,284,350,381,178,185
060710100341,852,199,653,855,193,662,1130,304,812,949,208,696
060710100103,333,159,174,337,153,184,628,311,300,478,218,235
060710100104,469,214,255,476,212,264,726,334,369,528,241,258
060710100152,321,153,168,325,143,182,532,250,268,437,190,217
060710100153,339,160,179,347,151,196,518,247,267,424,180,218
060710100111,302,160,142,307,155,152,503,249,234,371,185,159
060710100112,305,160,145,307,154,153,479,246,231,389,204,170
060710100113,278,146,132,284,142,142,484,244,233,416,215,181
060710100151,525,256,269,534,249,285,736,375,351,563,266,261
060710100141,186,104,82,186,101,85,283,158,120,205,113,81
060710100142,258,145,113,257,139,118,474,267,199,393,210,152
060710100143,230,129,101,231,125,106,510,283,211,390,208,153
060710100281,410,170,240,416,162,254,662,279,376,472,184,265
060710100282,639,262,377,646,253,393,963,399,529,770,301,412
060710100331,352,173,179,354,159,195,600,295,298,638,264,337
060710100212,599,217,382,600,210,390,867,335,512,590,246,313
060710100121,276,113,163,282,109,173,487,201,268,383,142,218
060710100122,445,176,269,453,173,280,722,288,418,597,214,352
060710100291,622,257,365,629,249,380,912,382,516,761,289,430
060710100292,361,156,205,361,148,213,669,291,366,528,210,287
060710100213,724,224,500,735,223,512,1096,375,707,936,265,632
060710100221,687,230,457,690,227,463,1162,418,718,869,272,562
060710100222,616,191,425,620,187,433,869,257,594,693,190,480
060710100243,817,224,593,830,232,598,1261,396,847,904,233,639
060710100301,732,292,440,741,282,459,1176,497,656,933,368,529
060710100192,453,195,258,461,201,260,741,329,401,658,249,385
060710100322,200,76,124,202,73,129,342,130,204,223,86,125
060710100323,347,175,172,353,166,187,724,378,327,610,241,336
060710100321,552,207,345,563,200,363,940,347,571,731,260,428
060710100241,288,90,198,289,87,202,476,162,309,336,124,196
060710100242,590,205,385,598,198,400,939,321,592,766,241,481
060710100311,559,311,248,566,302,264,957,498,438,803,389,374
060710100312,388,172,216,393,163,230,706,314,373,476,211,243
060710100191,377,123,254,380,114,266,679,251,414,458,172,265
060710100343,488,129,359,498,125,373,626,174,443,511,142,346
060710100231,797,270,527,807,256,551,1341,470,830,1010,340,618
060710100233,436,164,272,440,156,284,797,322,473,600,206,371
060710100193,334,108,226,337,99,238,510,161,340,464,156,287
060710100211,668,221,447,673,212,461,1015,336,666,783,223,521
060710100232,403,132,271,403,127,276,659,239,409,526,178,320
060710064023,172,123,49,175,121,54,352,229,104,252,183,50
060710064021,294,213,81,298,207,91,512,342,153,400,291,80
060710065021,167,126,41,168,122,46,332,220,105,231,168,50
060710063041,340,260,80,346,249,97,560,400,147,463,328,113
060710074081,227,171,56,230,167,63,363,256,98,285,211,63
060710074082,232,179,53,234,172,62,296,213,77,236,174,48
060710076051,79,65,14,80,62,18,186,137,42,122,99,17
060710076052,115,91,24,118,87,31,302,218,77,258,195,49
060710076062,205,167,38,205,155,50,326,237,79,269,212,42
060710074121,339,189,150,341,180,161,524,298,212,490,266,198
060710074072,151,108,43,153,106,47,257,162,87,203,145,48
060710074083,175,130,45,180,127,53,348,230,105,246,183,51
060710074092,360,247,113,365,233,132,565,351,196,487,318,140
060710074101,271,175,96,271,166,105,409,254,146,331,200,112
060710074103,102,58,44,103,59,44,203,112,82,152,92,47
060710076061,216,167,49,217,161,56,353,253,91,267,199,53
060710076053,151,116,35,151,111,40,322,230,83,218,162,43
060710076031,232,159,73,234,151,83,403,269,123,307,211,76
060710076033,335,238,97,342,230,112,602,395,191,501,340,133
060710074091,472,296,176,472,280,192,748,456,276,610,366,206
060710074093,639,349,290,646,341,305,923,493,411,697,356,300
060710076032,252,160,92,257,151,106,306,189,114,277,177,85
060710076041,207,133,74,207,125,82,392,248,136,344,224,102
060710076042,322,198,124,328,187,141,506,294,194,369,213,133
060710076043,578,344,234,586,328,258,882,501,360,674,378,264
060710079052,631,274,357,640,264,376,766,343,413,650,276,345
060710079053,779,311,468,792,316,476,939,421,501,865,361,468
060710079062,1266,564,702,1286,550,736,1508,714,771,1201,518,631
060710079032,619,307,312,631,297,334,835,446,372,648,294,313
060710079033,465,211,254,473,199,274,846,408,423,545,236,280
060710079031,772,350,422,788,339,449,1051,494,538,818,358,416
060710079044,1058,446,612,1077,415,662,1393,612,757,1132,468,613
060710074102,542,284,258,553,284,269,735,384,336,632,314,286
060710079051,305,148,157,307,145,162,392,192,196,346,150,178
060710079041,594,260,334,598,251,347,850,412,418,724,317,372
060710079061,533,252,281,543,252,291,1037,528,489,838,396,403
060710079042,731,320,411,745,310,435,1036,465,552,907,381,479
060710079043,531,227,304,539,219,320,858,374,468,590,239,321
060710111014,361,118,243,366,113,253,479,171,299,380,120,239
060710073081,694,325,369,700,316,384,763,391,355,538,250,251
060710073032,336,206,130,340,198,142,575,343,217,454,256,162
060710073033,251,161,90,252,154,98,472,289,170,407,242,132
060710072011,332,220,112,336,215,121,516,322,180,407,260,122
060710072022,146,115,31,146,114,32,224,162,57,209,162,33
060710073053,358,221,137,359,213,146,666,415,230,479,282,156
060710073052,264,164,100,267,159,108,421,262,145,262,154,85
060710073051,221,145,76,223,138,85,426,261,146,271,164,81
060710073062,136,81,55,137,80,57,197,122,67,151,87,51
060710073061,405,242,163,406,234,172,718,449,247,547,313,186
060710078001,499,307,192,508,304,204,1056,673,348,569,336,184
060710073063,275,164,111,279,166,113,410,240,156,333,195,108
060710073064,658,391,267,665,396,269,1106,650,424,754,445,245
060710078004,272,166,106,276,167,109,603,389,203,271,160,94
060710073072,597,317,280,609,304,305,1150,641,483,766,380,329
060710073073,434,217,217,439,203,236,658,340,305,532,257,242
060710073083,739,326,413,743,314,429,1051,511,511,937,405,455
060710002011,352,266,86,353,257,96,437,301,123,384,265,93
060710002012,339,258,81,341,254,87,993,690,276,471,326,114
060710002013,315,238,77,315,229,86,400,278,113,331,230,79
060710002031,565,406,159,574,405,169,885,603,258,557,390,138
060710002033,339,249,90,343,252,91,510,355,144,214,153,49
060710002071,392,284,108,398,284,114,612,419,174,345,241,83
060710002032,221,156,65,222,152,70,390,265,116,333,234,86
060710002051,385,272,113,388,264,124,640,432,188,501,326,144
060710002081,772,576,196,784,567,217,964,665,277,741,520,179
060710002052,711,445,266,728,451,277,1112,677,405,810,505,254
060710002053,264,186,78,268,180,88,444,283,141,349,239,91
060710002082,336,237,99,340,227,113,522,333,166,411,280,105
060710002073,284,219,65,285,211,74,320,221,91,260,198,48
060710003061,293,224,69,295,220,75,487,340,139,354,260,75
060710003053,151,116,35,150,112,38,404,279,114,321,245,59
060710003054,142,110,32,142,106,36,374,257,106,201,154,37
060710003071,209,165,44,207,157,50,424,305,110,326,247,61
060710003072,262,203,59,264,196,68,349,243,99,255,196,47
060710002072,320,245,75,323,236,87,390,268,108,303,226,58
060710003062,238,183,55,242,176,66,453,315,126,369,260,90
060710003051,100,77,23,102,74,28,300,207,83,214,160,41
060710003052,106,81,25,108,78,30,355,246,98,264,197,50
060710003082,366,260,106,367,248,119,640,429,199,469,334,116
060710003041,483,322,161,489,307,182,803,488,297,581,377,179
060710003042,611,416,195,620,403,217,960,596,348,749,491,214
060710107001,251,115,136,254,109,145,297,124,170,244,93,142
060710107002,325,131,194,332,127,205,551,207,329,442,153,260
060710251001,224,81,143,228,79,149,363,122,235,249,82,160
060710107003,220,102,118,220,94,126,425,174,238,319,124,172
060710251002,158,59,99,160,59,101,259,99,157,203,73,119
060710010011,440,298,142,444,291,153,757,477,259,574,371,172
060710010013,323,220,103,327,215,112,488,308,167,340,220,103
060710010012,391,265,126,398,261,137,571,371,188,408,263,117
060710010021,241,169,72,245,165,80,424,284,132,342,231,89
060710011041,738,384,354,752,387,365,1153,633,494,875,446,392
060710011011,200,133,67,199,130,69,369,236,125,265,170,78
060710011012,301,207,94,307,204,103,484,308,165,326,206,98
060710011013,135,92,43,136,90,46,377,241,129,313,197,94
060710011043,498,342,156,503,333,170,644,416,221,463,296,139
060710011033,331,207,124,334,205,129,437,273,146,344,213,101
060710014001,304,195,109,309,196,113,483,319,160,355,232,98
060710014002,274,194,80,273,185,88,562,382,178,399,256,112
060710011031,491,283,208,497,275,222,734,424,285,585,325,226
060710011032,517,262,255,522,266,256,671,332,324,546,256,257
060710012001,506,292,214,513,271,242,716,413,285,628,346,240
060710012002,324,214,110,329,208,121,558,348,190,438,270,136
060710013091,363,277,86,362,268,94,822,594,208,449,341,87
060710013101,352,247,105,354,238,116,565,374,168,460,303,132
060710013104,237,167,70,241,161,80,347,235,106,335,209,108
060710013052,227,165,62,225,156,69,497,337,143,318,235,64
060710013053,123,90,33,124,87,37,344,237,96,233,174,45
060710015011,306,229,77,311,228,83,515,376,129,348,277,56
060710015032,225,164,61,222,160,62,403,281,112,311,241,49
060710015041,320,246,74,323,236,87,608,421,172,420,318,77
060710015042,293,232,61,292,225,67,472,336,129,441,332,85
060710013092,277,215,62,277,206,71,424,308,105,329,250,61
060710013093,244,189,55,242,182,60,462,337,113,324,250,61
060710013082,295,197,98,295,191,104,521,341,171,365,260,93
060710013051,375,276,99,378,273,105,531,359,162,507,365,115
060710013081,461,325,136,463,319,144,668,439,213,655,466,155
060710013071,543,391,152,545,374,171,789,527,245,598,420,145
060710013072,355,249,106,359,239,120,620,407,199,459,316,118
060710013121,436,309,127,437,303,134,649,434,201,503,338,148
060710013122,347,249,98,346,234,112,434,294,133,351,247,88
060710013123,401,297,104,400,279,121,1288,896,365,687,476,172
060710010024,176,128,48,176,123,53,428,293,120,321,234,67
060710010023,138,100,38,138,96,42,258,178,74,183,136,38
060710010022,267,195,72,271,189,82,385,263,106,268,192,56
060710016003,170,128,42,172,119,53,303,216,77,223,175,38
060710017021,337,213,124,340,200,140,664,428,227,661,383,237
060710017023,683,326,357,698,323,375,1056,546,492,864,433,378
060710017041,379,247,132,382,236,146,448,266,175,352,217,124
060710017042,281,184,97,286,178,108,590,344,232,417,263,139
060710016004,149,120,29,150,116,34,244,191,52,212,182,28
060710016005,157,129,28,158,123,35,291,224,61,235,191,32
060710017061,302,244,58,303,236,67,609,449,149,446,339,78
060710017062,151,112,39,154,112,42,267,184,75,224,156,57
060710017064,396,294,102,400,289,111,658,452,186,488,339,125
060710017063,147,109,38,148,106,42,224,153,63,161,113,41
060710017072,349,228,121,355,224,131,569,349,205,417,274,119
060710017073,522,320,202,527,315,212,872,525,329,674,434,203
060710017071,463,344,119,467,329,138,830,568,248,518,388,106
060710016001,129,106,23,131,101,30,213,157,52,182,160,21
060710016002,18,13,5,17,12,5,40,27,12,59,50,9
060710018121,282,227,55,287,223,64,514,373,126,480,352,101
060710018122,235,189,46,237,185,52,480,338,125,400,300,76
060710018131,220,191,29,221,182,39,401,302,89,287,237,38
060710018133,120,102,18,117,97,20,227,176,51,160,132,20
060710018132,123,106,17,125,104,21,291,222,64,226,184,30
060710018032,86,61,25,86,61,25,193,128,57,149,107,34
060710018102,321,224,97,324,220,104,492,329,151,359,243,93
060710018103,330,236,94,333,234,99,446,300,134,338,237,76
060710018031,655,441,214,667,425,242,960,637,305,697,446,216
060710018101,284,191,93,287,183,104,611,404,193,480,307,148
060710018041,767,504,263,780,491,289,1196,741,430,855,562,247
060710018062,430,283,147,432,269,163,641,402,231,500,311,164
060710018061,499,301,198,506,292,214,711,408,282,543,317,198
060710018081,404,276,128,414,268,146,737,481,234,560,365,157
060710019081,396,217,179,401,219,182,2140,1296,794,228,119,98
060710019101,332,169,163,337,165,172,676,368,297,210,123,83
060710019063,1236,739,497,1254,711,543,2699,1625,1034,930,556,336
060710019062,631,377,254,636,352,284,1253,759,474,867,515,310
060710022063,399,264,135,398,254,144,697,439,240,544,350,167
060710022064,628,388,240,633,383,250,930,578,343,638,382,227
060710127001,568,374,194,575,366,209,883,550,317,760,502,226
060710019061,434,269,165,442,270,172,558,349,195,480,294,155
060710019064,318,197,121,325,199,126,808,505,282,639,389,206
060710018093,268,157,111,271,150,121,435,259,168,348,213,114
060710022061,712,420,292,719,402,317,1077,640,413,873,534,286
060710022062,298,182,116,301,180,121,410,256,150,314,187,112
060710127002,661,419,242,667,404,263,1164,686,457,912,560,301
060710021092,585,420,165,588,408,180,479,337,131,420,284,106
060710021093,472,339,133,477,331,146,1021,721,281,695,471,179
060710018042,516,298,218,521,288,233,889,505,371,644,365,250
060710018043,410,246,164,416,238,178,758,422,319,515,290,199
060710018063,567,335,232,573,324,249,889,485,387,707,391,282
060710018082,392,220,172,396,212,184,656,367,274,488,273,193
060710018083,415,233,182,416,223,193,615,347,258,515,288,204
060710018091,365,223,142,370,211,159,448,271,167,368,214,127
060710018092,321,196,125,326,185,141,667,398,245,524,305,181
060710015043,199,146,53,200,140,60,372,241,125,244,182,52
060710011042,302,181,121,309,177,132,413,257,154,325,193,117
060710013102,403,301,102,408,293,115,574,398,161,425,294,104
060710013103,292,219,73,294,211,83,556,387,156,439,303,108
060710015012,182,145,37,184,140,44,273,213,58,316,214,82
060710015031,121,102,19,120,98,22,297,231,55,273,214,44
060710017022,555,270,285,556,253,303,783,408,363,460,267,164
060710012003,399,227,172,401,223,178,598,339,252,380,227,127
060710012004,308,169,139,310,162,148,454,249,191,280,156,108
060710020131,589,267,322,597,263,334,919,449,447,745,332,371
060710020132,1228,467,761,1246,457,789,1595,645,932,1395,533,797
060710020173,991,358,633,1002,352,650,1362,537,795,1162,413,688
060710008121,630,277,353,648,264,384,1042,454,562,825,329,450
060710020142,1369,486,883,1407,473,934,1851,710,1116,1568,548,949
060710020152,872,410,462,896,404,492,1240,599,608,1019,451,504
060710020151,916,406,510,933,402,531,1225,551,644,887,404,445
060710020232,264,123,141,268,120,148,412,197,210,280,126,141
060710020234,495,244,251,502,239,263,766,384,367,545,261,255
060710020251,1073,480,593,1079,471,608,1398,681,692,1255,552,644
060710020252,899,421,478,915,414,501,1492,710,751,1054,492,509
060710020231,401,215,186,409,213,196,720,378,332,646,326,280
060710008122,466,208,258,473,200,273,530,250,269,496,219,249
060710008123,530,228,302,539,223,316,868,403,445,700,282,380
060710020161,696,366,330,711,353,358,1036,540,473,783,397,336
060710020162,702,346,356,710,332,378,1025,513,495,867,403,408
060710008192,758,360,398,768,356,412,1171,601,553,878,418,412
060710020112,848,284,564,869,284,585,1202,425,745,985,321,612
060710020141,1205,389,816,1229,388,841,1373,485,857,1204,391,753
060710008041,1203,445,758,1209,431,778,726,301,408,770,263,466
060710008042,368,134,234,371,130,241,1542,659,847,1130,410,654
060710020111,1118,353,765,1138,360,778,1488,558,893,1267,429,769
060710020172,510,171,339,514,169,345,694,269,411,574,202,340
060710020171,1353,479,874,1376,483,893,1712,671,1016,1426,491,866
060710020181,1200,458,742,1216,447,769,1715,748,927,1374,577,708
060710020182,854,437,417,866,427,439,1381,721,634,1202,558,569
060710009011,487,284,203,492,277,215,673,398,258,567,311,219
060710021012,402,249,153,408,244,164,846,512,321,664,391,236
060710021051,729,473,256,740,466,274,1136,723,388,750,467,234
060710020271,716,389,327,718,380,338,1044,581,443,876,463,360
060710020272,619,328,291,628,321,307,974,507,444,739,357,337
060710021053,620,356,264,621,344,277,868,486,364,720,402,275
060710021072,522,321,201,523,305,218,999,585,394,640,348,246
060710020282,1037,483,554,1055,470,585,1502,703,761,1255,553,619
060710020281,841,481,360,856,471,385,1283,738,512,961,508,397
060710021011,526,385,141,537,385,152,936,663,242,715,499,159
060710021122,324,224,100,326,221,105,830,562,243,448,291,134
060710021121,396,274,122,398,270,128,485,331,141,501,326,150
060710021052,239,167,72,239,155,84,402,237,153,333,216,98
060710021071,273,184,89,278,176,102,472,281,175,416,268,122
060710021073,407,247,160,412,240,172,706,416,277,446,287,131
060710021111,332,221,111,339,216,123,551,327,207,404,263,118
060710013112,598,383,215,607,383,224,764,472,280,574,372,169
060710013111,488,305,183,498,304,194,1028,623,385,647,420,193
060710022071,392,267,125,396,263,133,998,652,333,629,412,189
060710021113,138,93,45,141,87,54,336,191,140,200,121,68
060710021031,346,235,111,352,232,120,546,340,195,538,329,183
060710021033,448,305,143,458,302,156,836,518,297,581,352,184
060710020233,506,277,229,511,275,236,738,440,280,665,299,335
060710020273,609,313,296,612,290,322,926,464,431,708,345,319
060710021032,245,155,90,248,147,101,429,249,170,233,141,74
060710021112,253,188,65,256,178,78,560,388,149,458,301,128
060710020291,531,290,241,543,290,253,878,461,401,636,335,260
060710020292,551,279,272,564,283,281,856,432,410,671,337,297
060710020311,667,367,300,681,365,316,845,452,380,663,364,262
060710020313,712,370,342,719,371,348,970,496,453,839,435,357
060710020354,331,196,135,337,199,138,510,322,178,319,184,121
060710020503,484,291,193,491,291,200,612,385,214,580,334,221
060710020502,478,294,184,483,287,196,967,604,348,773,471,272
060710020501,473,291,182,477,282,195,693,434,250,446,273,157
060710020441,804,383,421,815,370,445,1315,638,652,982,481,446
060710020442,887,459,428,889,440,449,1317,716,578,1084,537,481
060710020482,481,280,201,484,275,209,852,498,348,636,358,250
060710020481,536,313,223,546,299,247,877,489,373,622,342,245
060710020471,235,168,67,236,158,78,525,330,186,439,263,157
060710020452,706,337,369,716,324,392,936,438,478,703,339,334
060710020451,449,215,234,456,207,249,606,283,310,445,197,227
060710020312,917,460,457,925,453,472,1639,858,754,1202,588,545
060710020512,642,410,232,646,401,245,1060,664,376,888,538,307
060710020511,499,324,175,498,315,183,1013,639,353,555,338,191
060710020353,554,332,222,558,327,231,687,412,260,531,316,186
060710020492,533,319,214,539,317,222,861,517,327,613,364,214
060710020352,938,497,441,955,477,478,1233,645,565,918,452,408
060710020491,282,160,122,286,154,132,645,366,263,458,245,183
060710020472,307,176,131,312,168,144,740,411,304,396,214,160
060710020473,175,99,76,180,96,84,201,111,83,263,141,108
060710020351,658,361,297,665,357,308,990,578,391,704,391,260
060710020191,854,447,407,863,436,427,1279,670,582,886,468,360
060710020192,672,392,280,676,379,297,1052,634,398,925,510,363
060710020211,872,347,525,889,337,552,1164,507,636,1046,400,604
060710020293,506,233,273,517,222,295,765,366,389,555,254,270
060710020294,743,344,399,760,329,431,995,478,504,955,419,486
060710020462,569,266,303,572,270,302,918,439,457,708,356,313
060710020463,696,463,233,694,462,232,829,493,326,519,316,181
060710020464,345,216,129,349,203,146,573,311,255,371,225,129
060710020212,754,347,407,763,347,416,978,466,490,796,358,397
060710020213,474,235,239,483,230,253,782,374,388,653,301,319
060710020412,1067,514,553,1090,505,585,1461,717,722,1184,545,593
060710020433,670,349,321,684,339,345,1279,685,575,1037,516,477
060710020431,735,378,357,739,363,376,1221,644,560,626,327,270
060710020432,573,292,281,575,281,294,827,438,382,757,395,328
060710020411,857,363,494,870,363,507,1336,573,741,878,366,473
060710020461,676,405,271,684,384,300,1100,613,468,939,492,400
060710078003,400,244,156,408,239,169,630,400,212,500,277,182
060710078002,319,195,124,329,193,136,553,352,186,505,280,185
060710080042,294,209,85,295,200,95,556,360,178,505,325,146
060710081002,400,250,150,407,244,163,633,415,196,486,284,166
060710081003,183,114,69,187,112,75,243,159,76,186,107,63
060710081001,359,224,135,362,221,141,449,271,166,354,192,126
060710082013,611,362,249,621,359,262,723,442,262,669,359,262
060710083011,342,193,149,346,192,154,442,262,168,438,224,185
060710083012,587,341,246,592,333,259,766,449,291,628,344,245
060710083013,445,233,212,449,231,218,786,443,319,574,281,252
060710083014,697,343,354,711,343,368,962,521,416,833,388,384
060710083015,623,299,324,634,296,338,689,365,314,554,270,249
060710082012,233,135,98,238,135,103,393,232,140,267,145,96
060710080012,457,277,180,460,267,193,676,411,250,621,367,217
060710080013,517,360,157,527,343,184,799,528,246,621,418,170
060710080041,326,240,86,326,224,102,554,365,168,403,272,96
060710080014,893,474,419,903,469,434,1100,592,476,760,395,316
060710080031,185,130,55,185,125,60,185,122,59,258,137,107
060710080032,162,114,48,166,112,54,323,213,105,218,127,75
060710080033,168,117,51,170,115,55,260,168,83,231,145,69
060710080011,349,216,133,356,214,142,572,327,227,497,279,184
060710080034,259,181,78,262,177,85,442,286,137,386,242,117
060710084061,639,329,310,646,324,322,1318,690,606,839,434,358
060710084062,824,429,395,829,427,402,1399,762,598,1142,570,514
060710084021,351,179,172,356,175,181,502,259,230,410,206,178
060710084022,1156,577,579,1174,562,612,1572,797,734,1286,619,578
060710084023,582,272,310,592,267,325,760,368,369,622,279,309
060710084024,657,291,366,665,280,385,931,434,475,742,311,382
060710084032,941,403,538,965,392,573,1162,543,592,1028,412,557
060710084033,776,312,464,794,318,476,1036,467,544,966,401,518
060710085011,1104,449,655,1125,447,678,1451,690,720,1247,529,646
060710085023,1069,419,650,1086,418,668,1190,544,624,1000,398,539
060710085021,616,255,361,626,252,374,727,349,366,630,260,330
060710086012,353,149,204,357,140,217,602,256,326,415,168,224
060710086013,521,250,271,526,234,292,870,412,429,652,284,321
060710086021,675,309,366,682,292,390,978,445,502,742,325,369
060710086022,638,243,395,651,244,407,957,361,579,769,269,454
060710084051,633,319,314,636,307,329,885,462,406,658,336,288
060710084052,525,269,256,530,260,270,746,394,337,433,226,187
060710084053,580,341,239,589,337,252,1018,605,395,691,394,259
060710084031,586,310,276,590,307,283,633,338,281,531,250,243
060710084041,240,144,96,246,143,103,425,252,157,257,147,90
060710084042,393,237,156,396,232,164,553,332,199,443,243,169
060710084034,467,221,246,472,219,253,622,312,295,548,235,273
060710082021,748,395,353,761,390,371,954,543,390,791,359,376
060710082022,389,206,183,391,201,190,492,275,202,407,202,178
060710083021,536,275,261,541,270,271,654,362,274,542,255,250
060710083022,459,220,239,469,218,251,607,321,269,495,218,245
060710083023,765,351,414,785,353,432,981,505,449,844,361,431
060710085012,1084,445,639,1103,447,656,1363,631,699,1154,479,611
060710085022,641,246,395,649,246,403,890,387,484,782,303,440
060710085024,324,111,213,325,106,219,493,199,287,427,152,251
060710082011,459,242,217,465,238,227,628,352,255,480,261,171
060710027062,555,396,159,564,383,181,837,581,242,662,465,171
060710023061,226,173,53,226,168,58,277,207,66,246,191,40
060710034041,212,163,49,212,158,54,517,381,122,392,300,65
060710027031,736,467,269,747,451,296,1110,686,401,857,519,295
060710027032,611,383,228,622,368,254,988,566,399,690,412,239
060710027033,487,321,166,493,313,180,866,531,318,713,437,225
060710027071,504,336,168,507,326,181,649,413,220,525,327,166
060710027072,456,306,150,461,297,164,810,530,260,519,329,159
060710027051,440,304,136,438,288,150,672,427,223,540,357,156
060710027052,512,357,155,518,341,177,829,550,270,602,403,174
060710027061,2286,1274,1012,2326,1251,1075,4360,2276,2000,1909,1093,727
060710027053,410,305,105,423,294,129,667,470,185,517,373,120
060710035031,388,298,90,394,286,108,597,446,143,427,333,77
060710027054,308,228,80,315,222,93,443,279,158,402,287,96
060710027063,676,455,221,673,443,230,1043,670,349,885,592,251
060710038013,446,344,102,449,331,118,691,492,174,539,402,103
060710038011,309,237,72,312,226,86,516,376,130,406,307,80
060710038012,391,301,90,400,292,108,642,463,165,547,410,105
060710038042,339,260,79,344,251,93,513,370,132,454,342,90
060710035052,208,161,47,211,157,54,508,364,131,372,283,67
060710035062,371,285,86,375,277,98,567,405,146,468,359,84
060710035061,184,143,41,186,135,51,461,346,104,347,271,61
060710035063,374,277,97,378,264,114,675,493,171,566,431,113
060710038041,358,269,89,358,257,101,564,400,151,386,289,78
060710038043,494,372,122,502,359,143,850,601,227,717,540,141
060710043023,403,334,69,409,321,88,590,448,129,488,403,70
060710035092,415,318,97,419,306,113,792,567,195,625,477,116
060710038032,540,408,132,548,398,150,880,615,245,659,498,133
060710039001,338,256,82,337,241,96,555,399,139,437,320,87
060710035051,338,262,76,336,251,85,673,510,151,435,348,72
060710038031,365,269,96,366,261,105,753,546,183,539,403,106
060710035053,360,284,76,361,273,88,690,525,157,439,351,71
060710035072,372,289,83,377,276,101,654,480,163,535,418,93
060710035033,346,269,77,346,256,90,508,371,127,388,293,76
060710035032,576,440,136,582,426,156,903,637,244,684,501,144
060710035071,629,488,141,634,460,174,1124,800,300,955,741,164
060710040032,317,206,111,319,201,118,458,293,156,369,251,99
060710040043,222,146,76,224,139,85,335,220,112,276,185,80
060710036091,169,136,33,171,127,44,341,246,85,274,208,52
060710036062,239,188,51,241,175,66,401,273,119,352,271,65
060710036052,453,342,111,459,325,134,750,525,214,527,393,117
060710034053,263,206,57,261,197,64,631,462,149,339,262,57
060710036032,439,317,122,446,306,140,792,523,255,627,452,142
060710034032,358,257,101,361,256,105,567,404,156,438,314,93
060710039002,320,242,78,318,227,91,546,397,133,409,307,83
060710035091,348,276,72,348,265,83,668,486,167,522,408,91
060710037001,242,194,48,245,188,57,468,348,114,348,276,60
060710037002,378,297,81,376,285,91,597,430,153,514,397,96
060710035102,158,126,32,161,125,36,242,184,52,156,125,22
060710035103,253,203,50,257,199,58,530,402,113,378,304,53
060710035101,310,250,60,315,243,72,422,324,91,312,251,43
060710036071,514,402,112,521,391,130,900,646,237,588,454,112
060710036072,519,396,123,521,376,145,966,682,266,749,549,158
060710036122,226,163,63,229,159,70,505,350,148,365,252,94
060710039003,276,210,66,276,199,77,490,344,134,382,283,81
060710036092,299,209,90,301,202,99,415,286,124,357,247,91
060710036093,363,255,108,366,245,121,555,378,165,460,318,117
060710036031,473,379,94,473,365,108,918,669,229,635,504,101
060710036051,420,311,109,422,294,128,699,482,202,595,441,124
060710057012,117,92,25,116,91,25,158,112,41,137,108,23
060710057011,176,142,34,177,137,40,274,197,74,209,166,34
060710058002,149,119,30,150,117,33,345,244,89,230,181,38
060710058003,131,105,26,133,105,28,189,133,49,158,123,25
060710043021,251,217,34,252,206,46,298,225,57,257,211,29
060710043022,148,128,20,149,125,24,254,201,53,229,195,29
060710048002,214,182,32,214,177,37,332,254,73,248,201,29
060710049012,238,196,42,237,187,50,339,260,76,265,219,35
060710047002,152,131,21,154,126,28,314,239,61,243,201,24
060710047004,113,96,17,114,92,22,226,178,44,159,139,14
060710047005,154,129,25,154,125,29,246,197,49,193,173,19
060710048001,181,156,25,183,149,34,391,305,77,298,251,27
060710049022,236,190,46,240,177,63,418,311,95,311,253,47
060710056012,141,110,31,140,105,35,269,197,67,240,187,38
060710056021,210,174,36,208,167,41,351,264,80,268,217,38
060710058001,136,106,30,137,102,35,280,202,68,239,184,39
060710063032,221,164,57,224,155,69,411,279,117,289,208,67
060710064012,223,182,41,224,178,46,471,354,104,284,221,40
060710064022,85,69,16,85,65,20,163,121,28,129,108,15
060710065011,127,100,27,126,95,31,249,172,71,167,130,30
060710065012,172,135,37,174,131,43,327,230,88,289,216,55
060710064011,40,34,6,40,34,6,24,19,5,90,74,10
060719801001,1,0,1,1,0,1,0,0,0,0,0,0
060710063031,215,159,56,215,147,68,395,273,112,311,228,72
060710056011,110,91,19,112,88,24,185,138,43,148,119,23
060710056013,139,111,28,138,109,29,210,158,49,188,154,28
060710056022,118,97,21,119,98,21,215,169,43,178,146,26
060710063013,334,252,82,334,245,89,519,381,128,427,314,90
060710063033,146,107,39,146,104,42,234,172,53,183,129,40
060710054004,282,232,50,280,223,57,387,278,97,336,258,59
060710063011,197,141,56,198,132,66,332,219,102,247,172,56
060710063012,182,130,52,186,124,62,300,198,93,249,172,57
060710063014,118,96,22,119,92,27,208,160,43,179,137,31
060710063043,257,180,77,256,166,90,409,269,131,336,224,94
060710046041,257,182,75,261,177,84,420,255,147,317,215,78
060710046042,273,191,82,278,185,93,603,367,219,358,248,90
060710046044,373,257,116,376,247,129,711,442,265,552,367,155
060710054001,243,189,54,248,184,64,392,272,105,373,273,73
060710054002,180,140,40,181,135,46,281,191,76,251,185,49
060710054003,308,257,51,312,250,62,465,336,117,371,286,65
060710055023,185,157,28,185,156,29,285,222,52,218,177,26
060710055024,108,93,15,110,93,17,216,172,40,161,132,20
060710055021,176,146,30,179,143,36,281,210,58,238,189,32
060710055022,141,117,24,142,115,27,289,217,59,203,166,27
060710055011,147,120,27,142,109,33,322,231,76,279,224,41
060710055012,74,60,14,74,57,17,142,99,33,124,97,19
060710053004,251,166,85,250,162,88,394,243,138,346,215,109
060710053005,186,116,70,187,113,74,292,188,98,243,164,63
060710071103,501,303,198,508,299,209,833,506,301,617,339,224
060710044032,185,148,37,187,141,46,251,182,61,198,154,35
060710044033,256,204,52,259,195,64,551,404,135,446,345,81
060710044041,205,161,44,207,155,52,407,295,100,312,243,58
060710044042,225,170,55,221,161,60,268,190,71,165,123,35
060710044043,282,221,61,282,212,70,466,328,123,361,270,78
060710044012,309,238,71,309,231,78,568,413,145,386,301,69
060710044013,279,219,60,278,214,64,551,405,139,409,319,70
060710049011,257,201,56,256,182,74,512,367,124,384,297,65
060710124002,154,118,36,155,116,39,285,209,70,250,181,51
060710124003,160,123,37,161,121,40,289,213,74,222,165,45
060710073031,233,180,53,238,183,55,402,287,105,347,259,66
060710072023,124,83,41,128,83,45,229,141,80,157,102,46
060710072021,161,108,53,163,106,57,306,190,107,246,160,72
060710072012,353,236,117,355,232,123,547,344,192,415,273,124
060710110021,413,195,218,417,186,231,411,208,197,372,170,187
060710074111,460,242,218,468,246,222,733,415,308,609,298,288
060710074123,568,335,233,571,323,248,809,485,305,596,340,222
060710074124,382,218,164,387,210,177,551,324,218,403,225,155
060710061023,463,232,231,467,219,248,682,349,314,649,298,316
060710061022,208,143,65,209,136,73,357,224,119,292,181,93
060710074041,306,157,149,311,151,160,392,209,174,327,159,150
060710123001,52,25,27,52,24,28,408,206,195,403,192,186
060710074042,402,196,206,405,186,219,306,156,147,295,142,137
060710074043,316,155,161,316,151,165,426,222,197,296,134,153
060710074044,403,179,224,406,173,233,448,225,212,398,168,216
060710074045,274,145,129,279,142,137,494,267,211,404,198,184
060710061012,463,274,189,462,262,200,747,456,277,623,336,246
060710061011,268,176,92,271,172,99,471,308,152,367,219,123
060710074104,426,243,183,433,243,190,756,469,271,591,339,222
060710061013,325,157,168,328,151,177,454,229,211,343,160,164
060710074122,245,164,81,247,158,89,438,302,129,427,274,126
060710045052,272,164,108,274,161,113,416,249,157,317,181,120
060710045071,267,183,84,269,180,89,384,225,140,326,209,95
060710045073,353,223,130,355,217,138,549,334,205,513,302,185
060710045091,471,271,200,477,263,214,725,418,290,579,319,228
060710045092,317,196,121,321,193,128,509,305,194,414,245,147
060710045093,495,279,216,502,273,229,791,468,302,659,357,264
060710045053,442,274,168,451,267,184,841,500,312,680,392,247
060710051021,303,191,112,304,182,122,492,287,187,388,220,146
060710051022,326,217,109,326,209,117,484,298,168,372,225,125
060710108051,543,222,321,557,218,339,657,273,372,632,219,386
060710045051,411,247,164,412,238,174,540,322,209,449,257,168
060710062031,372,274,98,374,268,106,725,502,205,493,337,120
060710045072,325,220,105,326,217,109,574,360,192,416,266,120
060710045031,922,451,471,928,434,494,1373,692,648,1050,534,448
060710045121,694,411,283,708,411,297,1338,787,530,889,476,366
060710045122,747,383,364,768,390,378,904,464,427,794,384,360
060710045111,385,238,147,391,235,156,552,347,199,517,298,188
060710045112,695,434,261,706,424,282,1077,670,385,871,521,297
060710045101,348,201,147,350,199,151,483,275,191,529,338,151
060710045102,265,192,73,269,192,77,487,328,147,449,300,112
060710045103,377,273,104,383,274,109,515,346,157,284,189,69
060710046011,590,373,217,594,361,233,640,400,219,541,323,177
060710046012,321,208,113,323,200,123,477,306,162,386,234,122
060710046013,279,180,99,281,174,107,581,366,196,486,293,157
060710046014,280,190,90,284,186,98,350,235,109,302,192,89
060710046015,296,200,96,298,194,104,311,208,98,291,183,86
060710046033,438,279,159,443,272,171,726,462,246,571,348,185
060710046031,408,247,161,418,246,172,510,304,200,422,237,157
060710046032,218,133,85,220,128,92,449,262,174,326,180,124
060710046034,503,321,182,507,313,194,1008,595,382,808,472,286
060710046043,324,215,109,324,209,115,528,316,198,427,262,142
060710043011,307,244,63,304,234,70,548,403,138,418,336,69
060710043012,147,122,25,148,120,28,311,234,72,237,190,36
060710043013,350,292,58,355,286,69,724,552,161,572,468,82
060710044011,140,109,31,138,104,34,261,185,66,228,175,42
060710042013,349,305,44,348,294,54,638,513,112,442,399,29
060710042011,333,292,41,338,285,53,598,494,91,474,412,43
060710042012,321,281,40,325,276,49,558,455,94,456,403,38
060710041033,190,158,32,189,151,38,347,265,78,267,222,31
060710042021,344,300,44,348,294,54,513,418,85,428,366,41
060710042022,228,195,33,228,189,39,401,313,84,331,276,35
060710047001,142,123,19,143,116,27,279,211,57,233,191,25
060710041013,260,192,68,258,183,75,466,332,118,352,267,64
060710041012,244,191,53,246,184,62,407,299,96,329,252,63
060710041031,290,247,43,292,234,58,539,414,113,419,338,58
060710041032,200,178,22,201,169,32,384,299,73,319,268,29
060710041041,274,204,70,276,194,82,515,366,138,419,325,71
060710042023,243,209,34,244,200,44,405,326,72,337,294,32
060710047003,141,121,20,143,118,25,247,186,49,228,195,21
060710051011,504,260,244,509,253,256,698,378,302,564,275,262
060710051012,253,142,111,255,139,116,386,215,159,313,162,135
060710052001,306,187,119,307,184,123,450,260,173,346,194,130
060710062011,204,115,89,205,116,89,322,199,113,254,141,97
060710062012,211,129,82,213,129,84,321,197,123,266,152,98
060710052002,270,177,93,272,172,100,419,270,142,363,230,109
060710062013,454,291,163,465,288,177,730,456,252,608,371,199
060710062042,281,193,88,284,200,84,462,323,124,412,307,76
060710062041,264,185,79,268,185,83,379,275,96,336,225,84
060710062032,281,222,59,286,219,67,463,328,122,337,249,69
060710074071,99,75,24,100,76,24,207,152,48,169,131,30
060710074073,129,98,31,130,98,32,230,170,54,160,125,27
060710051013,303,188,115,306,180,126,405,238,156,322,177,126
060710051014,279,174,105,280,166,114,407,242,160,334,184,126
060710051023,208,127,81,212,122,90,356,202,144,263,140,106
060710052004,265,167,98,267,161,106,392,231,148,292,167,106
060710052003,166,113,53,165,108,57,226,149,77,199,134,55
060710053001,271,190,81,269,178,91,457,300,138,345,238,83
060710053002,169,119,50,173,115,58,277,185,85,276,187,65
060710053003,177,117,60,178,114,64,279,174,102,218,137,70
060710104021,113,60,53,114,55,59,417,158,209,270,99,143
060710104152,350,159,191,354,155,199,521,243,257,394,146,219
060710104341,244,113,131,246,105,141,492,230,238,408,138,229
060710104321,646,303,343,655,296,359,737,340,367,527,199,290
060710104151,300,123,177,306,118,188,472,199,249,361,134,196
060710104153,317,134,183,320,129,191,550,236,271,442,165,245
060710104313,107,48,59,109,48,61,163,70,88,142,53,84
060710104154,316,131,185,322,126,196,534,250,265,378,142,206
060710104331,273,150,123,278,145,133,529,265,228,363,135,195
060710104222,328,133,195,330,130,200,494,229,251,211,80,117
060710104262,232,99,133,232,96,136,237,97,132,148,58,82
060710104332,90,38,52,91,36,55,229,100,113,272,100,146
060710104333,130,53,77,131,51,80,255,115,121,248,90,135
060710104261,334,122,212,338,123,215,518,234,256,339,121,196
060710104221,104,32,72,104,33,71,201,67,129,120,42,69
060710121052,339,80,259,348,78,270,620,163,448,450,101,326
060710121051,697,176,521,704,172,532,946,236,694,836,184,619
060710097082,446,84,362,450,79,371,615,140,466,470,93,361
060710097084,278,70,208,277,70,207,355,99,251,294,76,204
060710103001,107,42,65,107,32,75,141,40,97,140,44,86
060710119001,137,39,98,141,38,103,101,24,77,112,25,82
060710119002,93,29,64,94,27,67,92,28,63,85,20,57
060710119003,234,73,161,237,73,164,384,113,261,320,96,206
060710117001,271,89,182,276,86,190,450,151,291,339,104,215
060710116021,365,115,250,374,114,260,519,156,339,489,139,329
060710116022,44,11,33,46,12,34,70,33,35,63,19,43
060710111021,385,132,253,397,133,264,525,171,342,427,128,274
060710104252,116,58,58,115,54,61,156,74,82,155,60,87
060719401001,230,67,163,232,71,161,363,99,261,327,90,228
060710089012,233,58,175,235,61,174,356,92,254,338,82,229
060290054101,461,138,323,468,139,329,572,187,365,545,158,344
060710121062,110,35,75,108,33,75,200,69,127,155,47,98
060710103002,305,78,227,309,78,231,370,93,267,340,88,239
060710103004,176,41,135,178,39,139,309,83,219,213,54,149
060710103003,199,51,148,200,51,149,282,71,199,238,64,164
060710250001,147,85,62,147,82,65,541,276,224,369,166,156
060710089011,233,56,177,242,58,184,342,78,246,290,62,206
060710116013,649,187,462,657,182,475,924,293,602,762,182,536
060710116012,516,153,363,522,149,373,671,223,434,556,154,377
060710116011,437,124,313,444,124,320,619,197,403,507,121,356
060710116014,602,176,426,608,173,435,944,314,609,728,203,493
060710113002,409,135,274,417,134,283,480,166,308,361,109,234
060710121031,521,156,365,528,148,380,663,172,474,566,155,377
060710121061,279,96,183,281,91,190,486,152,326,424,122,278
060710104243,316,116,200,320,113,207,280,121,156,256,84,162
060710121032,525,151,374,531,149,382,840,219,617,718,198,487
060710104241,183,50,133,183,47,136,205,57,141,173,45,115
060710114043,179,55,124,185,56,129,322,98,220,235,51,169
060710104361,124,43,81,128,45,83,293,106,179,253,83,157
060710104362,100,37,63,100,36,64,163,70,89,156,53,93
060710104251,87,45,42,88,41,47,172,74,88,121,43,63
060710104102,456,174,282,465,175,290,693,258,415,549,190,339
060710104351,242,108,134,246,106,140,305,135,160,264,91,157
060710104311,117,69,48,116,67,49,159,82,75,135,63,61
060710104312,252,108,144,254,104,150,372,147,206,282,89,163
060710104202,560,286,274,565,288,277,521,240,275,429,176,227
060710104193,375,192,183,376,195,181,537,281,247,426,183,215
060710104191,477,253,224,479,253,226,549,297,237,523,222,252
060710104201,369,195,174,374,194,180,692,339,320,553,243,268
060710104203,249,140,109,254,139,115,410,214,180,302,139,139
060710104194,285,141,144,286,145,141,469,237,213,369,153,190
060710104192,390,194,196,391,197,194,563,296,249,518,215,269
060710104132,480,176,304,489,168,321,589,231,346,410,143,246
060710104173,264,123,141,265,125,140,390,173,208,305,108,179
060710104242,300,137,163,303,137,166,432,213,210,336,138,186
060710104352,300,139,161,303,141,162,421,197,219,363,142,210
060710104353,376,164,212,376,164,212,399,167,215,317,114,183
060710104281,448,167,281,451,161,290,522,219,292,383,140,222
060710104101,540,219,321,532,210,322,760,282,451,661,212,399
060710104171,695,313,382,697,313,384,904,399,483,724,254,421
060710104172,257,117,140,260,117,143,370,162,196,302,107,176
060710091352,145,51,94,150,55,95,268,94,171,248,67,165
060710091191,558,137,421,564,132,432,869,224,628,696,155,517
060710091193,516,155,361,522,152,370,684,211,457,546,150,367
060710091192,565,134,431,568,127,441,738,199,524,603,138,439
060710099102,717,369,348,728,341,387,1077,503,545,819,390,381
060710091282,391,252,139,398,235,163,706,429,265,472,285,163
060710100271,453,140,313,461,142,319,901,291,593,647,191,428
060710100272,487,147,340,493,148,345,792,257,520,684,205,450
060710100391,1015,328,687,1027,317,710,1405,501,885,1083,318,710
060710091221,521,176,345,524,164,360,661,214,423,584,167,386
060710091222,471,152,319,480,142,338,794,266,513,686,195,456
060710091231,342,93,249,351,93,258,530,167,339,478,125,314
060710091194,206,56,150,212,55,157,346,96,246,273,77,189
060710091093,376,90,286,385,89,296,490,128,355,397,95,286
060710091094,499,120,379,503,116,387,795,208,563,592,138,422
060710111023,187,76,111,190,78,112,282,135,141,191,82,98
060710111011,392,149,243,398,146,252,504,190,303,436,147,262
060710111012,446,166,280,452,167,285,625,234,385,499,162,310
060710111013,377,138,239,383,136,247,474,180,286,408,126,255
060710111022,308,140,168,313,140,173,471,218,240,348,118,197
060710109051,434,131,303,437,129,308,628,212,405,467,144,299
060710109062,166,71,95,167,66,101,249,110,130,290,104,168
060710109032,353,126,227,355,124,231,407,142,258,306,94,194
060710109033,447,158,289,454,160,294,533,214,307,495,149,317
060710110031,469,166,303,475,160,315,341,152,180,317,121,180
060710110041,306,128,178,313,123,190,508,216,280,287,100,164
060710109043,561,166,395,568,161,407,581,196,378,467,127,320
060710109042,307,99,208,314,98,216,485,175,302,447,114,315
060710109041,263,93,170,271,94,177,520,183,328,361,111,235
060710109031,568,193,375,572,189,383,680,250,417,590,170,384
060710109052,275,86,189,278,88,190,356,118,232,310,94,197
060710109053,315,99,216,321,100,221,451,164,278,420,127,268
060710110032,287,119,168,290,117,173,447,202,238,369,147,206
060710110022,379,153,226,387,151,236,462,191,256,374,145,212
060710109061,185,58,127,190,57,133,313,122,182,293,89,191
060710108063,276,104,172,280,103,177,454,179,270,381,133,225
060710108062,405,168,237,410,160,250,398,179,211,325,117,184
060710108052,337,135,202,340,131,209,794,312,464,521,188,294
060710108061,383,141,242,390,138,252,675,253,403,474,157,282
060710108041,483,172,311,487,167,320,582,243,330,323,108,198
060710108031,355,151,204,359,147,212,375,160,204,291,116,161
060710108033,378,162,216,385,158,227,568,249,295,526,199,299
060710108042,367,157,210,377,156,221,534,246,270,440,161,247
060710108032,332,140,192,337,136,201,416,182,223,436,159,254
060710108034,355,143,212,361,139,222,451,191,246,411,149,243
060710108043,260,96,164,264,98,166,325,130,187,335,113,204
060710115001,444,171,273,448,171,277,497,192,299,448,159,259
060710114042,564,175,389,577,173,404,704,225,459,583,157,391
060710114061,549,186,363,561,185,376,838,288,525,680,207,434
060710114062,310,106,204,310,104,206,563,204,344,492,155,311
060710114051,174,58,116,174,58,116,218,84,134,192,64,121
060710114052,160,56,104,163,55,108,228,84,144,243,81,152
060710114071,379,133,246,386,133,253,553,196,341,361,111,225
060710114081,270,116,154,272,106,166,462,203,249,324,117,184
060710114082,357,131,226,364,129,235,393,158,228,392,122,248
060710114044,322,93,229,325,93,232,394,122,268,306,77,214
060710114041,402,155,247,409,146,263,666,263,390,522,174,312
060710087112,785,217,568,794,216,578,956,298,646,798,220,539
060710091201,568,153,415,572,141,431,770,219,529,658,139,476
060710091232,367,124,243,368,110,258,537,164,367,472,137,314
060710091212,789,219,570,808,207,601,1027,281,727,833,192,602
060710091211,290,79,211,294,77,217,460,122,324,376,87,268
060710091091,577,125,452,582,125,457,821,221,578,711,160,512
060710091092,447,97,350,450,96,354,632,171,450,551,127,396
060710092011,913,315,598,922,310,612,1001,362,610,760,234,467
060710092012,608,205,403,623,206,417,927,336,557,691,211,425
060710092013,483,169,314,491,172,319,941,333,587,722,232,427
060710092022,251,72,179,254,70,184,375,110,254,304,84,204
060710045032,497,159,338,501,146,355,678,213,450,582,173,388
060710087153,651,213,438,655,214,441,856,315,516,749,253,462
060710087111,1153,252,901,1161,251,910,1533,364,1147,1278,279,947
060710041043,112,88,24,111,83,28,208,148,55,85,68,11
060710041014,102,72,30,103,69,34,201,142,54,149,111,27
060710041011,182,129,53,189,127,62,341,239,90,279,206,51
060710041042,183,125,58,182,119,63,360,244,107,292,218,56
060710061021,426,282,144,429,267,162,665,403,242,517,312,168
060710063042,191,131,60,194,125,69,312,201,103,257,167,73
060710065022,189,146,43,192,151,41,390,273,104,284,219,56
060710086011,310,150,160,312,141,171,356,173,172,316,132,155
060710086014,564,274,290,569,260,309,997,480,487,730,312,358
060710036061,148,111,37,149,101,48,258,176,78,205,151,45
060710036063,246,174,72,247,167,80,447,295,138,362,258,81
060710036064,172,119,53,171,116,55,334,225,104,267,185,62
060710026081,185,131,54,187,125,62,322,201,119,303,217,73
060710040011,492,345,147,497,333,164,801,506,272,630,449,148
060710040012,274,207,67,278,201,77,455,312,121,389,286,72
060710040033,356,270,86,357,256,101,671,454,206,461,354,88
060710040042,254,166,88,257,159,98,452,288,152,377,251,105
060710040031,223,177,46,224,166,58,393,292,97,308,241,52
060374028042,150,118,32,151,114,37,249,179,64,149,123,21
060710003081,249,194,55,250,187,63,395,287,101,308,234,60
060374028043,189,154,35,192,151,41,296,212,75,274,222,36
060710003043,274,186,88,279,192,87,445,285,152,347,234,108
060710004033,519,238,281,526,229,297,792,352,430,642,303,317
060710004013,385,171,214,392,168,224,651,291,347,522,241,258
060710024031,157,133,24,159,131,28,351,259,89,249,204,32
060710024052,223,177,46,224,168,56,461,333,118,333,261,53
060710024033,362,291,71,363,277,86,693,497,182,529,425,77
060710024032,199,160,39,199,153,46,329,236,87,240,197,33
060710025011,186,150,36,187,143,44,297,212,79,216,175,30
060710025012,320,262,58,323,254,69,503,366,126,400,329,54
060710114072,278,118,160,283,115,168,438,195,234,295,109,173
060710091361,113,77,36,113,73,40,222,145,77,153,98,52
060710099111,466,219,247,472,204,268,813,396,407,654,316,307
060710100273,370,132,238,371,122,249,613,198,408,477,143,307
060710091202,671,171,500,678,165,513,972,258,689,905,202,649
060710100401,645,196,449,651,191,460,841,269,564,642,166,435
060710008131,852,380,472,871,383,488,1270,652,594,1102,528,519
060710008132,904,385,519,923,386,537,1220,591,609,1011,446,520
060710008142,688,272,416,701,270,431,828,379,437,729,297,394
060710008143,441,176,265,451,172,279,544,245,288,445,189,232
060710008151,760,373,387,773,373,400,1173,614,541,883,436,403
060710008152,893,455,438,908,446,462,1148,620,506,926,472,411
060710008162,899,382,517,915,373,542,1142,541,576,945,405,492
060710008163,732,316,416,746,308,438,1015,498,497,819,357,416
060710008171,564,289,275,576,282,294,752,405,330,559,277,255
060710008172,573,283,290,583,277,306,807,430,360,726,368,325
060710008181,742,339,403,754,335,419,1125,555,547,933,401,480
060710008173,443,219,224,450,218,232,647,337,296,503,254,228
060710008183,569,308,261,578,295,283,832,460,356,789,379,372
060710008191,566,231,335,573,223,350,607,278,321,479,194,269
060710008141,448,151,297,458,149,309,593,237,344,520,180,310
060710008144,469,161,308,479,159,320,589,245,334,491,177,287
060710008201,901,325,576,919,315,604,1217,495,698,1002,389,556
060710008081,650,321,329,657,318,339,902,469,415,759,368,342
060710008193,856,376,480,870,365,505,1620,764,816,1172,534,585
060710008202,586,242,344,596,237,359,704,334,359,561,229,309
060710008203,563,234,329,572,227,345,751,356,383,668,273,370
060710008161,508,209,299,513,205,308,664,297,357,526,219,286
060710008184,601,247,354,608,244,364,778,348,418,709,293,385
060710008084,516,256,260,528,255,273,782,399,363,659,317,300
060710008182,556,246,310,555,233,322,724,365,350,538,259,255
060710008242,427,241,186,430,240,190,736,419,293,527,298,191
060710008243,345,198,147,347,197,150,446,252,182,308,176,112
060374019011,314,273,41,318,276,42,816,611,177,240,214,9
060710008212,99,72,27,100,69,31,717,497,199,290,199,72
060710008211,620,441,179,628,429,199,943,647,273,549,370,142
060710008231,494,281,213,502,277,225,728,433,276,537,303,201
060710008262,360,205,155,365,201,164,603,358,229,442,249,165
060710008263,447,257,190,457,253,204,672,393,264,521,286,204
060710008234,380,261,119,387,254,133,492,320,162,358,229,108
060710008233,280,186,94,284,181,103,418,265,145,331,207,104
060710008251,202,134,68,205,130,75,313,199,108,239,150,75
060710008252,411,274,137,416,265,151,703,443,243,542,338,171
060710008253,117,78,39,119,76,43,251,160,87,206,128,65
060710008232,357,255,102,360,247,113,745,518,206,562,386,140
060710008261,489,260,229,495,251,244,671,363,287,415,222,166
060710008083,295,177,118,301,173,128,538,307,218,387,211,154
060710008082,690,365,325,697,355,342,890,487,384,764,405,327
060710009033,261,175,86,261,171,90,508,333,159,392,254,111
060710009041,640,406,234,648,402,246,1001,625,351,792,466,268
060710009012,518,299,219,523,292,231,675,402,258,534,295,206
060710009013,278,170,108,280,165,115,553,338,197,383,223,137
060710009031,253,172,81,254,168,86,308,204,97,254,167,72
060710009032,303,205,98,305,200,105,558,372,175,435,287,123
060710008241,210,134,76,212,128,84,413,254,148,415,221,168
060710008244,250,160,90,254,153,101,463,284,166,442,251,161
060710009042,231,148,83,235,145,90,476,309,158,243,144,81
060710091353,322,203,119,332,196,136,775,443,315,451,264,170
060710100092,214,93,121,214,88,126,384,174,201,268,112,142
060710100091,367,161,206,370,150,220,621,283,321,500,210,267
060710091363,453,303,150,456,290,166,597,376,206,475,298,156
060710091362,449,307,142,453,291,162,983,613,333,731,454,236
060710091351,688,401,287,699,389,310,1106,622,465,824,465,322
060719802001,0,0,0,0,0,0,2,1,1,1,1,0
060710091262,470,225,245,466,217,249,751,394,338,509,250,229
060710099152,256,166,90,258,159,99,543,333,198,394,239,127
060710099151,184,118,66,182,112,70,420,256,152,274,168,90
060710098002,76,42,34,75,38,37,237,129,105,178,94,76
060710121012,148,78,70,150,77,73,223,124,95,160,80,70
060710091263,249,167,82,254,162,92,303,190,104,220,109,98
060710091261,527,354,173,532,339,193,1175,743,399,682,445,197
060710099161,173,101,72,177,94,83,383,219,145,342,201,120
060710099163,312,179,133,315,172,143,521,307,200,388,226,141
060710099162,499,286,213,507,278,229,874,517,338,694,406,254
060710098001,93,62,31,90,56,34,237,151,83,203,132,59
060710098003,207,138,69,204,127,77,297,184,104,243,156,71
060710098004,171,114,57,171,107,64,285,172,96,211,136,59
060710091281,612,415,197,619,391,228,1094,736,331,797,546,207
060710091272,437,312,125,439,298,141,776,522,238,542,362,152
060710091273,316,225,91,317,215,102,633,425,194,495,330,141
060710091271,586,391,195,595,376,219,996,600,376,747,486,217
060710099182,386,254,132,389,247,142,689,439,224,544,335,172
060710099172,356,239,117,358,228,130,603,389,201,521,320,168
060710099171,239,137,102,251,139,112,376,205,155,316,165,133
060710099173,305,228,77,309,216,93,605,438,151,627,408,181
060710099181,157,96,61,156,92,64,246,149,92,190,110,68
060710099121,251,151,100,252,143,109,474,286,170,470,244,201
060710099133,216,119,97,217,114,103,332,181,141,194,117,65
060710099132,228,143,85,233,139,94,418,254,147,293,176,97
060710099131,269,169,100,271,161,110,486,294,170,553,259,252
060710099112,461,234,227,470,223,247,717,378,320,553,271,246
060710099141,220,128,92,221,120,101,394,231,153,349,212,117
060710099123,362,184,178,375,178,197,591,318,257,481,233,224
060710099134,362,161,201,365,153,212,481,226,248,309,148,142
060710091372,786,442,344,794,430,364,1109,604,475,851,461,347
060710091393,282,162,120,288,158,130,444,244,185,343,189,137
060710091392,431,252,179,431,242,189,1038,590,420,674,396,246
060710091381,469,277,192,470,273,197,976,612,343,685,418,236
060710091382,462,276,186,461,271,190,881,472,394,644,397,222
060710099061,421,229,192,427,227,200,739,436,280,559,314,226
060710099063,426,246,180,427,231,196,607,347,243,538,290,214
060710099062,349,201,148,353,192,161,611,350,244,454,246,179
060710099113,699,369,330,710,362,348,1020,563,434,864,421,383
060710099081,476,263,213,492,256,236,848,451,377,712,355,314
060710099082,622,354,268,630,331,299,938,528,392,707,388,282
060710099101,454,281,173,462,268,194,760,458,290,579,345,210
060710100362,466,268,198,467,261,206,752,435,305,516,292,203
060710100361,436,249,187,438,244,194,826,469,337,628,352,248
060710100373,259,129,130,259,120,139,507,258,235,421,186,207
060710100372,525,261,264,525,247,278,786,408,366,593,266,294
060710100371,617,306,311,624,290,334,1078,532,515,893,407,433
060710100351,338,176,162,340,164,176,568,308,252,432,222,191
060710100352,263,137,126,266,128,138,460,246,202,346,176,152
060710100382,385,215,170,389,205,184,686,386,289,572,314,226
060710100381,523,286,237,526,269,257,876,480,373,679,362,277
060710091371,315,173,142,319,167,152,509,277,228,439,234,183
060710099142,144,102,42,146,95,51,374,251,107,238,144,80
060710099122,329,156,173,334,145,189,505,256,244,337,166,159
060710091391,292,180,112,295,176,119,543,338,193,404,269,120
060710104131,403,171,232,405,164,241,694,295,370,602,204,363
060710087154,639,208,431,649,204,445,988,340,629,674,218,422
060710087151,702,239,463,712,231,481,930,318,597,742,230,475
060710087163,526,179,347,537,174,363,875,300,558,662,205,422
060710087051,291,124,167,298,121,177,466,169,285,392,144,215
060710087053,273,131,142,278,124,154,413,167,236,390,142,215
060650438022,307,99,208,313,96,217,484,158,317,381,126,235
060650438232,181,61,120,183,59,124,264,87,174,202,63,128
060710087131,497,158,339,511,152,359,633,190,430,525,169,332
060710087141,904,310,594,912,299,613,1331,491,809,1050,363,628
060710087133,559,192,367,568,190,378,817,311,483,590,212,346
060710087142,271,111,160,275,103,172,493,198,284,350,124,194
060710087132,445,158,287,449,150,299,601,227,359,451,154,270
060710087052,302,107,195,309,103,206,487,183,294,385,133,228
060710087054,365,130,235,371,125,246,613,231,365,486,167,288
060710087152,719,281,438,731,277,454,1187,439,725,879,319,511
060710087101,370,147,223,377,146,231,603,251,342,488,182,281
060710087103,332,132,200,337,131,206,479,200,272,408,152,233
060710087093,475,186,289,484,183,301,792,273,491,587,208,338
060710087081,431,148,283,435,143,292,594,207,374,444,144,263
060710088002,516,204,312,517,190,327,871,352,509,677,224,404
060710087102,327,129,198,331,130,201,552,242,302,523,196,300
060710087161,969,335,634,990,336,654,1351,495,824,1069,374,633
060710087162,835,295,540,853,293,560,1227,451,747,916,333,533
060710088003,641,245,396,652,241,411,916,352,542,752,274,431
060710087121,1129,310,819,1144,308,836,1433,427,977,1210,329,829
060710088001,565,161,404,572,160,412,891,274,597,703,205,454
060710088004,335,95,240,341,95,246,515,159,346,426,125,274
060710087091,313,101,212,318,100,218,564,187,363,410,117,266
060710087083,586,183,403,595,184,411,903,293,592,738,211,491
060710087082,599,197,402,610,194,416,781,277,490,670,207,421
060710087092,369,123,246,378,122,256,643,227,402,527,164,330
060710087122,942,258,684,959,256,703,1297,406,865,1078,284,734
060710104271,431,187,244,431,191,240,707,305,380,603,211,353
060710104272,384,137,247,390,135,255,583,236,326,490,162,297
060710104133,516,226,290,523,225,298,849,359,461,664,242,386
060710104283,438,189,249,443,188,255,655,278,348,604,191,378
060710104282,490,180,310,493,176,317,642,235,388,475,144,309
060710104134,609,264,345,614,264,350,866,375,474,655,243,380
060710104293,325,116,209,326,115,211,504,182,310,389,119,246
060710104292,526,201,325,533,197,336,794,320,464,657,201,415
060710104291,422,143,279,427,140,287,575,214,354,426,125,280
060710104302,684,221,463,694,217,477,1052,360,664,817,232,547
060710104301,641,219,422,642,209,433,901,313,569,773,223,523
060790100173,741,223,518,751,212,539,933,292,628,741,194,510
060790100163,581,183,398,587,173,414,751,251,485,578,188,367
060790100162,639,215,424,647,206,441,1004,444,525,869,281,523
060790103032,589,194,395,600,187,413,1002,313,678,645,202,405
060790100172,455,142,313,465,137,328,559,177,378,371,102,256
060790100171,497,147,350,505,140,365,729,221,491,586,155,402
060790102071,947,324,623,963,308,655,1414,574,818,656,234,393
060790103031,537,147,390,546,140,406,890,278,588,760,201,521
060790100161,931,343,588,944,336,608,972,383,565,879,303,520
060790101011,758,341,417,778,331,447,924,401,501,862,338,449
060790101041,310,167,143,312,163,149,595,312,269,452,193,232
060790102072,1326,548,778,1355,543,812,1052,471,556,972,398,508
060790103021,1055,313,742,1069,309,760,1128,360,746,1043,311,678
060790102022,600,250,350,613,241,372,633,294,329,652,269,351
060790103022,714,251,463,731,246,485,946,354,573,610,203,377
060790102042,792,370,422,810,365,445,1690,797,853,1059,477,511
060790102041,1213,513,700,1237,499,738,1535,730,760,1301,504,708
060790103011,666,209,457,675,208,467,1039,305,709,794,241,507
060790103012,847,246,601,858,249,609,810,265,533,726,200,485
060790103013,261,96,165,263,93,170,394,163,215,338,114,195
060790101042,165,93,72,171,90,81,668,354,287,462,199,233
060790101033,366,198,168,379,195,184,507,277,226,565,270,241
060790101031,349,181,168,357,176,181,421,224,195,440,207,199
060790102061,688,274,414,696,261,435,817,380,420,886,317,517
060790102062,1163,436,727,1186,428,758,1181,548,594,1218,456,678
060790101032,424,199,225,440,200,240,622,304,306,467,214,219
060790102051,465,222,243,477,216,261,849,395,436,612,268,307
060790102053,707,317,390,723,312,411,1098,501,569,823,352,416
060790102052,356,155,201,365,155,210,523,240,270,449,188,228
060790102021,788,327,461,809,309,500,936,445,474,866,359,458
060790102023,766,354,412,782,339,443,952,448,477,729,331,348
060790127071,705,304,401,725,301,424,870,400,450,757,316,395
060790126021,926,402,524,944,396,548,1209,570,611,971,408,490
060790127061,768,315,453,783,317,466,953,430,496,873,341,471
060790127073,592,235,357,607,240,367,704,320,372,622,241,336
060790131005,632,264,368,644,265,379,1062,495,534,814,341,428
060790127072,1012,427,585,1045,429,616,1485,686,764,1140,471,586
060790131002,705,225,480,720,216,504,904,327,551,736,234,455
060790131004,385,170,215,390,166,224,485,223,242,465,204,231
060790104032,715,448,267,720,444,276,764,532,232,705,431,241
060790104041,776,472,304,798,473,325,924,616,290,807,479,283
060790130001,625,332,293,638,333,305,673,353,301,612,306,271
060790104031,856,563,293,868,565,303,908,631,269,835,523,268
060790104033,733,501,232,739,494,245,941,648,278,704,466,195
060790104042,402,276,126,409,274,135,615,410,186,482,315,125
060790105061,789,467,322,810,461,349,985,587,370,802,438,304
060790105041,407,217,190,415,215,200,502,296,202,366,195,146
060790105042,580,329,251,594,331,263,773,438,305,723,389,290
060790105043,567,322,245,577,319,258,693,407,274,597,323,240
060790105062,441,258,183,449,255,194,624,381,229,365,202,144
060790105052,883,540,343,896,523,373,955,581,354,877,496,324
060790105051,853,521,332,869,511,358,1094,690,384,990,553,377
060790106031,667,396,271,684,400,284,905,578,302,693,395,247
060790106021,739,463,276,758,458,300,913,594,301,715,430,247
060790106023,731,443,288,748,444,304,840,546,278,714,413,250
060790106022,810,495,315,829,488,341,1008,666,326,925,550,322
060790107012,1100,792,308,1121,775,346,1409,1003,357,1122,743,286
060790107031,782,544,238,800,548,252,1170,832,297,949,605,263
060790107032,836,585,251,851,575,276,1083,772,287,1004,660,263
060790107011,770,571,199,785,560,225,868,628,219,702,485,169
060790107013,643,451,192,657,456,201,753,543,191,680,444,179
060790107071,520,365,155,530,363,167,570,417,138,449,300,124
060790107072,857,619,238,878,619,259,1136,841,285,974,663,244
060790107073,647,475,172,666,476,190,854,613,218,758,522,184
060790107074,711,506,205,724,501,223,744,545,182,677,448,183
060790107075,818,567,251,833,569,264,823,584,225,748,491,208
060790130002,531,255,276,540,250,290,285,140,140,401,172,198
060790112011,1000,723,277,1043,732,311,1217,926,255,1127,762,260
060790112012,899,591,308,935,597,338,950,701,232,888,578,231
060790112021,1262,932,330,1302,945,357,1088,845,209,1013,697,208
060790113002,865,614,251,890,611,279,1414,1003,362,1228,798,292
060790113003,673,444,229,691,447,244,667,472,171,695,456,178
060790113004,405,298,107,419,296,123,606,434,150,449,291,105
060790109033,1336,1102,234,1382,1107,275,442,340,84,371,271,62
060790109032,25,18,7,26,18,8,141,114,19,205,152,32
060790109042,26,19,7,27,19,8,12,6,6,169,75,79
060790113005,560,379,181,577,377,200,653,454,177,648,409,179
060790113001,652,455,197,673,448,225,998,684,277,708,466,183
060790111031,723,509,214,743,508,235,860,599,240,534,337,152
060790115011,890,595,295,911,586,325,999,677,303,944,589,274
060790111032,793,543,250,810,541,269,1129,813,290,883,580,228
060790115052,1187,815,372,1218,809,409,1364,992,335,1230,813,311
060790116002,803,426,377,817,419,398,977,563,386,774,405,311
060790110011,820,560,260,838,563,275,1271,932,302,1072,715,267
060790111053,765,591,174,789,588,201,702,543,139,760,547,157
060790111041,845,663,182,868,661,207,1252,985,234,797,580,142
060790115051,880,565,315,907,553,354,1169,815,316,905,547,274
060790110012,808,564,244,825,555,270,875,649,213,774,524,194
060790110013,996,726,270,1016,734,282,1363,1036,292,1061,749,236
060790110021,1007,741,266,1033,755,278,1177,884,270,955,668,216
060790111012,610,471,139,634,469,165,954,730,192,657,468,117
060790111052,514,423,91,529,427,102,720,568,127,665,479,114
060790111051,573,467,106,584,459,125,765,599,133,664,492,99
060790110022,495,384,111,504,376,128,615,473,121,642,442,138
060790111013,495,387,108,508,387,121,628,491,112,557,403,98
060790116001,978,432,546,1012,443,569,1199,637,526,1034,482,486
060790123024,402,171,231,411,175,236,559,275,271,469,209,236
060790116003,964,552,412,974,551,423,1061,656,389,966,552,347
060790117062,843,434,409,856,430,426,1123,622,480,947,466,415
060790117041,726,396,330,739,393,346,891,492,373,818,430,333
060790117042,702,400,302,718,399,319,888,489,378,754,416,294
060790117043,507,262,245,518,258,260,712,401,306,569,283,253
060790117061,1030,467,563,1053,471,582,1099,549,535,1021,453,515
060790117051,823,378,445,841,380,461,1082,534,520,791,365,382
060790121021,565,305,260,578,298,280,749,403,330,708,342,310
060790121022,888,482,406,906,474,432,1102,601,486,967,468,420
060790120021,753,444,309,771,443,328,1080,575,466,891,461,367
060790120022,325,185,140,330,181,149,416,228,182,347,174,146
060790119031,833,452,381,854,453,401,1004,545,433,925,458,397
060790120023,712,386,326,723,374,349,986,526,422,758,393,293
060790121023,465,263,202,473,259,214,725,402,311,501,265,183
060790121024,284,162,122,292,156,136,420,234,181,298,159,110
060790120011,977,520,457,993,502,491,1318,730,554,1075,554,428
060790122012,550,340,210,566,325,241,914,530,362,646,361,232
060790119043,683,335,348,705,324,381,1033,577,430,736,327,340
060790118005,1602,767,835,1641,752,889,1851,972,828,1461,676,663
060790123021,1205,556,649,1233,545,688,1568,771,754,1271,578,608
060790123022,523,221,302,533,219,314,763,345,400,549,236,278
060790118002,1112,557,555,1125,537,588,1318,728,561,1078,538,473
060790118003,501,244,257,511,246,265,684,379,284,559,268,254
060790118001,904,438,466,927,439,488,1050,578,437,942,446,428
060790118004,446,223,223,454,215,239,563,311,239,546,254,249
060790119011,840,351,489,860,343,517,909,452,431,893,372,450
060790119041,667,373,294,674,352,322,956,536,398,729,377,302
060790119012,822,448,374,842,445,397,1060,552,481,823,394,356
060790119042,861,440,421,887,435,452,1081,585,467,938,452,412
060790119044,616,314,302,629,292,337,928,501,396,709,330,314
060790123023,803,300,503,818,292,526,816,336,462,683,245,394
060790123061,2176,975,1201,2209,962,1247,2694,1378,1284,1658,771,814
060790123053,913,385,528,929,378,551,1124,518,587,963,393,511
060790123054,664,268,396,675,257,418,951,407,523,868,340,482
060790123051,1089,442,647,1115,427,688,1411,628,760,1209,478,668
060790123052,559,224,335,571,216,355,585,257,320,458,165,261
060790123062,411,178,233,419,169,250,640,281,350,520,218,269
060790124061,363,175,188,367,166,201,586,278,288,468,198,233
060790124063,434,213,221,444,202,242,698,359,320,493,222,232
060790124062,264,133,131,269,125,144,476,236,222,375,164,181
060790124041,630,289,341,646,280,366,825,370,436,579,267,283
060790124044,349,164,185,358,159,199,864,389,453,572,268,274
060790124042,512,256,256,516,247,269,677,340,321,485,228,222
060790124031,876,380,496,891,370,521,1291,573,689,995,419,507
060790124051,721,363,358,730,354,376,1030,513,494,786,366,362
060790124052,442,204,238,444,196,248,643,284,345,518,231,245
060790124032,784,310,474,799,307,492,1011,483,512,966,404,512
060790124043,785,261,524,803,258,545,806,368,424,916,321,541
060790122021,798,446,352,816,446,370,998,572,404,865,451,359
060790122011,310,188,122,319,182,137,345,199,134,326,181,118
060790122022,484,293,191,489,277,212,917,532,367,711,401,259
060790127062,956,420,536,982,420,562,1142,519,585,1047,442,537
060790125051,1084,435,649,1101,418,683,1364,608,733,1068,402,589
060790126012,623,323,300,638,311,327,897,440,426,688,320,319
060790126011,1101,486,615,1130,470,660,1421,684,706,1117,462,584
060790127051,461,208,253,469,205,264,675,315,350,557,243,280
060790127063,777,387,390,785,379,406,890,432,447,821,399,366
060790126013,588,305,283,602,291,311,782,388,370,640,295,298
060790126014,713,327,386,726,323,403,802,400,370,766,315,395
060790125022,406,215,191,420,216,204,681,353,313,491,234,210
060790125023,848,439,409,863,438,425,1228,637,546,1120,506,516
060790125052,509,212,297,516,203,313,653,291,345,589,224,317
060790125053,791,396,395,806,392,414,1063,536,496,861,394,390
060790125021,630,336,294,642,330,312,777,402,355,622,297,263
060790125031,684,296,388,703,288,415,684,339,329,692,262,379
060790125033,500,258,242,512,248,264,728,358,351,350,158,167
060790125034,664,372,292,673,367,306,887,459,398,645,316,268
060790131003,264,98,166,270,97,173,391,151,226,589,224,322
060790125032,454,262,192,464,261,203,897,519,346,623,318,242
060790127054,1113,467,646,1123,453,670,1646,711,886,1200,474,637
060790127052,359,147,212,365,147,218,556,187,354,442,173,237
060790127053,855,422,433,870,415,455,1091,604,449,917,434,405
060790131001,266,74,192,269,74,195,423,134,280,401,104,272
060790127081,436,157,279,444,157,287,595,206,382,478,164,288
060790115053,431,168,263,434,165,269,434,202,214,562,237,286
060790111011,500,384,116,515,379,136,675,519,139,546,389,94
060790109023,438,346,92,455,353,102,662,523,114,581,419,107
060790112022,539,408,131,565,417,148,511,404,97,517,365,107
060790109031,238,193,45,253,196,57,643,499,125,355,261,63
060790109022,409,317,92,430,319,111,548,439,92,514,356,96
060790109021,314,240,74,326,237,89,415,338,70,384,266,75
060790109041,10,5,5,10,5,5,250,190,48,329,232,62
060750255011,554,471,83,561,467,94,759,619,120,659,546,79
060750255022,729,611,118,736,610,126,1017,818,175,826,690,95
060750255012,577,489,88,580,485,95,732,600,119,605,506,69
060750255013,338,284,54,344,284,60,419,337,76,386,317,49
060750255023,524,468,56,532,471,61,683,590,83,592,516,50
060750256004,568,486,82,585,489,96,870,681,171,665,548,79
060750255021,378,319,59,381,313,68,486,376,97,414,332,60
060750313011,357,302,55,372,306,66,560,460,86,440,361,58
060750313012,625,521,104,643,524,119,834,692,130,628,515,80
060750312014,427,354,73,439,353,86,608,478,111,507,408,72
060750313013,564,501,63,596,512,84,731,614,104,644,550,65
060750312011,671,565,106,697,575,122,1096,881,189,870,723,97
060750312021,484,407,77,495,409,86,614,490,116,493,409,60
060750312012,490,416,74,524,433,91,716,571,131,591,488,63
060750312022,583,502,81,599,503,96,894,732,152,761,656,77
060750261002,698,556,142,734,580,154,1108,828,262,859,687,136
060750261004,405,333,72,425,346,79,538,415,118,473,380,71
060750261001,448,369,79,466,373,93,728,555,158,574,477,74
060750313022,445,363,82,459,370,89,652,486,140,583,474,68
060750313023,902,741,161,933,757,176,1277,1015,240,1125,916,147
060750313021,505,430,75,531,453,78,754,604,136,584,492,61
060750314022,304,262,42,319,269,50,515,400,101,428,356,49
060750314023,376,320,56,398,335,63,538,436,96,452,375,55
060750314021,607,502,105,630,529,101,883,709,161,720,607,79
060750314011,466,393,73,483,408,75,694,526,151,557,472,52
060750261003,364,280,84,391,297,94,563,424,134,445,343,80
060750262021,522,421,101,544,427,117,815,612,183,686,547,108
060750314012,214,178,36,224,186,38,367,276,81,270,224,30
060750262012,422,348,74,436,363,73,634,485,142,491,412,62
060750262013,315,253,62,326,263,63,485,366,111,413,333,62
060750262011,346,295,51,358,310,48,537,411,119,418,357,46
060750263033,354,274,80,365,281,84,583,425,145,411,329,63
060750262022,406,319,87,425,335,90,634,484,138,483,382,81
060750263032,346,266,80,357,271,86,473,344,118,366,292,58
060750263012,625,499,126,654,499,155,1005,763,220,779,611,137
060750263013,263,208,55,276,209,67,451,342,107,315,253,57
060750263031,585,467,118,611,485,126,901,708,180,694,559,112
060750263021,327,268,59,347,284,63,532,410,102,436,354,61
060750263022,397,319,78,412,336,76,526,415,101,444,363,59
060750263023,712,574,138,744,607,137,985,752,219,827,663,136
060750256001,554,474,80,572,480,92,772,594,163,638,537,73
060750260021,425,358,67,435,359,76,681,547,121,592,479,74
060750260022,683,582,101,692,585,107,893,729,143,767,641,79
060750260011,390,322,68,395,324,71,536,413,109,445,368,57
060750260012,424,350,74,429,352,77,654,501,133,538,446,70
060750260013,381,314,67,388,319,69,569,440,111,485,397,63
060750260031,710,601,109,731,607,124,1077,841,206,887,719,115
060750260014,384,322,62,399,331,68,577,465,93,499,410,61
060750260041,634,538,96,662,555,107,916,722,168,784,643,97
060750260032,801,650,151,835,664,171,1110,854,227,922,739,129
060750260042,530,430,100,545,437,108,813,633,163,685,558,90
060750263011,338,277,61,348,281,67,516,392,111,417,343,53
060750177001,279,256,23,280,256,24,430,391,33,266,238,14
060750228011,638,588,50,644,591,53,780,710,55,738,659,35
060750228012,805,754,51,805,753,52,942,867,58,902,820,35
060750228021,351,322,29,355,322,33,365,333,25,344,303,22
060750228022,507,477,30,505,471,34,567,513,38,682,617,27
060750227041,758,703,55,769,709,60,1008,925,60,874,792,44
060750607021,891,791,100,914,796,118,1199,1004,164,772,674,59
060750227042,579,534,45,585,533,52,665,608,41,670,601,36
060750227021,680,644,36,682,644,38,725,683,29,712,655,26
060750227022,639,592,47,643,592,51,668,626,34,703,643,36
060750229032,447,420,27,440,408,32,458,406,35,407,367,16
060750614012,379,345,34,377,341,36,461,405,38,433,383,23
060750227043,630,580,50,635,584,51,719,664,38,677,624,29
060750614013,584,546,38,584,545,39,697,646,39,650,599,23
060750614021,655,596,59,662,597,65,768,701,50,595,534,33
060750614011,486,443,43,488,446,42,579,520,44,670,599,31
060759809001,232,213,19,237,216,21,444,391,43,214,193,9
060750614022,383,349,34,386,350,36,646,593,43,456,407,26
060750226002,2031,1851,180,2089,1899,190,1123,1035,69,627,583,13
060750226001,1045,979,66,1053,981,72,1264,1188,59,813,751,24
060750230011,473,394,79,506,423,83,724,562,143,640,535,70
060750612002,251,214,37,266,233,33,421,344,65,365,319,27
060750612003,329,293,36,343,308,35,538,468,64,452,395,31
060750231021,621,556,65,641,585,56,860,742,101,813,738,54
060750231031,444,403,41,469,434,35,721,620,81,423,380,25
060750612001,434,390,44,440,396,44,605,512,76,573,516,35
060750230012,353,294,59,374,310,64,580,450,116,415,339,53
060750230033,499,435,64,512,445,67,702,581,97,599,521,44
060750230031,356,301,55,373,317,56,516,420,81,396,344,35
060750231022,402,359,43,407,372,35,599,516,66,486,447,24
060750232003,396,365,31,404,373,31,608,545,48,464,428,22
060750231032,660,588,72,695,631,64,926,805,90,700,645,30
060750230013,483,388,95,513,426,87,741,555,164,577,460,93
060750230032,361,291,70,381,310,71,591,450,125,455,374,62
060750232001,443,397,46,461,414,47,615,511,88,490,432,41
060750233002,712,559,153,762,604,158,1133,804,302,794,622,139
060750232002,499,451,48,530,472,58,677,584,75,625,548,44
060750234001,355,308,47,373,320,53,581,467,101,518,447,47
060750234002,486,409,77,512,437,75,748,612,118,596,530,47
060759806001,166,148,18,170,152,18,563,486,69,246,217,22
060750264041,299,234,65,314,250,64,534,384,138,360,302,46
060750264042,276,219,57,288,235,53,452,332,114,310,266,38
060750605023,280,219,61,287,226,61,508,384,118,418,348,53
060750605021,131,109,22,145,125,20,323,247,67,226,199,20
060759805011,38,29,9,40,31,9,53,41,12,132,109,17
060750605022,101,85,16,114,101,13,202,165,29,244,225,12
060750264011,469,359,110,500,392,108,748,534,195,546,451,73
060750264012,428,323,105,461,358,103,724,507,188,574,444,95
060750264021,271,214,57,276,219,57,437,333,90,315,257,40
060750264023,444,352,92,469,375,94,713,540,155,511,418,69
060750259002,802,663,139,828,679,149,1127,903,212,936,772,118
060750258002,203,167,36,209,173,36,344,261,73,275,229,32
060750264022,431,354,77,456,373,83,657,514,125,534,445,65
060750233001,333,296,37,350,305,45,565,452,98,398,351,31
060750610002,395,345,50,414,355,59,586,483,92,416,366,31
060750264032,391,304,87,432,338,94,819,603,201,605,470,105
060750264031,456,338,118,511,391,120,762,551,199,587,447,112
060750610001,494,398,96,523,416,107,792,583,183,650,513,111
060750610003,403,333,70,415,342,73,654,519,116,452,370,63
060750165004,555,533,22,552,530,22,638,608,20,654,609,14
060750102011,799,667,132,811,674,137,906,805,86,921,803,71
060750102021,516,405,111,528,418,110,586,489,83,592,484,77
060750102022,521,434,87,532,448,84,635,557,68,607,526,53
060750101011,287,238,49,302,254,48,347,275,64,325,265,42
060750103001,730,616,114,750,637,113,925,791,117,841,723,76
060750102012,615,533,82,625,538,87,663,598,54,729,636,59
060750109022,646,551,95,664,568,96,701,629,59,724,634,62
060750109011,637,547,90,648,553,95,694,617,65,703,620,48
060750103002,564,482,82,585,495,90,625,543,69,649,556,59
060750103003,623,523,100,643,540,103,777,672,90,708,597,71
060750152021,600,514,86,616,525,91,683,605,66,675,583,59
060750152022,632,556,76,655,581,74,701,638,53,688,609,38
060750151002,566,492,74,585,513,72,676,586,75,437,370,43
060750151003,421,361,60,434,377,57,536,460,67,529,450,53
060750152011,556,485,71,566,496,70,618,544,66,636,566,45
060750151001,436,371,65,448,389,59,553,469,72,500,423,51
060750101012,526,432,94,543,448,95,607,503,93,596,490,72
060750101021,682,571,111,710,596,114,882,724,138,824,680,98
060750104021,337,274,63,345,281,64,460,388,62,415,343,48
060750105001,469,385,84,484,397,87,589,478,97,452,364,59
060750107021,353,305,48,374,317,57,417,360,47,402,345,36
060750104011,276,236,40,282,239,43,328,286,37,360,304,35
060750104012,797,667,130,813,676,137,949,823,97,948,801,90
060750104022,356,309,47,364,313,51,434,386,39,421,358,33
060750104023,387,328,59,392,331,61,457,396,55,429,358,42
060750109021,566,475,91,587,494,93,727,627,84,709,612,68
060750109012,624,551,73,644,563,81,714,619,80,738,651,55
060750108001,612,504,108,638,530,108,776,664,95,713,590,82
060750108002,582,498,84,614,520,94,657,542,100,670,552,78
060750107022,228,194,34,241,204,37,312,258,47,300,254,28
060750107012,325,278,47,353,299,54,597,482,102,540,463,51
060750107011,289,235,54,325,266,59,470,356,107,391,321,52
060750106001,476,409,67,484,413,71,587,497,78,526,438,48
060750106003,440,378,62,452,384,68,624,527,83,588,492,50
060750106002,411,336,75,425,347,78,557,455,90,566,449,77
060750110021,266,227,39,274,235,39,337,302,31,343,289,32
060750110022,323,274,49,336,292,44,417,359,50,414,358,37
060750110023,384,327,57,398,341,57,427,379,39,395,332,37
060750113001,332,276,56,360,303,57,545,427,108,505,421,58
060750611021,96,78,18,110,90,20,159,119,36,134,111,17
060750110012,528,446,82,560,481,79,671,579,81,541,472,46
060750111011,508,447,61,523,453,70,610,524,72,688,586,50
060750110011,791,685,106,825,719,106,830,723,92,827,726,64
060750108003,722,628,94,754,657,97,877,742,118,880,748,82
060750113002,380,297,83,421,341,80,457,347,98,461,367,69
060750611022,203,154,49,224,171,53,389,280,103,312,242,55
060750117002,129,103,26,137,108,29,181,146,31,160,130,22
060750118001,303,239,64,336,277,59,500,380,108,439,359,60
060750611012,194,154,40,215,176,39,245,184,57,229,192,29
060750611011,136,106,30,152,126,26,301,223,73,238,200,29
060750105002,410,313,97,417,316,101,387,310,71,449,351,78
060750117004,265,229,36,270,232,38,309,251,51,243,205,27
060750105003,290,220,70,293,220,73,513,411,95,401,316,71
060750111021,522,462,60,533,468,65,578,511,56,616,528,43
060750111012,444,383,61,458,392,66,474,415,50,549,476,46
060750112003,272,232,40,278,237,41,277,239,31,324,277,30
060750111013,441,392,49,451,401,50,462,401,55,523,459,36
060750112001,614,502,112,628,512,116,731,600,117,743,614,85
060750112002,371,308,63,376,312,64,404,338,55,409,344,41
060750112004,336,273,63,343,278,65,371,304,60,348,287,42
060750119012,136,112,24,142,116,26,202,168,29,236,194,30
060750119021,227,188,39,235,193,42,329,269,51,349,290,42
060750111022,437,384,53,444,391,53,554,484,53,449,383,37
060750120011,473,414,59,485,426,59,571,504,50,643,549,49
060750120022,214,193,21,215,193,22,275,238,29,213,185,14
060750122022,383,334,49,391,339,52,440,357,72,515,439,47
060750119013,277,245,32,279,242,37,281,244,28,266,227,24
060750119011,642,566,76,646,563,83,715,613,80,733,625,65
060750120012,279,255,24,284,263,21,291,260,24,291,261,15
060750121002,492,442,50,497,449,48,583,508,59,551,482,38
060750121003,472,426,46,476,425,51,557,483,55,591,514,42
060750119022,649,584,65,654,584,70,653,586,49,606,533,36
060750121001,320,282,38,326,288,38,431,370,49,423,365,35
060750120021,466,426,40,466,420,46,536,473,51,545,477,36
060750123021,277,255,22,281,255,26,262,235,19,340,302,20
060750123023,148,134,14,151,136,15,208,181,19,185,162,15
060750123024,200,175,25,207,184,23,250,204,38,203,175,16
060750117003,71,63,8,72,64,8,103,85,18,81,70,10
060750119023,236,203,33,239,205,34,302,243,50,267,226,30
060750123013,76,62,14,82,71,11,82,67,14,107,90,11
060750125032,128,104,24,142,123,19,291,236,47,207,172,22
060750125031,188,153,35,209,183,26,265,215,42,256,214,27
060750117001,253,217,36,258,218,40,169,138,28,212,181,23
060750152012,280,241,39,289,248,41,390,342,41,361,317,27
060750155004,430,364,66,445,382,63,449,374,68,455,388,47
060750155001,536,481,55,549,500,49,645,561,62,684,615,39
060750155003,299,251,48,309,264,45,366,306,54,427,356,50
060750159004,365,322,43,374,331,43,451,384,56,357,311,30
060750159003,332,293,39,341,302,39,452,386,56,420,364,36
060750159002,312,272,40,325,287,38,480,403,63,388,333,36
060750161022,520,450,70,552,492,60,794,651,127,579,503,52
060750159001,539,468,71,560,485,75,652,545,95,591,498,67
060750161021,329,295,34,341,307,34,476,420,48,455,413,29
060750160002,602,532,70,610,538,72,640,541,89,700,607,64
060750160001,570,508,62,578,512,66,693,582,97,701,610,63
060750161011,604,485,119,611,495,116,857,615,229,724,567,131
060750161012,412,353,59,430,377,53,534,431,94,462,393,47
060750163001,329,306,23,334,314,20,468,412,47,448,412,20
060750162001,561,513,48,567,520,47,599,540,50,423,386,21
060750162003,560,521,39,562,524,38,750,672,60,602,559,22
060750165003,844,800,44,844,797,47,949,899,31,966,896,23
060750165002,660,626,34,664,628,36,702,669,27,727,674,16
060750165001,789,743,46,798,750,48,933,867,54,995,905,39
060750163003,642,619,23,634,610,24,714,675,24,776,715,12
060750164002,552,523,29,550,520,30,586,561,19,604,556,12
060750164001,923,852,71,934,858,76,1053,951,87,1075,962,59
060750163004,530,509,21,533,511,22,593,552,26,641,583,15
060750163002,577,533,44,581,537,44,615,552,50,744,675,32
060750162002,624,581,43,626,581,45,571,524,39,711,649,31
060759803001,43,40,3,44,41,3,95,90,5,85,81,2
060750164003,677,655,22,679,654,25,664,645,11,751,693,16
060750166021,1395,1323,72,1394,1326,68,1488,1388,57,1486,1329,51
060750166012,894,854,40,896,857,39,978,926,28,970,886,27
060750166011,973,931,42,976,933,43,1068,1005,36,1113,1027,25
060750167003,597,570,27,597,569,28,652,628,20,668,629,14
060750167004,907,864,43,908,865,43,994,948,26,967,906,18
060750167001,1046,1007,39,1053,1008,45,1179,1131,29,1199,1120,17
060750168011,802,769,33,792,760,32,903,866,21,949,887,20
060750168012,665,638,27,674,646,28,721,687,31,951,885,27
060750168022,709,675,34,705,674,31,810,761,33,868,811,21
060750168013,656,629,27,666,637,29,893,835,47,524,489,15
060750168021,634,591,43,637,594,43,793,742,36,722,660,24
060750168023,639,614,25,651,615,36,603,570,25,681,636,16
060750171023,1039,982,57,1039,979,60,1135,1069,39,1068,982,30
060750171013,732,690,42,732,701,31,839,789,30,800,738,24
060750301011,794,736,58,807,748,59,924,838,57,881,790,38
060750171021,809,767,42,815,772,43,891,837,32,883,819,25
060750171011,802,757,45,817,775,42,860,813,28,854,804,23
060750301023,797,702,95,819,717,102,1104,973,116,971,826,91
060750301024,516,474,42,523,481,42,567,533,29,591,532,30
060750171022,420,400,20,426,404,22,488,464,18,497,456,15
060750171012,687,634,53,689,638,51,804,751,34,822,762,33
060750301022,594,549,45,597,557,40,709,672,25,659,618,22
060750122021,340,295,45,348,307,41,387,306,68,354,303,30
060750122032,301,275,26,306,279,27,321,274,39,323,284,19
060750122031,259,236,23,263,239,24,299,254,37,339,299,20
060750122043,308,282,26,312,285,27,321,273,34,363,317,17
060750122042,290,266,24,294,269,25,310,265,33,317,278,15
060750123011,297,261,36,302,269,33,420,346,60,393,333,34
060750123022,280,246,34,284,254,30,293,242,41,267,225,24
060750123012,183,154,29,192,169,23,363,266,83,283,241,25
060750124031,266,229,37,276,241,35,404,314,77,357,307,30
060750124061,237,206,31,243,210,33,290,231,51,284,241,27
060750122041,310,272,38,315,281,34,313,255,48,340,289,23
060750124042,278,244,34,281,251,30,369,300,57,350,297,23
060750125022,194,144,50,207,165,42,261,166,83,237,194,32
060750125021,179,141,38,200,169,31,234,172,56,228,187,25
060750125023,207,163,44,232,196,36,318,235,77,300,247,33
060750125033,294,229,65,323,272,51,395,294,87,384,306,53
060750176022,202,172,30,207,182,25,273,228,40,299,253,28
060750124053,321,294,27,325,299,26,302,268,22,439,387,23
060750124062,322,258,64,345,283,62,402,319,76,404,322,62
060750124032,173,148,25,180,158,22,230,176,47,229,198,19
060750124051,257,216,41,266,233,33,250,198,45,276,237,23
060750124041,252,215,37,255,227,28,355,289,55,427,367,31
060750124043,182,156,26,185,164,21,149,121,23,192,165,14
060750125024,157,125,32,177,150,27,214,154,50,233,182,34
060750124052,655,601,54,671,615,56,784,706,56,347,305,19
060750125041,161,122,39,169,142,27,316,243,63,340,284,41
060750201011,550,500,50,560,502,58,652,570,58,594,524,41
060750202021,642,602,40,638,600,38,702,656,33,760,707,23
060750176034,448,403,45,451,407,44,650,561,68,0,0,0
060750176033,333,291,42,340,302,38,562,469,77,593,517,47
060750177002,671,616,55,677,622,55,729,647,68,920,818,54
060750176043,307,261,46,319,276,43,424,356,56,328,279,33
060750176041,0,0,0,0,0,0,323,282,31,0,0,0
060750176042,633,561,72,648,571,77,519,457,49,466,402,40
060750176032,366,321,45,377,333,44,389,314,65,401,347,34
060750176021,482,412,70,500,438,62,577,467,89,556,477,52
060750176023,172,145,27,176,154,22,245,199,39,185,157,17
060750178042,375,329,46,386,342,44,542,476,51,341,302,22
060750178011,369,281,88,422,340,82,551,413,129,482,399,65
060750615013,267,230,37,277,244,33,315,269,43,394,338,37
060750615012,169,144,25,176,154,22,214,179,32,209,180,20
060750615031,265,234,31,272,242,30,719,631,74,155,134,13
060750615033,304,267,37,309,276,33,415,363,47,416,357,37
060750615071,288,237,51,297,245,52,589,501,77,356,302,34
060750615011,282,233,49,291,242,49,283,232,46,200,170,19
060750615062,309,253,56,320,263,57,375,322,41,358,303,33
060750178031,403,370,33,408,373,35,482,422,48,449,396,26
060750178032,364,334,30,372,340,32,421,380,31,208,183,12
060750178041,648,580,68,668,603,65,786,702,65,780,693,37
060750178043,245,220,25,252,225,27,284,245,34,295,259,20
060750178012,433,379,54,449,395,54,476,400,63,516,456,35
060750178044,246,215,31,258,225,33,285,236,38,206,181,15
060750180004,299,274,25,305,278,27,515,467,36,618,549,38
060750180003,265,242,23,270,246,24,363,327,26,74,66,4
060750180002,381,342,39,389,343,46,483,435,40,431,388,22
060750178013,416,343,73,439,373,66,547,423,110,547,460,55
060750615022,413,348,65,426,363,63,467,397,63,438,375,39
060750607033,755,675,80,770,688,82,800,702,80,605,536,43
060750180001,495,437,58,501,436,65,435,397,31,413,368,25
060750615041,374,324,50,377,324,53,285,253,20,506,435,39
060750615042,287,245,42,290,245,45,785,688,83,303,260,23
060750615051,419,347,72,431,356,75,557,494,57,573,477,70
060750615061,648,536,112,667,550,117,811,689,110,479,399,59
060750607031,645,567,78,662,580,82,797,717,68,855,755,59
060750607011,411,341,70,425,355,70,569,490,70,495,421,45
060750607013,301,260,41,313,272,41,552,501,45,302,274,14
060750615083,255,207,48,266,218,48,324,273,47,335,283,33
060750615021,476,395,81,484,406,78,681,586,80,562,479,55
060750615081,187,162,25,199,179,20,151,127,19,46,39,5
060750615082,307,266,41,326,294,32,405,342,48,718,608,80
060750607032,515,456,59,524,465,59,751,655,80,652,584,42
060750607012,253,230,23,261,238,23,1948,1758,163,1553,1406,73
060750179031,461,410,51,478,435,43,716,607,89,578,489,38
060750176031,328,282,46,340,299,41,313,256,48,554,479,44
060750615063,324,286,38,333,296,37,454,398,45,348,296,32
060750615032,306,275,31,306,277,29,218,190,15,272,234,21
060750301021,717,616,101,742,629,113,781,695,77,731,615,73
060750305003,372,311,61,384,318,66,371,314,50,260,218,30
060750305001,504,419,85,516,419,97,631,541,84,544,439,70
060750305002,470,377,93,481,389,92,688,574,105,633,514,83
060750307001,1582,1354,228,1621,1386,235,1890,1667,192,1707,1447,187
060750217001,745,619,126,758,632,126,979,847,115,893,758,102
060750307002,946,838,108,964,850,114,1110,1001,91,1015,897,72
060750311005,938,831,107,942,832,110,1195,1059,113,1091,956,84
060750311001,592,540,52,593,539,54,661,594,54,658,596,34
060750170003,745,706,39,754,718,36,800,770,19,800,751,23
060750170002,549,508,41,549,506,43,577,540,27,590,547,25
060750170004,638,598,40,642,606,36,732,694,29,739,690,26
060750170001,676,634,42,677,638,39,700,668,26,747,698,26
060750167002,429,408,21,429,403,26,501,475,18,482,443,12
060750169001,796,758,38,808,775,33,888,842,31,849,796,13
060750169003,769,737,32,771,739,32,795,757,25,886,828,15
060750169002,501,481,20,504,485,19,568,541,19,581,550,11
060750203003,832,806,26,842,804,38,882,842,27,792,739,20
060750203001,865,833,32,870,825,45,1004,941,46,956,896,24
060750202023,563,528,35,573,531,42,665,588,61,681,613,38
060750202022,726,682,44,736,689,47,847,767,60,872,790,36
060750202011,604,557,47,608,564,44,714,644,53,675,607,32
060750204011,817,767,50,822,777,45,745,715,21,713,662,20
060750204012,357,331,26,362,337,25,541,498,35,499,456,23
060750204013,858,808,50,862,816,46,942,901,29,941,876,27
060750205001,565,531,34,574,541,33,555,523,24,534,491,25
060750203002,412,394,18,413,392,21,438,422,13,462,433,13
060750202012,546,509,37,545,510,35,634,580,43,706,633,34
060750204023,708,650,58,718,663,55,760,698,41,762,697,33
060750205002,608,572,36,610,577,33,629,594,24,691,645,26
060750206022,628,592,36,631,597,34,671,640,25,671,629,17
060750206012,1029,976,53,1035,984,51,1134,1079,38,1098,1034,32
060750206011,768,728,40,772,735,37,834,792,28,844,788,24
060750207021,648,613,35,648,610,38,697,644,36,732,668,26
060750207022,725,694,31,727,695,32,733,690,30,659,607,19
060750204024,440,405,35,450,415,35,610,564,42,568,514,32
060750212003,525,485,40,527,490,37,592,561,26,557,518,21
060750205003,642,607,35,640,609,31,686,656,22,678,633,19
060750206021,800,754,46,808,761,47,876,826,37,854,792,28
060750207012,642,613,29,645,619,26,633,601,20,622,579,18
060750207013,553,525,28,553,529,24,756,717,25,698,650,21
060750204021,720,655,65,730,667,63,834,761,60,826,738,58
060750204022,630,573,57,638,583,55,730,669,50,663,591,46
060750213002,794,736,58,804,745,59,950,883,48,908,839,34
060750212002,689,630,59,698,638,60,793,728,48,765,700,38
060750212001,564,526,38,570,531,39,648,609,30,596,548,25
060750211001,747,703,44,752,707,45,807,762,34,814,762,27
060750211004,522,487,35,528,490,38,590,555,27,584,542,20
060750207011,531,503,28,533,501,32,598,559,27,636,586,22
060750210001,548,515,33,547,511,36,632,588,34,662,603,28
060750210002,536,505,31,532,498,34,587,544,33,638,585,27
060750210003,802,759,43,795,754,41,838,778,45,814,740,33
060750213001,639,586,53,652,597,55,754,696,43,719,654,35
060750211003,600,561,39,603,560,43,666,626,29,714,665,24
060750214003,756,704,52,769,711,58,797,752,33,816,751,30
060750211002,531,500,31,533,500,33,626,592,27,587,541,20
060750214001,461,434,27,463,432,31,465,435,20,507,467,18
060750216002,775,677,98,792,681,111,805,713,84,761,665,74
060750216003,467,425,42,477,432,45,571,515,45,527,482,29
060750216001,1109,1027,82,1127,1041,86,1317,1227,76,1260,1147,68
060750214002,865,813,52,876,822,54,927,884,36,927,860,35
060750215001,476,447,29,477,447,30,526,496,21,527,488,18
060750210004,417,393,24,414,392,22,523,486,28,517,469,20
060750217003,957,867,90,966,876,90,1095,1000,79,990,888,56
060750215003,526,486,40,524,486,38,601,552,38,543,492,29
060750215004,616,566,50,618,570,48,682,627,35,662,603,29
060750215005,592,545,47,594,544,50,691,646,35,670,614,32
060750253004,900,855,45,899,841,58,1037,960,57,1001,914,34
060750215002,676,631,45,676,628,48,775,725,35,746,679,29
060750218001,696,649,47,696,647,49,799,741,47,793,730,37
060750217002,634,574,60,648,586,62,844,767,63,736,660,47
060750218002,670,630,40,667,624,43,756,703,41,697,651,24
060750218003,444,420,24,445,418,27,499,469,26,457,423,18
060750218004,588,555,33,602,563,39,668,630,29,664,605,33
060750253003,438,415,23,438,410,28,505,459,34,512,462,20
060750254011,577,536,41,578,540,38,668,606,51,656,587,28
060750254013,484,450,34,483,448,35,571,513,44,497,444,26
060750254031,845,755,90,860,757,103,1126,958,145,1052,905,97
060750201012,684,642,42,683,634,49,802,717,68,732,669,24
060750201021,463,430,33,467,434,33,524,459,54,567,507,26
060750201022,298,276,22,301,280,21,302,267,29,425,377,23
060750201023,218,202,16,221,205,16,264,228,31,297,261,18
060750208021,449,414,35,449,415,34,558,498,48,554,483,31
060750208022,549,521,28,545,522,23,613,566,36,634,596,13
060750208011,453,429,24,453,428,25,530,492,28,527,488,16
060750228013,662,631,31,656,623,33,748,702,33,773,709,17
060750208012,524,481,43,538,483,55,677,576,87,734,640,57
060750208013,421,396,25,424,391,33,469,423,36,450,403,22
060750209001,682,648,34,680,637,43,829,747,67,857,766,38
060750209004,526,494,32,515,482,33,540,488,40,588,532,19
060750228031,812,759,53,798,746,52,907,830,52,958,869,35
060750228032,565,540,25,561,526,35,565,523,33,569,521,18
060750228033,513,490,23,508,475,33,651,600,38,633,576,20
060750229031,564,525,39,558,514,44,681,613,54,637,562,29
060750209003,341,321,20,336,313,23,347,315,28,325,296,10
060750229011,709,673,36,692,650,42,757,679,57,749,664,30
060750229021,492,474,18,482,458,24,548,497,36,566,510,18
060750209002,376,358,18,371,347,24,455,403,40,491,438,21
060750229013,294,274,20,288,265,23,427,374,40,423,368,22
060750229012,586,547,39,576,527,49,679,596,57,609,535,30
060750229022,508,481,27,508,474,34,604,538,46,536,481,22
060750229033,363,338,25,358,331,27,381,344,31,386,342,18
060750252001,608,575,33,595,560,35,765,705,46,752,675,29
060750252002,829,788,41,820,776,44,965,894,53,898,811,32
060750251001,844,797,47,837,790,47,982,923,42,951,868,36
060750251003,442,410,32,443,413,30,411,378,28,393,354,19
060750252004,695,660,35,686,646,40,707,666,31,678,624,21
060750253001,647,616,31,648,610,38,681,646,26,700,644,19
060750251002,513,489,24,514,485,29,584,546,30,564,518,21
060750252003,734,697,37,733,693,40,937,871,47,871,798,32
060750253002,481,456,25,474,444,30,508,479,21,469,431,14
060750254022,404,377,27,408,379,29,570,519,41,494,452,22
060750254023,483,444,39,490,451,39,547,495,44,530,480,34
060750254012,504,481,23,501,477,24,621,578,33,527,486,15
060750254021,516,491,25,521,488,33,598,552,41,583,529,23
060750254032,846,775,71,855,784,71,1147,1019,103,1031,919,64
060750256002,325,248,77,343,253,90,515,377,132,396,309,72
060750257011,388,324,64,411,329,82,568,437,119,449,370,63
060750257012,536,445,91,572,494,78,869,661,178,702,571,92
060750256003,361,307,54,373,307,66,520,413,97,442,351,62
060750259001,741,583,158,769,598,171,1024,808,191,857,688,125
060750257013,385,295,90,401,305,96,643,479,150,480,373,83
060750257023,447,349,98,470,363,107,626,474,140,494,390,81
060750257022,415,340,75,427,333,94,642,493,130,548,425,94
060750258001,281,226,55,293,234,59,469,360,104,393,318,53
060750257021,316,234,82,329,255,74,522,370,134,407,311,76
060750479023,538,449,89,559,461,98,687,568,104,539,434,72
060750479021,579,478,101,604,494,110,804,660,125,670,539,92
060750479022,527,428,99,548,442,106,631,511,106,557,451,80
060759802001,41,34,7,43,34,9,46,38,8,109,86,17
060750427003,751,614,137,778,633,145,1004,803,180,875,690,127
060750478021,481,385,96,490,389,101,645,515,119,527,431,75
060750427002,701,582,119,722,594,128,980,782,178,831,664,111
060750427001,707,584,123,730,598,132,973,793,158,857,696,109
060750426012,1029,885,144,1057,899,158,1248,1061,158,1130,943,125
060750426022,539,465,74,553,471,82,693,586,94,615,526,61
060750426011,613,518,95,629,524,105,845,688,141,694,567,91
060750426023,545,477,68,565,493,72,715,613,87,655,554,68
060750426021,439,381,58,456,397,59,628,532,85,504,422,55
060750477012,627,531,96,650,544,106,825,677,132,733,597,81
060750402002,404,353,51,412,354,58,483,405,68,462,389,48
060750402003,528,462,66,547,473,74,722,614,93,652,553,64
060750402004,746,652,94,776,672,104,953,829,109,805,693,67
060750401004,448,398,50,458,413,45,551,498,46,503,439,35
060750402001,826,724,102,850,742,108,971,838,110,888,767,73
060750401002,519,449,70,526,460,66,604,519,70,573,486,53
060750401003,647,566,81,659,581,78,767,666,88,716,612,65
060750451003,579,516,63,581,516,65,737,629,86,667,588,56
060750479033,482,402,80,497,407,90,643,524,108,521,422,73
060750478023,592,486,106,617,504,113,811,648,141,678,548,92
060750479031,445,363,82,455,372,83,620,501,106,510,407,70
060750479032,638,529,109,661,538,123,875,712,143,721,582,98
060750478012,459,377,82,472,387,85,702,558,126,564,453,77
060750478013,730,580,150,761,603,158,931,736,181,827,648,132
060750477011,630,503,127,657,522,135,813,637,154,756,610,108
060750477013,532,440,92,549,448,101,750,599,134,641,518,85
060750476001,600,510,90,623,525,98,794,668,111,695,579,74
060750476002,605,502,103,633,522,111,757,632,110,683,569,76
060750476003,522,428,94,541,441,100,623,513,100,522,428,65
060750452011,499,428,71,507,425,82,635,543,78,541,452,61
060750452012,566,483,83,575,483,92,679,572,93,630,522,78
060750452013,578,488,90,589,491,98,697,571,111,649,531,94
060750452021,761,648,113,770,653,117,944,805,117,874,733,99
060750451001,959,856,103,975,861,114,1221,1048,145,1181,1024,98
060750156003,504,447,57,512,450,62,617,526,77,457,393,39
060750156001,355,312,43,365,316,49,448,391,50,385,321,41
060750157011,974,853,121,995,863,132,1207,1039,150,1119,936,119
060750479041,666,535,131,689,542,147,950,712,206,757,585,132
060750479042,554,457,97,566,471,95,712,584,115,639,523,81
060750478011,546,427,119,566,442,124,780,629,135,605,454,111
060750478022,498,410,88,511,425,86,684,558,110,575,464,84
060750477021,487,416,71,503,426,77,636,523,104,564,460,75
060750477023,589,501,88,603,510,93,791,648,128,683,557,91
060750477022,582,483,99,594,488,106,739,611,115,627,507,91
060750476004,735,615,120,749,623,126,905,768,123,805,657,108
060750452022,786,698,88,798,701,97,935,823,104,883,752,81
060750451002,667,592,75,678,598,80,826,717,96,744,636,58
060750156002,644,577,67,655,583,72,780,705,60,721,624,58
060750157012,582,527,55,595,531,64,421,371,40,675,586,58
060750326011,857,736,121,878,743,135,871,721,133,773,643,83
060750601001,582,519,63,582,517,65,1027,921,91,740,631,44
060750601002,742,640,102,754,669,85,1002,902,75,869,762,55
060750428002,375,290,85,390,302,88,514,421,85,414,329,67
060750126021,802,569,233,842,621,221,1009,816,175,920,712,159
060750127001,791,567,224,826,594,232,1006,820,166,893,671,165
060750129011,860,722,138,889,746,143,796,694,87,765,640,78
060750129012,597,501,96,616,517,99,849,734,96,800,667,79
060750129022,567,471,96,590,491,99,690,582,93,697,588,66
060750127002,638,472,166,663,483,180,766,621,127,691,530,119
060750127003,393,316,77,407,325,82,506,427,70,464,371,61
060750126012,660,509,151,692,544,148,795,663,111,800,645,107
060750126011,543,415,128,571,442,129,651,541,98,612,489,87
060750128021,398,317,81,417,335,82,523,446,71,444,360,56
060750126022,540,409,131,564,434,130,808,664,127,738,612,91
060750128013,385,304,81,402,318,84,524,441,75,479,383,64
060750129023,458,367,91,486,390,96,619,520,90,571,475,64
060750128012,547,412,135,571,444,127,653,537,102,586,467,86
060750128011,480,358,122,494,373,121,566,471,84,537,432,71
060750128022,487,392,95,507,411,96,605,519,74,597,488,73
060750130021,516,397,119,541,426,115,642,528,99,598,477,85
060750130022,483,376,107,510,403,107,585,494,77,598,491,76
060750129021,718,569,149,743,609,134,832,702,112,781,656,86
060750130012,575,448,127,600,475,125,632,526,93,650,532,81
060750132002,767,601,166,791,634,157,925,801,111,907,761,105
060750132001,391,302,89,411,324,87,463,394,63,464,379,63
060750132004,458,358,100,476,377,99,622,523,87,631,512,88
060750132003,635,498,137,671,536,135,744,632,97,752,617,92
060750131022,720,577,143,750,604,146,812,696,106,823,682,96
060750130011,671,540,131,692,559,133,717,615,93,815,690,76
060750131013,405,326,79,424,342,82,500,424,64,485,400,53
060750428001,622,482,140,643,499,144,684,560,111,655,514,105
060750428003,436,351,85,452,373,79,377,330,41,549,455,56
060750401001,516,439,77,533,457,76,615,542,65,592,497,66
060750133005,393,323,70,405,337,68,460,407,47,450,379,47
060750133003,474,377,97,491,397,94,597,508,77,652,542,78
060750133004,430,335,95,450,361,89,547,484,56,472,407,46
060750133001,396,309,87,407,319,88,429,374,48,450,379,47
060750133002,614,481,133,630,496,134,719,620,81,677,559,75
060750134021,1227,1043,184,1273,1104,169,1384,1241,116,1355,1187,111
060750134011,390,332,58,407,356,51,448,406,36,455,399,34
060750131021,828,698,130,846,713,133,922,810,96,914,787,87
060750131014,524,441,83,540,459,81,585,506,66,567,485,43
060750131011,593,493,100,613,510,103,684,615,57,672,578,51
060750131012,660,570,90,673,581,92,709,635,60,772,674,64
060750134012,455,413,42,474,425,49,532,488,36,505,447,38
060750135001,706,605,101,728,620,108,881,793,73,794,699,53
060750135003,324,285,39,341,300,41,422,375,35,358,311,23
060750135002,417,354,63,426,362,64,443,393,45,475,413,40
060750154022,608,519,89,631,538,93,724,649,59,676,584,52
060750154012,607,517,90,626,535,91,687,614,56,648,560,49
060750154021,754,619,135,778,643,135,846,716,115,791,657,90
060750154011,1161,1013,148,1196,1040,156,1427,1255,149,1335,1150,110
060750153001,561,500,61,571,505,66,614,560,37,599,533,28
060750153002,639,576,63,653,584,69,807,751,41,712,634,37
060750155002,299,279,20,305,283,22,317,294,16,395,354,19
060750158012,802,740,62,818,762,56,974,889,76,915,825,40
060750157021,838,752,86,851,760,91,979,883,85,943,838,71
060750352012,483,403,80,506,422,84,549,437,96,458,358,64
060750352021,693,617,76,712,627,85,959,829,107,823,681,85
060750352022,626,557,69,643,567,76,820,700,104,763,632,79
060750351011,497,413,84,516,426,90,686,547,129,584,480,74
060750351012,526,441,85,547,455,92,671,543,117,613,493,86
060750327001,355,287,68,373,295,78,479,388,86,444,362,58
060750327002,485,390,95,508,402,106,679,537,121,602,491,82
060750327007,343,281,62,367,290,77,502,413,75,391,329,44
060750326012,616,528,88,630,535,95,793,660,117,742,618,76
060750326021,733,586,147,763,597,166,1026,799,204,858,682,128
060750326013,649,534,115,668,545,123,804,651,139,712,576,90
060750302011,852,754,98,860,764,96,1074,927,124,1000,856,83
060750302012,544,486,58,550,491,59,694,602,80,603,520,48
060750352014,511,440,71,527,445,82,682,565,102,566,458,67
060750352023,506,445,61,514,445,69,761,639,102,640,531,63
060750351013,476,393,83,497,404,93,662,528,122,534,418,87
060750327003,489,403,86,506,408,98,620,496,109,556,466,62
060750327006,352,264,88,368,280,88,464,353,102,378,289,67
060750352013,481,415,66,507,429,78,639,530,96,508,417,60
060750352015,388,322,66,412,339,73,562,449,100,472,376,63
060750351021,327,253,74,347,260,87,433,323,100,371,276,73
060750351022,365,283,82,388,291,97,514,383,119,410,305,82
060750351023,356,274,82,380,284,96,524,392,121,404,303,80
060750327004,377,273,104,400,296,104,548,403,130,426,313,86
060750327005,303,218,85,324,236,88,434,321,105,334,257,65
060750326022,515,394,121,543,410,133,689,531,146,585,444,101
060750326023,485,371,114,510,385,125,674,524,144,592,449,103
060750303011,638,530,108,663,547,116,787,670,108,663,536,96
060750352011,436,354,82,459,377,82,584,460,106,481,375,70
060750354001,529,433,96,565,464,101,660,542,111,578,460,86
060750351024,544,423,121,588,453,135,806,600,189,648,509,109
060750353001,396,300,96,414,316,98,611,462,134,425,325,78
060750353006,505,399,106,536,424,112,750,583,154,618,489,102
060750354002,589,471,118,630,505,125,861,685,158,666,528,107
060750329021,441,332,109,481,354,127,685,519,154,519,404,98
060750329022,468,368,100,505,388,117,677,530,136,563,430,102
060750328023,483,373,110,511,392,119,688,522,152,559,430,101
060750328021,513,402,111,540,415,125,651,502,132,546,417,96
060750328022,552,436,116,572,441,131,705,531,156,597,457,104
060750329011,449,346,103,462,350,112,634,480,140,552,422,101
060750329012,498,384,114,517,390,127,724,548,163,559,432,102
060750329023,489,383,106,514,398,116,719,555,152,552,422,103
060750328011,520,406,114,548,423,125,845,646,177,687,535,121
060750353002,540,405,135,571,424,147,748,570,166,625,474,115
060750329013,484,366,118,505,380,125,686,500,174,580,444,108
060750329014,498,377,121,518,391,127,763,554,191,568,432,106
060750328012,548,435,113,571,451,120,746,581,144,621,490,101
060750328013,442,339,103,462,358,104,671,508,154,519,407,90
060750354003,467,371,96,486,391,95,596,465,122,536,422,85
060750354004,708,568,140,733,593,140,994,770,196,806,635,124
060750354005,457,373,84,475,387,88,638,513,111,532,433,69
060750353005,477,381,96,494,391,103,707,551,135,577,451,87
060750353003,369,280,89,389,294,95,581,447,125,432,330,73
060750330012,561,439,122,585,457,128,763,583,161,621,486,103
060750330013,561,440,121,589,459,130,736,563,156,625,485,105
060750330021,538,427,111,561,451,110,743,587,142,630,513,89
060750330022,485,381,104,506,397,109,645,504,129,539,437,82
060750353004,377,294,83,396,311,85,548,423,110,409,318,63
060750330011,510,366,144,542,392,150,735,540,182,630,472,139
060750308004,934,734,200,960,740,220,1123,905,206,951,742,163
060750330023,731,538,193,751,562,189,938,739,178,801,617,138
060750158011,215,196,19,221,206,15,296,264,27,244,222,11
060750158013,691,649,42,701,654,47,846,771,55,880,809,29
060750157022,902,847,55,898,836,62,962,911,36,974,884,38
060750158021,862,832,30,866,831,35,931,880,28,926,851,21
060750158022,923,854,69,921,850,71,1044,967,61,1040,947,43
060750301012,692,649,43,701,653,48,730,676,37,784,710,24
060750302021,839,768,71,847,768,79,992,883,90,897,798,59
060750302022,796,729,67,804,729,75,890,794,80,892,799,56
060750302023,745,676,69,755,682,73,898,814,66,849,754,54
060750301013,498,463,35,510,474,36,547,507,35,555,506,21
060750301014,541,504,37,553,511,42,617,571,38,611,553,25
060750302013,620,530,90,622,536,86,723,652,61,676,576,66
060750303021,620,502,118,649,514,135,806,664,124,699,547,117
060750303012,994,891,103,1014,903,111,1195,1072,107,1150,997,97
060750303014,587,486,101,610,497,113,765,654,105,648,540,79
060750303013,851,733,118,866,738,128,1030,900,109,913,776,94
060750303023,592,487,105,611,488,123,787,643,131,661,531,92
060750303022,616,494,122,631,510,121,760,641,107,698,566,89
060750304001,643,502,141,668,528,140,745,619,118,682,556,102
060750304002,616,476,140,632,495,137,768,629,128,674,535,107
060750304003,649,506,143,678,523,155,850,678,154,761,596,125
060750304004,356,281,75,375,287,88,451,355,86,406,318,67
060750304005,396,321,75,403,320,83,563,452,95,479,378,72
060750308005,847,679,168,863,675,188,1049,838,192,961,755,143
060750308001,553,432,121,569,444,125,629,513,109,549,434,80
060750306002,437,355,82,442,356,86,528,438,81,459,384,59
060750306003,450,350,100,466,363,103,565,468,89,492,395,68
060750306001,426,329,97,442,348,94,544,442,96,454,375,63
060750308003,383,283,100,393,289,104,494,383,102,442,335,84
060750331003,347,241,106,359,245,114,488,372,107,377,263,96
060750331002,473,334,139,503,343,160,679,492,174,529,390,113
060750331004,648,429,219,680,455,225,895,648,236,730,532,166
060750331001,292,220,72,308,225,83,441,316,117,503,384,94
060750332011,774,694,80,788,691,97,390,304,79,1080,927,103
060750309006,320,219,101,336,231,105,408,298,102,370,260,99
060750309005,417,301,116,428,311,117,555,430,119,471,341,109
060750309002,696,524,172,720,537,183,834,648,174,739,538,163
060750309001,536,395,141,547,412,135,647,513,117,559,424,110
060750308002,445,332,113,461,338,123,516,411,96,468,366,85
060750310001,434,360,74,443,365,78,591,501,89,528,428,73
060750307003,1337,1101,236,1358,1111,247,1680,1422,236,1446,1194,187
060750310002,790,645,145,803,651,152,1045,863,164,828,661,121
060750604001,359,289,70,370,293,77,486,376,101,440,326,83
060750332043,453,393,60,453,386,67,495,405,82,580,473,67
060750332032,508,436,72,510,432,78,502,405,92,597,484,74
060750332041,335,289,46,340,293,47,359,284,68,372,288,52
060750309007,451,330,121,469,348,121,625,464,149,508,391,102
060750332031,666,579,87,676,587,89,1035,826,183,889,709,110
060750332042,445,371,74,449,360,89,523,409,105,561,437,91
060750309003,626,507,119,641,517,124,764,608,146,700,555,122
060750309004,449,342,107,456,343,113,581,452,121,484,367,100
060750312013,322,273,49,333,278,55,485,381,87,422,345,58
060750310003,667,542,125,684,544,140,899,714,164,892,700,139
060750311004,583,494,89,590,496,94,808,679,106,701,590,83
060750311003,332,291,41,339,292,47,370,321,46,338,289,36
060750311002,665,583,82,676,585,91,826,709,105,840,700,87
061150403021,271,123,148,275,118,157,562,250,293,359,154,170
061150403041,635,279,356,640,272,368,1121,501,580,908,392,444
061150403043,364,161,203,365,154,211,586,262,304,389,177,177
061150404002,230,104,126,231,102,129,341,153,180,288,125,143
061150404003,330,134,196,331,123,208,566,219,330,476,179,267
061150403011,371,148,223,378,148,230,440,180,243,401,154,224
061150403012,293,131,162,300,128,172,523,230,271,316,132,148
061150403042,240,107,133,240,103,137,365,161,190,374,167,175
061150403051,553,241,312,558,234,324,956,418,509,356,149,182
061150402022,405,156,249,407,149,258,661,247,382,487,172,281
061150402023,255,97,158,258,92,166,401,149,239,331,107,196
061150402012,226,89,137,227,83,144,421,162,251,374,138,216
061150402013,314,140,174,316,134,182,424,181,234,315,121,168
061150402024,151,56,95,155,56,99,215,83,126,198,70,110
061150402021,198,76,122,197,72,125,295,110,171,241,83,133
061150401001,222,83,139,228,81,147,308,112,183,223,70,137
061150401002,177,73,104,179,67,112,377,147,218,206,87,107
061150402011,436,167,269,436,153,283,664,242,400,551,192,317
061150401003,204,99,105,206,97,109,248,117,130,186,85,89
061150401004,165,78,87,167,78,89,210,98,111,149,66,73
061150401005,177,90,87,181,86,95,384,174,194,268,111,136
061150404001,241,106,135,243,94,149,353,150,188,408,184,198
061150409011,552,156,396,570,154,416,757,204,540,598,139,409
061150405001,224,98,126,224,94,130,343,133,202,277,106,151
061150405002,252,115,137,257,109,148,471,198,256,323,130,171
061150405003,172,75,97,174,73,101,304,118,180,236,104,118
061150406002,203,89,114,204,85,119,331,129,194,251,111,125
061150409012,306,100,206,307,102,205,522,167,345,444,127,281
061150406003,301,126,175,305,118,187,490,205,268,384,149,215
061150406004,190,80,110,192,74,118,251,103,135,231,86,128
061150406005,152,63,89,155,59,96,379,162,209,290,116,149
061150407022,502,213,289,507,200,307,822,335,457,625,243,325
061150407023,200,64,136,200,60,140,165,54,108,193,71,109
061150406001,321,148,173,325,138,187,624,272,327,347,141,185
061150407011,513,220,293,514,207,307,883,385,470,503,194,269
061150407014,647,263,384,655,252,403,1316,563,705,748,277,407
061150407013,466,185,281,471,178,293,811,333,452,579,191,340
061150407021,622,226,396,636,227,409,1104,438,626,664,242,379
061150407012,560,197,363,571,197,374,828,320,489,576,181,354
061150408001,602,178,424,606,176,430,1082,308,742,863,225,576
061150408002,161,47,114,162,46,116,318,93,221,248,67,168
061150408003,361,103,258,366,102,264,621,170,427,559,153,372
061150409021,2,1,1,2,1,1,2,2,0,21,8,10
061150409023,20,9,11,20,9,11,63,32,26,12,5,6
061150409024,6,3,3,6,3,3,41,20,18,7,2,3
061150410021,546,212,334,550,205,345,539,214,319,501,192,282
061150411011,519,271,248,527,266,261,548,269,262,482,200,227
061150411021,584,298,286,593,298,295,788,398,370,718,324,337
061150411013,412,177,235,418,174,244,560,231,312,566,187,331
061150411012,314,107,207,319,100,219,466,148,303,422,119,268
061150410012,512,103,409,520,99,421,630,113,505,581,105,447
061150410011,238,51,187,240,46,194,500,119,374,432,96,314
061150410023,622,163,459,632,153,479,911,235,660,721,191,488
061150410022,721,168,553,733,153,580,947,212,719,818,173,595
061150410013,711,134,577,722,123,599,904,177,710,665,118,514
061150409022,7,2,5,7,1,6,45,24,18,60,22,26
060050004012,337,161,176,348,161,187,524,226,281,419,171,220
060050005001,537,184,353,546,182,364,766,270,473,665,219,404
060050005002,543,209,334,551,202,349,583,212,356,499,169,301
060050005003,474,199,275,487,191,296,673,264,389,535,202,303
060050003041,812,313,499,828,310,518,1130,405,688,863,296,511
060050004014,516,222,294,529,216,313,514,207,292,457,174,260
060050004023,421,167,254,426,162,264,536,205,318,439,158,249
060050004021,840,324,516,855,303,552,1253,458,763,878,313,514
060050004024,549,199,350,564,191,373,705,254,427,566,176,346
060050003031,864,321,543,876,299,577,968,379,570,845,297,502
060050003012,732,211,521,745,203,542,896,243,628,788,206,531
060050003032,659,209,450,671,191,480,1035,298,710,658,185,442
060050003033,910,281,629,922,268,654,1347,405,903,926,291,570
060050002011,463,167,296,470,163,307,586,224,346,446,158,258
060050003011,316,102,214,322,98,224,555,190,344,432,128,271
060050003042,853,241,612,867,233,634,1233,326,876,980,257,659
060050002012,878,374,504,902,360,542,952,409,513,838,314,473
060050001015,357,148,209,363,143,220,424,180,239,343,139,186
060050001014,456,177,279,464,175,289,406,153,245,426,146,257
060050004022,370,138,232,379,133,246,547,204,326,436,133,272
060050001022,452,164,288,463,166,297,626,225,387,319,110,190
060050001012,604,220,384,609,220,389,712,279,420,373,137,207
060050001013,355,125,230,361,127,234,578,210,358,424,137,261
060050001011,511,188,323,517,188,329,562,226,330,357,138,203
060050001021,469,197,272,475,199,276,577,252,317,484,186,277
060050004013,839,346,493,851,332,519,987,418,549,852,319,487
060050004011,728,259,469,737,247,490,887,320,548,791,258,492
060050002013,414,168,246,424,162,262,575,229,333,480,177,270
060050002022,463,196,267,473,186,287,634,262,352,503,199,265
060050002021,557,241,316,568,226,342,531,220,304,552,210,304
060070025001,191,87,104,193,85,108,221,93,119,123,49,64
060070025002,273,125,148,277,118,159,454,190,251,341,135,180
060070025003,111,51,60,111,49,62,263,109,143,211,87,107
060070025004,401,139,262,411,134,277,509,181,317,401,139,235
060070028002,169,77,92,171,73,98,310,139,158,198,80,104
060070028003,298,142,156,298,136,162,376,178,185,356,152,178
060070028004,133,65,68,135,65,70,191,89,96,160,68,77
060070028005,192,94,98,195,90,105,212,99,106,183,77,90
060070030021,117,55,62,120,55,65,183,73,101,226,72,136
060070027001,374,126,248,379,118,261,349,119,222,269,87,167
060070027002,259,90,169,264,89,175,515,183,318,427,134,264
060070027003,228,78,150,233,71,162,326,106,214,258,76,163
060070027004,289,103,186,292,94,198,427,151,261,302,97,183
060070027005,458,179,279,463,168,295,622,232,371,482,168,283
060070028001,170,71,99,173,70,103,254,108,134,226,88,120
060070030012,144,68,76,146,67,79,245,111,128,206,89,102
060070027006,336,114,222,342,106,236,399,129,259,336,97,213
060070026021,512,162,350,517,153,364,801,272,515,581,171,381
060070030011,208,79,129,211,75,136,310,127,178,190,79,96
060070031002,354,107,247,359,104,255,603,187,399,462,134,293
060070031003,308,104,204,313,101,212,438,142,283,340,98,219
060070030013,118,61,57,118,57,61,247,127,116,188,94,81
060070030014,99,53,46,100,48,52,197,99,93,170,79,73
060070030024,159,71,88,164,69,95,282,117,155,333,107,199
060070030023,219,78,141,225,77,148,343,131,202,295,89,182
060070026022,830,270,560,842,256,586,927,329,586,767,230,501
060070026023,414,132,282,418,126,292,506,169,330,414,120,273
060070031001,574,166,408,585,149,436,755,212,526,639,165,436
060070026013,405,123,282,412,111,301,644,190,438,424,103,287
060070031004,421,140,281,426,126,300,705,214,470,491,152,305
060070030022,264,97,167,270,91,179,354,132,217,275,89,163
060070033001,729,219,510,738,194,544,972,287,667,749,208,498
060070026012,379,121,258,384,118,266,563,186,371,444,128,294
060070026011,280,74,206,284,65,219,327,95,225,323,79,224
060070032001,286,93,193,290,86,204,423,129,283,385,120,240
060070032002,462,143,319,465,127,338,534,160,369,527,156,340
060070032003,347,118,229,355,111,244,500,152,338,451,140,282
060070033003,567,164,403,571,149,422,771,224,532,652,188,421
060070024023,610,196,414,616,186,430,640,201,427,641,188,403
060070033002,319,101,218,318,94,224,460,136,313,438,129,275
060070024011,342,144,198,346,135,211,304,118,172,426,153,222
060070024012,433,182,251,432,174,258,404,166,225,476,168,260
060070024022,509,212,297,515,209,306,487,187,292,570,201,325
060070024021,248,83,165,253,81,172,316,95,216,340,106,210
060070022002,949,335,614,963,324,639,680,255,409,892,308,521
060070004032,954,540,414,967,528,439,1121,647,450,1012,537,400
060070004031,582,325,257,595,320,275,858,502,337,601,321,235
060070006012,400,257,143,403,247,156,420,270,137,401,237,131
060070005011,446,212,234,449,205,244,683,329,332,411,162,213
060070005012,571,302,269,590,299,291,724,397,307,528,263,223
060070005013,487,269,218,497,261,236,514,291,207,440,222,183
060070005014,183,131,52,187,131,56,181,99,76,328,165,136
060070005015,243,181,62,249,183,66,231,178,45,264,195,39
060070005021,340,212,128,344,199,145,471,284,173,430,236,159
060070004041,1422,648,774,1455,649,806,1675,846,782,1442,615,705
060070004042,514,230,284,527,235,292,686,358,311,531,236,253
060070004012,1230,578,652,1259,558,701,1532,775,716,1100,455,544
060070004011,292,137,155,304,138,166,957,482,450,237,100,118
060070006011,452,257,195,466,257,209,563,331,215,439,210,186
060070006013,699,419,280,718,410,308,841,536,270,691,352,266
060070010002,192,154,38,194,154,40,260,195,56,203,141,39
060070010004,166,138,28,171,138,33,264,195,54,186,125,39
060070010005,188,155,33,196,155,41,249,191,53,193,128,40
060070010006,491,396,95,501,401,100,587,441,128,542,379,99
060070006033,556,450,106,568,447,121,431,327,92,649,447,119
060070005022,208,174,34,214,175,39,203,156,40,260,193,38
060070005023,374,301,73,382,299,83,651,502,125,506,361,94
060070005024,316,265,51,323,265,58,535,422,91,387,284,60
060070011004,298,230,68,307,231,76,280,192,77,284,186,65
060070006032,243,201,42,249,201,48,252,198,43,263,189,41
060070006041,150,134,16,156,137,19,275,221,42,233,178,25
060070006043,141,125,16,145,128,17,241,192,37,197,150,21
060070006045,256,227,29,262,231,31,329,261,50,271,206,29
060070010001,306,239,67,309,237,72,373,268,86,256,174,48
060070010003,268,214,54,269,215,54,286,208,66,310,211,53
060070013001,374,283,91,379,278,101,588,419,135,387,243,91
060070013002,314,243,71,317,238,79,414,301,95,247,165,50
060070013004,249,193,56,253,190,63,389,279,87,313,211,59
060070006031,225,180,45,231,178,53,304,226,66,212,148,37
060070006044,299,217,82,303,210,93,372,265,90,265,167,64
060070006042,286,180,106,293,172,121,533,346,158,430,240,140
060070002012,295,150,145,302,145,157,435,201,223,283,135,125
060070003002,471,266,205,479,259,220,770,419,318,603,294,246
060070014001,1268,455,813,1298,434,864,1500,548,911,1186,386,716
060070014003,427,150,277,430,137,293,558,202,347,486,157,299
060070014004,770,281,489,791,269,522,1142,435,682,925,306,557
060070014002,601,262,339,617,258,359,787,377,385,701,285,362
060070016021,664,322,342,671,320,351,812,373,420,700,298,346
060070001021,593,332,261,604,323,281,692,413,257,595,313,229
060070001022,640,355,285,654,349,305,798,441,331,702,365,270
060070001023,591,315,276,607,310,297,763,422,319,620,315,255
060070001031,1082,587,495,1103,571,532,1685,939,698,938,472,396
060070001032,1084,563,521,1119,556,563,1728,934,745,1037,512,446
060070001041,865,506,359,882,490,392,857,474,362,608,315,236
060070001043,423,236,187,426,227,199,555,339,198,537,274,221
060070001044,334,197,137,340,190,150,822,464,331,579,303,223
060070009041,1319,783,536,1344,779,565,1737,1051,644,1425,812,512
060070009042,862,523,339,884,525,359,978,624,330,825,495,267
060070016023,861,473,388,874,466,408,1152,682,445,937,505,371
060070008001,585,365,220,592,361,231,514,328,177,481,286,158
060070008002,460,288,172,465,283,182,470,319,135,355,209,119
060070008003,508,314,194,519,313,206,705,468,218,607,359,190
060070008005,439,272,167,445,269,176,546,351,176,499,295,158
060070008006,335,209,126,341,207,134,396,268,118,353,209,112
060070009043,357,219,138,364,221,143,532,339,178,479,288,154
060070007001,475,327,148,481,320,161,649,444,189,512,309,145
060070007002,581,418,163,590,415,175,720,522,181,564,370,136
060070007003,786,539,247,806,542,264,946,651,271,780,514,191
060070007004,402,296,106,416,299,117,561,413,138,455,307,104
060070008004,569,388,181,581,384,197,691,460,205,541,321,159
060070002011,345,188,157,351,182,169,513,274,222,293,130,133
060070002013,299,154,145,304,148,156,422,222,187,275,117,129
060070002014,630,327,303,642,317,325,1086,573,481,732,317,344
060070002022,260,153,107,266,152,114,352,193,146,304,148,127
060070002023,314,170,144,322,168,154,390,210,172,536,243,252
060070002024,297,168,129,302,166,136,308,172,125,247,121,101
060070002021,421,252,169,428,249,179,562,315,224,424,210,171
060070003001,217,134,83,218,131,87,413,259,140,313,163,114
060070003003,214,132,82,215,129,86,223,140,75,193,101,72
060070003004,318,198,120,321,193,128,386,242,130,314,163,115
060070009044,568,287,281,575,278,297,805,448,340,624,310,277
060070001042,480,274,206,497,279,218,799,455,324,538,265,218
060070016011,599,287,312,612,286,326,775,370,389,636,292,301
060070016012,221,102,119,228,102,126,304,140,158,236,108,114
060070017041,255,84,171,254,80,174,292,94,194,279,89,181
060070016022,551,319,232,559,320,239,476,279,181,549,275,210
060070011001,152,125,27,158,128,30,316,241,58,218,150,38
060070011002,603,286,317,619,285,334,730,360,352,613,256,311
060070011003,251,187,64,257,188,69,377,274,91,261,171,64
060070011005,131,108,23,137,111,26,238,188,44,144,96,26
060070012001,422,345,77,434,343,91,479,369,97,343,229,67
060070012002,272,223,49,281,221,60,397,302,82,285,190,56
060070012003,251,164,87,258,163,95,422,265,139,264,140,94
060070012004,185,152,33,190,150,40,400,301,80,359,237,71
060070009031,358,217,141,369,210,159,500,296,184,366,194,129
060070009032,353,213,140,358,204,154,482,286,175,352,185,126
060070013003,363,196,167,369,191,178,448,257,181,359,184,140
060070009033,716,412,304,732,404,328,1055,626,395,818,443,301
060070009034,571,328,243,584,323,261,899,568,311,587,318,217
060070034001,465,132,333,469,119,350,550,183,355,396,117,255
060070035012,256,115,141,262,106,156,331,149,177,268,112,138
060070035013,219,107,112,224,103,121,297,143,150,217,107,103
060070035014,268,119,149,274,112,162,334,144,179,239,100,124
060070035022,280,129,151,284,123,161,496,226,260,382,170,188
060070035024,265,118,147,272,112,160,571,257,303,381,160,195
060070035011,421,147,274,421,132,289,523,179,327,338,103,217
060070035021,383,106,277,390,93,297,548,149,389,448,120,308
060070035023,277,140,137,275,130,145,434,212,211,415,207,179
060070036001,271,88,183,278,89,189,419,143,267,298,94,190
060070036002,322,109,213,330,111,219,450,155,286,396,136,240
060070036003,559,94,465,572,90,482,773,160,607,627,97,502
060070029001,412,156,256,418,149,269,652,227,411,562,196,328
060070029002,379,151,228,384,144,240,578,221,344,419,146,239
060070037001,413,165,248,418,153,265,590,225,346,434,156,246
060070037003,350,132,218,357,127,230,495,171,317,402,137,239
060070037004,265,100,165,270,96,174,446,156,275,323,110,189
060070034002,466,115,351,472,103,369,666,185,467,570,137,401
060070015001,473,167,306,483,157,326,725,272,434,634,219,368
060070015002,535,181,354,547,158,389,772,260,486,636,202,383
060070015003,954,355,599,973,343,630,1051,412,605,863,310,493
060070015004,352,112,240,354,104,250,464,151,296,386,124,237
060070015005,245,79,166,249,75,174,345,112,227,294,94,182
060070037002,256,75,181,256,70,186,409,125,271,281,82,176
060070009011,1329,671,658,1340,668,672,1668,933,693,1414,698,609
060070018001,721,315,406,733,305,428,244,92,144,773,295,415
060070018002,328,146,182,335,144,191,96,36,58,338,127,184
060070018004,448,200,248,458,196,262,144,53,87,548,201,297
060070018005,381,150,231,391,145,246,99,37,60,380,130,223
060070021003,322,137,185,329,132,197,108,43,61,353,131,195
060070021002,298,132,166,307,131,176,52,18,33,472,183,251
060070021004,607,281,326,618,270,348,291,110,169,562,226,288
060070021005,391,189,202,397,181,216,234,103,123,443,185,222
060070022001,653,279,374,664,266,398,174,74,96,705,270,383
060070018003,519,218,301,533,215,318,116,43,71,535,200,297
060070019001,283,123,160,289,120,169,75,27,45,299,110,168
060070019002,512,213,299,529,209,320,170,61,107,513,193,282
060070019003,351,150,201,359,147,212,184,66,112,364,135,202
060070019004,417,178,239,428,175,253,142,51,88,506,188,280
060070021001,407,208,199,414,205,209,142,58,81,476,204,241
060070020005,503,212,291,507,201,306,211,71,133,567,215,309
060070020006,309,138,171,314,136,178,85,31,51,320,125,169
060070020004,386,167,219,393,161,232,109,40,67,476,183,255
060070023002,508,210,298,518,199,319,213,73,133,679,251,380
060070023003,343,151,192,351,145,206,161,58,95,386,150,199
060070023004,466,206,260,477,203,274,105,39,65,457,179,237
060070020001,543,217,326,551,204,347,136,45,88,491,175,279
060070020002,354,144,210,360,135,225,96,32,63,306,109,174
060070023001,722,269,453,731,253,478,227,79,145,873,300,520
060070022003,419,180,239,422,168,254,90,37,51,409,156,218
060070022004,580,240,340,590,227,363,324,120,193,658,242,364
060070020003,361,139,222,365,132,233,139,44,93,365,130,208
060070017024,418,171,247,425,163,262,573,226,330,512,170,304
060070017043,520,217,303,525,205,320,898,344,522,657,225,383
060070017022,755,335,420,763,317,446,207,78,118,1056,410,578
060070017023,969,396,573,977,374,603,1041,414,595,827,299,471
060070017031,511,221,290,515,207,308,221,97,120,474,182,261
060070017032,715,299,416,725,279,446,633,275,337,745,282,409
060070017042,394,156,238,400,147,253,514,178,316,437,138,269
060070017021,397,177,220,401,167,234,110,41,63,469,186,250
060070023005,472,164,308,470,162,308,618,192,405,565,185,336
060990021001,205,155,50,208,145,63,325,191,124,236,174,50
060990021002,198,146,52,201,142,59,289,172,110,262,162,77
060990023041,74,60,14,75,57,18,134,96,32,100,72,20
060990023042,257,223,34,257,208,49,433,338,86,284,223,43
060990023021,279,230,49,281,216,65,327,236,77,273,204,53
060990023022,263,215,48,264,203,61,344,253,85,348,257,69
060990027022,317,246,71,323,240,83,544,331,196,313,233,62
060990025032,219,144,75,226,138,88,286,177,102,246,152,83
060990026023,281,170,111,282,165,117,385,217,158,323,181,120
060990025061,191,162,29,191,152,39,268,199,67,269,201,50
060990023033,400,330,70,404,315,89,586,426,146,501,374,99
060990024021,284,222,62,283,208,75,453,324,117,391,275,89
060990024022,135,104,31,137,99,38,242,115,122,137,102,30
060990023031,208,173,35,208,164,44,371,269,94,312,242,54
060990024023,243,187,56,244,174,70,441,208,219,242,177,53
060990031001,220,69,151,223,64,159,154,76,78,228,76,140
060990031003,438,163,275,447,155,292,515,232,279,496,191,287
060990040003,537,119,418,554,112,442,663,207,446,629,180,423
060990031002,189,111,78,188,113,75,263,155,101,220,126,78
060990026041,299,191,108,303,185,118,492,287,196,371,182,167
060990026042,223,144,79,226,139,87,398,231,158,356,174,160
060990027021,166,118,48,167,117,50,475,273,189,341,223,102
060990027023,263,164,99,270,157,113,415,243,162,343,207,120
060990027024,341,214,127,342,205,137,354,208,140,299,183,101
060990027025,293,185,108,297,181,116,366,213,146,288,182,96
060990026051,502,283,219,507,277,230,785,470,299,576,303,241
060990026052,541,307,234,549,299,250,627,357,258,657,380,239
060990030032,542,326,216,546,315,231,761,454,291,560,304,223
060990030042,317,180,137,321,173,148,456,275,174,352,205,125
060990025031,308,196,112,313,188,125,520,293,212,393,222,144
060990025033,310,202,108,312,194,118,494,280,199,407,237,140
060990025041,646,431,215,649,412,237,804,458,320,701,428,229
060990026021,225,144,81,224,134,90,341,197,143,219,116,94
060990025042,486,334,152,486,320,166,604,350,240,579,367,179
060990026031,236,117,119,238,113,125,297,170,116,186,95,76
060990026043,296,204,92,300,197,103,649,376,258,468,245,195
060990030021,332,119,213,336,114,222,474,206,263,367,156,193
060990026022,585,353,232,591,342,249,863,484,353,666,373,247
060990027011,536,313,223,540,308,232,762,410,341,675,375,263
060990020023,182,96,86,183,90,93,338,167,157,284,143,120
060990030034,814,562,252,827,550,277,1087,620,453,878,585,248
060990026032,767,345,422,778,332,446,687,400,275,567,278,253
060990025062,3,2,1,3,2,1,117,79,34,125,88,30
060990025051,490,375,115,491,366,125,827,566,242,544,387,131
060990025052,523,402,121,525,392,133,732,499,212,538,379,128
060990027012,821,459,362,831,441,390,998,529,432,781,413,333
060990030033,230,166,64,236,164,72,396,241,152,280,196,68
060990030031,550,396,154,558,385,173,816,489,309,594,371,188
060990036031,191,56,135,198,53,145,229,70,159,183,48,129
060990036032,145,45,100,145,38,107,274,77,197,210,52,149
060990036033,379,146,233,385,142,243,385,127,256,291,108,171
060990037003,278,189,89,286,183,103,471,272,180,351,236,96
060990037001,239,93,146,245,88,157,363,145,208,280,86,179
060990037002,324,115,209,332,107,225,411,115,287,376,111,241
060990001021,472,137,335,480,128,352,312,83,225,372,98,259
060990003011,338,196,142,341,188,153,499,260,235,394,199,174
060990004051,518,162,356,525,147,378,822,292,517,543,147,368
060990028024,479,145,334,486,135,351,643,203,432,590,166,401
060990020021,525,284,241,529,270,259,630,330,292,594,300,262
060990028032,670,303,367,681,298,383,817,385,414,703,287,373
060990030041,279,116,163,286,116,170,376,138,230,322,110,194
060990030022,382,215,167,386,206,180,539,272,250,475,185,264
060990030023,461,269,192,467,261,206,606,349,251,698,280,379
060990030024,454,267,187,461,257,204,832,477,321,581,229,314
060990004044,319,156,163,327,153,174,420,198,212,371,167,184
060990004043,934,452,482,947,442,505,1313,620,661,974,439,482
060990005011,730,233,497,742,237,505,890,304,570,650,202,421
060990005012,506,189,317,515,191,324,694,248,434,535,184,330
060990005053,472,243,229,479,242,237,758,372,375,551,260,258
060990005063,377,179,198,381,177,204,497,239,243,442,199,217
060990005064,314,136,178,320,135,185,329,163,157,289,114,158
060990009081,575,300,275,587,295,292,576,296,269,511,241,241
060990009082,620,303,317,632,298,334,753,405,328,880,399,428
060990032013,274,165,109,277,161,116,327,188,128,230,128,90
060990032031,617,388,229,628,388,240,765,465,272,681,405,237
060990033002,550,235,315,557,225,332,928,432,472,592,302,264
060990034001,250,106,144,249,98,151,331,144,184,262,109,146
060990033003,225,108,117,228,103,125,246,118,127,227,85,135
060990033004,292,121,171,293,115,178,365,165,194,338,112,204
060990034002,141,58,83,144,56,88,215,70,140,179,60,110
060990035014,690,391,299,698,376,322,949,533,398,812,418,341
060990035012,324,193,131,329,185,144,534,298,223,434,241,161
060990035011,212,112,100,212,107,105,309,170,132,235,119,101
060990035023,368,219,149,374,212,162,622,343,274,485,280,178
060990035022,169,97,72,173,95,78,301,162,129,202,115,77
060990035021,484,291,193,497,285,212,771,433,322,541,308,194
060990036034,376,118,258,391,115,276,565,170,385,409,129,266
060990032011,373,254,119,382,246,136,616,386,214,376,247,107
060990032052,768,491,277,776,480,296,959,592,340,853,516,272
060990033001,274,126,148,279,119,160,418,187,220,234,140,88
060990029011,390,113,277,399,109,290,465,125,336,437,107,309
060990029013,339,100,239,343,96,247,433,121,311,312,84,212
060990029014,257,75,182,261,72,189,414,111,293,245,89,146
060990036071,455,143,312,466,143,323,621,186,424,470,140,308
060990036082,294,91,203,300,91,209,422,127,288,326,96,213
060990036083,858,325,533,875,318,557,1134,416,702,1069,329,683
060990036072,435,138,297,447,135,312,485,171,307,437,141,275
060990029012,364,107,257,366,101,265,381,95,280,308,86,205
060990029015,514,146,368,521,142,379,586,148,425,396,161,217
060990029041,933,341,592,953,335,618,1009,364,626,712,263,417
060990029031,899,355,544,909,340,569,1273,474,771,1044,380,613
060990029033,254,79,175,259,76,183,452,123,320,272,109,151
060990036084,837,242,595,846,233,613,1079,323,734,828,237,548
060990036081,569,218,351,589,220,369,602,230,364,569,189,347
060990039071,911,332,579,927,319,608,904,344,539,962,321,590
060990039044,360,146,214,368,141,227,587,251,323,385,157,200
060990039053,591,253,338,606,246,360,648,283,354,695,250,400
060990039054,266,114,152,271,110,161,291,130,145,200,84,99
060990020022,183,100,83,188,95,93,299,156,135,246,128,107
060990028023,538,166,372,541,157,384,730,218,497,532,152,357
060990040001,373,69,304,386,67,319,435,115,313,409,80,306
060770055031,271,90,181,270,84,186,324,115,203,285,101,171
060990005131,733,377,356,746,368,378,999,504,470,818,387,374
060990006011,307,120,187,308,115,193,458,200,247,393,143,228
060990006012,696,379,317,705,368,337,878,443,414,741,352,349
060990006013,567,279,288,584,273,311,711,360,338,580,299,249
060990029034,394,193,201,401,175,226,582,216,354,417,153,244
060990029032,288,133,155,295,125,170,566,212,347,470,171,280
060990001011,787,216,571,805,211,594,1079,299,760,704,182,488
060990001012,500,131,369,508,131,377,697,191,501,584,144,418
060990001014,334,84,250,347,89,258,501,131,353,514,134,353
060990002024,1232,410,822,1253,391,862,1895,609,1255,965,346,566
060990001022,1154,319,835,1172,305,867,1313,371,917,926,241,641
060990001023,465,129,336,468,123,345,672,178,482,550,145,379
060990002012,617,224,393,623,215,408,760,253,489,612,208,370
060990002015,452,183,269,465,180,285,660,230,422,551,188,338
060990002023,667,236,431,677,225,452,982,334,624,652,229,383
060990002051,369,150,219,376,142,234,477,179,287,491,169,295
060990002052,885,361,524,901,348,553,1461,484,940,992,341,585
060990002043,823,294,529,838,286,552,1093,364,711,757,254,458
060990028013,355,87,268,363,85,278,491,119,365,405,95,290
060990020042,246,162,84,246,154,92,304,185,112,273,148,101
060990020043,453,299,154,453,280,173,707,425,260,581,311,217
060990009051,607,310,297,615,302,313,839,418,389,813,355,401
060990009052,870,445,425,883,437,446,1243,579,630,978,427,491
060990009053,778,396,382,792,391,401,904,446,445,813,367,397
060990009063,868,399,469,879,387,492,1071,508,533,767,349,370
060990020041,425,218,207,434,215,219,483,285,184,366,206,136
060990020044,413,212,201,421,209,212,545,333,194,457,258,168
060990023032,206,171,35,207,163,44,269,193,68,227,175,39
060990016012,305,229,76,311,224,87,408,264,133,370,265,86
060990016013,209,171,38,209,167,42,320,250,60,275,221,38
060990016041,198,163,35,197,157,40,263,204,48,234,186,33
060990016043,165,142,23,165,136,29,254,195,46,201,161,29
060990022004,212,168,44,210,156,54,307,219,80,247,187,45
060990022001,279,233,46,283,221,62,371,264,98,268,225,38
060990022002,322,262,60,320,244,76,426,307,107,365,286,57
060990016031,230,153,77,233,149,84,221,175,44,306,184,97
060990022003,83,67,16,85,64,21,140,101,36,90,69,15
060990015001,465,314,151,470,308,162,577,385,175,566,356,184
060990016011,220,181,39,222,178,44,304,224,70,241,182,43
060990017001,220,183,37,224,181,43,482,342,140,300,236,44
060990017002,100,84,16,102,83,19,186,134,52,120,95,15
060990015002,386,275,111,391,271,120,484,334,134,452,300,133
060990015003,412,293,119,419,289,130,518,351,146,515,339,151
060990014001,551,316,235,563,315,248,831,447,353,672,346,278
060990014002,349,201,148,353,198,155,456,270,174,391,229,133
060990014003,151,87,64,155,87,68,198,117,75,114,67,40
060990014004,547,316,231,555,315,240,801,440,347,627,328,265
060990014005,158,91,67,161,91,70,313,170,133,260,133,110
060990008051,515,284,231,516,273,243,675,354,304,552,266,244
060990008054,442,245,197,448,237,211,662,352,295,529,256,231
060990008031,289,170,119,294,168,126,371,225,137,317,179,111
060990008033,413,242,171,417,237,180,550,337,203,449,248,174
060990008052,459,268,191,466,264,202,751,397,337,561,296,230
060990008053,276,161,115,278,158,120,382,204,171,238,136,84
060990005052,573,300,273,585,301,284,806,381,407,712,359,311
060990008061,723,387,336,740,386,354,931,450,463,734,369,325
060990008062,660,353,307,675,353,322,816,427,364,757,376,335
060990019001,838,457,381,856,454,402,910,471,398,837,416,364
060990019002,279,153,126,284,152,132,388,206,174,309,154,135
060990019003,396,215,181,401,215,186,492,262,220,473,238,207
060990019004,271,148,123,276,148,128,397,206,174,358,181,156
060990019005,310,170,140,314,169,145,372,199,168,367,181,160
060990010012,577,282,295,587,279,308,881,447,416,583,271,277
060990010023,259,138,121,265,138,127,343,175,160,272,142,109
060990018001,213,144,69,219,142,77,295,182,106,193,111,62
060990018002,257,170,87,258,166,92,418,261,149,263,158,87
060990018003,0,0,0,0,0,0,0,0,0,92,54,30
060990012001,321,184,137,327,185,142,336,175,160,263,138,108
060990012002,471,286,185,483,288,195,581,298,270,429,221,175
060990012003,663,406,257,681,410,271,860,522,320,800,428,304
060990013002,265,161,104,275,164,111,338,200,133,293,155,114
060990013004,646,372,274,657,371,286,807,442,345,671,349,270
060990013006,370,226,144,384,229,155,396,219,171,412,222,155
060990010011,568,282,286,580,280,300,644,323,293,622,282,296
060990010013,273,143,130,277,141,136,375,192,172,307,144,144
060990010021,344,180,164,351,179,172,456,231,208,348,175,146
060990010022,478,251,227,486,248,238,619,316,286,477,246,192
060990011001,344,181,163,348,177,171,463,232,211,336,170,141
060990006021,331,194,137,335,191,144,449,207,237,414,201,190
060990006022,585,329,256,594,321,273,843,428,397,614,329,255
060990011002,274,143,131,279,145,134,539,274,248,433,219,181
060990011003,321,172,149,328,172,156,396,203,183,321,161,133
060990011004,320,172,148,331,172,159,423,216,196,317,160,136
060990013001,373,200,173,380,199,181,608,329,259,491,220,241
060990013005,432,233,199,441,231,210,502,274,220,440,197,219
060990013003,456,247,209,462,247,215,681,372,294,531,273,214
060990008013,363,172,191,370,171,199,391,183,202,366,170,172
060990008014,596,289,307,607,288,319,799,394,384,763,357,357
060990008015,581,281,300,592,281,311,689,340,330,584,273,274
060990009073,446,232,214,459,227,232,558,265,284,428,191,205
060990009091,614,319,295,630,311,319,954,452,485,615,285,283
060990009092,577,300,277,590,290,300,852,404,433,663,297,315
060990009093,285,148,137,291,143,148,472,223,237,326,154,147
060990008011,587,277,310,597,271,326,781,363,399,586,246,304
060990008012,633,298,335,643,292,351,786,369,397,654,275,339
060990009071,585,252,333,595,248,347,555,264,281,513,224,263
060990009072,523,225,298,531,221,310,505,241,257,456,199,234
060990010014,462,217,245,469,215,254,558,286,263,549,250,274
060990010015,516,242,274,523,240,283,695,354,321,549,254,259
060990009101,464,255,209,474,249,225,765,383,364,538,250,251
060990009102,442,242,200,451,237,214,749,404,321,628,308,269
060990009103,261,142,119,261,138,123,357,194,153,319,157,136
060990009104,393,217,176,401,211,190,636,320,302,465,217,218
060990004032,834,378,456,846,387,459,1068,486,560,805,343,400
060990004033,657,304,353,667,311,356,857,382,455,612,271,307
060990004031,488,226,262,496,231,265,634,324,302,574,255,288
060990016032,257,215,42,260,207,53,312,237,57,307,227,56
060990016034,291,197,94,296,192,104,384,236,136,333,208,105
060990016042,173,151,22,175,145,30,245,191,44,224,176,33
060990008032,372,200,172,376,192,184,515,314,190,407,230,143
060990008071,355,193,162,359,184,175,595,294,288,399,191,183
060990008072,644,349,295,647,328,319,1193,586,581,812,389,371
060990009083,591,325,266,598,313,285,732,373,340,724,333,353
060990009141,647,350,297,658,342,316,873,457,402,738,362,337
060990009143,592,315,277,603,311,292,1128,590,515,600,317,259
060990024011,272,226,46,271,213,58,341,264,67,302,237,49
060990024012,365,303,62,366,287,79,482,372,95,422,331,68
060990009062,861,415,446,874,402,472,1331,615,673,917,406,448
060990009061,632,305,327,643,297,346,766,350,389,847,374,416
060990028031,506,234,272,511,229,282,543,272,253,680,286,348
060990005031,461,255,206,469,255,214,814,424,367,597,310,257
060990005032,600,333,267,614,334,280,860,447,389,662,343,284
060990005033,365,202,163,371,202,169,545,285,248,391,203,168
060990009151,971,458,513,979,449,530,1304,608,672,970,438,481
060990009133,868,417,451,881,402,479,1307,624,662,968,431,471
060990009134,787,375,412,797,362,435,1357,631,693,892,397,432
060990005113,749,343,406,760,337,423,1040,506,522,707,318,349
060990005111,810,384,426,827,377,450,1123,567,536,917,422,444
060990005121,740,340,400,757,333,424,767,381,372,689,322,334
060990005122,617,283,334,633,278,355,672,330,327,538,246,261
060990004041,394,194,200,399,190,209,614,292,312,419,191,203
060990004042,439,218,221,446,211,235,539,254,272,489,226,240
060990005061,403,191,212,411,191,220,586,287,289,495,211,253
060990005062,397,189,208,403,187,216,550,267,269,467,212,226
060990005112,554,295,259,562,294,268,844,424,401,778,357,375
060990005051,493,262,231,501,262,239,673,340,314,571,288,249
060990020051,487,301,186,496,294,202,796,434,337,639,350,242
060990020061,601,373,228,612,365,247,888,481,376,706,394,265
060990020062,602,368,234,607,358,249,892,491,380,730,405,275
060990020052,410,266,144,411,253,158,696,380,296,446,266,154
060990009111,634,317,317,645,316,329,809,405,384,632,280,316
060990009112,595,297,298,601,296,305,869,436,411,739,326,368
060990009131,428,214,214,434,214,220,515,271,237,414,182,210
060990004052,203,94,109,206,91,115,280,117,159,210,94,108
060990009152,677,317,360,688,314,374,1060,493,547,767,346,382
060990009113,393,207,186,401,206,195,594,309,270,471,204,239
060990009132,366,193,173,369,191,178,446,235,206,409,178,206
060990009142,613,323,290,621,321,300,1122,587,513,751,409,309
060990035013,442,253,189,447,244,203,642,357,267,359,186,151
060990001013,488,125,363,495,126,369,675,184,487,598,140,429
060990002013,289,114,175,294,110,184,416,160,254,398,137,242
060990002014,216,82,134,217,77,140,320,107,204,284,97,170
060990002021,339,147,192,346,141,205,496,216,265,563,202,328
060990002022,175,75,100,178,73,105,327,140,174,359,128,209
060990002041,836,308,528,853,302,551,1175,395,751,838,282,500
060990002042,244,89,155,248,86,162,286,122,159,328,112,196
060990002011,699,232,467,709,220,489,937,314,600,746,253,447
060990015004,379,177,202,388,170,218,571,175,379,381,161,199
060990016033,159,105,54,162,102,60,283,123,150,166,103,57
060990032032,894,621,273,907,611,296,1205,815,372,825,542,241
060990032051,395,259,136,401,258,143,582,363,199,495,304,158
060990032012,333,226,107,338,219,119,669,423,232,464,309,125
060990032014,203,137,66,206,132,74,283,179,98,165,111,45
060990032041,323,214,109,331,207,124,372,234,134,283,184,84
060990032042,253,172,81,256,166,90,446,280,163,328,211,102
060990032062,697,487,210,703,469,234,1067,717,323,848,543,257
060990032061,582,426,156,588,413,175,1018,720,275,695,478,182
060990003012,160,88,72,160,82,78,231,128,103,194,100,92
060990003021,130,63,67,132,59,73,315,168,137,262,130,118
060990003022,289,141,148,296,135,161,381,179,191,269,133,122
060990003023,342,166,176,343,155,188,413,216,188,329,163,147
060990003031,634,373,261,648,357,291,941,497,425,670,334,300
060990004062,935,499,436,955,482,473,1096,575,488,911,449,409
060990003033,548,349,199,553,331,222,843,453,373,754,376,336
060990003042,373,229,144,380,222,158,626,313,301,466,247,192
060990003041,249,153,96,248,145,103,465,250,201,278,165,96
060990003043,422,261,161,422,247,175,774,416,337,508,303,176
060990003032,468,226,242,471,224,247,605,285,307,498,224,246
060990004061,956,478,478,969,474,495,1519,722,759,1105,499,542
060990004071,339,142,197,344,144,200,399,174,215,297,124,155
060990004072,784,343,441,796,346,450,1149,504,620,809,354,413
060990005013,688,372,316,702,354,348,1129,601,501,714,365,298
060990005014,824,447,377,836,421,415,1103,587,490,953,430,443
060990005141,644,367,277,658,360,298,869,476,361,723,379,296
060990005132,856,479,377,868,463,405,1026,539,457,835,433,343
060990005142,251,146,105,257,140,117,526,300,219,400,220,162
060990040002,473,177,296,482,173,309,654,262,383,496,173,292
060770051063,210,49,161,213,47,166,356,87,263,256,56,185
060990038021,190,114,76,192,114,78,264,162,98,254,145,85
060990038024,209,143,66,212,138,74,383,230,141,389,225,131
060990038032,289,186,103,296,182,114,510,282,215,402,202,174
060990038041,256,157,99,260,157,103,293,178,111,325,176,135
060990038042,229,138,91,235,141,94,267,161,97,270,142,111
060990038044,276,169,107,281,169,112,453,271,165,469,248,193
060990037004,242,164,78,245,159,86,306,171,127,289,179,94
060990038022,157,113,44,162,108,54,273,164,101,279,161,93
060990038023,356,245,111,360,235,125,500,285,210,394,230,135
060990038031,283,200,83,291,193,98,396,231,150,323,184,111
060990039041,438,188,250,450,183,267,499,233,256,242,139,94
060990039042,264,114,150,268,110,158,396,182,202,183,110,66
060990039043,415,179,236,424,173,251,651,284,354,295,170,101
060990039051,327,140,187,335,136,199,266,127,134,367,129,214
060990039052,610,261,349,626,256,370,509,245,262,629,232,358
060990039061,283,121,162,289,118,171,528,201,316,248,111,118
060990039062,567,253,314,581,245,336,1022,479,516,826,373,386
060990039063,374,161,213,383,156,227,600,278,303,442,219,185
060990039073,568,244,324,577,236,341,747,285,446,558,212,311
060990039074,1002,430,572,1022,417,605,1177,461,686,1014,350,605
060990039081,289,146,143,293,142,151,473,233,227,339,162,150
060990036102,676,364,312,696,363,333,1221,535,662,658,336,282
060990036101,752,391,361,774,387,387,1006,455,539,765,377,352
060990036123,607,315,292,626,313,313,928,468,447,683,351,298
060990036121,828,429,399,854,427,427,1264,633,612,924,467,403
060990039082,289,152,137,295,150,145,534,264,254,408,186,191
060990039091,596,312,284,609,308,301,783,388,370,605,276,283
060990039092,509,268,241,519,264,255,610,301,291,523,238,245
060990039093,643,339,304,656,332,324,931,463,447,562,257,266
060990036092,656,303,353,675,297,378,631,271,346,493,222,241
060990036091,691,321,370,712,314,398,999,425,553,860,390,420
060990036111,764,354,410,786,346,440,1051,452,581,834,378,406
060990036112,610,282,328,628,276,352,784,336,434,700,318,342
060990039072,827,355,472,850,349,501,1313,498,782,924,374,488
060990039094,334,154,180,344,151,193,598,226,354,392,178,182
060990038043,776,437,339,789,426,363,1051,538,489,613,325,251
060990038051,769,431,338,778,420,358,1283,638,618,912,486,354
060990036122,946,535,411,970,531,439,1408,711,673,1138,572,494
060990028011,870,306,564,879,293,586,1039,391,623,756,278,433
060990028012,464,207,257,467,197,270,789,300,476,626,229,368
060990028021,365,162,203,364,152,212,472,179,282,385,138,232
060990028022,603,263,340,613,251,362,1045,383,633,848,299,501
060630003004,525,130,395,527,118,409,667,166,489,545,131,402
060630003003,464,171,293,481,171,310,642,244,384,537,185,319
060630002011,634,248,386,643,233,410,631,270,352,554,209,321
060630002021,314,137,177,319,135,184,385,192,181,294,132,144
060630002022,262,120,142,270,122,148,320,132,181,256,98,135
060630001005,387,173,214,394,166,228,371,169,195,335,129,178
060630001006,383,175,208,392,176,216,402,210,179,414,184,194
060630004002,358,162,196,372,160,212,474,212,247,426,171,219
060630004001,479,193,286,494,184,310,432,172,251,377,144,204
060630005022,263,77,186,268,76,192,232,71,160,203,58,142
060630003002,397,176,221,404,170,234,539,237,285,486,195,251
060630003001,353,121,232,364,118,246,451,164,273,389,117,250
060630002012,533,209,324,536,197,339,703,308,385,595,225,342
060630001001,492,261,231,497,251,246,459,244,202,439,220,174
060630001003,332,144,188,335,135,200,352,156,185,327,131,166
060630001004,615,242,373,631,236,395,963,411,529,818,313,434
060630001002,286,175,111,295,182,113,537,325,201,290,163,110
060630004003,386,163,223,390,148,242,594,230,344,469,173,247
060630005023,443,125,318,449,123,326,579,182,390,494,141,335
060630005011,285,76,209,292,81,211,368,110,250,298,82,199
060630005012,585,170,415,592,172,420,857,262,582,689,187,469
060630005021,293,86,207,295,79,216,298,94,200,270,71,185
061070015021,725,215,510,736,223,513,922,284,619,709,204,474
061070015022,209,70,139,210,72,138,322,111,210,277,92,170
061070015023,368,118,250,367,119,248,701,245,455,570,172,369
061070015011,649,194,455,657,200,457,889,292,582,649,189,417
061070015013,481,160,321,484,168,316,627,197,410,530,151,343
061070015012,437,151,286,440,157,283,604,203,384,547,177,332
061070015024,291,89,202,292,89,203,431,138,286,310,98,193
061070026012,217,153,64,221,149,72,425,275,138,485,338,122
061070026011,329,219,110,334,213,121,487,312,165,309,211,81
061070026021,254,165,89,260,153,107,387,241,140,324,187,118
061070026022,206,144,62,210,139,71,272,182,85,173,124,40
061070025004,217,113,104,223,110,113,350,200,142,223,108,102
061070026023,220,150,70,225,146,79,234,157,77,237,162,64
061070026024,122,85,37,122,82,40,237,155,78,166,116,39
061070028001,241,158,83,244,153,91,398,252,134,298,195,87
061070028002,166,107,59,171,103,68,372,217,138,201,128,58
061070017051,452,175,277,458,181,277,602,244,344,581,197,349
061070017061,889,346,543,897,352,545,1175,474,672,646,230,384
061070017062,458,169,289,463,172,291,1171,456,691,802,284,476
061070013061,468,212,256,479,211,268,655,316,323,532,237,262
061070013062,256,108,148,262,109,153,415,200,204,323,141,162
061070017034,695,263,432,704,266,438,1074,419,636,657,235,377
061070017033,615,244,371,621,247,374,922,374,528,745,263,439
061070017031,727,284,443,734,290,444,822,334,470,666,242,383
061070017032,764,275,489,775,280,495,740,302,424,896,300,542
061070017052,353,125,228,356,128,228,743,299,430,315,111,185
061070017013,377,151,226,378,153,225,704,286,406,523,188,294
061070017015,487,194,293,494,201,293,674,273,387,501,187,290
061070013051,90,50,40,93,49,44,125,77,45,90,54,29
061070013052,375,186,189,382,183,199,674,323,331,398,169,195
061070013063,591,278,313,596,270,326,754,348,389,614,268,307
061070013041,877,264,613,887,269,618,1211,419,768,945,274,624
061070013042,247,124,123,250,121,129,531,255,259,329,147,163
061070013033,496,264,232,502,255,247,599,285,291,547,239,274
061070013032,262,152,110,264,145,119,505,241,247,330,149,162
061070016011,231,161,70,234,159,75,328,204,115,238,157,68
061070016012,183,127,56,184,125,59,278,173,96,231,151,65
061070016013,119,82,37,121,81,40,284,177,98,201,131,57
061070016014,182,125,57,183,124,59,229,145,82,187,120,53
061070016022,357,247,110,360,248,112,557,350,190,357,234,99
061070016023,403,159,244,408,158,250,547,219,312,438,167,242
061070014006,252,175,77,254,176,78,411,258,138,289,189,87
061070001021,370,180,190,376,188,188,401,200,191,400,167,214
061070001011,787,280,507,794,291,503,927,309,601,760,264,459
061070001012,651,328,323,657,334,323,824,434,372,715,325,339
061070014001,265,75,190,266,75,191,278,90,184,256,98,152
061070014002,312,70,242,318,70,248,359,91,260,290,62,214
061070014003,316,76,240,319,76,243,330,88,236,363,79,268
061070014004,224,50,174,225,50,175,338,88,243,252,77,165
061070014005,163,44,119,165,44,121,268,81,180,214,53,147
061070016021,285,70,215,287,69,218,458,120,332,487,118,352
061070024023,534,139,395,543,137,406,700,221,468,403,98,292
061070020111,363,166,197,372,164,208,645,275,362,573,217,328
061070020112,593,209,384,595,213,382,707,264,433,406,138,252
061070025001,180,62,118,184,62,122,230,72,157,180,63,114
061070033022,211,41,170,216,38,178,202,52,148,167,45,116
061070024022,355,73,282,358,72,286,486,134,337,400,90,293
061070025002,332,123,209,334,118,216,411,164,241,285,117,165
061070032021,122,77,45,120,73,47,220,145,72,177,115,51
061070032022,65,46,19,67,43,24,114,83,29,76,53,19
061070025003,101,46,55,104,47,57,209,114,90,170,84,78
061070027021,550,131,419,556,136,420,634,170,453,471,106,344
061070033011,424,159,265,418,154,264,628,240,376,395,162,218
061070033012,103,64,39,103,59,44,201,103,94,213,96,106
061070033013,233,117,116,235,114,121,374,194,172,362,165,175
061070033023,423,107,316,422,97,325,402,142,254,312,110,194
061070033021,189,83,106,184,87,97,292,132,149,247,100,133
061070022024,234,152,82,238,141,97,392,231,152,267,148,103
061070022031,259,169,90,261,157,104,415,244,161,309,174,119
061070022032,286,183,103,289,169,120,444,261,176,381,212,148
061070022033,245,161,84,249,149,100,351,210,137,202,120,73
061070022034,28,18,10,27,17,10,221,131,84,26,17,9
061070030021,221,114,107,222,107,115,300,175,114,259,123,118
061070030011,135,83,52,139,82,57,227,152,68,228,128,91
061070030022,236,165,71,235,153,82,377,233,132,295,194,80
061070030012,141,97,44,140,91,49,290,190,98,181,113,59
061070030013,192,135,57,191,129,62,297,188,104,227,159,59
061070022021,168,107,61,171,99,72,327,200,124,304,162,134
061070022022,93,59,34,94,55,39,195,117,78,137,76,59
061070022023,179,113,66,188,112,76,388,228,154,280,146,128
061070022044,141,88,53,139,83,56,267,150,102,238,113,101
061070022041,318,203,115,321,196,125,461,259,177,382,209,140
061070022042,269,172,97,269,163,106,383,215,148,316,177,114
061070022043,122,80,42,118,72,46,228,134,89,167,98,64
061070024032,801,334,467,807,328,479,1279,464,791,601,214,351
061070029011,275,127,148,272,119,153,489,244,226,359,201,137
061070029012,276,144,132,278,134,144,397,256,139,280,175,99
061070029033,135,66,69,141,65,76,205,126,69,174,79,75
061070029034,370,179,191,374,169,205,436,185,247,475,183,272
061070029043,314,143,171,314,138,176,426,173,245,318,117,180
061070029041,364,182,182,372,177,195,548,223,312,474,188,253
061070029042,392,186,206,393,178,215,601,247,346,379,231,123
061070024021,361,140,221,366,139,227,618,229,379,468,154,288
061070023021,303,109,194,303,107,196,573,217,343,319,120,179
061070023022,678,234,444,686,232,454,909,336,560,708,249,421
061070023034,389,132,257,395,129,266,623,198,420,404,136,246
061070023035,223,87,136,225,84,141,237,92,143,258,90,154
061070023041,157,64,93,157,59,98,429,137,286,167,81,72
061070023042,230,89,141,234,86,148,228,91,132,259,89,156
061070029032,271,106,165,274,101,173,444,173,256,490,171,294
061070021002,356,119,237,356,115,241,409,139,265,337,103,217
061070023031,421,112,309,428,116,312,471,151,311,519,135,366
061070023032,887,235,652,896,239,657,1004,321,668,852,245,578
061070023033,376,115,261,386,116,270,539,171,359,312,117,173
061070024012,919,303,616,933,303,630,1014,365,630,674,209,437
061070024011,490,161,329,496,159,337,1018,365,633,897,281,576
061070023023,344,115,229,347,116,231,561,201,350,408,130,255
061070029031,456,151,305,463,154,309,644,230,404,794,260,501
061070024031,831,340,491,839,335,504,1670,590,1039,659,217,414
061070031002,259,109,150,259,106,153,652,208,421,422,147,248
061070031003,122,38,84,123,38,85,187,55,132,145,42,98
061070032011,275,152,123,279,158,121,387,218,162,369,231,117
061070044012,256,206,50,259,199,60,460,350,91,268,207,52
061070044011,118,96,22,122,93,29,228,162,57,156,122,29
061070044021,63,54,9,68,52,16,222,175,43,163,138,21
061070044022,66,54,12,65,50,15,183,133,43,126,100,19
061070044023,111,88,23,112,84,28,243,182,56,163,135,25
061070020103,501,187,314,510,189,321,827,299,512,680,212,438
061070021001,281,68,213,284,66,218,384,103,277,289,82,199
061070024013,168,46,122,167,44,123,314,110,200,111,38,67
061070031001,155,43,112,156,42,114,209,61,148,160,52,103
061070032012,123,27,96,128,26,102,164,36,125,115,26,88
061070032013,128,41,87,128,38,90,150,39,111,103,32,69
061070043011,92,43,49,89,42,47,72,44,28,67,37,29
061070042004,167,56,111,172,55,117,179,52,127,155,47,104
061070043021,134,66,68,138,70,68,216,121,85,177,89,82
061070042001,161,81,80,163,74,89,212,91,121,168,83,82
061070043022,63,33,30,64,30,34,57,30,27,53,34,19
061070034012,144,49,95,145,51,94,248,91,155,137,55,77
061070042002,108,46,62,110,44,66,166,91,75,135,58,70
061070042003,185,79,106,183,74,109,272,128,139,214,92,109
061070042005,137,61,76,137,57,80,259,137,113,230,98,114
061070019022,515,206,309,520,206,314,423,165,251,366,127,213
061070020102,288,132,156,293,131,162,442,190,242,425,159,241
061070020101,747,304,443,750,293,457,1275,526,720,910,352,510
061070018001,219,96,123,219,96,123,252,129,121,188,83,99
061070018002,540,233,307,543,235,308,613,295,302,523,200,284
061070018003,332,151,181,335,151,184,282,144,137,196,86,101
061070018004,362,167,195,366,167,199,603,289,292,428,172,226
061070019011,400,184,216,403,184,219,645,251,375,497,166,298
061070019024,332,131,201,335,133,202,531,207,314,406,137,243
061070020021,304,132,172,310,132,178,386,168,208,303,114,169
061070020022,378,163,215,384,165,219,649,269,361,541,205,301
061070020023,459,198,261,468,200,268,513,213,293,401,153,226
061070020024,401,171,230,406,172,234,522,237,277,427,161,241
061070020091,472,184,288,478,191,287,720,293,410,462,185,251
061070020092,507,213,294,509,216,293,754,308,429,590,228,323
061070020093,297,126,171,298,128,170,430,176,247,307,127,159
061070010051,1138,341,797,1154,344,810,1372,472,883,1227,397,763
061070020061,561,195,366,560,196,364,551,213,327,526,170,331
061070020081,401,148,253,403,151,252,729,296,414,551,236,287
061070020082,319,115,204,322,119,203,421,169,238,285,120,152
061070020062,674,233,441,680,233,447,730,298,413,696,232,419
061070020063,685,233,452,691,231,460,714,287,412,789,213,531
061070017011,155,63,92,156,64,92,300,149,139,247,103,122
061070017012,172,71,101,172,71,101,364,182,171,311,130,149
061070017014,237,97,140,238,98,140,487,230,241,397,145,218
061070019021,218,90,128,219,91,128,384,151,225,287,102,161
061070020031,369,143,226,371,147,224,512,217,285,395,151,219
061070020034,441,175,266,449,180,269,564,244,310,425,163,237
061070020035,386,154,232,393,158,235,653,278,354,477,182,264
061070019012,542,188,354,549,192,357,683,267,401,538,182,324
061070019013,284,99,185,286,100,186,382,148,224,310,103,187
061070019023,569,198,371,580,203,377,673,262,395,526,177,316
061070020032,359,136,223,365,143,222,510,211,292,438,156,246
061070020033,261,100,161,266,105,161,416,172,237,324,131,171
061070020041,299,129,170,300,132,168,473,195,269,327,131,183
061070020042,894,385,509,898,392,506,1333,546,755,1160,414,675
061070020043,475,205,270,478,210,268,609,249,345,419,167,234
061070011012,105,77,28,105,74,31,165,109,54,113,78,28
061070011021,270,189,81,276,185,91,411,263,138,378,230,128
061070012001,332,128,204,340,137,203,505,221,269,435,183,225
061070010082,1278,423,855,1293,430,863,1522,552,939,1027,332,648
061070009011,166,83,83,169,82,87,216,103,111,205,78,113
061070010061,324,114,210,330,115,215,318,128,181,254,91,142
061070010062,369,130,239,373,133,240,523,208,297,451,161,253
061070010063,1015,358,657,1027,359,668,1150,454,665,1011,362,595
061070010064,428,151,277,433,152,281,534,212,311,452,156,275
061070010065,184,65,119,187,66,121,280,111,164,240,78,152
061070010081,822,264,558,837,269,568,1366,489,850,893,261,595
061070010113,376,254,122,381,253,128,549,367,165,406,268,110
061070010102,258,185,73,258,177,81,478,350,116,275,197,57
061070011011,127,91,36,128,89,39,252,165,76,201,137,40
061070011022,218,162,56,217,152,65,333,217,98,226,161,46
061070010124,521,293,228,526,289,237,1120,591,505,726,316,369
061070010101,217,147,70,220,142,78,321,220,92,250,167,67
061070010111,509,260,249,510,249,261,726,356,356,816,377,387
061070010112,884,448,436,899,437,462,1452,711,718,632,296,304
061070010071,729,255,474,736,257,479,1009,387,602,823,270,507
061070010072,740,260,480,745,262,483,1504,586,886,664,244,384
061070010123,658,295,363,662,284,378,924,448,452,596,212,353
061070005011,229,162,67,235,160,75,386,242,121,374,243,113
061070005013,292,229,63,295,222,73,434,290,135,261,172,76
061070005022,228,137,91,228,128,100,434,281,146,223,147,63
061070005021,299,171,128,295,163,132,522,320,196,323,186,115
061070005012,140,107,33,140,106,34,328,192,130,268,183,72
061070005014,166,127,39,170,126,44,367,218,149,282,197,80
061070004024,300,157,143,302,156,146,474,275,181,591,321,236
061070004023,319,175,144,317,175,142,490,285,201,314,196,112
061070004011,233,98,135,234,96,138,265,118,142,206,98,98
061070003033,323,111,212,327,107,220,347,118,227,208,72,130
061070004012,511,324,187,521,305,216,830,481,324,426,241,157
061070004013,377,240,137,383,226,157,585,346,231,495,333,132
061070004021,239,118,121,239,116,123,367,185,177,252,126,118
061070004022,520,279,241,529,272,257,707,349,342,563,275,255
061070010122,578,254,324,585,249,336,1038,453,552,555,233,286
061070010091,203,138,65,207,134,73,374,255,110,215,161,41
061070010092,328,223,105,330,211,119,528,355,156,356,263,67
061070013031,315,214,101,321,207,114,551,283,255,377,178,175
061070010121,479,201,278,484,197,287,860,365,470,596,256,304
061070001022,630,211,419,633,202,431,806,252,549,649,207,419
061070007011,225,164,61,229,158,71,359,240,109,243,168,62
061070007012,327,106,221,336,104,232,382,122,258,398,117,257
061070007021,272,179,93,273,168,105,385,266,113,297,207,77
061070007022,167,122,45,173,119,54,220,153,66,156,111,41
061070007023,269,204,65,275,198,77,506,322,171,371,246,96
061070007024,130,98,32,129,93,36,184,125,54,142,100,32
061070009013,99,64,35,101,64,37,168,107,61,185,113,65
061070009012,419,266,153,426,265,161,732,454,254,432,266,133
061070003032,465,111,354,469,112,357,502,151,344,433,109,304
061070008023,454,85,369,461,85,376,474,96,370,262,68,179
061070009021,431,174,257,438,164,274,655,259,379,421,146,253
061070006001,267,201,66,269,183,86,465,323,135,325,252,62
061070006002,92,79,13,94,74,20,132,106,26,141,118,15
061070006003,70,61,9,74,58,16,102,83,19,98,84,13
061070006004,190,108,82,193,105,88,354,158,192,231,119,108
061070002031,227,162,65,228,158,70,330,186,135,235,153,64
061070002032,198,133,65,200,130,70,315,193,111,321,223,86
061070002041,213,160,53,216,157,59,324,240,79,220,173,31
061070002042,233,179,54,238,176,62,376,285,86,237,193,34
061070002023,133,69,64,133,68,65,212,85,122,144,75,63
061070002033,132,89,43,132,84,48,225,141,80,217,125,81
061070008011,160,101,59,162,100,62,239,129,100,233,109,111
061070008012,164,116,48,169,113,56,339,182,155,326,148,170
061070008013,268,186,82,271,183,88,516,314,187,395,236,132
061070003042,178,50,128,177,48,129,211,70,138,153,51,97
061070003031,400,95,305,402,94,308,501,126,365,275,83,180
061070003041,201,91,110,202,90,112,361,135,218,262,89,164
061070003043,173,50,123,175,50,125,196,73,123,166,60,105
061070003021,133,30,103,134,30,104,183,59,122,162,45,113
061070003022,177,49,128,175,47,128,435,143,285,364,120,222
061070009023,209,40,169,209,36,173,191,65,124,170,35,127
061070009022,13,2,11,13,2,11,200,68,126,322,72,230
061070002022,153,50,103,152,48,104,169,70,99,102,59,41
061070003023,111,22,89,114,26,88,176,80,94,194,55,137
061070008021,140,69,71,141,69,72,160,92,67,163,48,112
061070008022,424,91,333,423,82,341,273,96,176,324,79,233
061070002021,117,43,74,119,42,77,146,65,80,113,65,47
061070036023,291,171,120,293,164,129,570,249,311,494,252,206
061070041031,164,106,58,165,101,64,314,195,103,271,181,73
061070041032,304,201,103,309,190,119,471,295,157,304,204,82
061070041041,92,60,32,94,60,34,244,150,81,226,140,70
061070041033,91,59,32,92,58,34,159,105,54,149,102,45
061070038023,253,148,105,258,144,114,386,204,173,311,162,140
061070039043,137,76,61,137,74,63,201,117,77,160,79,72
061070039032,153,76,77,158,75,83,294,173,112,308,151,139
061070041042,120,74,46,122,74,48,280,165,111,249,128,103
061070035011,391,139,252,395,146,249,496,206,282,418,164,236
061070036024,534,207,327,539,205,334,685,290,371,537,175,340
061070034021,336,131,205,344,137,207,582,223,346,315,135,169
061070039041,112,64,48,113,63,50,214,123,87,280,117,149
061070039042,127,68,59,130,69,61,244,120,113,179,90,80
061070041043,184,101,83,183,100,83,307,225,77,316,169,128
061070041021,299,164,135,301,164,137,567,253,302,325,174,133
061070035042,523,247,276,526,243,283,702,338,352,560,252,276
061070036021,301,147,154,302,149,153,550,267,265,487,248,211
061070037004,237,119,118,238,116,122,337,155,170,294,137,141
061070038012,300,145,155,301,148,153,578,265,290,395,193,172
061070038021,202,98,104,212,101,111,420,215,197,288,150,120
061070038022,114,58,56,116,56,60,232,120,108,123,66,52
061070039031,240,118,122,245,114,131,336,190,139,304,158,134
061070039021,490,170,320,497,171,326,744,273,460,551,184,339
061070040001,2,1,1,2,1,1,10,4,6,90,48,36
061070034013,277,93,184,284,96,188,394,153,236,245,109,124
061070035041,268,105,163,269,106,163,438,174,259,198,90,101
061070035033,360,164,196,364,165,199,558,239,309,435,182,233
061070035032,473,228,245,476,224,252,792,380,400,520,255,236
061070036013,303,147,156,307,142,165,605,254,344,404,178,205
061070036011,475,231,244,473,219,254,591,290,291,408,170,214
061070036014,279,134,145,280,130,150,576,266,296,419,184,210
061070036022,143,70,73,146,73,73,327,154,167,211,119,83
061070038011,229,109,120,228,110,118,326,151,170,258,129,121
061070035043,405,190,215,406,188,218,673,323,335,499,225,248
061070037001,296,142,154,298,136,162,558,260,285,327,164,143
061070037003,355,168,187,362,167,195,674,323,335,429,199,201
061070035012,459,138,321,462,142,320,532,215,317,467,152,297
061070036012,459,204,255,460,195,265,685,287,386,464,211,225
061070035031,382,187,195,386,184,202,664,319,332,615,231,355
061070037002,188,93,95,188,88,100,337,170,159,329,154,152
061070043012,257,222,35,263,222,41,308,260,41,315,269,28
061070027011,282,71,211,283,72,211,389,107,279,273,59,205
061070027022,283,72,211,285,74,211,478,125,344,413,107,287
061070027023,676,201,475,679,206,473,924,283,622,822,207,567
061070027024,300,127,173,301,132,169,289,117,164,291,75,201
061070034022,234,68,166,235,69,166,258,75,178,184,53,119
061070045005,316,112,204,320,113,207,410,165,238,358,139,197
061070045001,245,80,165,249,82,167,323,126,190,255,101,151
061070045004,282,100,182,283,101,182,361,105,254,196,80,115
061070045002,123,54,69,122,52,70,250,134,110,253,100,141
061070045003,101,43,58,101,43,58,191,103,85,187,73,106
061070039024,75,37,38,76,37,39,125,66,56,122,48,66
061070039022,145,82,63,148,82,66,317,177,134,331,135,178
061070039023,108,62,46,108,62,46,204,118,84,222,89,119
061070027012,263,59,204,268,61,207,390,102,282,293,78,208
061070034011,191,122,69,192,117,75,361,219,130,342,195,126
060330011021,520,314,206,526,306,220,430,269,153,385,217,132
060330013021,136,69,67,142,67,75,273,130,130,180,78,81
060330013023,322,172,150,332,163,169,577,280,279,479,208,224
060330013025,125,70,55,128,67,61,218,111,99,190,81,92
060330012004,382,199,183,385,192,193,477,237,230,453,210,203
060330013011,463,239,224,468,226,242,978,478,479,599,276,277
060330013012,789,424,365,803,399,404,966,495,452,859,415,387
060330013022,472,230,242,487,223,264,323,153,161,411,182,203
060330013024,235,119,116,247,118,129,570,295,259,392,183,178
060330012002,309,151,158,317,149,168,305,139,162,246,98,130
060330012003,200,94,106,204,94,110,451,200,240,316,132,160
060330012001,306,153,153,308,153,155,401,185,203,343,157,160
060330008011,355,211,144,358,205,153,453,268,168,399,224,142
060330007023,3,0,3,3,0,3,9,1,8,9,1,5
060330008012,283,159,124,285,151,134,435,218,194,358,173,145
060330008022,204,119,85,210,116,94,328,175,140,258,132,102
060330006022,177,97,80,182,96,86,163,88,72,149,75,62
060330007032,358,198,160,364,194,170,395,201,181,337,168,141
060330007041,336,205,131,346,205,141,436,261,171,409,213,155
060330007042,147,88,59,151,86,65,201,118,76,195,103,74
060330007031,244,151,93,246,145,101,383,216,149,337,191,115
060330008024,117,62,55,118,60,58,216,110,104,154,72,73
060330008021,202,113,89,204,112,92,403,216,173,372,179,152
060330008023,215,123,92,217,121,96,377,199,166,319,161,124
060330007021,401,254,147,405,244,161,631,365,253,492,263,185
060330007022,410,250,160,412,243,169,585,323,247,445,261,158
060330006023,295,135,160,296,129,167,431,200,221,388,159,196
060330001001,606,294,312,619,284,335,709,306,382,588,236,290
060330001002,269,122,147,276,117,159,456,192,257,383,142,204
060330005022,230,124,106,236,123,113,454,239,203,370,178,154
060330001003,401,192,209,409,190,219,312,145,165,273,109,143
060330005021,468,236,232,476,238,238,585,313,264,516,241,218
060330005011,449,246,203,453,240,213,560,280,271,466,215,207
060330005012,505,288,217,512,294,218,713,388,305,624,301,265
060330006021,295,166,129,304,170,134,310,180,124,270,139,111
060330006012,341,184,157,348,179,169,531,282,234,450,210,205
060330006011,322,172,150,322,165,157,458,227,219,363,185,154
060330004011,549,291,258,565,280,285,620,317,284,563,248,252
060330004012,321,166,155,327,156,171,470,263,198,379,158,182
060330004013,305,160,145,313,159,154,435,237,189,367,158,179
060330004022,573,330,243,584,315,269,841,444,379,739,386,282
060330003001,610,258,352,615,242,373,819,356,439,723,278,377
060330004021,313,178,135,315,171,144,429,226,194,314,169,118
060330003002,541,280,261,554,282,272,810,429,359,672,297,321
060330003003,222,115,107,225,116,109,401,210,182,316,144,148
060330010004,314,143,171,314,136,178,434,191,232,386,153,199
060330010002,256,131,125,254,122,132,319,160,148,284,122,136
060330010003,183,95,88,186,89,97,311,152,153,291,131,138
060330009021,713,399,314,726,392,334,889,515,359,717,371,291
060330010001,289,157,132,293,146,147,350,173,166,334,156,148
060330010006,302,161,141,305,159,146,546,272,256,438,222,178
060330009022,487,267,220,494,262,232,564,316,234,531,266,224
060330011012,261,134,127,267,128,139,465,228,226,395,178,179
060330009023,443,222,221,451,216,235,626,328,277,529,238,241
060330010005,391,236,155,398,226,172,580,329,236,474,251,175
060330009011,555,333,222,561,313,248,765,416,329,589,299,233
060330009012,635,342,293,644,319,325,698,376,311,611,290,270
060330011011,334,199,135,335,190,145,461,250,196,392,196,165
060330011022,326,192,134,324,186,138,464,270,182,411,221,160
060250122013,242,217,25,243,202,41,367,276,86,416,361,43
060250122022,433,384,49,434,359,75,704,524,162,691,598,68
060250122021,190,167,23,191,160,31,411,300,97,402,364,25
060250121021,178,153,25,180,145,35,328,240,80,425,363,50
060250121011,299,258,41,306,242,64,571,424,138,694,590,75
060250121012,266,236,30,265,213,52,433,328,97,458,410,36
060250122012,302,264,38,302,248,54,581,393,174,506,437,49
060250122011,208,182,26,209,172,37,402,275,119,399,339,39
060250120042,682,575,107,683,541,142,1099,798,274,812,706,78
060250119021,113,99,14,113,92,21,569,413,141,389,330,45
060250119022,770,688,82,773,639,134,993,716,248,1247,1098,100
060250120011,530,469,61,533,436,97,724,537,169,704,626,51
060250120041,318,282,36,323,263,60,862,617,221,637,555,52
060250120012,132,116,16,133,109,24,327,243,75,298,262,22
060250121022,284,250,34,286,236,50,441,302,126,417,376,27
060250119012,272,232,40,274,222,52,514,356,146,442,371,49
060250120032,340,283,57,340,265,75,615,440,166,530,437,76
060250119032,455,372,83,457,354,103,924,621,285,731,597,92
060250120031,469,388,81,472,367,105,940,644,279,620,505,88
060250121023,212,187,25,212,176,36,335,237,90,299,268,23
060250119011,91,64,27,91,63,28,124,86,36,130,100,23
060259400003,68,48,20,69,47,22,122,81,39,102,66,31
060250124001,75,32,43,77,31,46,114,37,75,71,25,44
060259400002,36,28,8,37,28,9,90,69,19,68,44,21
060250116001,398,247,151,394,231,163,717,431,270,574,357,191
060250118011,567,352,215,567,330,237,637,384,241,644,391,214
060250118022,493,303,190,489,284,205,726,431,273,641,385,219
060250118012,831,409,422,845,386,459,1136,563,568,951,448,449
060250118021,242,151,91,244,143,101,565,339,210,506,322,153
060250116002,307,232,75,312,218,94,613,411,183,635,474,119
060250116003,156,112,44,156,105,51,204,135,69,167,129,37
060250116004,351,259,92,354,237,117,450,308,136,383,291,73
060250114002,89,66,23,85,58,27,233,161,68,188,146,36
060250117001,458,334,124,456,307,149,849,574,252,756,571,150
060250117003,441,307,134,442,285,157,577,377,186,489,344,117
060250118032,333,194,139,335,186,149,646,370,256,568,343,192
060250117002,319,188,131,322,184,138,463,265,193,363,214,130
060250118023,535,295,240,536,278,258,846,466,365,679,400,238
060250118033,561,335,226,573,333,240,993,555,423,750,460,254
060250123012,177,66,111,178,60,118,255,113,139,259,110,135
060250111001,167,54,113,172,48,124,265,98,164,197,72,118
060250113031,490,367,123,488,355,133,955,631,313,842,680,127
060250113011,436,359,77,440,342,98,657,451,191,635,523,77
060250113012,213,185,28,214,170,44,606,430,156,464,396,42
060250111002,293,97,196,295,96,199,459,163,285,413,168,234
060250118031,513,289,224,515,279,236,917,504,404,682,390,269
060250112011,299,218,81,302,200,102,477,309,159,319,244,64
060250115004,248,184,64,252,167,85,547,353,173,752,580,135
060250112021,285,233,52,287,221,66,533,398,123,494,421,57
060250112022,137,112,25,138,106,32,245,182,57,243,203,29
060250112013,519,294,225,523,280,243,907,503,387,623,358,242
060250112023,142,105,37,142,98,44,305,208,87,251,191,46
060250112024,162,120,42,159,110,49,332,226,94,234,178,42
060250115001,153,121,32,153,113,40,361,258,97,140,100,36
060250115002,157,116,41,155,106,49,302,208,86,238,179,44
060250115003,179,145,34,181,135,46,294,217,75,274,227,36
060250110026,470,200,270,476,184,292,638,271,358,479,201,255
060250110013,380,215,165,387,198,189,699,380,304,490,264,200
060250110012,430,247,183,435,232,203,754,406,327,520,284,211
060250110022,157,92,65,160,88,72,342,188,141,289,162,108
060250110021,192,113,79,195,106,89,322,178,133,254,144,97
060250110023,382,213,169,386,201,185,356,201,151,308,171,121
060250110024,230,135,95,232,126,106,313,177,134,314,179,119
060250110025,780,396,384,789,383,406,1842,897,906,1008,519,428
060250110011,307,153,154,311,153,158,854,420,421,710,371,292
060250112014,407,250,157,409,239,170,889,520,349,491,298,165
060250112012,539,300,239,540,287,253,802,437,350,721,409,279
060250103001,347,134,213,348,126,222,266,92,171,289,107,166
060250111003,220,158,62,221,146,75,445,277,147,434,302,92
060250105002,294,123,171,299,112,187,429,192,230,363,148,194
060250105003,277,163,114,280,151,129,438,248,173,361,212,126
060250104011,88,60,28,89,57,32,172,112,60,138,98,35
060250105001,138,92,46,141,87,54,287,177,103,251,167,68
060250106001,258,176,82,264,169,95,411,266,143,393,260,112
060250106002,231,154,77,233,142,91,440,257,179,274,181,82
060250104012,248,176,72,250,164,86,604,376,213,500,353,116
060250105005,416,295,121,422,277,145,664,424,228,458,327,106
060250105004,142,101,41,143,94,49,313,196,103,264,188,58
060250106003,639,168,471,647,163,484,824,229,581,718,186,496
060250106004,354,182,172,357,174,183,600,293,295,294,164,113
060250106005,505,228,277,513,224,289,841,399,427,705,315,350
060250107003,233,184,49,236,170,66,465,324,126,348,278,55
060250104022,218,177,41,219,162,57,264,191,73,217,176,36
060250107001,241,183,58,243,170,73,407,276,115,337,245,73
060250101022,178,127,51,178,106,72,307,187,111,262,175,72
060250101023,200,144,56,205,120,85,382,233,140,305,203,85
060250101024,175,125,50,174,100,74,210,129,77,186,122,51
060250102001,252,133,119,261,118,143,244,135,108,241,141,94
060250102002,244,157,87,241,136,105,392,245,135,364,254,94
060250101021,218,108,110,219,103,116,339,202,134,253,144,95
060250101011,150,67,83,151,66,85,102,44,56,184,78,101
060250124002,44,24,20,44,20,24,72,40,31,58,27,27
060250124003,36,13,23,36,13,23,112,53,59,48,18,29
060250123011,179,92,87,182,89,93,77,43,34,161,86,71
060250123022,183,98,85,184,97,87,631,348,255,462,218,219
060250123023,179,80,99,179,74,105,322,165,157,181,89,89
060250123021,115,61,54,116,58,58,201,125,70,157,95,57
060250104021,254,216,38,259,195,64,285,204,74,310,248,46
060250104023,252,217,35,253,195,58,708,519,174,489,397,70
060250107002,229,182,47,231,170,61,348,253,92,304,244,45
060250119031,481,413,68,482,389,93,895,617,262,765,646,87
060250114001,221,181,40,222,174,48,432,325,102,217,172,33
060250114003,362,298,64,371,293,78,662,481,166,741,627,79
060250113021,220,147,73,221,139,82,435,245,181,362,259,85
060250113032,234,122,112,236,118,118,246,126,115,381,204,158
060250109001,417,207,210,424,193,231,560,266,279,534,289,218
060250109002,287,169,118,290,158,132,564,319,235,461,275,156
060250109003,265,162,103,265,149,116,421,248,167,350,216,111
060250109004,227,145,82,229,133,96,288,187,101,234,162,64
060250109005,157,102,55,158,91,67,209,130,76,161,112,43
060250109006,113,72,41,112,66,46,194,123,69,153,105,41
060250108001,159,50,109,159,41,118,223,74,149,189,69,118
060250108002,256,88,168,261,82,179,334,121,205,265,94,151
060259400001,80,42,38,78,38,40,180,108,67,129,65,52
060510001021,181,71,110,181,71,110,232,91,133,215,67,134
060510001022,295,108,187,294,107,187,351,137,197,268,84,167
060510001023,214,70,144,215,67,148,327,129,190,312,107,194
060510001011,607,248,359,611,241,370,656,240,397,507,146,324
060510001012,306,159,147,305,158,147,387,222,153,306,152,132
060510001024,196,124,72,199,129,70,274,181,80,228,129,79
060510001013,297,206,91,301,207,94,358,246,104,333,219,96
060510001014,390,228,162,392,222,170,720,421,274,543,298,208
060510002011,587,385,202,600,384,216,753,519,201,527,331,156
060510002025,213,137,76,214,130,84,445,288,142,366,208,124
060510002021,426,271,155,431,262,169,358,235,118,337,195,117
060510002024,297,196,101,302,192,110,604,416,165,378,241,105
060510002012,174,116,58,175,115,60,298,215,82,265,171,74
060510002022,178,122,56,178,120,58,255,171,76,235,142,71
060510002023,209,144,65,211,143,68,384,268,109,252,155,76
060510002013,242,163,79,244,158,86,335,234,92,199,128,54
060770022011,157,142,15,159,142,17,256,200,51,237,212,20
060770023002,183,154,29,183,152,31,366,285,73,258,210,27
060770021003,240,200,40,242,187,55,230,164,51,276,223,41
060770021004,218,184,34,219,172,47,377,276,84,344,282,48
060770022012,237,214,23,240,212,28,517,411,98,335,309,20
060770022021,197,160,37,200,159,41,360,271,75,296,252,34
060770023001,191,164,27,192,159,33,438,347,88,257,217,31
060770023003,174,152,22,179,150,29,412,327,85,265,227,32
060770025031,169,138,31,172,134,38,278,218,54,233,192,30
060770025032,164,133,31,166,132,34,292,228,56,269,227,34
060770025041,328,256,72,333,261,72,493,371,95,436,370,53
060770024013,278,226,52,279,211,68,448,348,89,395,329,42
060770024021,202,159,43,205,148,57,303,227,70,260,219,30
060770024022,134,113,21,134,108,26,216,168,44,181,155,19
060770024011,233,203,30,234,205,29,461,356,89,348,306,29
060770024012,163,134,29,165,127,38,314,249,64,254,224,27
060770003002,99,78,21,100,77,23,263,192,58,153,119,24
060770007003,110,86,24,109,84,25,207,159,48,158,124,25
060770007004,184,143,41,185,141,44,269,199,62,233,183,39
060770019002,216,187,29,213,181,32,326,247,79,326,302,15
060770020001,183,160,23,186,157,29,222,159,50,230,195,21
060770020002,156,137,19,160,136,24,228,169,54,254,224,24
060770038042,340,261,79,342,248,94,636,481,148,435,354,68
060770038052,418,321,97,419,307,112,659,489,163,523,419,87
060770001023,96,75,21,95,69,26,136,103,33,107,82,20
060770001011,46,38,8,49,38,11,199,143,44,93,69,17
060770006001,72,59,13,75,56,19,188,143,45,124,105,16
060770006002,86,70,16,85,67,18,227,172,54,145,121,17
060770001021,109,81,28,112,79,33,191,142,45,160,115,36
060770001012,94,69,25,91,64,27,207,152,46,127,100,21
060770003001,267,185,82,268,178,90,364,273,81,310,214,75
060770004012,148,103,45,150,99,51,128,97,30,175,118,42
060770004014,190,132,58,197,130,67,177,137,40,176,124,45
060770009002,274,191,83,278,185,93,514,333,160,373,253,98
060770008033,247,201,46,247,194,53,309,237,62,321,262,46
060770008032,280,229,51,280,221,59,356,277,73,346,286,50
060770004021,153,119,34,155,120,35,262,197,57,207,158,39
060770004022,143,109,34,145,110,35,225,168,49,190,143,33
060770004023,134,104,30,136,106,30,252,189,57,191,148,36
060770004024,310,227,83,314,225,89,492,347,130,443,313,104
060770038061,404,314,90,410,308,102,711,512,185,512,398,93
060770038062,380,298,82,384,290,94,627,469,142,504,407,78
060770038051,259,197,62,263,194,69,473,349,114,392,323,59
060770038032,338,255,83,348,255,93,562,396,152,611,407,167
060770001022,85,61,24,86,64,22,221,161,53,98,75,16
060770005001,172,121,51,174,121,53,320,242,78,216,158,53
060770005002,80,59,21,82,60,22,282,212,65,183,134,39
060770017003,134,96,38,134,95,39,219,156,62,164,135,24
060770018001,221,149,72,220,142,78,344,239,86,289,182,83
060770018002,274,184,90,278,174,104,413,309,100,352,245,91
060770019001,187,152,35,187,148,39,281,214,67,259,207,40
060770019003,159,128,31,163,125,38,235,178,56,248,205,37
060770019004,104,80,24,104,81,23,180,137,41,121,103,16
060770020003,221,171,50,225,170,55,302,226,70,289,217,55
060770016002,104,75,29,104,73,31,209,154,49,175,120,46
060770004011,221,159,62,224,157,67,275,191,80,248,173,63
060770004013,431,307,124,434,302,132,514,353,151,449,305,117
060770028001,272,212,60,274,209,65,417,328,81,404,316,72
060770028003,269,207,62,268,206,62,416,327,81,352,274,63
060770028004,234,187,47,236,186,50,437,336,89,353,296,45
060770038033,314,151,163,319,156,163,445,227,205,254,124,112
060770010002,328,179,149,330,175,155,541,304,227,472,257,192
060770010004,341,162,179,341,160,181,357,199,150,362,160,183
060770011023,201,113,88,202,110,92,280,173,97,204,131,64
060770011025,190,113,77,192,107,85,324,199,115,230,148,71
060770038043,365,271,94,367,265,102,619,465,140,501,364,120
060770038071,265,197,68,269,194,75,375,282,85,274,214,51
060770038072,220,163,57,222,160,62,399,301,90,309,239,57
060770038031,183,113,70,184,112,72,298,172,121,186,123,52
060770021001,223,194,29,226,194,32,393,289,84,306,273,21
060770021002,185,154,31,186,154,32,305,224,67,248,214,24
060770007001,105,84,21,108,82,26,327,258,68,145,113,22
060770007002,135,108,27,136,106,30,376,298,77,183,142,27
060770038081,377,298,79,382,292,90,624,455,149,495,376,96
060770038083,269,212,57,272,209,63,430,323,98,321,258,52
060770038082,328,261,67,332,254,78,583,439,132,448,353,73
060770025042,369,286,83,376,293,83,509,385,95,453,373,67
060770011011,556,328,228,562,316,246,629,403,208,619,352,220
060770011012,444,254,190,450,243,207,617,373,230,575,327,222
060770011021,316,192,124,322,185,137,460,277,169,373,217,131
060770009004,217,151,66,218,149,69,382,242,126,213,156,45
060770009005,179,124,55,181,123,58,550,349,181,305,220,67
060770009001,284,194,90,290,180,110,244,161,83,292,179,97
060770009003,299,204,95,305,190,115,326,205,109,379,227,124
060770022022,231,175,56,232,173,59,440,320,98,348,273,57
060770022023,191,167,24,194,167,27,508,399,101,253,222,22
060770028002,286,247,39,284,243,41,460,362,90,403,358,32
060770008031,388,293,95,394,280,114,493,377,101,509,412,75
060770038041,521,398,123,529,390,139,918,678,221,761,586,141
060770031081,548,315,233,556,309,247,551,334,198,447,256,164
060770031082,424,255,169,431,248,183,689,422,252,602,349,218
060770031083,430,270,160,434,259,175,659,405,241,474,281,157
060770031063,773,351,422,789,359,430,850,468,367,800,369,401
060770031061,524,278,246,532,278,254,775,435,325,584,298,261
060770031062,362,166,196,366,168,198,474,264,200,410,221,174
060770031092,706,339,367,719,335,384,686,383,282,767,385,332
060770032032,873,421,452,885,426,459,667,390,264,971,482,427
060770033072,275,188,87,279,183,96,504,289,195,363,238,102
060770033073,253,177,76,260,174,86,552,322,216,358,239,103
060770031094,587,308,279,599,309,290,808,435,351,649,344,267
060770031121,613,328,285,629,323,306,826,487,318,683,387,266
060770031122,535,276,259,548,269,279,369,236,125,611,309,279
060770033063,258,175,83,264,176,88,544,360,171,336,234,81
060770033062,188,125,63,190,122,68,443,293,140,321,226,77
060770033071,366,251,115,373,251,122,678,390,263,411,272,116
060770031102,247,157,90,246,149,97,321,230,83,272,182,74
060770033053,386,250,136,388,238,150,440,285,152,460,286,145
060770032161,430,266,164,433,253,180,583,363,209,500,331,139
060770032162,323,197,126,325,187,138,457,285,166,324,209,93
060770032171,275,172,103,279,166,113,581,355,207,448,284,128
060770032172,317,207,110,320,199,121,574,330,221,396,245,120
060770031093,354,193,161,358,189,169,361,228,124,430,229,172
060770031103,324,206,118,323,202,121,573,410,150,446,299,122
060770031111,515,314,201,522,309,213,883,525,333,687,447,203
060770033122,110,85,25,113,83,30,462,300,148,214,150,52
060770033132,119,96,23,122,98,24,581,367,193,232,167,49
060770034072,219,155,64,221,148,73,520,330,173,307,209,77
060770034071,225,157,68,227,147,80,497,328,156,266,184,68
060770034101,320,242,78,323,230,93,574,401,162,504,388,94
060770034103,267,194,73,270,185,85,478,343,129,398,309,77
060770034102,227,171,56,230,162,68,425,304,116,222,169,46
060770034104,156,119,37,156,111,45,298,209,80,187,143,35
060770012001,471,292,179,479,289,190,1148,747,366,834,514,268
060770012002,414,258,156,419,251,168,291,192,98,235,146,77
060770012003,498,309,189,507,303,204,462,306,148,422,255,140
060770012004,430,266,164,431,259,172,385,258,125,438,258,155
060770041084,358,227,131,360,220,140,690,418,253,300,209,83
060770041081,397,271,126,398,264,134,829,529,283,482,355,112
060770041082,372,251,121,376,249,127,659,421,230,604,434,149
060770033051,281,169,112,285,173,112,421,271,143,359,220,120
060770033052,375,251,124,378,239,139,451,289,152,436,267,142
060770033131,228,142,86,235,140,95,445,296,138,174,127,37
060770031112,605,408,197,604,398,206,747,466,259,650,438,171
060770013001,322,206,116,325,207,118,526,347,166,421,263,122
060770013002,598,385,213,606,388,218,659,437,216,535,336,162
060770013004,119,77,42,120,78,42,292,194,97,261,166,81
060770013003,317,205,112,325,207,118,497,313,173,405,259,132
060770032031,676,352,324,681,337,344,702,394,294,807,363,397
060770032051,353,165,188,352,154,198,493,244,238,393,175,188
060770032052,670,348,322,676,332,344,830,472,336,727,363,315
060770014004,430,281,149,436,276,160,475,318,150,585,364,185
060770033081,360,236,124,364,230,134,547,361,170,283,192,78
060770014002,243,156,87,244,146,98,459,303,142,386,242,127
060770014001,236,148,88,237,139,98,372,246,114,223,135,74
060770014003,222,141,81,226,134,92,329,219,104,255,163,87
060770015011,358,228,130,359,218,141,387,234,148,320,191,103
060770035042,325,244,81,329,238,91,670,473,186,510,397,99
060770035043,473,330,143,480,322,158,740,501,227,611,453,138
060770035041,702,504,198,702,496,206,1086,735,331,816,620,171
060770031162,126,93,33,126,90,36,369,270,87,188,132,45
060770031161,150,103,47,154,103,51,352,254,89,147,104,36
060770031151,182,132,50,188,136,52,360,257,92,346,245,80
060770031152,317,232,85,320,225,95,295,216,69,320,227,75
060770031153,147,108,39,149,105,44,194,142,46,217,154,51
060770033121,145,103,42,147,97,50,284,182,96,106,78,23
060770033123,76,60,16,78,57,21,298,201,91,179,120,50
060770033061,355,222,133,361,216,145,555,378,173,437,290,123
060770031091,263,167,96,266,159,107,510,311,186,334,198,111
060770035034,675,475,200,678,457,221,1261,820,416,801,580,196
060770035032,444,314,130,444,297,147,740,488,236,584,431,131
060770035033,366,262,104,370,256,114,772,532,232,473,347,113
060770035031,192,137,55,193,129,64,390,269,117,279,203,65
060770034091,297,211,86,298,206,92,429,290,132,389,290,85
060770034092,329,234,95,336,231,105,523,353,159,422,315,89
060770034093,260,184,76,263,182,81,402,284,107,364,273,76
060770032152,350,227,123,354,210,144,425,259,155,411,225,158
060770015013,279,200,79,278,193,85,621,396,207,328,252,67
060770015021,145,95,50,146,93,53,505,330,161,397,254,107
060770016001,137,97,40,139,90,49,291,218,70,215,154,46
060770041083,610,307,303,615,297,318,1235,664,551,610,299,270
060770034031,254,180,74,257,183,74,410,284,117,307,225,68
060770034032,337,220,117,341,221,120,531,368,157,417,306,97
060770034033,385,220,165,386,215,171,561,363,183,431,297,116
060770034051,192,137,55,193,136,57,365,233,129,253,186,54
060770034052,161,115,46,163,115,48,278,176,97,186,138,39
060770034053,173,124,49,175,124,51,395,247,138,274,201,59
060770015012,264,201,63,269,197,72,587,382,180,308,252,47
060770034044,325,184,141,326,178,148,261,166,91,268,157,98
060770034041,157,115,42,158,115,43,338,211,118,195,143,39
060770034042,159,116,43,162,117,45,350,220,123,195,144,39
060770034043,252,186,66,256,186,70,497,314,176,516,304,188
060770033101,337,225,112,339,219,120,534,344,183,395,256,117
060770033102,355,238,117,359,231,128,570,362,194,455,321,117
060770033103,245,164,81,244,158,86,413,262,140,310,219,79
060770040032,750,447,303,762,440,322,1049,627,406,822,480,303
060770040042,320,186,134,325,181,144,565,345,211,379,234,125
060770040031,508,304,204,517,299,218,654,405,238,564,323,217
060770040044,518,301,217,526,293,233,853,523,318,550,338,182
060770040041,412,241,171,415,231,184,564,347,212,554,328,204
060770031181,427,234,193,433,228,205,616,367,239,504,295,180
060770031192,478,263,215,486,258,228,690,413,267,594,324,239
060770031193,581,323,258,589,320,269,672,402,259,654,362,260
060770031191,272,152,120,276,151,125,387,229,149,338,184,137
060770031182,553,304,249,563,300,263,758,451,295,571,326,216
060770031171,835,348,487,851,343,508,1177,563,594,955,422,478
060770031172,913,391,522,930,386,544,1091,522,550,949,416,479
060770032131,297,169,128,298,161,137,663,383,262,388,247,120
060770032132,310,197,113,311,189,122,505,302,190,353,211,123
060770032133,239,152,87,242,147,95,322,199,116,232,156,66
060770032134,407,246,161,417,249,168,578,356,208,447,285,137
060770040043,582,342,240,591,326,265,949,581,354,671,414,219
060770032192,476,272,204,480,260,220,833,498,318,567,369,169
060770032195,1029,552,477,1040,531,509,1324,810,484,1171,651,465
060770032191,590,345,245,596,330,266,928,541,369,768,417,302
060770033111,329,204,125,330,196,134,638,407,218,408,269,115
060770033112,273,169,104,279,165,114,602,385,205,378,247,107
060770032053,300,153,147,304,149,155,341,205,130,357,173,155
060770032091,418,227,191,418,220,198,423,262,152,515,255,226
060770032092,302,161,141,308,160,148,388,243,141,439,220,192
060770032093,511,270,241,517,263,254,558,352,204,590,300,255
060770040033,423,277,146,432,266,166,793,485,291,630,386,212
060770034061,346,237,109,348,233,115,837,516,302,455,329,106
060770034062,232,158,74,235,158,77,489,301,174,275,201,64
060770032181,475,248,227,479,241,238,737,434,287,566,315,214
060770032182,380,208,172,383,201,182,583,360,212,413,244,144
060770032193,413,241,172,413,236,177,623,362,254,489,287,173
060770032194,518,305,213,525,300,225,683,422,251,561,294,228
060770032151,466,271,195,468,266,202,537,329,195,516,310,187
060770032141,389,213,176,396,207,189,561,326,227,523,277,214
060770032142,735,400,335,745,401,344,998,576,404,854,464,345
060770032101,590,343,247,606,352,254,659,408,237,721,425,259
060770032102,325,177,148,335,179,156,405,232,164,452,244,183
060770032153,118,88,30,122,87,35,180,114,61,148,107,31
060770032154,176,131,45,183,130,53,422,267,143,226,164,46
060770052081,560,334,226,569,326,243,646,384,249,583,318,235
060770052082,454,270,184,461,263,198,714,421,274,499,278,190
060770054052,390,251,139,401,251,150,488,303,173,374,232,114
060770054061,562,352,210,566,349,217,905,559,324,647,437,174
060770054031,468,274,194,478,268,210,612,389,205,453,270,148
060770054032,442,253,189,452,250,202,472,295,161,473,264,176
060770054033,593,362,231,612,352,260,824,537,265,627,363,224
060770054034,582,362,220,595,360,235,723,455,254,670,405,222
060770053033,136,81,55,139,80,59,230,137,87,167,97,54
060770053034,236,134,102,244,137,107,357,216,137,220,131,72
060770053035,200,120,80,207,119,88,430,254,162,274,160,90
060770053081,281,158,123,284,158,126,299,181,116,268,143,111
060770053082,220,127,93,227,123,104,236,141,91,176,95,73
060770053072,405,247,158,418,236,182,642,388,234,563,317,206
060770053083,253,155,98,257,148,109,342,203,130,318,194,106
060770053084,462,285,177,472,276,196,653,389,247,590,382,173
060770053031,180,117,63,185,111,74,350,211,134,219,128,72
060770053032,231,151,80,235,143,92,352,213,136,199,117,66
060770052142,585,334,251,605,341,264,906,503,388,588,319,241
060770053091,491,300,191,501,282,219,766,479,266,631,354,232
060770053092,401,243,158,409,231,178,425,272,150,343,196,130
060770052141,1076,584,492,1089,554,535,2730,1623,1062,903,433,403
060770053101,298,197,101,307,195,112,522,330,179,336,204,107
060770053102,331,217,114,340,217,123,387,245,134,256,161,80
060770053103,309,203,106,318,202,116,467,297,159,319,204,98
060770053112,356,233,123,364,235,129,631,400,216,428,274,132
060770053111,203,132,71,207,133,74,420,267,144,306,195,94
060770053121,318,200,118,324,202,122,354,226,121,357,216,122
060770053122,446,269,177,455,271,184,572,353,207,489,296,170
060770053071,354,225,129,364,219,145,514,305,194,419,219,165
060770054053,270,187,83,273,183,90,489,296,171,382,234,114
060770054051,214,149,65,220,146,74,420,262,152,238,153,67
060770054062,245,150,95,250,148,102,396,249,144,280,175,88
060770052083,594,362,232,603,364,239,711,428,271,675,418,219
060770052163,825,495,330,839,497,342,875,518,335,642,376,232
060770052162,367,225,142,374,224,150,736,435,291,341,203,119
060770052201,742,460,282,760,451,309,1093,660,407,753,434,266
060770052191,893,516,377,913,518,395,1175,749,406,864,496,323
060770052192,886,496,390,906,502,404,1526,897,600,1120,607,445
060770052171,777,458,319,790,451,339,940,610,311,713,413,251
060770052172,531,351,180,541,344,197,519,331,178,392,253,117
060770052084,449,261,188,455,258,197,546,339,193,612,342,227
060770053123,278,171,107,281,168,113,335,212,115,334,200,119
060770052121,986,610,376,1014,609,405,1221,767,430,814,496,283
060770052123,731,460,271,742,450,292,1205,779,401,964,619,306
060770052252,414,191,223,422,183,239,933,491,417,426,167,232
060770052242,942,588,354,970,587,383,1158,740,394,1028,632,348
060770052241,612,382,230,633,387,246,764,488,256,655,373,245
060770052182,430,294,136,435,288,147,841,542,277,487,331,129
060770052181,606,415,191,612,405,207,969,627,319,707,476,193
060770052161,489,305,184,497,305,192,626,394,221,623,384,203
060770052132,690,376,314,702,373,329,1124,681,426,464,248,202
060770052112,618,423,195,637,417,220,917,587,302,602,409,169
060770052111,357,263,94,369,260,109,448,297,140,259,185,64
060770052113,457,336,121,469,331,138,1085,721,341,656,468,159
060770052152,421,243,178,435,252,183,1081,643,417,727,421,268
060770052153,661,375,286,681,389,292,676,404,262,454,253,183
060770052131,277,164,113,286,165,121,529,331,184,372,221,136
060770052122,616,415,201,625,415,210,840,549,278,726,470,220
060770042032,187,107,80,191,101,90,546,223,306,262,129,112
060770042033,274,141,133,281,134,147,715,289,406,334,156,147
060770042031,468,201,267,471,193,278,696,284,399,546,201,309
060770045011,436,146,290,438,146,292,454,179,267,365,138,210
060770045023,151,96,55,155,91,64,280,178,93,171,117,48
060770045012,287,164,123,296,153,143,711,288,399,509,250,222
060770041042,599,205,394,600,196,404,689,260,414,648,216,396
060770041043,512,178,334,519,173,346,525,198,316,572,191,345
060770041052,506,178,328,516,172,344,535,202,322,536,167,340
060770042021,946,289,657,954,282,672,845,337,489,1000,298,653
060770041051,775,263,512,786,249,537,837,306,514,690,250,396
060770041071,601,199,402,613,199,414,1134,457,657,563,170,366
060770044021,411,194,217,414,182,232,429,210,210,374,171,182
060770044023,641,281,360,654,274,380,741,364,363,691,314,342
060770043072,376,190,186,380,178,202,570,279,277,525,201,285
060770043073,229,98,131,232,93,139,312,142,163,289,110,157
060770043081,438,223,215,444,209,235,449,220,220,241,139,89
060770043082,224,114,110,226,106,120,279,161,110,248,142,92
060770043083,3,2,1,3,1,2,567,269,285,302,172,110
060770044022,340,163,177,346,154,192,782,365,402,669,333,301
060770044041,127,82,45,126,75,51,330,160,161,108,71,29
060770043102,608,216,392,616,213,403,546,231,302,516,157,330
060770043092,551,204,347,558,199,359,583,253,323,652,222,385
060770043053,138,49,89,140,49,91,470,202,256,388,146,216
060770043052,723,260,463,732,254,478,1063,456,580,775,299,427
060770043022,539,198,341,549,184,365,745,303,421,605,239,338
060770043023,531,175,356,538,170,368,831,350,458,602,194,369
060770042041,324,133,191,327,132,195,472,194,273,298,133,146
060770042042,501,204,297,510,202,308,540,226,310,531,185,312
060770042043,342,142,200,347,142,205,374,157,217,473,162,273
060770043021,415,171,244,420,171,249,654,264,366,438,188,214
060770043091,526,192,334,540,182,358,604,250,341,636,220,373
060770042051,430,136,294,434,132,302,603,229,361,440,146,264
060770042052,441,147,294,445,142,303,809,305,488,590,196,355
060770042061,568,226,342,580,206,374,1050,392,626,634,227,363
060770042053,331,125,206,335,119,216,549,205,330,374,125,230
060770041041,927,313,614,936,302,634,1064,419,631,659,224,393
060770042062,607,211,396,614,202,412,747,297,427,700,224,429
060770043101,652,212,440,668,207,461,757,304,434,863,251,564
060770043054,534,200,334,541,193,348,537,228,294,481,180,267
060770043024,313,138,175,317,134,183,600,264,329,386,168,191
060770044033,287,189,98,291,175,116,240,160,75,177,118,42
060770044032,85,56,29,86,52,34,222,145,69,170,115,39
060770044031,213,139,74,216,132,84,323,213,99,296,182,85
060770044042,2,1,1,2,1,1,275,184,89,173,124,43
060770044043,92,60,32,95,57,38,274,180,86,243,155,67
060770045022,97,63,34,97,59,38,200,130,65,127,82,40
060770045021,131,86,45,127,76,51,329,217,103,204,146,53
060770043071,524,224,300,531,218,313,750,319,411,697,255,399
060770046004,495,150,345,505,147,358,680,228,438,533,153,352
060770043051,707,231,476,718,222,496,886,358,512,750,280,425
060770051341,517,275,242,525,270,255,934,469,447,587,288,269
060770051351,632,327,305,642,317,325,881,449,417,656,312,304
060770051251,334,161,173,338,156,182,388,205,173,379,163,188
060770051252,302,146,156,304,140,164,343,181,153,353,152,174
060770051344,449,217,232,456,202,254,799,399,382,481,212,232
060770051343,351,168,183,355,163,192,621,312,298,375,167,181
060770051342,301,145,156,305,141,164,380,200,169,369,159,182
060770051352,670,325,345,676,301,375,916,485,407,668,301,324
060770051261,284,164,120,290,158,132,436,224,198,258,146,98
060770051262,399,242,157,407,233,174,534,282,239,478,231,213
060770051263,326,194,132,333,186,147,704,364,319,444,240,177
060770051192,113,61,52,113,59,54,168,101,65,187,103,72
060770051233,622,348,274,635,339,296,865,466,379,699,373,285
060770051232,294,165,129,299,160,139,368,198,162,345,183,145
060770051231,302,169,133,308,164,144,560,301,243,322,184,119
060770051081,525,295,230,527,288,239,607,312,278,409,218,166
060770051083,401,248,153,403,238,165,678,353,308,517,276,214
060770051242,362,206,156,368,201,167,463,248,202,404,211,173
060770051243,337,190,147,337,184,153,450,241,196,388,202,165
060770051082,147,93,54,150,91,59,308,158,141,202,110,81
060770051241,223,142,81,228,139,89,528,283,230,302,170,115
060770051353,1120,490,630,1137,490,647,1276,593,657,940,431,459
060770051354,1683,782,901,1710,785,925,1576,791,766,1655,748,859
060770051091,368,184,184,376,183,193,568,292,260,489,218,223
060770051092,357,186,171,363,174,189,533,279,249,369,176,160
060770051401,490,247,243,500,240,260,544,283,254,547,232,276
060770051412,639,312,327,655,319,336,733,372,330,730,319,354
060770051093,179,94,85,182,88,94,253,125,122,202,93,97
060770051403,275,145,130,285,139,146,408,203,197,305,140,148
060770051374,290,157,133,296,157,139,530,294,224,355,190,141
060770051402,213,103,110,216,101,115,346,170,170,180,99,74
060770051391,496,228,268,503,219,284,663,319,332,613,262,314
060770051392,749,352,397,760,347,413,1022,522,487,875,396,437
060770051411,367,176,191,373,163,210,360,177,177,347,153,174
060770051313,470,161,309,479,155,324,803,322,460,626,257,332
060770051321,218,112,106,219,108,111,322,163,155,226,120,90
060770051322,250,137,113,253,129,124,427,231,187,308,163,125
060770051323,242,133,109,247,128,119,490,267,216,313,166,127
060770051333,174,95,79,178,92,86,265,130,125,199,105,79
060770051334,186,102,84,191,100,91,317,159,151,210,114,82
060770051372,577,316,261,590,318,272,1044,517,499,654,325,302
060770051373,461,249,212,466,247,219,648,363,273,526,282,209
060770051061,985,455,530,999,447,552,1615,759,816,635,219,379
060770051362,522,275,247,532,271,261,736,399,321,620,318,275
060770051361,554,314,240,561,311,250,663,359,290,590,301,263
060770051371,650,359,291,661,352,309,1265,681,559,960,601,308
060770051062,760,415,345,777,410,367,959,538,406,892,473,378
060770051064,1194,636,558,1208,618,590,2655,1392,1207,902,447,393
060770051223,541,289,252,550,285,265,799,412,367,395,196,175
060770051221,722,418,304,730,411,319,1261,727,507,819,463,313
060770051382,414,193,221,422,187,235,487,262,217,345,168,161
060770051381,403,195,208,406,188,218,806,452,340,601,297,273
060770051331,339,171,168,345,165,180,407,207,186,419,178,219
060770051332,495,250,245,499,238,261,545,276,250,592,253,305
060770051224,370,170,200,376,163,213,548,297,239,445,213,208
060770051222,264,122,142,273,118,155,309,167,137,291,139,136
060770049032,629,219,410,647,214,433,854,283,559,677,215,425
060770049031,443,146,297,454,145,309,519,170,336,448,145,275
060770049041,416,140,276,424,137,287,609,200,398,457,153,276
060770049051,478,149,329,487,146,341,695,188,494,544,161,353
060770049063,324,77,247,332,59,273,415,88,323,363,90,252
060770049042,494,172,322,506,164,342,709,236,459,549,168,350
060770049043,415,144,271,415,135,280,525,171,346,407,128,252
060770049044,421,161,260,427,155,272,650,215,419,450,179,248
060770050013,469,141,328,479,130,349,481,155,319,439,105,314
060770050014,690,207,483,704,200,504,828,275,536,649,164,442
060770050011,522,151,371,528,149,379,724,234,487,480,132,317
060770050012,910,263,647,930,268,662,1085,314,756,934,211,669
060770050033,794,218,576,800,206,594,1013,298,689,902,223,625
060770050041,676,191,485,688,185,503,575,168,399,422,95,306
060770050042,671,218,453,679,211,468,1043,330,687,748,241,454
060770050043,420,136,284,428,132,296,922,296,602,771,218,504
060770050044,619,164,455,629,166,463,768,226,519,616,169,410
060770050034,563,165,398,571,160,411,954,307,630,418,126,277
060770050032,781,238,543,788,229,559,1112,369,715,994,290,653
060770051272,381,249,132,389,245,144,639,404,220,525,354,145
060770051273,487,316,171,493,309,184,769,483,264,567,368,162
060770051271,502,328,174,505,318,187,854,542,297,622,412,175
060770051291,336,218,118,343,209,134,513,327,173,378,246,112
060770051292,569,369,200,576,351,225,776,491,265,592,368,187
060770051301,205,133,72,208,126,82,336,208,112,283,171,90
060770051302,433,281,152,441,267,174,769,486,262,653,392,222
060770051191,643,461,182,656,452,204,1316,882,406,923,645,236
060770051193,895,596,299,909,585,324,1033,656,361,891,573,286
060770051194,370,270,100,378,262,116,1059,714,326,665,483,147
060770015023,192,125,67,189,120,69,528,305,200,255,168,74
060770015022,105,67,38,106,67,39,390,228,149,159,105,46
060770017001,133,85,48,133,84,49,242,146,93,189,127,53
060770008021,165,143,22,163,133,30,377,282,91,239,194,40
060770017002,183,133,50,185,131,54,294,214,77,249,177,59
060770027011,121,87,34,124,87,37,233,149,80,178,109,57
060770037003,91,62,29,92,62,30,54,34,18,186,107,71
060770037002,224,125,99,226,121,105,387,218,163,306,161,133
060770048004,667,187,480,676,175,501,845,264,567,710,213,468
060770049062,383,96,287,385,84,301,602,168,421,380,98,266
060770051311,216,94,122,221,85,136,542,270,250,302,157,133
060770011013,427,249,178,435,239,196,630,377,239,528,314,189
060770011022,302,186,116,308,179,129,476,280,178,369,215,129
060770011024,226,140,86,230,135,95,381,230,145,288,175,94
060770027012,153,103,50,155,99,56,247,159,84,180,116,55
060770027013,265,178,87,268,173,95,483,306,159,361,231,112
060770027014,357,233,124,360,223,137,553,360,189,512,344,154
060770037001,209,135,74,215,133,82,376,223,149,275,158,106
060770010001,313,179,134,316,168,148,561,313,238,396,223,147
060770010003,580,306,274,583,294,289,831,462,347,748,379,319
060770031101,386,195,191,386,187,199,348,208,136,405,200,177
060770035021,412,169,243,417,163,254,489,194,288,486,166,302
060770036011,285,91,194,291,86,205,341,106,227,338,121,195
060770036012,354,129,225,361,121,240,432,170,258,384,139,233
060770036013,217,83,134,220,80,140,280,106,170,262,95,156
060770036014,301,106,195,303,98,205,453,148,294,367,147,201
060770036021,356,106,250,365,100,265,366,114,247,235,60,167
060770036022,224,71,153,227,67,160,674,210,447,479,131,326
060770047044,464,137,327,472,123,349,566,168,391,475,162,287
060770027021,184,129,55,189,125,64,283,185,95,255,187,53
060770027022,193,135,58,194,128,66,323,205,108,277,203,63
060770027023,191,134,57,196,129,67,299,188,99,267,188,70
060770035023,322,135,187,325,130,195,415,191,219,375,188,164
060770035022,357,146,211,364,141,223,452,179,266,436,182,234
060770048001,381,106,275,386,99,287,499,155,337,448,130,296
060770048002,672,186,486,682,166,516,733,229,488,705,182,487
060770048003,334,86,248,336,81,255,475,147,322,441,128,287
060770047041,428,113,315,439,106,333,591,172,410,498,152,318
060770035011,619,243,376,628,245,383,906,361,533,668,296,340
060770035012,553,218,335,562,219,343,728,288,424,608,241,342
060770036023,318,120,198,322,114,208,483,150,318,369,134,212
060770041072,425,140,285,423,135,288,736,283,444,528,182,321
060770046001,439,141,298,444,132,312,701,224,470,669,205,429
060770046005,293,90,203,295,88,207,451,152,290,363,106,236
060770047011,371,114,257,381,112,269,566,166,388,395,119,260
060770047012,545,170,375,560,167,393,799,230,550,703,209,462
060770047043,522,154,368,524,136,388,696,201,480,681,176,473
060770047031,556,142,414,568,136,432,600,171,418,506,119,362
060770047042,544,135,409,551,130,421,552,159,384,510,118,369
060770046003,552,163,389,561,149,412,657,183,466,540,160,352
060670095011,463,164,299,471,157,314,447,176,260,325,130,172
060770041061,344,94,250,346,94,252,612,224,376,411,131,266
060770041062,342,83,259,347,84,263,402,133,261,422,108,295
060770040011,357,153,204,362,141,221,554,207,338,411,177,215
060770040012,275,135,140,278,125,153,331,166,160,302,149,136
060770046002,423,103,320,430,103,327,575,213,357,528,136,370
060770047032,513,131,382,525,122,403,641,183,448,588,151,404
060770047033,440,113,327,450,108,342,624,180,440,516,132,361
060770041054,538,185,353,548,176,372,805,294,494,666,238,379
060770041053,366,127,239,370,118,252,551,202,337,469,168,278
060670094061,501,146,355,506,140,366,621,185,425,483,140,314
060770052151,501,215,286,507,212,295,684,306,363,597,260,303
060770055021,374,159,215,383,160,223,715,367,343,387,169,198
060770055022,335,133,202,341,126,215,454,193,255,406,166,216
060770055032,174,66,108,179,65,114,373,134,233,309,111,184
060770055033,177,69,108,180,66,114,42,16,26,76,28,43
060770052251,238,113,125,241,104,137,339,176,159,264,130,116
060770052233,271,107,164,280,105,175,384,159,213,396,179,201
060770052211,1401,956,445,1419,952,467,2420,1642,723,1554,1064,410
060770052212,522,361,161,528,357,171,872,594,265,698,468,188
060770052221,524,363,161,535,355,180,713,481,212,668,445,185
060770052222,563,389,174,565,384,181,811,546,248,548,360,152
060770052231,689,473,216,696,459,237,1612,1082,495,780,551,188
060770052232,156,107,49,152,103,49,1165,782,362,0,0,0
060770051312,510,171,339,512,160,352,625,222,393,551,159,365
060770049061,272,68,204,275,57,218,322,80,236,297,80,202
060770050031,402,95,307,410,84,326,545,138,393,438,105,318
060770049053,308,62,246,314,62,252,396,103,289,427,86,311
060770049052,354,91,263,362,88,274,548,139,396,380,102,253
060770039001,156,72,84,155,70,85,220,93,121,178,81,88
060770039002,161,50,111,168,47,121,206,88,114,187,67,111
060670094062,542,165,377,552,157,395,725,213,494,604,181,390
060779800001,2,1,1,2,1,1,28,12,16,4,2,2
060930002001,335,89,246,335,91,244,422,120,298,412,107,274
060930003001,705,187,518,712,180,532,915,242,659,812,189,584
060930001001,323,65,258,325,61,264,333,96,231,319,69,230
060930002002,143,34,109,142,34,108,205,53,151,178,35,135
060930003002,448,119,329,455,113,342,624,161,445,616,150,423
060930003003,504,179,325,512,169,343,655,208,426,587,202,350
060930007011,595,156,439,601,150,451,436,111,322,385,81,283
060930012002,387,151,236,387,136,251,410,172,229,346,120,198
060930012001,295,120,175,299,111,188,374,157,211,326,117,182
060930011001,271,155,116,276,147,129,340,177,159,285,148,110
060930011003,350,213,137,353,203,150,493,292,179,386,198,148
060930009012,791,432,359,793,417,376,807,439,351,710,350,310
060930010032,480,297,183,493,293,200,594,356,218,469,254,151
060930010033,671,427,244,687,423,264,994,619,345,815,466,266
060930010034,345,200,145,349,198,151,525,321,190,371,197,130
060930010021,875,489,386,886,477,409,1134,599,513,965,433,441
060930010011,589,302,287,594,292,302,893,433,436,710,316,327
060930009023,236,91,145,236,87,149,283,108,172,256,86,151
060930009014,237,132,105,237,126,111,386,184,185,257,118,118
060930007013,564,138,426,573,128,445,563,146,404,575,122,422
060930007014,295,78,217,297,74,223,437,105,324,360,80,264
060930009021,158,59,99,155,54,101,241,90,150,313,139,162
060930009022,1042,466,576,1053,441,612,1455,679,746,1200,479,642
060930009011,237,136,101,237,129,108,203,104,97,187,89,84
060930007023,429,161,268,431,152,279,614,233,359,517,164,310
060930013004,330,118,212,332,114,218,358,104,250,364,108,231
060930013001,376,163,213,385,160,225,383,148,227,359,120,208
060930013003,209,73,136,212,71,141,259,110,143,228,89,121
060930006002,435,128,307,440,125,315,573,178,380,530,127,368
060930007012,433,142,291,435,133,302,579,197,372,458,122,309
060930007021,564,226,338,577,215,362,813,291,503,668,217,399
060930007033,515,174,341,521,167,354,732,251,465,661,188,423
060930008003,268,84,184,274,83,191,393,125,258,331,88,219
060930008002,286,107,179,287,107,180,412,150,253,383,128,225
060930011002,233,141,92,236,136,100,301,181,113,255,132,100
060930010031,523,334,189,540,329,211,443,277,161,348,197,115
060930009013,136,78,58,137,75,62,284,140,133,239,113,106
060930009015,157,91,66,160,87,73,187,90,91,161,77,72
060930007022,328,105,223,329,101,228,632,195,417,458,123,301
060930007032,436,165,271,442,159,283,618,233,360,522,180,306
060930007031,255,96,159,254,92,162,355,135,208,294,99,174
060930008004,587,177,410,592,173,419,923,286,614,748,190,508
060930013002,141,58,83,142,54,88,218,78,134,216,62,131
060930008001,220,79,141,223,79,144,290,95,187,254,81,158
060930006001,226,76,150,228,72,156,361,124,221,279,84,172
060830015001,807,488,319,823,499,324,801,538,245,772,469,260
060830017061,758,472,286,772,472,300,1071,724,316,877,567,263
060830017063,264,167,97,270,164,106,370,252,109,396,238,134
060830015002,430,237,193,442,247,195,563,374,178,510,304,180
060830017064,364,246,118,371,244,127,408,284,114,384,245,117
060830007003,608,397,211,623,402,221,426,309,108,438,293,116
060830005011,929,682,247,951,696,255,730,563,156,911,652,209
060830005012,788,577,211,813,585,228,801,622,164,986,707,220
060830007002,791,543,248,809,547,262,1138,835,281,962,647,243
060830001021,883,631,252,906,644,262,1070,788,262,972,660,250
060830018001,474,160,314,484,157,327,463,159,292,363,108,227
060830016011,542,337,205,553,332,221,566,399,153,531,340,157
060830016012,949,618,331,966,602,364,1411,1016,367,1064,702,284
060830016013,961,618,343,987,624,363,957,685,248,1030,648,315
060830017041,579,395,184,589,395,194,936,661,251,701,493,169
060830017062,546,341,205,560,336,224,593,415,167,597,374,185
060830016042,305,221,84,311,219,92,414,299,108,297,208,71
060830017065,374,253,121,381,249,132,482,339,136,455,294,139
060830014031,950,527,423,976,546,430,1055,698,334,939,593,290
060830014041,530,298,232,540,304,236,716,476,228,674,412,226
060830015003,479,280,199,492,291,201,630,413,199,602,367,202
060830007004,905,638,267,920,628,292,1385,1031,328,961,608,296
060830014042,410,243,167,420,254,166,433,293,133,384,242,120
060830005021,672,520,152,684,523,161,769,605,146,531,408,98
060830005013,507,392,115,517,397,120,766,616,131,570,439,106
060830005022,451,350,101,453,345,108,619,477,129,432,329,79
060830016044,1107,787,320,1127,779,348,901,653,232,734,494,194
060830017042,200,140,60,204,138,66,710,511,184,592,432,125
060830016041,431,315,116,436,308,128,686,494,174,493,349,113
060830016043,336,245,91,341,242,99,584,423,154,520,366,127
060830009001,665,527,138,679,525,154,800,652,138,761,588,118
060830009003,202,158,44,206,157,49,267,217,50,172,134,26
060830006003,562,405,157,578,405,173,524,382,128,494,354,117
060830007001,568,375,193,580,371,209,963,769,178,447,313,107
060830008051,394,274,120,401,275,126,605,474,124,450,301,111
060830012061,464,358,106,475,365,110,577,444,115,492,364,98
060830012063,328,274,54,333,263,70,514,424,73,410,335,48
060830008061,278,237,41,283,232,51,578,493,72,557,463,64
060830010022,320,274,46,325,271,54,482,396,73,593,475,81
060830011021,499,423,76,509,418,91,552,475,70,579,464,82
060830011022,338,296,42,340,287,53,604,517,76,445,362,46
060830011023,191,168,23,193,163,30,364,312,46,243,196,26
060830012062,286,253,33,288,244,44,531,455,67,357,293,37
060830011011,465,384,81,476,379,97,615,490,111,300,244,40
060830011012,307,262,45,314,259,55,461,393,60,543,444,68
060830011013,361,309,52,361,301,60,358,308,47,382,313,48
060830003011,286,236,50,291,233,58,357,304,49,313,253,41
060830003012,431,356,75,442,354,88,605,509,83,552,449,70
060830003013,362,306,56,370,303,67,464,388,64,389,314,52
060830004001,688,523,165,705,534,171,782,628,139,715,529,154
060830004004,577,461,116,591,472,119,686,561,108,543,425,82
060830004005,616,503,113,629,509,120,866,714,131,632,498,98
060830009002,492,413,79,503,413,90,642,535,93,536,427,74
060830010021,365,313,52,371,310,61,483,404,68,463,370,63
060830010023,534,446,88,548,445,103,677,562,103,599,465,84
060830010011,468,406,62,476,409,67,597,504,79,508,405,66
060830001032,915,607,308,938,611,327,1206,872,311,477,309,131
060830006004,386,324,62,397,324,73,492,415,69,414,331,56
060830006006,290,224,66,296,221,75,394,300,84,355,264,72
060830010012,554,462,92,561,456,105,692,571,105,647,501,90
060830008011,262,204,58,272,204,68,442,350,83,361,275,60
060830008063,354,300,54,355,288,67,488,416,70,404,333,52
060830004002,418,323,95,429,329,100,443,359,78,434,329,78
060830004003,449,367,82,457,368,89,547,448,86,378,297,52
060830006001,363,270,93,374,274,100,345,276,65,364,272,74
060830006002,514,377,137,527,377,150,538,403,126,528,386,117
060830006005,549,434,115,558,425,133,895,721,157,585,442,112
060830008012,528,457,71,534,443,91,603,519,75,690,576,80
060830008013,444,386,58,452,372,80,469,407,58,497,415,55
060830008062,406,355,51,410,339,71,551,466,67,504,422,55
060830008064,318,272,46,325,264,61,520,445,64,525,439,59
060830005023,324,251,73,332,251,81,559,425,123,463,350,84
060830005024,611,433,178,629,433,196,785,598,177,661,452,161
060830005025,488,313,175,501,312,189,593,448,136,497,328,137
060830005026,877,645,232,895,652,243,1127,872,229,941,681,203
060830001031,713,425,288,729,431,298,872,546,299,512,325,155
060830019071,406,213,193,412,210,202,519,310,204,397,195,183
060830029071,1034,621,413,1062,624,438,857,570,264,443,260,151
060830001011,767,498,269,779,493,286,970,701,253,1147,741,336
060830030051,460,324,136,470,318,152,459,331,113,1001,647,289
060830002022,532,400,132,541,398,143,896,660,219,700,499,152
060830013061,906,629,277,935,638,297,1044,774,251,899,614,237
060830013063,426,257,169,428,248,180,463,333,122,485,287,165
060830001013,673,458,215,682,449,233,806,601,190,723,467,215
060830029073,441,257,184,455,256,199,451,294,146,381,219,136
060830029131,1164,756,408,1185,748,437,1407,992,383,1131,729,327
060830029132,902,589,313,915,585,330,1105,786,296,965,628,274
060830029322,909,573,336,926,579,347,1180,797,352,987,608,310
060830030012,610,437,173,618,430,188,598,463,125,539,383,130
060830030041,709,476,233,719,464,255,892,635,241,783,539,194
060830030072,664,427,237,682,432,250,744,531,195,881,552,277
060830030071,625,359,266,639,361,278,646,404,225,773,455,274
060830001022,233,168,65,237,169,68,414,307,94,348,238,86
060830001024,695,519,176,709,516,193,887,678,191,722,503,177
060830001014,746,528,218,763,522,241,717,532,170,691,477,175
060830001023,538,399,139,545,395,150,835,638,179,761,549,161
060830030052,805,537,268,834,549,285,1081,782,278,1145,728,343
060830030073,823,457,366,845,472,373,1061,683,352,893,517,333
060830030042,864,584,280,878,570,308,1133,814,301,951,617,270
060830030053,767,544,223,782,535,247,1356,1008,318,1216,797,338
060830030043,721,497,224,738,489,249,1089,801,261,1083,693,325
060830001012,612,421,191,619,419,200,869,639,208,742,502,187
060830001033,473,267,206,482,271,211,626,394,214,566,362,170
060830029143,857,532,325,874,533,341,1093,748,322,953,589,306
060830029072,727,437,290,749,442,307,1367,913,426,186,114,58
060830002011,459,348,111,466,342,124,467,358,101,452,340,84
060830002012,825,524,301,848,523,325,1000,742,238,833,534,258
060830013071,254,211,43,258,206,52,549,444,89,213,167,33
060830012081,391,285,106,399,286,113,673,506,148,482,329,116
060830012082,453,332,121,466,334,132,514,390,112,506,353,112
060830012085,416,305,111,425,305,120,489,374,111,407,279,100
060830012083,341,251,90,351,253,98,522,393,116,477,340,99
060830012084,366,275,91,379,277,102,486,374,101,411,302,78
060830013081,400,310,90,413,310,103,501,390,101,393,294,70
060830013082,361,279,82,373,280,93,456,360,93,348,263,62
060830013062,571,398,173,589,405,184,667,500,154,708,501,172
060830013074,695,503,192,708,504,204,736,573,149,621,439,147
060830013083,429,315,114,436,318,118,511,390,110,459,329,103
060830013084,412,308,104,421,314,107,495,387,103,543,409,104
060830013085,457,361,96,466,361,105,483,372,100,636,488,113
060830012032,1117,827,290,1138,824,314,1314,997,293,924,640,230
060830012031,338,266,72,343,261,82,390,302,77,544,404,103
060830011014,423,347,76,432,343,89,432,346,81,683,538,115
060830013073,526,394,132,537,392,145,653,509,132,395,285,89
060830013072,274,197,77,280,197,83,537,418,109,355,251,84
060830002021,419,311,108,426,310,116,540,399,127,488,368,91
060830003023,491,421,70,502,422,80,612,512,89,441,352,56
060830003024,196,168,28,201,170,31,396,328,59,233,189,29
060830003025,242,208,34,247,208,39,421,349,61,337,268,44
060830003021,345,283,62,350,285,65,371,310,55,368,287,61
060830003022,296,242,54,302,246,56,327,272,49,304,235,50
060830030013,304,218,86,306,213,93,353,268,75,453,320,109
060830030011,186,152,34,192,149,43,383,296,80,153,122,25
060830030014,356,290,66,359,282,77,771,595,161,456,359,71
060830030015,130,107,23,135,105,30,322,248,68,196,153,32
060839800001,220,174,46,223,170,53,7,3,4,6,4,2
060830029061,575,351,224,586,340,246,638,429,197,598,365,201
060830029331,147,115,32,151,114,37,607,462,128,248,179,47
060830029141,361,230,131,369,232,137,443,295,135,358,235,103
060830029142,541,345,196,557,350,207,772,534,220,572,376,163
060830029062,902,530,372,925,525,400,1189,791,365,1041,663,318
060830029063,708,431,277,725,423,302,948,609,316,807,485,277
060830029091,905,623,282,925,617,308,1369,966,373,1034,685,275
060830029092,731,461,270,750,455,295,887,626,240,816,510,250
060830029093,889,580,309,904,573,331,1168,828,310,1034,676,291
060830019111,720,304,416,734,299,435,654,336,310,669,325,301
060830019121,951,477,474,965,448,517,1413,779,597,1140,551,498
060830019123,689,341,348,703,337,366,904,497,382,550,256,262
060830019091,838,381,457,863,393,470,697,352,329,613,283,295
060830019092,947,438,509,972,453,519,1659,867,755,1185,572,554
060830019051,564,247,317,579,248,331,903,439,448,856,428,380
060830019053,476,198,278,487,200,287,627,303,311,503,236,233
060830019083,548,232,316,558,230,328,674,327,329,357,147,190
060830019084,571,296,275,585,290,295,763,438,312,344,204,115
060830029321,190,117,73,188,113,75,231,143,82,308,172,114
060830031021,278,125,153,283,126,157,414,196,209,323,147,155
060830029361,1106,998,108,1141,1009,132,975,861,82,1358,1117,116
060830029371,139,114,25,141,113,28,145,134,10,166,90,61
060839802001,166,54,112,169,54,115,280,146,107,181,76,78
060839805001,6,2,4,6,2,4,9,2,7,17,9,7
060830028093,338,151,187,344,145,199,612,282,314,422,186,205
060830028094,962,346,616,980,352,628,978,429,519,903,326,517
060830025031,179,101,78,181,93,88,647,414,218,307,218,75
060830020061,681,200,481,691,192,499,1036,349,664,685,189,455
060830028081,555,221,334,564,213,351,153,74,72,106,43,51
060830020132,813,250,563,827,234,593,982,379,577,957,289,628
060839803001,1993,1822,171,2045,1832,213,261,239,15,2888,2415,248
060830029333,356,262,94,366,261,105,437,334,94,512,361,116
060830029334,526,493,33,537,496,41,224,206,12,617,516,37
060830029332,691,649,42,704,642,62,381,348,20,1070,893,116
060830029351,695,541,154,707,533,174,1116,848,236,939,725,116
060830029372,1077,855,222,1098,855,243,1001,792,180,961,628,264
060830029241,681,628,53,701,632,69,539,475,46,811,676,78
060830029242,689,630,59,708,637,71,659,589,56,1038,867,92
060830029243,337,305,32,344,309,35,334,293,29,715,588,68
060830029244,436,391,45,448,394,54,581,517,50,698,565,75
060830029262,727,680,47,755,695,60,643,568,55,1249,1032,119
060830029261,521,477,44,540,481,59,664,589,56,814,659,74
060830029263,424,364,60,438,372,66,612,543,52,463,361,50
060830029362,303,273,30,308,272,36,708,620,60,620,498,58
060830019101,439,212,227,451,219,232,480,259,209,464,219,222
060830019081,879,397,482,904,391,513,1187,570,593,2121,856,1128
060830019082,639,225,414,642,224,418,662,316,330,17,6,9
060830019052,359,165,194,366,164,202,488,238,242,432,235,159
060830028084,938,422,516,957,396,561,1705,786,869,1214,537,584
060830028082,537,200,337,546,193,353,826,380,422,622,234,339
060830028083,459,169,290,468,165,303,710,329,362,527,199,285
060830028085,823,314,509,836,311,525,1031,479,524,1142,440,634
060830028092,415,187,228,422,177,245,645,286,342,448,197,217
060830019112,514,255,259,522,244,278,747,389,339,564,261,271
060830028091,377,130,247,384,134,250,510,202,293,469,167,274
060830020113,338,222,116,348,204,144,547,339,192,474,270,167
060830029341,515,382,133,522,374,148,865,657,184,432,298,108
060830029352,536,409,127,548,403,145,649,492,136,691,468,183
060830029342,893,646,247,909,635,274,951,724,201,743,521,174
060830019102,471,214,257,480,212,268,480,262,209,415,188,200
060830019103,425,195,230,435,193,242,618,335,267,535,242,258
060830019122,524,260,264,532,252,280,740,409,315,759,361,352
060839804001,40,16,24,41,17,24,53,11,40,239,86,135
060830025041,287,210,77,291,193,98,497,339,152,329,247,61
060830025043,555,405,150,561,379,182,757,512,230,632,457,143
060830025042,344,252,92,345,238,107,439,295,132,432,305,103
060830028062,316,163,153,322,161,161,355,212,143,365,200,146
060830031022,402,197,205,411,191,220,412,227,162,408,183,184
060830031023,528,274,254,538,265,273,577,317,233,633,302,289
060830020112,385,158,227,393,149,244,465,233,225,374,194,162
060830024093,772,434,338,785,399,386,1163,693,454,574,320,216
060830020062,468,157,311,479,167,312,651,228,415,467,159,291
060830020111,890,279,611,906,282,624,1276,538,710,1028,351,620
060830020052,599,202,397,611,198,413,856,327,518,763,239,479
060830020053,792,267,525,800,259,541,972,369,586,817,277,490
060830020051,492,154,338,502,150,352,507,173,324,412,113,273
060830020054,602,192,410,616,192,424,838,318,503,823,245,522
060830020122,467,175,292,480,176,304,655,248,391,534,184,314
060830020123,375,152,223,383,149,234,640,247,389,461,169,265
060830020131,657,223,434,667,210,457,805,306,478,651,202,413
060830020121,624,196,428,641,198,443,710,271,416,624,190,403
060830020091,676,231,445,691,224,467,1001,398,576,671,222,410
060830020092,534,169,365,546,167,379,685,272,393,572,175,357
060830020093,464,165,299,475,159,316,775,308,444,722,214,453
060830020102,427,143,284,431,139,292,569,217,343,459,150,285
060830020103,364,122,242,367,118,249,509,191,303,442,144,273
060830020101,940,334,606,967,315,652,1122,424,672,1016,336,616
060830020104,304,107,197,311,101,210,505,190,299,372,120,230
060830020082,599,216,383,611,211,400,913,365,518,750,249,453
060830020083,453,170,283,463,162,301,645,263,364,449,151,264
060830020081,782,285,497,794,275,519,1022,418,580,860,299,504
060830020084,695,245,450,708,240,468,1000,403,558,937,312,565
060830020152,364,136,228,372,131,241,557,226,312,489,185,269
060830020153,472,176,296,482,172,310,629,263,360,537,203,307
060830020154,518,193,325,530,193,337,482,212,263,383,159,205
060830027031,577,309,268,590,296,294,723,412,299,529,287,209
060830027032,643,325,318,658,312,346,840,482,345,651,337,252
060830027061,407,208,199,415,197,218,531,303,227,419,227,169
060830027062,256,139,117,268,134,134,576,324,230,511,284,192
060830028021,547,260,287,555,247,308,784,430,340,676,348,285
060830027081,215,105,110,222,105,117,267,151,108,228,111,99
060830027082,387,198,189,397,187,210,437,248,182,460,221,205
060830027083,342,174,168,349,166,183,285,163,118,418,179,204
060830027101,156,94,62,158,85,73,311,187,115,238,136,79
060830027071,197,104,93,202,99,103,256,146,109,233,121,97
060830027103,311,182,129,318,174,144,593,339,232,290,182,87
060830027091,335,185,150,338,176,162,767,428,303,519,288,186
060830027072,222,125,97,222,121,101,336,192,141,241,126,99
060830027073,344,178,166,351,174,177,361,198,145,380,189,161
060830027102,153,100,53,153,92,61,378,236,130,261,162,74
060830027051,344,194,150,350,186,164,358,228,125,535,260,241
060830027052,271,181,90,277,166,111,509,318,176,485,295,154
060830027053,255,150,105,260,143,117,284,181,98,341,193,126
060830027063,221,138,83,228,130,98,617,343,241,312,186,98
060830027065,70,47,23,73,43,30,231,141,79,207,123,65
060830027064,179,112,67,183,103,80,301,173,122,207,121,70
060830028022,581,294,287,590,279,311,712,379,312,593,295,259
060830027092,195,106,89,202,105,97,332,208,118,259,150,90
060830028023,521,280,241,529,267,262,968,520,421,604,316,249
060830028024,751,362,389,759,348,411,985,525,427,885,411,412
060830028061,603,272,331,606,264,342,810,435,356,567,257,274
060830020142,932,420,512,944,409,535,990,479,495,812,367,400
060830020151,419,156,263,436,155,281,409,183,217,455,167,267
060830020143,567,228,339,579,220,359,736,329,391,655,262,362
060830020141,420,192,228,430,190,240,1090,511,560,748,338,368
060830024101,434,297,137,438,280,158,307,184,119,278,184,88
060830024092,465,267,198,474,246,228,971,593,357,575,316,221
060830024091,379,254,125,388,244,144,435,283,138,468,276,165
060830024062,83,63,20,83,56,27,271,173,87,156,116,29
060830024051,154,114,40,154,103,51,396,259,126,232,162,58
060830024052,129,98,31,131,88,43,357,234,113,149,113,27
060830024071,155,106,49,157,101,56,322,216,106,304,198,86
060830024072,68,54,14,67,48,19,159,135,22,175,131,31
060830023071,340,227,113,345,209,136,523,333,181,492,307,159
060830022112,658,266,392,667,249,418,792,379,393,768,329,399
060830022114,329,139,190,334,135,199,306,159,136,326,139,170
060830021032,364,225,139,373,217,156,768,431,314,531,295,207
060830021033,359,176,183,367,177,190,455,232,214,358,200,141
060830021021,342,210,132,348,205,143,442,244,191,206,126,69
060830021031,163,103,60,167,98,69,418,235,171,288,159,112
060830024103,240,165,75,244,155,89,412,259,142,363,223,123
060830024102,58,42,16,61,40,21,204,130,63,349,227,102
060830021011,555,319,236,567,313,254,908,490,408,432,248,166
060830021012,324,163,161,331,160,171,797,386,400,458,228,209
060830021022,191,111,80,194,108,86,380,195,177,246,130,99
060830024081,155,105,50,158,104,54,312,216,93,528,319,187
060830024061,64,44,20,66,44,22,214,140,67,199,124,57
060830022111,564,244,320,573,244,329,503,245,253,429,191,215
060830022113,642,298,344,649,284,365,771,407,335,760,342,376
060830022101,677,363,314,678,338,340,1124,602,494,892,468,374
060830022102,459,214,245,467,213,254,627,336,272,639,300,298
060830022103,414,210,204,419,197,222,653,351,287,572,295,237
060830022061,404,225,179,411,217,194,600,339,253,382,199,165
060830022062,236,132,104,239,126,113,607,324,263,359,204,128
060830022051,271,156,115,277,142,135,290,179,99,386,181,182
060830022052,301,171,130,308,167,141,352,221,121,342,172,145
060830022053,100,58,42,102,55,47,529,330,182,379,226,123
060830022091,315,193,122,322,183,139,441,278,156,449,266,154
060830022092,259,148,111,267,137,130,304,194,105,317,188,108
060830022063,165,94,71,174,94,80,323,205,113,226,135,76
060830023035,126,88,38,129,81,48,188,124,54,156,114,31
060830023033,142,103,39,144,95,49,286,187,94,138,106,28
060830023034,114,83,31,117,77,40,274,178,90,133,100,26
060830023042,106,75,31,109,70,39,241,160,73,220,158,48
060830023043,172,121,51,172,109,63,310,203,98,240,180,47
060830023044,119,83,36,119,76,43,353,239,106,323,243,65
060830023031,175,131,44,176,126,50,401,251,140,242,152,72
060830023032,168,126,42,169,120,49,298,187,103,245,181,51
060830023041,62,49,13,64,44,20,176,119,57,115,72,39
060830023101,232,155,77,230,146,84,354,219,123,282,214,52
060830023102,226,154,72,230,147,83,364,227,127,304,231,57
060830023081,643,405,238,652,381,271,766,493,263,750,458,248
060830023091,214,158,56,218,147,71,586,371,192,298,223,56
060830023092,230,170,60,235,156,79,629,403,209,333,260,60
060830023082,303,163,140,305,156,149,216,139,73,229,135,84
060830023072,423,226,197,429,217,212,625,407,211,737,443,264
060830023073,222,150,72,224,138,86,393,256,133,364,215,128
060650301011,245,173,72,247,170,77,366,262,97,339,233,84
060650422092,185,133,52,187,133,54,373,277,86,241,169,60
060650422091,258,179,79,257,173,84,348,255,85,392,263,100
060650422101,265,202,63,267,197,70,305,227,69,316,233,60
060650422102,370,287,83,370,279,91,478,347,118,425,310,83
060650422103,286,229,57,286,222,64,419,310,95,309,247,38
060650305021,127,107,20,132,106,26,272,209,61,192,155,27
060650465022,38,35,3,37,34,3,10,8,2,188,151,23
060650465021,61,53,8,61,51,10,132,98,30,116,93,14
060650465024,285,249,36,285,239,46,401,296,91,315,253,39
060650465025,158,138,20,159,133,26,305,226,68,287,230,36
060650304001,106,87,19,106,85,21,436,334,89,226,177,33
060650304002,226,185,41,227,177,50,351,272,72,309,246,41
060650304003,230,191,39,232,180,52,228,180,48,191,157,28
060650304004,190,154,36,190,148,42,254,200,54,210,168,29
060650304005,257,211,46,254,199,55,447,344,93,385,308,54
060650305011,189,160,29,188,152,36,354,273,73,247,202,25
060650305012,237,191,46,247,192,55,280,219,58,298,243,47
060650305022,132,112,20,134,108,26,258,201,53,166,141,18
060650305031,85,73,12,87,70,17,227,175,48,131,111,13
060650305032,188,160,28,188,151,37,420,320,86,283,234,28
060650305033,102,86,16,102,82,20,291,219,59,211,173,22
060650305013,535,421,114,546,424,122,584,443,119,721,573,114
060650422093,296,260,36,299,256,43,461,311,134,352,301,31
060650465011,321,296,25,328,296,32,1089,740,318,603,522,45
060650465023,102,90,12,105,90,15,210,141,60,122,104,11
060650422131,618,439,179,627,432,195,480,332,142,721,471,192
060650422141,900,571,329,909,556,353,1369,846,492,889,532,298
060650422132,437,296,141,443,292,151,801,543,234,539,362,140
060650422133,538,364,174,544,356,188,446,304,132,640,415,172
060650422062,498,301,197,506,297,209,569,369,186,629,377,213
060650422064,399,242,157,405,239,166,851,525,305,732,439,249
060650422072,594,310,284,598,310,288,713,426,270,649,330,281
060650422061,598,401,197,602,391,211,701,477,204,829,507,260
060650422063,273,183,90,274,178,96,248,170,73,273,167,86
060650422171,748,469,279,755,462,293,832,495,314,626,357,227
060650425051,153,110,43,154,102,52,495,361,122,361,269,70
060650509012,363,222,141,364,217,147,675,403,256,423,254,141
060650509011,181,111,70,182,108,74,445,266,169,207,124,69
060650509023,280,152,128,280,150,130,425,232,179,320,167,122
060650509021,188,113,75,189,110,79,407,243,157,286,167,99
060650509022,310,189,121,310,184,126,508,303,193,317,190,105
060650422071,933,414,519,946,413,533,941,498,424,1003,447,503
060650422081,691,332,359,698,336,362,646,389,248,647,307,307
060650422082,703,338,365,709,341,368,705,423,269,753,357,358
060650306031,822,371,451,832,369,463,881,459,411,912,424,429
060650306032,462,209,253,465,207,258,510,262,236,530,243,253
060650306033,375,171,204,381,171,210,422,221,198,383,176,183
060650306021,656,307,349,663,306,357,736,382,343,596,264,297
060650312001,346,161,185,347,161,186,472,244,221,360,159,179
060650312005,630,326,304,633,320,313,1167,613,527,908,455,397
060650306023,343,159,184,351,155,196,433,208,218,317,146,157
060650312002,309,167,142,315,162,153,428,222,199,306,161,128
060650312003,454,244,210,459,238,221,737,380,343,549,285,231
060650312004,546,351,195,552,342,210,850,506,325,650,404,207
060650306042,1009,380,629,1022,370,652,1235,538,672,1067,413,595
060650306051,1300,571,729,1311,563,748,1492,754,710,1258,550,645
060650306022,733,272,461,746,268,478,892,384,492,835,322,473
060650313001,243,176,67,241,172,69,377,265,102,321,230,71
060650313002,278,203,75,278,197,81,445,317,122,381,274,85
060650317011,257,187,70,257,182,75,476,332,127,435,310,96
060650317043,313,184,129,315,178,137,511,249,243,303,168,115
060650306041,458,176,282,466,170,296,562,242,303,526,202,289
060650317012,569,257,312,577,250,327,748,365,377,595,263,303
060650420051,1069,403,666,1077,386,691,1337,583,727,1191,457,666
060650420124,584,270,314,595,262,333,989,486,483,713,323,351
060650422172,685,293,392,690,287,403,662,333,315,653,284,332
060650422174,438,187,251,444,185,259,623,314,299,632,275,324
060650422173,625,285,340,638,277,361,833,417,394,748,315,396
060650420123,440,208,232,445,201,244,754,365,379,525,232,255
060650420122,277,144,133,282,140,142,601,302,286,421,205,189
060650420121,607,316,291,620,307,313,1024,513,487,665,325,300
060650420053,425,153,272,427,146,281,645,257,378,570,195,343
060650420182,696,313,383,706,303,403,985,474,491,674,305,330
060650420183,683,309,374,688,297,391,1245,588,626,848,382,413
060650420181,690,343,347,698,330,368,1112,526,559,880,395,440
060650420153,813,372,441,822,368,454,1031,492,525,907,411,453
060650420151,331,158,173,336,157,179,626,298,314,472,212,236
060650420161,981,475,506,988,464,524,1470,700,743,1178,503,612
060650420152,1006,433,573,1015,421,594,1450,683,726,1162,492,603
060650420033,922,391,531,935,379,556,1270,555,690,863,346,475
060650420041,685,255,430,687,243,444,793,314,469,658,240,387
060650420052,449,206,243,454,199,255,960,472,471,609,272,308
060650420171,648,299,349,661,291,370,954,467,466,810,365,403
060650420091,648,271,377,658,270,388,1078,484,571,808,361,405
060650420093,397,184,213,402,175,227,580,280,287,481,231,220
060650420172,656,316,340,664,298,366,1070,523,521,814,391,370
060650315012,205,130,75,207,126,81,359,209,141,267,156,95
060650316023,459,271,188,463,266,197,815,479,317,597,337,217
060650316022,460,273,187,464,267,197,593,346,231,473,269,172
060650314023,479,298,181,485,288,197,679,407,246,450,259,155
060650315031,677,381,296,682,371,311,1053,604,423,764,406,303
060650315032,350,197,153,355,192,163,370,216,144,406,216,161
060650315033,296,166,130,297,161,136,321,188,124,366,195,145
060650315011,352,221,131,349,212,137,442,261,172,283,166,101
060650315016,78,49,29,78,47,31,256,134,110,290,157,109
060650315013,285,180,105,286,175,111,390,226,150,274,158,97
060650315014,241,138,103,242,135,107,192,109,78,165,90,63
060650316011,357,236,121,361,231,130,520,302,200,353,212,117
060650315015,67,31,36,69,32,37,13,6,6,151,55,74
060650316012,184,129,55,183,124,59,344,199,131,223,145,62
060650316013,453,293,160,454,282,172,635,371,245,379,247,108
060650316021,174,121,53,175,119,56,374,222,146,241,159,71
060650414031,877,479,398,882,461,421,1035,600,418,873,446,376
060650414032,459,230,229,459,224,235,1120,585,517,454,231,200
060650414131,1074,458,616,1085,442,643,1433,675,741,1263,571,635
060650317021,350,176,174,354,166,188,548,283,253,488,253,205
060650317022,601,280,321,607,267,340,523,273,241,436,215,198
060650317031,286,139,147,292,135,157,585,301,270,423,195,204
060650317032,764,371,393,775,359,416,1118,577,513,834,366,416
060650317041,431,222,209,433,214,219,759,414,335,567,279,254
060650317042,378,196,182,382,190,192,623,338,268,494,248,214
060650317044,421,217,204,425,209,216,669,369,294,536,271,233
060650315041,516,308,208,525,303,222,801,533,251,688,397,239
060650315042,366,219,147,372,214,158,449,300,139,392,224,138
060650410012,401,296,105,409,293,116,419,258,150,292,210,64
060650411011,125,95,30,126,90,36,439,257,168,257,168,73
060650411012,303,231,72,305,225,80,734,488,223,477,348,98
060650411013,173,132,41,175,128,47,403,269,123,250,183,52
060650412022,365,278,87,368,270,98,556,377,172,389,285,80
060650412023,225,170,55,222,165,57,358,245,112,238,181,51
060650412032,293,213,80,298,211,87,576,386,177,471,339,103
060650412011,512,355,157,515,350,165,613,412,188,608,422,145
060650412021,174,122,52,175,119,56,337,207,119,247,167,64
060650412031,291,201,90,293,199,94,381,253,116,379,265,89
060650412012,401,285,116,401,280,121,642,431,196,472,323,116
060650413021,540,385,155,545,382,163,748,496,227,596,411,148
060650413022,253,175,78,253,171,82,506,312,177,381,256,101
060650409012,438,302,136,443,296,147,642,390,238,467,305,132
060650414071,490,337,153,490,327,163,752,455,278,607,366,203
060650414072,352,242,110,355,237,118,619,375,228,449,292,127
060650414073,357,246,111,359,240,119,602,367,224,462,281,153
060650414051,425,258,167,429,249,180,844,512,317,576,307,238
060650414061,520,324,196,520,312,208,704,428,261,580,341,202
060650414081,304,189,115,305,184,121,616,376,228,355,224,107
060650414082,492,320,172,495,310,185,825,511,295,617,385,183
060650414122,605,314,291,610,305,305,968,478,471,507,290,198
060650414141,606,280,326,611,275,336,747,364,369,555,245,285
060650414142,935,457,478,943,448,495,1332,675,630,1004,460,497
060650414041,618,341,277,623,330,293,785,443,329,689,356,298
060650414042,453,270,183,454,258,196,559,337,206,527,291,206
060650414052,637,380,257,641,363,278,767,467,284,762,402,318
060650410031,701,354,347,706,347,359,855,526,306,843,402,376
060650411021,302,203,99,305,197,108,688,398,272,394,255,118
060650411022,485,314,171,488,308,180,835,482,329,482,311,143
060650413011,326,217,109,325,208,117,676,392,265,383,251,109
060650413012,292,193,99,298,191,107,527,305,208,332,215,97
060650408133,625,194,431,636,190,446,816,245,551,696,207,456
060650409021,523,279,244,530,267,263,547,317,217,491,254,204
060650409042,648,338,310,656,325,331,836,485,331,762,392,317
060650409011,586,360,226,593,353,240,849,503,325,685,390,250
060650409022,777,457,320,783,441,342,658,392,254,709,399,266
060650409031,361,203,158,366,196,170,399,232,159,482,260,193
060650409032,364,214,150,369,210,159,550,323,215,494,275,190
060650409041,284,159,125,286,153,133,490,286,195,455,246,183
060650409013,360,229,131,364,223,141,574,344,218,421,244,149
060650409014,196,102,94,198,99,99,740,441,281,352,190,148
060650409023,602,312,290,614,307,307,713,425,274,606,327,256
060650414063,460,291,169,466,284,182,664,397,252,495,301,163
060650414062,423,268,155,428,261,167,799,476,302,590,359,195
060650422143,667,392,275,673,375,298,994,606,366,803,459,288
060650414133,941,439,502,944,421,523,1469,705,742,1020,487,487
060650414152,731,356,375,741,356,385,1436,725,682,1168,553,552
060650414153,143,74,69,143,70,73,265,144,114,222,106,101
060650420081,272,98,174,279,96,183,426,172,240,309,104,189
060650420084,779,300,479,789,294,495,2105,921,1139,989,346,590
060650420032,546,215,331,551,206,345,783,308,454,673,264,375
060650420031,805,307,498,811,299,512,1241,530,691,947,330,569
060650420042,726,265,461,731,254,477,1065,428,612,792,269,475
060650414132,672,313,359,679,305,374,1037,499,525,752,358,359
060650420072,895,306,589,894,283,611,1211,390,810,904,262,592
060650420083,785,230,555,795,217,578,1092,388,683,889,271,587
060650420082,630,312,318,635,302,333,879,438,427,572,315,228
060650429033,259,110,149,261,107,154,360,158,193,296,137,139
060650420071,941,302,639,947,297,650,1852,655,1181,1046,323,672
060650420094,288,179,109,291,170,121,413,272,129,386,238,131
060650420092,280,174,106,280,165,115,552,366,170,525,327,176
060650420101,223,150,73,224,139,85,389,256,128,352,244,87
060650420103,233,157,76,238,149,89,422,279,141,345,241,83
060650420104,207,144,63,212,136,76,414,261,131,284,209,56
060650420102,110,78,32,108,69,39,174,111,57,121,87,25
060650429063,179,139,40,181,132,49,357,234,108,243,189,40
060650429061,300,232,68,299,220,79,596,403,189,457,356,75
060650429062,282,211,71,285,205,80,538,356,162,445,329,97
060650429052,270,168,102,270,158,112,467,299,155,362,227,116
060650429032,164,99,65,168,97,71,270,167,98,227,137,80
060650467004,253,90,163,261,90,171,244,118,125,298,97,188
060650430103,421,199,222,420,184,236,564,273,277,487,222,244
060650430101,745,343,402,752,325,427,981,464,500,913,416,471
060650430031,361,171,190,367,161,206,889,421,450,447,235,180
060650430033,237,120,117,239,111,128,674,320,337,376,196,151
060650430013,910,486,424,917,461,456,1895,1023,818,580,283,266
060650430081,1037,430,607,1048,400,648,1596,644,918,1064,407,601
060650464012,418,220,198,422,211,211,672,313,344,507,230,246
060650430083,461,172,289,464,169,295,691,276,401,564,231,310
060650464034,632,276,356,637,265,372,1088,500,566,825,329,453
060650430073,760,327,433,768,312,456,954,446,489,739,314,382
060650430091,799,348,451,810,320,490,1306,573,711,1163,466,633
060650430052,397,196,201,399,181,218,480,247,226,270,125,129
060650430092,528,264,264,535,250,285,1088,576,482,718,328,351
060650427493,685,376,309,693,364,329,1075,584,469,756,414,298
060650427502,654,357,297,660,343,317,1035,546,475,694,356,296
060650427491,227,127,100,227,122,105,491,267,217,274,151,107
060650427501,459,208,251,464,201,263,683,324,345,528,220,286
060650430011,211,130,81,212,124,88,636,348,264,574,311,228
060650430053,316,136,180,316,127,189,533,232,289,448,190,238
060650430063,262,135,127,261,125,136,443,233,210,236,125,108
060650430062,182,118,64,184,111,73,505,281,216,238,128,97
060650427492,209,114,95,209,108,101,420,229,185,266,146,105
060650429023,346,146,200,352,143,209,470,209,248,384,175,193
060650427481,673,311,362,684,302,382,925,445,463,695,305,356
060650427482,470,203,267,473,196,277,674,296,365,605,235,346
060650464043,471,203,268,475,191,284,892,400,476,639,268,334
060650427483,816,233,583,830,228,602,1568,527,1020,638,136,480
060650427332,622,248,374,631,239,392,3459,1502,1888,1245,494,692
060650432741,277,127,150,279,119,160,497,239,250,531,212,286
060650464042,635,291,344,646,274,372,980,468,485,796,318,430
060650427331,537,241,296,536,229,307,615,295,309,1018,441,529
060650432742,286,111,175,288,108,180,412,170,229,349,136,189
060650427333,2095,866,1229,2129,838,1291,2691,1211,1438,748,280,432
060650430032,365,185,180,371,175,196,783,392,378,503,242,225
060650430051,485,244,241,496,234,262,1025,522,483,559,258,261
060650430102,369,187,182,370,174,196,608,310,295,657,301,323
060650430012,160,90,70,160,84,76,471,262,200,409,222,161
060650430061,320,202,118,321,193,128,655,365,282,518,276,205
060650464041,459,254,205,463,243,220,482,252,223,375,190,156
060650464033,252,116,136,255,111,144,506,245,248,373,148,209
060650419103,702,317,385,713,314,399,1538,706,798,568,243,304
060650419102,523,234,289,526,228,298,1000,483,504,868,387,438
060650419152,477,226,251,483,228,255,1032,527,488,526,237,265
060650419153,749,333,416,764,332,432,1399,704,670,1069,498,516
060650419104,688,256,432,693,250,443,1021,505,505,1069,410,628
060650419101,739,276,463,745,270,475,588,290,293,567,218,335
060650419151,997,397,600,1013,391,622,1108,508,587,975,377,562
060650419154,722,351,371,728,339,389,448,224,222,365,152,204
060650481002,949,395,554,959,389,570,1407,625,759,1050,422,592
060650419141,776,424,352,784,413,371,2227,1115,1082,1086,545,488
060650419142,484,268,216,490,259,231,981,484,483,587,295,261
060650430072,729,335,394,735,319,416,1233,578,633,910,392,470
060650430071,741,326,415,752,313,439,1278,600,653,932,398,480
060650464011,538,172,366,546,170,376,787,279,497,661,191,432
060650464021,469,218,251,479,210,269,807,379,423,556,247,272
060650414151,328,202,126,332,198,134,477,278,189,348,208,124
060650427141,1002,227,775,1020,227,793,1415,332,1068,981,211,736
060650427142,557,121,436,562,118,444,798,189,601,679,130,521
060650429072,262,139,123,271,134,137,390,183,200,364,188,162
060650427161,691,160,531,697,155,542,934,219,706,888,177,677
060650427162,699,197,502,709,191,518,924,260,650,799,214,553
060650427163,734,206,528,744,201,543,1161,272,875,807,192,586
060650427172,366,132,234,371,126,245,497,164,326,437,146,270
060650427173,576,213,363,590,205,385,1033,362,648,639,217,388
060650464052,596,220,376,609,214,395,958,379,547,757,270,440
060650464031,384,163,221,388,153,235,588,249,326,461,180,248
060650464032,523,194,329,528,177,351,841,313,513,797,252,494
060650432792,455,166,289,463,158,305,742,275,455,586,201,349
060650432761,913,355,558,922,352,570,920,367,534,1041,381,596
060650432791,943,324,619,949,303,646,1405,517,857,1085,349,658
060650464051,568,206,362,573,198,375,945,351,577,685,228,412
060650432701,1193,451,742,1206,422,784,1874,693,1148,1434,525,841
060650432702,815,277,538,828,265,563,1142,422,697,861,272,536
060650432762,297,114,183,299,113,186,1039,406,614,519,188,299
060650432711,809,276,533,818,258,560,1360,527,809,831,275,508
060650432712,546,198,348,552,183,369,759,274,465,675,236,392
060650432721,845,239,606,859,230,629,868,287,565,569,161,388
060650432723,759,222,537,766,213,553,1116,351,738,897,255,588
060650432272,731,279,452,744,268,476,1067,458,580,831,300,485
060650432274,566,223,343,574,221,353,1062,423,617,515,188,295
060650432781,360,136,224,369,131,238,555,237,308,386,141,226
060650497011,809,246,563,822,237,585,1236,409,803,897,268,588
060650506002,374,143,231,378,136,242,586,214,362,480,152,303
060650430082,238,128,110,237,120,117,465,243,207,360,144,191
060650464022,477,206,271,479,199,280,882,406,457,617,253,331
060650429024,168,126,42,165,122,43,338,236,95,265,188,65
060650429021,106,79,27,105,74,31,197,140,54,152,112,33
060650429051,224,170,54,223,160,63,420,289,123,336,248,68
060650429071,348,264,84,353,252,101,496,357,120,411,306,80
060650429081,251,188,63,253,181,72,553,376,167,414,307,86
060650429034,165,127,38,165,123,42,349,243,92,262,196,50
060650429031,144,112,32,150,110,40,312,224,84,276,201,64
060650428021,304,241,63,301,220,81,659,477,158,700,517,136
060650429022,121,60,61,122,52,70,276,125,145,177,80,86
060650432722,775,176,599,786,172,614,1138,299,827,861,183,646
060650497023,491,136,355,494,129,365,573,182,384,464,126,319
060650512003,606,213,393,614,213,401,1185,493,661,671,232,398
060650512001,419,116,303,421,111,310,565,183,369,456,131,301
060650432541,367,146,221,370,140,230,639,275,347,469,177,260
060650406031,453,279,174,456,266,190,830,509,305,544,311,203
060650406061,291,181,110,293,174,119,548,307,215,334,209,105
060650406062,228,140,88,227,136,91,472,266,191,273,173,88
060650404031,420,243,177,421,229,192,629,360,259,518,294,197
060650404032,188,98,90,191,97,94,439,250,182,373,212,144
060650404033,397,235,162,399,221,178,651,368,265,533,303,203
060650405012,479,284,195,487,270,217,778,442,322,589,330,219
060650405022,299,180,119,304,177,127,412,269,135,642,364,243
060650405021,300,209,91,305,205,100,605,380,207,418,273,122
060650404021,412,218,194,419,212,207,598,340,244,445,238,178
060650410043,245,110,135,247,105,142,281,152,124,268,114,134
060650404022,617,325,292,620,313,307,700,398,289,568,307,229
060650402022,356,174,182,362,171,191,598,351,235,433,217,195
060650404041,421,237,184,422,236,186,648,369,268,557,313,212
060650404042,288,163,125,287,161,126,526,300,219,437,238,177
060650404051,700,336,364,708,321,387,897,475,405,895,409,447
060650405032,754,477,277,764,468,296,1172,607,540,1036,626,365
060650405031,430,277,153,437,275,162,568,295,262,438,272,146
060650406042,578,304,274,589,298,291,839,438,387,716,355,314
060650406043,652,308,344,661,303,358,980,509,453,882,403,430
060650406183,1310,731,579,1326,713,613,2854,1502,1280,384,214,145
060650405023,400,267,133,406,263,143,704,411,279,510,330,158
060650406041,528,233,295,532,229,303,716,376,334,713,308,371
060650406221,222,146,76,223,144,79,565,342,200,460,293,145
060650406162,673,402,271,682,395,287,1409,786,601,576,328,225
060650406051,273,185,88,275,179,96,411,261,141,335,211,105
060650406052,180,122,58,178,116,62,391,250,137,309,195,96
060650405011,548,353,195,552,335,217,904,497,390,552,319,196
060650405013,473,310,163,477,300,177,895,515,367,536,324,186
060650401021,657,416,241,659,401,258,844,512,314,790,472,273
060650401022,441,274,167,440,262,178,932,575,345,599,353,213
060650403032,624,363,261,629,347,282,1027,549,462,647,368,248
060650403031,283,179,104,281,172,109,615,322,282,548,307,213
060650403021,860,385,475,867,365,502,944,483,444,729,343,349
060650404053,742,330,412,745,311,434,940,490,431,800,354,409
060650401012,570,416,154,575,409,166,847,551,285,573,428,124
060650401011,192,159,33,192,155,37,366,286,74,276,238,23
060650402041,164,138,26,167,135,32,362,275,72,222,178,34
060650403043,159,131,28,159,128,31,335,255,67,217,171,34
060650403041,260,209,51,260,203,57,334,252,66,249,196,39
060650403051,363,231,132,366,222,144,710,424,265,425,260,132
060650302001,674,481,193,674,473,201,524,350,168,541,350,149
060650402012,82,58,24,83,57,26,130,77,49,91,54,31
060650402042,181,154,27,180,149,31,557,419,111,365,287,57
060650403042,157,117,40,158,113,45,276,202,67,314,188,103
060650403052,415,254,161,420,241,179,589,366,212,523,304,181
060650402031,216,163,53,214,153,61,369,251,111,305,221,65
060650402032,241,204,37,239,188,51,471,347,119,430,311,93
060650403024,483,247,236,489,241,248,747,384,347,616,305,272
060650403023,431,260,171,437,246,191,786,460,312,682,374,261
060650403022,392,180,212,393,179,214,608,314,281,429,197,211
060650404052,344,155,189,345,155,190,410,195,206,306,132,160
060650402011,499,261,238,512,253,259,626,366,247,599,295,266
060650402021,345,214,131,349,207,142,592,342,231,353,202,124
060650402014,588,377,211,590,364,226,1146,666,451,506,365,109
060650402013,224,144,80,225,138,87,435,255,171,260,167,78
060650308002,298,169,129,298,166,132,325,197,116,315,161,127
060650308003,493,256,237,497,240,257,831,503,296,666,309,309
060650308004,453,238,215,457,225,232,569,348,203,448,208,206
060650307001,587,358,229,596,356,240,570,356,207,511,297,183
060650307002,450,275,175,458,274,184,745,453,267,671,390,230
060650307003,414,244,170,420,242,178,413,256,153,426,229,167
060650307004,359,211,148,363,208,155,362,223,130,389,210,153
060650307005,432,264,168,438,262,176,540,326,191,431,247,150
060650302004,608,356,252,609,351,258,647,397,234,620,334,238
060650302002,385,241,144,392,240,152,553,341,204,494,284,170
060650308001,267,153,114,270,153,117,320,196,117,301,155,120
060650301031,193,129,64,193,125,68,327,215,101,230,140,66
060650301032,260,176,84,263,172,91,425,286,130,344,217,97
060650303001,280,186,94,285,185,100,503,319,173,308,190,88
060650303004,175,118,57,175,114,61,577,356,209,392,245,114
060650303002,207,140,67,207,133,74,566,346,202,210,131,59
060650303003,195,131,64,194,126,68,298,184,107,118,74,33
060650302003,290,197,93,295,194,101,359,223,133,285,186,80
060650301041,547,380,167,551,380,171,1010,676,315,663,456,162
060650301043,165,114,51,166,112,54,321,216,100,222,149,57
060650301042,344,238,106,346,239,107,630,421,194,510,351,125
060650301044,377,252,125,381,239,142,642,424,197,487,303,142
060650423001,587,381,206,593,361,232,960,622,314,693,421,219
060650309001,332,220,112,332,213,119,514,323,183,400,239,133
060650309002,503,330,173,504,320,184,694,428,249,547,325,180
060650310022,310,201,109,312,194,118,652,389,247,429,259,138
060650310023,260,164,96,261,158,103,558,322,216,367,226,115
060650308005,212,129,83,218,127,91,389,218,156,234,145,74
060650310021,342,208,134,346,203,143,698,393,283,408,257,124
060650308006,597,335,262,602,317,285,880,500,362,688,368,279
060650310011,600,330,270,610,320,290,820,466,334,666,350,271
060650311003,427,236,191,435,228,207,558,317,229,459,235,189
060650311001,496,259,237,503,256,247,745,423,303,641,314,275
060650311002,593,310,283,606,308,298,835,476,342,649,317,279
060650310014,361,189,172,370,189,181,428,243,174,436,224,182
060650310013,332,174,158,340,173,167,398,226,162,381,195,160
060650310012,539,283,256,552,281,271,849,483,347,659,337,276
060650314011,265,152,113,271,149,122,545,327,201,421,219,173
060650314012,488,289,199,499,281,218,818,491,305,624,349,226
060650314024,236,140,96,243,136,107,351,214,132,256,144,93
060650314025,298,176,122,303,171,132,485,293,180,389,217,141
060650314014,372,212,160,377,204,173,429,259,161,359,184,154
060650314013,472,262,210,477,261,216,678,393,265,564,308,217
060650314021,342,190,152,344,189,155,555,322,218,444,246,172
060650314022,319,177,142,323,177,146,458,268,179,355,194,137
060650410022,426,266,160,432,254,178,580,356,207,508,290,182
060650410041,355,229,126,362,222,140,474,293,171,420,254,139
060650410011,217,160,57,221,158,63,465,288,168,299,216,65
060650410021,204,151,53,206,146,60,485,301,173,318,226,70
060650410042,278,205,73,283,202,81,721,445,258,465,334,102
060650423003,1007,596,411,1019,572,447,1896,1136,716,680,386,254
060650423002,374,222,152,376,214,162,877,528,329,717,411,268
060650406171,768,427,341,777,418,359,2058,1155,876,1035,581,410
060650406172,1007,553,454,1021,543,478,1090,608,460,719,402,285
060650406181,371,238,133,373,231,142,641,375,259,432,250,149
060650406182,204,133,71,206,130,76,254,146,101,176,97,65
060650406223,652,399,253,654,388,266,1393,828,545,816,487,287
060650406093,1003,503,500,1018,494,524,1383,722,641,1127,583,491
060650406094,718,359,359,730,357,373,1328,696,618,725,375,317
060650415001,99,68,31,100,66,34,361,205,147,110,79,25
060650406092,1237,620,617,1247,611,636,2380,1240,1107,1540,765,703
060650406164,662,373,289,672,371,301,1125,583,519,616,359,234
060650406163,446,253,193,451,251,200,882,462,409,602,350,226
060650406161,645,368,277,652,363,289,1398,725,642,749,436,282
060650406222,407,233,174,410,227,183,663,369,287,488,278,190
060650406211,487,270,217,494,264,230,1037,583,434,712,409,266
060650406212,593,333,260,599,327,272,843,476,353,608,358,226
060650406193,366,202,164,372,199,173,721,394,311,385,220,146
060650406192,350,190,160,350,188,162,643,363,269,484,278,182
060650406113,595,328,267,604,320,284,951,524,409,775,428,313
060650406114,410,227,183,414,226,188,725,399,311,490,259,206
060650406112,813,435,378,826,426,400,1613,867,725,1113,604,457
060650406203,616,343,273,620,339,281,861,478,371,602,319,254
060650406201,608,335,273,620,329,291,1104,609,477,851,470,344
060650406204,655,369,286,661,360,301,1060,551,494,757,429,296
060650406111,420,233,187,424,231,193,681,373,291,506,267,212
060650406202,311,173,138,314,172,142,560,310,241,396,210,167
060650406091,1018,529,489,1032,522,510,2136,1110,993,1022,556,417
060650406191,732,412,320,740,404,336,1249,649,581,882,503,345
060650414102,185,136,49,187,132,55,453,333,108,304,222,67
060650414111,350,266,84,352,254,98,483,327,145,306,234,59
060650414112,319,252,67,322,245,77,482,318,159,356,274,62
060650414121,754,471,283,758,459,299,1197,706,462,891,535,314
060650414101,211,145,66,214,138,76,230,146,71,305,204,82
060650419091,432,194,238,442,190,252,661,313,335,551,252,275
060650419092,383,170,213,385,165,220,473,219,238,373,167,189
060650419093,415,185,230,419,180,239,501,236,253,393,180,195
060650419094,415,186,229,421,182,239,951,421,514,536,208,302
060650481003,608,242,366,614,237,377,851,389,443,691,278,382
060650407011,1036,269,767,1049,261,788,1116,338,762,1113,304,769
060650407031,424,114,310,438,109,329,669,199,460,534,136,372
060650407021,476,147,329,482,138,344,744,220,512,546,154,362
060650407022,500,145,355,510,136,374,729,216,498,570,154,387
060650408131,905,281,624,927,283,644,975,307,643,1339,431,837
060650408122,716,235,481,731,237,494,1061,315,725,821,270,507
060650466011,238,71,167,241,68,173,1777,565,1179,805,235,544
060650466021,518,169,349,527,162,365,508,163,337,421,121,280
060650408082,346,220,126,350,219,131,976,486,465,525,317,174
060650466022,969,298,671,984,284,700,855,271,567,666,191,438
060650408121,481,165,316,486,157,329,786,234,535,532,165,329
060650408132,773,232,541,787,229,558,960,292,652,741,219,486
060650407032,641,188,453,653,184,469,869,257,593,543,158,363
060650408062,523,184,339,533,178,355,563,230,324,661,210,415
060650408061,614,233,381,626,225,401,625,290,318,665,235,390
060650408161,763,418,345,774,414,360,1096,614,453,925,511,363
060650419042,646,291,355,653,285,368,969,464,486,696,294,361
060650419043,363,170,193,367,165,202,635,346,271,469,226,213
060650419052,338,191,147,346,190,156,691,397,275,492,261,198
060650419132,661,322,339,671,313,358,1044,495,525,869,380,425
060650419133,633,293,340,645,294,351,1067,508,540,688,306,343
060650479022,708,295,413,723,295,428,1155,524,607,914,374,498
060650418031,910,388,522,933,391,542,1386,644,716,978,427,497
060650418042,899,376,523,914,365,549,1349,647,675,1001,416,532
060650408143,309,180,129,314,178,136,545,312,223,429,244,163
060650408141,434,257,177,441,253,188,648,382,252,520,306,185
060650408213,314,180,134,319,175,144,417,232,173,396,219,156
060650408212,477,289,188,482,285,197,900,506,373,537,313,191
060650408091,565,302,263,571,290,281,824,462,343,580,323,224
060650482001,775,414,361,783,398,385,1092,613,454,842,468,326
060650482002,518,298,220,522,290,232,858,482,358,587,335,215
060650408211,169,105,64,171,103,68,437,246,182,282,165,100
060650408214,416,256,160,420,253,167,922,518,383,525,308,189
060650408142,358,225,133,365,222,143,794,471,303,568,345,189
060650408151,527,309,218,531,301,230,741,440,283,617,371,217
060650408152,449,269,180,459,266,193,667,397,256,511,308,175
060650418091,324,169,155,330,164,166,465,238,216,334,161,154
060650418092,460,239,221,466,228,238,932,475,430,584,309,240
060650418094,246,128,118,250,123,127,396,204,184,298,146,139
060650418093,464,241,223,471,233,238,619,316,284,591,301,261
060650418103,776,338,438,791,328,463,1036,475,547,866,382,444
060650408072,719,283,436,733,272,461,900,449,434,885,333,507
060650408071,419,189,230,423,183,240,559,278,267,414,186,203
060650408081,413,210,203,418,206,212,719,357,342,517,251,233
060650408084,273,124,149,278,121,157,419,211,201,334,153,162
060650408083,356,227,129,360,227,133,845,424,405,430,260,143
060650408092,353,243,110,356,236,120,542,325,194,519,290,199
060650415002,392,260,132,395,254,141,886,554,297,221,158,51
060650417032,490,297,193,492,289,203,698,421,256,368,259,86
060650418051,430,257,173,438,245,193,560,338,208,491,259,201
060650418052,554,334,220,560,324,236,638,389,237,687,343,300
060650419061,255,157,98,255,152,103,588,354,217,434,244,161
060650419062,420,258,162,422,252,170,593,358,218,400,223,147
060650419063,310,191,119,313,186,127,497,299,183,472,257,181
060650418053,561,340,221,569,324,245,711,430,262,680,356,277
060650417031,198,119,79,198,115,83,513,311,190,329,227,81
060650417033,224,135,89,226,132,94,683,412,252,354,253,79
060650417021,274,193,81,277,187,90,359,210,132,229,160,57
060650417022,597,355,242,609,348,261,689,410,254,813,396,362
060650417023,388,199,189,395,195,200,415,248,155,462,230,201
060650417041,295,208,87,296,201,95,568,339,211,393,275,94
060650417042,303,215,88,308,208,100,615,361,225,350,246,82
060650416011,184,129,55,191,126,65,453,277,169,257,177,59
060650416021,297,210,87,299,202,97,738,443,272,381,256,99
060650416022,113,78,35,113,74,39,265,162,102,154,108,35
060650416012,253,177,76,253,170,83,437,266,164,240,166,55
060650418121,625,302,323,632,290,342,681,363,304,643,279,316
060650418131,502,279,223,507,270,237,740,387,335,614,322,261
060650418132,714,393,321,725,379,346,1025,536,469,708,379,294
060650418133,391,236,155,393,227,166,939,498,418,490,316,148
060650418122,573,259,314,573,248,325,758,396,349,701,301,356
060650418071,344,172,172,349,166,183,322,193,120,410,194,188
060650418072,434,217,217,441,209,232,394,237,148,516,245,235
060650419041,515,221,294,524,220,304,774,368,391,600,248,311
060650419122,584,254,330,593,250,343,808,384,407,633,260,328
060650419121,1026,470,556,1044,459,585,1509,719,760,1109,506,546
060650419123,554,254,300,565,248,317,775,368,391,522,230,261
060650419051,447,219,228,454,212,242,586,280,291,474,207,229
060650419064,375,183,192,382,179,203,542,308,222,419,229,160
060650419131,385,189,196,391,183,208,732,352,366,640,278,310
060650418041,742,309,433,757,303,454,980,471,489,861,353,459
060650418061,708,330,378,719,330,389,1071,515,536,807,401,371
060650418062,866,404,462,877,403,474,1132,545,567,984,434,506
060650418082,897,410,487,915,408,507,1394,666,698,1095,515,538
060650418081,853,383,470,868,376,492,1352,626,701,1064,438,573
060650418083,550,251,299,562,250,312,926,444,469,705,311,366
060650418101,772,325,447,786,323,463,1096,501,581,848,362,445
060650418102,686,287,399,698,287,411,1157,529,615,768,306,429
060650479013,751,300,451,761,295,466,1107,505,586,825,324,467
060650479021,843,333,510,850,323,527,1159,531,612,826,323,476
060650479023,771,315,456,786,311,475,1300,592,687,979,401,535
060650479011,395,168,227,402,165,237,631,286,334,421,181,218
060650479012,755,300,455,762,290,472,1166,529,616,885,377,455
060650418032,322,144,178,327,137,190,544,251,284,401,183,202
060650418033,858,381,477,872,366,506,1385,639,725,1001,440,508
060650481001,854,341,513,865,338,527,1440,655,753,1192,481,663
060650427442,457,209,248,465,203,262,670,310,355,536,222,288
060650427451,1132,441,691,1143,429,714,1623,698,902,1109,392,678
060650435173,708,396,312,717,376,341,1049,587,436,833,440,333
060650435171,560,325,235,566,308,258,1029,570,430,660,362,268
060650513021,699,335,364,702,333,369,1194,643,521,862,401,419
060650513012,412,227,185,418,226,192,778,412,340,634,345,259
060650435091,495,266,229,503,235,268,845,381,444,596,263,288
060650435093,171,87,84,172,83,89,255,144,108,165,89,64
060650435092,472,269,203,471,242,229,845,446,376,642,321,270
060650436022,308,199,109,309,196,113,692,368,308,404,244,134
060650436011,308,173,135,310,162,148,642,359,273,413,240,149
060650513022,404,210,194,408,191,217,674,280,386,518,218,268
060650435172,491,291,200,496,272,224,961,535,397,596,331,235
060650435182,487,228,259,491,214,277,1116,507,600,678,307,343
060650435062,547,281,266,550,280,270,1124,614,483,805,412,359
060650435222,105,62,43,106,60,46,471,259,205,237,129,95
060650436021,233,152,81,232,149,83,617,343,262,341,205,114
060650513011,567,331,236,580,317,263,900,475,402,599,329,240
060650435231,283,175,108,289,170,119,626,337,277,438,239,175
060650435123,360,205,155,363,202,161,533,292,223,404,218,162
060650435131,647,319,328,648,309,339,971,509,438,801,376,381
060650436012,303,201,102,304,195,109,824,452,344,517,300,182
060650435243,612,260,352,615,254,361,637,332,291,662,262,359
060650435122,380,184,196,384,181,203,558,308,233,551,271,252
060650435124,394,200,194,398,199,199,650,357,273,558,278,249
060650435241,427,174,253,429,167,262,452,221,224,452,179,251
060650435242,213,114,99,215,111,104,289,161,123,234,118,105
060650435121,418,222,196,423,220,203,536,293,223,524,262,229
060650435232,381,167,214,387,164,223,581,275,296,403,171,215
060650435221,248,158,90,248,154,94,382,223,147,266,155,94
060650435211,333,189,144,333,185,148,773,433,315,488,261,198
060650432931,1101,292,809,1110,290,820,1296,351,924,980,230,701
060650432923,467,136,331,469,131,338,569,195,369,358,78,262
060650432932,292,72,220,292,68,224,425,116,301,319,74,228
060650432921,746,192,554,753,186,567,878,244,614,839,206,591
060650432971,867,318,549,878,307,571,1533,637,862,1192,422,696
060650432671,1188,408,780,1204,398,806,1732,707,991,1340,457,819
060650432922,467,116,351,475,115,360,768,214,541,615,146,443
060650432461,404,86,318,409,85,324,494,129,356,468,90,351
060650432463,496,162,334,502,160,342,793,286,484,561,168,365
060650432653,341,130,211,345,128,217,582,240,324,507,176,295
060650432021,552,218,334,558,213,345,826,352,456,778,289,449
060650432031,1407,565,842,1421,549,872,1557,688,837,1028,403,568
060650432022,424,160,264,426,153,273,687,284,389,701,261,403
060650432023,658,273,385,664,268,396,1408,611,768,658,263,361
060650432032,175,51,124,178,52,126,232,77,151,194,49,139
060650432962,799,302,497,802,288,514,1646,721,891,1003,379,566
060650432983,856,385,471,864,366,498,1028,484,529,884,351,493
060650432011,653,304,349,661,297,364,1244,579,634,1016,393,555
060650432981,723,324,399,727,305,422,1173,558,598,880,354,476
060650432982,366,163,203,370,155,215,473,226,242,382,153,210
060650434011,328,167,161,334,166,168,683,365,309,471,233,208
060650434012,344,179,165,349,179,170,587,326,255,476,226,219
060650434013,289,159,130,292,159,133,657,336,307,468,243,202
060650434051,281,148,133,284,148,136,501,271,218,383,186,174
060650434052,278,156,122,281,155,126,481,242,229,297,158,126
060650434053,334,182,152,337,182,155,627,315,291,458,235,199
060650435212,143,80,63,143,79,64,301,151,143,216,115,92
060650435213,136,77,59,139,76,63,275,137,130,199,105,85
060650433091,206,104,102,207,102,105,523,262,247,337,162,155
060650433092,261,131,130,266,130,136,518,261,244,289,137,131
060650433102,353,173,180,358,168,190,640,292,327,414,190,200
060650433101,295,130,165,300,129,171,521,238,263,460,192,244
060650433111,286,109,177,289,105,184,362,183,172,405,145,239
060650437021,903,333,570,917,321,596,1096,475,598,1057,375,621
060650427452,819,330,489,829,321,508,771,345,413,666,257,386
060650427453,297,97,200,299,95,204,454,151,295,334,107,213
060650435202,449,181,268,452,173,279,694,315,374,657,252,383
060650435201,316,131,185,319,125,194,500,231,263,461,181,262
060650435051,616,255,361,626,252,374,664,307,345,575,229,325
060650435061,661,273,388,676,271,405,840,388,439,715,285,406
060650435064,277,114,163,281,113,168,510,234,265,458,181,257
060650435063,284,118,166,290,117,173,449,205,233,373,146,210
060650435181,483,227,256,485,206,279,820,412,398,651,289,316
060650435031,252,121,131,259,122,137,459,225,220,323,137,172
060650435034,288,133,155,295,133,162,609,303,293,454,195,239
060650435032,358,181,177,365,182,183,355,191,156,428,195,216
060650435033,297,150,147,301,150,151,670,364,296,420,192,212
060650435052,588,298,290,600,298,302,736,399,324,605,278,307
060650433061,725,318,407,734,312,422,1211,563,619,971,387,538
060650433062,641,281,360,652,276,376,1025,475,519,842,331,463
060650435191,161,70,91,165,70,95,418,196,214,305,124,170
060650435192,276,121,155,282,119,163,2,1,1,82,33,45
060650433071,532,237,295,541,230,311,775,382,383,632,261,336
060650434041,445,221,224,450,218,232,438,232,202,334,149,170
060650434042,389,190,199,394,186,208,554,279,264,456,201,232
060650433192,491,261,230,498,247,251,902,430,457,598,279,287
060650427233,222,91,131,219,87,132,357,160,194,230,92,129
060650433182,997,415,582,1008,419,589,1082,521,553,700,280,395
060650433181,474,198,276,482,200,282,774,368,393,1027,407,575
060650433162,571,217,354,576,213,363,461,221,235,491,175,293
060650433163,617,280,337,624,270,354,890,425,451,608,280,297
060650433191,542,295,247,546,279,267,1195,565,602,685,320,326
060650433074,541,201,340,549,200,349,853,408,433,795,288,474
060650433072,328,131,197,332,128,204,632,306,316,575,217,332
060650433161,402,148,254,407,147,260,347,165,176,325,117,196
060650433082,250,127,123,252,123,129,449,238,202,300,156,118
060650434031,277,158,119,281,156,125,418,221,183,328,169,142
060650434032,269,157,112,271,152,119,511,279,215,392,200,169
060650433073,214,98,116,217,95,122,367,185,173,375,165,191
060650433121,341,184,157,352,185,167,645,323,307,468,234,209
060650433122,379,180,199,391,182,209,738,359,365,604,277,293
060650433045,526,205,321,538,204,334,645,266,360,429,155,250
060650433043,334,138,196,342,137,205,422,194,216,416,167,226
060650438131,211,83,128,212,80,132,280,111,165,230,82,129
060650432271,495,186,309,500,175,325,711,312,380,515,185,303
060650432782,515,189,326,521,186,335,664,251,396,556,198,333
060650432783,616,215,401,620,204,416,709,271,428,905,282,583
060650432784,658,230,428,664,222,442,1474,561,887,573,219,330
060650432292,693,253,440,703,250,453,988,432,528,1180,431,701
060650504022,386,152,234,391,147,244,639,280,342,555,203,319
060650504012,323,119,204,325,116,209,482,211,257,391,145,228
060650504011,440,161,279,443,157,286,216,95,115,514,190,297
060650504014,461,177,284,467,172,295,827,363,442,486,195,264
060650504013,328,138,190,333,130,203,625,275,335,337,136,174
060650504021,408,169,239,412,162,250,999,438,534,592,240,304
060650504023,643,275,368,651,261,390,1099,480,584,845,308,470
060650507021,491,222,269,496,217,279,991,468,504,708,293,379
060650507012,414,186,228,418,185,233,669,317,341,496,200,273
060650507022,632,237,395,642,235,407,939,419,505,707,244,432
060650507011,1187,516,671,1213,507,706,1860,865,961,981,406,526
060650432101,619,229,390,629,228,401,883,392,478,634,240,359
060650503023,542,226,316,547,212,335,1027,480,530,409,158,228
060650503021,545,227,318,548,212,336,761,340,402,549,208,310
060650503022,453,208,245,461,206,255,610,290,311,606,265,306
060650432102,872,293,579,886,281,605,1705,638,1045,569,225,318
060650503011,505,205,300,512,203,309,566,267,285,370,145,207
060650432951,316,127,189,320,124,196,437,182,247,431,151,257
060650503012,705,309,396,716,307,409,956,450,486,702,298,361
060650503013,429,201,228,435,197,238,1014,476,516,672,292,338
060650497022,1094,335,759,1103,327,776,1547,519,999,1284,365,864
060650497012,766,234,532,775,232,543,1123,378,724,1214,339,816
060650432273,684,278,406,689,264,425,1423,500,886,1044,402,575
060650506001,365,147,218,368,142,226,581,195,377,446,140,285
060650506003,403,130,273,406,123,283,596,241,342,506,142,337
060650432282,850,322,528,863,311,552,1238,567,646,907,336,516
060650497021,838,212,626,848,205,643,995,324,651,912,238,627
060650506004,738,186,552,751,182,569,1196,383,791,850,272,548
060650498001,627,217,410,631,210,421,1383,544,818,877,302,527
060650498002,471,159,312,479,159,320,718,281,428,534,152,353
060650432281,399,156,243,403,151,252,960,436,507,589,215,341
060650432293,1011,388,623,1022,380,642,851,388,453,639,237,371
060650432291,905,332,573,916,332,584,798,346,438,890,326,532
060650432061,511,221,290,515,212,303,913,401,492,698,285,377
060650432062,314,133,181,319,126,193,424,185,232,450,185,246
060650432063,799,347,452,806,334,472,1254,548,680,739,289,401
060650432065,463,205,258,462,198,264,1043,456,567,527,213,279
060650506005,647,244,403,655,245,410,1169,521,625,710,212,470
060650432064,167,74,93,169,72,97,449,196,244,255,102,134
060650432112,442,185,257,450,183,267,621,293,315,525,193,304
060650432113,520,214,306,530,210,320,777,336,426,663,237,388
060650432114,436,177,259,446,173,273,734,296,421,800,281,472
060650432111,389,162,227,393,160,233,493,231,250,523,204,285
060650432103,261,109,152,267,108,159,308,146,158,535,219,280
060650505022,589,264,325,600,258,342,1036,493,522,700,305,358
060650505032,564,263,301,574,256,318,1326,622,673,569,256,284
060650496002,952,448,504,971,438,533,1308,642,643,945,395,493
060650505031,260,123,137,268,121,147,514,246,260,312,140,155
060650505033,511,247,264,516,238,278,761,367,381,516,225,259
060650505021,456,215,241,463,209,254,798,383,403,520,233,257
060650432091,387,157,230,393,153,240,672,315,342,540,209,303
060650432092,817,331,486,826,321,505,1279,600,651,1462,538,851
060650505011,321,129,192,323,126,197,893,419,453,583,235,318
060650505012,356,175,181,358,168,190,605,292,304,419,184,208
060650505013,605,295,310,610,282,328,1031,504,506,771,336,391
060650432542,361,146,215,369,144,225,455,203,238,414,154,228
060650432543,858,357,501,873,345,528,1440,643,747,1032,397,551
060650432082,654,300,354,661,292,369,1116,527,564,957,396,506
060650432083,510,233,277,517,225,292,649,304,326,783,311,429
060650432072,194,74,120,197,72,125,323,167,150,236,109,115
060650432073,756,344,412,767,333,434,1301,616,661,695,308,355
060650432081,359,165,194,363,163,200,704,331,358,481,201,250
060650432521,635,290,345,642,284,358,1108,522,561,682,288,354
060650432524,657,276,381,665,270,395,885,418,446,679,276,377
060650432523,408,189,219,413,185,228,695,328,351,298,125,156
060650432522,1054,401,653,1074,399,675,2288,1031,1208,1138,448,639
060650432482,866,313,553,885,313,572,1033,486,522,923,333,539
060650432561,306,129,177,312,128,184,447,201,238,403,150,221
060650432201,527,248,279,537,237,300,1172,509,630,645,277,323
060650432202,586,287,299,594,271,323,1047,456,562,549,236,276
060650432662,203,104,99,206,99,107,493,251,223,327,141,155
060650432663,370,190,180,375,181,194,444,227,202,362,157,171
060650432664,191,97,94,191,93,98,520,267,236,326,140,154
060650432221,820,360,460,836,361,475,977,470,479,1082,342,670
060650432222,863,335,528,874,325,549,1050,464,564,1109,352,685
060650432071,247,93,154,252,91,161,358,187,167,227,103,111
060650432462,665,241,424,675,235,440,1098,465,603,882,305,528
060650432643,664,257,407,672,253,419,576,246,315,629,224,361
060650432654,342,133,209,343,129,214,997,427,544,447,160,256
060650432481,738,314,424,748,309,439,1087,489,578,946,351,530
060650432563,338,144,194,342,142,200,647,290,346,447,180,243
060650432562,449,192,257,455,189,266,705,316,375,482,195,261
060650432623,633,243,390,643,234,409,999,427,548,755,268,444
060650432622,554,212,342,565,207,358,743,318,407,595,210,349
060650432621,1050,424,626,1061,410,651,1265,539,694,1152,421,677
060650432641,675,309,366,686,295,391,1167,498,644,815,326,435
060650432642,727,334,393,743,321,422,1014,431,555,767,306,409
060650432644,843,317,526,854,312,542,1198,513,662,956,369,531
060650432652,888,347,541,903,347,556,1336,568,734,865,291,521
060650432655,438,173,265,445,176,269,640,273,352,548,195,315
060650432651,406,161,245,411,162,249,627,266,346,648,218,390
060650432464,534,193,341,541,188,353,704,300,385,597,206,356
060650432182,833,297,536,843,293,550,1085,453,608,1376,475,828
060650432012,681,280,401,687,278,409,1149,539,580,132,45,81
060650432172,529,249,280,537,245,292,890,390,486,707,292,376
060650432171,601,234,367,610,226,384,658,285,358,500,203,269
060650432181,706,273,433,720,266,454,994,415,560,785,302,429
060650496001,525,254,271,531,243,288,745,380,336,561,236,294
060650432183,702,239,463,710,225,485,1098,419,656,761,256,459
060650432162,751,299,452,756,296,460,1151,521,612,726,294,369
060650432163,790,343,447,803,345,458,1114,516,570,887,342,478
060650432672,882,321,561,895,315,580,1143,468,653,986,351,590
060650432673,916,337,579,924,328,596,1235,504,710,1020,364,614
060650432161,344,161,183,350,162,188,896,458,407,655,267,331
060650512002,202,95,107,207,97,110,367,186,166,314,152,141
060650496004,583,274,309,587,264,323,866,424,424,710,297,372
060650496003,349,164,185,356,161,195,512,250,252,419,177,219
060650432661,243,125,118,247,119,128,277,142,126,185,79,87
060650427371,760,282,478,773,280,493,1571,649,882,903,357,499
060650432351,1004,393,611,1014,378,636,3035,1371,1609,1234,491,692
060650507013,537,240,297,552,238,314,958,441,491,694,285,368
060650432352,1615,670,945,1633,657,976,2569,1180,1343,1282,506,696
060659415001,655,293,362,664,285,379,1017,443,540,756,312,395
060650427232,549,261,288,555,255,300,1222,583,610,540,244,269
060650427201,459,179,280,460,166,294,665,280,364,474,180,269
060650427203,415,180,235,423,174,249,663,299,350,481,200,263
060650427231,565,274,291,571,268,303,927,469,438,648,287,328
060650427261,308,111,197,314,109,205,678,280,390,461,177,272
060650427202,191,81,110,187,73,114,300,145,149,273,116,137
060650432961,44,17,27,44,16,28,23,10,13,327,115,190
060650432972,1545,634,911,1567,613,954,2650,1168,1429,1082,421,596
060650432942,585,237,348,593,223,370,1061,448,597,703,260,408
060650432953,650,274,376,657,253,404,1242,516,699,876,331,492
060650432952,350,148,202,351,134,217,698,293,395,450,170,256
060650432042,782,337,445,786,332,454,1262,554,687,821,310,458
060650432043,717,292,425,723,285,438,1619,713,881,670,249,376
060650432052,661,270,391,666,262,404,1093,490,578,592,226,330
060650432041,415,174,241,418,170,248,572,250,306,578,221,326
060650432051,716,274,442,726,269,457,1066,453,594,632,223,365
060650432941,691,263,428,700,256,444,1036,432,583,1116,392,668
060650433112,329,152,177,335,150,185,419,190,217,348,151,180
060650433081,229,120,109,229,114,115,438,201,225,290,138,125
060650433131,266,131,135,269,126,143,620,281,320,445,208,203
060650433132,390,156,234,399,157,242,595,268,305,524,203,287
060650433141,496,193,303,497,188,309,831,353,452,640,231,364
060650433041,648,233,415,657,233,424,792,332,444,749,242,467
060650433142,484,175,309,490,173,317,784,332,427,683,234,403
060650433151,730,263,467,739,258,481,1024,421,579,820,276,491
060650433044,711,259,452,721,245,476,910,322,569,774,249,488
060650437022,485,177,308,489,166,323,823,305,503,650,211,407
060650437012,500,208,292,504,198,306,816,344,451,675,267,365
060650437031,424,181,243,430,168,262,727,307,401,511,199,273
060650437032,250,105,145,253,101,152,421,179,237,369,147,199
060659415002,479,195,284,485,186,299,758,320,419,565,209,322
060650437011,601,230,371,603,218,385,632,265,349,626,232,364
060650444042,503,280,223,510,279,231,479,279,189,479,225,219
060650444053,317,173,144,320,175,145,424,232,185,372,190,155
060650444071,480,152,328,486,152,334,347,114,230,345,98,229
060650444052,258,145,113,259,145,114,340,200,136,300,150,131
060650444073,392,183,209,394,187,207,512,256,241,386,182,179
060650444034,215,96,119,217,94,123,291,117,172,279,107,159
060650444041,437,259,178,442,255,187,687,403,258,572,303,228
060650444051,500,296,204,506,293,213,642,387,245,483,260,187
060650433042,399,98,301,402,94,308,584,174,399,482,125,332
060650444062,406,119,287,412,116,296,674,217,452,577,177,367
060650444061,491,161,330,494,149,345,766,216,535,584,149,399
060650444031,480,160,320,487,158,329,380,121,253,314,84,205
060650444032,219,69,150,218,66,152,387,126,252,302,85,201
060650444072,408,128,280,411,127,284,696,233,447,644,192,412
060650444033,256,82,174,256,81,175,505,166,321,453,133,291
060650451242,211,78,133,213,81,132,251,109,138,248,97,144
060650445072,475,303,172,481,299,182,574,392,172,554,340,185
060650445092,364,230,134,366,227,139,640,382,230,633,363,225
060650445172,511,283,228,514,281,233,694,379,303,474,240,216
060650445181,501,308,193,507,305,202,784,475,285,544,314,200
060650445171,547,252,295,552,255,297,750,372,369,599,252,326
060650445183,456,279,177,458,269,189,791,478,296,533,302,205
060650445242,243,149,94,243,146,97,523,326,186,388,237,133
060650445091,353,233,120,359,229,130,594,363,217,460,268,157
060650445182,429,281,148,425,271,154,677,416,251,479,283,170
060650445102,259,163,96,259,160,99,476,298,172,373,217,133
060650445103,278,187,91,278,182,96,570,375,181,398,253,120
060650445161,548,350,198,556,344,212,978,602,351,680,397,242
060650445164,292,171,121,293,169,124,478,291,177,321,191,112
060650445074,219,156,63,218,151,67,480,327,137,343,236,89
060650445071,271,194,77,276,189,87,457,326,127,366,249,95
060650445104,241,170,71,242,167,75,409,284,125,274,193,75
060650445101,148,105,43,147,101,46,355,245,95,231,158,60
060650445152,161,117,44,162,114,48,284,200,76,224,156,57
060650445151,431,329,102,432,317,115,679,498,160,498,372,101
060650445163,229,178,51,226,168,58,451,336,104,383,285,73
060650445162,165,122,43,166,118,48,277,199,74,247,168,62
060650445073,148,86,62,145,77,68,303,175,120,185,104,69
060650445202,319,172,147,318,166,152,340,177,157,290,131,151
060650445241,184,119,65,182,112,70,390,231,155,307,181,103
060650445231,189,94,95,192,95,97,262,154,103,247,122,117
060650445211,294,183,111,296,173,123,437,242,187,313,160,142
060650446043,446,344,102,448,344,104,734,562,166,570,416,134
060650446053,363,287,76,365,287,78,437,343,90,336,256,73
060650446052,439,348,91,439,348,91,592,461,121,359,272,77
060650446054,526,417,109,529,419,110,961,747,197,824,621,177
060650446042,363,262,101,365,263,102,458,348,110,389,279,103
060650446041,540,394,146,546,395,151,1031,779,250,1004,708,274
060659412001,276,203,73,279,204,75,737,621,111,157,122,25
060659412002,971,723,248,979,728,251,586,439,140,663,434,200
060650446051,309,231,78,316,237,79,491,368,116,344,248,89
060650446064,450,331,119,455,334,121,507,376,127,452,323,123
060659413001,431,324,107,433,326,107,538,400,129,362,254,93
060659413002,394,295,99,399,300,99,521,388,124,399,285,104
060659413004,453,341,112,456,344,112,528,392,127,527,370,137
060659413003,287,216,71,291,219,72,354,263,83,288,205,75
060650446021,268,205,63,269,206,63,343,275,66,354,253,85
060650446022,479,364,115,486,369,117,482,385,97,444,329,112
060650446023,493,375,118,496,376,120,521,412,102,543,391,131
060650446063,307,236,71,313,239,74,293,233,60,335,243,84
060650446062,353,284,69,358,291,67,293,237,55,203,155,44
060659405001,654,499,155,662,507,155,737,588,145,587,423,148
060650447012,345,272,73,348,275,73,547,434,107,433,331,91
060650447013,299,241,58,301,245,56,340,272,65,346,268,71
060650447011,480,376,104,482,376,106,941,713,214,595,439,133
060650448062,424,342,82,429,350,79,615,496,112,420,321,86
060650448061,488,389,99,492,395,97,655,530,119,376,282,85
060659414001,324,263,61,325,269,56,502,401,97,326,247,67
060659414002,482,389,93,488,399,89,771,608,149,615,471,125
060650448041,445,347,98,448,347,101,516,384,121,521,387,117
060650448042,332,249,83,332,250,82,473,359,111,512,367,127
060659407001,485,375,110,489,376,113,657,503,152,459,334,112
060659414003,379,295,84,382,295,87,716,566,138,371,271,83
060650448051,476,364,112,484,369,115,510,412,93,440,321,108
060650448052,585,446,139,588,449,139,556,449,101,471,339,118
060650448071,251,192,59,253,193,60,346,258,82,283,203,70
060650448072,604,455,149,611,462,149,447,338,106,384,281,97
060659407002,429,326,103,433,329,104,496,379,115,391,281,98
060659407003,339,259,80,344,262,82,479,362,112,420,302,104
060659408001,349,263,86,353,268,85,568,444,120,415,299,104
060659408004,364,274,90,369,280,89,454,359,95,403,295,102
060659410011,507,360,147,508,365,143,632,482,143,493,325,157
060659410023,317,225,92,318,226,92,360,278,81,301,199,94
060659410012,323,229,94,324,232,92,449,328,112,350,229,110
060659410021,357,254,103,359,257,102,442,336,103,318,211,101
060659410022,422,299,123,424,303,121,588,445,136,465,308,146
060650450002,606,455,151,610,457,153,715,542,162,555,387,139
060659405003,246,186,60,248,188,60,485,379,101,346,250,87
060659405002,315,221,94,319,223,96,384,296,86,337,221,108
060659408002,408,306,102,410,309,101,538,421,113,434,319,111
060659408003,297,224,73,301,228,73,435,342,92,415,299,106
060659411001,263,187,76,262,181,81,409,312,93,320,203,107
060650449071,231,186,45,231,180,51,449,354,91,222,179,35
060650449072,167,134,33,165,129,36,341,268,68,197,154,31
060650449073,216,175,41,216,167,49,413,322,84,247,191,38
060650449262,376,289,87,378,282,96,585,426,152,482,366,93
060650449261,242,188,54,241,183,58,328,245,76,282,214,55
060650450001,283,215,68,287,216,71,392,299,90,437,307,109
060650450003,278,210,68,282,213,69,525,393,122,463,320,127
060650449332,158,117,41,159,116,43,256,198,54,178,139,28
060650449333,161,120,41,162,119,43,247,191,53,183,142,28
060650449331,91,68,23,92,67,25,178,135,37,129,101,20
060650449342,200,149,51,198,145,53,326,250,67,228,181,35
060650449341,221,165,56,225,164,61,219,169,46,146,119,22
060650449161,486,369,117,492,368,124,789,589,191,649,423,210
060650449162,385,278,107,385,274,111,480,348,123,629,362,241
060659411002,221,165,56,225,164,61,399,279,118,258,160,92
060659411003,312,232,80,312,228,84,563,391,167,377,234,134
060659409001,722,521,201,734,535,199,765,569,191,609,398,199
060659409002,338,203,135,341,210,131,493,310,177,342,213,121
060650449043,483,333,150,492,338,154,746,503,235,475,300,159
060650449042,515,360,155,520,358,162,769,526,238,683,420,235
060650449041,412,285,127,416,287,129,663,448,212,534,330,183
060650449311,881,588,293,889,585,304,1108,715,375,692,458,204
060659406001,305,208,97,308,208,100,404,260,136,217,125,83
060650449322,548,347,201,551,342,209,818,530,279,637,368,245
060650449321,170,107,63,172,106,66,652,423,222,374,257,107
060659406004,303,175,128,306,176,130,513,332,177,365,221,137
060659412003,364,208,156,368,205,163,575,362,205,263,162,91
060650447021,457,366,91,457,359,98,625,498,121,612,445,139
060650449251,218,162,56,220,158,62,360,252,96,233,169,52
060650449252,600,446,154,604,439,165,986,706,268,693,503,160
060650449263,431,319,112,430,311,119,735,522,201,523,395,103
060650449231,490,320,170,493,312,181,901,594,295,738,462,241
060650449232,457,299,158,455,287,168,612,407,202,492,310,162
060650449241,528,345,183,532,336,196,976,637,317,685,428,232
060650449242,480,314,166,480,302,178,799,519,258,552,343,188
060650445053,547,344,203,554,333,221,923,524,388,507,325,162
060650445052,435,291,144,435,277,158,986,563,414,650,435,185
060650445051,347,175,172,347,173,174,354,201,149,359,163,183
060650445054,448,227,221,450,225,225,498,281,210,456,211,233
060650445201,208,106,102,212,106,106,168,95,69,261,121,132
060650452333,265,112,153,267,108,159,486,206,270,296,120,163
060650452332,658,280,378,666,280,386,1071,458,599,621,249,339
060650452331,358,155,203,364,162,202,751,318,419,718,323,348
060650452142,527,214,313,531,213,318,725,340,378,617,249,343
060650452143,710,244,466,722,245,477,811,345,452,887,275,577
060650452141,642,236,406,645,234,411,794,338,443,621,213,386
060650514013,711,341,370,720,345,375,807,428,377,749,348,385
060650514021,790,386,404,800,392,408,1019,537,475,808,376,415
060650514011,1113,531,582,1123,538,585,1238,654,580,1182,551,608
060650514012,792,383,409,804,391,413,981,521,459,891,417,460
060650514023,669,328,341,675,332,343,852,449,395,598,280,306
060650514022,555,274,281,561,276,285,670,353,313,577,268,297
060650451241,466,206,260,471,208,263,574,299,268,438,183,238
060659406003,408,233,175,414,237,177,918,575,335,403,213,179
060650449163,336,182,154,341,186,155,565,338,222,423,228,189
060650449164,356,194,162,359,195,164,492,291,192,367,195,163
060650449171,1022,591,431,1027,595,432,973,587,380,846,463,359
060650449183,454,209,245,457,211,246,437,211,220,385,155,219
060650449212,535,285,250,536,284,252,608,314,283,398,179,213
060650449211,676,380,296,681,382,299,855,512,334,728,394,314
060659406002,402,219,183,406,220,186,556,332,218,413,220,185
060650449174,413,239,174,417,242,175,492,297,193,438,243,187
060650451031,255,134,121,259,136,123,498,293,198,413,210,196
060650449172,416,225,191,421,228,193,552,332,216,430,217,201
060650449173,509,275,234,513,278,235,482,287,189,403,212,180
060650449181,521,281,240,526,284,242,650,390,256,468,238,217
060650451035,189,103,86,191,104,87,445,266,174,289,147,134
060650451034,174,94,80,177,94,83,232,138,93,261,133,122
060650451032,374,200,174,377,203,174,412,247,163,406,207,192
060650451033,389,189,200,396,194,202,554,299,248,428,191,223
060650449182,633,271,362,642,277,365,854,412,433,678,272,390
060650451182,399,204,195,403,204,199,734,365,359,475,231,223
060650449191,751,370,381,763,371,392,977,516,451,596,277,302
060650449192,657,284,373,665,284,381,826,437,375,675,260,396
060650449194,444,208,236,452,209,243,495,264,229,534,233,286
060650449193,609,286,323,620,287,333,605,321,279,699,306,376
060650449223,229,118,111,232,119,113,879,484,384,533,247,265
060650449221,631,301,330,644,306,338,771,400,360,318,137,169
060650449224,648,334,314,653,332,321,954,526,414,840,387,414
060650449292,413,223,190,417,221,196,549,290,250,345,171,159
060650449293,546,315,231,552,311,241,937,495,429,479,254,203
060650449294,221,127,94,223,126,97,426,225,196,297,157,127
060650449301,196,113,83,200,113,87,175,94,81,92,50,40
060650449302,176,101,75,178,100,78,391,206,180,259,138,111
060650449303,640,339,301,646,337,309,1150,644,483,912,459,418
060650449283,227,89,138,228,88,140,308,121,184,243,93,142
060650449281,285,120,165,288,120,168,435,231,200,399,146,239
060650449284,700,293,407,707,292,415,847,450,390,704,260,426
060650451232,576,217,359,581,218,363,878,420,443,582,254,294
060650449222,584,256,328,592,261,331,746,363,372,533,228,286
060650449272,582,255,327,590,260,330,1043,508,518,766,331,417
060650449273,391,172,219,400,177,223,475,233,240,409,175,221
060650449271,428,186,242,438,193,245,554,271,279,453,195,243
060650449111,663,337,326,663,327,336,879,441,419,621,301,294
060650449114,516,262,254,517,255,262,668,342,310,580,278,274
060650449112,421,215,206,422,207,215,707,372,322,558,270,266
060650449113,323,149,174,325,146,179,455,224,223,355,158,183
060650449282,273,139,134,276,137,139,427,204,217,326,157,154
060650451261,501,291,210,501,285,216,688,415,253,558,310,220
060650451181,306,178,128,309,176,133,561,330,221,409,229,162
060650451271,867,440,427,873,439,434,983,503,465,739,343,364
060650451262,214,124,90,215,123,92,345,206,126,351,188,144
060650451272,214,125,89,216,124,92,256,156,95,262,141,107
060650451174,415,216,199,424,222,202,806,407,384,616,298,292
060650451191,628,325,303,633,323,310,964,533,416,878,414,426
060650451192,273,158,115,275,157,118,393,231,152,253,138,101
060650449291,473,233,240,479,232,247,578,304,266,470,214,238
060650451162,224,121,103,226,122,104,290,153,131,268,136,120
060650451161,321,160,161,326,162,164,553,291,253,420,201,202
060650451173,288,155,133,293,159,134,396,209,183,305,156,135
060650451172,400,210,190,405,211,194,537,280,247,471,229,221
060650451171,389,211,178,392,213,179,552,294,254,448,230,198
060650451141,546,248,298,550,249,301,545,287,249,453,199,237
060650451151,360,166,194,365,168,197,423,223,194,383,175,194
060650451152,580,266,314,588,267,321,632,332,292,566,250,292
060650451142,448,198,250,452,202,250,571,300,263,455,191,246
060650451253,137,45,92,140,45,95,262,118,141,250,92,146
060650451252,284,85,199,286,85,201,470,186,278,352,105,235
060650451222,423,131,292,426,132,294,454,179,271,387,119,258
060650451221,317,99,218,318,99,219,383,152,226,318,97,212
060650451231,499,153,346,505,156,349,531,209,316,464,144,304
060650452281,606,314,292,609,311,298,1480,766,696,535,265,238
060650469003,194,64,130,196,64,132,181,73,106,184,79,95
060659404001,82,75,7,83,72,11,143,113,29,116,101,9
060650452144,603,282,321,606,274,332,825,405,404,665,266,371
060650452133,780,511,269,792,491,301,986,635,329,979,615,314
060650452131,317,133,184,319,133,186,377,194,182,310,141,158
060650452341,1053,440,613,1066,435,631,1455,690,748,1192,496,637
060650452351,940,417,523,950,419,531,1104,530,554,943,432,471
060650452352,409,183,226,415,186,229,889,419,453,740,339,370
060650452342,348,163,185,351,166,185,491,230,251,413,174,218
060650452343,474,222,252,478,226,252,676,319,347,531,226,279
060650451292,665,276,389,674,283,391,1145,589,538,440,205,221
060650451291,282,112,170,285,115,170,366,187,170,271,124,135
060650451282,565,225,340,572,232,340,530,274,250,494,179,303
060650451281,259,102,157,263,106,157,317,162,147,326,114,200
060650451293,247,97,150,251,101,150,290,148,136,338,120,206
060650451294,322,127,195,327,132,195,367,188,172,401,141,246
060650451295,280,111,169,284,115,169,353,181,165,351,124,215
060650451201,248,132,116,250,131,119,354,182,166,224,105,109
060650451202,711,380,331,719,378,341,1117,579,531,977,536,376
060650451204,304,162,142,306,161,145,604,311,284,395,188,191
060650451203,143,77,66,145,77,68,299,155,143,202,97,100
060650451251,424,225,199,425,222,203,506,261,237,451,215,219
060650451254,201,107,94,202,105,97,282,152,122,209,104,95
060650451091,577,325,252,582,319,263,812,476,322,641,363,254
060650451092,785,443,342,788,432,356,1016,599,407,774,458,300
060650451103,541,309,232,542,304,238,861,500,341,673,373,266
060650451102,535,307,228,541,303,238,845,482,334,692,377,269
060650451101,508,292,216,513,288,225,844,494,334,639,357,250
060650456132,165,81,84,169,82,87,377,201,161,279,124,142
060650456172,310,126,184,313,126,187,207,146,56,230,169,50
060650456064,390,120,270,393,120,273,367,153,210,306,94,204
060650456063,343,181,162,342,176,166,490,276,212,363,195,155
060650456062,104,32,72,104,32,72,411,172,233,221,66,147
060650456133,185,56,129,186,56,130,430,180,245,305,92,204
060650456131,222,66,156,223,66,157,390,164,222,283,86,190
060650456141,295,89,206,297,89,208,523,222,299,370,111,248
060650456171,1046,417,629,1054,413,641,1027,434,586,941,371,553
060650456142,169,66,103,170,66,104,217,92,125,227,91,133
060650456192,190,164,26,189,155,34,207,165,36,160,137,14
060650456183,1,1,0,2,2,0,87,71,14,71,60,6
060650456182,23,20,3,22,19,3,88,74,14,78,66,7
060650456193,82,64,18,80,61,19,108,82,26,85,71,11
060650456061,147,76,71,147,75,72,581,314,261,146,74,68
060650456151,382,291,91,381,285,96,370,262,105,361,254,79
060650456101,375,344,31,376,334,42,262,214,44,141,127,7
060650456191,19,17,2,18,16,2,133,108,21,85,77,3
060650456161,174,145,29,176,141,35,118,90,28,118,96,15
060650456162,25,20,5,23,18,5,253,176,69,155,121,23
060650456152,128,97,31,128,89,39,331,233,91,199,152,36
060650456121,157,127,30,157,121,36,263,210,41,210,170,22
060650456122,64,59,5,63,57,6,105,85,18,98,80,14
060650456103,98,91,7,97,88,9,162,136,24,123,114,2
060650456102,82,76,6,82,75,7,144,122,20,97,90,3
060650456112,75,69,6,73,66,7,344,286,48,222,203,6
060650456111,1,1,0,1,1,0,234,198,32,129,120,3
060650456123,126,107,19,124,97,27,326,259,56,252,201,35
060650452282,759,368,391,767,367,400,1642,845,782,630,278,321
060650494001,726,376,350,732,373,359,761,389,362,982,457,504
060650494002,364,178,186,367,175,192,400,205,192,502,234,257
060650494003,546,263,283,550,261,289,555,285,265,679,318,349
060650452162,598,317,281,601,315,286,548,280,263,711,333,365
060650452161,502,267,235,509,267,242,810,415,390,596,280,307
060650452173,663,356,307,667,354,313,685,456,215,441,306,103
060650452171,617,373,244,620,363,257,1084,604,459,847,459,340
060650452121,596,251,345,598,248,350,729,373,347,576,262,294
060650452122,428,180,248,427,178,249,441,226,211,360,163,183
060650453061,548,301,247,557,292,265,884,510,360,614,305,279
060650453051,692,379,313,696,366,330,986,531,441,752,381,341
060650453052,422,232,190,424,222,202,758,408,337,503,253,228
060650453053,222,122,100,224,118,106,391,209,174,306,154,138
060650453062,208,137,71,207,129,78,743,428,303,399,224,158
060650453063,124,80,44,122,76,46,305,175,124,268,150,109
060650453064,276,181,95,283,177,106,663,381,270,558,307,222
060650453021,388,317,71,389,298,91,599,434,157,454,363,73
060650453022,178,146,32,178,138,40,246,181,65,183,149,30
060650453023,182,149,33,182,141,41,322,228,85,240,186,40
060650453031,488,357,131,492,342,150,308,230,66,310,241,52
060650453032,141,117,24,145,111,34,347,263,79,302,235,50
060650452222,78,47,31,79,46,33,157,84,73,181,103,74
060650455011,180,146,34,181,142,39,534,390,128,350,273,59
060650455013,175,142,33,174,136,38,288,213,69,140,115,21
060650455012,473,384,89,473,370,103,684,506,165,513,400,89
060650495022,237,195,42,232,185,47,592,446,138,392,313,62
060650495021,230,191,39,230,186,44,384,281,91,359,288,54
060650495011,287,237,50,285,230,55,572,420,135,448,363,69
060650495012,315,262,53,311,250,61,426,316,101,343,275,53
060650452221,666,348,318,676,346,330,638,342,288,285,160,113
060650452223,221,113,108,221,112,109,507,269,232,185,102,74
060650452132,678,467,211,677,447,230,619,417,194,595,380,182
060650452244,433,301,132,433,298,135,543,361,167,545,370,146
060650452241,22,16,6,23,16,7,390,265,121,281,193,77
060650452092,487,347,140,488,329,159,1147,765,354,526,397,103
060650452172,315,236,79,318,223,95,561,374,173,382,262,103
060650455022,281,209,72,280,197,83,624,419,194,366,277,72
060650452091,406,300,106,410,283,127,755,509,234,567,399,132
060650455021,227,167,60,228,159,69,599,404,188,399,282,94
060650452071,333,221,112,334,212,122,703,470,221,569,388,150
060650452072,467,310,157,469,298,171,654,437,205,580,397,153
060650452242,486,242,244,492,240,252,449,242,202,327,163,152
060650452243,879,437,442,886,432,454,808,440,363,669,337,314
060650491011,434,216,218,439,214,225,671,363,299,480,240,223
060650491012,73,36,37,74,36,38,577,313,259,406,205,190
060650491023,417,202,215,417,204,213,584,308,274,472,221,238
060650491022,274,133,141,277,136,141,467,246,217,342,159,173
060650491021,387,188,199,392,193,199,577,301,269,442,206,224
060650452261,363,316,47,363,301,62,787,613,154,575,467,74
060650452263,321,278,43,322,267,55,522,410,103,528,428,69
060650452262,283,245,38,286,236,50,352,274,70,279,229,35
060650457091,150,134,16,149,128,21,446,349,88,293,255,24
060650457062,130,118,12,130,112,18,458,360,90,268,236,23
060650457071,196,174,22,195,164,31,379,300,79,333,291,34
060650457074,277,244,33,277,233,44,399,305,78,350,293,35
060650457073,220,193,27,216,182,34,347,271,68,316,266,31
060659404003,456,402,54,453,380,73,558,428,110,493,415,49
060659404004,65,58,7,67,56,11,158,123,31,117,100,12
060650457041,202,182,20,203,174,29,326,259,66,259,228,19
060650457042,169,153,16,171,146,25,420,333,83,187,168,17
060650457081,247,220,27,245,211,34,473,373,90,298,256,28
060650457082,130,115,15,131,112,19,471,371,91,302,264,26
060650457063,187,168,19,187,161,26,358,281,72,270,231,23
060650457061,128,115,13,127,108,19,276,216,54,197,167,17
060650457092,322,283,39,320,272,48,687,539,134,354,303,36
060650457072,241,211,30,243,206,37,482,379,95,308,260,32
060659404002,301,266,35,299,256,43,629,491,124,487,414,48
060650457033,238,214,24,239,203,36,447,349,83,201,182,15
060650457032,327,295,32,331,280,51,431,336,81,443,387,31
060650457031,239,216,23,245,208,37,486,378,91,500,445,35
060650445232,410,181,229,410,187,223,691,336,349,325,157,160
060650472012,187,105,82,188,106,82,187,107,79,156,77,75
060650472011,119,67,52,121,68,53,255,146,105,241,118,116
060650472013,149,84,65,151,85,66,181,102,75,134,66,65
060650472023,125,62,63,127,61,66,244,117,119,178,80,88
060650472022,192,92,100,193,90,103,331,159,166,218,97,113
060650472021,191,93,98,192,91,101,217,106,107,226,103,115
060650459001,322,134,188,325,125,200,266,110,153,225,77,137
060650461011,213,98,115,219,97,122,307,140,165,204,102,95
060650461012,406,205,201,409,202,207,569,255,304,424,209,190
060650461021,341,153,188,342,148,194,643,277,339,519,217,268
060650461031,345,159,186,351,157,194,496,213,267,458,187,246
060650461032,287,143,144,291,143,148,376,166,203,326,159,149
060650462001,240,117,123,240,113,127,446,202,243,352,174,169
060650462002,255,128,127,251,124,127,513,221,266,436,214,197
060650469001,13,6,7,13,6,7,108,44,60,109,41,63
060650470001,174,86,88,176,87,89,169,76,89,155,73,72
060650470002,80,41,39,81,40,41,173,79,94,132,67,63
060659401001,16,3,13,16,3,13,48,6,41,31,4,26
060650470003,129,33,96,130,30,100,199,53,145,194,46,136
060650469002,115,52,63,116,47,69,205,97,103,170,88,74
060650459002,70,50,20,69,44,25,114,70,39,101,63,26
060650425223,332,253,79,331,243,88,507,373,126,336,257,63
060650425221,242,186,56,243,177,66,397,291,98,298,222,55
060650425233,207,158,49,207,151,56,405,300,94,377,270,81
060650425232,379,289,90,379,277,102,514,384,120,447,320,96
060650424052,238,187,51,240,187,53,607,451,140,389,321,45
060650424053,164,129,35,166,129,37,387,288,90,246,202,29
060650424041,412,302,110,416,297,119,635,444,181,563,405,125
060650424051,270,197,73,274,196,78,496,340,140,443,319,99
060650425132,429,298,131,429,284,145,558,391,161,554,382,142
060650425131,251,175,76,254,168,86,295,206,84,321,220,83
060650425141,293,204,89,299,198,101,502,348,143,493,340,127
060650425142,234,163,71,236,156,80,335,234,96,324,222,84
060650425151,204,153,51,208,147,61,541,375,154,331,249,62
060650425152,171,129,42,172,123,49,424,292,119,243,183,44
060650425191,254,184,70,254,177,77,592,406,177,371,275,79
060650425201,359,262,97,363,253,110,762,520,221,495,371,101
060650425112,269,203,66,272,195,77,458,335,115,341,261,64
060650425121,236,181,55,234,171,63,359,261,90,289,220,52
060650425122,203,156,47,205,150,55,470,341,116,367,271,76
060650425162,236,182,54,238,174,64,434,317,108,338,257,61
060650425211,544,403,141,546,389,157,888,623,251,669,503,131
060650425052,195,144,51,196,132,64,494,364,125,333,249,62
060650425111,250,179,71,250,173,77,662,483,164,332,246,69
060650425161,387,295,92,389,282,107,512,376,127,512,381,106
060650425222,173,134,39,177,132,45,280,206,70,259,197,47
060650425231,310,241,69,309,231,78,425,314,105,347,265,63
060650467001,232,180,52,230,172,58,432,316,107,362,276,66
060650467002,144,112,32,145,109,36,438,318,108,334,256,60
060650422142,639,379,260,643,362,281,905,556,328,814,465,286
060650424101,967,623,344,980,607,373,1730,1068,632,1230,758,408
060650424102,655,420,235,665,409,256,1013,622,367,828,502,281
060650424123,818,448,370,829,442,387,1055,618,417,812,454,319
060650424111,331,197,134,335,190,145,445,252,183,433,239,167
060650424112,548,327,221,555,316,239,753,428,310,725,400,282
060650424122,541,318,223,548,305,243,844,481,356,646,362,251
060650422122,553,361,192,558,350,208,825,527,282,804,488,269
060650422123,347,226,121,350,220,130,627,401,214,509,309,171
060650422121,516,313,203,521,306,215,851,544,292,576,343,198
060650422124,308,187,121,312,183,129,508,325,175,347,208,118
060650424061,465,278,187,470,278,192,791,503,269,634,379,217
060650424062,578,364,214,585,363,222,893,573,306,658,407,212
060650424091,408,249,159,410,247,163,594,382,203,433,258,147
060650424071,383,203,180,383,195,188,855,483,353,503,276,204
060650424072,326,173,153,329,167,162,635,358,260,442,242,179
060650424092,355,256,99,361,256,105,738,473,253,604,420,142
060650424081,436,260,176,439,254,185,798,451,328,525,288,203
060650424082,401,239,162,403,233,170,712,403,293,458,250,178
060650424031,714,423,291,724,403,321,1172,668,488,856,488,316
060650424032,511,302,209,515,286,229,855,483,351,679,387,251
060650424023,314,198,116,320,195,125,518,306,203,401,259,118
060650424022,487,305,182,494,302,192,932,551,366,711,457,212
060650424021,569,271,298,578,267,311,760,442,302,698,328,334
060650424011,819,353,466,832,345,487,892,520,366,920,387,494
060650424121,497,197,300,503,192,311,612,304,292,612,239,348
060650425101,322,247,75,323,239,84,544,398,137,444,341,82
060650425102,242,187,55,243,179,64,457,332,113,354,271,65
060650425103,235,181,54,236,175,61,467,339,117,385,294,71
060650426213,481,348,133,488,333,155,647,438,195,572,416,130
060650426214,474,343,131,475,324,151,811,548,247,574,422,129
060650426211,370,267,103,370,253,117,856,581,260,476,346,107
060650426221,563,366,197,572,359,213,1002,680,305,714,468,218
060650426222,565,380,185,571,363,208,872,602,249,685,430,221
060650426242,430,256,174,433,250,183,569,389,177,511,303,188
060650425212,355,261,94,359,253,106,680,468,193,473,350,96
060650425202,353,250,103,355,241,114,823,554,245,562,413,125
060650468002,558,397,161,558,380,178,1032,697,311,793,565,185
060650468003,355,255,100,356,241,115,643,437,197,493,349,118
060650426212,333,238,95,335,228,107,588,396,176,464,321,113
060650468001,370,264,106,373,253,120,602,419,175,531,366,130
060650425091,280,206,74,280,196,84,512,363,133,383,285,75
060650425181,280,197,83,280,187,93,503,347,144,398,280,94
060650425182,359,264,95,360,252,108,719,500,205,543,382,127
060650426241,613,343,270,622,334,288,1147,628,490,823,463,320
060650487003,382,274,108,387,261,126,546,374,165,435,322,92
060650487001,202,136,66,207,132,75,456,318,130,293,187,94
060650425171,272,185,87,274,178,96,416,293,119,343,241,87
060650425172,373,256,117,382,248,134,657,456,188,537,375,136
060650489011,369,256,113,370,245,125,588,411,162,521,359,134
060650425092,334,231,103,335,220,115,560,388,160,447,315,105
060650489023,375,267,108,378,254,124,925,653,254,446,323,101
060650425072,440,325,115,437,311,126,746,536,198,515,374,115
060650425071,252,189,63,254,178,76,506,358,132,403,309,72
060650425081,207,155,52,207,145,62,405,291,103,368,279,66
060650425082,185,138,47,186,131,55,321,231,81,266,203,47
060650425083,325,239,86,323,231,92,566,402,147,474,347,106
060650489022,333,249,84,336,236,100,538,388,142,446,342,79
060650489021,407,300,107,410,292,118,848,601,222,682,510,135
060650425073,322,250,72,326,245,81,498,357,133,483,356,101
060650488001,519,403,116,527,396,131,794,568,209,724,536,150
060650483003,595,451,144,600,442,158,629,467,154,669,520,117
060650488002,361,279,82,367,275,92,603,431,158,493,366,102
060650487002,698,483,215,705,463,242,1036,706,315,605,444,137
060650489012,421,307,114,422,291,131,599,434,158,569,377,156
060650511004,310,232,78,314,226,88,621,456,153,451,335,94
060650511001,310,229,81,313,223,90,662,490,163,515,385,111
060650483001,391,297,94,390,290,100,646,477,159,538,403,107
060650483004,261,199,62,264,194,70,411,302,100,366,283,66
060650511003,385,294,91,386,286,100,609,450,149,522,393,104
060650511002,247,188,59,247,183,64,467,346,115,354,266,70
060650426251,494,364,130,493,348,145,970,669,288,526,365,132
060650483002,270,205,65,272,200,72,671,495,164,441,343,77
060650490011,463,342,121,469,334,135,853,620,216,451,332,99
060650490012,487,370,117,487,360,127,989,728,242,595,455,113
060650490013,360,271,89,362,266,96,539,386,143,440,323,95
060650490022,538,361,177,541,351,190,745,506,225,737,490,198
060650426232,753,479,274,764,464,300,1139,777,346,883,537,299
060650426231,440,280,160,441,268,173,673,460,205,544,333,185
060650490021,170,108,62,171,103,68,565,384,171,493,301,168
060650438243,663,183,480,663,176,487,709,233,469,639,163,447
060650438244,516,151,365,528,152,376,804,281,512,666,191,439
060650438241,376,127,249,379,123,256,773,249,504,450,146,277
060650438073,495,144,351,497,142,355,878,289,570,586,158,395
060650438072,600,252,348,607,245,362,1008,429,549,754,307,407
060650438091,385,116,269,389,111,278,308,102,201,430,119,288
060650438093,1291,551,740,1305,535,770,2484,1143,1285,815,263,520
060650438092,356,104,252,361,104,257,605,201,395,412,114,277
060650441041,802,379,423,818,373,445,961,443,491,798,368,387
060650438102,743,307,436,750,300,450,713,323,380,763,307,425
060650438221,1009,420,589,1024,400,624,1665,791,836,837,303,481
060650438124,2148,881,1267,2168,878,1290,1780,790,969,1339,502,811
060650438202,1082,527,555,1092,521,571,1553,769,749,1502,732,712
060650467003,125,59,66,123,57,66,205,114,90,119,53,60
060650426321,281,211,70,279,202,77,539,372,158,482,344,105
060650426252,418,320,98,422,308,114,839,612,213,620,480,107
060650426292,302,233,69,304,223,81,523,382,132,414,324,69
060650426293,303,234,69,305,225,80,526,381,132,383,296,66
060650426301,513,390,123,516,375,141,777,567,195,801,607,151
060650426303,322,242,80,323,234,89,698,511,174,507,389,89
060650426313,233,183,50,237,179,58,358,244,104,312,248,49
060650426311,249,196,53,253,192,61,453,310,132,384,305,61
060650426312,341,268,73,342,260,82,653,478,161,534,426,85
060650426322,217,170,47,219,166,53,385,266,114,363,259,80
060650426262,206,163,43,210,159,51,582,425,148,392,302,68
060650426272,241,189,52,241,185,56,358,263,86,346,274,49
060650426273,374,286,88,375,277,98,580,424,143,558,439,86
060650426271,342,262,80,347,257,90,599,438,150,589,463,90
060650426261,721,564,157,722,550,172,1485,1065,391,640,506,92
060650428022,276,209,67,272,194,78,402,297,101,328,244,63
060650429082,321,241,80,318,226,92,538,358,165,409,301,85
060650426281,194,151,43,193,148,45,420,316,98,308,247,44
060650426283,217,171,46,219,164,55,412,291,111,303,239,44
060650427472,157,123,34,158,119,39,269,204,58,226,179,34
060650427462,270,214,56,272,206,66,524,400,114,375,300,55
060650428013,135,107,28,137,104,33,281,189,90,168,120,41
060650428012,188,148,40,188,142,46,345,242,92,328,233,80
060650427461,351,291,60,352,282,70,562,423,121,482,383,74
060650427473,252,209,43,253,203,50,480,359,103,409,325,62
060650427193,246,123,123,246,118,128,400,213,180,337,181,139
060650428023,151,120,31,152,109,43,289,214,72,321,236,63
060650428011,136,109,27,135,100,35,312,215,91,283,210,54
060650427311,1115,555,560,1124,519,605,1126,532,584,986,415,528
060650427312,410,247,163,416,240,176,943,547,379,496,296,168
060650427313,403,241,162,410,234,176,1079,621,437,548,319,193
060650426291,344,260,84,343,246,97,605,441,152,508,370,112
060650426302,527,395,132,529,378,151,674,489,170,541,395,117
060650426263,414,276,138,413,261,152,898,602,279,539,362,150
060650426282,98,77,21,98,74,24,236,174,57,164,130,23
060650426284,229,181,48,230,177,53,394,292,94,368,292,54
060650427471,217,171,46,218,168,50,330,248,79,266,212,40
060650441031,776,352,424,788,349,439,1147,533,584,876,368,469
060650438132,307,177,130,308,175,133,428,233,178,365,186,149
060650438134,194,125,69,192,127,65,333,201,127,270,160,85
060650438133,212,116,96,216,114,102,310,169,137,352,169,161
060650443003,192,105,87,193,101,92,341,178,155,359,187,144
060650427092,379,147,232,384,142,242,521,224,286,521,199,304
060650427093,563,219,344,571,213,358,763,327,419,839,318,486
060650427401,794,307,487,804,297,507,1042,436,588,681,258,398
060650427402,512,197,315,517,191,326,617,260,353,411,157,240
060650427412,777,301,476,787,291,496,1078,456,612,732,280,430
060650427091,1107,433,674,1127,421,706,1506,654,834,1271,429,794
060650427112,772,316,456,782,312,470,1001,423,566,788,315,445
060650427113,818,321,497,830,313,517,1202,506,680,1014,409,572
060650427323,1242,502,740,1263,478,785,1066,464,584,676,259,378
060650427411,422,165,257,427,161,266,648,271,364,501,201,281
060650427083,473,184,289,479,173,306,857,368,471,647,236,372
060650427111,988,404,584,1000,401,599,1333,564,759,853,329,491
060650427321,696,251,445,703,239,464,1267,548,697,854,291,514
060650427322,760,320,440,776,303,473,619,255,351,425,155,246
060650427081,578,224,354,580,216,364,892,387,496,849,323,484
060650427171,285,126,159,295,122,173,671,296,366,442,189,227
060650427082,358,137,221,366,132,234,723,312,398,495,181,283
060650427421,645,267,378,652,251,401,1594,686,876,1473,579,817
060650427431,575,198,377,586,186,400,2103,820,1237,874,275,552
060650427422,766,257,509,775,244,531,1295,507,755,983,289,638
060650432793,283,93,190,287,90,197,505,193,305,542,160,359
060650427242,876,372,504,891,361,530,1313,622,667,775,298,438
060650427241,524,213,311,529,208,321,879,403,457,682,282,359
060650427521,637,261,376,641,256,385,810,373,427,563,241,292
060650427383,697,260,437,709,255,454,1112,461,632,976,344,568
060650427382,546,203,343,554,198,356,1186,490,673,779,268,455
060650427381,1131,456,675,1138,429,709,1904,788,1078,848,313,487
060650427394,728,292,436,735,286,449,1200,495,679,499,193,283
060650427391,547,217,330,552,215,337,1016,422,577,600,236,332
060650427392,700,275,425,705,260,445,1541,640,880,1426,598,759
060650427393,364,120,244,370,110,260,682,278,397,438,134,288
060650427301,317,173,144,320,164,156,708,370,336,473,237,217
060650427304,343,204,139,346,188,158,559,300,246,426,248,160
060650427302,219,102,117,224,97,127,270,146,120,187,101,80
060650427281,573,268,305,583,258,325,1250,581,647,722,317,365
060650427262,551,243,308,559,237,322,1394,675,690,1186,476,639
060650427263,1868,854,1014,1900,839,1061,2798,1357,1383,1383,571,723
060650427511,523,243,280,529,232,297,864,382,470,541,239,275
060650427512,684,304,380,695,292,403,1357,600,738,638,276,332
060650427522,647,250,397,660,242,418,1168,548,601,908,376,486
060650427513,548,202,346,555,195,360,819,364,440,898,334,529
060650427523,1008,368,640,1017,353,664,827,366,447,933,343,558
060650438021,911,296,615,936,291,645,1129,370,732,1016,298,660
060650438023,985,322,663,1006,319,687,2138,742,1357,978,307,615
060650438242,537,219,318,544,206,338,761,283,458,563,206,329
060650438233,787,350,437,798,340,458,1473,649,789,915,385,485
060650438231,684,304,380,688,292,396,1647,749,865,784,333,417
060650438234,984,455,529,1000,440,560,2175,1018,1108,1206,538,603
060650438101,608,250,358,619,246,373,732,312,409,641,254,371
060650438103,1041,429,612,1059,426,633,1555,705,823,1227,491,686
060650438071,513,223,290,521,218,303,966,424,506,687,296,351
060650438211,1020,516,504,1034,498,536,2516,1309,1153,1065,540,467
060650439002,290,134,156,291,128,163,694,340,350,436,189,224
060650440001,325,169,156,331,163,168,977,494,474,478,228,222
060650439001,587,244,343,597,237,360,863,387,458,699,276,370
060650439003,581,260,321,590,249,341,1108,524,562,868,366,447
060650438181,583,279,304,596,271,325,879,465,397,779,350,384
060650438182,554,272,282,566,265,301,826,440,376,770,358,371
060650438201,1043,512,531,1052,507,545,1132,563,546,1223,599,577
060650441011,329,195,134,330,186,144,596,348,235,421,240,156
060650441012,124,72,52,126,70,56,308,180,120,210,121,78
060650441021,214,126,88,218,124,94,391,226,155,264,143,103
060650441022,554,289,265,557,281,276,454,262,174,307,173,112
060650442001,169,99,70,170,96,74,408,229,167,267,150,95
060650443002,164,90,74,165,86,79,248,134,109,158,82,64
060650443001,495,283,212,495,272,223,758,429,308,486,267,186
060650441033,602,279,323,602,279,323,1012,499,485,772,349,387
060650438121,1046,358,688,1059,363,696,1264,526,727,1246,443,784
060650438123,412,157,255,417,161,256,520,215,298,501,189,294
060650438122,963,368,595,980,380,600,1236,513,714,1050,398,622
060650441032,188,85,103,190,82,108,644,310,320,515,231,265
060650442003,328,215,113,332,213,119,496,311,179,360,230,106
060650442002,256,168,88,261,168,93,478,291,172,323,207,96
060650442004,215,142,73,217,140,77,450,280,161,342,216,100
060650427303,205,91,114,206,88,118,347,162,178,219,96,114
060650427191,547,233,314,552,223,329,821,376,429,617,255,323
060650427441,530,202,328,532,193,339,716,300,403,619,233,346
060650427192,456,201,255,465,192,273,716,326,370,588,240,313
060650446061,188,118,70,189,118,71,316,194,113,228,123,97
060030100001,612,399,213,615,386,229,741,476,244,600,334,217
060210101012,533,269,264,538,252,286,675,369,287,458,222,198
060210101021,178,67,111,182,64,118,317,129,180,260,97,144
060210101011,242,95,147,244,92,152,248,107,130,265,109,151
060210101013,502,197,305,514,184,330,707,290,400,525,204,285
060210102003,244,66,178,240,55,185,316,92,221,244,66,163
060210101023,577,198,379,591,182,409,989,411,562,681,229,400
060210101022,288,105,183,291,98,193,458,174,267,398,148,226
060210102001,331,98,233,332,88,244,414,131,274,442,134,283
060210102002,572,155,417,581,136,445,871,258,597,726,197,488
060210102004,341,93,248,342,83,259,510,145,355,444,118,304
060210105011,332,243,89,340,220,120,389,290,96,352,259,80
060210105012,246,58,188,255,51,204,315,67,243,271,55,207
060210105013,226,110,116,227,97,130,371,170,189,328,156,150
060210103001,256,41,215,258,37,221,279,47,227,245,43,195
060210103003,321,67,254,326,59,267,256,54,199,262,54,195
060210103002,299,50,249,301,45,256,427,86,328,409,76,311
060210104011,235,52,183,239,49,190,370,88,280,267,59,190
060210104024,147,63,84,147,55,92,215,110,101,162,75,80
060210105021,323,59,264,330,58,272,325,70,244,323,66,243
060210105022,268,46,222,274,37,237,334,55,276,284,47,227
060210104012,267,55,212,267,51,216,339,99,235,318,73,231
060210104022,382,116,266,387,108,279,464,167,288,354,127,208
060210104021,213,66,147,210,52,158,314,107,201,204,61,130
060210104025,300,87,213,313,83,230,450,144,301,365,115,232
060210104023,164,49,115,169,49,120,323,116,197,304,111,172
060210104026,226,75,151,229,73,156,337,110,221,207,71,128
060210104027,204,71,133,205,66,139,279,109,164,281,93,167
060150001011,450,229,221,450,224,226,704,332,354,517,210,253
060150001021,719,292,427,721,279,442,869,325,518,554,204,301
060150001022,556,239,317,557,225,332,851,342,479,564,220,285
060150001072,514,242,272,521,238,283,785,347,420,565,232,287
060150001041,854,345,509,866,347,519,606,257,327,645,251,336
060150001063,178,64,114,181,62,119,269,92,168,239,85,132
060150001012,473,248,225,480,245,235,651,329,293,535,255,225
060150001071,346,157,189,348,156,192,642,274,350,356,135,192
060150001061,214,90,124,214,87,127,1015,383,612,799,278,460
060159900000,444,199,245,448,195,253,0,0,0,0,0,0
060150002021,169,78,91,170,74,96,584,276,299,486,207,245
060150002013,994,354,640,990,348,642,1034,303,696,879,230,595
060150002022,157,55,102,159,50,109,308,95,206,224,72,137
060150002024,363,185,178,367,186,181,638,300,331,515,224,265
060150002012,394,136,258,400,130,270,634,221,400,572,175,365
060150002023,392,201,191,399,198,201,506,250,239,450,199,219
060150001062,501,181,320,508,174,334,656,226,411,863,269,525
060150002011,285,87,198,288,88,200,239,73,160,233,65,150
060150002031,258,141,117,261,135,126,461,252,198,365,174,162
060591101062,506,242,264,517,234,283,660,346,301,478,239,208
060591101172,514,254,260,529,248,281,552,297,243,534,279,231
060591101174,528,260,268,542,255,287,898,476,400,782,408,334
060591101023,517,282,235,527,277,250,838,474,345,603,330,240
060591101043,308,165,143,314,166,148,451,251,192,329,183,131
060591101101,294,173,121,298,165,133,581,334,238,388,205,153
060591101102,657,345,312,670,347,323,1225,656,544,872,460,348
060591101103,488,268,220,492,268,224,728,394,321,611,310,257
060591101041,961,481,480,983,485,498,1478,751,705,970,492,410
060591101042,918,451,467,935,443,492,1331,725,581,884,380,440
060591101061,266,137,129,274,135,139,459,264,188,289,149,120
060591101181,547,281,266,563,276,287,736,423,303,651,379,239
060591101182,502,258,244,515,254,261,721,414,294,537,290,214
060591100011,1304,560,744,1324,549,775,1676,796,839,1500,697,711
060591100101,1010,441,569,1024,432,592,1418,685,694,1159,510,573
060591101063,697,321,376,712,311,401,963,486,448,833,403,377
060591101141,606,287,319,613,278,335,920,476,423,654,305,304
060591101143,703,328,375,715,322,393,1005,517,465,749,344,354
060591100112,669,272,397,679,273,406,869,416,436,696,299,355
060591101112,903,455,448,923,454,469,1276,701,559,989,501,441
060591101111,466,250,216,475,251,224,666,372,282,713,341,339
060591101113,577,311,266,591,313,278,928,513,392,674,391,245
060375551073,690,462,228,717,457,260,1128,709,400,839,539,253
060375552122,377,289,88,383,283,100,693,487,186,452,341,81
060591101091,339,178,161,343,174,169,444,246,188,461,209,232
060591101092,338,177,161,344,174,170,682,379,290,478,225,229
060591101093,453,237,216,459,233,226,667,371,284,628,341,245
060591101094,517,261,256,527,258,269,814,412,385,589,295,261
060591101171,701,424,277,716,424,292,958,588,354,778,434,295
060591101173,198,120,78,202,120,82,520,316,191,294,188,89
060591101132,358,166,192,367,165,202,871,433,428,543,257,252
060591100102,620,270,350,630,263,367,782,379,382,620,268,315
060591100103,337,136,201,345,138,207,467,205,245,369,156,193
060591100111,679,296,383,687,287,400,1037,505,501,848,414,387
060591102024,578,281,297,592,278,314,960,502,444,735,398,299
060591101131,525,257,268,530,249,281,753,374,360,609,299,272
060591101142,607,277,330,616,269,347,888,438,424,691,321,322
060591101022,923,472,451,941,467,474,1363,771,570,1138,582,486
060591101161,566,288,278,581,287,294,842,473,356,681,372,265
060591101021,628,313,315,637,309,328,922,515,394,689,347,294
060591101162,617,296,321,624,295,329,884,472,400,653,324,289
060591103041,764,382,382,775,373,402,1082,562,496,945,492,406
060591101151,327,176,151,331,174,157,467,260,197,431,247,161
060591101153,627,300,327,634,299,335,866,464,390,691,335,328
060591101163,386,228,158,393,222,171,824,465,342,583,358,210
060591103012,483,255,228,486,250,236,514,254,248,382,193,167
060591101152,381,216,165,389,214,175,513,295,209,418,239,158
060591103011,964,487,477,983,486,497,1661,879,760,1139,599,479
060590116011,225,171,54,224,168,56,295,215,78,287,221,53
060590116021,223,163,60,222,159,63,482,334,131,384,286,72
060590114033,394,252,142,398,240,158,593,350,225,435,256,155
060590115022,428,276,152,435,272,163,597,371,209,492,290,164
060590113001,710,457,253,717,436,281,1247,773,428,755,488,200
060590112001,393,222,171,407,225,182,537,309,216,429,250,139
060590112004,569,341,228,584,347,237,831,486,324,686,378,256
060590110004,652,373,279,668,372,296,928,524,384,748,343,350
060590113003,252,157,95,258,156,102,395,248,137,168,104,48
060590017053,493,217,276,498,203,295,638,315,306,489,228,223
060590017052,317,167,150,324,166,158,460,253,200,346,174,149
060590017061,484,205,279,491,199,292,659,326,316,556,248,276
060590017064,441,190,251,446,179,267,607,300,292,429,197,206
060590019021,438,265,173,444,250,194,600,354,237,562,323,204
060590110003,217,132,85,218,126,92,269,159,102,237,135,89
060590111023,525,377,148,533,379,154,628,436,180,500,358,119
060590116013,146,106,40,148,106,42,235,165,64,199,126,62
060590116014,345,251,94,348,250,98,434,305,118,358,256,82
060590116015,177,129,48,179,129,50,327,228,88,270,192,62
060590116024,111,81,30,113,81,32,305,212,82,103,66,32
060590019011,442,267,175,450,261,189,597,343,245,527,286,200
060590019012,413,251,162,420,245,175,567,338,217,496,281,178
060590110001,175,105,70,177,102,75,395,224,161,286,139,127
060590111011,755,449,306,763,443,320,1143,667,447,795,473,278
060590111021,402,249,153,412,240,172,486,291,179,468,272,165
060590111022,413,253,160,422,248,174,613,372,225,480,282,168
060590112003,335,177,158,342,172,170,475,268,193,352,178,149
060590112002,446,234,212,454,228,226,498,284,205,417,214,172
060590015053,953,415,538,971,410,561,1108,556,524,999,485,464
060590016021,468,208,260,479,207,272,487,242,232,406,191,198
060590016022,610,241,369,622,229,393,690,322,348,609,228,340
060590016023,868,455,413,891,447,444,602,286,303,572,212,328
060590016025,286,114,172,293,108,185,425,200,214,246,117,106
060590115031,421,202,219,435,196,239,475,239,224,474,206,240
060590115032,254,173,81,260,172,88,181,117,59,271,171,80
060590115042,84,58,26,86,57,29,523,339,166,439,277,129
060590115045,344,236,108,353,233,120,479,312,153,456,288,134
060590114035,477,354,123,482,337,145,605,392,193,450,304,106
060590114032,316,215,101,317,209,108,343,214,118,309,196,90
060590115021,252,154,98,254,151,103,361,199,150,309,180,111
060590117071,642,292,350,653,281,372,801,398,384,628,261,326
060590117082,399,274,125,408,275,133,608,428,164,288,190,74
060590117083,551,245,306,565,241,324,769,375,380,602,259,305
060590115023,582,363,219,588,364,224,838,519,294,668,387,232
060590015051,436,229,207,443,229,214,526,309,206,438,218,188
060590015052,1296,612,684,1317,603,714,1338,647,658,1179,506,586
060590015054,548,246,302,557,243,314,790,388,382,778,350,372
060590117073,697,278,419,712,280,432,1027,470,532,673,300,330
060590117072,269,141,128,274,141,133,877,513,341,445,251,158
060590016041,400,159,241,403,154,249,805,387,403,583,258,296
060590016042,521,231,290,528,225,303,636,324,300,413,183,206
060590015034,558,220,338,566,207,359,712,322,370,632,231,343
060590016043,465,188,277,468,186,282,513,254,251,505,207,270
060590016044,467,188,279,474,187,287,547,270,268,533,219,287
060590015031,368,170,198,374,167,207,479,236,234,309,148,143
060590015033,528,218,310,539,212,327,694,314,368,560,202,325
060590016032,584,246,338,593,247,346,763,390,360,642,288,324
060591106052,553,278,275,564,275,289,672,371,288,550,311,215
060591106053,306,158,148,314,156,158,735,408,311,416,232,168
060591106041,688,354,334,700,351,349,1047,569,464,743,402,322
060591106054,342,162,180,349,161,188,621,328,284,421,230,177
060591106055,433,214,219,447,212,235,551,293,247,471,255,196
060590017042,791,389,402,812,386,426,1016,539,456,875,465,375
060590017102,424,213,211,434,210,224,667,356,298,466,280,166
060591106051,268,138,130,273,136,137,468,251,205,360,196,148
060590110006,628,300,328,645,292,353,878,432,416,658,316,291
060590017043,674,378,296,689,372,317,852,510,336,600,356,216
060590017044,252,141,111,256,137,119,838,496,326,425,250,151
060590110002,385,185,200,393,183,210,487,268,206,405,179,199
060590110005,334,160,174,341,159,182,524,290,221,432,191,212
060590113002,1045,517,528,1072,507,565,1252,695,525,1087,545,480
060590114011,239,138,101,240,133,107,350,218,121,304,176,102
060590016031,1397,624,773,1431,629,802,1486,781,678,1253,585,588
060590017062,420,170,250,430,170,260,552,265,276,457,193,230
060590017063,410,158,252,415,159,256,765,354,395,546,234,273
060590114012,760,386,374,776,381,395,893,480,391,673,342,287
060590114021,497,279,218,504,271,233,536,321,201,532,266,226
060590114022,752,395,357,763,388,375,865,478,362,783,380,350
060590114031,328,185,143,331,177,154,451,268,169,399,198,169
060590016024,547,270,277,559,273,286,861,453,386,719,338,340
060590018012,260,164,96,262,157,105,438,271,155,344,202,121
060590018013,237,124,113,237,123,114,336,183,146,308,160,132
060590018022,494,317,177,500,306,194,672,430,225,515,310,169
060590018023,376,228,148,381,223,158,676,422,237,488,287,166
060590019031,595,352,243,602,345,257,660,379,271,528,274,218
060590019032,345,234,111,345,226,119,645,399,232,491,291,169
060590111012,506,299,207,511,292,219,791,456,327,684,411,233
060590018011,447,311,136,450,295,155,618,412,189,497,302,172
060590017101,498,281,217,513,268,245,728,431,281,557,336,194
060590018014,121,95,26,122,90,32,247,186,57,158,113,31
060590018021,351,246,105,357,239,118,486,325,148,340,219,101
060590019022,515,308,207,521,291,230,753,438,296,552,323,197
060590116012,345,257,88,347,257,90,461,335,117,424,320,80
060590116016,339,254,85,340,251,89,525,379,134,374,280,70
060590117112,471,304,167,478,304,174,714,462,232,571,322,194
060590117113,251,183,68,256,183,73,284,202,74,185,127,44
060590117114,290,211,79,297,211,86,455,319,120,324,218,78
060590117115,215,153,62,218,151,67,631,434,177,499,338,120
060590117122,494,331,163,501,324,177,798,493,289,606,383,185
060590115041,233,166,67,237,163,74,317,218,89,278,173,72
060590115043,166,118,48,169,116,53,216,149,61,210,127,58
060590115044,299,213,86,304,208,96,395,273,113,347,223,85
060590117081,419,267,152,431,272,159,677,436,216,605,354,189
060590117074,647,257,390,656,244,412,875,434,422,921,405,455
060590117092,704,285,419,715,280,435,927,418,493,861,354,464
060590114034,197,147,50,199,142,57,323,227,86,227,158,48
060590116022,687,498,189,695,481,214,768,543,212,659,463,155
060590116023,253,189,64,254,181,73,459,324,122,316,250,40
060590018024,191,141,50,193,136,57,249,171,70,193,133,49
060590018025,197,145,52,198,140,58,412,284,116,309,212,78
060590867012,494,345,149,496,329,167,797,525,256,640,457,141
060591104011,587,350,237,595,350,245,1039,600,417,614,357,224
060590017041,434,200,234,445,200,245,560,286,260,432,214,198
060590017103,589,270,319,605,271,334,916,471,428,620,343,251
060590017083,578,267,311,594,268,326,822,422,380,779,346,393
060590885011,841,478,363,854,470,384,1373,742,603,994,571,347
060590886021,546,309,237,555,305,250,871,465,389,652,403,215
060590880021,401,240,161,407,247,160,674,349,315,533,335,169
060590880022,272,144,128,277,143,134,346,166,173,314,160,139
060590882012,486,266,220,488,250,238,677,321,344,542,299,219
060590880023,518,273,245,520,272,248,787,363,413,593,339,228
060590882011,284,149,135,290,148,142,585,281,292,378,218,144
060590882013,276,146,130,281,144,137,461,220,229,356,198,141
060590882021,416,214,202,425,213,212,633,302,324,400,225,156
060590883011,412,218,194,420,221,199,901,457,428,599,340,225
060590883012,799,419,380,811,421,390,1217,606,592,980,530,409
060590883013,386,205,181,390,206,184,530,269,252,350,200,132
060590882022,566,281,285,573,278,295,903,415,471,673,352,278
060590882031,729,405,324,744,394,350,1132,545,569,850,485,316
060590887021,730,408,322,744,402,342,1189,570,603,831,527,255
060590888012,136,80,56,137,78,59,294,152,135,195,129,55
060590888013,367,202,165,373,200,173,658,307,340,438,276,138
060590883021,716,395,321,725,385,340,1189,616,551,842,491,299
060590883022,584,308,276,597,308,289,853,421,421,732,385,307
060590883023,576,319,257,586,313,273,848,425,405,658,389,237
060590886012,467,257,210,477,255,222,875,445,414,643,393,215
060590886011,309,174,135,312,167,145,497,239,247,351,211,121
060590887011,160,92,68,164,95,69,378,192,180,304,190,98
060590887012,348,198,150,355,196,159,808,375,414,486,275,187
060590887013,488,280,208,502,291,211,781,397,371,518,325,165
060590998011,385,229,156,387,216,171,556,295,251,405,259,125
060590889021,365,221,144,371,212,159,668,298,362,421,280,120
060590889022,545,331,214,559,320,239,871,389,475,562,373,161
060590889023,349,212,137,355,203,152,559,248,305,399,260,116
060590888014,386,214,172,395,219,176,813,403,398,501,353,131
060590888015,309,172,137,314,173,141,539,270,264,317,225,83
060590888022,344,191,153,350,193,157,496,248,244,340,195,123
060590888024,150,83,67,153,84,69,332,164,162,261,149,94
060590888021,313,181,132,320,174,146,646,296,339,355,219,117
060590888023,361,210,151,368,200,168,570,264,304,465,297,148
060590879021,476,277,199,483,267,216,603,330,266,499,328,141
060590880012,308,159,149,315,159,156,663,304,348,499,285,187
060590880013,437,227,210,442,226,216,834,383,427,599,336,232
060590881062,580,335,245,589,326,263,1095,554,523,696,444,209
060590881072,776,450,326,790,437,353,1395,685,690,944,623,275
060591100051,830,315,515,841,312,529,1103,461,620,945,340,527
060591100052,825,329,496,846,326,520,1076,469,589,821,329,439
060591100012,627,272,355,638,266,372,984,439,516,834,348,436
060591100032,912,399,513,926,394,532,1169,514,632,920,393,474
060590881011,571,336,235,575,314,261,961,574,367,641,411,190
060591100031,559,191,368,575,202,373,746,275,457,587,214,338
060591100041,560,231,329,574,231,343,721,310,396,591,222,339
060591100043,513,215,298,523,216,307,691,336,346,608,252,317
060591100042,450,170,280,465,173,292,582,257,313,541,203,302
060591100044,831,313,518,864,321,543,1071,475,575,834,334,456
060590875035,485,261,224,487,256,231,692,384,299,564,318,211
060590884011,456,274,182,461,266,195,711,395,300,562,346,190
060590884013,331,199,132,334,191,143,549,304,232,441,267,150
060590884012,787,478,309,790,473,317,1182,639,529,902,557,304
060590884031,878,599,279,880,571,309,1313,849,427,934,637,228
060590884032,695,435,260,707,426,281,1084,630,428,897,625,220
060590885021,804,503,301,821,493,328,1246,726,492,920,621,260
060590761033,653,426,227,663,412,251,1013,617,379,807,540,221
060590891071,903,569,334,911,547,364,1284,757,515,882,582,256
060590889012,552,315,237,563,313,250,572,286,275,434,290,121
060590889014,431,250,181,439,237,202,774,329,435,470,312,138
060590889041,362,196,166,372,201,171,468,178,288,275,176,90
060590889042,537,296,241,553,301,252,979,381,589,480,311,152
060590881041,676,386,290,685,377,308,960,497,446,680,395,243
060590881051,647,374,273,655,362,293,1085,558,516,784,499,254
060590889033,704,427,277,716,428,288,1221,603,605,872,593,247
060590889032,741,392,349,765,393,372,1394,585,794,871,508,314
060590992031,782,419,363,801,411,390,1345,577,749,944,567,338
060590992032,1008,506,502,1036,502,534,1536,658,858,1063,588,429
060590881042,466,258,208,473,245,228,882,457,408,602,329,236
060590878062,273,191,82,272,179,93,480,283,183,394,273,101
060590876022,567,325,242,573,312,261,804,438,346,636,363,239
060590885012,202,145,57,208,146,62,532,334,188,407,302,85
060590885013,350,250,100,362,251,111,498,314,176,367,274,77
060590888011,349,186,163,354,194,160,594,305,283,413,273,125
060590881052,505,251,254,519,259,260,726,348,369,599,335,226
060590881071,604,300,304,618,309,309,1016,487,520,710,412,272
060590889031,555,295,260,562,293,269,815,341,466,594,359,215
060590882032,482,275,207,494,270,224,811,406,384,621,362,225
060590887014,281,160,121,284,157,127,345,162,179,220,126,86
060590891061,389,247,142,393,241,152,706,418,267,549,390,145
060590891072,505,320,185,512,313,199,942,537,391,713,485,193
060590886013,589,342,247,597,334,263,1027,517,493,611,407,171
060590886014,166,96,70,171,96,75,345,175,158,305,202,85
060590887022,451,261,190,460,259,201,846,395,445,536,369,146
060590890011,359,236,123,362,229,133,460,248,205,361,253,91
060590890032,429,265,164,439,261,178,698,403,284,504,347,134
060590891021,631,429,202,632,415,217,951,573,364,662,476,154
060590891023,438,300,138,440,290,150,711,445,253,467,354,88
060590891042,425,290,135,424,280,144,750,442,304,533,393,117
060590891062,177,121,56,177,117,60,424,266,151,329,251,63
060590761031,318,211,107,319,204,115,344,220,119,198,132,56
060590761032,316,211,105,316,199,117,408,260,133,437,298,112
060590761034,230,154,76,230,145,85,748,413,313,361,245,93
060590884021,598,376,222,599,361,238,855,519,316,621,373,210
060590884022,418,258,160,416,245,171,709,400,292,543,356,157
060590885022,302,187,115,306,180,126,570,306,255,452,290,140
060590885023,105,65,40,106,62,44,348,186,154,279,198,68
060590886022,572,322,250,584,314,270,1031,472,543,613,373,211
060590890031,253,142,111,258,138,120,495,268,220,448,274,154
060590889011,332,178,154,342,179,163,596,254,331,369,244,112
060590889013,535,288,247,545,288,257,845,359,474,557,368,168
060590879011,362,212,150,364,205,159,424,216,202,304,194,99
060590880011,379,202,177,385,201,184,619,291,314,439,238,175
060590879022,325,196,129,328,189,139,617,321,279,453,290,139
060590878052,339,234,105,337,224,113,631,376,238,374,255,90
060590017051,725,381,344,736,378,358,995,548,431,820,405,354
060590012021,398,274,124,399,264,135,449,297,145,392,261,108
060590012022,250,173,77,253,168,85,332,218,106,233,155,65
060590012023,149,102,47,153,100,53,378,249,121,246,160,71
060590014012,358,166,192,363,161,202,440,218,214,399,170,200
060590014014,224,154,70,226,150,76,500,327,159,316,220,76
060590014042,173,119,54,174,115,59,317,210,103,201,142,48
060590014043,275,190,85,274,182,92,366,239,116,271,185,65
060590011033,394,235,159,396,226,170,636,374,244,447,264,155
060590012011,356,232,124,361,223,138,523,329,179,367,229,116
060590012012,311,210,101,309,198,111,552,357,179,402,260,116
060590012013,293,193,100,296,185,111,596,377,201,439,277,135
060590014013,379,182,197,381,176,205,568,291,264,447,234,189
060590011021,327,174,153,330,171,159,523,263,241,392,179,187
060590011022,355,188,167,361,185,176,443,227,207,397,181,191
060590011031,340,181,159,344,177,167,470,261,198,327,186,124
060590014022,425,230,195,431,224,207,777,432,330,527,303,196
060590014041,446,240,206,449,233,216,734,398,317,746,415,280
060590015011,968,451,517,982,440,542,1204,581,601,894,405,441
060590017081,452,222,230,466,211,255,612,321,278,565,274,255
060590017082,544,266,278,556,252,304,760,399,345,571,268,269
060590017091,974,478,496,991,452,539,1405,706,677,1131,562,514
060590013011,448,264,184,453,255,198,582,335,233,428,224,179
060590013014,307,175,132,316,171,145,473,302,160,370,201,145
060590013015,530,337,193,536,327,209,873,533,319,697,407,242
060590013031,536,347,189,541,338,203,902,547,334,619,367,216
060590013033,453,300,153,458,292,166,750,485,248,632,398,195
060590013012,715,344,371,727,331,396,1116,562,537,575,288,255
060590011023,406,223,183,411,217,194,638,325,305,425,207,187
060590011032,443,264,179,452,255,197,679,395,261,455,246,180
060590013013,410,228,182,418,219,199,581,296,278,550,265,248
060590014011,563,252,311,570,245,325,812,387,405,616,262,317
060590013041,151,115,36,150,108,42,330,242,82,251,164,68
060590014023,514,270,244,525,264,261,876,477,386,525,294,201
060590014021,722,378,344,735,368,367,723,393,316,800,345,410
060590014031,728,314,414,750,316,434,863,385,458,735,282,406
060590014032,854,381,473,873,377,496,1159,537,602,904,372,483
060590011012,392,169,223,395,162,233,558,270,273,478,205,251
060590011014,408,187,221,412,174,238,529,271,252,436,188,225
060590011013,425,212,213,437,201,236,546,286,246,376,160,195
060590011011,537,280,257,546,273,273,818,444,358,671,337,296
060590013032,511,324,187,515,313,202,731,452,262,627,397,184
060590013042,602,381,221,606,366,240,1096,677,392,650,401,219
060590865011,356,275,81,356,266,90,544,405,129,473,355,92
060590865021,207,132,75,208,128,80,463,307,144,396,266,101
060590117201,120,103,17,121,99,22,233,182,44,177,138,29
060590867021,240,175,65,241,167,74,294,202,89,301,209,75
060590867026,278,203,75,277,192,85,354,243,105,319,220,80
060590867022,153,111,42,151,104,47,301,203,88,188,136,39
060590867023,194,142,52,194,134,60,365,248,107,256,188,50
060590867025,133,97,36,133,92,41,291,197,86,200,146,39
060590867024,221,161,60,223,154,69,437,294,127,277,203,53
060590869011,158,113,45,159,108,51,382,234,140,327,241,73
060590869015,247,175,72,247,167,80,352,224,117,257,162,76
060590869017,170,118,52,173,115,58,286,183,95,222,140,66
060590869025,226,156,70,226,150,76,244,158,83,174,108,53
060590869021,337,207,130,334,197,137,285,172,106,275,174,86
060590869022,162,97,65,160,92,68,269,161,101,184,116,57
060591102023,217,149,68,216,141,75,369,237,123,267,180,66
060590219051,982,408,574,999,403,596,1183,532,637,1013,414,557
060590219054,552,240,312,568,240,328,642,308,329,563,254,289
060590219053,538,202,336,544,193,351,703,308,381,567,200,332
060591104022,310,220,90,314,218,96,422,272,144,321,222,81
060591104023,421,302,119,424,298,126,762,495,249,621,432,147
060590868013,256,150,106,259,142,117,408,238,155,384,222,135
060590218121,472,126,346,476,122,354,595,205,378,486,133,327
060590218124,365,162,203,369,167,202,525,236,278,352,157,171
060590218122,535,253,282,539,247,292,729,354,358,572,259,276
060590218123,504,240,264,506,233,273,807,413,370,700,314,340
060590219232,477,192,285,486,188,298,685,317,359,663,300,336
060590219234,559,246,313,578,249,329,858,412,436,638,289,325
060590219235,629,276,353,649,278,371,856,410,433,696,315,352
060590870015,336,200,136,337,188,149,468,246,209,385,232,137
060590870014,359,213,146,361,198,163,578,327,242,455,276,157
060590870013,239,142,97,237,130,107,351,197,148,302,184,104
060590219241,457,212,245,465,213,252,584,285,283,544,279,234
060590219244,702,335,367,721,344,377,1221,630,570,719,371,313
060590219242,380,175,205,383,172,211,380,188,181,381,162,191
060590219243,203,94,109,208,94,114,398,195,192,244,105,122
060590869024,308,156,152,314,156,158,596,314,268,470,263,187
060590869023,338,169,169,343,169,174,501,254,232,476,258,197
060590869031,222,124,98,225,123,102,431,242,178,276,149,107
060590869033,482,269,213,488,265,223,698,393,289,572,309,223
060590863036,311,171,140,310,167,143,290,163,124,234,127,99
060590219211,861,245,616,876,230,646,873,300,562,701,194,474
060590219052,676,257,419,692,253,439,883,351,520,774,283,459
060590218071,674,352,322,679,339,340,863,467,378,804,361,390
060590218163,909,346,563,931,337,594,1190,511,651,1023,387,591
060590218131,6,3,3,6,3,3,43,22,20,9,5,4
060590219122,1198,395,803,1223,376,847,1118,382,712,1033,366,602
060590219233,553,224,329,562,213,349,1108,498,592,610,237,329
060590219201,481,202,279,491,197,294,453,215,231,379,158,204
060590219202,565,234,331,573,222,351,691,328,351,753,322,393
060590219205,429,181,248,438,177,261,782,377,392,654,291,331
060590219191,834,379,455,847,377,470,731,341,377,666,294,339
060590219192,542,247,295,550,245,305,1011,474,523,846,372,430
060590218072,541,220,321,555,222,333,787,336,441,599,237,335
060590218073,409,160,249,419,159,260,593,242,341,489,179,287
060590219162,312,124,188,315,122,193,582,249,323,504,202,283
060590219163,507,203,304,514,200,314,619,264,344,478,177,278
060590867015,291,173,118,290,165,125,280,162,113,286,167,103
060590867011,397,236,161,401,228,173,500,292,205,574,331,208
060590867013,279,166,113,281,160,121,373,217,151,143,88,50
060590867016,286,170,116,289,165,124,830,481,335,489,295,173
060590874012,365,256,109,362,245,117,467,313,140,397,263,95
060590874013,350,245,105,344,234,110,566,376,170,415,274,97
060590868035,220,140,80,224,139,85,398,245,141,300,187,94
060590219121,925,330,595,938,325,613,1202,519,665,924,341,542
060590219204,755,338,417,770,336,434,1036,541,476,812,361,410
060590219206,554,251,303,562,248,314,740,357,367,642,302,305
060590219203,344,156,188,347,153,194,441,213,219,367,170,180
060590219212,839,339,500,855,333,522,1219,554,645,988,400,543
060590219221,785,340,445,807,340,467,1118,561,540,920,414,460
060590219213,486,195,291,496,192,304,754,343,399,567,249,295
060590219223,341,151,190,350,150,200,511,246,252,405,191,194
060590219224,569,262,307,582,257,325,845,415,413,657,297,328
060590117221,440,242,198,447,238,209,546,295,247,447,233,189
060590117223,306,168,138,312,166,146,465,251,210,400,210,169
060590878053,254,174,80,258,167,91,471,326,136,334,210,104
060590878032,139,103,36,143,106,37,289,220,53,199,151,39
060590864044,331,242,89,328,233,95,602,424,165,442,311,109
060590864043,275,201,74,275,193,82,377,267,104,293,218,58
060590864041,332,244,88,333,235,98,517,361,143,395,294,77
060590864042,318,233,85,317,224,93,505,352,138,361,253,90
060590871063,293,190,103,295,182,113,419,265,148,374,237,112
060590871062,100,65,35,102,62,40,304,190,106,199,126,60
060590876011,226,147,79,229,142,87,387,241,135,306,195,93
060590876013,121,79,42,122,75,47,278,174,97,140,89,42
060590876014,260,170,90,262,162,100,268,171,93,247,156,75
060590877033,318,204,114,323,199,124,430,250,172,328,220,92
060590877032,330,206,124,333,201,132,591,345,235,425,288,119
060590878061,323,226,97,328,215,113,552,339,207,364,257,90
060590871011,418,249,169,416,227,189,627,361,254,505,290,190
060590877015,357,212,145,370,211,159,534,288,229,395,237,136
060590877012,235,137,98,235,134,101,321,177,138,261,158,90
060590877035,335,218,117,337,207,130,459,271,176,379,254,102
060590877034,247,161,86,250,154,96,513,301,195,390,261,104
060590877031,201,131,70,204,125,79,355,208,136,206,140,55
060590863011,620,432,188,626,419,207,658,439,208,489,329,131
060590873023,303,219,84,309,215,94,473,328,132,395,278,88
060590873021,271,196,75,273,191,82,516,365,141,440,315,91
060590873026,138,102,36,139,99,40,369,262,95,316,231,61
060590873025,179,130,49,184,129,55,278,192,81,191,142,35
060590874011,233,171,62,235,168,67,633,453,164,134,100,25
060590874014,326,239,87,327,234,93,422,305,110,401,295,79
060590877011,529,282,247,524,265,259,705,374,327,550,314,204
060590877013,214,114,100,215,109,106,409,213,185,283,163,105
060590871036,274,151,123,276,146,130,414,224,182,338,190,124
060590871032,363,200,163,367,197,170,557,303,246,429,258,150
060590871035,247,137,110,249,131,118,440,240,193,313,191,109
060590871034,417,231,186,422,224,198,645,352,286,457,273,160
060590871051,420,269,151,422,265,157,734,459,267,525,336,163
060590876012,379,219,160,382,216,166,542,304,225,399,234,142
060590877044,277,160,117,279,157,122,341,193,142,356,209,127
060590877045,180,104,76,181,102,79,403,227,167,297,174,106
060590877041,214,123,91,215,121,94,319,182,132,227,134,82
060590876024,176,105,71,180,103,77,572,322,238,173,114,48
060590876026,146,87,59,149,86,63,172,98,72,116,77,33
060590876027,111,66,45,113,65,48,186,105,78,161,93,59
060590876025,322,192,130,325,187,138,431,242,179,346,198,126
060590877042,292,174,118,294,169,125,407,231,172,389,236,133
060590877043,352,209,143,356,205,151,508,287,212,448,291,138
060590871061,302,192,110,304,189,115,328,208,113,244,153,75
060590875051,711,451,260,721,449,272,625,399,214,485,306,149
060590875052,126,80,46,129,80,49,723,456,245,563,351,173
060590875053,183,116,67,188,117,71,354,227,121,292,185,91
060590875034,209,112,97,210,114,96,380,215,156,236,134,88
060590864051,466,352,114,470,337,133,363,257,99,255,196,44
060590864052,238,180,58,239,173,66,508,359,137,372,285,62
060590864053,196,148,48,198,142,56,276,195,74,272,202,55
060590864054,188,142,46,189,136,53,537,379,145,325,240,67
060590864055,207,157,50,208,150,58,410,293,111,389,286,81
060590865012,329,257,72,329,249,80,366,277,86,326,241,69
060590865013,218,171,47,219,167,52,242,184,58,331,229,85
060590865022,200,158,42,202,153,49,490,364,112,285,232,35
060590865024,164,129,35,164,124,40,290,214,66,175,143,21
060590865023,220,173,47,221,167,54,352,259,79,206,165,26
060590873011,171,122,49,175,120,55,517,352,151,434,297,108
060590873024,227,162,65,232,160,72,274,186,79,253,186,46
060590873012,294,211,83,300,207,93,491,335,145,348,240,88
060590873013,215,155,60,221,151,70,399,275,118,204,149,41
060590873022,52,37,15,52,36,16,75,51,22,23,17,4
060590866021,408,255,153,406,243,163,655,409,226,437,293,116
060590866023,251,157,94,252,151,101,460,287,159,315,211,84
060590872001,317,197,120,320,191,129,344,217,121,402,237,153
060590872002,327,224,103,329,215,114,312,207,100,313,202,100
060590863014,292,223,69,292,212,80,534,380,145,385,288,75
060590863015,412,316,96,414,299,115,566,402,155,444,330,85
060590863013,381,249,132,384,239,145,616,401,210,455,303,130
060590863012,408,261,147,412,255,157,581,372,200,521,357,136
060590874041,344,269,75,342,257,85,612,440,152,434,332,77
060590874042,197,153,44,195,147,48,249,181,62,173,133,32
060590874051,195,152,43,194,146,48,298,217,73,251,193,44
060590874052,156,122,34,155,117,38,248,180,61,209,159,38
060590874053,165,129,36,162,122,40,389,284,96,305,233,55
060590874054,217,169,48,216,162,54,312,229,77,232,179,42
060591106043,650,342,308,661,337,324,1584,856,689,1123,605,456
060590872006,262,166,96,265,161,104,507,340,151,322,229,73
060590872005,480,250,230,486,246,240,541,306,224,555,284,234
060590872007,279,197,82,279,187,92,371,249,110,344,219,100
060590872004,222,157,65,220,147,73,342,230,102,319,201,92
060590872003,181,128,53,182,122,60,354,238,105,309,228,63
060590866022,245,163,82,244,161,83,624,402,208,407,274,103
060590761042,106,78,28,108,78,30,325,238,79,175,117,45
060590761043,292,215,77,296,212,84,178,131,43,233,156,60
060590761044,132,97,35,134,96,38,433,317,105,200,134,52
060590761041,769,573,196,776,560,216,1019,723,272,702,468,185
060590863034,231,170,61,235,169,66,1416,1037,345,242,163,62
060590863035,300,221,79,305,219,86,811,580,213,338,221,95
060590874032,133,110,23,134,105,29,307,229,67,255,193,46
060590874031,233,190,43,230,179,51,215,161,50,197,150,35
060590874033,69,57,12,71,55,16,138,104,31,97,76,17
060590863061,327,188,139,331,185,146,377,224,148,364,209,130
060590863062,267,153,114,271,152,119,588,348,229,438,252,157
060590863063,492,265,227,498,261,237,587,334,241,488,259,198
060590863043,344,201,143,345,192,153,426,246,170,358,205,136
060590863044,220,130,90,221,124,97,599,359,227,339,195,124
060590863051,692,404,288,693,388,305,790,453,312,637,358,240
060590219031,599,242,357,608,235,373,839,375,445,659,251,368
060590219154,386,141,245,391,142,249,637,267,361,467,178,268
060590219151,398,147,251,407,148,259,511,214,287,458,176,259
060590219153,575,220,355,584,219,365,688,291,384,632,267,335
060590219152,552,218,334,559,213,346,724,323,392,565,223,312
060590219032,738,366,372,752,360,392,1033,514,495,757,365,350
060590219033,375,186,189,383,183,200,631,315,303,458,221,207
060590758131,1082,388,694,1101,385,716,1399,578,791,1252,437,755
060590758133,957,348,609,975,348,627,1345,561,756,957,376,529
060590218213,628,303,325,642,297,345,984,526,439,632,342,257
060590218125,672,298,374,681,308,373,888,400,465,602,270,293
060590877014,121,73,48,122,74,48,238,134,100,173,117,49
060590870023,515,309,206,518,306,212,780,429,341,617,376,213
060590870024,479,290,189,483,285,198,835,463,352,688,407,239
060590117151,757,278,479,774,280,494,952,401,536,830,313,463
060590218212,757,466,291,762,453,309,1606,961,615,1015,540,395
060590117102,967,420,547,983,399,584,1249,577,647,1048,409,564
060590117181,741,259,482,759,252,507,1011,401,586,840,320,465
060590117172,399,148,251,411,151,260,510,213,280,449,170,248
060590117123,573,325,248,588,318,270,777,491,268,600,377,189
060590117161,457,240,217,467,233,234,923,516,394,698,342,322
060590117162,1485,713,772,1515,694,821,1847,937,878,1499,741,687
060590117213,477,273,204,490,269,221,899,539,341,365,244,92
060590117101,772,327,445,787,323,464,1025,499,504,766,330,389
060590117111,443,203,240,453,206,247,567,275,281,576,244,292
060590117093,1037,423,614,1056,412,644,1316,607,686,1033,390,571
060590218202,1466,666,800,1490,649,841,1669,801,832,1454,643,728
060590218211,682,344,338,692,338,354,1081,577,480,908,446,405
060590117152,1658,715,943,1679,696,983,2044,958,1058,1652,657,906
060590869013,302,177,125,306,174,132,385,225,155,278,165,97
060590869014,204,115,89,204,114,90,352,203,141,217,126,75
060591102022,373,215,158,379,208,171,594,338,245,412,236,150
060591102021,312,199,113,316,193,123,547,334,200,395,248,120
060590117222,268,160,108,276,159,117,322,171,148,343,128,202
060590117121,408,276,132,411,265,146,602,391,202,417,270,128
060590117211,199,155,44,199,152,47,297,226,65,262,174,66
060590117212,288,209,79,288,204,84,422,322,91,450,302,114
060590218102,742,293,449,757,281,476,996,421,547,801,336,416
060590117141,155,104,51,156,101,55,376,256,111,263,166,83
060590117202,350,283,67,349,268,81,474,353,113,346,264,62
060590218101,540,175,365,556,167,389,700,252,439,597,213,348
060590117171,938,357,581,957,350,607,1317,565,714,1057,382,608
060590868011,401,233,168,410,234,176,626,368,245,437,257,157
060590117091,576,230,346,584,220,364,745,337,392,604,227,334
060590117203,196,145,51,196,139,57,420,292,117,336,256,60
060590218312,148,46,102,149,46,103,1280,662,600,206,73,122
060590218311,1199,484,715,1220,471,749,1811,809,975,1307,508,736
060590117182,928,371,557,940,351,589,1064,471,566,990,350,573
060590878063,178,114,64,180,109,71,341,192,139,220,127,78
060590878064,227,157,70,231,148,83,336,199,130,247,161,72
060590864071,632,376,256,639,365,274,738,457,265,614,364,216
060590864073,332,180,152,332,176,156,512,303,202,387,230,135
060590868034,586,378,208,593,356,237,727,447,265,376,226,130
060590868033,131,83,48,132,81,51,148,91,53,160,96,53
060590868036,255,163,92,256,158,98,312,195,115,265,159,88
060590870011,155,99,56,156,97,59,358,213,138,232,141,77
060590870012,119,76,43,120,70,50,374,230,136,234,139,82
060590868021,405,268,137,407,261,146,608,395,209,437,293,121
060590868023,456,302,154,460,294,166,604,390,205,479,319,132
060590868024,154,98,56,156,96,60,458,299,151,333,217,97
060590869012,263,141,122,263,141,122,596,329,257,441,246,168
060590878054,474,280,194,473,274,199,788,458,315,823,544,244
060590871064,312,205,107,316,206,110,460,290,157,397,265,103
060590117153,824,360,464,834,350,484,1166,566,577,945,397,491
060590866024,335,244,91,334,241,93,470,322,140,356,238,91
060590875032,224,147,77,228,147,81,270,168,95,205,122,71
060599800001,15,11,4,15,11,4,8,6,2,3,2,1
060590864024,436,291,145,437,281,156,442,281,151,356,226,109
060590864023,159,106,53,159,102,57,442,281,152,362,229,110
060590864061,157,105,52,156,100,56,260,165,89,198,125,60
060590864021,342,204,138,343,195,148,482,295,175,382,239,130
060590864022,417,248,169,424,240,184,598,365,218,445,276,153
060590864062,248,148,100,250,142,108,599,365,219,447,271,155
060590864063,307,158,149,309,155,154,326,188,132,302,179,102
060590864064,241,121,120,244,119,125,429,242,180,333,197,113
060590864072,305,186,119,309,180,129,712,445,250,473,280,164
060590864074,224,136,88,226,131,95,452,283,157,367,216,128
060590863041,266,158,108,266,149,117,472,286,176,277,162,101
060590863053,332,196,136,335,189,146,471,286,176,549,304,217
060590863031,276,153,123,279,152,127,485,271,203,440,240,178
060590762021,396,217,179,401,209,192,564,312,234,436,251,157
060590761021,332,232,100,332,223,109,626,431,181,368,250,98
060590875042,268,196,72,266,186,80,538,362,163,327,225,86
060590875041,87,70,17,88,65,23,287,212,68,153,123,20
060590875044,320,228,92,320,219,101,431,291,131,292,202,76
060590875031,207,165,42,207,154,53,290,213,68,222,167,39
060590875033,184,146,38,183,136,47,331,243,78,267,199,48
060590875043,199,157,42,198,147,51,545,398,127,378,301,47
060590863032,242,154,88,243,151,92,306,192,105,278,175,86
060590863037,376,239,137,379,235,144,510,322,175,414,258,128
060590863033,149,95,54,150,93,57,338,214,117,203,126,63
060590871033,368,220,148,369,213,156,598,344,239,462,288,153
060590871037,326,193,133,332,191,141,326,190,133,289,183,96
060590871031,120,72,48,123,70,53,330,189,131,210,130,69
060590876021,312,184,128,315,186,129,532,308,216,404,253,123
060590876023,371,219,152,374,221,153,545,314,220,441,275,135
060590870021,309,177,132,313,169,144,478,272,199,328,188,122
060590870022,417,239,178,424,229,195,856,485,355,653,368,244
060590871012,241,154,87,244,148,96,343,220,118,283,197,69
060590871021,197,143,54,199,140,59,384,255,118,271,199,56
060590871025,191,139,52,194,136,58,399,264,123,91,62,22
060590871022,337,244,93,339,238,101,400,266,124,197,133,47
060590871024,188,136,52,188,132,56,254,169,78,157,115,32
060590871023,140,102,38,140,99,41,313,207,96,234,173,48
060590869016,243,173,70,242,165,77,499,307,183,447,329,100
060591102011,743,439,304,746,408,338,1260,713,511,967,578,331
060590868031,422,287,135,429,278,151,685,438,236,444,310,110
060590871013,62,42,20,63,41,22,265,168,91,234,163,58
060590871014,214,145,69,216,140,76,442,281,152,306,212,75
060590626524,444,220,224,448,220,228,399,210,182,365,182,172
060590626532,10,5,5,9,5,4,337,224,106,11,6,5
060590626491,845,424,421,850,420,430,1193,641,539,1056,532,488
060590626481,303,150,153,309,150,159,526,281,241,444,218,211
060590626482,927,478,449,931,468,463,762,420,336,698,363,315
060590626483,866,474,392,878,473,405,1106,626,470,1039,569,440
060590626493,454,256,198,456,253,203,557,298,253,449,256,183
060590626461,593,320,273,601,316,285,470,261,206,427,225,189
060590626462,260,140,120,264,139,125,677,376,297,502,265,222
060590626463,862,462,400,874,466,408,1118,626,482,948,495,422
060590626464,412,221,191,416,218,198,531,294,233,495,261,219
060590626472,358,192,166,362,191,171,488,271,214,398,210,176
060590626474,327,175,152,331,177,154,712,404,300,537,277,242
060590626251,669,358,311,676,364,312,617,349,260,510,263,229
060590626252,595,318,277,601,323,278,791,448,334,558,288,252
060590626473,511,277,234,522,283,239,791,445,336,653,321,301
060590626411,728,453,275,732,445,287,1697,1045,615,1021,608,368
060590626413,858,472,386,877,460,417,561,303,251,546,311,215
060590626221,964,472,492,980,473,507,467,245,218,422,205,203
060590626222,247,121,126,251,121,130,584,307,273,496,241,239
060590626223,614,301,313,625,302,323,729,383,341,560,272,269
060590626225,456,223,233,464,224,240,1087,571,508,864,420,416
060590871053,413,232,181,417,224,193,612,333,266,519,296,199
060590871052,462,259,203,467,251,216,674,403,259,526,340,155
060590878011,692,375,317,697,361,336,821,429,371,698,408,259
060590878023,455,265,190,457,254,203,542,291,246,374,198,154
060590219164,396,142,254,404,143,261,548,241,299,347,125,205
060590219161,524,188,336,533,189,344,688,301,375,607,208,365
060590758143,542,219,323,556,214,342,856,388,453,647,270,346
060590219222,269,116,153,276,117,159,437,208,221,314,152,143
060590219231,604,262,342,621,262,359,857,409,434,670,297,338
060590866011,166,129,37,167,125,42,406,277,117,267,205,45
060590866014,258,201,57,259,194,65,338,231,97,287,220,49
060590866015,159,124,35,160,120,40,169,116,49,117,91,21
060590866016,147,116,31,148,111,37,235,161,68,178,136,30
060590866012,263,206,57,265,199,66,530,375,138,388,306,62
060590866013,373,291,82,375,282,93,523,370,136,449,347,70
060590867014,356,247,109,360,240,120,543,353,177,432,306,95
060590868022,254,177,77,255,170,85,432,278,151,357,244,95
060591102031,443,221,222,448,210,238,708,338,355,570,246,289
060591102033,267,142,125,268,140,128,540,327,199,353,204,134
060591102034,208,112,96,209,110,99,274,136,130,294,143,133
060590869034,144,92,52,145,90,55,284,165,112,220,134,72
060590869035,206,131,75,208,129,79,492,295,186,369,224,121
060590869032,301,192,109,304,188,116,345,204,137,305,186,99
060590863045,275,134,141,277,133,144,460,249,202,340,159,163
060590863042,255,125,130,259,124,135,411,221,181,353,164,168
060590863052,420,207,213,426,205,221,589,321,262,430,201,207
060590762041,369,183,186,373,175,198,435,230,197,381,182,173
060590879012,555,361,194,556,344,212,932,533,384,689,493,166
060590881061,532,293,239,536,285,251,901,486,401,777,421,314
060590878012,559,319,240,567,321,246,916,483,415,735,432,262
060590878031,315,215,100,316,201,115,453,249,197,563,398,141
060590878024,113,70,43,114,67,47,360,214,140,245,144,88
060590878022,618,393,225,625,378,247,1067,642,402,875,511,312
060590878033,347,226,121,348,217,131,677,364,306,320,216,78
060590879023,512,356,156,521,354,167,808,463,331,734,470,215
060590878013,312,183,129,319,182,137,460,248,204,295,174,104
060590878021,493,334,159,499,322,177,907,564,322,609,422,164
060590878051,116,90,26,116,81,35,185,126,49,309,222,66
060590218171,1226,485,741,1248,474,774,1772,776,956,1406,514,787
060590218161,489,142,347,499,141,358,582,203,367,463,129,314
060590218162,985,329,656,1005,324,681,1255,467,762,1030,342,639
060590218313,539,220,319,551,220,331,690,318,359,630,268,332
060590218224,954,377,577,972,367,605,1175,560,595,777,306,425
060590218231,1780,587,1193,1796,572,1224,2794,1097,1640,1908,700,1113
060590218241,561,168,393,570,167,403,682,252,419,805,246,523
060590218242,817,252,565,824,247,577,864,306,539,728,209,485
060590218221,572,201,371,584,199,385,486,203,273,477,169,280
060590218225,830,313,517,849,308,541,1414,648,742,1167,420,683
060590218222,399,130,269,407,126,281,1080,423,641,495,194,278
060590218251,859,258,601,879,260,619,1026,377,627,813,252,518
060590218271,658,254,404,679,266,413,970,444,511,920,333,549
060590218252,645,204,441,657,206,451,916,363,538,741,253,449
060590218301,754,228,526,769,229,540,842,313,516,724,239,445
060590218304,771,236,535,786,235,551,1059,381,661,893,292,555
060590218291,1135,355,780,1152,347,805,1353,502,828,1319,409,839
060590218103,473,178,295,479,163,316,632,256,366,568,202,338
060590218092,530,186,344,538,181,357,710,284,413,634,224,382
060590218021,700,230,470,712,221,491,929,352,555,719,240,441
060590218022,695,248,447,710,237,473,821,322,479,700,251,410
060590218024,654,243,411,665,234,431,870,365,485,744,278,426
060590218026,348,135,213,356,130,226,685,308,366,388,140,232
060590218023,643,195,448,655,194,461,757,279,461,665,195,442
060590218272,718,276,442,733,275,458,857,377,464,912,371,488
060590218261,599,230,369,606,218,388,873,368,483,717,268,403
060590218262,446,172,274,455,165,290,644,273,359,519,194,293
060590218282,555,202,353,565,198,367,799,336,450,580,208,345
060590218281,589,191,398,593,185,408,675,272,395,467,160,287
060590218283,834,291,543,843,287,556,1297,532,749,986,368,571
060590218091,860,282,578,871,271,600,1353,518,808,974,338,584
060590218201,697,204,493,708,194,514,885,314,556,768,229,501
060590218302,743,223,520,756,221,535,1068,375,673,980,292,640
060590218303,806,320,486,816,315,501,1049,489,545,824,374,417
060590218025,344,110,234,351,108,243,413,151,254,366,121,227
060590218223,938,301,637,954,292,662,1391,510,860,1157,391,710
060590218172,420,166,254,426,163,263,584,247,324,452,169,254
060590218292,866,270,596,878,263,615,1089,407,664,1002,343,611
060590218293,768,311,457,776,305,471,1062,494,551,860,346,479
060590992311,946,386,560,966,380,586,1191,520,633,999,395,543
060590992314,428,175,253,437,171,266,587,260,313,448,177,243
060590992142,304,133,171,312,136,176,587,278,292,401,171,202
060590992313,990,416,574,1014,417,597,1188,534,624,972,430,491
060590992293,273,152,121,279,153,126,429,227,196,307,185,111
060590992294,502,279,223,514,282,232,671,356,307,577,346,208
060590992291,875,432,443,890,432,458,1075,542,507,946,484,405
060590992292,1040,505,535,1064,502,562,1130,581,530,928,451,420
060590992332,699,321,378,705,326,379,945,434,488,774,343,386
060590992341,670,308,362,680,314,366,904,417,467,670,299,333
060590992261,710,354,356,723,360,363,997,470,512,772,413,323
060590992262,798,366,432,819,372,447,948,423,512,785,392,361
060590992021,770,500,270,770,483,287,1080,597,463,705,456,219
060590992023,528,355,173,527,342,185,851,493,342,613,408,179
060590992271,313,177,136,317,170,147,435,217,213,331,185,135
060590992241,786,349,437,800,337,463,1108,514,578,799,380,372
060590992242,694,294,400,709,291,418,965,432,516,778,359,372
060590992252,777,331,446,791,325,466,1028,459,551,836,361,424
060590992331,827,359,468,848,368,480,1075,492,558,857,374,428
060590992342,447,195,252,460,198,262,541,247,280,557,235,291
060590992343,541,230,311,558,235,323,668,284,376,603,257,309
060590992321,842,386,456,870,394,476,1193,574,598,909,388,464
060590992323,648,280,368,661,276,385,792,362,411,693,289,364
060590992324,512,222,290,524,220,304,634,293,331,552,236,283
060590992233,524,245,279,532,250,282,715,297,401,590,325,241
060590992301,883,379,504,910,382,528,1114,503,588,918,397,459
060590992302,1152,530,622,1182,537,645,1734,838,859,1265,611,573
060590992043,732,356,376,753,347,406,1102,480,612,822,441,346
060590992251,658,286,372,668,288,380,979,419,549,705,329,336
060590992272,345,220,125,349,217,132,528,323,192,287,202,61
060590992273,697,337,360,715,338,377,962,437,512,747,368,346
060590992274,594,326,268,605,327,278,1228,629,579,921,532,331
060590992312,437,192,245,449,198,251,650,304,335,494,222,247
060590992322,514,225,289,534,235,299,800,375,413,584,251,300
060590992502,454,194,260,466,195,271,716,303,402,492,201,268
060590992511,547,325,222,560,322,238,793,429,344,571,328,205
060590992512,507,261,246,518,263,255,1216,629,559,994,499,428
060590992501,735,331,404,761,336,425,749,356,384,658,307,316
060590992513,561,285,276,574,286,288,791,416,361,603,289,272
060590994161,527,289,238,541,292,249,827,436,368,677,309,322
060590994162,352,192,160,362,195,167,510,270,228,483,222,231
060590994163,874,475,399,901,483,418,1188,626,528,1029,516,449
060590995131,723,259,464,733,257,476,1018,405,590,826,301,482
060590995061,683,268,415,706,280,426,753,323,416,730,289,391
060590995132,419,143,276,422,143,279,519,191,319,428,148,262
060590995141,510,155,355,521,155,366,677,236,427,580,203,352
060590995144,383,128,255,390,126,264,419,158,253,379,130,231
060590995145,539,180,359,553,180,373,653,247,394,584,200,356
060590993052,571,277,294,586,275,311,928,447,452,699,314,336
060590993054,381,190,191,393,191,202,650,311,326,501,234,235
060590993053,298,145,153,307,145,162,464,224,226,323,141,158
060590993092,856,408,448,875,400,475,1141,540,582,778,300,424
060590994181,647,329,318,659,327,332,1034,521,496,722,348,340
060590994182,327,162,165,335,161,174,470,236,225,397,175,198
060590994193,501,171,330,506,174,332,696,265,419,578,209,349
060590994151,560,220,340,572,222,350,680,297,359,573,236,305
060590992412,690,394,296,702,391,311,1108,543,543,706,411,253
060590993055,477,244,233,489,243,246,616,312,291,515,243,238
060590993094,470,231,239,482,231,251,681,340,330,454,217,209
060590993093,330,163,167,336,161,175,452,227,218,422,203,193
060590994191,480,232,248,491,232,259,477,238,230,431,192,216
060590992442,1215,557,658,1243,561,682,1487,720,751,1233,552,645
060590994154,720,272,448,742,280,462,892,412,456,758,287,415
060590992461,592,244,348,611,248,363,723,315,401,601,238,329
060590992462,926,382,544,953,387,566,1199,516,659,1009,405,538
060590992463,332,137,195,343,139,204,483,209,267,372,149,203
060590995142,1051,388,663,1084,398,686,1196,512,657,980,400,525
060590995143,745,227,518,761,226,535,922,328,577,670,258,375
060590993061,641,340,301,665,346,319,970,480,468,726,339,340
060590993062,461,236,225,476,239,237,719,332,364,509,241,234
060590993063,397,208,189,409,211,198,659,327,319,469,219,217
060590993065,422,206,216,430,201,229,598,289,293,491,224,234
060590992421,626,299,327,634,304,330,831,395,416,662,336,279
060590992422,717,344,373,728,349,379,1023,486,511,773,318,407
060590994101,344,216,128,346,213,133,431,252,169,639,340,260
060590994103,541,340,201,546,336,210,906,524,354,608,394,182
060590997022,850,427,423,865,423,442,1258,568,667,936,453,416
060590997031,417,234,183,425,233,192,759,401,340,475,250,198
060590994061,860,376,484,881,377,504,1071,468,581,897,365,478
060590994062,1106,519,587,1129,524,605,1563,740,785,1224,543,606
060590996042,924,420,504,947,432,515,1037,472,533,994,440,497
060590996052,1175,596,579,1195,605,590,1779,909,828,940,458,428
060590996034,617,276,341,640,279,361,825,383,424,693,308,343
060590996041,839,350,489,855,353,502,1032,442,569,847,355,429
060590996051,861,378,483,874,377,497,1229,564,635,997,448,482
060590994072,1076,493,583,1091,493,598,1169,550,592,979,420,494
060590994071,359,157,202,365,157,208,391,180,200,368,164,180
060590994081,387,166,221,395,166,229,681,318,346,530,217,278
060590994083,432,205,227,440,207,233,539,256,268,499,224,240
060590994052,594,268,326,606,264,342,810,357,433,711,309,359
060590994053,660,311,349,680,310,370,1200,569,606,1337,643,609
060590993101,771,370,401,785,372,413,1058,490,547,820,380,392
060590993102,745,357,388,760,360,400,1117,525,561,834,394,372
060590993103,385,182,203,394,185,209,584,280,288,448,204,206
060590992401,434,185,249,443,185,258,494,221,256,473,186,260
060590992403,387,165,222,394,165,229,498,225,258,342,157,165
060590992404,627,268,359,637,267,370,1001,449,517,743,351,340
060590992431,1297,560,737,1327,555,772,1659,784,837,1327,586,659
060590992451,738,324,414,747,315,432,905,450,442,822,347,422
060590992141,534,234,300,541,236,305,554,263,279,497,197,270
060590992152,885,388,497,903,394,509,1156,551,582,870,346,461
060590993081,1099,401,698,1118,403,715,1323,557,743,1038,363,619
060590993082,1001,379,622,1019,374,645,1404,542,836,1151,404,688
060590993083,1213,435,778,1234,443,791,1338,580,741,1130,443,643
060590994041,1103,479,624,1125,486,639,1466,693,739,1143,472,604
060590992143,409,179,230,420,179,241,589,261,320,493,196,268
060590992144,519,226,293,531,226,305,600,265,325,455,180,247
060590992163,394,168,226,404,173,231,639,293,334,466,191,250
060590992441,1091,488,603,1113,483,630,1383,634,712,1196,469,634
060590992371,890,417,473,901,412,489,1153,550,577,876,402,422
060590992372,908,433,475,922,431,491,1219,592,603,1037,458,514
060590992171,627,258,369,637,253,384,823,380,433,673,284,359
060590992172,660,282,378,675,277,398,988,458,505,550,236,290
060590992382,1179,484,695,1204,463,741,1488,637,825,1270,489,698
060590992353,778,393,385,793,395,398,1189,580,583,974,428,481
060590992354,676,348,328,690,351,339,461,225,226,435,192,213
060590992452,784,366,418,798,368,430,1066,505,540,820,347,424
060590995084,603,233,370,613,234,379,716,289,416,570,199,348
060590994082,1125,519,606,1145,529,616,1589,786,759,1306,600,612
060590994172,1160,526,634,1184,526,658,1397,685,681,1114,506,533
060590994171,743,365,378,757,369,388,1000,498,474,871,394,415
060590994173,381,174,207,388,174,214,734,359,358,107,49,51
060590995081,685,294,391,703,298,405,915,405,481,774,298,419
060590992402,983,450,533,1003,461,542,1160,542,596,1086,465,553
060590992151,954,533,421,976,531,445,1457,768,641,1128,606,450
060590992153,481,268,213,491,268,223,558,292,244,589,238,314
060590994042,1210,512,698,1245,520,725,1527,686,814,1258,535,648
060590994122,562,276,286,577,271,306,611,299,303,498,222,245
060590994123,909,385,524,933,389,544,1140,513,607,963,396,502
060590994153,815,333,482,832,340,492,977,446,514,870,345,475
060590994152,606,249,357,622,253,369,749,337,391,618,281,296
060590994155,346,141,205,351,142,209,446,201,233,402,156,221
060590994023,336,169,167,342,165,177,446,225,217,218,104,105
060590994121,589,296,293,601,289,312,1001,504,483,661,312,315
060590994051,605,293,312,625,293,332,667,328,328,467,195,243
060590996021,599,302,297,616,303,313,935,477,437,615,300,273
060590996022,661,289,372,682,291,391,898,413,468,731,305,371
060590992203,770,347,423,789,343,446,1035,447,569,768,319,400
060590992204,422,188,234,432,185,247,520,237,269,554,228,292
060590992393,528,206,322,544,205,339,674,289,368,606,220,356
060590992161,405,172,233,415,177,238,433,199,227,445,185,237
060590992162,740,321,419,758,326,432,941,445,475,774,331,401
060590992164,327,154,173,335,156,179,523,248,262,350,154,171
060590992351,415,190,225,425,193,232,646,301,331,503,204,269
060590994183,389,207,182,396,208,188,956,469,469,701,350,307
060590993064,690,326,364,704,322,382,757,352,385,580,254,274
060590993071,693,330,363,705,328,377,1251,575,647,756,311,377
060590992391,454,205,249,463,193,270,566,242,308,531,220,272
060590992394,523,221,302,535,212,323,662,285,363,629,249,337
060590992381,991,407,584,1009,402,607,1310,597,680,1089,405,591
060590995021,85,44,41,86,44,42,97,56,38,265,136,115
060590996031,1005,484,521,1035,483,552,1543,743,772,1248,562,610
060590992122,382,239,143,387,238,149,335,193,134,451,205,211
060590992124,329,206,123,336,206,130,352,204,142,436,199,205
060590994021,267,167,100,274,167,107,730,419,292,367,263,83
060590994022,518,308,210,525,306,219,761,415,324,503,272,195
060590994024,274,172,102,279,172,107,663,380,265,299,213,69
060590993111,584,274,310,594,274,320,776,366,392,593,256,301
060590993112,647,305,342,658,305,353,943,452,469,821,351,410
060590993113,328,154,174,337,155,182,509,243,253,425,182,206
060590992201,752,364,388,767,364,403,892,433,434,562,283,241
060590992202,641,312,329,652,314,338,946,460,461,805,350,402
060590992432,822,383,439,843,380,463,1227,578,620,1000,413,522
060590993072,519,242,277,530,239,291,739,356,361,521,229,258
060590993051,485,269,216,490,263,227,837,419,401,548,253,257
060590993056,275,153,122,278,149,129,402,202,196,237,108,111
060590992121,378,216,162,382,213,169,567,304,248,396,199,168
060590992123,333,190,143,337,188,149,492,263,215,360,180,152
060590992392,561,230,331,574,230,344,752,353,389,640,263,344
060590995083,397,190,207,404,191,213,565,255,292,669,258,375
060590995082,349,163,186,354,168,186,647,341,294,498,212,255
060590994113,436,291,145,442,293,149,536,324,194,418,236,149
060590994114,165,110,55,167,111,56,420,255,150,379,214,134
060590993091,694,264,430,710,262,448,807,381,403,895,405,457
060590992352,382,176,206,388,175,213,472,220,241,398,163,213
060590994192,747,341,406,760,344,416,1179,567,584,923,423,437
060590994102,449,230,219,460,234,226,668,374,277,631,267,334
060590994111,362,186,176,368,186,182,420,216,195,255,131,106
060590994112,568,291,277,580,294,286,1065,548,490,657,338,276
060591100152,1012,478,534,1038,464,574,1286,607,652,1005,438,493
060591100061,780,363,417,798,356,442,1008,506,481,834,398,398
060591101081,237,113,124,243,116,127,311,184,118,231,113,98
060591101082,594,283,311,607,290,317,797,390,378,648,273,338
060375739021,1133,603,530,1154,600,554,1485,877,580,1204,629,515
060591101083,291,132,159,299,134,165,443,221,213,303,142,135
060591100141,282,166,116,285,165,120,462,269,187,385,209,147
060591100142,359,197,162,368,194,174,678,344,315,409,214,169
060591100144,335,183,152,344,182,162,522,283,225,398,197,172
060591100151,632,293,339,650,291,359,790,392,380,763,314,403
060591100124,1019,463,556,1045,466,579,1235,621,593,1063,522,495
060591100153,114,63,51,118,61,57,152,84,63,91,43,41
060591100143,433,261,172,438,261,177,626,361,243,526,309,180
060590997023,658,368,290,680,363,317,1031,482,530,733,473,224
060590997033,606,282,324,621,276,345,883,393,473,716,333,330
060590997011,794,396,398,808,387,421,1361,587,756,944,542,354
060590997012,351,186,165,359,182,177,651,274,370,396,234,146
060590997013,316,163,153,324,163,161,646,266,368,410,232,155
060591100062,853,374,479,872,368,504,904,456,432,841,372,419
060591100071,548,230,318,563,233,330,650,330,304,560,241,286
060591100073,967,410,557,990,419,571,1271,628,611,1089,502,534
060591100074,607,253,354,622,255,367,859,418,417,718,316,364
060591100081,1075,538,537,1103,541,562,1453,771,654,1242,589,589
060591100082,635,282,353,647,279,368,783,366,400,656,276,350
060591100083,583,259,324,594,255,339,652,316,322,620,301,292
060590995091,769,357,412,780,361,419,647,315,325,538,243,272
060590995092,525,250,275,534,251,283,729,357,368,647,301,322
060590995094,280,129,151,283,129,154,417,200,216,338,145,180
060590995095,369,169,200,373,171,202,547,254,288,484,223,245
060590995101,1333,615,718,1347,613,734,1539,708,815,1174,547,586
060590995102,649,300,349,653,297,356,977,477,485,784,393,366
060590995103,733,338,395,741,336,405,941,447,489,851,400,422
060379800071,0,0,0,0,0,0,3,2,1,0,0,0
060590995093,414,205,209,420,202,218,579,293,282,494,232,241
060591100072,512,222,290,520,213,307,618,306,303,517,218,274
060590995111,487,233,254,493,234,259,473,242,219,478,219,230
060590995112,447,228,219,455,233,222,586,291,284,517,271,221
060590995113,379,183,196,382,183,199,493,248,233,457,217,215
060590995114,396,203,193,407,208,199,539,288,244,452,232,191
060590995123,351,181,170,357,182,175,387,220,160,340,179,143
060590995121,688,353,335,702,357,345,899,481,405,771,385,345
060591100121,724,327,397,741,329,412,791,405,376,757,375,351
060591100122,625,287,338,639,291,348,840,411,416,655,294,337
060591100123,495,227,268,507,231,276,657,319,326,591,269,296
060375745002,1072,637,435,1070,627,443,1331,825,477,1188,680,429
060590995041,1586,799,787,1629,807,822,1978,1016,915,1477,731,658
060590995122,396,223,173,399,226,173,711,428,268,459,244,194
060375776041,703,381,322,710,376,334,904,530,357,850,439,356
060590423072,601,307,294,611,300,311,604,306,289,544,269,246
060590423074,287,149,138,291,147,144,474,242,223,376,187,171
060590423075,345,171,174,351,172,179,667,359,297,486,240,221
060590423274,606,282,324,615,277,338,537,281,250,512,196,294
060590423071,942,422,520,961,412,549,1232,636,575,997,419,509
060590423073,607,272,335,619,267,352,827,424,384,642,295,318
060590626224,276,142,134,276,133,143,383,204,175,310,146,140
060590626522,778,422,356,795,421,374,1137,633,475,879,455,362
060590626521,627,341,286,641,332,309,891,511,351,696,359,277
060590626523,394,214,180,402,208,194,501,288,198,483,249,207
060590423331,1081,439,642,1101,437,664,1752,831,896,942,386,514
060590423332,1135,464,671,1158,463,695,1685,828,831,1240,548,638
060590423201,909,518,391,922,507,415,889,538,333,859,487,326
060590423203,524,314,210,535,310,225,806,498,294,584,313,234
060590423281,689,270,419,701,267,434,921,413,492,803,307,452
060590423282,473,169,304,481,165,316,763,334,419,571,218,326
060590423271,436,178,258,445,174,271,604,292,297,491,195,264
060590626253,549,308,241,557,313,244,813,449,352,625,301,292
060590626254,226,127,99,230,129,101,292,205,83,155,121,24
060590423272,432,192,240,438,188,250,551,292,247,487,207,245
060590423273,1126,501,625,1144,491,653,1463,699,740,1217,532,601
060590626471,517,276,241,524,270,254,706,407,279,521,284,201
060590997021,740,363,377,765,356,409,1305,534,758,917,516,353
060590999021,439,213,226,444,201,243,620,290,319,497,240,227
060590999022,593,288,305,597,271,326,833,391,427,650,314,296
060590999033,629,316,313,644,309,335,965,451,492,777,397,337
060590996012,659,361,298,670,367,303,996,498,489,921,526,367
060590999031,393,237,156,404,225,179,569,281,274,387,226,141
060590999032,343,207,136,352,196,156,719,368,337,579,360,187
060590996014,449,212,237,461,217,244,603,280,311,383,216,150
060590999061,977,443,534,997,437,560,1193,542,620,1012,449,510
060590999062,580,280,300,592,275,317,794,364,414,651,304,317
060590999063,770,339,431,783,334,449,1075,488,564,871,361,462
060590998022,740,438,302,769,439,330,1278,532,717,886,564,273
060590998013,398,215,183,403,208,195,781,354,416,505,321,155
060590998021,541,290,251,549,282,267,719,323,382,643,361,255
060590996011,407,249,158,418,239,179,591,303,276,414,282,109
060590996013,231,141,90,234,134,100,427,218,199,327,221,85
060590999042,367,223,144,372,213,159,710,354,345,420,268,132
060590999044,196,119,77,200,115,85,357,185,170,262,166,83
060590999045,252,153,99,254,146,108,447,228,207,309,194,98
060590889051,247,124,123,254,128,126,592,238,348,459,285,154
060590889052,628,319,309,648,329,319,1334,537,785,839,529,281
060590889053,363,184,179,372,188,184,617,250,366,413,259,138
060590998032,403,223,180,420,228,192,713,296,407,489,306,153
060590998033,571,307,264,591,314,277,887,360,516,643,392,217
060590992411,797,376,421,817,382,435,1154,502,634,872,427,387
060590997032,871,401,470,893,401,492,1378,602,759,1048,497,492
060590998031,416,215,201,430,223,207,785,297,478,558,352,187
060590998012,643,306,337,660,316,344,1138,522,610,709,443,238
060590999051,415,212,203,422,211,211,733,390,330,520,264,224
060590999052,508,260,248,516,258,258,660,349,296,556,282,239
060590992231,492,231,261,503,230,273,968,387,565,531,338,173
060590992232,372,174,198,381,174,207,563,227,331,546,289,228
060590999023,408,207,201,417,204,213,773,359,395,496,302,168
060590999041,256,129,127,262,129,133,430,200,219,285,161,110
060590999043,280,142,138,286,140,146,497,233,253,386,202,165
060590992221,324,160,164,337,163,174,627,297,324,457,284,155
060590992222,439,216,223,451,219,232,711,284,414,516,274,216
060590992223,432,213,219,447,216,231,699,281,409,500,265,209
060590992224,322,159,163,332,160,172,550,222,322,403,214,169
060590996032,509,202,307,512,202,310,568,246,315,515,209,277
060590996033,681,271,410,688,271,417,905,393,501,736,300,396
060590889043,345,175,170,354,179,175,577,255,319,405,243,144
060590889044,408,206,202,421,212,209,715,316,392,483,289,173
060590992041,305,156,149,315,148,167,550,240,304,402,227,159
060590992042,310,159,151,317,149,168,515,224,284,326,186,129
060590423052,763,252,511,785,252,533,901,387,501,772,313,417
060590423233,528,209,319,535,208,327,730,324,394,604,245,332
060590423381,1460,656,804,1491,642,849,1930,944,951,1592,705,778
060590423382,812,347,465,830,345,485,1044,496,537,937,411,474
060590423393,465,209,256,471,208,263,707,359,334,549,234,282
060590423131,408,200,208,411,196,215,393,200,184,361,151,188
060590423132,399,189,210,405,186,219,497,239,254,468,203,240
060590423133,582,284,298,586,276,310,992,498,464,755,344,355
060590423231,524,227,297,535,226,309,514,232,274,450,190,241
060590423112,592,249,343,605,250,355,752,342,395,643,243,369
060590423134,606,273,333,617,273,344,772,366,388,678,313,317
060590423392,617,260,357,631,260,371,848,387,448,695,324,340
060590422014,499,228,271,507,227,280,688,315,361,547,222,290
060590422015,637,269,368,648,262,386,860,364,485,645,262,347
060590422061,744,339,405,757,335,422,853,395,444,745,299,403
060590422062,975,438,537,993,436,557,1424,663,738,1218,488,655
060590422012,327,141,186,330,140,190,322,149,171,337,142,178
060590422013,675,302,373,688,309,379,909,413,473,659,313,307
060590422011,461,229,232,465,224,241,572,284,283,618,260,327
060590421062,716,313,403,728,306,422,928,422,488,291,136,142
060590422052,600,222,378,616,223,393,816,336,464,652,244,374
060590422053,1184,488,696,1206,482,724,1508,665,816,1303,529,693
060590422054,646,297,349,650,299,351,845,392,436,657,301,312
060590423114,1157,536,621,1184,544,640,1470,729,706,1218,531,600
060590423391,497,204,293,505,198,307,663,313,339,519,217,273
060590423135,506,251,255,517,248,269,819,424,366,619,291,299
060590423234,929,346,583,950,360,590,1214,525,669,913,341,530
060590423415,468,183,285,468,182,286,555,274,265,494,216,253
060590423411,448,232,216,455,225,230,657,346,296,512,221,264
060590423241,496,210,286,509,210,299,641,296,334,472,198,250
060590423242,285,149,136,287,146,141,575,302,262,413,174,220
060590423232,672,279,393,684,277,407,860,398,450,668,282,356
060590423053,559,279,280,574,281,293,696,380,303,563,260,273
060590626562,909,359,550,932,352,580,1128,517,588,934,364,511
060590423051,827,504,323,844,512,332,1022,647,364,837,506,293
060590626202,843,512,331,866,515,351,1108,711,387,923,532,343
060590626203,526,315,211,533,315,218,643,402,227,562,343,187
060590626204,834,527,307,853,531,322,1000,648,335,943,590,309
060590626324,829,491,338,844,497,347,1069,667,384,799,480,291
060590626191,707,443,264,727,447,280,786,510,258,684,438,218
060590626321,445,310,135,453,307,146,416,286,121,383,227,132
060590626323,698,419,279,710,417,293,939,599,322,766,463,256
060590626051,354,239,115,362,240,122,354,240,108,307,206,84
060590626052,368,218,150,377,222,155,450,275,169,391,234,126
060590626054,553,346,207,559,345,214,840,531,296,670,409,209
060590626194,489,322,167,501,324,177,612,410,192,574,372,172
060590626192,476,301,175,489,305,184,572,370,189,487,311,154
060590626201,781,510,271,803,513,290,867,575,275,794,507,246
060590626053,359,250,109,368,251,117,456,311,133,398,267,107
060590626193,556,385,171,570,385,185,707,483,203,612,410,166
060590626561,481,280,201,492,285,207,438,261,167,387,226,137
060590626563,699,409,290,715,413,302,980,586,376,810,463,303
060590626492,533,383,150,543,380,163,864,598,248,674,437,202
060590626322,450,282,168,464,286,178,605,391,202,485,307,157
060590626331,1376,650,726,1399,647,752,1857,905,914,1550,734,728
060590626391,497,273,224,510,268,242,802,433,351,589,303,254
060590626392,793,424,369,813,417,396,1140,606,513,995,492,444
060590626393,875,464,411,893,455,438,1241,651,564,630,338,261
060590626344,352,195,157,358,195,163,464,276,176,380,201,152
060590626343,942,501,441,960,491,469,685,380,285,569,295,228
060590626361,274,159,115,278,162,116,622,390,218,419,224,165
060590626362,469,271,198,477,278,199,652,408,229,554,314,192
060590626363,966,561,405,994,561,433,632,360,259,468,258,177
060590626371,658,405,253,671,404,267,1435,848,555,782,436,298
060590626382,781,435,346,800,427,373,999,565,411,873,464,350
060590626383,598,360,238,613,360,253,1510,883,596,1170,613,491
060590626341,387,211,176,396,214,182,529,299,220,404,216,168
060590626353,574,313,261,588,318,270,748,421,311,605,323,241
060590626372,534,310,224,543,312,231,732,423,291,477,265,184
060590626373,483,280,203,491,282,209,829,479,330,462,254,181
060590626412,419,222,197,428,218,210,526,292,218,733,370,331
060590626401,942,529,413,965,526,439,1243,687,527,1080,575,438
060590626402,623,351,272,639,346,293,988,538,430,577,308,230
060590626342,1107,563,544,1136,563,573,1535,873,632,1197,576,537
060590626394,589,330,259,604,330,274,817,454,344,798,392,352
060590626381,444,243,201,455,237,218,568,320,235,570,313,206
060590626352,854,449,405,869,442,427,1113,614,470,900,456,385
060590626351,470,252,218,478,250,228,689,387,291,532,269,227
060590423204,656,362,294,678,368,310,958,546,392,730,371,295
060590626332,1403,733,670,1417,717,700,2048,1158,844,1411,706,619
060590320151,884,413,471,889,410,479,1105,584,495,988,455,478
060590320152,595,284,311,606,274,332,797,386,391,623,279,299
060590320154,645,300,345,662,295,367,909,440,444,699,293,372
060590320153,551,254,297,567,250,317,747,383,348,568,252,279
060590320491,422,147,275,434,144,290,480,191,281,412,132,252
060590320495,734,355,379,748,353,395,1084,566,495,758,352,361
060590320494,1088,481,607,1112,483,629,1049,509,516,1047,471,523
060590320482,1130,409,721,1148,396,752,1517,719,788,1144,440,684
060590320483,495,241,254,504,241,263,828,427,376,627,303,291
060590320382,353,190,163,359,185,174,522,305,210,443,243,175
060590320531,1370,566,804,1399,569,830,1552,708,810,1417,570,773
060590320534,639,290,349,652,291,361,1170,583,563,669,333,301
060590320383,1270,646,624,1299,644,655,1954,1055,862,1499,759,653
060590320381,1413,675,738,1455,675,780,1789,917,843,2215,1023,1068
060590320341,896,384,512,920,391,529,981,516,454,771,328,401
060590320342,1468,607,861,1506,597,909,2069,982,1033,1799,742,956
060590320474,606,309,297,614,303,311,957,485,448,643,344,258
060590320481,573,292,281,582,288,294,574,293,270,649,276,341
060590320351,839,316,523,848,309,539,1054,458,579,920,342,541
060590320352,461,175,286,467,170,297,605,261,332,483,178,285
060590320201,1170,499,671,1195,494,701,1326,630,671,1362,554,729
060590320202,1447,612,835,1479,604,875,1570,750,789,1116,460,594
060590320401,908,401,507,921,386,535,1136,573,547,995,430,507
060590320402,558,246,312,565,237,328,747,376,359,575,248,292
060590320332,458,219,239,468,217,251,484,259,212,438,203,212
060590320333,327,141,186,339,148,191,379,204,168,369,157,193
060590320203,516,229,287,528,228,300,630,316,305,586,242,307
060590320311,651,327,324,667,322,345,933,489,423,864,393,413
060590320312,1082,472,610,1099,453,646,1215,585,609,887,387,444
060590320331,508,259,249,520,253,267,1012,541,445,664,333,298
060590320362,1223,519,704,1253,517,736,1599,734,839,1338,539,722
060590320321,677,288,389,690,277,413,822,375,434,655,263,356
060590320322,855,378,477,869,368,501,1281,624,630,1090,469,557
060590320292,770,349,421,790,350,440,823,409,396,937,402,475
060590320293,863,408,455,883,406,477,1011,528,450,604,295,269
060590320302,1074,497,577,1097,488,609,1415,697,681,1245,546,612
060590320272,502,307,195,511,303,208,973,551,394,722,418,246
060590320273,366,188,178,374,183,191,547,279,259,550,269,245
060590320282,649,379,270,663,375,288,1160,657,472,719,381,282
060590320371,1417,538,879,1438,542,896,1693,761,913,1479,580,851
060590320373,985,362,623,998,366,632,994,442,541,923,360,532
060590320022,1060,467,593,1080,460,620,1188,576,591,944,392,487
060590320281,560,244,316,572,239,333,650,368,264,680,276,351
060590320361,590,259,331,609,267,342,830,417,400,595,246,313
060590320133,429,178,251,437,177,260,499,219,272,447,176,249
060590320134,385,237,148,395,239,156,514,329,172,450,288,134
060590320131,710,288,422,719,287,432,775,339,424,664,260,369
060590320132,700,348,352,708,354,354,1121,587,507,863,438,377
060590320031,839,377,462,852,368,484,912,463,420,906,390,456
060590320032,818,333,485,834,329,505,1080,522,533,881,339,481
060590320033,803,343,460,815,334,481,1125,543,553,942,390,495
060590320121,747,320,427,760,312,448,914,420,474,700,286,376
060590320023,949,430,519,963,423,540,1318,639,654,1031,443,526
060590320024,670,294,376,679,292,387,822,400,409,713,304,379
060590320372,549,236,313,560,231,329,1032,512,503,847,358,445
060590320021,441,176,265,450,174,276,528,254,261,470,177,260
060590320301,665,327,338,674,320,354,933,522,383,754,393,312
060590320291,541,259,282,557,260,297,674,339,319,518,241,243
060590320471,275,173,102,276,160,116,510,300,197,398,212,149
060590320472,368,181,187,373,177,196,445,225,207,414,177,206
060590320473,282,138,144,287,137,150,369,189,174,319,138,160
060590320223,404,206,198,405,201,204,225,116,108,267,130,121
060590320224,223,123,100,224,119,105,670,353,306,524,261,234
060590320221,955,507,448,969,487,482,1344,743,571,683,407,232
060590320222,446,258,188,454,251,203,749,449,282,433,249,160
060590320393,305,159,146,306,153,153,680,361,301,366,182,162
060590320394,767,398,369,774,387,387,898,483,391,751,372,332
060590320391,644,280,364,662,287,375,771,385,371,592,266,296
060590320392,1177,512,665,1209,525,684,1507,753,726,1356,582,701
060590320122,772,327,445,788,323,465,957,437,493,792,354,383
060590320123,264,112,152,269,110,159,453,207,234,347,157,168
060590421162,638,295,343,655,297,358,680,325,341,473,206,234
060590421164,881,384,497,903,384,519,1174,533,612,939,386,486
060590421151,551,229,322,561,229,332,870,362,491,701,264,390
060590421141,690,291,399,702,287,415,1150,493,637,977,382,535
060590421161,771,378,393,796,383,413,1120,581,520,958,432,449
060590421163,646,270,376,663,273,390,729,328,392,645,244,369
060590421082,241,107,134,245,107,138,423,196,220,286,129,130
060590421083,392,186,206,400,186,214,630,293,324,425,197,188
060590421071,341,173,168,347,172,175,748,354,376,648,299,314
060590421072,687,367,320,699,367,332,1173,594,544,930,467,406
060590421081,333,180,153,339,181,158,376,198,166,271,140,113
060590421084,658,350,308,666,350,316,911,467,425,700,356,305
060590421061,421,161,260,421,155,266,574,247,322,420,171,226
060590421121,1541,527,1014,1566,520,1046,2036,827,1166,1733,579,1064
060590421094,567,231,336,573,222,351,589,272,301,470,187,253
060590421131,703,281,422,722,288,434,783,334,441,655,256,363
060590421132,692,277,415,707,278,429,887,377,494,747,285,419
060590421133,555,222,333,566,223,343,902,384,504,738,278,422
060590421143,590,249,341,607,249,358,660,298,349,595,258,308
060590421085,268,156,112,274,156,118,446,233,199,385,198,152
060590421091,578,235,343,584,228,356,764,354,387,648,260,348
060590421111,598,215,383,612,215,397,747,305,430,603,212,355
060590421122,815,287,528,832,287,545,1396,565,798,1105,383,654
060590421112,802,305,497,816,297,519,904,367,520,741,275,428
060590421123,953,348,605,963,343,620,1346,545,777,1059,399,600
060590320622,1083,394,689,1110,395,715,1401,601,774,1015,378,579
060590320632,721,267,454,731,265,466,993,425,545,877,329,500
060590320633,940,350,590,953,341,612,1481,647,794,1147,435,652
060590320643,50,18,32,51,18,33,272,105,160,166,70,87
060590320631,1245,468,777,1265,464,801,1699,723,932,1411,527,801
060590421092,819,333,486,829,321,508,840,379,451,696,266,392
060590421093,276,112,164,281,109,172,671,301,358,587,223,332
060590421113,450,173,277,458,169,289,476,193,274,449,168,257
060590421114,1035,384,651,1046,377,669,1064,430,612,906,338,517
060590320621,807,292,515,819,292,527,951,399,536,776,286,438
060590421115,733,274,459,745,270,475,633,258,364,560,214,315
060590421142,471,205,266,480,199,281,553,250,294,481,208,249
060590421134,491,201,290,506,202,304,588,252,330,488,195,262
060590422051,807,302,505,827,299,528,1149,470,651,980,375,551
060590422036,663,248,415,663,244,419,1309,546,739,1055,413,599
060590320613,856,281,575,872,278,594,934,358,559,819,266,523
060590320614,376,109,267,380,106,274,667,236,423,638,207,400
060590423122,692,330,362,703,324,379,923,450,462,796,334,422
060590320642,615,216,399,627,218,409,532,217,303,554,206,321
060590422035,945,333,612,964,335,629,1438,589,819,1117,417,648
060590320641,811,315,496,828,318,510,1018,444,560,824,327,457
060590422032,594,223,371,598,217,381,540,234,303,497,183,294
060590422031,710,251,459,720,262,458,894,376,510,744,259,443
060590422034,625,282,343,637,283,354,1025,481,518,536,234,268
060590423414,851,441,410,861,433,428,1140,631,482,956,430,463
060590423401,655,337,318,660,317,343,953,423,517,651,335,276
060590423111,628,278,350,635,268,367,805,482,307,822,333,441
060590423121,842,600,242,839,580,259,711,473,227,529,358,143
060590423123,228,163,65,227,156,71,736,487,235,599,400,164
060590423124,217,156,61,218,146,72,434,317,114,345,251,76
060590423113,599,246,353,604,242,362,599,275,312,440,191,226
060590423412,474,202,272,480,195,285,646,263,371,465,184,255
060590423413,609,260,349,618,252,366,856,349,492,697,277,384
060590422033,619,231,388,627,228,399,599,258,332,603,221,358
060590320583,829,412,417,849,416,433,461,227,223,793,360,384
060590320611,523,186,337,533,184,349,489,204,273,779,253,485
060590320463,1213,332,881,1235,339,896,1524,580,922,1185,357,785
060590320666,288,130,158,291,130,161,132,63,68,180,76,94
060590320464,700,180,520,712,183,529,1276,452,801,1176,341,781
060590320462,849,269,580,858,269,589,937,367,552,862,275,554
060590320442,794,256,538,807,255,552,811,316,478,626,199,394
060590320443,565,158,407,571,152,419,677,237,426,579,179,374
060590320553,287,137,150,291,135,156,295,147,143,262,119,127
060590320452,797,285,512,810,283,527,1101,466,615,644,226,371
060590320444,799,255,544,809,249,560,1154,453,678,954,302,607
060590320461,337,89,248,344,86,258,513,172,334,433,131,284
060590320411,583,201,382,590,198,392,615,212,395,520,173,312
060590320432,789,271,518,801,276,525,1018,437,558,859,294,510
060590320112,362,186,176,372,189,183,458,244,200,363,169,163
060590320431,1167,423,744,1201,432,769,1664,711,916,1336,472,765
060590320423,658,258,400,676,253,423,955,426,508,762,281,442
060590320441,926,297,629,949,295,654,1187,472,682,927,333,540
060590524282,334,172,162,343,168,175,661,328,318,516,222,255
060590626105,810,555,255,826,555,271,1819,1169,605,271,155,98
060590631021,914,510,404,940,504,436,1151,626,495,954,468,412
060590631024,714,384,330,729,381,348,1108,580,502,851,405,376
060590637011,325,230,95,331,224,107,472,298,166,318,178,117
060590637013,310,220,90,314,213,101,487,346,126,586,326,217
060590637024,355,258,97,361,256,105,454,324,117,382,253,100
060590639031,655,359,296,665,356,309,1034,577,435,874,425,370
060590639084,330,220,110,332,217,115,716,452,243,537,337,143
060590633011,383,213,170,394,217,177,635,346,271,507,270,194
060590633012,473,261,212,487,265,222,649,356,276,564,305,210
060590633021,494,219,275,508,224,284,622,306,302,420,165,218
060590633022,392,173,219,406,180,226,633,309,306,536,247,247
060590632021,298,153,145,305,153,152,486,244,225,371,174,168
060590632022,442,226,216,449,226,223,584,296,274,531,249,243
060590632024,322,165,157,329,165,164,465,233,216,340,160,155
060590639022,592,409,183,599,401,198,511,340,154,577,347,173
060590639024,198,137,61,200,134,66,1119,631,455,505,249,222
060590638051,535,260,275,543,254,289,646,333,294,590,264,282
060590638052,653,319,334,662,311,351,771,399,354,821,374,394
060590638061,406,198,208,410,193,217,787,407,358,415,195,180
060590638062,649,294,355,658,296,362,838,378,443,765,332,375
060590636041,577,373,204,581,372,209,446,295,143,439,251,156
060590636051,168,136,32,168,132,36,256,202,51,413,238,147
060590636053,155,123,32,154,119,35,350,257,85,380,232,125
060590639052,385,215,170,390,209,181,619,389,215,385,195,148
060590639053,705,394,311,716,384,332,958,487,452,892,444,388
060590639051,671,329,342,687,340,347,842,472,349,721,357,314
060590639023,214,159,55,215,155,60,411,273,124,427,255,138
060590632012,511,282,229,520,284,236,725,375,328,575,275,254
060590631011,673,403,270,678,402,276,869,438,408,894,389,442
060590636052,549,320,229,561,318,243,1038,604,400,429,259,144
060590631022,691,392,299,708,388,320,1042,585,433,734,389,293
060590631023,630,358,272,643,353,290,839,473,348,671,320,301
060590637021,460,315,145,468,312,156,586,375,197,297,184,90
060590637023,338,220,118,341,222,119,542,319,206,397,219,150
060590639061,407,271,136,415,271,144,643,421,204,409,258,121
060590639062,337,226,111,343,225,118,496,326,155,386,242,112
060590632011,503,280,223,520,282,238,691,377,293,553,273,227
060590636011,870,486,384,892,484,408,427,242,176,550,307,204
060590636012,514,285,229,532,286,246,924,517,387,408,226,151
060590638032,456,260,196,465,257,208,0,0,0,335,187,124
060590638034,506,284,222,521,283,238,1299,726,541,446,247,166
060590631031,872,401,471,890,409,481,941,463,450,862,360,442
060590631032,494,232,262,504,234,270,759,378,358,572,267,262
060590632023,511,248,263,524,248,276,622,328,275,515,235,250
060590639041,661,357,304,675,356,319,669,358,296,579,286,243
060590639042,592,319,273,609,320,289,740,397,327,548,279,229
060590639043,205,110,95,211,111,100,599,316,261,463,242,178
060590639082,794,476,318,797,470,327,945,553,355,713,339,317
060590639081,516,297,219,528,292,236,647,380,250,615,292,288
060590639083,345,198,147,350,195,155,577,335,231,356,207,111
060590638021,766,402,364,780,403,377,963,470,472,857,391,416
060590638073,873,430,443,891,426,465,1143,607,508,745,418,268
060590638071,327,176,151,332,175,157,734,421,295,660,334,286
060590638063,804,303,501,816,300,516,962,428,517,522,218,278
060590638031,512,241,271,523,238,285,541,260,268,260,145,97
060590638072,339,159,180,346,157,189,465,225,230,326,165,141
060590638083,241,200,41,243,194,49,361,290,57,699,390,259
060590639063,875,491,384,899,479,420,1228,666,522,1169,584,492
060590639101,1229,634,595,1251,637,614,1320,694,606,1135,563,521
060590639102,890,468,422,904,468,436,1178,601,556,955,460,447
060590639032,775,403,372,790,399,391,911,483,410,741,378,309
060590633013,315,153,162,326,157,169,416,206,202,323,155,144
060590633023,582,283,299,598,288,310,761,375,371,596,262,295
060590633024,419,204,215,431,208,223,554,269,266,500,227,238
060590636034,397,214,183,409,217,192,855,461,371,674,356,270
060590636042,646,376,270,657,382,275,1207,629,555,520,300,185
060590638033,399,227,172,405,225,180,1065,611,425,340,190,126
060590637014,250,179,71,253,178,75,326,233,84,494,276,182
060590638082,269,197,72,271,197,74,467,339,118,705,392,262
060590638081,497,353,144,501,352,149,781,515,244,593,329,220
060590637012,267,213,54,268,210,58,295,226,66,562,312,208
060590632013,580,287,293,590,288,302,752,378,349,659,318,288
060590639092,795,559,236,815,555,260,714,474,227,509,322,156
060590637022,139,105,34,140,105,35,205,123,78,206,113,77
060590637025,239,180,59,242,181,61,399,288,103,272,189,61
060590638022,760,279,481,773,279,494,853,374,457,698,252,417
060590639021,992,514,478,1012,529,483,997,567,407,714,344,319
060590218143,548,210,338,559,215,344,677,302,361,658,261,366
060590218322,743,380,363,759,375,384,1461,826,621,761,405,328
060590015035,424,234,190,432,225,207,346,199,143,291,149,124
060590015071,486,254,232,493,241,252,1090,620,450,557,279,248
060590015072,255,132,123,258,126,132,571,289,271,456,207,217
060590626421,455,175,280,463,175,288,548,250,293,451,186,247
060590626422,651,243,408,668,245,423,670,303,356,450,177,252
060590626423,780,287,493,800,288,512,1016,425,573,696,267,395
060590627022,413,156,257,421,161,260,520,219,290,407,157,232
060590627023,716,328,388,732,351,381,966,470,482,824,356,419
060590627024,383,153,230,392,156,236,487,239,243,521,225,272
060590626583,906,341,565,931,347,584,1208,521,657,1007,382,574
060590626581,1022,384,638,1049,392,657,1358,596,730,1229,465,702
060590630041,1132,453,679,1159,459,700,1485,700,760,1284,519,696
060590630074,694,281,413,708,284,424,1002,469,520,899,379,470
060590630091,429,168,261,440,165,275,458,195,256,373,161,186
060590636031,686,348,338,694,342,352,717,357,339,591,276,270
060590627011,807,287,520,819,288,531,951,391,543,850,316,499
060590630043,581,235,346,590,230,360,538,218,312,656,242,386
060590630051,349,121,228,355,118,237,495,184,306,360,84,266
060590630052,371,128,243,380,126,254,538,199,331,404,146,241
060590015012,1244,524,720,1272,500,772,1705,789,891,1455,621,751
060590015061,926,422,504,934,408,526,1161,543,588,928,383,481
060590634001,504,223,281,513,218,295,639,276,349,418,178,215
060590628002,448,185,263,456,187,269,560,239,311,429,168,232
060590635001,473,191,282,485,192,293,560,233,320,444,154,267
060590635002,259,112,147,265,112,153,453,192,245,386,148,217
060590635003,343,142,201,353,143,210,471,197,264,371,147,202
060590635004,279,112,167,290,114,176,408,164,234,305,114,171
060590635005,223,94,129,227,95,132,288,123,160,273,116,140
060590627012,740,309,431,754,314,440,1024,472,535,827,350,426
060590629001,644,184,460,655,186,469,771,251,506,712,210,474
060590629002,467,136,331,475,137,338,601,198,395,514,151,339
060590015041,370,186,184,378,180,198,507,293,204,416,210,179
060590015043,377,189,188,385,184,201,541,314,220,373,189,162
060590015073,783,382,401,802,374,428,1118,568,532,910,403,461
060590630102,480,307,173,489,304,185,867,485,349,1013,432,515
060590630103,1419,478,941,1448,476,972,1608,616,966,1382,498,806
060590634003,375,126,249,378,127,251,580,224,342,398,170,200
060590636032,723,333,390,747,345,402,955,473,467,781,338,393
060590630061,741,240,501,759,250,509,820,308,500,712,239,440
060590630062,774,250,524,796,260,536,1038,389,632,1007,329,632
060590630101,508,183,325,522,183,339,462,183,268,551,232,285
060590630104,748,277,471,771,277,494,1033,438,580,855,326,480
060590627021,518,200,318,529,207,322,663,278,376,565,221,318
060590627025,441,181,260,449,183,266,630,278,346,576,227,314
060590634005,719,222,497,735,234,501,939,330,591,628,229,364
060590626433,471,180,291,483,190,293,513,217,291,482,192,274
060590628003,553,230,323,566,233,333,821,339,466,671,269,358
060590628004,337,146,191,347,151,196,433,192,235,399,163,207
060590628001,588,202,386,602,211,391,640,235,394,591,221,334
060590635006,585,269,316,603,269,334,807,360,432,793,301,451
060590015032,389,191,198,396,188,208,658,325,316,476,229,216
060590626432,576,255,321,590,266,324,750,366,374,738,329,376
060590626454,332,148,184,341,151,190,448,214,228,397,177,203
060590626436,438,201,237,443,198,245,726,370,345,464,208,228
060590626434,461,214,247,468,210,258,459,219,232,346,183,153
060590626453,403,196,207,410,189,221,554,261,284,546,240,277
060590626431,731,293,438,747,305,442,978,435,530,657,270,364
060590626437,219,98,121,223,98,125,382,196,179,493,239,228
060590626435,447,199,248,453,198,255,641,331,297,456,194,230
060590626451,720,313,407,731,315,416,1003,466,516,727,318,371
060590626452,370,161,209,375,162,213,516,239,265,383,167,196
060590626455,913,374,539,917,362,555,1175,559,600,785,335,410
060590634004,418,172,246,430,179,251,500,223,269,426,143,259
060590630071,1179,339,840,1195,351,844,858,284,560,831,315,474
060590630082,345,99,246,349,102,247,451,149,295,295,112,169
060590630081,147,42,105,149,44,105,934,308,611,156,59,90
060590634002,622,235,387,637,239,398,772,323,436,521,213,279
060590630073,845,432,413,861,432,429,1307,683,596,935,437,443
060590015042,476,254,222,481,251,230,906,492,387,656,330,274
060590626571,397,195,202,406,197,209,970,487,462,482,226,228
060590630072,1027,377,650,1038,376,662,1228,499,706,988,372,563
060590630092,563,206,357,579,208,371,726,306,405,587,211,341
060374087031,625,311,314,646,303,343,921,521,389,583,286,274
060590015013,1000,405,595,1028,385,643,1189,547,616,970,364,542
060590218321,295,137,158,297,125,172,407,195,202,371,186,168
060590218323,1264,633,631,1287,606,681,1088,585,488,1105,551,494
060590626582,835,338,497,850,342,508,983,445,523,700,264,400
060590630042,703,376,327,715,373,342,735,363,351,953,360,545
060590626572,557,274,283,568,275,293,585,294,280,622,291,294
060590636013,291,153,138,296,147,149,399,203,182,343,162,152
060590630044,712,307,405,722,315,407,926,434,480,852,372,432
060590015062,981,424,557,1002,416,586,1293,651,620,1200,530,614
060590631012,444,167,277,457,164,293,610,238,356,437,187,218
060590636033,624,336,288,644,341,303,977,530,426,757,322,383
060590015044,429,260,169,441,258,183,616,356,247,451,246,172
060590218144,888,414,474,901,395,506,1170,616,527,838,373,387
060590320511,305,151,154,308,144,164,538,273,255,407,202,179
060590320513,558,277,281,565,264,301,757,383,355,587,284,261
060590320501,268,127,141,274,122,152,377,184,188,351,155,176
060590320502,604,275,329,612,260,352,873,406,449,786,338,396
060590320512,489,233,256,491,219,272,655,310,330,368,184,157
060590320542,207,99,108,209,97,112,236,114,118,230,103,113
060590320543,210,102,108,209,98,111,217,102,111,210,94,104
060590320544,516,267,249,522,260,262,694,339,341,550,256,259
060590320514,230,114,116,230,108,122,544,276,249,423,201,195
060590320532,839,347,492,856,352,504,839,397,423,658,291,340
060590320533,708,299,409,719,299,420,1389,649,710,865,400,412
060590320652,333,155,178,339,153,186,594,303,273,479,223,224
060590320651,463,196,267,474,196,278,1118,521,571,610,244,333
060590320493,1110,515,595,1132,511,621,1498,763,711,1181,541,570
060590320484,761,372,389,774,366,408,1061,548,489,854,413,389
060590320492,569,281,288,581,277,304,1272,649,597,808,362,394
060590320421,1680,660,1020,1710,642,1068,2381,1043,1291,1788,667,1005
060590320422,498,192,306,509,187,322,422,186,226,504,177,293
060590320343,581,215,366,590,220,370,349,157,186,661,255,376
060590320551,251,120,131,258,120,138,343,174,159,186,96,75
060590320552,226,108,118,232,108,124,597,301,278,343,178,138
060590320554,506,242,264,519,241,278,588,298,275,602,272,285
060590320541,919,448,471,937,430,507,1551,786,723,1148,543,531
060590320503,1110,541,569,1129,526,603,1524,785,722,1248,579,610
060590524225,1390,827,563,1420,815,605,2072,1186,847,1092,596,442
060590524253,471,263,208,480,257,223,729,401,310,531,279,218
060590524231,608,283,325,621,283,338,595,298,285,681,284,356
060590524233,559,243,316,567,243,324,902,443,442,756,315,396
060590524242,622,310,312,636,306,330,1315,703,580,803,383,368
060590524243,506,249,257,519,250,269,658,347,296,376,182,168
060590524254,685,348,337,698,351,347,1062,578,461,624,327,258
060590524251,502,252,250,510,248,262,812,437,353,679,318,309
060590524221,828,367,461,841,363,478,1080,551,505,906,390,458
060590524252,323,161,162,328,157,171,375,197,168,316,144,149
060590524232,752,420,332,769,424,345,1096,660,411,869,492,318
060590524241,590,373,217,595,355,240,843,525,300,698,338,316
060590524152,1031,423,608,1056,424,632,1301,607,654,1111,452,577
060590320271,1123,551,572,1143,528,615,1393,723,647,1188,548,561
060590524081,547,217,330,559,218,341,711,331,366,614,256,328
060590524084,640,254,386,657,256,401,814,360,443,656,272,349
060590524161,284,152,132,290,152,138,451,261,184,316,154,141
060590524162,743,395,348,755,395,360,1150,643,490,809,374,378
060590320141,948,528,420,960,521,439,1279,703,552,804,479,264
060590524082,990,443,547,1010,432,578,1371,681,660,1060,521,480
060590524083,974,435,539,993,425,568,1135,560,545,1030,415,540
060590320143,520,268,252,531,260,271,716,368,338,785,383,349
060590320142,308,162,146,315,156,159,546,295,235,505,248,226
060590524111,640,309,331,645,300,345,943,502,417,810,390,374
060590524112,550,292,258,556,292,264,749,454,279,754,392,315
060590524223,613,224,389,625,227,398,715,322,380,564,200,328
060590524224,440,234,206,448,230,218,1002,540,440,537,270,230
060590524309,742,385,357,757,379,378,1566,911,621,1093,592,432
060590524303,942,394,548,963,389,574,993,490,483,753,327,379
060590524271,1057,509,548,1087,514,573,1465,771,662,1157,500,582
060590524272,1013,484,529,1043,490,553,1523,797,694,1099,474,551
060590524301,611,247,364,620,239,381,853,420,415,658,285,330
060590524281,729,335,394,747,331,416,1368,706,632,666,289,332
060590524283,363,157,206,373,157,216,663,308,340,529,231,259
060590524284,1046,465,581,1074,466,608,1221,631,561,1053,458,527
060590524285,376,168,208,385,167,218,494,257,224,428,186,215
060590524113,495,238,257,501,231,270,565,297,252,445,214,206
060590524163,578,264,314,589,252,337,720,357,348,529,224,273
060590524101,335,185,150,341,177,164,574,310,247,507,273,193
060590524102,558,224,334,567,229,338,625,285,332,586,189,383
060590524103,620,342,278,627,326,301,762,413,328,778,373,354
060590524151,1086,540,546,1105,547,558,1170,656,489,1148,580,517
060590524104,638,255,383,648,261,387,873,400,463,517,249,235
060590757013,369,212,157,375,213,162,693,425,253,548,327,185
060590218141,992,453,539,1015,458,557,1216,619,571,1225,554,608
060590218142,738,337,401,754,340,414,1151,578,551,768,389,314
060590423171,494,205,289,502,205,297,733,355,365,470,207,232
060590423172,476,196,280,486,198,288,602,290,299,503,185,284
060590423311,1259,546,713,1282,544,738,1468,740,701,1579,725,779
060590423292,721,350,371,734,349,385,914,474,423,817,378,410
060590423293,817,396,421,829,395,434,1192,620,551,881,416,425
060590423301,883,415,468,905,422,483,1036,531,480,716,334,347
060590423262,1427,759,668,1445,745,700,1923,1059,833,1596,825,690
060590423243,802,364,438,813,363,450,937,466,456,895,406,454
060590423251,952,466,486,966,455,511,1117,600,497,1071,497,523
060590423303,613,290,323,623,286,337,638,341,289,960,451,455
060590423304,403,191,212,410,188,222,1070,572,484,321,154,150
060590423313,666,346,320,677,340,337,489,275,209,466,242,199
060590423244,828,416,412,843,428,415,1257,697,529,1079,521,511
060590423252,759,384,375,775,385,390,956,513,426,856,412,403
060590423302,201,95,106,206,96,110,437,224,202,202,96,94
060590423372,780,261,519,789,262,527,999,406,573,788,276,475
060590423191,1293,558,735,1316,569,747,1593,801,771,1344,562,697
060590423261,614,308,306,626,301,325,832,441,374,441,232,189
060590423155,494,246,248,503,247,256,585,295,267,639,328,278
060590423153,517,256,261,524,249,275,727,368,345,688,356,295
060590423371,487,241,246,495,236,259,718,364,341,464,194,243
060590423312,274,154,120,280,152,128,502,287,208,397,217,157
060590423151,507,250,257,513,244,269,667,346,310,552,246,272
060590423154,767,380,387,778,377,401,984,514,452,1006,440,505
060590423152,534,259,275,540,250,290,543,281,252,510,219,258
060590423321,745,316,429,757,314,443,758,376,369,689,312,340
060590423322,1060,443,617,1076,439,637,1269,581,671,1024,407,561
060590423323,1055,445,610,1072,445,627,1688,832,819,1358,614,667
060590423173,975,423,552,995,421,574,1185,592,574,840,332,463
060590423373,428,178,250,436,177,259,641,288,344,502,211,258
060590423341,570,305,265,575,302,273,711,378,322,557,277,248
060590423342,349,186,163,352,186,166,571,301,256,478,267,184
060590423352,929,471,458,944,466,478,1089,564,506,1277,610,609
060590423353,959,492,467,974,486,488,1390,722,643,935,477,415
060590423361,1425,687,738,1460,686,774,1981,1017,922,1407,665,661
060590423351,584,314,270,593,307,286,918,485,414,608,290,288
060590423362,639,344,295,648,337,311,960,506,434,748,358,344
060590423291,592,283,309,606,282,324,677,349,316,590,272,278
060590423343,700,360,340,713,357,356,945,511,414,783,371,366
060590423344,583,301,282,595,298,297,680,367,297,657,356,278
060590423192,501,235,266,504,237,267,609,315,283,502,227,245
060590525051,290,168,122,296,168,128,391,231,151,349,198,131
060590525262,1086,607,479,1102,600,502,1493,879,586,1152,622,450
060590626101,309,181,128,312,184,128,704,409,277,1,1,0
060590755166,232,169,63,237,170,67,945,652,266,197,129,53
060590626111,127,86,41,131,87,44,245,169,71,246,161,70
060590626112,368,249,119,376,250,126,608,419,177,592,388,169
060590626113,564,382,182,578,386,192,699,484,203,600,393,172
060590626271,404,273,131,413,274,139,508,351,148,444,322,96
060590626501,808,531,277,825,534,291,1414,949,431,1186,766,345
060590626502,603,373,230,616,373,243,666,413,243,549,317,205
060590626503,772,504,268,785,504,281,818,533,273,595,370,193
060590525221,471,295,176,476,297,179,651,423,215,478,307,147
060590525223,438,265,173,443,266,177,795,501,275,557,372,162
060590525232,360,218,142,368,220,148,568,357,196,433,266,145
060590525233,611,369,242,622,372,250,764,479,264,674,414,225
060590626554,1126,564,562,1142,551,591,813,393,404,852,437,367
060590626291,892,506,386,913,499,414,1200,752,422,835,486,296
060590626292,355,207,148,364,209,155,487,305,170,496,291,175
060590626313,530,301,229,542,296,246,693,432,245,531,306,193
060590626311,350,204,146,354,203,151,464,293,163,633,335,271
060590626312,392,225,167,400,224,176,433,271,151,443,260,157
060590626148,1060,981,79,1077,980,97,326,296,21,1510,1313,106
060590525282,467,279,188,485,279,206,405,262,133,267,158,94
060590525284,280,167,113,289,167,122,389,253,128,380,225,129
060590525281,306,183,123,317,183,134,366,238,119,393,232,135
060590525283,248,149,99,257,149,108,596,386,194,396,234,138
060590525321,1042,666,376,1066,666,400,1033,686,325,1247,773,381
060590525324,347,221,126,355,221,134,561,367,184,305,188,92
060590525322,84,54,30,86,54,32,733,489,230,349,207,118
060590525061,761,349,412,773,351,422,941,482,441,729,336,347
060590525062,468,215,253,477,216,261,564,289,263,544,256,267
060590525275,624,365,259,643,371,272,911,553,343,673,393,243
060590525276,766,436,330,793,444,349,1127,684,417,855,493,318
060590525271,590,336,254,607,340,267,765,464,284,577,331,214
060590626512,242,156,86,245,156,89,400,258,134,462,287,152
060590626513,366,237,129,369,235,134,415,269,140,244,150,81
060590525111,563,311,252,578,317,261,616,365,240,556,314,209
060590525112,388,196,192,395,199,196,424,237,179,368,185,162
060590525115,378,211,167,386,212,174,341,207,128,356,206,128
060590525116,301,172,129,311,176,135,405,248,148,314,188,108
060590525114,286,164,122,292,166,126,439,269,162,408,243,139
060590525113,611,314,297,624,320,304,814,456,344,674,336,297
060590626301,475,245,230,486,246,240,811,485,311,518,267,232
060590626302,403,207,196,413,210,203,243,145,93,366,188,163
060590525131,417,248,169,426,250,176,467,292,163,463,277,159
060590525136,405,241,164,414,244,170,534,336,186,407,246,134
060590525134,516,304,212,531,310,221,649,407,227,663,396,228
060590525135,342,195,147,347,198,149,402,259,136,327,184,125
060590524174,311,197,114,312,188,124,546,340,199,507,290,191
060590524361,398,234,164,407,230,177,650,430,209,619,362,238
060590524364,334,195,139,341,192,149,538,355,173,467,277,171
060590524211,844,485,359,862,486,376,1053,650,382,910,536,311
060590524212,537,306,231,549,307,242,663,408,239,576,322,215
060590525132,330,216,114,337,216,121,457,294,155,303,190,91
060590525133,343,224,119,347,223,124,540,347,183,365,234,104
060590525331,388,218,170,401,223,178,511,312,190,433,247,157
060590525336,528,296,232,543,303,240,750,462,281,592,331,228
060590525332,377,213,164,388,216,172,442,271,165,394,222,150
060590626281,314,202,112,322,200,122,338,223,109,240,143,81
060590626282,958,572,386,983,575,408,982,628,331,852,496,310
060590524176,385,169,216,393,169,224,555,288,258,436,225,192
060590524171,577,254,323,590,253,337,542,283,253,448,175,251
060590524172,391,173,218,399,170,229,546,284,255,622,245,351
060590524173,449,197,252,457,196,261,664,344,309,455,236,200
060590524214,358,198,160,363,197,166,562,344,208,437,241,169
060590524215,473,261,212,484,261,223,584,356,217,498,277,193
060590525144,712,377,335,729,378,351,963,565,374,700,392,265
060590525143,457,242,215,469,243,226,549,324,214,525,299,194
060590525193,832,505,327,849,503,346,1071,671,373,764,432,279
060590525192,402,245,157,410,242,168,655,418,219,560,347,191
060590525204,269,162,107,277,161,116,396,244,143,273,167,94
060590525202,415,244,171,426,241,185,478,294,173,528,312,186
060590525201,235,135,100,240,136,104,359,220,131,253,139,97
060590626262,303,250,53,310,256,54,354,268,73,444,321,96
060590626272,323,266,57,331,273,58,261,198,54,313,227,68
060590626273,270,223,47,276,228,48,306,233,63,347,251,75
060590626144,562,519,43,573,524,49,509,467,28,677,586,41
060590626147,1124,1021,103,1140,1022,118,1107,979,105,587,509,39
060590626145,445,398,47,452,397,55,352,310,35,592,516,48
060590626553,182,102,80,185,99,86,456,257,192,298,153,129
060590626141,579,514,65,585,512,73,548,481,56,688,605,56
060590626143,353,314,39,355,311,44,514,455,52,504,444,41
060590524333,285,202,83,290,199,91,483,320,156,392,257,114
060590524332,310,220,90,314,215,99,316,208,101,245,151,79
060590524331,328,233,95,332,228,104,672,444,216,528,355,145
060590525333,441,259,182,450,257,193,725,434,276,530,306,192
060590525334,375,221,154,382,218,164,497,301,191,437,244,170
060590525335,815,480,335,833,475,358,1084,648,412,810,469,294
060590626261,440,338,102,449,336,113,505,361,132,491,385,81
060590525141,472,286,186,479,287,192,581,371,195,496,280,189
060590525323,238,133,105,243,138,105,375,230,141,228,141,73
060590525142,511,334,177,522,330,192,647,412,217,694,436,227
060590524175,837,465,372,856,466,390,1106,691,404,718,417,258
060590626314,137,80,57,140,80,60,383,241,133,301,172,114
060590524362,263,153,110,268,151,117,474,314,152,292,177,101
060590524363,527,308,219,541,305,236,556,369,178,369,223,128
060590524365,497,290,207,508,286,222,797,488,295,538,324,188
060590525291,558,355,203,570,352,218,863,572,271,589,382,177
060590525301,582,366,216,594,364,230,971,635,311,764,479,240
060590525302,491,308,183,502,308,194,687,449,221,516,324,162
060590525311,656,390,266,669,394,275,598,370,217,492,291,169
060590525312,610,364,246,626,369,257,1257,774,453,747,454,246
060590525292,453,291,162,465,288,177,586,388,184,438,289,133
060590525272,314,202,112,322,200,122,423,281,133,284,182,83
060590525273,205,132,73,209,130,79,388,258,122,280,182,81
060590755164,316,236,80,325,236,89,474,333,125,212,139,56
060590525222,445,287,158,450,289,161,516,342,166,379,241,119
060590525231,217,140,77,221,142,79,398,262,127,299,188,94
060590525234,162,105,57,164,105,59,275,181,88,219,139,68
060590525213,246,180,66,249,180,69,312,212,93,353,224,104
060590525214,199,147,52,203,147,56,384,261,116,289,190,76
060590755165,336,247,89,340,246,94,762,516,228,236,155,62
060590525303,351,246,105,354,246,108,485,320,156,430,274,127
060590525211,481,341,140,485,341,144,683,459,207,580,374,161
060590525212,271,192,79,272,191,81,453,305,137,291,192,75
060590755163,930,574,356,946,564,382,356,223,126,184,109,60
060590525191,558,329,229,575,325,250,616,380,222,430,243,161
060590525203,498,292,206,511,289,222,734,454,266,574,330,210
060590755161,303,233,70,308,228,80,511,394,111,151,111,32
060590626511,519,292,227,533,289,244,596,366,222,454,258,173
060590525053,482,267,215,492,266,226,596,339,245,486,270,190
060590525056,371,206,165,378,204,174,444,253,184,471,240,210
060590525052,258,143,115,263,142,121,396,224,163,187,122,53
060590525055,386,214,172,393,213,180,393,223,162,219,141,67
060590525054,104,58,46,107,58,49,337,193,141,303,154,135
060590525274,684,400,284,703,406,297,891,538,337,708,413,257
060590525261,679,373,306,688,368,320,946,547,375,765,426,282
060590626541,569,378,191,582,379,203,1042,677,341,958,586,315
060590626543,758,504,254,777,505,272,955,621,312,979,669,279
060590626542,573,374,199,589,376,213,1177,766,384,341,210,111
060590524373,501,307,194,511,308,203,750,471,272,431,258,153
060590524374,111,70,41,111,71,40,341,199,133,30,18,10
060590524375,517,295,222,536,294,242,675,411,250,152,92,53
060590525181,963,721,242,975,717,258,1297,879,394,222,144,64
060590525183,508,380,128,514,378,136,916,621,278,1269,822,364
060590524351,393,243,150,403,244,159,668,442,210,389,234,130
060590524352,569,340,229,582,340,242,535,328,194,437,257,155
060590524353,661,396,265,680,397,283,569,351,208,504,301,177
060590524354,327,195,132,335,194,141,462,282,169,273,161,97
060590524355,430,245,185,441,248,193,743,455,272,602,354,229
060590626142,1008,936,72,1025,942,83,897,814,40,1003,862,46
060590626146,455,423,32,463,426,37,501,455,23,385,321,21
060590626551,224,125,99,226,121,105,337,189,142,281,144,121
060590626552,417,232,185,423,226,197,908,513,383,586,302,254
060590524341,327,186,141,339,190,149,414,255,149,308,192,103
060590524343,410,237,173,422,239,183,699,433,253,478,299,159
060590524342,1096,650,446,1121,651,470,1592,997,557,1253,772,417
060590524344,394,240,154,400,237,163,769,490,260,653,398,217
060590525341,583,384,199,588,372,216,1047,667,354,530,335,167
060590524321,2777,1862,915,2839,1848,991,317,205,104,366,242,102
060590524323,361,242,119,371,243,128,853,558,273,798,530,222
060590524311,467,312,155,482,314,168,1104,718,362,861,572,243
060590524312,2297,1522,775,2360,1549,811,765,514,237,754,501,208
060590524396,27,10,17,28,11,17,1379,890,466,0,0,0
060590524307,360,220,140,369,218,151,417,272,138,12,9,3
060590524308,1429,874,555,1467,868,599,539,341,185,17,11,5
060590524302,0,0,0,0,0,0,658,418,227,19,12,6
060590524306,4,2,2,4,2,2,1109,704,379,1465,937,454
060590524383,354,239,115,363,244,119,1109,724,361,50,33,15
060590626102,240,156,84,245,156,89,577,363,200,610,358,212
060590626103,908,587,321,928,591,337,1054,662,365,660,393,219
060590626104,175,113,62,179,114,65,691,434,239,778,459,271
060590524322,280,188,92,290,190,100,1407,948,433,453,303,126
060590524291,1144,723,421,1172,716,456,911,610,290,716,459,222
060590524292,909,574,335,935,572,363,1172,779,375,759,485,238
060590524293,641,404,237,651,401,250,377,253,120,400,257,123
060590524294,96,61,35,99,61,38,509,342,161,116,74,36
060590755183,55,34,21,56,33,23,965,602,338,6,4,2
060590626533,1212,764,448,1222,758,464,1472,961,486,1333,822,440
060590524381,16,11,5,16,11,5,455,304,143,1,1,0
060590524382,251,167,84,258,172,86,618,414,194,547,334,186
060590525351,916,525,391,935,529,406,1390,847,514,995,616,347
060590524324,40,27,13,40,26,14,873,577,277,966,619,298
060590525353,29,20,9,29,19,10,241,159,75,230,158,57
060590525354,65,44,21,67,44,23,344,227,107,291,200,73
060590525352,114,78,36,115,75,40,413,272,128,175,120,44
060590762022,488,220,268,500,213,287,681,316,351,524,224,269
060590758072,1054,480,574,1084,465,619,1308,618,652,955,430,450
060590761051,499,290,209,500,276,224,631,382,236,515,299,177
060590761053,275,161,114,278,152,126,542,324,201,476,278,165
060590761052,522,311,211,521,292,229,721,443,267,580,337,202
060590758052,659,302,357,670,289,381,775,392,366,684,295,345
060590759011,378,210,168,384,207,177,210,124,81,238,125,96
060590759012,327,205,122,334,200,134,256,152,99,360,201,131
060590759013,680,436,244,688,421,267,956,665,271,830,491,262
060590762081,643,318,325,647,310,337,889,458,409,685,316,321
060590762082,392,195,197,392,188,204,420,219,197,370,171,175
060590762083,676,308,368,680,303,377,901,434,447,684,317,327
060590762084,270,134,136,271,129,142,465,239,214,363,168,170
060590758101,828,292,536,840,289,551,1014,412,578,770,277,457
060590758121,300,159,141,302,153,149,655,404,231,639,343,252
060590762052,600,316,284,604,307,297,744,380,345,412,215,168
060590762061,380,200,180,377,192,185,767,388,354,390,203,158
060590762014,694,324,370,706,317,389,1117,582,510,873,405,420
060590762013,411,191,220,419,185,234,575,295,269,453,199,230
060590758051,432,233,199,436,225,211,382,231,139,410,229,151
060590758151,958,427,531,973,414,559,1028,469,528,1027,468,492
060590758153,444,197,247,452,192,260,488,224,252,335,165,147
060590761023,524,317,207,547,328,219,805,448,347,626,442,158
060590762042,236,156,80,237,145,92,360,234,115,315,210,82
060590762043,214,140,74,212,131,81,472,306,150,308,205,80
060590762062,327,149,178,331,145,186,444,224,211,329,144,166
060590762063,427,182,245,438,178,260,559,281,265,480,199,256
060590762051,293,153,140,298,153,145,887,518,340,741,388,297
060590762054,273,142,131,278,142,136,248,144,94,235,123,94
060590758053,334,191,143,336,184,152,338,205,123,345,193,128
060590219182,1097,562,535,1121,571,550,1431,762,636,1091,507,524
060590760014,426,267,159,427,257,170,696,453,229,631,382,205
060590760021,313,222,91,317,229,88,835,575,242,416,261,123
060590760012,548,344,204,550,331,219,635,411,209,704,425,224
060590760013,366,232,134,366,227,139,539,351,180,556,351,172
060590760015,531,342,189,533,342,191,889,534,334,591,375,171
060590758061,523,267,256,531,261,270,759,370,373,608,271,306
060590758062,431,220,211,438,214,224,658,319,323,509,221,262
060590758063,208,106,102,211,103,108,354,253,93,313,206,83
060590758064,376,198,178,377,191,186,575,318,242,470,248,193
060590756045,550,227,323,559,224,335,705,331,361,950,497,392
060590756046,656,250,406,664,240,424,801,360,421,663,263,364
060590758065,344,205,139,348,198,150,423,246,170,352,199,127
060590759022,659,385,274,673,372,301,989,590,372,806,459,289
060590759023,464,274,190,469,268,201,799,478,289,495,307,154
060590759024,425,257,168,436,249,187,535,320,201,470,265,163
060590759025,298,174,124,299,170,129,380,232,142,334,175,132
060590219134,506,382,124,503,363,140,774,536,215,772,504,224
060590219141,1174,565,609,1183,571,612,1625,861,716,1093,537,492
060590762024,487,196,291,495,194,301,654,293,350,587,239,311
060590219132,702,377,325,698,361,337,913,528,371,789,395,343
060590219133,668,366,302,675,354,321,1077,583,478,743,380,322
060590758132,316,141,175,320,140,180,359,212,140,392,199,171
060590762023,686,306,380,691,303,388,1103,520,559,921,386,482
060590219123,724,254,470,733,249,484,716,288,410,665,219,409
060590219173,513,167,346,525,170,355,679,264,405,554,163,362
060590219142,680,317,363,684,311,373,738,366,352,649,283,322
060590219183,534,202,332,545,196,349,452,172,271,555,224,302
060590219181,481,252,229,488,244,244,752,400,338,655,310,302
060590219171,810,277,533,819,265,554,1028,397,609,601,190,377
060590219172,598,241,357,607,241,366,724,328,384,568,232,301
060590756044,756,309,447,770,304,466,954,433,504,752,312,392
060590756052,769,334,435,792,340,452,1075,521,528,895,375,465
060590756055,606,273,333,623,279,344,827,418,392,731,304,381
060590756054,285,129,156,294,131,163,555,280,261,485,202,251
060590758152,306,181,125,309,175,134,975,522,418,747,379,316
060590758071,445,240,205,448,235,213,602,338,249,452,215,202
060590758073,234,126,108,236,124,112,431,241,178,375,179,167
060590758081,757,368,389,768,367,401,846,425,397,927,450,423
060590758082,974,422,552,996,412,584,1271,606,638,1081,451,556
060590759021,468,279,189,471,270,201,473,289,174,557,277,243
060590760011,375,237,138,377,227,150,551,351,182,373,233,113
060590761022,152,101,51,151,97,54,492,329,153,406,266,111
060590761024,163,108,55,163,104,59,321,214,100,99,65,27
060590758142,437,177,260,449,173,276,566,257,295,553,238,289
060590758092,662,193,469,675,186,489,774,273,488,645,204,406
060590758141,407,138,269,421,141,280,682,268,401,455,147,287
060590758093,562,180,382,579,183,396,745,295,431,621,189,397
060590762011,484,237,247,489,233,256,670,367,290,574,299,239
060590762012,337,165,172,341,162,179,423,236,184,518,218,265
060590762015,755,371,384,765,364,401,1180,644,508,720,399,280
060590219131,453,172,281,462,167,295,736,320,395,468,188,254
060590758161,579,340,239,583,328,255,893,571,297,792,389,349
060590758162,493,290,203,499,281,218,753,397,339,467,238,197
060590758102,866,271,595,876,273,603,1160,454,687,938,308,589
060590758111,852,340,512,867,336,531,1094,500,567,873,345,478
060590758122,554,224,330,565,221,344,784,356,412,614,232,344
060590758112,144,75,69,144,72,72,175,117,46,160,111,38
060590762053,531,279,252,536,267,269,948,496,425,823,378,382
060590762064,505,266,239,510,254,256,587,307,264,495,227,231
060590758123,566,226,340,576,223,353,765,336,413,618,250,328
060590758124,463,185,278,468,182,286,606,286,310,532,208,289
060590320571,167,76,91,170,75,95,1561,756,771,1169,525,574
060590320573,1832,826,1006,1875,799,1076,425,207,208,305,131,153
060590320662,3788,1720,2068,3840,1712,2128,560,269,281,908,382,472
060590320572,1482,647,835,1500,637,863,2196,1040,1121,1748,726,936
060590320592,763,322,441,781,310,471,1110,525,560,821,357,429
060590320582,434,216,218,445,219,226,1450,716,703,649,295,315
060590320594,98,45,53,101,47,54,878,419,439,725,300,369
060590320591,150,67,83,153,65,88,1169,571,572,843,338,470
060590320595,360,165,195,367,157,210,899,440,444,752,338,370
060590320593,441,206,235,460,215,245,717,353,345,540,240,277
060590320581,1286,445,841,1317,447,870,1964,796,1144,1413,519,821
060590320612,2,1,1,2,1,1,1469,708,743,21,9,11
060590752011,585,469,116,584,444,140,1012,734,250,814,650,119
060590890041,380,222,158,394,226,168,586,276,305,435,305,115
060590890043,417,245,172,428,246,182,714,334,369,502,349,132
060590744053,110,97,13,111,95,16,170,134,31,133,113,12
060590750041,247,186,61,251,183,68,730,515,195,598,412,150
060590750042,234,207,27,235,198,37,353,276,62,265,221,24
060590753011,405,292,113,406,283,123,620,432,181,469,332,103
060590753012,545,329,216,555,324,231,732,465,254,501,303,171
060590753013,621,389,232,621,377,244,906,583,306,634,398,200
060590753021,523,350,173,524,336,188,916,596,305,686,457,192
060590891022,343,230,113,346,223,123,550,348,194,383,264,100
060590891043,169,112,57,170,109,61,285,145,139,281,195,74
060590992471,364,227,137,366,227,139,495,250,239,327,229,86
060590992472,403,251,152,407,252,155,695,349,335,449,313,118
060590890012,468,297,171,470,295,175,832,409,408,530,369,138
060590890013,281,179,102,283,176,107,546,270,269,385,269,102
060590752012,437,356,81,438,335,103,634,478,144,516,418,68
060590752021,489,406,83,490,385,105,748,565,168,578,476,70
060590741061,499,347,152,505,336,169,750,522,210,594,413,133
060590741062,566,345,221,575,347,228,1083,703,360,712,430,239
060590741063,323,197,126,328,199,129,514,325,180,425,255,142
060590741102,432,264,168,439,265,174,492,320,163,412,250,139
060590750031,158,118,40,158,114,44,325,248,71,274,211,49
060590751003,500,356,144,501,342,159,783,544,222,605,435,135
060590753031,189,123,66,193,123,70,343,233,103,297,187,92
060590753032,690,451,239,697,444,253,541,370,165,439,275,137
060590741071,148,97,51,149,98,51,592,375,206,543,347,160
060590741072,619,371,248,629,365,264,1122,670,426,873,487,329
060590741073,657,391,266,666,385,281,875,524,327,648,354,250
060590751002,503,357,146,502,341,161,617,438,166,564,386,137
060590751004,394,290,104,391,276,115,482,344,128,387,278,82
060590752022,537,451,86,537,433,104,661,503,148,560,471,64
060590749012,261,221,40,260,212,48,276,205,62,243,208,25
060590751001,208,176,32,205,166,39,604,454,133,497,424,51
060590750021,285,228,57,283,221,62,397,289,98,263,218,32
060590750033,137,109,28,136,105,31,368,262,97,291,241,35
060590748031,758,557,201,762,540,222,1229,836,373,897,673,176
060590749011,312,277,35,305,265,40,337,273,56,276,244,24
060590749013,182,162,20,181,156,25,352,280,58,252,218,23
060590749015,179,159,20,175,152,23,406,322,68,322,280,29
060590746011,178,150,28,178,146,32,257,204,51,258,215,28
060590746012,209,177,32,207,173,34,311,240,61,278,238,27
060590746013,154,130,24,154,129,25,236,186,46,239,198,25
060590749014,165,140,25,164,138,26,379,295,74,240,203,30
060590749022,185,159,26,181,154,27,327,263,59,283,246,26
060590750024,214,181,33,216,175,41,199,160,38,134,115,15
060590750032,169,144,25,173,139,34,401,324,70,382,315,48
060590746021,130,112,18,129,108,21,202,156,38,157,130,15
060590746022,182,157,25,184,153,31,303,234,59,243,201,24
060590746023,326,281,45,326,275,51,517,402,102,428,365,45
060590746024,399,345,54,401,333,68,516,409,104,406,348,42
060590748013,308,264,44,305,253,52,446,362,81,300,259,21
060590748022,301,264,37,297,248,49,406,322,71,257,222,19
060590748051,233,198,35,232,189,43,792,631,143,456,402,29
060590748052,176,151,25,177,145,32,300,241,56,222,198,16
060590748061,199,169,30,200,162,38,556,447,100,293,258,20
060590747013,523,456,67,525,431,94,690,548,124,627,551,49
060590747023,224,194,30,221,183,38,501,386,108,418,368,34
060590748062,409,357,52,408,337,71,526,422,96,471,414,38
060590748011,242,206,36,240,200,40,349,287,54,346,301,32
060590748012,289,250,39,289,242,47,536,432,95,359,307,33
060590747021,405,344,61,402,329,73,571,442,113,464,393,53
060590747022,364,310,54,360,295,65,580,454,116,501,419,57
060590747011,337,285,52,342,284,58,540,409,117,506,416,65
060590747012,367,309,58,370,306,64,621,478,137,614,506,81
060590746014,444,337,107,454,334,120,650,455,183,457,347,84
060590746015,350,267,83,351,259,92,596,416,167,462,345,86
060590740032,423,360,63,427,356,71,633,498,118,621,485,104
060590741031,486,403,83,483,390,93,514,397,105,403,331,48
060590742003,638,549,89,636,527,109,995,774,194,871,720,102
060590742004,463,397,66,460,380,80,795,624,156,715,591,84
060590741032,312,258,54,311,250,61,497,384,102,368,304,44
060590741033,328,271,57,325,262,63,621,483,125,490,404,57
060590741023,389,315,74,388,303,85,690,532,142,573,468,81
060590741021,483,379,104,485,368,117,405,311,89,388,320,49
060590741022,438,344,94,440,334,106,861,618,227,533,438,68
060590741081,537,424,113,534,406,128,845,611,218,663,527,104
060590741091,413,316,97,410,313,97,539,395,141,451,374,58
060590741092,212,162,50,211,162,49,468,337,120,395,324,51
060590740044,782,507,275,785,490,295,1129,744,365,911,634,230
060590744062,269,197,72,270,192,78,277,208,64,229,167,48
060590744063,136,103,33,137,100,37,225,173,48,216,163,46
060590744064,79,59,20,80,58,22,313,234,71,155,114,32
060590754032,273,199,74,272,195,77,371,271,89,296,216,61
060590754034,526,386,140,527,377,150,462,350,107,361,262,75
060590754031,639,424,215,645,411,234,598,396,187,484,290,162
060590754033,591,387,204,592,374,218,1258,834,395,1002,602,333
060590755041,1306,658,648,1334,651,683,1599,870,693,1328,641,618
060590746025,253,219,34,251,210,41,396,304,80,330,271,36
060590745011,164,142,22,162,135,27,482,373,96,331,280,32
060590745012,261,223,38,263,215,48,363,291,70,307,260,30
060590743002,411,355,56,412,348,64,542,425,99,517,405,85
060590744031,289,251,38,286,241,45,870,645,196,289,249,27
060590748032,631,483,148,634,460,174,1030,641,366,729,565,132
060590748033,328,250,78,329,239,90,438,335,96,462,358,83
060590891052,286,231,55,284,220,64,504,374,118,307,254,40
060590891053,223,168,55,224,160,64,445,298,139,321,253,54
060590741082,252,201,51,250,191,59,546,391,142,404,320,64
060590890014,469,308,161,476,299,177,674,364,300,463,323,116
060590890042,538,353,185,548,346,202,1240,668,552,764,536,192
060590891041,168,118,50,168,108,60,265,172,89,220,153,57
060590891051,167,117,50,168,109,59,401,258,132,351,240,91
060590992481,457,326,131,466,323,143,574,356,207,365,273,76
060590992482,434,309,125,444,307,137,778,482,280,459,342,94
060590992491,323,230,93,330,229,101,555,344,201,381,284,78
060590992492,197,141,56,201,139,62,476,296,171,314,233,65
060590992022,793,537,256,796,520,276,1301,734,540,892,622,236
060590741101,866,573,293,865,557,308,1271,771,480,995,673,276
060590753022,762,512,250,766,490,276,1192,780,379,981,649,275
060590753033,529,356,173,531,339,192,516,347,166,415,276,118
060590744051,192,161,31,193,158,35,391,309,73,403,296,84
060590744052,402,336,66,404,329,75,515,412,95,592,432,121
060590744061,107,90,17,108,88,20,164,133,28,218,158,46
060590750022,311,261,50,314,256,58,413,328,78,539,395,113
060590750023,218,183,35,222,179,43,445,350,83,593,436,123
060590748021,218,192,26,214,180,34,319,260,56,267,235,19
060590748023,270,238,32,267,224,43,465,363,83,426,366,32
060590749021,237,214,23,235,206,29,318,259,52,257,222,22
060590749023,210,189,21,206,181,25,381,294,73,321,277,27
060590744071,256,219,37,251,208,43,394,321,63,308,278,17
060590744032,192,167,25,189,159,30,500,383,103,277,237,25
060590745013,118,103,15,118,99,19,518,399,107,285,244,26
060590757012,363,242,121,367,236,131,621,406,199,453,292,131
060590754011,991,561,430,999,547,452,1001,603,385,808,452,301
060590754012,767,438,329,770,426,344,1056,655,369,631,408,182
060590754043,485,295,190,490,284,206,750,466,264,349,254,73
060590754044,335,206,129,339,199,140,619,386,218,468,284,152
060590754041,482,287,195,488,277,211,604,374,220,429,263,140
060590754042,521,287,234,526,276,250,757,424,320,685,370,278
060590754051,599,350,249,606,350,256,805,491,301,625,374,210
060590754052,385,225,160,391,226,165,510,309,189,480,286,161
060590745021,704,574,130,701,555,146,556,431,115,891,739,109
060590742001,272,242,30,271,231,40,325,267,58,224,200,21
060590742002,215,189,26,212,180,32,384,311,68,306,266,27
060590743001,303,268,35,302,257,45,525,420,91,413,357,35
060590745022,313,277,36,310,264,46,660,524,115,474,413,43
060590740041,570,396,174,575,388,187,875,583,272,764,516,194
060590740042,127,88,39,129,87,42,385,257,119,307,208,79
060590740043,543,378,165,551,371,180,690,462,216,538,364,137
060590740062,433,323,110,436,321,115,515,375,123,396,280,91
060590740063,530,396,134,533,393,140,912,665,217,811,573,187
060590741111,367,232,135,373,228,145,475,288,181,365,221,121
060590740031,283,192,91,282,188,94,580,366,201,180,141,30
060590740053,232,163,69,235,160,75,524,366,144,458,316,110
060590740054,504,351,153,507,345,162,490,346,136,491,333,125
060590740061,261,182,79,262,178,84,334,235,92,341,230,87
060590741113,850,616,234,851,600,251,1310,843,442,775,570,159
060590740051,322,237,85,322,231,91,594,416,164,446,343,80
060590740052,350,257,93,349,250,99,679,480,189,488,378,88
060590741112,300,221,79,298,213,85,527,350,168,391,285,83
060590320451,658,236,422,671,236,435,833,350,464,867,291,518
060590320654,559,257,302,576,247,329,1032,524,484,799,351,388
060590320653,905,412,493,924,412,512,1147,571,549,1107,488,548
060590320111,536,261,275,550,263,287,684,345,318,607,265,293
060591106062,357,232,125,357,226,131,539,361,167,297,215,66
060591105002,639,444,195,644,430,214,893,560,311,718,494,181
060591105004,207,139,68,212,136,76,312,202,108,234,162,63
060591106073,246,171,75,259,165,94,478,313,156,275,178,74
060591105001,473,348,125,475,336,139,788,559,215,668,469,162
060591105003,299,218,81,300,209,91,520,340,171,394,279,94
060591106032,241,177,64,243,170,73,453,300,141,343,250,72
060591106033,323,204,119,322,210,112,534,318,205,390,256,111
060591106035,334,254,80,336,247,89,586,404,167,410,298,89
060591103021,402,226,176,403,211,192,672,371,291,557,315,210
060591104013,265,138,127,266,136,130,401,214,182,295,164,116
060591104014,281,143,138,286,138,148,473,241,220,360,197,140
060591106031,513,333,180,528,331,197,654,409,233,510,338,136
060591106072,340,221,119,350,219,131,709,449,255,465,309,124
060591103023,722,446,276,732,429,303,1135,667,440,930,533,330
060591106061,391,261,130,397,253,144,852,515,314,604,388,181
060591106071,276,156,120,278,155,123,421,243,168,295,177,104
060591106034,242,175,67,241,167,74,346,230,115,256,192,51
060590755121,334,234,100,337,232,105,672,437,217,344,244,78
060590755122,430,301,129,432,298,134,493,323,160,695,414,234
060590755173,458,321,137,460,317,143,744,484,240,426,305,94
060590755141,507,360,147,510,351,159,727,471,246,437,306,96
060591104012,465,235,230,467,234,233,689,360,318,574,302,236
060590755042,700,355,345,715,351,364,881,478,380,718,315,342
060590755071,627,372,255,636,373,263,950,604,325,736,413,267
060590755072,202,148,54,207,151,56,319,238,71,229,154,57
060590525023,827,479,348,840,473,367,1189,679,481,806,468,275
060590755131,839,584,255,850,574,276,1160,755,384,517,364,126
060590755132,372,259,113,378,255,123,667,435,221,929,568,286
060590868012,410,238,172,414,230,184,746,409,320,498,289,186
060590755051,534,305,229,537,297,240,871,521,326,661,352,256
060590755053,321,182,139,324,179,145,594,356,222,444,235,171
060590755052,326,185,141,329,182,147,414,250,154,330,189,124
060590757022,792,387,405,807,380,427,993,522,448,869,365,431
060590525021,650,316,334,662,313,349,875,470,386,708,345,325
060590525022,724,352,372,736,347,389,917,492,405,730,361,334
060590524192,726,362,364,737,357,380,1062,590,449,788,384,355
060590756051,532,212,320,544,211,333,602,278,306,426,168,234
060590525245,732,437,295,742,420,322,1058,658,366,843,480,313
060590868032,441,237,204,443,228,215,552,301,237,508,287,200
060591104021,469,261,208,469,249,220,677,373,288,513,283,201
060590756071,357,184,173,366,179,187,534,319,200,366,191,153
060590756072,814,421,393,830,408,422,1250,750,470,924,476,387
060590756073,424,221,203,432,209,223,671,371,287,474,240,209
060590756074,382,218,164,387,216,171,688,411,262,610,340,239
060590756065,408,173,235,417,172,245,518,253,251,517,216,272
060590756064,569,299,270,576,294,282,910,507,386,696,377,275
060590756061,1023,366,657,1037,347,690,1254,532,694,1086,392,617
060590756062,334,160,174,340,153,187,469,245,217,416,193,200
060590524191,808,401,407,819,395,424,914,505,390,714,381,283
060590756075,446,259,187,453,257,196,399,240,154,364,202,143
060590525241,532,293,239,542,293,249,723,431,281,636,314,286
060590525242,573,339,234,581,329,252,801,499,288,440,280,136
060590525243,274,162,112,276,157,119,418,261,150,303,175,110
060590525244,483,286,197,492,278,214,893,553,322,627,388,202
060590744072,490,342,148,492,336,156,749,521,212,662,440,179
060590744081,277,193,84,276,190,86,504,349,140,383,285,80
060590744082,246,184,62,246,182,64,288,206,77,194,146,37
060590744083,149,113,36,149,112,37,360,257,95,253,194,47
060590755061,806,368,438,820,356,464,1002,504,473,845,374,406
060590755171,482,333,149,488,322,166,672,461,199,348,250,77
060590755142,171,135,36,171,135,36,249,181,61,339,239,73
060590755172,167,133,34,167,133,34,412,302,101,508,363,112
060590757011,779,319,460,789,316,473,945,435,489,471,200,248
060590757014,946,429,517,960,417,543,1216,616,565,883,381,441
060590755184,709,423,286,722,432,290,993,632,333,699,444,213
060590755182,230,137,93,235,141,94,514,327,171,407,258,124
060590525024,524,300,224,537,299,238,595,339,239,605,286,284
060591103042,849,432,417,862,411,451,1311,672,611,1052,543,446
060590755185,815,504,311,829,494,335,1365,839,505,1686,1018,590
060591103013,443,218,225,449,216,233,608,302,297,468,228,210
060591103014,535,295,240,540,282,258,684,373,298,552,288,232
060591102025,212,117,95,214,112,102,317,176,136,264,146,103
060591102032,736,373,363,748,368,380,1184,605,562,883,435,377
060591103022,623,369,254,629,351,278,951,531,397,873,519,305
060591103031,703,417,286,707,394,313,1141,636,475,728,371,310
060591102012,810,448,362,820,430,390,1057,580,458,916,471,384
060591102013,639,355,284,645,338,307,1197,656,517,842,490,308
060590755062,325,185,140,331,181,150,400,246,145,364,197,145
060590755063,329,188,141,337,186,151,379,230,137,303,156,128
060590755073,625,356,269,640,352,288,1052,645,383,727,398,279
060590756033,548,284,264,564,282,282,753,399,337,655,275,328
060591103032,889,450,439,898,438,460,1324,695,605,1032,509,473
060591106042,886,463,423,913,457,456,676,358,303,549,278,249
060591106044,505,265,240,520,264,256,760,391,365,562,303,238
060590756031,831,346,485,847,334,513,788,370,398,677,278,341
060590756063,864,312,552,876,301,575,1186,526,634,1083,409,602
060590756042,1051,403,648,1071,401,670,1361,589,727,1162,510,584
060590756041,746,282,464,752,278,474,1032,483,533,791,308,436
060590756043,528,199,329,532,197,335,540,252,279,454,169,256
060590757031,1160,468,692,1181,464,717,1522,694,789,1346,532,724
060590757023,387,188,199,395,186,209,521,271,234,409,167,209
060590757021,564,219,345,573,211,362,688,296,370,585,246,285
060590756032,701,281,420,710,274,436,862,398,442,787,311,424
060590757032,441,179,262,449,178,271,525,242,272,399,170,201
060590757033,574,233,341,586,233,353,733,337,381,1064,413,584
060590756053,739,287,452,757,285,472,885,409,455,725,259,410
060590758091,583,175,408,592,169,423,622,218,390,591,176,379
060170307091,782,314,468,793,314,479,970,458,496,792,301,433
060170307093,515,161,354,524,152,372,778,287,476,573,201,335
060170307092,1196,490,706,1219,487,732,1628,745,836,1254,499,668
060170307011,1298,560,738,1318,552,766,1585,767,791,1249,531,629
060170307013,548,238,310,560,235,325,704,333,359,571,238,297
060170307012,1391,579,812,1419,565,854,1813,840,926,1547,624,823
060170307111,645,236,409,660,225,435,1017,430,560,572,201,333
060170307112,1302,601,701,1319,592,727,1952,990,944,966,464,455
060170307064,794,352,442,798,343,455,1104,528,549,876,358,453
060170317001,1493,620,873,1516,602,914,2225,1041,1131,1559,648,807
060170307063,867,386,481,880,382,498,921,445,453,907,377,473
060170307062,580,259,321,585,254,331,868,419,429,559,238,286
060170307102,824,292,532,839,287,552,1069,455,597,468,172,274
060170307103,843,307,536,854,300,554,1296,567,713,1001,368,579
060170307061,978,434,544,991,433,558,1217,574,603,1160,494,579
060170318001,376,166,210,386,167,219,464,240,216,353,170,161
060170318002,1004,450,554,1028,451,577,1618,815,767,1205,548,593
060170318004,478,211,267,487,211,276,454,222,224,430,187,220
060170308084,1039,365,674,1063,347,716,1332,562,741,1008,332,608
060170318003,998,463,535,1023,462,561,1429,694,699,1129,514,541
060170307101,1291,512,779,1310,512,798,1723,756,933,1303,520,691
060170308072,977,377,600,1001,371,630,1385,581,775,1123,429,596
060170308082,822,299,523,834,281,553,1123,437,663,894,309,523
060170308101,254,115,139,259,110,149,571,251,300,474,169,262
060170308103,577,237,340,587,228,359,647,275,351,530,190,292
060170308102,544,182,362,549,178,371,682,264,403,545,197,322
060170308081,497,197,300,503,185,318,721,294,406,570,208,309
060170308083,943,379,564,955,360,595,1319,561,735,1037,398,559
060170314071,623,242,381,630,230,400,727,268,446,617,206,369
060170314082,801,313,488,816,304,512,1003,391,585,911,327,514
060170314092,511,147,364,515,137,378,485,153,320,612,187,380
060170314093,415,163,252,430,160,270,426,173,244,426,159,247
060170307113,919,424,495,939,430,509,1300,593,676,1523,649,765
060170307122,390,181,209,397,182,215,719,379,333,56,27,27
060170307121,650,173,477,664,173,491,646,188,439,653,173,434
060170307123,1065,468,597,1082,467,615,1759,785,945,483,158,298
060170315032,1035,336,699,1052,325,727,1465,478,960,1264,399,773
060170308071,861,362,499,878,349,529,1227,523,671,932,381,482
060170308121,1170,454,716,1201,458,743,1290,533,721,1041,398,570
060170308091,426,158,268,424,152,272,559,215,330,449,150,260
060170308092,743,291,452,749,279,470,983,399,556,792,290,440
060170314081,317,120,197,326,119,207,456,175,264,314,97,195
060170314091,235,65,170,235,62,173,322,97,216,290,84,188
060170315043,719,260,459,727,250,477,760,262,477,641,196,398
060170308041,854,245,609,870,241,629,1074,341,707,821,231,546
060170308044,681,226,455,698,216,482,781,253,506,727,230,451
060170314061,385,132,253,389,127,262,499,181,306,394,120,245
060170314062,577,226,351,589,222,367,830,309,493,649,233,366
060170314065,548,196,352,559,191,368,712,273,425,548,181,326
060170314063,442,155,287,444,147,297,565,213,336,469,148,287
060170314064,586,221,365,595,213,382,828,329,479,662,232,371
060170314041,852,287,565,862,275,587,1030,317,696,889,281,550
060170314042,453,144,309,454,137,317,608,217,378,484,137,310
060170308042,659,224,435,678,219,459,864,300,541,654,208,399
060170308043,1300,441,859,1331,437,894,1642,591,1013,1406,473,831
060170310001,294,148,146,297,146,151,355,181,163,262,122,117
060170310003,976,475,501,997,459,538,1281,620,629,1083,475,515
060170310004,729,319,410,743,304,439,961,443,491,749,305,395
060170312001,996,421,575,1011,414,597,1238,566,655,1008,384,558
060170311001,637,327,310,648,310,338,875,442,409,673,310,307
060170311004,438,217,221,445,208,237,576,277,284,549,247,257
060170311002,463,232,231,473,232,241,571,293,260,535,248,237
060170311003,956,386,570,969,368,601,1043,425,594,875,344,474
060170312004,327,164,163,333,164,169,416,218,186,434,192,209
060170312003,265,133,132,269,130,139,399,206,183,379,163,181
060170312002,766,369,397,776,368,408,1032,483,519,706,296,359
060170314052,409,144,265,412,137,275,578,211,356,393,127,239
060170315061,760,264,496,768,248,520,886,305,563,875,284,529
060170315051,717,261,456,731,250,481,834,286,528,733,247,435
060170315052,392,134,258,398,134,264,524,187,328,481,152,291
060170315053,448,149,299,458,150,308,660,211,435,525,174,314
060170315062,516,190,326,527,177,350,704,261,433,487,175,283
060170315042,313,110,203,318,106,212,564,196,359,417,131,260
060170315044,789,280,509,805,269,536,1128,422,685,885,293,525
060170315031,503,163,340,508,156,352,531,172,352,405,123,254
060170315041,725,264,461,739,258,481,882,345,515,770,243,466
060170310002,746,305,441,763,301,462,861,366,476,712,265,399
060170313013,671,262,409,686,254,432,841,322,500,724,270,406
060170309022,724,249,475,738,245,493,920,338,561,723,235,444
060170313011,595,244,351,610,228,382,642,242,383,554,199,315
060170313012,479,189,290,491,183,308,770,310,446,572,202,335
060170313022,663,255,408,679,253,426,886,334,527,767,283,435
060170314051,855,332,523,865,308,557,1034,396,607,946,313,552
060170313024,471,191,280,474,182,292,688,277,390,515,181,294
060170313023,324,130,194,325,125,200,522,198,307,466,167,264
060170306033,705,241,464,722,236,486,937,344,575,746,218,467
060170308123,658,220,438,667,208,459,1051,380,640,836,287,504
060170308111,762,278,484,783,272,511,1259,529,696,990,330,579
060170308122,1176,337,839,1190,324,866,1416,480,899,1221,369,784
060170308011,1426,477,949,1453,461,992,1654,548,1062,1447,452,891
060170308012,777,249,528,788,242,546,1086,406,650,893,293,537
060170309021,1096,337,759,1120,330,790,1414,492,896,1239,412,750
060170306014,825,328,497,836,320,516,1166,471,669,800,304,443
060170306013,693,277,416,701,270,431,741,296,435,695,270,377
060170306011,616,209,407,630,203,427,907,307,577,816,251,512
060170306012,622,232,390,638,232,406,746,272,459,575,188,350
060170306063,732,292,440,745,281,464,791,311,464,672,240,389
060170306041,441,130,311,441,123,318,446,139,299,410,107,267
060170306062,711,236,475,726,217,509,819,270,534,710,216,438
060170306051,478,167,311,488,158,330,538,175,353,426,136,256
060170306031,321,100,221,328,93,235,467,142,312,375,108,236
060170306032,480,196,284,491,198,293,592,233,346,570,209,321
060170306061,609,240,369,619,235,384,931,387,524,714,261,397
060170306052,435,164,271,442,160,282,564,225,322,463,164,265
060170309011,964,378,586,985,368,617,1452,606,818,1237,452,706
060170309012,646,248,398,659,243,416,650,259,383,634,219,372
060170309023,828,294,534,845,287,558,916,354,542,890,302,521
060170304022,266,176,90,269,176,93,346,230,105,277,156,100
060170305041,589,369,220,600,369,231,693,440,228,651,370,229
060170305042,366,229,137,371,229,142,444,280,150,400,226,142
060170303013,217,151,66,227,155,72,320,221,97,269,167,81
060170305043,401,255,146,410,258,152,621,409,199,395,226,141
060170305071,258,164,94,261,167,94,334,222,105,334,195,105
060170302022,161,103,58,164,106,58,317,221,84,201,125,65
060170302021,251,161,90,256,166,90,276,183,86,252,154,82
060170302011,232,159,73,241,164,77,312,202,103,240,158,66
060170302012,242,163,79,244,162,82,302,203,91,237,149,71
060170302023,182,119,63,187,123,64,209,134,70,206,124,66
060170303012,309,210,99,313,214,99,526,357,153,397,242,118
060170316021,219,152,67,222,152,70,358,245,107,213,131,60
060170316022,144,96,48,148,99,49,244,173,64,170,105,53
060170305061,486,308,178,491,312,179,688,456,222,433,251,138
060170305072,289,182,107,296,188,108,455,306,142,348,185,123
060170305073,198,126,72,203,128,75,349,230,106,240,141,77
060170304042,398,230,168,410,234,176,538,324,199,336,169,144
060170304041,259,152,107,268,156,112,401,260,130,227,124,83
060170304021,314,207,107,319,207,112,427,286,134,268,157,86
060170304023,194,127,67,199,129,70,305,197,97,210,131,63
060170304024,356,233,123,368,238,130,512,339,162,369,222,118
060170304025,204,134,70,208,135,73,338,222,105,237,138,79
060170305024,268,179,89,272,180,92,328,237,85,246,154,73
060170303011,289,203,86,301,208,93,361,249,108,319,194,95
060170303021,285,198,87,289,199,90,375,252,108,328,200,98
060170304032,205,117,88,211,119,92,240,139,93,187,90,82
060170304033,237,136,101,244,137,107,241,140,93,186,91,83
060170304031,323,183,140,332,185,147,390,247,136,249,144,84
060170304043,207,123,84,211,123,88,303,202,92,204,120,61
060170320022,59,39,20,59,39,20,4,3,1,55,40,14
060170303022,301,207,94,308,213,95,398,275,110,333,205,102
060170303023,258,178,80,271,189,82,335,233,93,219,138,61
060170303024,201,141,60,204,143,61,316,221,89,253,156,78
060170302013,122,86,36,123,86,37,293,204,82,168,113,41
060170316013,127,91,36,129,89,40,176,117,56,83,53,24
060170316012,82,56,26,80,56,24,182,133,45,149,91,41
060170316011,196,138,58,199,137,62,249,182,61,245,160,61
060170305021,442,295,147,454,300,154,556,393,151,466,287,142
060170305022,286,192,94,291,193,98,397,284,107,319,199,98
060170305023,432,284,148,440,292,148,560,381,160,452,271,146
060170320021,85,59,26,85,60,25,160,114,42,89,55,27
060170313021,426,176,250,426,166,260,460,185,265,458,162,262
060170306034,81,37,44,83,39,44,70,31,39,57,24,27
060170319001,46,20,26,49,22,27,75,38,36,37,17,18
060170320011,345,234,111,351,237,114,434,295,129,361,216,108
060910100004,377,135,242,383,128,255,458,168,276,418,133,245
060910100003,381,170,211,378,146,232,422,185,214,418,137,228
060910100005,263,85,178,267,80,187,461,162,289,394,118,251
060910100001,355,134,221,366,138,228,313,123,182,351,141,190
060910100002,267,109,158,273,107,166,276,92,181,223,72,134
060530007014,70,62,8,71,61,10,126,107,17,104,95,6
060530007022,69,60,9,68,59,9,198,169,26,163,148,10
060530106072,271,235,36,270,226,44,317,261,52,237,207,21
060530106071,120,107,13,121,104,17,232,196,31,187,171,11
060530106081,64,57,7,64,55,9,160,135,21,114,104,7
060530106082,166,138,28,167,135,32,479,363,111,326,253,60
060530007013,119,100,19,119,96,23,269,209,52,210,180,22
060530007012,136,122,14,137,117,20,413,343,57,296,261,23
060530106041,545,448,97,548,440,108,807,601,192,563,470,70
060530106043,277,232,45,277,225,52,390,308,77,287,246,31
060530007011,171,157,14,171,153,18,297,253,41,237,210,15
060530106052,356,300,56,359,295,64,664,536,117,526,444,62
060530106051,384,331,53,385,321,64,569,463,94,458,385,52
060530009001,224,198,26,225,188,37,296,244,47,231,198,18
060530009002,88,78,10,87,74,13,222,182,35,197,171,16
060530006002,131,111,20,127,105,22,204,171,33,153,132,18
060530006003,207,183,24,209,178,31,392,324,61,297,259,29
060530008002,251,207,44,256,202,54,332,267,58,247,208,30
060530006004,150,138,12,151,137,14,214,181,32,139,131,6
060530007021,116,108,8,118,106,12,297,246,44,216,196,11
060530007023,202,187,15,203,183,20,379,311,56,263,237,14
060530012001,771,457,314,768,443,325,1041,657,364,850,501,293
060530012002,472,289,183,473,285,188,599,391,202,476,288,154
060530013002,248,174,74,249,169,80,357,251,93,314,218,72
060530013001,176,133,43,178,130,48,335,244,84,287,213,54
060530145001,300,186,114,303,183,120,405,264,134,347,222,102
060530018022,204,164,40,204,160,44,499,367,117,362,276,65
060530018021,356,285,71,357,279,78,446,327,102,380,287,67
060530002001,326,236,90,328,228,100,644,436,189,523,376,119
060530002002,376,272,104,380,264,116,442,303,132,333,245,77
060530002003,359,258,101,357,256,101,404,296,103,471,345,99
060530002004,320,231,89,321,224,97,476,384,85,430,305,96
060530004001,172,139,33,171,136,35,354,270,77,322,253,52
060530004004,255,207,48,259,205,54,303,234,65,242,189,40
060530004003,95,72,23,94,70,24,102,78,22,112,84,21
060530005022,355,298,57,357,285,72,411,334,71,285,236,35
060530005021,375,322,53,376,305,71,579,478,91,404,333,48
060530006001,244,211,33,245,201,44,473,389,76,373,309,44
060530005013,146,117,29,146,111,35,293,232,60,227,188,32
060530005012,74,59,15,77,58,19,198,149,39,146,118,19
060530005011,177,141,36,178,136,42,343,267,66,290,238,39
060530001032,319,224,95,324,218,106,453,325,122,435,314,106
060530001033,223,140,83,223,135,88,88,64,24,197,140,47
060530001031,407,287,120,406,275,131,922,620,283,529,379,127
060530004002,430,316,114,433,303,130,602,440,146,445,318,95
060530004005,196,143,53,196,139,57,454,333,110,342,245,72
060530018023,394,313,81,396,314,82,609,469,125,488,379,83
060530001062,449,329,120,455,322,133,754,539,204,556,409,116
060530001061,432,324,108,434,312,122,841,614,205,695,518,131
060530001063,453,334,119,453,320,133,699,503,188,565,416,117
060530001052,379,283,96,381,274,107,492,362,118,338,252,63
060530003001,545,382,163,551,371,180,808,569,216,682,450,186
060530003002,522,364,158,524,353,171,820,557,244,634,422,172
060530101012,97,85,12,97,86,11,166,139,25,124,106,10
060530101011,255,205,50,255,203,52,429,340,85,324,258,44
060530101021,501,343,158,506,334,172,695,458,218,464,317,118
060530146011,487,341,146,491,329,162,788,620,158,695,486,167
060530146012,473,334,139,477,327,150,510,372,126,388,278,89
060530146013,300,212,88,302,207,95,453,340,100,374,263,87
060530101013,157,107,50,158,104,54,338,237,90,279,194,64
060530102021,361,249,112,360,241,119,438,312,114,354,245,86
060530101022,731,425,306,738,414,324,935,574,335,808,463,286
060530102022,458,280,178,461,278,183,887,561,306,679,403,229
060530102023,585,336,249,595,333,262,787,483,285,656,374,233
060530147001,329,216,113,330,211,119,451,306,135,417,261,126
060530147002,808,500,308,812,496,316,838,548,266,769,469,257
060530147003,440,270,170,444,263,181,786,494,280,651,377,229
060530147004,588,377,211,592,371,221,1054,712,320,850,535,264
060530103051,652,388,264,659,387,272,881,538,320,669,385,238
060530103052,820,462,358,831,462,369,1003,599,377,883,496,322
060530104001,273,230,43,270,221,49,377,294,74,445,383,48
060530104002,268,230,38,269,221,48,564,458,96,391,337,43
060530104003,203,172,31,209,170,39,405,318,83,160,121,33
060530104004,196,167,29,199,164,35,444,359,76,374,321,37
060530103061,393,210,183,401,206,195,488,278,200,449,238,182
060530105011,445,258,187,450,243,207,752,432,307,548,288,217
060530105013,1751,861,890,1754,849,905,2288,1200,1046,1518,733,685
060530105012,395,188,207,398,186,212,600,324,258,887,443,386
060530103053,297,163,134,300,163,137,424,255,161,359,203,131
060530001013,314,190,124,316,184,132,423,267,150,332,212,102
060530001012,288,174,114,296,173,123,482,304,169,343,218,106
060530106061,703,398,305,710,405,305,908,546,346,760,459,270
060530018011,321,239,82,322,236,86,575,433,129,437,326,87
060530105043,232,166,66,235,164,71,372,268,96,269,205,49
060530105044,16,13,3,16,13,3,14,11,3,25,19,6
060530106042,424,345,79,428,341,87,614,467,138,496,406,68
060530018012,783,533,250,789,536,253,1067,773,269,898,607,243
060530105052,269,199,70,271,192,79,329,252,69,257,186,52
060530105053,260,192,68,261,184,77,325,251,69,257,191,53
060530105063,104,77,27,104,73,31,227,173,48,183,134,37
060530105062,159,118,41,160,113,47,404,310,85,304,222,62
060530105051,447,327,120,450,316,134,575,396,165,472,337,100
060530105061,268,197,71,268,188,80,627,429,186,528,365,128
060530105042,378,288,90,380,277,103,409,315,85,332,248,61
060530105041,351,268,83,353,259,94,805,619,168,659,493,120
060530001051,625,446,179,628,427,201,975,700,259,759,573,158
060530001042,648,459,189,650,443,207,737,524,204,666,458,167
060530001041,576,409,167,581,397,184,875,616,242,651,445,166
060530106033,770,554,216,775,549,226,931,685,230,876,632,199
060530106031,299,218,81,299,215,84,645,484,149,291,210,65
060530106032,806,600,206,805,585,220,1273,916,329,1015,738,216
060530106034,402,276,126,400,276,124,753,529,208,558,378,147
060530008001,277,233,44,277,224,53,318,259,55,330,280,36
060530008003,190,160,30,189,154,35,350,284,57,420,353,44
060530009003,277,219,58,280,211,69,514,402,99,397,327,51
060539800001,0,0,0,0,0,0,3,2,1,2,1,1
060530106063,477,408,69,477,394,83,1201,947,237,371,311,43
060530106062,367,314,53,365,301,64,495,404,80,549,465,57
060530108042,157,64,93,157,62,95,141,70,70,156,72,76
060530148001,222,132,90,224,127,97,384,227,152,308,180,117
060530148002,222,145,77,225,143,82,425,278,141,322,211,100
060530108044,280,218,62,279,211,68,399,304,85,329,268,46
060530108041,200,154,46,202,151,51,350,268,80,270,219,44
060530148003,385,300,85,388,294,94,536,406,112,376,300,53
060530148004,442,339,103,443,331,112,650,477,157,537,418,91
060530108043,315,240,75,313,233,80,626,449,167,490,386,88
060530111031,185,159,26,185,154,31,306,237,58,244,206,22
060530111061,346,267,79,345,258,87,701,510,178,424,322,77
060530111032,514,431,83,522,417,105,617,485,122,462,393,42
060530111052,532,417,115,532,393,139,731,534,175,596,467,90
060530111042,372,292,80,373,281,92,465,353,104,287,228,48
060530111051,627,504,123,633,489,144,1441,1073,330,798,635,117
060530111041,557,441,116,564,427,137,328,255,70,153,120,27
060530109001,30,17,13,32,16,16,823,629,172,741,579,126
060530112024,261,204,57,258,196,62,284,218,60,180,140,36
060530112021,492,380,112,497,372,125,764,585,159,620,467,113
060530112031,265,217,48,265,202,63,362,292,65,307,257,39
060530112032,307,251,56,310,238,72,598,475,107,477,388,62
060530112033,400,326,74,400,310,90,517,414,92,487,394,64
060530112042,379,307,72,381,289,92,599,459,120,392,316,56
060530112022,279,230,49,278,216,62,423,342,74,368,305,47
060530112023,144,118,26,142,111,31,183,148,31,152,125,20
060530112043,38,31,7,38,29,9,116,90,20,62,50,8
060530113033,347,147,200,349,137,212,416,185,219,340,151,162
060530113032,517,219,298,520,206,314,756,346,383,636,285,300
060530114001,704,161,543,711,165,546,917,249,653,733,189,509
060530114002,499,222,277,500,215,285,630,244,369,579,202,335
060530113021,198,136,62,200,131,69,304,201,96,326,227,81
060530113022,148,97,51,148,94,54,301,191,102,129,92,32
060530113052,0,0,0,0,0,0,0,0,0,0,0,0
060530113053,3,2,1,3,2,1,0,0,0,1,1,0
060530113051,151,101,50,153,100,53,127,73,54,161,85,65
060530113054,375,264,111,372,255,117,759,510,230,220,160,54
060530113023,328,186,142,331,181,150,329,209,114,490,340,122
060530113061,185,143,42,186,139,47,466,342,110,536,366,133
060530113062,138,103,35,138,98,40,202,140,55,164,113,40
060530113031,131,66,65,130,62,68,207,123,77,230,159,57
060530134001,824,547,277,838,551,287,1085,721,339,918,593,258
060530133001,647,465,182,655,452,203,850,603,220,662,452,155
060530141041,65,59,6,66,60,6,7,6,1,97,82,6
060530141081,1036,697,339,1048,688,360,1503,1017,426,1080,673,303
060530141092,329,219,110,333,215,118,343,238,99,248,153,68
060530141091,226,150,76,228,148,80,470,324,134,337,207,94
060530135001,326,244,82,335,246,89,395,294,91,348,261,69
060530135002,535,359,176,543,359,184,722,492,206,481,313,136
060530135003,748,553,195,768,556,212,1102,815,263,880,644,181
060530137003,185,137,48,187,137,50,546,401,124,444,318,96
060530138002,724,584,140,730,580,150,927,746,162,662,530,96
060530139001,545,408,137,553,407,146,721,543,166,534,400,103
060530139002,332,247,85,337,247,90,479,360,109,398,290,82
060530138001,492,369,123,497,364,133,759,564,168,562,424,104
060530136002,313,224,89,314,221,93,446,329,106,357,260,74
060530137001,245,188,57,248,188,60,345,264,73,259,203,40
060530137002,265,203,62,267,203,64,506,390,104,363,285,60
060530140001,403,277,126,411,283,128,649,450,186,486,339,113
060530138003,411,348,63,411,343,68,660,544,99,435,370,46
060530140002,253,187,66,256,184,72,392,273,102,247,184,50
060530136003,153,104,49,155,103,52,398,276,113,307,208,81
060530136001,508,347,161,512,341,171,631,439,178,477,324,130
060530141021,2,1,1,2,1,1,9,6,3,1,1,0
060530143012,574,381,193,585,381,204,735,478,237,648,419,192
060530143022,536,354,182,548,354,194,844,551,265,645,419,190
060530143021,912,629,283,921,604,317,1258,898,334,977,645,275
060530143011,707,498,209,712,493,219,1119,813,269,900,592,235
060530142013,593,423,170,600,413,187,1051,761,262,631,447,130
060530142021,280,200,80,286,197,89,570,396,160,385,272,80
060530142011,499,340,159,507,337,170,515,369,134,521,340,146
060530142012,573,397,176,582,390,192,823,564,235,629,410,177
060530142022,931,639,292,942,627,315,1229,850,349,1109,725,312
060530141022,873,658,215,881,651,230,1123,785,297,753,549,142
060530141023,19,14,5,18,13,5,580,423,147,56,41,11
060530141053,835,734,101,840,714,126,1025,880,112,885,719,99
060530141051,148,130,18,149,127,22,164,141,18,229,184,26
060530014001,503,330,173,506,323,183,579,396,170,552,368,144
060530017001,537,360,177,540,358,182,770,526,222,690,459,180
060530017002,519,351,168,525,348,177,842,575,246,659,439,174
060530014002,414,272,142,420,269,151,619,382,221,453,300,117
060530016001,639,374,265,649,371,278,931,568,333,774,431,290
060530016002,446,261,185,453,258,195,603,374,215,511,287,191
060530015002,641,335,306,653,349,304,894,524,356,715,384,283
060530015003,859,477,382,869,484,385,1108,688,390,972,548,353
060530015001,755,454,301,770,456,314,1150,774,350,953,574,305
060530145002,728,412,316,734,396,338,991,587,382,854,487,311
060530145003,646,349,297,650,341,309,710,427,275,628,350,247
060530125031,573,424,149,580,429,151,672,513,154,584,419,124
060530125032,372,274,98,377,279,98,447,338,107,359,259,77
060530121002,605,437,168,615,437,178,702,523,157,603,429,141
060530125033,244,179,65,245,181,64,389,286,87,310,220,66
060530126011,64,42,22,67,43,24,240,155,73,115,67,31
060530125042,423,323,100,427,315,112,710,537,145,482,344,107
060530125041,577,439,138,582,428,154,738,570,153,656,466,147
060530127001,291,223,68,297,222,75,392,302,79,360,266,74
060530127002,409,292,117,414,294,120,502,379,119,289,209,70
060530127003,453,347,106,456,342,114,584,460,122,447,329,94
060530127004,499,383,116,507,378,129,660,509,133,569,416,116
060530128002,795,544,251,802,545,257,947,686,238,793,539,209
060530130001,281,196,85,283,195,88,399,302,86,390,269,95
060530133002,436,310,126,437,303,134,644,446,177,495,334,122
060530133003,555,398,157,561,388,173,940,658,249,803,548,191
060530133004,313,223,90,315,220,95,401,282,113,314,215,80
060530132001,1325,643,682,1335,632,703,1719,979,707,1474,747,637
060530132002,1199,733,466,1215,732,483,1444,955,468,1237,775,397
060530128003,635,435,200,647,438,209,743,538,187,623,422,167
060530128005,403,277,126,407,278,129,456,335,110,410,279,109
060530128001,635,439,196,649,441,208,819,599,209,766,522,204
060530128004,375,264,111,379,265,114,389,288,92,475,327,117
060530130004,614,429,185,625,433,192,908,609,282,646,446,158
060530130003,0,0,0,0,0,0,9,6,3,3,2,1
060530130002,347,242,105,355,245,110,480,361,104,448,311,109
060530124023,603,426,177,616,431,185,694,523,157,572,407,133
060530124021,344,237,107,348,237,111,368,273,90,359,249,86
060530124022,705,494,211,718,497,221,898,666,211,785,546,185
060530121001,529,379,150,540,389,151,676,507,145,524,369,121
060530122002,483,352,131,495,360,135,604,473,129,506,372,118
060530123021,570,423,147,589,433,156,703,555,139,582,428,117
060530123022,421,310,111,431,315,116,534,410,115,462,328,98
060530124011,547,404,143,556,411,145,734,567,147,628,452,126
060530124012,334,245,89,337,247,90,406,316,87,335,245,72
060530122001,916,684,232,931,697,234,1096,862,217,915,684,183
060530120002,683,488,195,689,481,208,1008,740,246,809,553,206
060530120001,912,677,235,937,678,259,1123,880,225,1012,740,220
060530119011,376,192,184,383,199,184,444,272,159,402,225,151
060530119022,502,257,245,509,264,245,578,356,208,518,290,197
060530119012,322,159,163,322,155,167,490,280,202,421,218,181
060530119021,594,304,290,609,319,290,698,438,253,646,366,248
060530119013,656,322,334,661,320,341,695,394,287,600,307,259
060530118012,1057,685,372,1093,724,369,686,473,203,612,394,178
060530117002,834,530,304,852,541,311,1245,868,348,1126,737,331
060530118011,3,2,1,3,2,1,593,409,172,508,330,149
060530117003,1425,881,544,1460,903,557,663,458,193,620,409,189
060530118021,125,75,50,130,79,51,604,412,179,580,359,184
060530116051,966,626,340,981,631,350,705,473,220,598,392,182
060530117001,665,429,236,672,432,240,987,688,285,877,569,262
060530118022,0,0,0,0,0,0,514,352,157,477,302,151
060530116052,739,447,292,748,449,299,1146,757,373,1068,650,354
060530116041,1140,683,457,1157,691,466,1023,705,300,876,573,271
060530116062,594,346,248,602,347,255,1248,819,412,1101,650,375
060530110021,1266,890,376,1287,892,395,1088,766,299,843,544,247
060530116061,568,338,230,570,332,238,620,394,218,510,300,180
060530110011,916,631,285,933,638,295,1181,851,304,994,677,248
060530110012,735,486,249,752,492,260,691,486,194,637,423,177
060530110013,404,288,116,409,289,120,751,558,175,710,492,172
060530115021,214,175,39,216,174,42,847,697,115,739,541,101
060530110022,473,322,151,479,320,159,551,354,188,494,308,151
060530111011,284,111,173,286,106,180,276,116,155,301,131,151
060530141101,1113,496,617,1123,500,623,1329,652,644,1097,493,524
060530107021,1193,539,654,1199,544,655,1166,605,532,1022,486,462
060530107022,1038,501,537,1056,513,543,1576,854,693,1464,740,632
060530141102,1491,722,769,1505,719,786,2019,1085,890,1671,869,695
060530141103,784,362,422,795,362,433,938,473,442,762,356,367
060530141104,386,178,208,392,178,214,497,249,234,399,187,193
060530001011,0,0,0,0,0,0,1,0,1,2,0,2
060530018013,13,8,5,14,8,6,22,14,8,16,10,5
060530112041,115,55,60,116,53,63,205,99,100,148,76,69
060530141052,648,429,219,659,428,231,543,376,153,0,0,0
060530131002,50,32,18,50,31,19,51,32,17,37,19,12
060530131001,21,13,8,21,13,8,45,28,15,35,17,12
060530116042,420,269,151,422,272,150,378,262,110,359,243,101
060411081001,1768,1440,328,1810,1442,368,2297,1884,367,1664,1313,256
060411150002,1043,802,241,1079,822,257,1200,1000,178,1097,860,192
060411081004,704,597,107,713,592,121,776,646,115,773,645,98
060411081002,696,563,133,713,565,148,849,704,126,776,623,120
060411082021,833,645,188,857,654,203,1093,908,160,1130,862,202
060411082023,676,515,161,696,518,178,835,677,141,505,377,109
060411081003,741,568,173,759,572,187,599,487,101,1007,768,184
060411060012,1082,864,218,1112,883,229,1224,1011,185,1304,1016,207
060411060022,954,784,170,975,798,177,1157,957,181,968,759,141
060411060023,630,511,119,652,529,123,488,400,80,499,394,76
060411082011,291,236,55,297,239,58,320,268,47,363,291,56
060411082012,652,526,126,665,536,129,918,750,156,721,588,95
060411082022,477,353,124,487,360,127,624,506,106,508,373,98
060411090021,906,777,129,927,784,143,1004,848,133,918,757,112
060411150001,1156,989,167,1184,1012,172,1360,1178,157,1192,1001,136
060411060011,624,488,136,645,503,142,936,743,175,707,557,121
060411090022,1029,881,148,1055,893,162,1247,1056,165,1278,1055,150
060411170001,722,626,96,739,642,97,856,746,97,763,651,85
060411090023,371,309,62,377,312,65,393,335,50,368,293,54
060411110023,982,853,129,1008,872,136,1090,968,108,975,817,106
060411170002,420,362,58,433,373,60,533,465,60,492,420,54
060411181001,458,326,132,478,349,129,505,398,97,452,324,97
060411090012,651,518,133,660,526,134,659,558,84,660,515,110
060411090011,488,418,70,502,426,76,671,579,77,614,508,70
060411090013,556,476,80,566,481,85,747,632,101,628,513,70
060411110011,458,398,60,465,402,63,701,603,89,531,432,63
060411101001,967,742,225,998,768,230,1027,819,182,933,707,183
060411102002,648,460,188,667,472,195,796,615,176,642,457,151
060411102003,1264,902,362,1295,920,375,1477,1135,321,1275,909,299
060411102001,1557,1105,452,1598,1148,450,1789,1379,387,1648,1201,367
060411110022,371,326,45,379,331,48,709,612,88,402,329,45
060411101002,1028,796,232,1053,809,244,1230,977,228,1156,871,232
060411101003,686,562,124,700,577,123,850,712,118,810,672,100
060411101004,242,199,43,244,202,42,385,326,52,314,244,52
060411070002,512,411,101,527,423,104,502,420,76,470,374,73
060411070003,522,420,102,536,426,110,660,553,102,393,328,49
060411070004,820,660,160,847,677,170,958,799,148,836,667,133
060411070001,848,667,181,870,680,190,1029,853,162,899,704,145
060411070005,869,691,178,894,703,191,1113,905,188,1328,993,253
060411060021,1025,852,173,1053,860,193,1613,1342,241,1372,1102,196
060411141001,1250,1147,103,1271,1162,109,1501,1384,85,1353,1167,92
060411141002,1054,955,99,1071,966,105,1102,981,98,1029,875,82
060411141003,980,878,102,993,888,105,1159,1039,104,919,791,70
060411142002,641,566,75,654,582,72,859,762,79,752,623,69
060411160001,989,866,123,1006,883,123,1103,972,109,998,862,84
060411142001,1182,1049,133,1194,1055,139,1434,1272,135,1393,1173,131
060411191005,656,480,176,687,518,169,679,550,118,618,481,104
060411200011,657,544,113,680,563,117,915,784,116,865,706,116
060411200023,996,820,176,1024,843,181,1246,1056,168,972,785,131
060411200021,763,625,138,777,635,142,893,760,119,676,546,92
060411200022,651,535,116,671,554,117,690,584,96,624,506,84
060411192012,965,785,180,997,812,185,1421,1189,212,983,778,154
060411192011,843,694,149,872,725,147,853,720,120,1152,938,165
060411200024,650,514,136,670,522,148,907,751,139,932,740,137
060411192021,980,747,233,1017,785,232,1187,984,184,945,732,165
060411121004,552,469,83,557,472,85,680,592,82,630,500,91
060411192022,1012,774,238,1054,819,235,1211,992,193,981,765,161
060411181002,809,566,243,845,610,235,1014,803,192,940,686,181
060411191002,605,495,110,623,511,112,766,621,131,658,536,90
060411191004,639,457,182,672,497,175,821,666,141,737,572,127
060411150004,1013,878,135,1040,905,135,1221,1075,126,1161,1005,106
060411150003,1139,971,168,1172,999,173,1310,1148,138,1226,1014,139
060411160002,867,754,113,884,766,118,1017,896,104,948,826,80
060411170003,831,714,117,847,726,121,1087,947,121,933,791,94
060411170004,683,598,85,695,605,90,826,719,91,735,609,77
060411191001,332,259,73,344,272,72,461,377,75,422,325,74
060411110021,787,684,103,808,701,107,1098,950,127,914,767,90
060411121001,166,142,24,168,143,25,289,240,46,274,225,32
060411121002,656,560,96,659,562,97,585,501,76,635,507,89
060411121003,607,515,92,615,522,93,554,481,60,598,512,51
060411311001,604,536,68,611,539,72,721,654,61,642,559,48
060411191003,463,359,104,480,377,103,587,477,95,558,431,96
060411230001,472,311,161,492,327,165,547,409,126,457,326,106
060411230002,771,510,261,805,537,268,854,641,195,798,567,187
060411261004,524,461,63,542,478,64,620,566,48,561,494,45
060411261005,553,481,72,567,498,69,656,593,53,605,534,42
060411270005,685,599,86,707,623,84,751,678,59,746,657,54
060411270002,357,313,44,368,317,51,438,398,36,340,296,30
060411270003,507,446,61,516,458,58,541,490,42,481,420,31
060411270004,566,501,65,584,519,65,681,615,54,620,543,41
060411282001,353,296,57,362,306,56,427,381,37,407,352,32
060411270001,690,594,96,705,604,101,867,788,68,735,640,65
060411261001,902,780,122,924,796,128,1052,949,83,949,832,84
060411261003,629,548,81,641,558,83,801,727,62,706,617,52
060411261002,791,689,102,811,706,105,1007,901,94,902,791,74
060411262001,1113,950,163,1132,963,169,1344,1214,114,1204,1057,100
060411262002,1057,906,151,1079,926,153,1198,1059,123,1129,960,123
060411262003,351,294,57,356,297,59,479,425,49,389,330,47
060411282003,1113,959,154,1148,975,173,1401,1243,128,1169,994,113
060411302031,982,816,166,1013,832,181,1304,1119,162,987,801,140
060411302043,573,482,91,592,493,99,763,653,98,652,542,77
060411302011,620,508,112,630,517,113,824,705,104,679,552,93
060411302012,703,559,144,713,564,149,873,732,124,721,557,120
060411302013,678,550,128,692,559,133,796,680,103,696,561,100
060411302041,469,411,58,478,418,60,553,478,66,768,654,80
060411302042,500,424,76,520,437,83,611,520,83,619,522,61
060411241002,697,482,215,723,499,224,815,625,177,691,496,158
060411241001,383,301,82,396,310,86,472,394,69,484,376,79
060411241003,404,296,108,419,309,110,484,390,82,507,382,95
060411241005,1148,872,276,1202,923,279,1283,1039,211,1170,914,183
060411242002,505,372,133,524,387,137,1260,965,270,538,390,112
060411242003,732,529,203,755,545,210,772,606,153,559,402,122
060411242004,996,764,232,1030,793,237,1045,824,199,1422,1047,278
060411242001,932,680,252,963,704,259,1052,828,204,810,588,174
060411281002,1155,995,160,1188,1027,161,1236,1099,116,1517,1309,138
060411282002,1319,1165,154,1343,1188,155,1550,1381,136,1371,1208,97
060411281001,1199,1032,167,1236,1051,185,1459,1296,136,1251,1050,124
060411281003,1539,1355,184,1571,1368,203,1886,1667,185,1438,1231,135
060411290001,440,398,42,447,403,44,674,585,71,487,430,36
060411290002,458,414,44,465,419,46,732,638,78,637,561,50
060411250001,588,453,135,599,461,138,590,468,112,482,363,91
060411250003,741,605,136,761,613,148,1123,940,161,947,747,149
060411250002,636,480,156,653,495,158,778,613,152,700,525,132
060411211002,422,355,67,433,363,70,578,500,74,422,355,49
060411211003,635,533,102,657,549,108,872,748,108,673,568,77
060411211004,602,506,96,617,520,97,748,643,93,659,555,69
060411211005,466,400,66,481,413,68,486,418,60,474,403,34
060411211001,809,674,135,839,696,143,1043,895,130,790,662,96
060411212003,958,762,196,993,793,200,1106,946,138,1083,865,170
060411212004,432,347,85,451,364,87,549,471,66,402,324,56
060411212001,600,462,138,623,479,144,741,588,130,623,495,98
060411212002,758,611,147,772,615,157,857,708,133,600,472,95
060411212005,201,164,37,204,165,39,209,164,40,225,179,36
060411031002,968,641,327,987,642,345,1206,850,338,1224,813,338
060411031001,1099,752,347,1141,769,372,1413,1022,363,1067,740,272
060411031003,1176,796,380,1209,808,401,1420,1009,382,1244,845,322
060411031004,852,575,277,881,584,297,972,699,250,954,630,263
060411022023,997,691,306,1027,702,325,1149,828,297,1072,712,299
060411022024,385,280,105,397,282,115,583,420,150,457,330,99
060411122041,148,125,23,150,126,24,363,293,64,188,160,20
060411122042,110,93,17,110,93,17,452,363,80,146,123,16
060411122032,82,70,12,85,71,14,255,205,45,100,84,11
060411122031,55,47,8,57,48,9,227,182,40,105,89,11
060411122022,127,108,19,131,110,21,161,130,29,177,148,23
060411122021,722,593,129,728,582,146,344,278,61,537,439,72
060411122023,147,121,26,150,119,31,210,169,37,319,262,43
060411130003,1135,1040,95,1151,1048,103,1342,1173,142,1261,1066,89
060411322002,392,361,31,394,362,32,423,367,48,367,290,49
060411322003,121,99,22,124,98,26,223,170,44,199,151,39
060411330001,512,391,121,530,390,140,573,437,119,510,394,79
060411330004,354,327,27,359,328,31,513,439,56,409,314,62
060411330002,305,216,89,307,212,95,401,353,43,350,268,52
060411330003,280,201,79,293,199,94,488,426,56,433,335,66
060411130001,521,464,57,530,469,61,617,536,65,424,347,40
060411321002,900,838,62,915,843,72,985,905,58,858,731,44
060411321001,295,270,25,302,271,31,405,369,26,421,374,26
060411130002,734,633,101,750,638,112,769,668,80,714,563,87
060411322001,430,396,34,434,403,31,420,365,47,445,390,22
060411021001,1334,927,407,1371,939,432,1381,997,354,1519,1072,348
060411022021,847,582,265,872,588,284,979,705,251,1158,810,290
060411011001,1606,1094,512,1645,1122,523,1772,1268,465,1633,1082,467
060411022033,733,527,206,754,541,213,913,687,209,467,334,105
060411022022,713,517,196,732,526,206,1155,880,255,729,520,164
060411032001,431,332,99,442,327,115,704,508,180,553,409,110
060411032003,1311,891,420,1340,899,441,1656,1204,420,1553,1024,444
060411022031,524,409,115,533,407,126,802,628,157,643,483,114
060411022032,609,479,130,619,486,133,808,629,166,680,511,134
060411032004,324,236,88,335,240,95,349,276,64,323,239,61
060411032002,730,539,191,753,545,208,734,574,139,689,508,135
060411041031,854,645,209,873,641,232,960,714,228,665,487,140
060411012001,1369,943,426,1396,940,456,1899,1401,464,1551,1046,419
060411041022,432,331,101,441,328,113,530,414,110,503,374,98
060411041043,1147,829,318,1175,822,353,1197,894,276,1248,880,292
060411041021,917,698,219,943,702,241,1413,1053,334,947,709,186
060411041023,514,395,119,525,393,132,1000,742,236,588,443,114
060411041032,746,559,187,764,560,204,881,642,220,1124,805,246
060411041042,596,436,160,612,438,174,858,654,187,816,606,172
060411042001,851,614,237,875,633,242,1167,885,247,1098,778,251
060411042003,1057,649,408,1085,654,431,986,736,233,1144,729,362
060411041041,436,322,114,449,325,124,426,326,93,332,248,70
060411043001,1060,731,329,1093,751,342,1193,823,352,1134,766,306
060411050021,339,262,77,350,272,78,513,404,97,390,292,80
060411050022,1062,819,243,1084,830,254,1298,1022,255,1149,863,231
060411042002,872,682,190,892,696,196,939,755,168,876,664,174
060411050012,249,191,58,253,189,64,449,360,81,425,319,83
060411050011,264,205,59,268,204,64,268,214,48,344,260,67
060411050014,294,229,65,296,228,68,599,478,108,338,259,66
060411050013,335,267,68,339,266,73,390,309,71,180,140,34
060411241004,250,203,47,257,209,48,336,274,53,283,214,43
060411220001,17,13,4,17,13,4,127,92,30,191,131,46
061010507011,658,303,355,678,296,382,1001,451,535,695,316,336
061010507012,477,240,237,482,227,255,705,327,361,526,251,240
061010507024,258,138,120,260,132,128,483,251,227,354,189,148
061010507023,333,181,152,339,170,169,570,289,265,491,257,195
061010507021,680,313,367,697,299,398,1156,533,598,652,303,312
061010506031,286,110,176,291,110,181,315,127,181,276,92,173
061010506042,1243,455,788,1281,452,829,1420,536,860,1400,524,795
061010501015,593,221,372,617,222,395,798,326,457,528,179,317
061010501014,530,203,327,541,193,348,757,295,444,540,192,304
061010501011,276,104,172,285,103,182,599,250,326,551,192,320
061010501013,268,101,167,276,98,178,578,232,330,332,124,177
061010505034,311,152,159,326,155,171,419,216,195,326,159,150
061010505035,462,222,240,478,220,258,784,378,398,517,230,254
061010505043,304,148,156,316,147,169,458,237,214,346,159,167
061010501022,324,156,168,327,146,181,465,199,243,366,152,184
061010501023,250,121,129,255,111,144,565,241,308,363,163,177
061010502023,88,46,42,91,42,49,178,88,85,202,84,99
061010503023,100,59,41,101,54,47,257,131,113,173,99,61
061010503022,210,120,90,211,111,100,400,209,182,264,163,88
061010502022,197,86,111,200,80,120,319,140,172,192,82,96
061010503012,553,201,352,560,190,370,621,250,359,629,221,348
061010503024,385,158,227,393,143,250,391,174,204,356,138,185
061010503011,361,114,247,361,108,253,418,152,249,378,126,214
061010506011,513,149,364,529,143,386,699,216,469,597,186,379
061010508001,991,194,797,1017,185,832,1390,270,1098,1189,233,889
061010508002,497,99,398,505,89,416,686,142,531,605,130,444
061010510002,519,135,384,532,126,406,698,180,505,694,183,479
061010506012,796,244,552,818,229,589,967,338,611,971,327,594
061010505011,388,131,257,401,134,267,526,159,353,378,116,242
061010506013,573,248,325,593,238,355,956,404,536,602,254,321
061010509001,235,39,196,241,39,202,310,72,237,276,54,207
061010506014,542,210,332,557,199,358,735,273,448,584,228,329
061010501012,146,51,95,151,47,104,360,139,209,305,107,177
061010501021,423,158,265,430,151,279,570,219,331,524,200,290
061010506041,376,143,233,384,135,249,631,249,371,471,165,271
061010506032,503,157,346,509,144,365,652,242,401,344,109,219
061010506034,677,239,438,694,230,464,844,334,499,823,282,499
061010506033,743,273,470,765,260,505,890,352,529,485,174,281
061010505013,439,220,219,462,231,231,766,418,341,634,351,253
061010505014,161,84,77,170,87,83,229,124,101,242,130,97
061010505015,419,239,180,454,254,200,686,372,305,507,321,161
061010505031,356,115,241,365,111,254,434,143,279,322,99,210
061010505032,495,247,248,516,252,264,825,439,367,622,293,295
061010505033,703,351,352,742,366,376,1220,626,567,822,421,359
061010505041,728,353,375,762,364,398,968,454,497,708,334,338
061010505045,499,240,259,520,245,275,907,463,429,625,320,274
061010505044,540,277,263,573,290,283,793,391,390,676,365,286
061010505012,238,108,130,247,108,139,308,110,194,200,97,95
061010504022,297,89,208,306,80,226,379,122,247,275,98,166
061010504023,658,300,358,670,282,388,1065,518,527,734,321,363
061010505042,354,114,240,366,104,262,484,150,317,359,132,207
061010510001,249,74,175,254,70,184,389,125,260,320,107,197
061010504011,454,165,289,467,161,306,712,264,432,578,207,333
061010504021,517,135,382,528,128,400,624,213,397,561,152,374
061010504032,419,189,230,434,186,248,711,329,358,492,225,238
061010504012,342,136,206,352,132,220,484,191,284,387,139,220
061010504013,351,158,193,358,149,209,479,210,260,444,169,244
061010504014,406,183,223,414,178,236,558,271,277,445,207,213
061010504031,662,300,362,675,287,388,989,442,531,766,322,392
061010511002,240,51,189,250,52,198,361,90,262,300,72,217
061010511003,390,68,322,396,67,329,494,112,372,427,87,311
061010511001,391,90,301,404,87,317,371,80,284,366,87,256
061010507022,397,101,296,395,96,299,429,116,309,291,80,199
061010509002,185,59,126,190,58,132,321,72,244,200,57,132
061010502011,269,117,152,273,109,164,518,213,285,422,173,210
061010502021,175,78,97,178,75,103,255,115,133,180,88,79
061010503021,323,139,184,331,131,200,516,219,276,426,176,209
061010502012,313,142,171,315,132,183,483,214,255,372,181,169
061010502024,211,95,116,216,92,124,314,141,163,261,122,118
060730170592,1528,682,846,1556,695,861,1275,695,563,950,446,475
060730170601,856,380,476,878,382,496,1045,568,461,1024,469,527
060730170602,806,344,462,822,346,476,951,513,413,971,436,489
060730170591,850,402,448,871,404,467,1568,851,693,1205,584,564
060730170513,1060,501,559,1092,510,582,1384,787,568,932,482,409
060730170523,479,252,227,493,258,235,806,459,332,943,521,377
060730170524,495,258,237,512,266,246,847,482,348,558,294,236
060730170062,383,208,175,394,206,188,488,279,203,422,206,195
060730170511,576,326,250,589,321,268,878,498,360,569,307,234
060730170512,491,264,227,502,261,241,689,392,283,498,241,238
060730170521,689,371,318,707,375,332,1006,572,414,634,342,261
060730170522,343,187,156,353,189,164,581,331,238,391,209,164
060730170141,738,333,405,760,345,415,724,413,297,904,439,428
060730170142,913,441,472,934,447,487,846,486,351,1073,521,520
060730170572,439,215,224,452,213,239,606,318,277,775,360,368
060730170573,972,501,471,997,501,496,1225,702,498,829,426,359
060730170571,429,174,255,444,174,270,467,268,189,448,182,237
060730170581,512,287,225,522,288,234,887,509,361,636,341,256
060730170582,470,260,210,479,261,218,614,352,250,505,268,206
060730170583,682,361,321,699,354,345,863,508,335,572,297,246
060730170711,822,475,347,853,475,378,1287,790,457,900,490,342
060730170333,1382,788,594,1420,790,630,1807,1144,625,1202,700,436
060730170341,915,507,408,946,515,431,1180,724,420,656,360,259
060730170662,1477,814,663,1519,826,693,1240,742,473,1510,879,561
060730170633,973,553,420,1008,559,449,1668,1009,610,1350,764,499
060730170311,564,296,268,585,301,284,862,521,315,668,335,273
060730170312,325,181,144,339,184,155,510,310,187,382,205,151
060730170313,633,352,281,658,357,301,1261,762,461,863,467,332
060730170631,631,333,298,656,339,317,795,482,291,592,307,250
060730170632,570,293,277,591,297,294,311,187,122,431,222,190
060730170691,1083,593,490,1121,592,529,1471,882,559,1163,611,464
060730170611,767,363,404,795,359,436,853,463,372,627,288,314
060730083361,445,241,204,454,242,212,465,282,172,479,254,200
060730083362,795,428,367,819,433,386,779,480,283,1014,551,403
060730170363,549,306,243,562,308,254,721,453,253,711,390,280
060730170361,373,232,141,386,237,149,676,422,235,481,295,157
060730170362,314,195,119,323,198,125,479,300,168,344,213,112
060730170181,474,274,200,487,269,218,876,539,318,860,474,327
060730170351,354,205,149,361,204,157,503,311,183,331,194,115
060730170352,87,50,37,89,50,39,634,393,231,47,25,20
060730170353,505,291,214,514,291,223,757,467,275,471,277,162
060730170342,471,243,228,484,250,234,500,306,179,992,535,392
060730170343,638,353,285,659,359,300,848,521,302,705,345,321
060730170391,325,171,154,333,176,157,371,231,134,531,270,238
060730170392,454,240,214,466,246,220,516,318,187,335,192,123
060730170551,598,325,273,619,335,284,848,524,308,781,480,265
060730170552,642,388,254,663,393,270,921,570,334,665,399,229
060730170561,776,456,320,796,460,336,1440,889,522,1113,627,422
060730170562,546,305,241,555,306,249,955,592,346,653,358,254
060730083681,527,270,257,545,276,269,545,333,200,628,300,278
060730083683,904,479,425,941,500,441,1038,628,387,986,534,396
060730170182,675,443,232,698,447,251,1231,769,428,778,465,267
060730170371,820,472,348,847,472,375,1156,720,403,1179,653,452
060730170373,756,426,330,791,435,356,1029,628,379,801,453,303
060730170331,542,332,210,559,332,227,812,500,295,620,371,193
060730170332,356,218,138,365,217,148,430,266,156,541,312,197
060730170553,764,428,336,794,445,349,1002,619,363,812,453,316
060730083661,1187,648,539,1236,663,573,1669,1018,620,1379,774,535
060730083663,636,391,245,657,397,260,876,531,327,711,446,228
060730083662,1185,628,557,1221,639,582,1637,968,636,1307,720,520
060730083651,770,424,346,791,426,365,1003,623,365,1001,582,373
060730083652,688,379,309,715,386,329,899,558,325,545,305,209
060730170372,439,243,196,454,243,211,476,297,165,315,175,122
060730170374,479,265,214,502,273,229,646,387,247,562,321,210
060730083684,904,499,405,928,508,420,1507,915,563,938,527,351
060730083682,437,238,199,447,236,211,572,347,213,229,127,87
060730083371,829,450,379,854,458,396,1031,629,377,917,502,356
060730083372,438,229,209,452,234,218,513,320,179,509,271,208
060730083373,704,376,328,727,382,345,887,545,324,768,420,301
060730083671,313,187,126,320,188,132,848,516,318,613,358,225
060730083672,804,446,358,826,455,371,1082,658,404,855,484,321
060730170621,1036,441,595,1063,433,630,1290,673,587,1292,593,641
060730170622,718,359,359,743,361,382,1315,722,571,1015,551,410
060730170651,1015,571,444,1042,577,465,1593,1031,532,1248,729,440
060730170652,1744,1037,707,1795,1044,751,2562,1651,856,873,556,266
060730170661,1215,527,688,1244,529,715,1926,1058,828,1423,659,697
060730083281,1712,985,727,1761,986,775,1370,881,462,664,398,238
060730215021,975,622,353,1007,628,379,2797,1866,881,1079,685,343
060730215022,392,213,179,405,216,189,889,595,276,380,239,122
060730083722,1397,829,568,1446,850,596,1472,928,507,1199,748,382
060730083731,843,512,331,869,517,352,541,364,166,608,379,199
060730083732,678,404,274,694,406,288,1236,829,382,691,399,258
060730083741,581,343,238,597,349,248,1090,734,335,1153,699,401
060730215023,735,378,357,753,382,371,1093,688,376,972,532,379
060730083742,650,389,261,673,399,274,1224,772,422,952,598,292
060730083721,308,202,106,315,203,112,837,545,272,890,586,251
060730083712,471,292,179,481,290,191,848,568,261,460,272,166
060730083711,1055,671,384,1085,692,393,1529,1025,471,693,440,225
060730215011,753,446,307,779,452,327,841,558,263,728,454,240
060730215012,512,303,209,528,305,223,440,293,137,615,397,197
060730083282,1686,874,812,1735,892,843,2749,1767,927,2111,1195,822
060730083701,840,556,284,863,555,308,1176,795,350,963,609,288
060730083302,541,360,181,559,365,194,746,490,242,549,372,150
060730083303,760,502,258,788,508,280,1487,975,482,1003,667,282
060730083301,1057,613,444,1091,613,478,1219,798,395,1250,780,410
060730083311,1278,766,512,1322,792,530,1416,958,420,985,626,310
060730083271,964,580,384,992,584,408,1221,802,397,1092,667,361
060730083273,571,343,228,584,348,236,713,469,232,564,348,190
060730083272,1149,713,436,1176,728,448,1958,1287,635,1261,787,427
060730173061,1074,567,507,1105,576,529,1349,820,502,1335,724,554
060730173062,677,396,281,689,389,300,832,546,272,704,412,253
060730083241,1352,899,453,1395,896,499,1646,1170,440,1418,938,405
060730083691,415,268,147,430,270,160,669,453,202,499,315,154
060730083692,356,237,119,371,245,126,600,418,168,733,470,224
060730083702,808,524,284,830,526,304,1075,725,320,635,404,204
060730215013,514,302,212,532,302,230,532,353,166,564,349,190
060730083244,509,345,164,523,348,175,679,484,181,365,243,103
060730083245,1047,716,331,1075,724,351,1081,770,289,760,504,214
060730083242,372,253,119,380,258,122,487,348,132,771,526,193
060730083243,736,512,224,753,518,235,995,704,265,959,647,267
060730083051,2662,2408,254,2733,2429,304,1080,967,75,2700,2327,191
060730083052,618,548,70,629,552,77,1298,1159,88,648,519,60
060730083391,549,441,108,565,442,123,774,580,176,633,471,120
060730083782,37,30,7,38,30,8,14,11,3,0,0,0
060730083781,187,150,37,191,150,41,362,283,70,298,223,56
060730083431,663,547,116,681,539,142,838,658,161,622,482,92
060730083432,391,322,69,400,316,84,480,375,93,408,313,62
060730083433,192,152,40,198,150,48,267,208,51,460,347,77
060730083611,682,515,167,692,507,185,1132,782,326,819,586,182
060730083612,224,169,55,228,167,61,421,289,121,295,211,65
060730083621,503,374,129,512,371,141,770,531,222,589,414,139
060730083771,277,219,58,284,221,63,486,380,93,367,283,64
060730083772,456,361,95,471,367,104,472,369,91,515,396,89
060730083631,119,101,18,122,101,21,421,329,81,184,148,23
060730083632,223,188,35,229,189,40,516,405,99,347,278,44
060730083643,394,309,85,405,312,93,535,418,103,368,262,76
060730083644,275,205,70,282,207,75,269,210,53,292,204,65
060730083642,451,357,94,466,362,104,615,482,119,513,363,108
060730083641,592,423,169,610,432,178,462,363,89,760,509,209
060730083131,579,394,185,597,395,202,637,439,183,547,365,156
060730083622,275,203,72,280,202,78,459,317,132,240,162,62
060730083623,497,367,130,508,367,141,751,518,216,764,537,183
060730083752,573,433,140,586,431,155,752,566,168,835,605,172
060730083762,235,177,58,237,175,62,373,281,84,230,148,73
060730083633,292,253,39,303,255,48,370,289,71,257,207,33
060730083634,391,338,53,406,341,65,537,421,103,344,276,44
060730083751,375,276,99,381,272,109,301,227,67,326,244,60
060730083753,224,165,59,227,163,64,764,576,170,220,165,40
060730083763,82,60,22,85,62,23,1222,920,272,671,493,125
060730083761,758,556,202,781,568,213,442,332,98,343,220,109
060730083463,1361,891,470,1396,884,512,1767,1119,613,1641,1025,518
060730083462,229,145,84,236,144,92,396,250,137,234,132,66
060730083764,309,228,81,316,226,90,357,268,79,276,176,87
060730083793,502,365,137,516,369,147,668,523,128,403,283,98
060730083792,136,99,37,139,99,40,443,347,85,369,259,90
060730083791,276,201,75,284,203,81,463,363,89,356,250,87
060730083121,338,229,109,351,239,112,377,272,99,334,229,91
060730083124,599,370,229,614,380,234,619,432,185,652,411,202
060730083123,401,258,143,414,264,150,361,251,101,479,306,137
060730081012,414,297,117,426,302,124,539,370,156,450,319,111
060730083031,789,471,318,806,481,325,875,598,257,592,342,219
060730083032,863,465,398,886,481,405,939,648,270,821,487,298
060730082011,488,302,186,501,307,194,639,438,184,527,324,171
060730082021,448,280,168,463,285,178,341,235,99,398,245,128
060730082022,335,204,131,346,211,135,687,472,198,365,225,120
060730082012,503,320,183,512,322,190,596,417,174,875,559,270
060730081011,328,234,94,336,238,98,411,283,119,333,231,82
060730081013,400,275,125,408,278,130,529,367,155,415,261,135
060730081014,415,285,130,426,291,135,540,373,154,524,335,160
060730081015,458,315,143,477,330,147,568,392,165,502,329,140
060730081022,595,382,213,622,398,224,793,528,249,701,453,208
060730081023,753,465,288,778,476,302,942,631,291,931,592,280
060730081021,508,286,222,528,297,231,577,399,170,516,296,193
060730080061,410,257,153,423,263,160,558,382,160,503,318,156
060730080062,377,259,118,386,261,125,508,344,149,373,255,92
060730080063,325,231,94,335,231,104,423,290,123,392,276,85
060730083112,667,364,303,687,373,314,794,490,288,718,401,282
060730083111,979,535,444,1012,553,459,1180,731,429,1125,650,430
060730080064,329,230,99,337,231,106,469,316,136,375,256,92
060730080065,451,316,135,464,319,145,580,391,167,484,327,121
060730083103,1407,755,652,1446,768,678,1810,1134,643,1388,763,566
060730083033,371,204,167,382,212,170,470,288,169,413,250,145
060730083101,630,348,282,647,357,290,1007,621,366,466,278,174
060730083102,991,528,463,1017,541,476,1127,710,391,1110,603,458
060730083011,793,472,321,823,484,339,806,552,226,859,494,318
060730083012,577,326,251,595,329,266,749,488,235,688,394,262
060730083013,448,259,189,462,268,194,561,349,204,603,377,199
060730083132,607,398,209,625,399,226,695,479,200,604,399,176
060730083122,562,340,222,574,340,234,860,593,247,685,410,223
060730083475,655,434,221,675,432,243,1234,749,456,843,510,279
060730083461,648,366,282,669,364,305,825,502,305,561,330,202
060730083471,631,358,273,650,358,292,847,517,311,716,407,267
060730083472,448,257,191,461,256,205,650,394,240,533,319,187
060730083473,338,194,144,348,193,155,449,274,165,310,184,111
060730083601,526,359,167,536,354,182,506,306,183,458,304,125
060730083602,496,320,176,511,319,192,554,337,201,592,377,183
060730083811,483,293,190,498,294,204,818,524,277,622,383,202
060730083812,272,166,106,281,168,113,450,285,153,405,255,126
060730083552,738,427,311,752,428,324,1126,716,386,861,512,297
060730083532,1071,633,438,1100,628,472,1268,772,469,745,436,269
060730083561,491,312,179,512,308,204,830,492,317,528,331,167
060730083573,488,310,178,507,304,203,950,563,362,600,379,191
060730083491,504,306,198,514,303,211,810,490,299,595,334,225
060730083562,605,367,238,617,357,260,829,495,318,791,459,277
060730083522,406,246,160,418,238,180,629,374,240,451,250,169
060730083523,269,164,105,276,157,119,511,303,196,331,184,123
060730083531,463,271,192,477,268,209,569,338,218,756,413,292
060730083571,414,230,184,424,233,191,594,362,218,464,264,174
060730083572,312,172,140,318,176,142,489,291,189,369,210,141
060730083551,329,185,144,334,186,148,424,252,162,369,217,129
060730083802,651,413,238,669,415,254,1000,635,340,847,557,249
060730083521,364,192,172,375,192,183,452,270,174,503,266,206
060730083533,320,169,151,329,171,158,392,234,149,546,289,224
060730083481,824,482,342,848,487,361,960,573,364,816,483,289
060730083482,368,213,155,376,214,162,490,296,185,349,206,124
060730083474,329,203,126,340,199,141,496,302,184,372,211,140
060730083492,692,415,277,710,417,293,1102,663,410,730,414,273
060730083503,363,221,142,369,218,151,476,284,180,293,175,102
060730083501,714,391,323,731,386,345,897,536,339,886,508,321
060730083513,277,166,111,285,164,121,537,321,203,411,240,147
060730083514,480,276,204,492,274,218,683,409,257,525,309,188
060730083581,635,390,245,660,390,270,690,422,252,728,427,262
060730083603,703,421,282,725,419,306,771,468,280,1020,629,329
060730083511,266,157,109,273,156,117,464,276,176,323,191,114
060730083512,292,172,120,297,170,127,357,213,136,284,169,99
060730083502,376,230,146,383,229,154,536,320,203,350,209,122
060730083801,353,218,135,362,222,140,1532,973,521,653,429,187
060730083803,78,48,30,80,49,31,817,519,279,141,94,41
060730083591,1097,800,297,1121,790,331,586,358,213,468,297,135
060730083483,623,373,250,643,379,264,984,589,373,891,553,290
060730083504,469,296,173,478,296,182,968,578,365,626,373,218
060730083583,670,397,273,688,395,293,530,326,194,757,457,254
060730083584,546,324,222,565,325,240,568,344,206,696,417,235
060730083582,267,171,96,274,170,104,243,148,89,328,200,110
060730083592,388,266,122,397,266,131,638,388,232,525,332,150
060730170432,379,237,142,389,229,160,724,454,254,836,520,253
060730170433,999,585,414,1027,572,455,1142,716,400,846,461,349
060730170461,1393,776,617,1441,787,654,1426,892,502,1338,758,500
060730170221,427,243,184,435,241,194,552,340,200,439,254,162
060730170222,465,271,194,481,274,207,566,350,206,451,263,162
060730170223,428,251,177,439,249,190,571,352,207,452,263,163
060730170226,551,326,225,568,331,237,839,516,304,607,356,209
060730170473,682,360,322,706,365,341,858,530,312,902,466,380
060730095043,1352,666,686,1396,686,710,1817,1121,660,1770,1032,637
060730170224,509,317,192,519,320,199,788,487,287,408,249,129
060730170225,364,226,138,370,228,142,655,404,239,346,207,116
060730170671,457,259,198,472,259,213,603,369,221,415,233,151
060730170672,850,459,391,877,459,418,1029,609,393,1038,579,402
060730170682,922,528,394,942,533,409,1182,725,428,1044,602,379
060730170431,884,496,388,909,491,418,1075,676,377,717,401,282
060730170441,604,349,255,621,349,272,955,601,335,635,384,212
060730170395,750,420,330,770,415,355,918,564,335,577,324,219
060730170502,617,265,352,631,261,370,890,469,401,664,287,336
060730170442,475,265,210,491,270,221,797,494,286,480,265,190
060730170444,445,256,189,457,258,199,659,409,236,781,447,292
060730170681,574,367,207,579,359,220,1041,639,379,597,337,220
060730095042,609,311,298,627,322,305,691,425,250,634,314,285
060730170472,658,339,319,683,343,340,764,473,275,930,478,397
060730095041,757,392,365,781,397,384,1068,607,444,748,400,312
060730170443,533,285,248,550,288,262,876,547,313,475,276,176
060730170451,1221,651,570,1269,666,603,1658,1016,604,1176,663,458
060730170471,805,425,380,832,434,398,998,620,356,856,478,334
060730170462,566,299,267,586,312,274,647,402,232,817,461,324
060730095044,514,270,244,530,272,258,821,467,337,608,300,285
060730170394,497,276,221,518,279,239,938,546,368,436,245,167
060730170393,738,384,354,766,390,376,1168,681,459,1174,620,471
060730083441,915,589,326,938,582,356,1166,804,338,1011,639,323
060730083442,886,584,302,911,586,325,1118,758,337,932,590,296
060730083451,574,345,229,589,345,244,658,446,196,657,389,221
060730083452,706,429,277,723,429,294,821,557,245,628,377,210
060730083453,670,438,232,691,443,248,893,606,266,790,505,238
060730083071,497,307,190,513,310,203,573,391,171,556,345,175
060730083073,484,286,198,507,302,205,587,397,175,599,368,201
060730083072,1160,755,405,1195,764,431,1394,947,417,1135,708,362
060730083061,367,230,137,384,237,147,439,300,133,343,216,113
060730083062,600,377,223,616,376,240,656,446,196,787,495,253
060730083063,836,525,311,865,530,335,979,667,293,850,532,278
060730085011,703,428,275,725,426,299,887,565,303,1284,747,454
060730085012,950,564,386,987,568,419,1073,684,365,672,341,276
060730085013,537,315,222,559,320,239,669,426,226,565,324,199
060730085014,429,258,171,445,258,187,612,392,208,481,274,172
060730085031,927,553,374,961,578,383,1095,699,370,1107,636,396
060730085034,675,405,270,703,421,282,831,528,280,1005,576,360
060730085033,1012,620,392,1047,640,407,1366,871,463,758,426,277
060730085021,750,461,289,774,462,312,899,571,305,733,440,247
060730085023,466,288,178,482,288,194,555,352,189,788,466,267
060730085024,672,417,255,692,417,275,784,496,264,699,416,235
060730085025,512,321,191,524,326,198,796,510,270,505,305,168
060730085032,518,321,197,532,325,207,921,587,313,546,305,202
060730085043,570,374,196,590,390,200,876,556,297,299,186,93
060730085041,326,207,119,336,210,126,521,330,176,598,356,210
060730085042,331,214,117,338,217,121,404,256,137,509,309,178
060730085022,378,234,144,386,234,152,581,372,197,436,259,155
060730085054,514,316,198,532,319,213,661,422,225,668,395,230
060730085055,419,257,162,430,259,171,703,445,238,559,331,193
060730085045,1175,682,493,1206,684,522,1109,702,381,1224,658,485
060730085044,444,259,185,453,262,191,513,328,178,530,295,197
060730085072,275,195,80,282,192,90,486,307,167,304,199,84
060730085073,471,303,168,483,302,181,860,543,295,626,381,201
060730085074,360,263,97,368,259,109,693,439,238,402,270,103
060730085121,387,228,159,398,231,167,494,308,172,616,357,231
060730085123,1166,661,505,1203,667,536,1342,842,469,819,428,347
060730085122,732,404,328,755,408,347,891,559,313,1082,554,464
060730085131,909,523,386,926,526,400,1069,669,372,1027,564,403
060730085132,587,333,254,602,336,266,673,423,235,646,359,251
060730085101,413,280,133,422,282,140,677,446,213,547,337,170
060730085104,473,310,163,486,313,173,899,593,282,551,361,147
060730085092,507,310,197,522,309,213,551,354,184,488,285,171
060730085096,740,479,261,767,491,276,803,504,279,684,385,250
060730085093,342,219,123,350,218,132,365,240,115,517,313,170
060730085095,418,276,142,432,282,150,1226,769,428,639,422,174
060730085091,526,346,180,540,331,209,706,443,247,563,318,207
060730085094,286,192,94,298,201,97,539,337,188,396,264,104
060730085071,710,405,305,737,407,330,825,522,284,701,383,270
060730085075,514,288,226,529,293,236,582,368,199,619,334,241
060730085061,453,277,176,470,278,192,679,430,232,639,367,230
060730085062,516,303,213,536,302,234,781,496,264,505,294,180
060730085063,614,375,239,634,376,258,765,482,259,811,476,281
060730085051,591,353,238,609,353,256,695,440,239,577,330,212
060730085052,440,261,179,459,266,193,663,419,225,439,256,155
060730085053,334,197,137,342,196,146,438,280,152,330,190,122
060730085076,339,203,136,351,205,146,551,349,190,447,249,166
060730085102,910,546,364,938,550,388,1064,691,348,982,547,369
060730085103,703,458,245,730,448,282,969,636,308,768,480,232
060730085111,958,663,295,990,658,332,1347,991,314,435,292,113
060730085112,192,114,78,199,110,89,765,486,264,523,274,222
060730085113,356,261,95,366,260,106,557,411,130,639,428,168
060730095111,74,47,27,74,43,31,283,145,125,143,66,61
060730095091,608,308,300,614,316,298,570,351,202,832,427,345
060730095112,84,53,31,84,50,34,290,149,129,163,74,69
060730095101,89,49,40,89,49,40,540,335,187,112,45,53
060730095102,180,99,81,182,99,83,1031,640,357,239,100,112
060730095103,95,52,43,96,52,44,445,276,154,103,42,49
060730095071,1004,555,449,1033,545,488,1304,816,458,843,463,319
060730095072,221,126,95,230,125,105,425,266,149,253,142,92
060730095073,405,226,179,421,235,186,533,347,176,466,267,171
060730095093,538,397,141,553,402,151,527,372,139,531,333,157
060730095092,260,195,65,267,197,70,1213,855,320,472,302,133
060730095022,815,501,314,842,495,347,847,526,293,920,514,342
060730095053,987,600,387,1024,619,405,1272,797,446,1791,1049,625
060730095062,884,570,314,911,575,336,809,500,278,999,613,316
060730095061,1318,752,566,1353,750,603,1561,979,548,1026,540,410
060730095021,975,529,446,1000,539,461,742,461,257,1051,566,410
060730095052,743,433,310,768,431,337,902,565,315,512,302,176
060730095054,720,439,281,735,431,304,998,624,349,947,561,322
060730095051,1113,611,502,1149,626,523,780,490,273,921,547,312
060730098053,641,366,275,658,369,289,809,482,308,680,379,261
060730098054,879,498,381,902,502,400,1193,725,443,868,472,342
060730097045,772,450,322,790,460,330,924,566,337,988,545,393
060730098052,398,228,170,406,227,179,460,277,175,428,226,170
060730098014,505,290,215,520,293,227,687,411,262,534,303,202
060730098013,694,391,303,715,388,327,848,513,323,763,400,323
060730098011,509,274,235,527,273,254,640,387,236,567,281,251
060730098021,632,337,295,650,340,310,732,450,271,685,340,303
060730098025,273,154,119,284,150,134,454,270,170,334,173,143
060730098041,919,530,389,947,530,417,1241,743,469,944,498,395
060730098043,426,239,187,436,242,194,521,314,200,516,283,206
060730098044,772,438,334,796,443,353,1008,600,380,841,436,363
060730097042,394,233,161,401,231,170,650,423,216,285,158,104
060730097043,832,485,347,858,495,363,921,602,302,1061,612,381
060730097044,458,263,195,472,267,205,546,339,197,320,178,127
060730098022,397,261,136,409,265,144,746,456,274,529,319,165
060730098023,436,279,157,449,283,166,769,467,282,506,295,176
060730161003,600,302,298,627,294,333,1193,599,562,717,340,320
060730098024,846,486,360,878,489,389,1046,643,387,928,476,407
060730098042,450,255,195,471,263,208,625,374,239,451,248,180
060730098051,673,381,292,701,390,311,806,480,304,763,419,297
060730098012,853,465,388,881,482,399,985,579,394,942,503,395
060730097061,721,384,337,737,381,356,788,480,290,615,317,267
060730148053,644,410,234,658,398,260,914,576,314,771,443,268
060730097062,586,324,262,602,326,276,823,506,300,1018,599,362
060730097067,495,264,231,507,261,246,579,358,211,450,230,199
060730097064,395,213,182,406,210,196,465,280,179,416,223,169
060730097065,613,323,290,634,328,306,729,438,279,741,409,300
060730097063,830,457,373,860,455,405,1128,677,431,800,437,319
060730097031,597,347,250,610,345,265,765,472,276,613,312,269
060730097041,662,380,282,684,389,295,927,571,336,852,497,303
060730096021,693,402,291,717,406,311,763,471,276,612,350,229
060730097032,433,252,181,450,258,192,585,365,214,426,236,172
060730097033,780,463,317,810,476,334,967,599,351,981,557,380
060730097066,490,259,231,505,264,241,561,343,209,597,325,250
060730097052,868,508,360,887,519,368,1080,666,394,525,268,229
060730097053,567,351,216,578,352,226,806,514,276,686,417,215
060730096042,419,261,158,432,263,169,535,346,178,371,218,120
060730096044,393,252,141,403,253,150,602,387,200,394,231,127
060730097051,470,254,216,481,266,215,558,342,203,644,329,280
060730096023,509,295,214,530,301,229,645,409,228,490,280,180
060730096024,343,194,149,351,196,155,427,264,154,476,270,174
060730096041,366,213,153,374,213,161,385,248,128,405,228,155
060730096022,412,252,160,416,242,174,689,426,250,516,299,186
060730096043,420,257,163,425,247,178,633,410,209,532,304,195
060730096031,467,344,123,479,340,139,628,442,166,577,395,151
060730096033,417,307,110,426,303,123,578,408,153,480,328,126
060730096032,384,268,116,392,263,129,444,314,118,489,298,158
060730096034,498,347,151,509,341,168,1096,774,290,620,383,200
060730092032,1381,898,483,1416,899,517,1017,694,299,1392,867,444
060730093061,769,466,303,794,469,325,1143,749,369,919,534,330
060730093064,766,497,269,791,484,307,910,595,294,707,428,241
060730093062,318,179,139,327,179,148,390,258,126,268,151,98
060730093063,426,276,150,445,289,156,631,414,205,712,434,218
060730093014,331,208,123,347,216,131,503,328,162,306,202,77
060730093055,370,230,140,383,231,152,311,202,100,321,183,117
060730093051,395,248,147,411,257,154,479,316,155,650,346,261
060730093011,327,203,124,338,203,135,428,281,139,456,255,170
060730093013,408,253,155,422,253,169,618,404,199,395,261,99
060730093052,317,191,126,324,187,137,341,223,110,252,144,92
060730093012,631,374,257,640,374,266,609,414,180,742,413,276
060730092041,531,298,233,539,291,248,683,468,201,680,374,261
060730092042,929,570,359,958,573,385,962,641,297,870,512,305
060730092011,479,325,154,490,330,160,1043,689,327,310,194,91
060730092012,89,61,28,92,62,30,625,426,183,329,205,97
060730092013,564,337,227,576,331,245,638,435,190,591,314,229
060730092014,102,69,33,107,70,37,704,480,208,358,225,106
060730087022,863,530,333,881,512,369,857,585,252,958,555,352
060730093074,209,152,57,218,149,69,287,196,85,203,135,54
060730093071,371,268,103,385,264,121,691,471,203,437,290,120
060730093083,650,471,179,671,465,206,687,467,202,693,460,191
060730093082,324,234,90,334,232,102,519,353,152,315,210,86
060730089021,417,284,133,420,282,138,747,524,205,610,390,167
060730089022,539,366,173,549,366,183,605,425,166,519,326,149
060730093072,401,292,109,414,294,120,722,537,166,530,359,128
060730093073,393,287,106,406,287,119,581,430,134,401,272,96
060730093081,381,277,104,395,277,118,888,604,261,687,457,182
060730093053,448,297,151,463,299,164,792,518,256,520,349,145
060730093054,229,151,78,236,153,83,572,370,184,433,292,107
060730087021,391,275,116,406,271,135,842,574,248,540,362,136
060730087023,294,208,86,305,205,100,507,344,148,338,226,85
060730088001,454,302,152,462,303,159,673,428,227,678,482,162
060730088002,245,157,88,248,156,92,454,301,143,246,160,74
060730088003,494,324,170,502,322,180,608,404,192,354,231,103
060730088004,338,219,119,343,218,125,681,451,215,490,331,133
060730089013,1416,959,457,1460,977,483,1318,868,414,1583,1021,458
060730087011,318,208,110,330,208,122,585,368,202,339,193,120
060730087012,244,168,76,251,165,86,554,355,181,360,226,112
060730086001,905,601,304,924,607,317,1187,786,374,944,577,286
060730086002,241,175,66,243,171,72,502,332,157,282,206,59
060730086003,154,112,42,156,110,46,416,275,131,226,165,48
060730086004,174,126,48,179,126,53,598,392,187,320,234,68
060730089011,322,200,122,329,199,130,439,293,137,396,246,124
060730089012,186,116,70,191,116,75,326,215,102,295,183,92
060730090001,838,579,259,853,570,283,1128,746,354,939,634,250
060730090002,281,199,82,282,194,88,418,275,131,402,272,105
060730091081,549,323,226,562,323,239,424,283,133,611,343,228
060730091091,202,141,61,207,140,67,1540,1014,480,656,441,162
060730091073,458,330,128,476,335,141,528,344,165,463,315,113
060730091072,326,240,86,333,247,86,394,260,123,465,323,111
060730091082,437,254,183,448,253,195,304,203,96,470,264,177
060730091071,388,273,115,404,275,129,927,612,289,199,134,49
060730091074,470,327,143,486,326,160,349,230,109,268,180,65
060730091042,928,542,386,971,545,426,631,415,196,776,441,279
060730091033,682,417,265,705,421,284,818,527,276,740,438,265
060730091034,545,335,210,563,335,228,735,475,249,602,346,210
060730091041,635,349,286,653,345,308,465,310,148,940,520,355
060730091032,413,255,158,429,258,171,536,342,181,514,300,186
060730091031,411,258,153,424,258,166,515,328,173,441,259,158
060730091012,1066,657,409,1096,659,437,1378,879,463,1002,582,358
060730091013,471,277,194,484,281,203,521,333,176,830,484,292
060730091021,481,319,162,495,320,175,785,500,264,449,287,124
060730091023,317,209,108,327,210,117,571,363,191,312,202,83
060730091011,532,313,219,547,318,229,584,370,197,581,326,223
060730091014,768,438,330,788,450,338,882,565,296,883,467,351
060730091022,340,241,99,350,241,109,753,479,252,442,280,126
060730078001,441,320,121,447,313,134,878,604,244,494,323,128
060730078002,362,228,134,371,231,140,511,355,142,467,282,157
060730078003,352,262,90,365,267,98,907,622,249,613,393,159
060730078004,223,163,60,228,159,69,410,284,114,221,146,57
060730078005,174,116,58,180,119,61,494,343,138,316,198,96
060730076014,201,122,79,207,121,86,232,162,69,253,145,86
060730077011,568,363,205,584,367,217,707,478,204,525,316,174
060730077013,277,192,85,288,193,95,416,280,119,347,222,96
060730080023,390,261,129,404,266,138,472,323,135,299,183,93
060730080022,555,338,217,571,343,228,660,453,191,535,304,202
060730079082,410,305,105,427,314,113,621,424,175,467,301,120
060730079083,405,301,104,422,310,112,620,422,174,437,285,111
060730077022,421,308,113,437,305,132,531,368,148,452,285,126
060730077023,473,333,140,492,333,159,628,433,173,546,353,144
060730079111,409,301,108,422,304,118,558,383,154,461,290,122
060730079112,430,316,114,446,317,129,676,464,186,499,321,126
060730079081,237,174,63,243,174,69,387,268,107,301,196,76
060730079121,396,276,120,413,278,135,624,425,182,469,290,141
060730080021,444,254,190,454,258,196,513,350,151,469,269,171
060730079113,158,118,40,164,118,46,227,154,65,198,132,47
060730079122,377,278,99,393,280,113,565,384,158,501,333,120
060730079072,512,381,131,531,392,139,852,575,245,667,443,161
060730077024,276,202,74,284,200,84,450,309,124,379,237,107
060730077012,434,269,165,452,273,179,579,393,167,485,286,162
060730077021,495,282,213,510,289,221,519,360,145,538,290,204
060730077014,226,160,66,235,161,74,443,301,128,413,267,110
060730079071,683,503,180,707,499,208,919,619,266,876,586,215
060730079051,443,302,141,458,305,153,718,486,208,594,367,163
060730079052,575,393,182,593,394,199,898,613,262,586,370,158
060730079101,636,459,177,656,464,192,802,542,234,806,507,230
060730079102,520,375,145,540,382,158,789,535,228,564,362,150
060730076012,375,229,146,381,224,157,558,385,162,370,211,124
060730076013,226,138,88,229,135,94,232,163,69,306,173,105
060730080031,547,383,164,567,385,182,714,486,207,626,424,152
060730080032,639,450,189,660,449,211,845,575,248,709,454,199
060730080033,418,294,124,437,296,141,554,379,162,509,343,123
060730076021,235,145,90,240,143,97,311,213,91,250,156,72
060730076022,264,162,102,270,162,108,370,255,106,307,165,115
060730076023,302,187,115,305,181,124,397,273,118,379,207,137
060730068011,561,396,165,574,403,171,822,574,225,570,372,148
060730068012,400,282,118,411,288,123,769,536,210,590,385,153
060730075014,413,322,91,424,321,103,615,465,129,469,319,99
060730075015,277,215,62,281,213,68,384,289,80,293,200,62
060730075022,401,323,78,413,322,91,630,474,132,497,343,103
060730075023,462,375,87,478,369,109,685,514,142,580,406,117
060730073041,808,614,194,831,610,221,1088,816,228,900,606,209
060730073042,793,615,178,818,614,204,1010,760,211,839,588,184
060730073031,538,413,125,548,412,136,618,468,131,581,401,128
060730073032,413,317,96,425,317,108,481,365,101,468,325,102
060730075021,543,414,129,560,413,147,677,515,142,631,446,137
060730072002,1189,723,466,1219,733,486,1130,688,417,1308,807,429
060730075013,390,311,79,405,307,98,549,415,116,461,329,90
060730075011,402,322,80,421,326,95,563,429,120,439,313,94
060730075012,289,231,58,300,233,67,401,306,85,328,232,70
060730074021,657,463,194,678,465,213,921,600,287,739,491,195
060730074022,595,423,172,614,425,189,937,616,291,710,477,187
060730074023,460,318,142,472,320,152,539,357,170,434,284,127
060730073021,432,286,146,441,299,142,512,339,160,512,336,143
060730073022,429,266,163,445,272,173,485,321,152,427,254,142
060730073023,386,236,150,397,238,159,444,293,139,403,238,137
060730074011,321,239,82,331,234,97,494,344,135,374,237,98
060730074012,414,308,106,427,302,125,628,437,173,485,304,126
060730068022,520,377,143,528,374,154,613,395,200,716,438,215
060730068023,603,441,162,621,441,180,1110,773,303,701,439,192
060730069001,1267,784,483,1313,798,515,1462,1011,406,1381,805,465
060730063001,190,109,81,200,116,84,732,472,239,402,235,133
060730066002,55,35,20,55,35,20,241,154,77,97,57,31
060730066001,125,82,43,128,82,46,381,246,123,130,76,43
060730068021,437,285,152,444,283,161,658,425,216,180,107,60
060730065001,486,313,173,503,319,184,389,255,126,535,317,190
060730001002,1126,768,358,1150,772,378,1138,844,276,1105,738,300
060730065002,363,246,117,370,249,121,569,400,156,465,288,150
060730002021,677,518,159,698,534,164,906,676,209,789,562,178
060730065003,278,216,62,283,210,73,481,360,108,377,247,105
060730001001,761,554,207,781,562,219,825,624,191,825,603,178
060730002022,439,303,136,449,305,144,639,478,146,539,397,107
060730002011,570,436,134,582,437,145,602,456,140,564,424,107
060730002023,703,567,136,721,574,147,881,661,202,904,703,151
060730002024,494,395,99,506,402,104,680,509,155,502,373,108
060730003011,324,268,56,329,265,64,387,323,56,288,230,40
060730003013,554,479,75,567,484,83,686,570,98,561,447,79
060730002012,661,511,150,677,510,167,782,587,180,627,480,115
060730004002,505,446,59,512,452,60,650,541,95,635,528,71
060730004004,463,404,59,469,404,65,749,624,109,447,371,46
060730004003,417,366,51,423,368,55,542,452,78,471,389,52
060730004001,484,424,60,495,428,67,621,519,90,509,422,53
060730003021,1045,905,140,1060,907,153,1219,1020,177,1242,1033,150
060730003022,530,465,65,543,469,74,677,562,98,773,629,96
060730003012,305,273,32,311,274,37,383,320,55,264,212,37
060730006002,615,530,85,630,538,92,661,569,78,633,519,75
060730005002,747,647,100,757,652,105,826,710,97,800,639,103
060730005001,529,432,97,532,433,99,641,545,83,549,434,78
060730005003,501,433,68,506,435,71,582,504,68,545,438,71
060730010001,706,592,114,716,594,122,846,715,111,755,601,103
060730006003,820,703,117,832,717,115,956,823,113,861,712,105
060730007001,780,678,102,793,684,109,920,791,109,845,715,84
060730007002,968,849,119,982,855,127,1150,988,137,993,838,98
060730007003,630,533,97,639,540,99,721,624,86,622,505,79
060730006001,370,325,45,379,328,51,568,486,68,487,400,57
060730009011,576,495,81,593,502,91,897,768,107,612,491,82
060730009023,335,294,41,342,295,47,608,524,72,385,305,51
060730010002,590,518,72,601,519,82,705,597,90,589,495,56
060730010003,596,528,68,609,534,75,769,658,94,665,559,64
060730010004,466,413,53,477,419,58,678,582,83,568,471,55
060730009012,406,360,46,417,363,54,645,552,76,576,469,63
060730009013,373,331,42,385,334,51,524,450,61,453,373,49
060730009021,462,396,66,470,394,76,586,503,69,434,345,66
060730009022,360,309,51,366,307,59,473,405,56,311,247,47
060730008003,679,602,77,683,606,77,845,714,110,687,568,73
060730008004,555,483,72,562,483,79,848,730,100,617,505,69
060730008005,469,408,61,477,408,69,673,570,89,609,504,63
060730008002,347,296,51,353,298,55,412,339,60,253,212,23
060730008001,276,238,38,282,238,44,375,325,44,335,274,39
060730014003,957,815,142,971,812,159,1152,984,145,1146,926,153
060730012012,463,413,50,473,409,64,654,552,83,504,417,50
060730012021,660,567,93,674,562,112,845,710,106,733,587,91
060730012022,781,672,109,795,663,132,1088,918,138,931,750,116
060730011002,610,533,77,618,530,88,801,672,105,693,558,87
060730011003,425,370,55,432,370,62,530,447,69,443,360,55
060730011001,581,496,85,591,497,94,701,593,93,669,553,82
060730013021,511,455,56,524,459,65,728,623,85,602,501,58
060730013022,549,492,57,561,495,66,706,607,83,548,460,52
060730013023,456,403,53,468,409,59,707,604,83,595,497,58
060730013012,710,624,86,727,632,95,961,830,115,795,653,86
060730014001,348,297,51,354,293,61,410,355,53,404,324,58
060730014002,403,340,63,410,336,74,460,388,69,424,341,59
060730012011,493,440,53,507,438,69,687,578,88,564,465,57
060730013011,469,416,53,479,419,60,707,599,91,530,431,59
060730016004,526,461,65,534,464,70,684,563,95,519,415,61
060730015001,518,455,63,530,458,72,652,558,83,586,472,70
060730015004,463,406,57,473,408,65,649,553,81,500,407,60
060730015002,519,438,81,530,440,90,567,470,81,565,450,75
060730015003,517,436,81,530,442,88,563,466,83,527,423,67
060730042002,1099,917,182,1112,919,193,1209,996,176,1289,1017,199
060730018012,477,407,70,484,405,79,744,626,98,607,490,76
060730018021,235,207,28,236,200,36,423,357,55,258,203,31
060730018022,316,279,37,320,270,50,468,391,62,321,252,39
060730023021,396,299,97,406,297,109,604,439,158,408,316,67
060730027071,167,122,45,169,122,47,315,228,85,241,189,40
060730027072,127,93,34,129,93,36,274,200,74,221,171,36
060730017001,530,461,69,539,460,79,792,660,108,672,542,77
060730017002,503,436,67,514,439,75,722,607,98,580,469,65
060730017003,560,485,75,573,486,87,699,588,95,567,464,62
060730017004,261,226,35,268,226,42,321,269,44,281,228,32
060730016002,415,366,49,421,366,55,602,515,73,449,372,49
060730016003,273,241,32,275,241,34,396,338,44,317,263,34
060730016001,356,306,50,361,301,60,549,449,88,479,383,52
060730022012,263,227,36,270,225,45,494,398,78,383,306,40
060730022011,314,255,59,318,252,66,618,462,139,348,282,41
060730022021,263,204,59,265,204,61,489,369,112,328,264,45
060730022022,331,262,69,338,260,78,583,436,132,538,430,71
060730022023,205,159,46,206,158,48,369,278,83,304,246,40
060730021003,294,235,59,301,239,62,322,246,70,300,231,49
060730021004,376,328,48,384,331,53,723,604,102,518,423,62
060730021005,471,410,61,479,411,68,740,626,101,588,479,69
060730018011,292,250,42,301,253,48,436,368,57,361,294,44
060730020013,538,420,118,548,420,128,520,399,110,647,491,120
060730020022,766,582,184,780,578,202,908,693,198,592,444,108
060730021002,336,269,67,343,272,71,434,326,98,380,291,63
060730023012,278,226,52,281,229,52,472,345,111,335,256,54
060730023013,147,119,28,149,121,28,291,214,69,216,166,35
060730020012,1030,746,284,1053,756,297,960,739,204,910,651,223
060730021001,578,481,97,582,482,100,651,509,138,565,438,91
060730020011,720,521,199,736,530,206,651,511,137,824,605,187
060730023022,215,172,43,216,168,48,462,341,111,259,209,38
060730023023,220,175,45,222,172,50,512,374,124,310,248,45
060730026011,299,245,54,302,237,65,440,322,106,403,326,57
060730026014,246,195,51,249,197,52,483,351,117,403,325,56
060730026013,74,60,14,75,59,16,133,100,33,113,91,16
060730026012,279,222,57,286,225,61,350,258,85,291,235,41
060730027073,107,85,22,109,85,24,258,186,61,148,118,21
060730027074,143,113,30,147,113,34,323,232,77,202,161,28
060730027091,315,262,53,320,262,58,511,373,123,490,388,62
060730020021,664,493,171,677,481,196,635,493,134,792,588,157
060730023011,290,236,54,298,229,69,710,543,147,421,309,80
060730028031,493,376,117,504,366,138,1011,772,210,695,513,146
060730028032,464,348,116,474,340,134,903,693,186,553,412,114
060730028033,352,257,95,358,254,104,471,362,99,378,268,88
060730028034,716,550,166,733,557,176,1088,840,228,759,537,177
060730019001,549,451,98,561,449,112,556,472,74,610,479,89
060730019002,816,673,143,834,685,149,736,625,98,789,618,126
060730019003,451,373,78,463,372,91,472,404,61,528,419,77
060730018023,354,295,59,356,292,64,502,425,65,440,341,60
060730018024,333,279,54,339,279,60,410,346,54,401,311,55
060730028042,740,556,184,757,552,205,661,497,153,628,440,133
060730028043,469,350,119,480,346,134,381,285,88,692,483,156
060730028011,849,618,231,867,610,257,795,589,192,955,662,243
060730028041,532,410,122,554,419,135,761,564,175,791,528,197
060730028012,463,384,79,485,386,99,831,616,191,483,332,105
060730029044,227,173,54,233,177,56,338,253,78,301,209,71
060730029045,740,574,166,761,579,182,828,615,190,1038,711,243
060730029041,667,546,121,689,543,146,1171,870,270,684,490,142
060730029042,353,261,92,361,259,102,602,449,138,450,300,108
060730029043,233,173,60,236,169,67,389,290,89,315,210,76
060730029053,651,497,154,669,493,176,655,489,151,754,525,174
060730029051,403,304,99,409,300,109,490,371,113,395,273,96
060730027081,221,177,44,228,173,55,336,237,88,240,194,34
060730027083,203,163,40,209,159,50,454,320,118,338,274,47
060730027084,183,148,35,190,150,40,469,339,117,336,269,49
060730027082,56,45,11,58,46,12,114,84,29,83,67,12
060730027101,264,213,51,266,215,51,399,297,97,300,237,45
060730027102,208,167,41,213,171,42,403,293,97,300,238,45
060730027103,207,164,43,210,162,48,235,172,56,162,130,24
060730027092,363,303,60,370,304,66,415,301,100,356,281,45
060730027052,627,425,202,644,415,229,910,586,306,752,514,200
060730034011,374,292,82,384,290,94,732,556,154,678,507,128
060730034012,369,283,86,376,280,96,330,251,70,185,135,37
060730027111,237,168,69,244,168,76,605,436,152,374,249,100
060730027051,690,491,199,704,488,216,968,634,313,812,600,171
060730027112,414,284,130,420,281,139,594,380,203,493,322,139
060730027121,470,357,113,487,366,121,648,442,192,561,418,115
060730027122,391,303,88,404,309,95,625,430,184,441,341,81
060730027123,394,329,65,397,322,75,973,703,248,570,466,69
060730027021,412,345,67,419,340,79,562,431,118,423,318,73
060730027022,426,336,90,435,343,92,532,408,113,498,361,110
060730027023,634,522,112,646,520,126,1092,837,231,860,638,165
060730027033,326,250,76,331,244,87,731,533,181,481,367,88
060730027031,541,403,138,552,397,155,712,515,178,542,406,107
060730027032,381,282,99,390,278,112,547,393,136,593,423,129
060730027034,636,447,189,647,446,201,876,581,276,639,427,174
060730029021,1205,896,309,1235,897,338,1284,953,301,1394,966,326
060730029022,523,396,127,538,397,141,1082,800,251,663,455,158
060730029023,581,416,165,587,403,184,685,509,160,632,407,178
060730029031,550,404,146,561,400,161,881,623,234,654,457,160
060730029032,424,299,125,434,299,135,518,364,138,422,275,115
060730029033,495,334,161,508,331,177,544,389,147,488,300,145
060730147022,1080,661,419,1108,656,452,1291,834,424,1210,718,417
060730029052,318,225,93,323,217,106,560,417,131,399,273,98
060730026021,195,154,41,196,147,49,336,247,82,257,197,42
060730026022,219,172,47,222,167,55,342,252,83,270,205,46
060730026023,203,160,43,205,154,51,409,297,97,324,247,54
060730025011,497,395,102,502,383,119,718,541,167,599,463,98
060730025023,141,117,24,143,118,25,340,258,73,215,167,31
060730025024,446,359,87,455,361,94,586,446,125,557,433,81
060730025022,326,258,68,334,259,75,432,333,92,321,249,47
060730025012,323,260,63,326,254,72,455,345,104,359,292,50
060730025013,303,244,59,308,238,70,626,469,146,505,407,73
060730024023,216,172,44,222,163,59,360,272,82,226,181,30
060730024022,207,164,43,212,155,57,364,271,82,244,196,32
060730024021,380,303,77,384,289,95,666,499,149,489,393,58
060730024011,226,188,38,229,185,44,288,215,63,168,137,20
060730024012,391,328,63,397,321,76,434,328,98,507,393,78
060730024013,439,374,65,445,369,76,463,348,104,564,436,89
060730025021,881,662,219,897,659,238,1286,927,325,1098,796,244
060730042001,1080,877,203,1098,880,218,1304,1079,189,1200,904,221
060730042004,431,353,78,437,353,84,606,502,89,466,353,82
060730043001,450,396,54,460,393,67,458,383,66,376,305,42
060730043002,960,828,132,987,833,154,1164,969,165,1136,919,142
060730043003,578,486,92,593,487,106,680,566,96,581,464,83
060730044002,648,554,94,667,564,103,768,640,105,814,667,100
060730044003,437,376,61,449,381,68,478,406,68,475,383,57
060730042003,454,381,73,464,381,83,568,482,82,411,324,62
060730044001,534,439,95,546,443,103,607,512,83,482,374,71
060730044004,411,336,75,420,342,78,444,380,62,437,346,69
060730041012,470,403,67,480,401,79,767,631,108,567,443,72
060730041013,632,548,84,649,535,114,869,715,128,758,605,98
060730040001,215,184,31,217,172,45,285,223,52,336,282,36
060730040002,127,109,18,128,103,25,149,120,28,178,150,19
060730040003,191,166,25,192,160,32,216,170,41,263,224,24
060730041011,297,255,42,303,254,49,370,306,53,322,250,40
060730060001,641,534,107,657,534,123,771,646,113,723,580,104
060730060002,622,474,148,637,484,153,786,654,115,647,481,133
060730060003,1092,800,292,1117,803,314,1396,1164,205,1052,747,247
060730059002,402,314,88,412,316,96,539,412,110,421,310,86
060730059003,327,256,71,336,258,78,428,329,88,410,300,83
060730061001,855,593,262,877,588,289,1167,872,268,893,594,228
060730059001,619,486,133,628,483,145,745,570,152,735,554,133
060730057001,209,165,44,217,164,53,345,269,72,184,135,36
060730057002,298,236,62,300,229,71,475,361,97,444,321,86
060730056011,445,325,120,456,326,130,569,406,150,524,353,137
060730056012,592,434,158,607,434,173,783,559,205,677,456,176
060730058022,408,295,113,421,295,126,582,415,153,612,422,147
060730058021,522,380,142,541,379,162,869,589,259,499,343,120
060730058012,297,229,68,303,223,80,536,386,142,394,278,76
060730058011,312,238,74,316,231,85,428,308,114,267,186,52
060730061002,284,209,75,290,207,83,397,298,93,299,202,74
060730036012,201,178,23,204,172,32,305,243,54,298,254,27
060730036031,241,200,41,241,192,49,306,238,55,372,304,45
060730036032,245,206,39,252,196,56,269,216,50,367,291,48
060730038001,57,48,9,57,45,12,1349,1066,249,339,263,49
060730039023,197,171,26,200,163,37,261,207,47,167,142,16
060730214013,223,126,97,235,134,101,286,184,93,210,105,89
060730214012,831,494,337,867,514,353,1111,780,303,857,514,292
060730214011,111,63,48,117,67,50,606,384,205,573,281,244
060730069002,533,337,196,561,347,214,558,387,159,634,372,217
060730069003,910,558,352,943,570,373,534,354,177,1051,615,368
060730214021,637,396,241,653,396,257,976,648,306,716,426,244
060730071001,1134,565,569,1167,580,587,922,551,343,801,393,363
060730071002,1514,791,723,1559,805,754,1354,818,508,1440,752,599
060730071003,381,192,189,393,197,196,408,244,151,578,305,239
060730099021,144,77,67,146,75,71,296,162,126,4,2,2
060730214022,547,333,214,559,323,236,838,555,271,646,378,227
060730074013,609,402,207,625,398,227,740,513,202,670,413,203
060730070021,902,516,386,928,520,408,1071,703,334,930,521,345
060730070022,880,448,432,903,453,450,1010,666,319,894,459,375
060730072001,804,433,371,819,431,388,1109,665,415,735,407,272
060730072003,537,296,241,548,298,250,985,597,369,729,408,266
060730053012,193,137,56,197,137,60,292,216,70,277,187,71
060730053013,257,184,73,265,184,81,377,274,93,358,246,90
060730053021,253,162,91,257,163,94,1667,1152,476,1185,714,414
060730053022,551,352,199,561,355,206,622,418,190,669,414,226
060730054012,254,169,85,261,172,89,286,195,86,365,236,102
060730054011,421,293,128,430,294,136,434,304,121,377,245,104
060730053011,608,425,183,627,428,199,739,544,179,326,221,84
060730054021,725,462,263,745,472,273,746,511,216,676,440,197
060730054022,526,341,185,544,348,196,693,492,181,281,183,83
060730054032,801,513,288,821,523,298,682,460,207,807,514,257
060730054031,412,265,147,420,270,150,719,486,218,548,348,162
060730054023,548,347,201,567,355,212,719,484,218,617,399,178
060730051012,281,217,64,291,210,81,312,221,82,240,172,51
060730051032,72,53,19,75,51,24,1085,764,286,591,391,154
060730051021,425,302,123,436,305,131,393,276,104,387,255,104
060730051022,461,328,133,473,330,143,464,327,123,424,279,115
060730056022,496,391,105,509,391,118,639,490,136,579,424,110
060730056021,479,378,101,493,378,115,491,364,112,478,349,91
060730052011,431,340,91,440,340,100,875,652,201,583,402,129
060730052023,633,484,149,644,481,163,721,538,164,498,344,108
060730052021,176,135,41,180,135,45,765,569,175,588,402,133
060730051011,247,198,49,254,199,55,790,559,207,355,259,69
060730052012,238,192,46,246,194,52,778,579,177,323,226,65
060730052022,343,257,86,354,258,96,491,367,112,403,283,82
060730051023,335,238,97,346,238,108,673,474,176,216,144,57
060730050001,393,338,55,398,322,76,697,564,120,524,422,67
060730051031,140,119,21,144,115,29,332,259,58,349,287,36
060730047001,177,151,26,179,149,30,165,136,29,217,169,28
060730047002,272,233,39,277,231,46,299,244,53,328,255,44
060730046001,627,531,96,645,534,111,701,587,98,692,548,86
060730046002,205,177,28,208,176,32,233,195,37,205,163,26
060730041021,560,485,75,574,481,93,868,711,129,750,590,99
060730048001,204,184,20,208,178,30,262,208,45,244,202,27
060730048002,320,285,35,324,276,48,440,341,73,388,320,42
060730045013,222,190,32,230,190,40,280,231,40,237,183,33
060730045011,531,471,60,537,474,63,780,643,109,638,502,72
060730045012,253,224,29,255,226,29,319,263,44,231,182,26
060730048003,216,183,33,222,178,44,382,304,65,286,246,25
060730036022,253,227,26,253,220,33,393,316,70,371,320,37
060730036011,261,221,40,263,216,47,473,374,85,390,336,33
060730035011,318,270,48,320,263,57,488,399,88,401,340,41
060730035022,317,276,41,320,267,53,529,428,96,499,437,41
060730035023,281,242,39,288,236,52,468,375,84,440,388,34
060730035021,153,131,22,158,129,29,223,178,40,193,170,14
060730035012,138,117,21,139,112,27,271,217,49,203,170,20
060730035013,133,112,21,132,108,24,292,234,51,245,210,25
060730039011,201,178,23,200,171,29,213,165,40,255,220,23
060730033011,321,277,44,325,268,57,463,377,80,496,428,42
060730033012,336,290,46,341,282,59,512,417,82,464,397,40
060730036021,233,201,32,234,194,40,419,333,75,380,325,37
060730036033,193,162,31,198,152,46,207,168,39,283,223,39
060730049002,317,276,41,317,265,52,400,319,69,368,316,33
060730049003,484,420,64,486,403,83,826,651,141,624,520,62
060730049001,183,160,23,186,152,34,371,290,63,309,263,30
060730039012,200,177,23,204,170,34,249,199,46,273,232,23
060730039013,227,201,26,228,191,37,284,227,53,321,271,31
060730039021,154,138,16,157,133,24,205,164,38,201,175,15
060730039024,146,130,16,147,124,23,164,133,31,196,171,15
060730040004,206,179,27,208,175,33,220,176,42,226,192,21
060730039022,219,193,26,223,191,32,264,206,48,79,63,10
060730031032,768,649,119,779,631,148,1209,835,363,869,714,113
060730031141,352,223,129,359,219,140,599,411,176,528,362,150
060730031142,550,347,203,558,345,213,894,615,267,841,531,276
060730031091,301,153,148,304,149,155,438,255,175,368,200,154
060730031092,294,149,145,298,145,153,465,274,187,368,201,154
060730031093,324,164,160,332,162,170,469,272,186,391,215,164
060730031131,834,591,243,841,570,271,1208,871,316,961,676,245
060730031152,364,237,127,368,229,139,594,350,240,349,229,109
060730031153,404,251,153,411,243,168,620,360,248,437,286,133
060730031154,557,328,229,573,326,247,843,493,338,607,361,217
060730031151,369,232,137,371,221,150,889,522,357,561,372,169
060730031031,608,508,100,618,501,117,1096,758,327,896,738,124
060730031033,443,373,70,447,363,84,654,449,194,419,346,55
060730141021,877,662,215,899,649,250,1310,968,314,1115,842,230
060730141022,318,244,74,330,235,95,551,397,140,437,311,104
060730031051,712,552,160,726,529,197,1131,817,285,995,752,186
060730031052,467,337,130,476,317,159,713,516,181,563,402,129
060730031071,857,555,302,873,530,343,1229,821,384,947,605,292
060730031072,557,425,132,567,420,147,897,647,231,730,532,154
060730031073,325,226,99,332,220,112,421,283,133,371,246,106
060730031012,445,398,47,450,389,61,531,411,113,465,408,45
060730031013,447,395,52,450,385,65,577,450,122,431,357,57
060730031113,564,371,193,572,366,206,783,600,164,814,646,135
060730031132,667,430,237,679,420,259,976,625,340,795,548,215
060730031011,349,314,35,356,309,47,420,323,89,414,369,30
060730030013,539,467,72,550,466,84,813,623,175,595,505,60
060730030041,504,435,69,511,416,95,947,720,199,680,560,79
060730031111,268,234,34,273,224,49,835,641,174,374,331,29
060730031112,414,358,56,423,344,79,790,608,166,369,328,27
060730030012,535,453,82,548,452,96,800,612,172,742,633,74
060730030011,397,349,48,405,351,54,439,337,95,354,305,35
060730031122,344,255,89,346,245,101,728,561,153,562,418,114
060730031123,296,255,41,301,244,57,457,350,95,597,455,119
060730119021,483,298,185,494,289,205,611,372,231,640,393,207
060730031121,352,264,88,356,256,100,670,523,142,472,354,93
060730030033,357,265,92,363,261,102,461,354,99,426,304,92
060730030034,333,266,67,341,262,79,350,250,94,455,348,80
060730030031,601,449,152,608,438,170,822,625,176,714,515,152
060730030032,425,316,109,427,307,120,657,500,140,548,390,121
060730142003,671,439,232,680,424,256,957,633,301,893,570,273
060730030042,437,363,74,448,352,96,685,520,143,632,506,91
060730034031,232,196,36,235,188,47,382,303,74,281,241,32
060730034032,321,271,50,329,263,66,561,442,107,470,395,50
060730034014,822,672,150,835,669,166,1130,891,221,1015,844,136
060730034041,331,291,40,333,273,60,606,502,97,447,379,44
060730034042,206,182,24,208,173,35,338,279,53,327,279,29
060730034043,284,254,30,291,244,47,415,340,64,356,304,31
060730034033,210,179,31,209,169,40,332,258,62,284,237,29
060730033032,376,322,54,379,312,67,676,526,137,473,407,38
060730033031,143,122,21,143,118,25,333,259,68,296,253,24
060730034013,244,203,41,246,198,48,501,390,96,314,254,44
060730033041,202,162,40,203,163,40,427,348,72,229,179,36
060730033042,290,232,58,291,234,57,629,513,103,422,330,66
060730033051,278,245,33,282,232,50,328,269,54,300,268,24
060730033052,403,363,40,409,352,57,671,550,111,699,625,58
060730033053,572,501,71,582,480,102,697,571,114,748,648,72
060730032141,693,493,200,703,478,225,964,651,302,722,492,196
060730032143,321,234,87,325,228,97,606,427,170,492,361,110
060730032081,303,196,107,306,191,115,564,357,197,458,318,123
060730032082,199,129,70,201,125,76,346,219,122,256,178,69
060730032085,654,429,225,667,426,241,754,477,263,725,478,213
060730032112,274,177,97,277,172,105,390,248,136,326,226,87
060730032012,434,279,155,442,277,165,716,464,237,486,314,141
060730032111,648,410,238,657,408,249,955,616,321,879,534,290
060730032121,405,259,146,415,262,153,662,424,227,490,325,147
060730032122,921,600,321,940,597,343,1312,837,451,1091,705,338
060730032131,595,344,251,606,326,280,816,509,293,651,369,245
060730032132,680,383,297,697,365,332,954,598,344,554,320,204
060730032091,524,361,163,531,364,167,1159,722,417,778,508,230
060730032092,449,332,117,455,312,143,730,454,262,716,520,167
060730032083,346,245,101,351,226,125,496,313,172,475,337,107
060730032084,316,223,93,321,206,115,401,255,139,348,250,78
060730032093,330,250,80,334,234,100,533,328,191,481,348,107
060730032022,836,598,238,852,585,267,1231,800,414,977,714,221
060730032011,252,152,100,258,152,106,396,253,139,197,122,63
060730032013,79,48,31,83,49,34,423,270,148,234,142,76
060730032014,83,50,33,84,51,33,408,259,142,208,127,67
060730032021,438,302,136,447,297,150,904,588,290,674,466,170
060730101031,421,319,102,428,305,123,816,512,290,597,435,132
060730105021,319,211,108,322,211,111,569,339,200,396,262,108
060730101032,498,346,152,509,321,188,919,563,322,531,385,120
060730101033,511,360,151,519,339,180,880,546,313,673,485,153
060730104011,574,394,180,584,384,200,947,558,352,729,477,200
060730101042,735,426,309,747,407,340,821,509,294,853,482,310
060730104021,450,291,159,459,281,178,759,459,278,561,377,149
060730104023,327,216,111,326,200,126,836,497,306,546,358,145
060730101101,420,320,100,428,305,123,753,464,267,612,439,137
060730101103,385,238,147,385,219,166,596,366,210,607,425,154
060730101104,336,201,135,338,186,152,635,425,195,412,231,152
060730101102,516,335,181,522,338,184,654,469,173,708,496,181
060730101122,123,99,24,126,95,31,580,416,150,328,224,91
060730101123,216,174,42,219,165,54,422,304,110,433,354,56
060730101121,467,383,84,471,364,107,955,656,274,647,527,84
060730101092,716,529,187,720,510,210,1082,740,316,1082,819,219
060730101041,416,242,174,423,227,196,601,377,209,327,184,121
060730102011,478,270,208,482,263,219,591,324,251,601,358,198
060730101105,295,191,104,302,182,120,404,268,124,369,235,111
060730101091,557,383,174,570,370,200,739,495,228,650,446,170
060730100091,388,330,58,391,314,77,757,547,191,502,405,74
060730100094,295,255,40,296,240,56,490,354,123,696,611,62
060730100134,236,202,34,237,193,44,508,375,118,438,383,37
060730101071,669,501,168,672,483,189,1141,795,320,878,667,159
060730101072,245,173,72,249,165,84,399,283,107,315,228,71
060730101062,369,320,49,373,306,67,555,399,144,729,620,78
060730101073,452,351,101,458,335,123,657,466,176,570,426,118
060730101074,322,215,107,330,208,122,474,336,133,366,254,95
060730100012,795,520,275,803,500,303,1264,836,401,963,644,271
060730101061,538,421,117,545,407,138,883,633,238,819,659,123
060730101063,317,260,57,319,243,76,586,409,164,504,415,63
060730101112,358,304,54,361,286,75,879,613,247,637,534,79
060730101111,457,392,65,456,360,96,511,359,144,443,372,55
060730100011,393,276,117,396,266,130,651,433,207,622,430,164
060730100112,513,371,142,522,365,157,959,646,295,860,613,200
060730100102,609,429,180,613,422,191,939,656,264,793,591,166
060730100042,747,572,175,752,551,201,1087,744,325,1043,795,197
060730100101,432,310,122,443,310,133,718,505,203,609,442,138
060730100103,470,339,131,480,335,145,702,477,212,593,439,124
060730100111,476,359,117,485,349,136,704,465,223,599,426,137
060730100033,436,335,101,446,328,118,656,436,203,559,389,133
060730100034,485,336,149,494,319,175,687,451,211,529,363,134
060730100032,471,325,146,473,309,164,700,467,218,617,429,161
060730100031,509,353,156,515,338,177,768,510,239,748,519,195
060730100041,627,477,150,636,455,181,971,642,313,924,689,188
060730100051,691,570,121,694,541,153,813,604,192,743,603,107
060730100052,349,295,54,353,278,75,377,278,89,352,287,51
060730100053,587,505,82,591,488,103,897,667,212,1046,884,107
060730100054,199,171,28,200,166,34,329,243,77,530,454,47
060730100151,521,394,127,523,368,155,768,516,238,709,540,133
060730100171,845,581,264,860,561,299,1480,992,461,853,589,230
060730100172,536,386,150,542,375,167,982,657,307,879,638,207
060730100181,546,381,165,549,362,187,841,538,289,834,610,189
060730100182,345,243,102,343,229,114,936,621,297,548,400,118
060730100183,736,528,208,747,502,245,1058,708,329,747,535,175
060730100192,666,451,215,676,430,246,1059,662,375,841,578,229
060730100152,242,207,35,241,195,46,808,563,229,393,309,63
060730100093,39,35,4,39,33,6,269,195,69,307,270,27
060730100132,147,125,22,147,118,29,311,233,74,295,261,20
060730100121,363,308,55,369,293,76,728,540,175,477,404,44
060730100123,341,292,49,347,283,64,487,359,115,513,438,50
060730100122,153,134,19,155,132,23,384,285,91,289,249,30
060730100131,281,242,39,286,230,56,733,548,174,533,475,37
060730100191,226,161,65,226,152,74,674,431,232,136,100,31
060730100161,27,18,9,27,17,10,11,7,4,21,16,5
060730100133,259,213,46,258,194,64,494,367,116,347,298,36
060730100092,601,479,122,605,463,142,779,564,197,535,433,79
060730185211,578,305,273,585,301,284,784,442,327,573,275,268
060730185212,1049,590,459,1065,575,490,1513,854,611,1043,479,494
060730185121,797,440,357,809,437,372,881,500,357,595,311,252
060730185233,501,240,261,512,235,277,742,428,292,469,238,203
060730186081,1067,536,531,1086,522,564,895,514,359,899,417,426
060730186171,1004,526,478,1018,521,497,1001,586,386,841,355,435
060730186172,331,209,122,337,209,128,475,279,183,486,294,167
060730186193,738,341,397,766,346,420,1267,603,629,963,430,474
060730186092,379,255,124,384,247,137,714,421,274,361,235,105
060730186202,385,237,148,393,230,163,564,337,204,413,240,140
060730186121,1103,525,578,1122,517,605,1442,725,681,958,428,463
060730186122,459,256,203,468,252,216,632,365,242,598,314,240
060730185042,844,454,390,857,455,402,960,535,396,884,459,375
060730185043,1132,555,577,1166,565,601,1193,665,491,1036,500,486
060730185112,275,166,109,282,164,118,286,174,106,257,130,108
060730186183,237,168,69,240,167,73,656,383,249,327,213,91
060730186181,173,123,50,176,123,53,337,196,128,285,187,80
060730186182,227,161,66,229,160,69,655,384,251,330,215,92
060730186082,236,132,104,242,127,115,450,254,182,439,212,192
060730186091,734,392,342,755,398,357,872,504,339,1033,477,503
060730186093,526,322,204,539,320,219,1026,603,392,636,411,185
060730186192,582,249,333,602,253,349,414,180,222,434,171,232
060730186194,603,267,336,612,268,344,882,416,438,634,251,332
060730186201,305,185,120,309,179,130,567,342,207,382,225,132
060730185201,536,331,205,544,315,229,788,442,323,654,364,239
060730193012,1230,587,643,1256,583,673,1322,684,598,1319,599,639
060730193013,1260,576,684,1296,574,722,1692,855,802,1069,468,525
060730193032,1178,514,664,1217,498,719,1522,699,785,1330,563,689
060730193031,1005,450,555,1038,432,606,1418,647,736,1075,430,582
060730193011,644,308,336,662,308,354,810,404,387,834,369,418
060730185251,1158,513,645,1189,525,664,1504,708,771,1374,600,695
060730185203,571,365,206,576,361,215,949,545,371,556,304,220
060730185241,794,445,349,816,454,362,868,504,342,631,320,269
060730185242,474,287,187,484,288,196,845,488,333,565,307,228
060730185231,777,430,347,790,428,362,1155,668,455,1193,604,502
060730185232,386,204,182,394,203,191,515,299,205,377,179,176
060730185222,637,342,295,646,332,314,831,479,330,863,419,406
060730185252,950,418,532,973,427,546,1262,595,648,903,396,463
060730185221,766,442,324,778,436,342,1221,698,489,685,370,265
060730185202,542,300,242,554,294,260,921,514,377,694,367,253
060730185223,249,149,100,249,141,108,740,449,272,400,218,157
060730185122,588,344,244,600,344,256,724,417,297,593,319,257
060730186131,396,214,182,409,215,194,462,262,188,403,217,158
060730186211,619,364,255,628,359,269,716,406,291,539,301,206
060730186222,793,431,362,812,432,380,1099,625,446,895,467,379
060730186223,518,297,221,529,294,235,511,291,210,415,230,162
060730186133,206,118,88,211,119,92,510,289,207,247,135,96
060730186221,175,100,75,179,99,80,628,356,255,539,299,206
060730186132,502,299,203,509,304,205,833,472,336,604,326,216
060730186013,601,249,352,613,245,368,648,372,256,347,176,148
060730186012,782,366,416,805,363,442,818,471,322,1180,548,567
060730193051,693,363,330,707,364,343,1256,644,577,1102,543,491
060730193052,837,435,402,854,436,418,958,501,440,625,292,297
060730184002,530,335,195,541,323,218,486,294,178,382,204,151
060730186152,167,117,50,169,113,56,416,239,163,272,178,73
060730186161,344,231,113,351,227,124,717,415,281,357,198,135
060730186163,234,163,71,239,158,81,408,235,160,442,285,126
060730186151,131,95,36,135,91,44,385,222,153,229,152,58
060730186162,337,242,95,343,232,111,562,323,221,321,214,79
060730186153,223,160,63,228,155,73,468,273,187,300,197,74
060730186011,461,230,231,471,222,249,625,362,246,607,269,287
060730187001,739,377,362,753,365,388,2436,1077,1190,1410,478,764
060730183012,241,118,123,246,121,125,259,155,94,238,120,98
060730183022,233,121,112,233,120,113,335,201,122,223,115,91
060730184001,406,241,165,419,236,183,536,323,196,484,246,200
060730184003,393,247,146,405,245,160,641,382,234,263,161,82
060730182011,621,401,220,634,397,237,795,481,294,596,330,228
060730182021,194,132,62,201,130,71,460,277,168,311,186,100
060730182023,433,272,161,439,273,166,492,302,182,509,266,204
060730182022,183,125,58,187,122,65,497,296,180,283,171,86
060730183011,174,110,64,177,109,68,212,129,80,198,106,75
060730183021,224,143,81,229,141,88,292,175,108,279,150,107
060730182012,241,164,77,249,161,88,580,348,212,295,179,89
060730181011,678,405,273,696,400,296,961,551,378,719,382,287
060730181023,284,178,106,296,179,117,434,242,181,327,182,123
060730193042,1002,510,492,1026,504,522,1331,691,604,997,467,465
060730193041,397,224,173,407,220,187,625,325,282,734,381,315
060730185091,252,156,96,258,155,103,622,374,230,427,239,162
060730185092,349,215,134,355,214,141,627,379,233,477,253,189
060730185093,278,170,108,284,171,113,459,276,169,299,164,115
060730185094,203,125,78,208,126,82,271,163,100,157,82,62
060730185111,336,207,129,344,208,136,473,284,175,319,169,126
060730185101,549,320,229,559,322,237,779,470,287,439,213,186
060730185102,438,264,174,447,260,187,579,350,214,408,229,145
060730185113,282,171,111,289,171,118,265,160,98,237,133,89
060730185114,526,318,208,537,318,219,945,570,349,812,472,284
060730185123,543,298,245,555,303,252,779,451,321,775,413,342
060730185191,559,361,198,574,351,223,666,411,235,564,344,184
060730185194,245,177,68,251,173,78,604,398,185,358,233,98
060730185192,374,240,134,387,236,151,539,334,189,520,314,170
060730185161,1043,562,481,1066,561,505,1261,723,504,986,510,408
060730185162,340,199,141,346,195,151,626,359,250,320,167,126
060730185171,438,251,187,446,249,197,664,363,284,810,417,335
060730194031,1720,980,740,1762,974,788,1991,1130,816,1824,986,701
060730194032,231,121,110,237,120,117,541,310,214,268,129,119
060730194051,435,250,185,447,252,195,406,244,151,395,203,160
060730193033,889,500,389,906,494,412,1455,818,600,929,479,390
060730185181,377,242,135,387,243,144,607,374,213,399,236,135
060730185182,448,289,159,459,289,170,709,439,250,505,300,174
060730185193,183,128,55,190,127,63,410,264,134,266,169,80
060730198051,1022,618,404,1048,615,433,1442,887,514,1150,648,417
060730198052,352,198,154,361,195,166,427,250,168,394,204,163
060730198102,810,421,389,843,417,426,1139,620,498,905,483,356
060730198091,829,417,412,849,409,440,1098,588,486,964,444,460
060730198093,652,319,333,667,315,352,763,416,339,638,306,300
060730198081,710,363,347,723,366,357,760,414,330,633,324,287
060730198083,1502,743,759,1530,769,761,1443,794,624,1503,767,689
060730198101,2027,1062,965,2091,1041,1050,2623,1502,1065,2382,1186,1022
060730198092,815,351,464,831,350,481,981,535,426,877,370,447
060730199041,1012,482,530,1035,477,558,1347,688,626,1239,573,590
060730198082,757,402,355,768,390,378,1263,689,549,920,459,406
060730185152,877,434,443,897,435,462,1412,774,606,792,402,341
060730185153,905,463,442,922,462,460,1044,568,445,1320,614,625
060730185172,486,265,221,500,268,232,646,356,277,470,238,204
060730185173,661,364,297,681,369,312,969,531,416,709,342,321
060730185151,410,184,226,420,181,239,444,242,189,366,153,191
060730198031,878,544,334,896,541,355,1699,1042,618,780,425,284
060730185044,359,215,144,371,217,154,716,399,295,526,280,205
060730185045,344,207,137,356,209,147,574,319,236,418,223,163
060730185041,567,287,280,593,290,303,768,428,318,629,300,296
060730181013,457,259,198,470,262,208,532,297,219,457,233,197
060730181012,415,240,175,425,241,184,534,305,222,425,234,164
060730181021,477,276,201,492,277,215,630,352,261,482,264,186
060730181022,281,179,102,294,180,114,500,281,208,353,196,133
060730180001,379,219,160,388,217,171,347,215,126,398,211,162
060730179011,804,509,295,827,514,313,1091,675,393,825,465,293
060730200351,807,455,352,827,451,376,871,519,329,655,351,270
060730200354,853,458,395,878,471,407,1088,678,389,1055,576,430
060730200352,598,333,265,615,334,281,834,507,304,537,299,211
060730200353,548,303,245,564,305,259,580,354,212,525,284,218
060730171091,1232,609,623,1276,628,648,1720,1004,680,1323,683,560
060730171112,1191,585,606,1230,605,625,1606,925,645,1131,569,495
060730221023,840,438,402,862,436,426,1298,806,469,700,361,289
060730221024,495,280,215,504,281,223,431,265,159,485,272,182
060730200302,1156,595,561,1184,606,578,1571,926,623,1163,591,498
060730200303,1184,603,581,1210,608,602,1473,843,607,1230,619,554
060730221021,947,503,444,972,497,475,1116,647,443,1146,601,483
060730221022,677,377,300,698,381,317,1103,640,438,512,282,194
060730200332,961,514,447,988,522,466,1326,755,548,1045,540,432
060730200322,795,416,379,823,425,398,1351,768,558,1228,651,501
060730200311,1008,540,468,1031,540,491,1528,893,600,1219,665,480
060730200313,932,476,456,949,468,481,969,532,419,696,358,306
060730200312,1210,671,539,1231,663,568,1499,875,588,1164,640,462
060730178111,639,395,244,650,404,246,779,448,310,803,460,293
060730178114,569,300,269,582,308,274,788,454,314,611,315,267
060730198033,504,277,227,525,284,241,605,349,241,484,237,210
060730198032,685,343,342,710,352,358,998,555,416,862,408,385
060730198043,1068,570,498,1095,581,514,1251,719,499,1230,620,532
060730200321,957,501,456,992,503,489,1105,630,462,913,478,386
060730200152,603,344,259,614,339,275,764,450,299,590,326,232
060730200153,597,359,238,613,348,265,923,577,329,904,509,349
060730171094,1087,600,487,1112,601,511,1318,785,507,960,512,378
060730171132,952,486,466,979,495,484,1515,887,599,797,417,328
060730178011,884,477,407,906,476,430,1032,580,430,978,497,417
060730178012,738,409,329,759,404,355,613,365,232,492,244,213
060730200151,1405,721,684,1443,714,729,1699,1018,651,1535,741,694
060730180003,565,320,245,587,318,269,697,427,252,690,381,256
060730180002,301,173,128,306,170,136,367,227,133,284,151,115
060730176011,620,434,186,640,439,201,741,499,226,709,469,190
060730178131,1026,478,548,1063,486,577,1321,701,596,1045,540,468
060730178133,596,302,294,613,310,303,1154,651,470,936,447,454
060730178132,647,303,344,659,306,353,573,290,269,519,219,267
060730200301,793,457,336,812,475,337,1213,702,487,946,536,353
060730179012,392,252,140,404,253,151,564,352,204,341,203,115
060730171093,442,242,200,458,243,215,814,482,313,712,368,285
060730221011,1018,527,491,1049,528,521,1480,804,637,1435,710,645
060730179013,328,221,107,341,220,121,569,354,205,608,376,186
060730179021,608,410,198,629,406,223,1013,622,363,725,416,261
060730179022,535,324,211,548,320,228,640,387,240,336,190,123
060730178115,830,406,424,855,417,438,1070,608,440,838,417,380
060730178112,948,507,441,977,502,475,1259,716,516,910,484,367
060730180004,264,148,116,275,147,128,277,170,99,319,179,114
060730178082,1088,534,554,1122,557,565,1389,790,570,1174,624,478
060730176013,687,301,386,709,311,398,744,390,345,640,285,328
060730176014,868,495,373,898,512,386,924,621,282,773,447,272
060730178113,394,215,179,406,210,196,582,332,239,623,296,299
060730178084,901,500,401,921,496,425,1164,673,475,1022,531,424
060730178081,806,374,432,821,376,445,928,504,413,671,314,323
060730221012,246,141,105,248,141,107,217,110,105,280,134,127
060730178101,1164,590,574,1186,584,602,1505,819,658,1249,613,545
060730178102,686,364,322,703,361,342,837,456,362,692,320,329
060730178091,1357,667,690,1395,678,717,1684,900,747,1288,598,586
060730178103,977,496,481,1009,506,503,1111,613,475,1158,583,492
060730178083,788,370,418,805,367,438,822,440,372,635,297,307
060730200421,684,386,298,697,390,307,1048,649,373,275,152,105
060730198042,591,266,325,601,256,345,691,342,341,450,216,201
060730198041,1212,583,629,1262,601,661,1068,584,460,926,397,466
060730178013,1135,562,573,1169,574,595,1518,803,677,1171,586,518
060730178014,562,357,205,574,348,226,1169,693,438,821,467,291
060730198113,710,405,305,730,413,317,1109,633,462,979,503,421
060730198114,795,455,340,819,466,353,1695,958,706,557,287,242
060730171092,582,301,281,607,312,295,678,403,259,621,343,234
060730198111,798,436,362,825,435,390,1018,549,443,790,404,339
060730200333,434,248,186,448,250,198,496,282,204,417,236,154
060730200331,463,289,174,478,290,188,650,420,219,603,369,193
060730200341,1549,901,648,1586,906,680,1941,1214,694,1567,881,578
060730200355,962,498,464,988,507,481,1110,658,426,976,545,359
060730171071,1003,615,388,1030,623,407,1239,818,387,1013,614,335
060730198112,539,219,320,547,226,321,501,276,223,420,218,185
060730177014,467,308,159,474,302,172,536,360,164,449,264,147
060730177015,446,293,153,449,288,161,647,436,198,550,343,164
060730176031,615,448,167,633,450,183,734,506,207,640,435,160
060730177013,672,492,180,691,499,192,1071,720,326,816,549,201
060730177021,616,434,182,633,440,193,782,542,222,598,400,157
060730177022,429,299,130,439,303,136,589,409,167,468,302,134
060730177011,682,466,216,706,469,237,613,412,187,373,237,113
060730177012,354,237,117,367,238,129,632,425,193,575,367,172
060730171041,1432,864,568,1481,881,600,1564,1057,467,882,535,294
060730171072,695,422,273,709,424,285,758,493,247,698,430,222
060730176052,875,502,373,895,508,387,960,579,361,965,538,371
060730176061,953,581,372,975,580,395,1088,677,390,993,551,390
060730176062,790,553,237,809,559,250,942,639,282,1051,714,264
060730176012,923,559,364,949,563,386,1221,823,373,1186,698,421
060730176032,682,500,182,702,504,198,903,643,235,651,433,172
060730176051,797,518,279,812,527,285,1228,834,368,1022,616,340
060730171042,745,497,248,769,499,270,842,578,240,1270,799,384
060730171083,655,448,207,676,453,223,705,487,202,727,473,202
060730174031,749,445,304,771,459,312,833,523,290,647,374,239
060730174032,811,455,356,835,461,374,878,557,301,723,413,266
060730171061,823,320,503,849,328,521,1034,497,523,824,358,432
060730171111,1146,458,688,1163,454,709,1397,637,739,1368,575,726
060730171121,1240,633,607,1268,648,620,1617,921,659,1175,624,479
060730171084,481,305,176,494,301,193,797,507,275,543,344,157
060730174034,825,489,336,850,495,355,1201,760,418,1080,611,411
060730174033,647,413,234,675,421,254,963,621,323,759,459,244
060730174061,587,366,221,603,370,233,632,436,182,591,368,182
060730174062,535,327,208,552,332,220,507,348,149,455,286,146
060730174052,582,427,155,596,433,163,699,482,198,565,376,146
060730174053,762,531,231,782,540,242,938,650,268,625,412,164
060730177023,447,306,141,454,308,146,629,436,178,537,360,150
060730175021,437,307,130,447,305,142,655,469,170,390,263,100
060730175022,559,392,167,574,392,182,774,552,200,525,352,135
060730175011,387,278,109,400,281,119,342,245,89,407,271,103
060730175012,559,382,177,583,391,192,643,468,171,614,388,173
060730171082,904,597,307,925,614,311,1158,786,352,1046,656,316
060730171081,516,312,204,532,319,213,634,419,207,544,338,180
060730174051,467,343,124,480,349,131,732,507,210,701,466,182
060730175023,458,363,95,467,369,98,876,621,226,477,333,111
060730174063,515,313,202,534,316,218,597,412,170,521,323,164
060730175013,771,591,180,794,585,209,714,517,188,801,581,169
060730174071,1060,726,334,1092,726,366,1234,856,353,1093,729,294
060730174072,655,444,211,672,444,228,783,546,224,832,542,236
060730174082,674,470,204,688,467,221,839,587,240,658,425,185
060730174081,669,463,206,682,461,221,916,635,261,660,429,184
060730173032,744,517,227,767,527,240,904,645,235,570,404,146
060730173051,716,391,325,732,391,341,734,443,279,598,335,232
060730173053,670,360,310,688,366,322,820,510,291,631,342,258
060730173052,461,234,227,471,245,226,530,309,210,540,293,210
060730173081,504,335,169,518,326,192,814,542,253,385,226,130
060730173072,723,467,256,740,469,271,879,598,260,847,536,263
060730173082,803,525,278,825,519,306,1134,732,374,843,505,287
060730173031,613,410,203,636,416,220,838,588,227,937,594,289
060730173033,380,248,132,391,248,143,416,296,113,465,292,137
060730173071,504,295,209,513,301,212,579,377,189,437,269,145
060730172011,753,450,303,787,470,317,911,576,308,645,396,215
060730172021,649,364,285,669,374,295,691,440,238,624,361,217
060730172012,419,238,181,433,246,187,584,371,201,465,274,164
060730172022,767,487,280,794,490,304,893,568,307,910,603,260
060730189031,815,321,494,831,322,509,974,402,552,530,192,305
060730189033,533,287,246,545,277,268,728,368,344,553,272,242
060730189034,234,141,93,238,134,104,266,148,110,250,137,95
060730189042,273,145,128,277,140,137,352,201,144,346,169,156
060730189032,194,73,121,198,74,124,517,206,297,308,105,185
060730190012,805,310,495,821,303,518,1158,466,673,1080,381,644
060730188012,903,308,595,922,300,622,1117,442,655,980,329,602
060730188042,1132,345,787,1172,350,822,1177,453,703,1060,309,693
060730188051,845,286,559,867,283,584,1091,440,631,907,285,580
060730188052,894,342,552,911,337,574,1286,513,750,875,301,540
060730190014,578,208,370,582,205,377,713,281,418,661,218,417
060730190021,828,357,471,844,343,501,1788,814,918,704,277,385
060730189043,289,145,144,293,141,152,430,216,202,343,165,155
060730189044,754,338,416,766,333,433,1031,521,484,863,380,435
060730189053,614,275,339,618,263,355,583,294,272,470,209,233
060730190013,1108,401,707,1127,401,726,1501,603,869,1146,372,715
060730189063,1047,357,690,1068,357,711,1575,605,936,1122,419,658
060730188011,1033,352,681,1044,344,700,1249,501,727,1055,345,656
060730188043,1140,374,766,1172,379,793,1409,543,842,1202,389,758
060730189041,152,99,53,155,95,60,336,189,139,140,84,43
060730189051,257,166,91,261,161,100,615,344,253,309,185,91
060730189052,131,83,48,132,82,50,509,260,234,182,109,53
060730189061,338,191,147,345,186,159,698,389,287,474,247,188
060730189062,247,122,125,255,120,135,360,199,147,354,168,167
060730189054,566,260,306,573,249,324,637,320,299,950,379,522
060730188041,905,284,621,925,281,644,1015,408,586,1019,313,668
060730188031,348,111,237,360,106,254,561,184,368,377,102,260
060730186191,780,254,526,801,260,541,1046,400,621,807,272,496
060730188034,862,298,564,882,292,590,1072,434,619,839,272,521
060730188032,569,200,369,581,198,383,628,226,392,476,161,292
060730188033,536,249,287,549,248,301,838,358,462,610,252,315
060730192051,328,206,122,336,201,135,414,258,148,254,134,99
060730192061,299,203,96,304,196,108,561,381,160,441,270,140
060730192062,390,254,136,399,246,153,575,371,190,430,239,165
060730192052,686,372,314,701,365,336,899,519,359,593,317,233
060730192053,394,214,180,405,215,190,610,355,241,805,430,332
060730192032,790,412,378,813,414,399,1084,557,498,963,473,433
060730194052,186,117,69,193,118,75,389,232,144,392,201,159
060730194053,332,240,92,338,235,103,623,372,233,282,182,77
060730194063,522,307,215,535,306,229,620,373,229,546,287,216
060730195022,346,240,106,353,235,118,437,287,136,269,182,65
060730195032,259,142,117,264,142,122,548,291,242,423,210,192
060730196013,770,409,361,792,404,388,1175,603,536,985,495,421
060730196021,605,303,302,621,310,311,729,374,332,624,284,306
060730192092,985,341,644,1006,333,673,1170,470,679,1074,373,645
060730192091,698,294,404,715,303,412,947,437,486,774,323,400
060730192101,987,469,518,1012,470,542,1311,679,600,751,353,346
060730196011,713,346,367,739,342,397,1296,664,593,704,290,367
060730192082,1005,409,596,1026,416,610,1062,515,525,1123,428,620
060730196022,1082,504,578,1105,513,592,1209,601,578,1076,458,562
060730199044,569,286,283,581,283,298,678,366,297,553,241,278
060730199051,730,374,356,748,373,375,839,477,344,548,278,240
060730199052,458,230,228,469,227,242,685,389,280,476,241,208
060730199053,619,337,282,631,331,300,981,531,432,1110,539,491
060730196023,284,150,134,291,150,141,706,414,266,575,279,253
060730197023,494,268,226,509,266,243,467,276,173,353,173,152
060730199021,996,518,478,1017,508,509,1238,666,544,967,462,452
060730192103,156,103,53,159,104,55,303,175,119,232,122,93
060730196012,357,194,163,367,189,178,552,282,252,434,226,175
060730196014,385,210,175,396,204,192,499,257,227,608,273,291
060730192063,229,149,80,237,144,93,316,198,108,295,167,108
060730195023,206,134,72,214,129,85,373,234,127,240,144,74
060730192054,271,150,121,275,144,131,243,142,96,185,97,77
060730194041,368,252,116,373,244,129,369,254,105,334,208,104
060730194042,361,280,81,369,273,96,497,340,142,341,246,71
060730195011,242,188,54,248,183,65,489,332,139,352,255,73
060730195012,210,150,60,214,147,67,408,281,117,369,249,96
060730195021,194,169,25,198,166,32,544,374,156,259,209,33
060730192102,210,136,74,213,137,76,479,298,170,545,298,209
060730195031,397,292,105,410,287,123,850,508,318,524,328,167
060730195033,435,266,169,449,263,186,666,404,243,410,247,138
060730194061,529,312,217,544,315,229,474,287,174,542,273,231
060730194062,529,313,216,544,317,227,894,541,328,654,363,237
060730197011,1626,859,767,1661,846,815,2746,1467,1208,1849,906,815
060730197012,506,267,239,521,264,257,654,339,299,434,212,193
060730197021,458,211,247,465,201,264,400,207,182,444,178,233
060730197024,850,395,455,875,393,482,880,461,397,867,351,455
060730197022,351,186,165,367,185,182,442,251,176,341,165,149
060730199031,1080,494,586,1103,499,604,1263,604,631,855,359,451
060730199043,564,320,244,577,315,262,1000,530,449,604,271,289
060730199042,428,246,182,435,242,193,713,406,289,512,243,228
060730200171,470,239,231,478,241,237,542,318,216,419,209,183
060730200172,313,185,128,319,184,135,439,264,165,370,187,156
060730192031,423,188,235,433,185,248,527,260,253,477,205,249
060730192081,678,277,401,688,279,409,891,404,466,664,251,370
060730199022,288,146,142,291,138,153,522,282,227,405,200,178
060730199032,917,440,477,937,442,495,1406,675,706,1081,512,503
060730200173,107,74,33,107,71,36,291,160,126,287,132,142
060730200261,405,186,219,415,191,224,617,301,310,557,247,286
060730200263,861,388,473,882,388,494,1038,533,491,1288,538,685
060730200444,1364,674,690,1399,668,731,1878,1028,819,574,263,278
060730200443,1357,719,638,1395,722,673,1782,964,785,1631,805,714
060730200422,1259,573,686,1288,585,703,1402,696,686,1005,439,541
060730200193,1240,666,574,1269,661,608,1801,984,779,1617,786,737
060730200361,223,141,82,229,139,90,487,309,163,257,181,64
060730200381,749,410,339,765,403,362,1627,925,660,982,507,411
060730200391,833,459,374,856,452,404,1204,686,490,1030,561,408
060730200213,411,245,166,417,238,179,425,255,159,399,210,163
060730200212,400,218,182,404,211,193,644,366,260,386,203,157
060730200214,430,290,140,434,281,153,601,414,174,481,318,132
060730200211,205,140,65,207,136,71,389,269,112,368,250,95
060730200412,469,246,223,482,244,238,702,420,263,604,331,229
060730200231,914,554,360,934,540,394,1301,748,519,853,437,358
060730200382,1111,569,542,1134,546,588,1593,824,728,1041,500,476
060730200401,1300,611,689,1337,606,731,1691,848,799,1333,565,680
060730203044,1736,771,965,1771,750,1021,1193,595,573,933,402,477
060730200411,372,205,167,385,205,180,498,330,159,695,361,291
060730200402,713,311,402,731,308,423,903,454,425,627,276,307
060730200294,253,148,105,260,145,115,339,179,154,444,219,194
060730200293,400,234,166,411,230,181,619,404,197,448,268,153
060730200262,934,478,456,957,470,487,1033,571,444,986,491,431
060730200441,339,186,153,347,182,165,716,401,295,465,244,194
060730200232,858,431,427,870,435,435,1182,597,560,991,434,500
060730200241,902,457,445,919,452,467,1151,581,543,1051,489,502
060730200242,331,181,150,336,177,159,479,268,193,296,134,133
060730200251,521,289,232,532,284,248,908,512,366,671,346,280
060730200252,532,313,219,549,306,243,662,372,270,542,284,219
060730200291,394,261,133,401,254,147,570,392,163,329,165,142
060730200292,200,133,67,203,129,74,491,338,141,259,194,45
060730203111,890,386,504,909,375,534,891,443,427,1119,475,591
060730203103,677,320,357,695,312,383,673,345,314,616,289,289
060730200253,669,352,317,685,349,336,782,401,364,849,407,389
060730203091,735,350,385,749,347,402,1125,597,494,825,348,415
060730200243,448,219,229,460,213,247,586,329,237,456,204,208
060730200362,296,201,95,303,197,106,634,399,215,345,243,84
060730200371,164,111,53,167,109,58,377,236,128,378,194,157
060730200372,929,576,353,957,563,394,1045,637,379,1021,591,373
060730200192,647,370,277,651,360,291,888,515,358,647,353,267
060730200191,1150,561,589,1174,563,611,1312,737,555,1100,510,553
060730203102,347,212,135,357,211,146,480,294,174,412,208,177
060730203101,1236,806,430,1270,799,471,2595,1498,1032,1516,893,509
060730171131,842,459,383,865,445,420,1186,697,464,968,496,404
060730200442,302,153,149,310,150,160,401,220,175,295,150,128
060730200431,1358,686,672,1407,694,713,1832,1067,725,1525,784,652
060730200432,883,493,390,912,500,412,1428,838,560,1093,585,444
060730200283,134,106,28,136,101,35,140,97,40,139,105,24
060730200282,64,51,13,67,50,17,381,262,109,85,64,15
060730200281,170,134,36,173,129,44,436,301,125,249,185,44
060730203112,462,243,219,478,241,237,1086,598,463,156,70,77
060730203121,909,406,503,932,405,527,1249,599,623,1139,460,592
060730203131,469,229,240,482,229,253,806,406,375,700,294,351
060730170641,552,326,226,564,324,240,968,609,347,640,381,227
060730170642,682,409,273,698,413,285,1275,795,452,919,573,303
060730170643,725,427,298,744,430,314,1211,753,437,817,476,297
060730170703,293,180,113,301,184,117,548,351,188,397,229,142
060730170701,905,498,407,928,504,424,1284,782,478,1055,607,400
060730170702,863,474,389,886,475,411,1241,763,451,885,508,335
060730170712,895,487,408,911,489,422,1320,806,489,1129,614,444
060730171062,649,253,396,666,244,422,869,408,441,720,297,386
060730170612,1445,528,917,1485,533,952,1624,788,810,1370,550,753
060730170623,509,178,331,527,177,350,703,321,367,524,211,287
060730171064,644,236,408,657,231,426,800,345,442,659,264,369
060730171063,729,257,472,745,251,494,829,375,442,779,305,436
060730111002,607,278,329,621,287,334,538,286,239,652,303,303
060730111003,345,155,190,352,161,191,299,161,136,380,181,179
060730218002,497,217,280,519,233,286,429,225,192,591,262,283
060730109001,415,189,226,425,189,236,315,166,141,443,205,208
060730110001,632,292,340,644,304,340,708,373,316,674,337,298
060730111001,896,443,453,910,439,471,787,415,350,973,464,440
060730110002,654,295,359,670,295,375,560,299,256,724,343,337
060730216001,194,80,114,200,83,117,971,508,431,482,207,241
060730216002,346,143,203,358,153,205,574,301,256,129,55,65
060730218001,470,204,266,487,217,270,408,219,186,544,257,262
060730108001,558,259,299,570,264,306,549,289,247,682,321,329
060730108002,571,265,306,591,275,316,446,241,203,649,289,313
060730109002,460,213,247,476,223,253,376,201,172,563,260,267
060730106012,596,257,339,609,262,347,756,382,364,663,283,353
060730106011,524,191,333,539,203,336,652,328,314,584,248,313
060730102021,333,190,143,340,187,153,564,308,232,418,208,177
060730102022,385,210,175,385,202,183,600,331,255,463,252,173
060730102013,245,140,105,247,135,112,340,186,146,264,130,114
060730105011,452,265,187,460,258,202,637,358,255,632,323,256
060730105023,330,210,120,342,209,133,559,345,201,430,279,129
060730105024,303,182,121,308,179,129,508,310,181,364,224,114
060730105022,227,139,88,231,137,94,415,237,162,292,193,80
060730103003,307,190,117,308,184,124,546,312,222,496,272,185
060730103004,280,165,115,287,161,126,336,193,139,329,181,127
060730102023,392,227,165,398,219,179,537,305,216,412,217,162
060730102012,376,195,181,387,194,193,465,260,203,435,191,216
060730103001,284,162,122,286,155,131,436,233,183,391,181,182
060730103002,496,275,221,502,264,238,736,385,329,564,340,195
060730104022,290,143,147,295,138,157,377,222,139,452,233,195
060730191091,961,364,597,995,358,637,1399,610,745,1085,381,641
060730191081,471,232,239,481,227,254,595,321,264,524,249,232
060730191092,457,241,216,463,239,224,322,160,152,269,105,147
060730191093,443,170,273,453,165,288,633,280,337,543,190,313
060730191082,211,93,118,214,92,122,502,272,219,361,163,163
060730191103,667,257,410,684,250,434,977,446,514,835,312,472
060730191101,748,222,526,766,221,545,802,324,464,746,213,495
060730191102,717,218,499,734,217,517,1077,409,649,806,234,526
060730191031,582,209,373,595,214,381,800,312,470,718,231,447
060730191034,492,190,302,504,189,315,729,291,424,513,178,302
060730191032,939,322,617,964,313,651,1342,507,807,1096,337,688
060730191033,843,323,520,867,329,538,1139,459,659,872,318,504
060730191052,929,314,615,949,307,642,1206,456,727,977,312,602
060730201103,730,280,450,746,272,474,932,378,540,726,269,411
060730191111,640,251,389,654,243,411,914,351,540,581,201,350
060730191112,540,206,334,550,200,350,782,316,443,699,244,418
060730191071,926,282,644,955,288,667,1237,483,736,988,302,643
060730191113,473,145,328,482,143,339,720,273,433,490,146,312
060730191051,720,239,481,732,234,498,797,323,460,700,235,436
060730191053,1094,400,694,1114,400,714,1226,501,702,1104,403,624
060730201112,484,179,305,501,176,325,721,290,413,584,198,360
060730191054,833,310,523,851,309,542,1361,555,782,1027,373,598
060730201111,893,356,537,917,357,560,1120,495,601,961,363,542
060730201051,520,226,294,532,209,323,695,328,343,587,241,300
060730201101,1356,609,747,1393,613,780,1960,956,968,1310,560,665
060730201113,443,176,267,457,171,286,616,245,351,499,170,305
060730203051,1621,762,859,1662,759,903,1631,772,824,1527,622,816
060730203053,543,268,275,559,269,290,835,402,411,711,285,381
060730203092,405,259,146,413,252,161,624,368,241,575,337,199
060730207053,998,452,546,1021,439,582,1456,691,738,1119,429,624
060730207063,355,155,200,367,158,209,610,303,292,445,178,229
060730207061,630,253,377,651,259,392,833,367,447,644,254,345
060730206024,694,352,342,707,335,372,1016,526,461,647,313,294
060730207064,1084,439,645,1102,435,667,1355,649,671,1259,514,676
060730207071,373,201,172,380,201,179,659,400,239,509,266,207
060730207081,1019,473,546,1041,471,570,1527,763,713,1043,450,510
060730207082,548,255,293,561,257,304,755,395,338,724,329,344
060730207062,1266,483,783,1295,482,813,1402,616,754,1222,457,696
060730204011,628,229,399,644,229,415,685,317,356,618,231,360
060730204012,852,380,472,870,383,487,1047,541,488,877,401,435
060730204032,815,355,460,837,355,482,1129,526,574,803,358,388
060730204042,552,294,258,564,290,274,1123,563,533,822,385,366
060730204043,1241,518,723,1268,514,754,1422,656,739,825,327,451
060730204051,764,286,478,776,285,491,1035,480,540,1148,421,679
060730204052,1115,428,687,1137,420,717,1576,720,822,1165,444,668
060730201052,286,133,153,294,127,167,667,334,314,586,244,296
060730201053,573,289,284,587,276,311,617,314,295,307,156,133
060730203052,262,132,130,268,133,135,647,373,255,706,344,307
060730207111,1120,462,658,1147,458,689,1511,706,783,1173,474,626
060730207122,706,302,404,719,299,420,997,464,515,668,269,358
060730203041,754,309,445,775,313,462,1446,702,719,1009,423,518
060730203043,471,195,276,486,202,284,874,426,434,684,273,366
060730203081,348,193,155,356,194,162,361,212,140,705,386,264
060730203083,956,524,432,974,525,449,1267,746,492,527,212,289
060730203082,260,161,99,265,157,108,550,324,213,443,260,151
060730201061,857,398,459,874,388,486,1094,549,516,901,373,477
060730201062,472,252,220,480,242,238,704,375,316,590,283,271
060730201071,864,391,473,882,384,498,1440,667,741,891,382,447
060730201072,565,254,311,574,246,328,840,423,392,589,255,302
060730201091,344,201,143,348,190,158,368,224,136,381,200,156
060730201094,448,256,192,455,251,204,397,265,127,527,303,191
060730202061,362,216,146,369,205,164,550,320,218,435,223,186
060730202111,315,181,134,324,176,148,295,196,90,417,224,163
060730201102,1080,547,533,1106,532,574,1316,681,603,967,455,457
060730201092,408,254,154,418,241,177,569,330,224,495,265,185
060730202081,718,414,304,735,401,334,1019,594,401,764,365,345
060730207112,483,214,269,494,213,281,720,329,378,471,185,253
060730202101,744,418,326,759,404,355,988,539,425,788,399,342
060730202024,158,118,40,159,111,48,276,190,77,152,104,35
060730202023,115,85,30,115,80,35,301,207,83,143,96,34
060730202131,131,97,34,131,91,40,328,226,91,195,131,46
060730202142,86,65,21,87,61,26,196,136,54,100,69,24
060730202021,329,243,86,335,236,99,645,428,204,282,203,60
060730202022,196,142,54,198,137,61,442,293,137,248,168,64
060730202133,108,80,28,109,77,32,358,237,112,158,114,33
060730202141,302,184,118,308,180,128,685,431,234,367,233,108
060730202144,111,82,29,113,79,34,357,236,112,182,131,39
060730202143,108,74,34,109,72,37,308,191,110,78,55,18
060730201081,256,170,86,261,164,97,431,296,121,438,248,156
060730201083,252,169,83,255,162,93,392,270,109,324,196,105
060730201084,257,172,85,261,165,96,225,155,63,205,124,67
060730201093,266,152,114,269,152,117,254,167,78,288,170,100
060730201082,167,108,59,173,106,67,268,184,74,361,206,128
060730202062,354,260,94,360,250,110,421,279,132,324,221,86
060730202063,190,133,57,194,127,67,484,320,152,367,235,111
060730202112,470,317,153,480,309,171,559,371,179,475,311,137
060730205002,353,237,116,358,229,129,653,398,233,481,297,153
060730205003,414,235,179,422,227,195,563,356,194,518,311,169
060730206012,299,195,104,306,190,116,595,368,206,320,192,103
060730206013,315,224,91,315,212,103,725,443,248,435,290,109
060730202132,156,111,45,158,106,52,193,125,58,169,107,48
060730206021,169,121,48,172,115,57,235,155,71,217,138,62
060730203132,536,270,266,549,265,284,665,371,272,572,296,240
060730202113,370,236,134,376,227,149,584,373,195,413,248,132
060730202114,173,110,63,175,106,69,316,201,106,272,163,87
060730202071,299,220,79,306,213,93,509,358,131,350,243,81
060730202072,318,234,84,323,225,98,824,533,275,403,289,85
060730202091,532,300,232,541,289,252,492,319,164,603,309,267
060730207123,688,297,391,702,292,410,650,348,288,692,278,373
060730202102,541,349,192,554,344,210,1313,699,580,743,425,270
060730202092,462,315,147,470,310,160,653,422,218,536,337,161
060730202093,153,104,49,155,103,52,277,179,93,231,145,70
060730207121,653,289,364,664,282,382,803,428,354,974,402,512
060730207051,457,224,233,474,225,249,631,331,281,566,265,255
060730207052,573,307,266,592,302,290,549,289,253,462,191,241
060730206011,415,234,181,428,234,194,512,320,172,544,307,197
060730206022,406,245,161,418,239,179,600,365,212,508,279,187
060730206023,444,263,181,466,269,197,588,359,208,458,254,171
060730204031,684,343,341,700,333,367,661,355,291,728,336,347
060730205001,341,188,153,347,181,166,334,204,117,445,238,180
060730203122,957,441,516,985,450,535,863,481,353,771,344,371
060730204041,356,198,158,363,194,169,735,405,308,537,269,234
060730207073,576,338,238,590,323,267,832,514,294,518,250,231
060730207072,173,102,71,177,97,80,317,206,99,258,124,115
060730207101,998,429,569,1014,421,593,1074,526,521,1081,480,537
060730170063,500,211,289,514,213,301,626,307,305,472,200,238
060730170061,848,334,514,868,332,536,966,474,468,694,272,364
060730170202,842,374,468,876,389,487,1031,506,501,846,395,392
060730170203,695,270,425,713,273,440,859,389,451,750,287,425
060730170201,620,259,361,642,266,376,848,416,413,692,290,363
060730170531,867,367,500,887,369,518,1131,559,546,830,394,385
060730170532,964,403,561,989,406,583,1214,607,577,1001,448,491
060730170543,451,206,245,460,204,256,571,291,268,537,244,260
060730170544,1214,536,678,1241,536,705,1616,822,754,1201,506,633
060730170211,942,357,585,967,358,609,1239,609,604,929,378,485
060730170212,797,291,506,815,290,525,925,390,514,719,257,413
060730170541,736,316,420,753,315,438,947,482,442,1332,579,658
060730170401,718,332,386,734,333,401,1109,578,509,1135,537,538
060730170411,972,440,532,999,453,546,1074,558,491,964,409,487
060730170501,596,288,308,610,291,319,796,442,329,748,356,356
060730170402,625,274,351,639,282,357,717,373,325,392,171,200
060730170412,726,362,364,748,361,387,1132,589,514,889,430,382
060730170413,346,175,171,355,173,182,522,273,238,410,194,189
060730170542,390,160,230,402,160,242,514,261,241,531,230,262
060730170091,1114,494,620,1147,497,650,1329,663,625,983,407,498
060730170101,598,269,329,621,262,359,767,408,340,776,343,378
060730170102,788,340,448,811,333,478,939,487,425,803,340,410
060730170092,542,246,296,558,241,317,977,486,459,755,295,394
060730170414,624,311,313,638,307,331,778,389,365,630,285,307
060730170403,553,272,281,566,276,290,710,370,324,656,311,302
060730170481,409,198,211,421,196,225,1122,582,506,639,304,283
060730170482,428,206,222,438,202,236,657,342,297,472,233,207
060730170483,657,326,331,678,329,349,937,490,424,583,288,256
060730170484,381,201,180,394,208,186,509,265,229,375,184,166
060730170492,723,345,378,751,349,402,967,503,437,942,422,452
060730170491,435,213,222,451,205,246,508,263,231,748,335,356
060730166211,1198,509,689,1237,496,741,1569,673,856,1312,510,724
060730166201,1162,493,669,1205,481,724,1565,671,854,1165,407,670
060730166102,840,313,527,868,307,561,1193,500,661,938,301,579
060730166142,866,378,488,891,379,512,1366,579,754,1031,414,538
060730166151,495,227,268,510,226,284,821,320,483,583,269,277
060730166073,610,215,395,627,216,411,915,337,558,555,172,348
060730166072,940,395,545,975,386,589,1096,459,611,1185,437,671
060730166081,1178,368,810,1218,355,863,1528,546,948,1317,377,868
060730166092,435,171,264,452,171,281,549,215,324,684,202,430
060730166093,778,291,487,809,290,519,1126,432,666,780,293,434
060730166091,1000,336,664,1035,330,705,971,377,569,1040,325,642
060730166101,875,384,491,898,368,530,1457,610,805,1129,455,592
060730166071,668,198,470,688,200,488,796,313,463,817,229,535
060730166074,619,256,363,629,249,380,795,335,442,689,247,420
060730166171,463,191,272,474,189,285,617,259,343,504,191,287
060730166152,523,213,310,541,210,331,1334,571,733,338,126,189
060730166062,741,318,423,753,312,441,985,422,536,1030,363,584
060730166212,359,133,226,366,126,240,1058,515,511,540,168,336
060730166061,738,316,422,766,306,460,1011,446,535,875,331,485
060730166132,607,242,365,621,238,383,711,306,390,623,232,356
060730166131,331,133,198,340,135,205,460,198,253,395,154,218
060730166141,703,326,377,728,321,407,1088,482,578,778,311,408
060730166181,719,353,366,740,355,385,1267,589,647,1187,513,610
060730166192,934,443,491,948,429,519,1237,572,631,880,365,452
060730166182,573,252,321,590,238,352,778,362,400,779,289,435
060730166191,509,209,300,518,204,314,683,317,349,624,264,333
060730166193,380,157,223,386,151,235,456,211,234,262,113,141
060730166161,480,209,271,490,205,285,906,420,463,780,301,428
060730166162,975,364,611,1011,359,652,1457,656,763,1060,366,637
060730162021,263,129,134,264,125,139,478,232,234,372,168,182
060730166172,591,297,294,604,297,307,887,410,452,689,264,381
060730166173,175,75,100,181,75,106,300,132,160,206,77,115
060730167041,1082,450,632,1104,443,661,1648,666,943,1326,490,761
060730167031,638,262,376,652,253,399,952,400,529,713,259,417
060730167042,633,272,361,651,261,390,1303,546,724,920,382,491
060730167043,883,328,555,905,318,587,801,299,480,932,327,556
060730162012,987,431,556,1009,419,590,893,433,442,706,314,358
060730162013,1187,494,693,1214,483,731,1446,713,697,1575,650,846
060730162011,826,309,517,851,307,544,1029,511,485,878,365,460
060730163011,529,258,271,543,249,294,837,445,375,693,326,325
060730165024,331,133,198,340,128,212,755,359,379,574,220,321
060730165041,470,270,200,476,260,216,1034,544,461,459,237,187
060730165045,338,183,155,345,179,166,598,302,281,462,236,194
060730165042,174,88,86,177,85,92,276,135,135,209,108,88
060730163021,301,163,138,308,157,151,515,236,270,390,188,178
060730163022,408,222,186,420,217,203,631,326,286,513,262,217
060730163023,289,160,129,297,155,142,492,259,214,380,199,156
060730165022,432,240,192,443,237,206,784,412,350,599,279,274
060730165023,511,281,230,524,276,248,607,304,288,607,311,262
060730164013,889,335,554,913,325,588,1045,402,612,974,330,592
060730165021,408,159,249,416,143,273,520,212,297,450,155,268
060730164012,642,283,359,656,277,379,1047,440,582,708,279,392
060730168074,673,253,420,682,252,430,744,296,429,584,201,353
060730168091,477,169,308,489,169,320,996,366,610,546,170,346
060730164011,344,115,229,355,117,238,373,147,221,453,137,303
060730164031,1063,316,747,1090,310,780,1378,428,927,1178,328,797
060730156011,597,279,318,615,275,340,1025,425,576,707,281,387
060730164032,325,127,198,332,126,206,366,132,229,294,100,179
060730164033,241,124,117,246,122,124,623,265,343,380,157,200
060730164042,371,191,180,378,187,191,714,304,392,498,248,218
060730156022,495,161,334,505,158,347,499,185,308,483,152,315
060730164041,273,123,150,278,121,157,533,227,292,441,184,232
060730161001,1057,536,521,1079,520,559,1438,714,679,1253,568,609
060730161002,815,392,423,836,388,448,1098,551,516,922,434,446
060730160002,802,356,446,820,367,453,1049,527,495,875,379,445
060730151001,535,295,240,551,287,264,621,367,238,497,262,195
060730151002,748,410,338,768,399,369,912,534,348,843,452,323
060730159011,177,128,49,181,128,53,508,311,183,304,197,91
060730159012,170,122,48,173,122,51,374,229,135,240,154,71
060730160001,146,106,40,148,105,43,224,141,79,195,115,63
060730162022,465,317,148,478,307,171,881,478,380,566,334,186
060730158012,272,180,92,283,180,103,520,288,218,365,221,122
060730158011,295,189,106,296,180,116,638,372,255,404,208,169
060730163012,226,135,91,229,130,99,531,293,222,343,181,137
060730163013,275,165,110,279,158,121,487,270,205,329,175,132
060730157011,210,125,85,218,126,92,358,197,151,174,105,59
060730157014,174,104,70,179,104,75,340,188,143,409,213,167
060730157013,181,108,73,187,108,79,463,254,194,233,141,79
060730157012,266,159,107,276,160,116,525,289,220,259,155,88
060730156021,777,221,556,802,224,578,995,320,661,783,217,534
060730157041,400,211,189,408,211,197,829,363,444,512,236,238
060730156013,272,145,127,276,145,131,506,223,271,318,145,149
060730157051,245,140,105,251,144,107,583,287,286,339,179,138
060730157061,308,179,129,315,185,130,658,326,324,415,220,170
060730157042,405,207,198,416,205,211,688,334,345,541,241,270
060730158021,106,55,51,107,57,50,296,127,163,164,85,70
060730158024,183,96,87,187,97,90,503,211,277,304,156,128
060730158023,202,106,96,209,107,102,361,157,200,208,107,89
060730154071,527,269,258,537,262,275,897,360,520,689,278,369
060730157052,271,162,109,277,158,119,629,278,337,415,216,164
060730158022,176,120,56,178,116,62,301,187,109,173,114,54
060730159022,290,162,128,295,156,139,484,232,239,332,170,145
060730159021,250,121,129,254,115,139,366,172,191,323,147,165
060730159023,309,148,161,316,141,175,442,204,225,344,155,176
060730153022,663,303,360,677,302,375,925,444,458,893,406,440
060730153021,744,369,375,759,368,391,851,436,399,803,377,382
060730153023,402,194,208,409,186,223,652,298,347,373,162,194
060730154031,621,272,349,638,267,371,796,366,414,675,267,375
060730154032,685,302,383,701,297,404,875,429,426,740,323,371
060730159024,295,181,114,300,172,128,558,307,235,488,260,203
060730153011,318,166,152,326,158,168,459,194,254,263,135,116
060730153012,342,180,162,352,174,178,622,264,342,417,214,175
060730154072,206,108,98,210,101,109,438,184,241,313,158,139
060730154081,767,279,488,786,282,504,925,369,537,820,297,484
060730154082,706,294,412,727,296,431,1111,424,663,775,278,454
060730156012,787,268,519,809,269,540,1230,449,764,948,327,581
060730154051,723,288,435,737,281,456,1163,420,724,890,331,514
060730165043,154,90,64,157,88,69,291,153,128,233,118,98
060730165044,119,70,49,122,70,52,255,134,114,264,132,111
060730165031,511,228,283,519,219,300,743,346,374,680,251,383
060730165032,434,184,250,444,180,264,515,218,289,453,158,266
060730168063,434,197,237,441,195,246,1114,464,624,857,330,474
060730168061,567,199,368,581,194,387,726,258,447,540,166,345
060730168062,269,94,175,275,92,183,499,185,302,377,114,243
060730168072,1051,335,716,1074,323,751,1172,413,729,1136,305,773
060730168073,1081,349,732,1113,333,780,1419,545,843,999,312,628
060730148041,490,284,206,501,287,214,544,330,204,516,288,201
060730148043,656,392,264,668,397,271,756,485,253,1077,640,378
060730150011,769,444,325,793,438,355,1007,608,376,828,440,330
060730150013,400,230,170,410,227,183,501,303,187,447,240,177
060730151003,374,228,146,380,217,163,549,327,207,419,224,165
060730151004,412,248,164,422,238,184,658,389,251,466,237,189
060730150021,394,246,148,406,242,164,749,451,279,601,333,234
060730150022,210,131,79,214,128,86,630,380,236,273,152,106
060730150012,583,356,227,611,347,264,887,532,331,715,373,302
060730148031,680,383,297,703,387,316,1038,650,362,850,459,333
060730148032,713,416,297,723,416,307,912,582,306,530,293,209
060730148033,367,206,161,380,210,170,623,396,210,443,241,173
060730149023,517,320,197,531,321,210,607,393,199,554,317,199
060730148044,331,198,133,337,195,142,521,314,194,439,249,162
060730148042,499,313,186,509,315,194,590,375,198,425,239,150
060730148052,673,436,237,687,427,260,1107,706,371,738,464,223
060730148051,376,246,130,382,240,142,554,352,186,464,292,140
060730148061,346,231,115,356,233,123,653,413,219,444,282,130
060730148062,404,270,134,412,267,145,699,444,235,481,305,140
060730147011,616,381,235,631,375,256,835,539,272,779,443,282
060730147021,682,434,248,700,425,275,874,569,286,678,413,224
060730147013,711,430,281,720,421,299,797,514,263,730,401,286
060730147012,353,236,117,361,231,130,521,336,171,359,218,116
060730146013,777,505,272,804,506,298,978,629,322,850,505,279
060730146011,725,483,242,740,476,264,1195,771,389,933,572,292
060730146021,823,519,304,850,521,329,898,579,293,856,498,289
060730149011,528,344,184,539,339,200,578,372,188,453,260,161
060730149012,746,463,283,768,459,309,1261,813,411,803,472,271
060730149013,692,436,256,709,431,278,886,573,288,831,468,302
060730149022,583,368,215,593,364,229,895,581,294,752,436,269
060730149021,334,205,129,340,205,135,410,265,134,405,230,147
060730152001,743,365,378,762,368,394,856,488,348,755,373,342
060730152002,550,282,268,566,290,276,581,360,204,537,269,239
060730152003,546,278,268,559,284,275,508,312,188,554,277,251
060730152004,486,245,241,499,248,251,483,284,190,547,274,250
060730138011,782,437,345,802,435,367,955,573,352,848,445,354
060730146022,352,216,136,363,213,150,756,491,245,351,211,117
060730145001,463,303,160,476,298,178,665,443,207,500,315,155
060730146012,242,142,100,250,141,109,401,260,132,328,185,121
060730146023,695,428,267,712,418,294,928,608,298,722,417,255
060730145002,441,288,153,457,286,171,816,542,252,589,369,185
060730145003,342,223,119,351,222,129,413,281,129,418,271,127
060730136011,495,242,253,505,242,263,512,285,213,485,239,220
060730136012,806,427,379,819,420,399,1107,633,447,886,460,382
060730136013,739,374,365,757,370,387,972,550,400,777,386,354
060730136053,809,413,396,824,412,412,878,472,389,862,440,386
060730137011,847,422,425,864,420,444,980,559,392,840,424,365
060730137012,413,208,205,420,205,215,516,295,206,495,248,216
060730135032,558,329,229,569,319,250,1248,696,521,738,410,276
060730136014,227,148,79,230,142,88,493,283,197,272,167,84
060730138012,376,199,177,385,198,187,425,253,165,470,241,195
060730138013,505,299,206,517,302,215,834,499,313,637,377,215
060730137021,717,360,357,733,360,373,1019,599,393,827,432,359
060730137022,309,177,132,314,175,139,703,414,272,555,306,211
060730137023,403,224,179,409,222,187,541,318,209,409,224,155
060730138022,258,172,86,260,164,96,574,334,219,375,240,116
060730135031,529,254,275,542,246,296,718,371,333,550,246,267
060730135042,337,164,173,347,161,186,557,307,239,409,193,195
060730139062,575,342,233,579,333,246,977,580,363,565,327,199
060730139063,548,336,212,556,328,228,667,438,212,569,331,199
060730139072,467,319,148,474,310,164,1018,668,322,590,434,121
060730139051,618,359,259,631,357,274,984,606,351,697,406,244
060730139053,326,194,132,330,190,140,464,285,166,346,202,121
060730138021,406,281,125,409,263,146,789,463,304,492,312,151
060730135051,979,501,478,993,489,504,1360,712,618,1015,491,476
060730135052,612,329,283,626,328,298,373,203,163,638,347,255
060730135053,218,116,102,221,112,109,493,271,212,443,225,196
060730135033,875,426,449,894,416,478,1016,527,474,953,447,459
060730135043,741,381,360,755,370,385,1293,708,557,708,344,329
060730135041,330,194,136,337,190,147,565,327,224,548,301,221
060730139091,472,311,161,481,287,194,859,523,310,624,405,180
060730139092,665,413,252,674,393,281,1324,808,487,1067,668,332
060730139061,204,129,75,207,125,82,395,259,125,360,227,113
060730140021,587,362,225,596,343,253,788,510,259,743,442,251
060730139071,219,144,75,223,140,83,508,332,161,454,299,129
060730139052,375,228,147,384,217,167,571,352,203,392,240,128
060730031081,523,306,217,535,287,248,819,534,270,814,465,291
060730140022,788,468,320,803,457,346,1049,672,348,964,572,334
060730031082,343,209,134,348,197,151,565,359,191,467,280,159
060730139081,335,235,100,347,229,118,595,366,221,408,255,133
060730139082,634,446,188,644,427,217,1219,754,430,839,548,248
060730134232,1077,619,458,1095,608,487,1001,586,398,872,504,326
060730139031,482,258,224,490,254,236,774,470,282,484,283,176
060730139032,822,421,401,835,411,424,601,364,220,1037,527,453
060730032142,378,261,117,382,250,132,687,438,233,511,344,148
060730135063,438,263,175,446,248,198,756,414,326,493,254,213
060730135061,361,205,156,371,194,177,530,286,231,507,259,222
060730135062,322,177,145,332,166,166,796,432,347,420,212,191
060730144001,499,378,121,503,372,131,1110,718,366,600,414,147
060730144002,339,231,108,344,223,121,774,511,248,599,409,152
060730143001,748,490,258,761,477,284,1136,749,362,927,584,278
060730143002,370,234,136,374,229,145,567,378,183,439,282,129
060730140011,324,205,119,327,201,126,458,291,154,367,220,121
060730140014,431,275,156,437,269,168,674,427,225,514,299,179
060730140012,301,183,118,303,183,120,438,275,147,350,204,126
060730141011,670,438,232,684,423,261,928,588,312,746,437,259
060730140013,591,371,220,604,361,243,742,470,249,712,426,246
060730142001,801,507,294,815,505,310,940,620,300,821,486,283
060730142002,334,212,122,340,212,128,646,422,204,415,249,139
060730142004,417,261,156,432,259,173,526,347,168,460,255,182
060730141012,591,386,205,606,371,235,863,555,293,651,415,195
060730032041,757,409,348,774,409,365,969,571,380,795,438,308
060730032042,572,391,181,579,379,200,843,550,276,633,432,158
060730032071,660,379,281,670,374,296,974,576,378,766,450,278
060730032072,909,543,366,925,522,403,1089,621,448,1213,707,452
060730134123,785,435,350,793,423,370,909,555,339,717,424,261
060730134122,302,150,152,310,150,160,550,313,229,492,250,214
060730032073,816,429,387,830,421,409,1169,664,480,926,496,389
060730134223,400,215,185,410,214,196,959,546,400,522,290,213
060730134222,540,286,254,553,288,265,667,379,275,698,353,308
060730134221,567,300,267,581,298,283,1254,728,511,781,417,331
060730134112,546,283,263,555,282,273,636,362,262,491,267,198
060730134114,554,311,243,562,305,257,838,478,349,811,463,307
060730134111,1020,546,474,1042,538,504,1203,701,484,957,527,386
060730134113,402,207,195,407,207,200,475,268,195,374,203,150
060730219001,354,273,81,356,250,106,561,393,155,484,368,89
060730219002,239,185,54,240,169,71,234,167,67,72,55,14
060730117001,513,367,146,529,354,175,819,534,272,646,451,165
060730117004,251,186,65,254,174,80,440,300,128,298,227,59
060730118011,386,297,89,395,283,112,545,385,153,526,417,88
060730118021,390,301,89,396,286,110,618,427,175,462,361,80
060730118024,95,71,24,97,68,29,319,223,87,134,105,22
060730118023,154,114,40,156,110,46,360,252,97,322,252,52
060730118022,418,323,95,422,308,114,704,489,188,502,396,80
060730122002,574,430,144,579,414,165,989,682,285,766,559,165
060730121021,355,259,96,362,247,115,597,409,172,449,322,106
060730121022,402,290,112,406,274,132,627,400,215,512,373,113
060730122001,237,178,59,238,172,66,391,274,112,294,217,62
060730118012,230,179,51,237,176,61,273,192,74,261,208,42
060730118013,231,182,49,231,172,59,277,195,76,269,213,44
060730220001,347,219,128,355,211,144,631,393,230,421,301,100
060730220002,424,290,134,431,269,162,799,506,279,579,415,131
060730119022,560,389,171,573,372,201,804,533,251,627,437,153
060730119023,292,218,74,300,215,85,417,285,123,367,272,76
060730119024,386,292,94,396,292,104,521,356,153,503,375,98
060730120031,348,229,119,358,223,135,430,263,159,471,301,141
060730117002,364,271,93,371,259,112,564,390,151,505,366,109
060730117003,389,292,97,394,274,120,452,316,120,450,347,82
060730120021,227,140,87,236,137,99,406,250,151,260,186,63
060730120022,560,344,216,579,336,243,922,566,343,568,407,136
060730120032,572,404,168,579,392,187,895,548,333,683,498,149
060730116011,282,224,58,288,213,75,488,342,140,383,290,68
060730116012,329,275,54,331,260,71,541,376,151,428,359,52
060730116013,568,473,95,572,448,124,799,557,226,676,567,82
060730116021,392,317,75,397,304,93,723,496,202,514,406,76
060730116022,185,147,38,186,139,47,422,291,119,276,220,40
060730121011,560,390,170,575,377,198,676,471,195,629,424,171
060730125021,291,220,71,295,212,83,521,363,144,340,257,62
060730125023,308,234,74,311,224,87,506,357,142,393,297,72
060730133223,372,221,151,382,221,161,595,378,207,623,400,187
060730133231,573,381,192,582,381,201,1140,745,374,744,496,212
060730133232,490,313,177,499,311,188,722,470,242,544,375,140
060730133233,701,453,248,710,439,271,970,635,318,856,562,266
060730133251,485,322,163,496,308,188,816,522,285,579,396,155
060730133252,215,144,71,217,136,81,1122,713,390,447,306,119
060730133253,595,392,203,608,376,232,782,499,273,601,397,168
060730134151,675,438,237,682,429,253,1050,668,366,826,534,249
060730134182,829,572,257,842,561,281,1398,861,513,1228,881,291
060730134242,325,215,110,330,212,118,640,396,234,385,252,120
060730134183,538,298,240,549,291,258,589,361,217,587,319,240
060730134184,481,263,218,492,256,236,637,391,233,589,322,240
060730134162,758,409,349,770,393,377,1183,728,436,844,466,337
060730213061,889,528,361,903,513,390,1442,882,540,1179,688,431
060730134231,476,284,192,485,277,208,1205,711,481,839,520,292
060730123032,540,357,183,550,350,200,613,403,196,498,308,160
060730124012,470,356,114,474,336,138,887,597,267,652,464,137
060730123031,760,508,252,770,483,287,1158,758,373,1005,616,331
060730124011,324,205,119,329,196,133,474,313,152,482,292,160
060730124021,377,265,112,384,252,132,552,385,152,464,315,120
060730124022,406,284,122,412,270,142,547,385,154,522,356,134
060730124023,536,392,144,540,382,158,906,631,250,684,512,132
060730127002,443,328,115,447,318,129,719,505,200,657,486,139
060730125011,362,275,87,367,274,93,620,434,172,448,326,98
060730125022,239,181,58,241,180,61,546,381,151,455,332,99
060730126001,335,256,79,344,247,97,396,271,118,310,234,57
060730123021,548,386,162,561,376,185,772,514,241,659,447,169
060730127001,414,301,113,420,289,131,616,429,173,599,431,133
060730130001,425,292,133,434,283,151,679,463,201,637,422,191
060730123041,318,209,109,321,198,123,453,286,157,343,216,106
060730123042,1092,723,369,1102,689,413,1513,954,528,1354,853,410
060730128001,372,233,139,377,226,151,487,308,169,381,250,106
060730128003,601,386,215,606,375,231,995,622,351,816,530,238
060730127003,264,197,67,267,190,77,374,258,103,328,242,70
060730125012,290,221,69,296,213,83,934,636,277,623,471,113
060730128002,430,267,163,437,261,176,622,385,223,456,289,143
060730134011,989,602,387,1010,582,428,1293,795,470,1069,651,367
060730134012,852,508,344,871,493,378,1223,749,434,1046,616,367
060730130002,405,267,138,418,262,156,505,348,150,494,336,130
060730130003,444,315,129,452,311,141,662,455,196,598,428,142
060730130004,304,206,98,312,204,108,384,265,112,397,268,107
060730126002,271,205,66,274,195,79,408,278,116,415,288,102
060730126003,365,277,88,369,264,105,768,526,217,479,367,87
060730129001,513,332,181,521,321,200,773,480,281,689,407,239
060730129002,344,210,134,352,202,150,466,291,170,395,228,141
060730129003,549,347,202,562,344,218,720,445,257,637,378,213
060730134092,766,470,296,781,454,327,1292,799,470,1249,740,438
060730134121,908,548,360,924,547,377,1153,723,411,877,559,281
060730134091,504,302,202,510,293,217,754,443,299,574,318,222
060730133272,154,98,56,155,96,59,653,407,236,323,213,94
060730133273,442,282,160,448,278,170,606,379,220,519,343,151
060730134093,688,434,254,700,418,282,999,619,369,906,569,296
060730134142,709,451,258,719,436,283,1203,754,430,875,565,264
060730134144,1001,608,393,1019,580,439,1288,802,458,1107,660,390
060730134202,805,516,289,824,505,319,1111,715,370,851,565,240
060730134143,415,243,172,420,234,186,734,468,255,646,365,240
060730134141,735,454,281,744,441,303,915,584,312,740,491,217
060730133011,1096,694,402,1113,674,439,1450,920,495,1294,781,432
060730131021,356,244,112,363,240,123,707,458,233,546,363,157
060730131022,348,239,109,351,232,119,992,640,325,521,390,99
060730126004,337,235,102,343,233,110,561,384,160,390,296,72
060730131042,254,181,73,257,173,84,351,236,105,298,215,67
060730131044,281,203,78,285,193,92,403,272,122,400,287,87
060730131031,210,166,44,211,160,51,411,285,116,344,267,56
060730131032,312,250,62,317,238,79,591,403,179,449,344,80
060730132062,343,271,72,345,261,84,800,555,226,680,503,145
060730133012,774,500,274,787,481,306,953,613,314,977,624,294
060730133091,475,299,176,477,286,191,711,441,256,579,356,188
060730133093,385,241,144,392,235,157,565,351,200,490,294,165
060730133095,549,334,215,563,334,229,790,505,268,821,514,271
060730133021,788,511,277,794,482,312,970,651,300,915,588,268
060730133022,855,577,278,867,553,314,1133,769,340,1119,742,302
060730131024,305,231,74,307,217,90,521,338,171,402,273,108
060730131023,404,308,96,411,290,121,884,571,291,533,400,103
060730133032,374,250,124,378,241,137,498,348,143,475,332,114
060730133033,381,257,124,388,248,140,476,332,135,524,362,126
060730133062,728,502,226,732,478,254,1159,798,331,790,535,216
060730133151,936,594,342,945,580,365,1237,781,436,998,640,318
060730133152,368,232,136,372,225,147,567,359,199,454,297,139
060730133191,691,434,257,700,421,279,1219,778,422,868,534,294
060730133192,645,400,245,649,389,260,2406,1553,805,742,473,235
060730133202,1019,652,367,1037,638,399,1579,1006,543,1300,819,412
060730133031,694,525,169,701,486,215,1103,759,313,796,616,145
060730132034,281,220,61,284,207,77,550,381,157,380,299,60
060730132033,208,163,45,211,156,55,561,387,159,448,353,75
060730132035,231,178,53,235,169,66,622,431,177,466,367,74
060730133092,432,263,169,447,263,184,572,371,196,562,387,151
060730133271,772,487,285,787,463,324,1247,791,432,882,560,279
060730133261,729,432,297,740,391,349,960,603,351,897,555,295
060730133094,647,407,240,656,396,260,882,567,303,651,410,206
060730133221,642,406,236,651,397,254,993,633,345,699,447,224
060730133162,892,575,317,910,557,353,1132,715,398,924,566,305
060730133164,240,158,82,242,156,86,348,226,115,299,210,80
060730134243,825,515,310,837,497,340,1253,777,458,942,597,302
060730134241,862,565,297,875,550,325,1235,766,450,1047,656,340
060730134181,407,283,124,416,277,139,645,398,237,402,284,93
060730133262,641,371,270,648,363,285,1123,715,391,795,502,270
060730133211,304,207,97,309,203,106,835,542,274,393,278,98
060730133212,637,437,200,643,432,211,1146,749,376,644,448,171
060730133213,461,313,148,468,303,165,612,397,200,514,357,129
060730133214,770,472,298,785,463,322,1200,783,392,1043,658,348
060730133071,484,367,117,487,350,137,662,449,191,459,338,90
060730133072,587,433,154,592,417,175,1112,763,320,829,610,171
060730133082,321,239,82,326,231,95,673,461,192,484,355,100
060730133061,698,482,216,707,468,239,894,617,256,1102,773,266
060730133181,781,508,273,793,495,298,1008,666,334,854,546,267
060730133171,741,482,259,748,465,283,2186,1404,750,183,122,56
060730134201,265,189,76,269,189,80,772,498,257,454,326,95
060730134213,466,323,143,476,322,154,785,507,263,639,427,181
060730133081,589,480,109,593,458,135,1057,728,302,925,730,152
060730133172,1066,693,373,1086,659,427,1550,994,528,1330,855,411
060730133173,1153,765,388,1175,741,434,2546,1629,869,1056,702,308
060730133182,537,333,204,545,315,230,924,596,309,939,620,266
060730133183,393,270,123,402,266,136,944,617,311,573,394,151
060730133184,304,208,96,309,206,103,429,285,143,432,297,112
060730133121,583,390,193,590,367,223,942,602,321,700,485,171
060730133122,286,213,73,292,206,86,562,360,191,397,278,96
060730133201,571,397,174,578,379,199,1330,858,451,623,416,176
060730133203,170,125,45,169,115,54,317,206,106,246,168,67
060730213062,770,460,310,782,444,338,1149,711,425,762,454,268
060730134212,929,568,361,943,555,388,1178,759,392,1042,672,325
060730134161,786,398,388,801,392,409,1265,723,530,947,502,401
060730134211,369,230,139,378,228,150,500,322,167,391,259,113
060730134171,936,538,398,961,533,428,1164,711,438,1123,676,394
060730133161,345,240,105,349,230,119,1230,773,433,689,505,146
060730133163,928,559,369,952,545,407,1161,732,409,1069,649,359
060730134251,830,485,345,847,475,372,1231,764,451,951,577,344
060730133222,454,263,191,464,260,204,764,486,266,606,388,194
060730133241,588,430,158,598,421,177,1154,753,378,691,507,154
060730131041,326,261,65,331,248,83,681,459,205,567,437,102
060730131043,335,234,101,338,225,113,623,421,190,517,375,119
060730132063,681,483,198,683,464,219,927,639,268,715,527,155
060730132031,276,216,60,278,207,71,507,341,155,391,300,70
060730132032,299,234,65,303,226,77,393,272,112,315,248,53
060730132041,299,216,83,301,208,93,501,351,136,430,339,70
060730132051,377,298,79,378,282,96,852,593,240,737,571,120
060730132043,387,296,91,389,282,107,590,434,152,641,502,108
060730132061,372,281,91,373,269,104,656,457,182,531,384,120
060730132042,286,225,61,288,210,78,390,265,113,468,357,85
060730209031,213,88,125,213,87,126,291,129,159,220,81,129
060730209033,477,168,309,483,167,316,665,254,391,448,144,282
060730209032,528,215,313,535,213,322,657,282,354,438,142,250
060730210021,576,308,268,587,308,279,411,237,168,368,194,158
060730208072,390,105,285,395,102,293,495,165,321,340,94,223
060730208071,993,278,715,1023,284,739,1127,394,701,1169,312,791
060730208101,627,200,427,642,198,444,790,263,511,625,178,405
060730208012,1155,349,806,1187,351,836,1281,447,800,947,267,627
060730208013,936,314,622,959,311,648,1353,450,875,1015,313,641
060730208051,470,140,330,484,140,344,713,250,450,565,151,380
060730208052,703,251,452,719,242,477,1149,422,701,774,266,465
060730208062,654,175,479,681,177,504,974,338,608,813,200,568
060730208132,848,239,609,870,233,637,1370,453,887,942,242,656
060730208102,339,101,238,348,101,247,409,136,263,370,110,237
060730208111,746,228,518,764,228,536,991,326,642,1014,288,671
060730208112,1034,324,710,1059,331,728,1418,465,920,1055,287,721
060730208061,544,192,352,557,189,368,936,337,571,755,251,458
060730208133,678,216,462,697,214,483,872,314,535,638,192,412
060730208121,552,181,371,572,176,396,900,336,544,700,208,466
060730208104,666,193,473,685,193,492,845,280,543,1000,264,683
060730208103,810,233,577,830,231,599,1076,356,695,847,230,571
060730208113,981,319,662,1011,318,693,1124,373,725,1131,322,739
060730169021,874,281,593,893,272,621,1361,451,886,1213,339,804
060730208064,290,100,190,295,100,195,665,237,406,423,130,263
060730208131,452,159,293,462,157,305,673,240,410,497,157,303
060730208063,278,95,183,288,99,189,737,257,460,397,118,254
060730208011,534,195,339,546,196,350,654,237,400,799,277,475
060730169013,717,226,491,733,221,512,866,285,561,778,222,520
060730169014,326,110,216,336,109,227,809,265,525,491,144,315
060730169015,549,185,364,563,185,378,756,247,491,718,202,480
060730169011,855,257,598,875,250,625,997,327,648,904,255,598
060730169012,594,169,425,610,167,443,725,237,470,515,149,337
060730168042,538,214,324,553,210,343,942,342,563,812,257,500
060730168043,478,191,287,488,186,302,694,253,417,402,149,225
060730168121,924,248,676,945,241,704,2132,607,1495,919,243,642
060730168041,665,202,463,684,198,486,1186,337,828,648,165,454
060730168113,561,166,395,574,158,416,749,234,503,703,193,469
060730167032,205,77,128,208,74,134,402,141,249,290,100,173
060730167051,671,259,412,685,256,429,784,284,476,936,312,556
060730167052,198,76,122,202,75,127,609,214,380,374,128,224
060730167053,474,172,302,483,168,315,750,263,466,604,199,370
060730167062,680,221,459,693,214,479,944,331,585,756,207,510
060730168044,389,152,237,398,147,251,722,262,433,424,135,262
060730168101,1214,393,821,1257,383,874,1624,556,1019,1467,405,961
060730168132,1126,330,796,1154,333,821,1430,453,960,1274,358,871
060730168112,593,182,411,606,172,434,859,281,562,727,200,497
060730168111,764,238,526,779,230,549,1018,327,675,882,263,583
060730168071,383,117,266,392,114,278,352,128,211,377,100,258
060730167061,324,108,216,331,106,225,517,183,321,358,107,232
060730168093,794,265,529,810,254,556,1170,400,747,906,270,592
060730168131,687,198,489,701,198,503,1166,329,819,1023,267,717
060730155013,974,299,675,1004,290,714,520,147,366,668,170,466
060730168122,420,129,291,424,133,291,866,243,608,577,162,392
060730155021,589,184,405,600,184,416,701,231,458,656,172,453
060730155022,814,222,592,842,227,615,1043,309,711,913,228,635
060730212041,1305,339,966,1333,322,1011,1770,512,1219,1195,277,864
060730212042,1506,475,1031,1560,471,1089,1671,531,1106,1558,462,1027
060730212052,740,228,512,757,231,526,1317,418,870,680,202,443
060730212053,843,245,598,863,237,626,1426,449,946,1247,375,818
060730212062,669,179,490,690,173,517,621,198,410,823,207,579
060730212061,981,251,730,1008,250,758,1246,347,878,997,258,699
060730212051,973,339,634,1004,337,667,1536,449,1054,1270,375,836
060730155011,476,156,320,487,156,331,601,202,385,452,134,297
060730155014,523,163,360,543,165,378,537,179,342,800,232,532
060730155012,723,236,487,737,237,500,898,298,583,750,232,492
060730136051,1227,529,698,1259,535,724,1149,496,632,1360,559,744
060730136052,795,381,414,815,381,434,1056,518,518,863,372,446
060730136072,645,302,343,662,299,363,951,478,455,894,408,443
060730154052,874,315,559,891,320,571,780,308,461,634,214,376
060730154061,1328,429,899,1354,424,930,1628,578,1026,1907,599,1219
060730136071,278,156,122,284,160,124,495,269,216,329,167,147
060730136082,439,237,202,458,238,220,845,387,445,537,267,251
060730136081,958,454,504,982,456,526,1637,750,861,1071,484,539
060730136043,1016,399,617,1047,401,646,1509,572,915,1309,504,748
060730136044,371,179,192,383,181,202,1152,437,700,406,199,189
060730136041,393,146,247,405,151,254,565,214,343,395,127,247
060730136042,371,125,246,383,124,259,592,226,359,391,126,245
060730213051,1135,385,750,1156,386,770,1555,502,1030,1352,466,827
060730154053,821,292,529,847,301,546,1128,428,684,860,247,565
060730168092,746,209,537,769,205,564,460,152,301,894,248,617
060730213052,927,305,622,953,306,647,1216,384,806,1025,334,640
060730213063,471,141,330,481,136,345,702,253,435,609,190,393
060730213041,779,264,515,795,257,538,1093,388,684,657,225,403
060730213042,624,240,384,635,238,397,778,290,474,825,250,542
060730213021,719,289,430,729,281,448,1116,428,663,660,295,327
060730213023,571,163,408,590,159,431,765,238,507,693,193,455
060730213022,679,216,463,692,209,483,763,291,451,849,272,522
060730210011,235,129,106,240,130,110,311,180,124,251,135,105
060730210012,260,140,120,265,140,125,270,155,112,217,113,97
060730210022,205,110,95,211,111,100,536,303,216,430,227,181
060730209044,469,191,278,486,194,292,479,201,269,511,191,294
060730209043,268,113,155,276,114,162,290,121,163,242,96,136
060730209041,411,166,245,421,159,262,566,234,319,459,160,275
060730209042,614,256,358,634,253,381,610,256,337,570,225,316
060730209021,264,97,167,271,92,179,402,136,260,251,82,157
060730209022,926,247,679,946,243,703,1108,313,772,977,238,695
060730212021,901,263,638,923,269,654,1148,358,770,1148,305,796
060730212022,359,90,269,373,92,281,600,162,427,449,110,317
060730211011,410,206,204,410,188,222,691,238,433,574,315,228
060730211021,594,170,424,602,166,436,840,290,530,661,186,446
060730211012,615,191,424,628,178,450,916,317,579,737,198,497
060730211013,553,183,370,562,178,384,917,314,579,670,206,419
060730211022,227,99,128,233,100,133,343,118,221,251,94,147
060730210013,253,88,165,255,89,166,462,193,261,284,100,160
060730190011,462,175,287,473,172,301,229,88,138,518,196,294
060730094001,50,32,18,51,31,20,2379,1451,863,156,66,67
060730113001,42,17,25,44,19,25,1729,914,772,39,12,24
060730062001,115,61,54,117,60,57,63,38,24,39,19,18
060730099011,13,7,6,14,7,7,394,235,148,283,136,130
060730076011,119,84,35,127,88,39,346,236,99,157,88,50
060730055001,16,11,5,17,11,6,243,202,33,19,10,6
060855068022,548,377,171,555,379,176,709,516,171,599,410,141
060855068023,349,241,108,358,240,118,479,337,125,388,260,98
060855068024,239,165,74,245,166,79,348,245,95,283,189,71
060855068025,436,301,135,448,300,148,571,402,155,466,315,119
060855068032,574,417,157,588,414,174,654,464,171,561,381,139
060855068034,408,288,120,424,295,129,544,394,137,450,314,106
060855068043,567,383,184,571,381,190,740,533,190,588,398,152
060855068044,276,195,81,281,193,88,387,278,103,315,216,79
060855068031,723,466,257,754,480,274,976,685,262,838,533,245
060855068033,866,607,259,898,624,274,1343,963,339,1035,718,248
060855120522,672,467,205,686,467,219,996,729,249,863,593,219
060855120523,382,266,116,387,264,123,472,340,126,382,263,99
060855120532,562,401,161,568,395,173,794,553,224,571,393,147
060855069001,492,330,162,504,337,167,617,444,154,567,369,171
060855069002,943,599,344,965,614,351,1195,834,331,1008,656,287
060855069003,1097,700,397,1112,705,407,1287,918,339,1191,783,330
060855119161,405,284,121,413,285,128,1055,740,287,803,545,197
060855119162,1151,761,390,1190,779,411,1507,1037,436,1260,829,353
060855119151,360,254,106,370,261,109,489,348,135,316,221,80
060855119153,289,203,86,299,207,92,327,233,89,329,233,79
060855029102,330,224,106,336,227,109,379,266,102,328,221,83
060855119152,154,111,43,158,113,45,418,298,110,331,234,79
060855119051,608,356,252,622,367,255,854,567,265,712,457,206
060855119102,320,184,136,327,191,136,471,314,149,464,266,172
060855119143,695,412,283,708,423,285,1005,685,301,838,522,252
060855119142,1348,857,491,1368,859,509,1709,1174,490,1426,912,434
060855119131,633,393,240,643,405,238,788,544,223,687,454,197
060855119132,690,445,245,702,449,253,963,657,282,921,613,257
060855119141,675,404,271,683,408,275,836,580,239,717,454,216
060855119133,790,503,287,807,509,298,972,668,285,843,562,240
060855119182,1249,779,470,1271,798,473,1649,1121,495,1238,820,350
060855119101,549,316,233,559,326,233,757,493,251,607,374,197
060855119181,351,201,150,361,207,154,532,341,179,383,229,130
060855119052,778,473,305,793,481,312,1036,697,314,922,605,268
060855119103,656,379,277,670,386,284,864,562,286,706,432,236
060855119173,1092,698,394,1115,707,408,1251,885,339,1014,717,247
060855119171,888,570,318,909,582,327,1344,968,353,1078,748,278
060855119112,459,278,181,467,279,188,530,334,181,520,288,202
060855122001,772,369,403,789,369,420,971,539,404,871,434,370
060855119122,711,483,228,724,485,239,1154,821,314,838,575,211
060855119113,954,557,397,979,563,416,1162,768,364,959,575,315
060855119121,1080,683,397,1095,698,397,1420,1011,380,1158,791,296
060855119123,552,350,202,559,363,196,719,509,193,485,318,143
060855119072,1202,741,461,1236,765,471,1557,1105,416,1319,878,362
060855119071,578,343,235,596,357,239,876,586,271,730,456,236
060855119111,833,552,281,850,556,294,1218,814,376,903,592,267
060855120521,314,217,97,319,217,102,408,299,102,348,236,93
060855120051,600,419,181,612,412,200,727,505,207,557,387,136
060855120054,635,445,190,652,438,214,925,643,263,771,530,190
060855120243,369,275,94,373,273,100,922,644,256,660,476,140
060855120241,485,335,150,497,343,154,551,387,153,624,417,162
060855120271,630,435,195,649,448,201,805,563,219,699,487,172
060855120242,735,529,206,746,519,227,785,551,219,690,469,172
060855120251,940,608,332,956,606,350,1324,882,422,1121,729,328
060855120531,656,503,153,662,499,163,1063,775,265,808,590,174
060855120473,740,484,256,755,479,276,875,595,257,784,492,239
060855120533,394,252,142,401,248,153,463,314,135,417,256,131
060855120471,812,545,267,813,531,282,1212,837,347,951,623,273
060855120472,667,449,218,675,440,235,951,654,279,800,523,231
060855120454,752,508,244,765,492,273,927,640,265,854,553,244
060855120452,442,297,145,444,289,155,653,448,193,531,343,148
060855120453,399,268,131,401,257,144,529,363,156,437,284,123
060855120314,458,293,165,470,293,177,600,420,161,519,338,144
060855120192,623,468,155,631,466,165,922,671,230,802,594,148
060855120193,611,446,165,619,450,169,837,611,207,663,503,112
060855120191,356,223,133,365,228,137,459,308,135,437,276,136
060855120252,444,291,153,452,286,166,602,400,194,471,311,135
060855119172,314,190,124,321,185,136,512,369,134,468,316,125
060855033061,263,199,64,265,200,65,380,257,119,346,293,45
060855033062,344,272,72,348,271,77,640,451,186,391,335,46
060855033063,254,198,56,259,199,60,533,361,165,378,316,46
060855078083,473,349,124,489,353,136,693,512,167,563,430,101
060855079051,383,243,140,393,254,139,803,559,221,592,403,155
060855079052,573,369,204,588,379,209,721,510,202,607,419,155
060855079061,515,340,175,526,343,183,683,470,189,486,340,119
060855079062,424,273,151,430,277,153,697,487,196,517,367,122
060855079032,603,381,222,612,385,227,869,605,246,689,488,163
060855079033,969,613,356,988,631,357,946,673,254,770,545,185
060855079063,358,248,110,369,246,123,505,353,143,403,289,95
060855079064,407,280,127,418,277,141,539,376,153,485,348,113
060855079053,699,482,217,713,484,229,934,653,259,771,556,183
060855080041,581,416,165,603,431,172,981,715,246,707,527,143
060855080043,712,510,202,739,520,219,1077,774,274,774,556,176
060855079041,636,427,209,652,444,208,1116,803,291,917,684,192
060855079042,645,427,218,657,436,221,972,709,252,789,558,187
060855079031,727,487,240,753,502,251,1011,729,266,881,661,176
060855062023,320,231,89,331,232,99,413,293,107,338,236,74
060855062022,817,588,229,837,593,244,1116,823,264,1039,741,231
060855062024,670,479,191,679,482,197,854,649,189,728,517,167
060855062021,755,558,197,769,574,195,944,694,229,916,675,185
060855062042,355,242,113,363,249,114,576,424,140,431,313,97
060855062043,371,256,115,381,263,118,520,383,129,412,298,92
060855062041,615,440,175,625,438,187,1147,823,294,805,579,163
060855062044,615,440,175,627,433,194,692,500,179,642,456,154
060855062031,246,191,55,258,199,59,422,307,104,485,368,89
060855062032,166,127,39,171,131,40,710,521,176,220,160,40
060855062033,280,206,74,286,213,73,239,176,59,217,163,40
060855062034,325,244,81,337,254,83,354,261,88,337,259,63
060855063011,256,213,43,260,212,48,554,414,127,314,243,46
060855063012,396,324,72,404,325,79,749,563,171,474,368,70
060855063013,419,289,130,444,306,138,495,373,114,561,389,134
060855063014,402,276,126,424,293,131,382,289,87,473,329,113
060855063022,763,510,253,764,511,253,710,528,169,947,615,256
060855063041,503,385,118,515,392,123,888,660,209,819,623,144
060855063042,194,149,45,198,151,47,305,228,73,170,128,30
060855063043,325,250,75,329,252,77,774,573,182,371,275,64
060855063051,271,180,91,278,184,94,398,277,109,350,232,92
060855063052,434,332,102,442,336,106,904,646,234,566,420,99
060855063054,382,285,97,389,283,106,705,514,177,475,342,90
060855063053,440,322,118,449,319,130,583,421,146,478,339,101
060855066051,840,592,248,860,601,259,916,667,228,764,535,181
060855066052,531,377,154,533,371,162,674,494,166,680,492,148
060855066063,485,357,128,487,354,133,628,467,149,693,505,142
060855066011,624,445,179,635,445,190,811,596,195,715,511,166
060855066012,378,267,111,382,269,113,497,381,110,382,276,91
060855066013,487,363,124,492,366,126,806,591,193,588,446,112
060855066045,695,490,205,709,496,213,847,636,193,750,537,175
060855066041,271,188,83,275,192,83,459,348,100,348,245,84
060855066042,670,468,202,675,470,205,964,702,247,791,550,185
060855066043,687,480,207,694,480,214,887,642,227,770,531,181
060855074022,587,403,184,591,396,195,744,538,188,600,414,149
060855066032,854,576,278,871,571,300,1031,738,263,919,620,230
060855066044,622,431,191,635,432,203,848,586,240,717,472,192
060855067011,289,200,89,293,200,93,369,258,104,316,209,86
060855067013,665,447,218,685,460,225,940,669,252,741,495,200
060855066031,421,297,124,433,296,137,520,377,138,551,386,132
060855066033,491,352,139,501,356,145,716,514,177,600,419,134
060855067012,662,464,198,676,471,205,920,661,229,826,592,182
060855067022,817,570,247,827,559,268,1082,771,283,905,612,236
060855022022,419,299,120,426,300,126,452,345,100,473,323,123
060855022023,302,213,89,307,214,93,283,215,65,321,216,86
060855021011,443,334,109,452,338,114,723,540,160,580,418,123
060855021013,1154,830,324,1173,830,343,1548,1144,363,1085,783,227
060855120222,642,429,213,648,424,224,962,657,292,730,508,179
060855120272,835,582,253,858,597,261,1287,917,349,1034,736,229
060855120261,739,529,210,756,531,225,966,674,275,851,583,220
060855120262,592,425,167,604,422,182,906,632,260,784,540,200
060855120551,922,668,254,934,679,255,1217,890,301,1088,812,218
060855120211,602,443,159,611,440,171,860,610,234,689,500,156
060855120212,633,452,181,644,453,191,901,646,239,753,537,170
060855120213,484,337,147,491,339,152,687,492,181,589,418,133
060855120421,395,281,114,403,283,120,689,441,239,657,479,145
060855120221,418,313,105,418,298,120,472,323,142,422,310,88
060855120433,269,210,59,272,210,62,615,443,159,409,322,62
060855120214,503,357,146,515,359,156,824,526,287,610,443,131
060855120223,414,332,82,416,321,95,856,583,256,565,441,92
060855120231,529,388,141,543,388,155,716,547,153,491,358,101
060855120232,358,294,64,364,293,71,745,568,159,575,433,106
060855120233,381,295,86,389,294,95,675,516,143,617,482,99
060855120451,856,584,272,873,596,277,1100,778,298,955,637,248
060855032182,232,190,42,235,185,50,427,303,114,340,277,51
060855120542,321,248,73,328,251,77,457,339,110,301,234,49
060855120543,208,159,49,211,161,50,566,420,136,368,286,61
060855120541,125,100,25,128,100,28,242,180,58,182,140,30
060855120291,678,482,196,695,487,208,942,667,252,866,601,203
060855120292,837,599,238,846,594,252,1145,818,293,935,639,234
060855120294,704,514,190,718,512,206,1102,797,276,922,632,222
060855120594,2369,1689,680,2422,1683,739,912,655,235,1643,1200,347
060855120371,754,505,249,772,510,262,1012,696,290,847,568,226
060855120372,444,301,143,457,305,152,664,457,189,512,346,131
060855120301,846,538,308,862,537,325,1057,744,288,913,590,238
060855120302,464,308,156,470,307,163,704,489,193,622,395,180
060855120361,303,213,90,309,212,97,1310,913,360,716,506,165
060855120362,621,436,185,629,432,197,918,640,253,1021,734,241
060855120311,293,199,94,301,205,96,460,324,123,371,258,87
060855120312,530,357,173,541,366,175,710,500,191,568,395,136
060855120313,492,319,173,503,323,180,698,490,189,556,371,147
060855120293,314,239,75,321,239,82,444,321,110,356,242,84
060855120593,478,309,169,491,311,180,670,476,180,559,352,161
060855120592,555,365,190,569,361,208,801,568,213,708,449,205
060855120591,549,371,178,559,357,202,646,456,173,579,376,165
060855120321,497,351,146,510,354,156,686,482,185,565,396,130
060855120322,358,249,109,368,251,117,415,296,109,510,340,128
060855120323,372,259,113,382,262,120,523,376,134,546,362,138
060855120341,1016,675,341,1033,661,372,1484,1012,420,894,614,222
060855120352,819,540,279,831,522,309,924,625,274,1074,719,286
060855120342,277,194,83,282,190,92,438,302,117,199,139,45
060855120351,824,541,283,842,533,309,1147,775,347,1113,756,276
060855121001,481,262,219,490,269,221,847,487,346,651,368,248
060855120013,481,335,146,490,337,153,905,607,275,676,468,160
060855120012,807,571,236,821,569,252,918,644,258,752,540,167
060855031272,516,373,143,528,374,154,1216,847,350,696,501,155
060855031271,796,573,223,808,574,234,1029,722,293,795,584,162
060855033122,785,513,272,799,529,270,1015,664,331,874,589,246
060855042022,703,480,223,716,482,234,1092,726,336,867,596,218
060855051002,36,31,5,36,30,6,47,40,7,35,29,6
060855051004,80,66,14,81,65,16,187,155,26,0,0,0
060855051001,409,326,83,416,326,90,657,485,161,554,428,92
060855051003,610,485,125,621,488,133,787,645,128,663,530,95
060855003001,583,505,78,588,496,92,951,826,106,520,430,52
060855004001,422,333,89,428,338,90,640,523,97,502,384,82
060855052031,751,601,150,759,604,155,1360,1058,265,1128,888,160
060855052032,367,289,78,371,293,78,480,388,83,446,354,63
060855004002,639,492,147,653,507,146,735,579,140,585,447,104
060855057003,626,494,132,638,501,137,776,613,149,731,555,119
060855058001,408,301,107,410,301,109,641,480,138,450,330,88
060855006004,440,350,90,447,349,98,468,379,79,499,378,90
060855002003,465,394,71,471,390,81,571,475,78,427,347,50
060855002004,646,558,88,656,550,106,972,820,132,877,731,91
060855008001,607,511,96,613,505,108,746,608,120,660,548,79
060855011011,603,508,95,612,499,113,799,657,124,771,640,84
060855002001,451,380,71,454,377,77,482,408,68,326,266,39
060855002002,46,39,7,46,38,8,251,209,35,402,326,48
060855001004,823,716,107,834,716,118,1398,1156,209,854,707,96
060855001001,305,247,58,311,242,69,338,265,67,396,327,47
060855001002,369,312,57,377,312,65,532,421,104,398,324,48
060855001003,389,328,61,398,328,70,555,430,107,498,401,61
060855036011,159,131,28,165,134,31,335,241,90,256,217,28
060855011021,528,439,89,535,438,97,449,352,91,572,466,70
060855011022,478,417,61,487,416,71,702,569,113,630,528,61
060855011023,433,367,66,436,362,74,439,349,77,468,389,51
060855012001,204,173,31,207,172,35,270,215,47,240,197,25
060855012004,415,357,58,417,352,65,487,393,75,427,347,40
060855011012,719,604,115,729,598,131,938,762,148,983,807,116
060855010002,279,243,36,286,243,43,322,258,53,285,233,32
060855008002,390,329,61,395,327,68,622,509,94,517,413,62
060855010003,255,216,39,259,215,44,350,277,62,258,212,28
060855010001,443,391,52,452,393,59,566,456,94,449,367,51
060855010004,260,222,38,258,219,39,466,368,81,308,248,37
060855010005,182,156,26,184,155,29,378,301,67,309,247,37
060855012002,298,250,48,304,250,54,387,299,77,387,322,45
060855012003,219,186,33,220,185,35,348,281,56,328,265,32
060855014012,208,170,38,210,167,43,385,300,80,179,147,26
060855014011,313,253,60,319,248,71,763,590,151,435,352,61
060855036012,368,309,59,373,305,68,649,499,129,516,429,59
060855014021,222,179,43,225,181,44,411,322,82,272,229,29
060855036021,264,229,35,270,227,43,459,366,86,361,311,31
060855014022,353,293,60,357,295,62,535,419,104,470,390,52
060855015011,423,336,87,433,344,89,637,462,162,481,402,55
060855036023,191,135,56,192,136,56,319,217,97,278,213,51
060855015012,289,232,57,295,238,57,488,375,100,411,335,50
060855015021,353,298,55,359,301,58,494,390,90,502,407,65
060855036022,382,285,97,385,285,100,578,415,153,497,392,78
060855013003,610,534,76,612,532,80,541,453,82,503,426,43
060855013001,543,475,68,544,472,72,639,519,98,757,634,64
060855013002,280,237,43,280,237,43,324,266,51,311,256,32
060855015023,159,128,31,160,128,32,491,377,102,259,214,31
060855016012,756,604,152,769,601,168,844,695,124,568,459,62
060855016021,122,108,14,124,108,16,152,121,27,182,149,18
060855016022,200,178,22,205,178,27,241,192,40,218,178,22
060855016023,335,296,39,341,296,45,607,490,93,562,453,59
060855009011,149,125,24,150,126,24,194,156,33,413,322,56
060855009022,423,365,58,425,364,61,838,652,150,525,421,56
060855009012,570,473,97,570,473,97,516,414,83,638,500,78
060855009013,291,249,42,291,249,42,497,411,74,282,223,32
060855008003,525,445,80,534,443,91,484,391,78,216,174,26
060855017001,222,198,24,224,197,27,450,373,66,239,203,27
060855017002,130,112,18,129,110,19,189,154,27,131,111,12
060855017003,281,243,38,280,238,42,486,407,67,313,267,27
060855017004,236,206,30,235,203,32,429,357,60,260,222,24
060855031131,533,462,71,532,452,80,652,549,94,656,545,72
060855031132,361,312,49,364,304,60,584,491,82,485,408,51
060855018001,335,285,50,340,279,61,454,363,76,368,285,51
060855018002,406,338,68,408,336,72,675,552,110,534,436,68
060855018003,503,418,85,508,413,95,616,506,97,558,434,86
060855024005,783,574,209,785,563,222,966,745,195,824,576,178
060855024006,726,578,148,733,585,148,880,695,160,799,628,123
060855024007,388,308,80,391,306,85,565,440,111,431,337,61
060855015022,142,114,28,142,114,28,348,251,90,294,243,34
060855009021,171,152,19,174,152,22,158,121,28,85,69,8
060855019022,538,437,101,547,440,107,1045,791,233,705,562,99
060855003002,856,750,106,863,737,126,887,723,146,969,789,110
060855006001,572,461,111,576,463,113,416,345,66,599,486,89
060855006003,599,509,90,615,523,92,1094,881,182,729,608,83
060855043181,259,177,82,265,175,90,627,387,232,250,193,46
060855023022,499,381,118,509,380,129,885,695,169,667,497,121
060855037102,320,250,70,324,247,77,552,397,146,356,291,48
060855037112,267,209,58,272,208,64,609,452,145,392,322,53
060855037113,305,258,47,304,247,57,439,300,135,309,268,33
060855005001,682,512,170,694,517,177,735,576,138,683,502,139
060855005002,793,632,161,802,631,171,1074,838,203,804,625,132
060855005003,316,252,64,323,250,73,411,323,79,472,340,102
060855032082,504,354,150,512,356,156,790,534,245,667,531,107
060855120562,298,235,63,302,233,69,497,356,134,386,301,70
060855120572,302,237,65,305,231,74,472,338,129,339,261,65
060855120561,638,498,140,644,488,156,1018,729,270,814,630,136
060855120422,333,252,81,337,247,90,514,367,135,442,332,79
060855120431,588,457,131,596,449,147,734,533,190,636,496,102
060855033371,543,397,146,554,401,153,954,591,352,665,515,118
060855033372,422,314,108,429,315,114,715,441,261,549,441,85
060855033381,656,437,219,664,444,220,1190,798,372,678,488,159
060855031162,639,464,175,655,478,177,674,462,198,660,470,157
060855031161,390,276,114,401,285,116,1096,753,324,724,524,156
060855032071,802,516,286,816,518,298,1343,771,555,939,691,203
060855032072,464,291,173,477,297,180,769,427,336,590,429,135
060855038022,620,441,179,628,455,173,994,670,303,764,589,149
060855031112,371,259,112,378,260,118,526,327,191,435,346,64
060855031113,492,340,152,501,342,159,606,379,220,593,455,117
060855031181,325,240,85,329,241,88,367,242,121,497,406,70
060855031182,178,139,39,181,138,43,443,301,133,314,256,45
060855033051,426,323,103,436,332,104,683,429,246,540,433,76
060855033052,481,369,112,485,370,115,1074,678,387,654,561,61
060855033053,478,365,113,479,361,118,892,558,319,664,527,113
060855043171,795,538,257,813,542,271,1000,676,308,902,661,205
060855043232,459,309,150,473,316,157,1252,850,385,623,476,122
060855043233,354,247,107,364,249,115,443,301,137,444,325,100
060855037072,423,321,102,430,337,93,702,470,222,613,495,87
060855037073,280,243,37,283,240,43,402,316,75,325,270,36
060855037121,138,102,36,138,102,36,344,229,108,202,158,32
060855037122,234,169,65,236,172,64,380,255,121,294,238,47
060855037123,296,218,78,298,220,78,531,355,169,335,273,53
060855043161,670,460,210,686,477,209,1019,662,346,701,514,155
060855043162,677,471,206,693,476,217,968,626,329,943,713,188
060855043152,252,166,86,255,167,88,432,273,151,338,250,69
060855043153,511,340,171,524,345,179,791,500,276,619,454,136
060855043154,379,253,126,388,253,135,534,340,188,417,296,105
060855043201,600,396,204,612,401,211,864,548,308,785,540,215
060855043202,357,234,123,361,235,126,468,296,165,400,275,109
060855031051,569,319,250,581,334,247,707,372,327,626,471,122
060855031171,271,195,76,278,196,82,379,257,114,282,228,47
060855039032,314,250,64,321,243,78,362,269,93,293,237,44
060855040011,341,277,64,346,279,67,600,439,155,495,394,78
060855040012,442,359,83,452,363,89,617,474,127,544,454,66
060855040013,262,212,50,265,213,52,586,427,149,464,382,63
060855040021,462,361,101,474,360,114,749,540,198,534,440,73
060855050113,188,144,44,191,145,46,374,281,83,209,155,41
060855050121,749,621,128,765,632,133,797,623,153,0,0,0
060855050142,322,256,66,329,258,71,401,318,78,413,305,93
060855050102,617,466,151,626,465,161,800,599,188,699,502,146
060855050141,205,170,35,207,171,36,629,495,121,409,331,47
060855050143,266,215,51,272,217,55,754,593,147,899,733,103
060855046021,1194,925,269,1213,924,289,560,447,110,702,563,100
060855050152,374,292,82,378,281,97,351,268,77,478,348,87
060855050132,377,311,66,380,301,79,416,330,75,427,326,71
060855050133,120,101,19,121,99,22,182,146,32,196,154,31
060855050151,267,208,59,271,201,70,723,549,158,362,265,66
060855050065,250,177,73,253,176,77,489,370,109,124,90,24
060855043111,620,417,203,638,429,209,948,688,247,762,572,150
060855043113,462,328,134,476,334,142,843,610,219,399,304,75
060855043114,698,491,207,717,501,216,737,531,190,568,429,111
060855043112,417,298,119,427,303,124,533,356,168,528,395,112
060855043222,271,201,70,277,204,73,568,417,136,429,332,74
060855043183,489,343,146,492,341,151,905,615,277,646,505,111
060855043231,487,323,164,497,332,165,679,445,223,488,359,106
060855044102,595,391,204,603,406,197,1037,651,368,785,606,142
060855045091,177,133,44,181,136,45,1465,1009,434,205,158,38
060855043172,504,342,162,518,338,180,763,492,259,732,528,170
060855043191,645,457,188,659,466,193,818,560,243,674,495,144
060855043192,734,521,213,753,525,228,1213,833,366,857,644,169
060855043193,304,216,88,311,221,90,560,398,149,432,333,80
060855043194,384,275,109,393,269,124,631,433,191,507,371,112
060855038033,355,248,107,363,246,117,536,368,161,427,310,91
060855038032,319,224,95,324,225,99,667,454,199,404,322,73
060855043072,834,583,251,850,582,268,1391,929,442,926,686,202
060855038031,542,373,169,554,370,184,942,645,282,716,520,155
060855038024,634,494,140,637,481,156,982,700,274,744,617,102
060855038041,695,504,191,709,512,197,990,668,313,785,592,158
060855038042,256,191,65,260,194,66,583,369,207,393,297,78
060855038043,377,266,111,383,277,106,833,544,275,522,392,111
060855039021,386,304,82,389,295,94,650,480,160,517,405,91
060855039022,246,195,51,250,189,61,441,327,107,347,269,64
060855039024,268,210,58,271,207,64,564,405,146,446,352,73
060855039031,457,353,104,463,351,112,622,430,185,499,396,75
060855038023,638,470,168,650,478,172,954,657,282,733,551,143
060855038021,496,359,137,507,365,142,649,445,194,506,375,101
060855043071,802,555,247,819,546,273,1413,941,443,1031,731,256
060855043083,545,360,185,563,357,206,720,485,229,699,494,165
060855042011,1198,789,409,1211,781,430,1341,903,413,1031,676,295
060855043081,682,402,280,696,412,284,973,631,325,759,515,198
060855043082,555,364,191,576,363,213,741,485,247,613,448,135
060855044111,874,560,314,903,581,322,1287,817,443,1082,744,275
060855044241,395,220,175,401,225,176,424,269,152,428,279,122
060855043144,457,316,141,469,322,147,642,417,214,449,331,95
060855043155,387,276,111,399,285,114,721,474,231,513,390,97
060855043213,373,270,103,384,266,118,637,415,212,470,349,106
060855043211,729,515,214,756,533,223,1066,696,353,896,654,192
060855043151,488,325,163,497,328,169,773,489,270,591,428,133
060855043141,457,316,141,466,314,152,631,406,210,500,374,100
060855043142,357,249,108,368,248,120,523,342,174,423,323,82
060855043143,272,185,87,281,189,92,422,273,144,308,225,68
060855044101,567,402,165,571,391,180,975,611,347,708,516,158
060855044112,731,499,232,758,520,238,1264,807,437,932,672,189
060855050061,857,666,191,878,672,206,1062,751,291,662,503,120
060855050063,282,211,71,292,213,79,302,230,65,734,558,132
060855050062,148,123,25,150,123,27,776,586,170,0,0,0
060855050064,214,178,36,218,180,38,407,308,88,700,519,130
060855043221,315,243,72,323,243,80,510,374,122,355,274,61
060855043223,311,240,71,315,238,77,653,479,154,573,431,107
060855045054,471,350,121,488,358,130,1341,958,364,198,146,42
060855037081,821,606,215,832,610,222,1037,659,362,1029,814,173
060855043212,339,245,94,347,241,106,676,439,229,438,349,78
060855050131,185,158,27,188,154,34,221,176,39,300,235,46
060855037091,410,303,107,423,306,117,1286,752,517,507,417,73
060855037131,382,300,82,389,293,96,630,418,199,484,391,72
060855037132,180,142,38,183,139,44,275,201,70,206,168,30
060855037101,329,277,52,326,262,64,555,375,170,353,301,37
060855037071,236,179,57,242,191,51,499,332,158,307,243,48
060855037111,164,138,26,163,131,32,301,205,92,241,204,25
060855035062,317,263,54,321,261,60,548,424,117,397,339,41
060855035071,367,299,68,370,298,72,703,534,155,535,463,58
060855037032,356,301,55,359,298,61,623,484,134,474,404,51
060855037031,247,209,38,252,207,45,578,443,123,409,349,45
060855040022,211,181,30,214,181,33,404,289,105,330,294,28
060855040023,361,310,51,366,310,56,585,423,155,455,410,37
060855035082,384,312,72,391,310,81,536,396,126,428,362,45
060855035083,353,295,58,359,293,66,672,500,154,512,417,70
060855041021,599,469,130,607,464,143,763,562,188,625,496,100
060855041022,251,211,40,256,212,44,480,365,106,407,348,49
060855041011,353,263,90,357,259,98,462,338,118,406,310,72
060855041013,408,328,80,414,321,93,465,343,112,472,369,78
060855041012,333,276,57,339,272,67,565,422,134,449,359,69
060855041023,292,244,48,294,243,51,533,402,117,396,335,48
060855035101,381,310,71,392,315,77,683,525,140,609,511,70
060855035102,291,240,51,292,236,56,542,400,134,333,287,33
060855035103,332,270,62,338,270,68,597,453,136,477,402,54
060855035112,440,355,85,450,359,91,665,492,166,566,475,68
060855035111,420,318,102,426,307,119,712,507,194,516,432,68
060855035063,365,298,67,373,298,75,622,472,136,498,427,49
060855035061,462,364,98,473,368,105,786,575,196,507,436,52
060855035041,255,220,35,258,224,34,401,309,86,312,276,22
060855035042,325,283,42,327,282,45,459,354,98,350,312,24
060855035044,359,300,59,365,301,64,662,491,165,476,412,51
060855035043,246,207,39,247,207,40,390,298,82,373,323,39
060855037092,292,194,98,299,200,99,422,243,172,357,283,60
060855034011,385,322,63,387,311,76,417,328,85,303,268,27
060855034012,320,267,53,318,257,61,528,408,107,428,377,36
060855034013,431,361,70,434,350,84,632,489,128,490,424,46
060855034021,274,228,46,272,221,51,570,450,115,508,439,51
060855034023,303,233,70,310,237,73,491,311,174,406,344,53
060855034022,78,60,18,80,61,19,463,292,164,154,131,19
060855042013,660,469,191,670,476,194,820,564,235,658,481,148
060855035091,412,340,72,418,339,79,638,491,137,507,421,69
060855035092,563,429,134,572,429,143,886,625,246,716,576,123
060855033221,365,289,76,371,289,82,590,394,182,456,371,68
060855033123,244,194,50,246,199,47,372,282,82,285,236,39
060855037093,365,235,130,373,244,129,438,243,189,432,339,77
060855042012,427,292,135,432,295,137,751,522,218,594,404,159
060855020011,291,243,48,296,244,52,485,385,78,415,328,55
060855020012,204,154,50,211,160,51,314,230,76,314,231,62
060855020014,563,465,98,570,466,104,735,588,124,614,482,84
060855020021,200,173,27,204,173,31,240,202,35,215,173,25
060855020023,621,515,106,627,513,114,985,804,161,723,577,97
060855033263,679,443,236,712,467,245,995,665,323,809,587,191
060855033222,539,406,133,552,401,151,826,577,238,656,520,108
060855031172,263,194,69,270,195,75,411,277,126,316,256,51
060855031221,435,282,153,443,286,157,1089,569,505,438,345,71
060855031222,331,240,91,344,247,97,392,204,182,359,263,76
060855005005,368,266,102,370,264,106,498,364,128,446,300,111
060855027043,620,410,210,639,423,216,743,519,207,674,456,176
060855027041,369,272,97,377,278,99,498,344,144,351,254,81
060855068021,610,429,181,620,433,187,884,640,213,793,546,186
060855032202,675,534,141,682,527,155,883,612,256,688,553,102
060855032203,183,146,37,187,145,42,418,293,116,359,291,50
060855020022,307,270,37,310,261,49,814,664,126,320,269,31
060855033324,1804,1155,649,1830,1169,661,1903,1362,515,1401,936,400
060855032201,352,274,78,360,274,86,558,384,161,435,343,73
060855031241,687,534,153,697,524,173,952,691,240,744,554,141
060855031242,169,133,36,172,126,46,475,343,119,299,230,51
060855019011,740,608,132,755,615,140,1231,1006,187,997,787,149
060855063024,237,188,49,239,185,54,344,256,80,402,303,75
060855063023,357,267,90,363,271,92,447,332,105,438,322,88
060855064012,322,255,67,325,251,74,587,443,126,594,431,127
060855064013,557,410,147,564,413,151,531,404,114,461,335,98
060855063021,769,566,203,785,569,216,629,472,146,925,664,195
060855065051,384,295,89,395,304,91,622,462,145,380,295,58
060855065052,712,521,191,724,525,199,1011,730,257,951,690,190
060855065041,185,132,53,188,136,52,353,263,82,194,151,30
060855065042,183,130,53,187,135,52,510,379,118,299,231,46
060855064021,451,334,117,459,335,124,517,391,111,533,387,119
060855064024,344,267,77,346,260,86,538,410,116,420,306,87
060855064025,367,284,83,373,278,95,583,442,126,394,292,72
060855064023,282,210,72,288,209,79,425,325,89,388,271,92
060855064022,360,266,94,366,263,103,333,256,71,342,241,83
060855064014,545,393,152,554,400,154,637,452,172,403,290,86
060855064011,118,85,33,120,87,33,292,207,77,243,176,52
060855058002,436,311,125,443,317,126,524,389,115,432,305,97
060855058003,448,324,124,452,326,126,482,363,105,449,321,96
060855059022,587,427,160,604,437,167,947,703,230,727,523,178
060855059011,401,279,122,410,285,125,487,378,102,509,365,109
060855005004,457,331,126,462,333,129,578,453,112,524,384,107
060855058004,511,380,131,518,378,140,642,478,142,621,462,117
060855006002,524,421,103,530,424,106,433,357,68,559,448,83
060855020013,469,355,114,481,361,120,662,504,132,583,425,117
060855019021,519,454,65,524,439,85,938,768,145,476,377,68
060855021012,358,269,89,362,268,94,466,347,103,405,292,86
060855021041,442,341,101,448,344,104,528,409,106,495,358,98
060855021042,238,184,54,242,184,58,422,326,85,439,314,99
060855026012,399,263,136,408,266,142,564,388,157,506,331,143
060855029021,1260,847,413,1294,867,427,1483,1097,348,1386,961,337
060855021031,378,291,87,383,293,90,621,478,127,640,481,109
060855021032,664,524,140,671,518,153,859,658,176,696,542,106
060855022031,804,628,176,823,640,183,1080,805,245,754,565,143
060855022032,528,412,116,535,414,121,776,578,175,620,474,102
060855022042,174,140,34,176,139,37,371,287,74,369,287,52
060855022041,451,358,93,457,357,100,786,609,157,766,590,133
060855022021,563,414,149,569,420,149,488,381,97,384,297,67
060855023011,737,521,216,743,528,215,868,665,183,846,572,219
060855023012,855,616,239,862,621,241,1131,882,227,919,679,180
060855023021,649,472,177,671,482,189,807,644,143,693,511,138
060855026013,580,377,203,585,383,202,764,536,202,680,445,195
060855029031,1231,819,412,1251,832,419,1278,969,293,1298,904,326
060855026011,491,331,160,495,329,166,508,365,128,426,288,109
060855025005,381,274,107,390,275,115,557,397,146,462,323,106
060855025006,694,495,199,711,497,214,842,604,219,738,517,173
060855025004,608,409,199,619,414,205,678,480,177,627,425,160
060855024001,413,301,112,417,304,113,468,367,92,423,320,82
060855024002,401,292,109,405,295,110,462,360,92,433,326,84
060855024003,374,273,101,378,278,100,456,353,92,406,308,72
060855031231,522,394,128,530,398,132,631,475,142,543,427,84
060855031232,333,257,76,341,258,83,577,429,135,430,337,66
060855018004,577,484,93,583,491,92,722,578,129,650,545,78
060855024004,547,399,148,559,413,146,620,473,130,539,410,91
060855025001,501,366,135,503,362,141,622,485,126,553,394,119
060855025003,594,433,161,604,432,172,708,546,150,602,431,131
060855025002,523,371,152,531,376,155,628,480,130,557,396,121
060855030011,665,461,204,682,472,210,807,610,185,711,494,178
060855030013,987,672,315,1006,679,327,1256,934,300,1087,758,269
060855031251,691,495,196,702,491,211,1101,803,276,795,580,169
060855031252,448,308,140,458,311,147,490,358,123,491,347,117
060855031211,268,179,89,277,179,98,260,141,115,371,263,84
060855032112,678,485,193,695,488,207,954,536,413,813,628,142
060855032121,476,328,148,492,329,163,677,387,278,556,418,112
060855033273,602,443,159,612,445,167,740,526,206,609,454,128
060855033292,557,393,164,571,403,168,876,628,237,663,503,132
060855033301,828,627,201,843,633,210,1167,868,275,1046,809,195
060855033303,662,472,190,674,479,195,1099,819,260,710,557,133
060855016011,403,344,59,400,334,66,552,437,102,389,314,49
060855031123,305,256,49,308,248,60,470,372,85,338,279,38
060855031122,349,287,62,346,275,71,435,340,79,444,355,56
060855031121,296,244,52,297,235,62,416,332,77,345,280,42
060855031213,249,196,53,251,193,58,373,283,82,257,210,35
060855031212,514,417,97,517,408,109,821,640,157,750,582,125
060855031261,601,412,189,619,417,202,1634,1116,495,1172,814,297
060855032222,930,633,297,951,638,313,616,347,260,565,433,120
060855032131,467,304,163,479,292,187,747,427,311,389,300,73
060855032132,560,366,194,574,369,205,1158,649,501,895,676,182
060855032211,195,118,77,198,127,71,593,331,254,281,221,49
060855032212,438,270,168,441,282,159,460,261,194,510,400,90
060855031101,322,235,87,331,233,98,682,428,245,320,268,41
060855031102,170,123,47,174,122,52,345,215,125,163,136,21
060855031103,62,45,17,63,44,19,337,208,121,190,160,24
060855031111,180,126,54,183,126,57,343,211,124,279,224,39
060855031183,250,200,50,252,199,53,611,415,184,366,295,54
060855032111,674,452,222,690,452,238,1013,599,399,836,652,149
060855032122,408,280,128,418,278,140,645,379,254,553,419,115
060855032123,335,224,111,341,224,117,463,273,183,444,333,95
060855032221,292,201,91,299,200,99,848,479,358,472,378,79
060855032191,282,198,84,289,198,91,575,383,180,390,303,67
060855032192,284,199,85,291,200,91,572,380,180,390,304,66
060855032101,491,338,153,494,333,161,1002,590,394,726,584,105
060855032102,492,337,155,495,331,164,807,473,325,604,468,118
060855032081,490,384,106,491,371,120,727,516,196,599,483,88
060855120571,748,540,208,757,531,226,1201,770,414,742,548,148
060855032171,286,234,52,290,229,61,518,360,150,326,276,35
060855032172,275,220,55,276,218,58,446,317,121,353,298,37
060855032173,236,190,46,239,187,52,365,262,98,296,251,30
060855032183,268,223,45,269,214,55,374,267,101,288,238,42
060855032181,227,189,38,231,182,49,409,291,110,327,266,48
060855031163,464,312,152,475,314,161,625,372,245,501,358,119
060855120055,837,572,265,851,578,273,1202,813,358,982,656,261
060855120052,362,228,134,366,221,145,467,324,133,292,182,88
060855120053,368,232,136,371,224,147,489,340,138,321,198,97
060855033042,371,288,83,377,285,92,583,364,212,419,344,62
060855033043,439,297,142,439,290,149,513,320,185,552,401,128
060855033382,939,588,351,953,609,344,1342,909,410,1276,830,396
060855120014,854,588,266,879,606,273,1108,779,310,723,510,168
060855033392,811,508,303,822,525,297,1322,898,397,1041,702,299
060855120391,348,236,112,357,243,114,834,557,266,529,376,123
060855120392,419,285,134,427,291,136,571,380,182,481,342,111
060855120393,550,377,173,557,381,176,778,514,245,722,518,165
060855033311,1141,758,383,1164,770,394,1342,948,376,1139,766,320
060855033312,463,328,135,472,327,145,757,540,216,610,456,125
060855033304,726,517,209,740,527,213,907,651,243,647,483,137
060855033332,897,658,239,912,661,251,1288,913,359,1159,870,239
060855120011,305,219,86,313,220,93,484,341,134,352,253,76
060855033321,965,610,355,974,610,364,1087,771,300,1242,771,430
060855033322,399,247,152,407,254,153,549,391,152,399,247,137
060855033302,333,249,84,339,253,86,964,717,226,641,508,104
060855033133,537,409,128,547,405,142,822,570,234,627,462,133
060855033231,699,516,183,712,516,196,1131,778,334,819,643,139
060855033391,625,435,190,638,439,199,1222,830,368,772,560,177
060855033323,420,293,127,425,287,138,682,481,188,652,473,142
060855042023,614,412,202,620,408,212,851,563,272,680,468,171
060855033262,823,570,253,850,603,247,1420,948,452,1001,750,214
060855033131,548,395,153,560,409,151,872,607,251,659,493,136
060855033132,664,448,216,670,446,224,959,677,279,780,575,167
060855033271,568,427,141,586,427,159,813,568,229,601,482,97
060855033272,553,415,138,560,414,146,797,562,225,676,527,121
060855033241,633,452,181,646,463,183,1094,747,334,746,589,130
060855033242,483,350,133,494,357,137,712,487,217,627,503,106
060855035081,428,367,61,439,365,74,830,627,182,618,510,76
060855033223,392,276,116,401,273,128,627,426,191,462,355,93
060855033121,242,168,74,241,163,78,356,249,101,266,193,54
060855033232,866,619,247,883,618,265,1373,901,463,1025,786,205
060855033211,600,391,209,615,418,197,941,610,312,727,556,145
060855033212,739,525,214,756,546,210,1288,834,433,1009,776,200
060855033151,620,453,167,626,456,170,917,593,307,760,596,130
060855033152,308,229,79,313,227,86,565,369,192,464,363,83
060855033153,381,283,98,384,279,105,1091,712,371,591,476,91
060855033154,556,416,140,569,413,156,736,481,251,588,470,100
060855033251,704,513,191,718,517,201,1158,789,357,801,611,156
060855033252,710,532,178,727,536,191,1102,753,329,846,679,133
060855033261,550,397,153,565,405,160,983,663,303,697,544,127
060855033291,642,454,188,667,484,183,1146,822,310,748,590,135
060855033362,609,437,172,615,429,186,872,558,304,780,621,138
060855033331,537,387,150,548,393,155,1031,692,323,915,713,172
060855033361,301,223,78,307,228,79,650,457,185,389,319,57
060855033044,310,195,115,312,196,116,266,167,95,292,213,70
060855033041,300,235,65,306,234,72,682,424,245,505,422,69
060855120432,307,244,63,311,244,67,636,459,166,336,265,52
060855120381,354,252,102,364,260,104,746,498,239,574,421,127
060855120382,374,265,109,383,272,111,645,447,190,522,389,113
060855027011,683,495,188,700,507,193,785,557,209,654,464,147
060855027013,490,359,131,499,367,132,832,588,221,706,491,162
060855027012,686,464,222,702,473,229,832,589,220,847,581,215
060855029013,452,317,135,464,319,145,580,432,135,509,356,118
060855029014,663,479,184,677,486,191,1009,725,250,823,568,191
060855026041,452,346,106,459,347,112,658,484,159,528,367,119
060855026033,582,370,212,588,373,215,562,425,129,476,327,118
060855029011,603,415,188,617,417,200,769,554,192,664,461,153
060855029012,692,506,186,709,497,212,881,666,194,796,565,184
060855029022,1208,882,326,1230,890,340,1489,1115,321,1337,957,285
060855029023,1122,813,309,1149,822,327,1519,1116,356,1244,869,289
060855029032,722,496,226,735,496,239,889,671,203,825,573,197
060855030012,560,371,189,575,376,199,672,481,180,569,393,143
060855029033,753,511,242,757,516,241,1008,750,240,880,629,196
060855030022,955,660,295,980,669,311,1284,932,329,1107,758,283
060855029071,903,615,288,911,617,294,1091,793,279,985,683,230
060855030032,652,434,218,658,427,231,824,551,250,743,461,226
060855030033,728,482,246,742,486,256,1005,680,305,858,551,250
060855030021,602,420,182,617,421,196,776,573,187,672,482,148
060855030031,871,563,308,893,562,331,1184,792,357,1000,633,305
060855029093,623,421,202,635,418,217,721,518,189,739,507,185
060855029094,331,253,78,336,247,89,547,390,142,441,329,82
060855029104,306,234,72,310,228,82,476,340,124,389,292,72
060855029072,868,592,276,880,604,276,967,695,251,950,631,254
060855029101,353,245,108,360,245,115,483,342,132,425,285,110
060855029103,191,130,61,198,133,65,326,229,86,275,187,68
060855029091,457,311,146,466,316,150,540,386,143,542,367,139
060855029092,395,269,126,403,273,130,368,267,97,374,257,95
060855029062,1004,694,310,1022,702,320,874,615,238,809,551,201
060855029063,544,384,160,562,386,176,767,542,210,658,442,170
060855029061,385,265,120,389,265,124,685,486,179,546,379,129
060855029082,1110,765,345,1128,756,372,1350,960,354,1215,830,297
060855029083,717,490,227,733,488,245,923,669,239,803,543,200
060855029081,756,518,238,766,514,252,1139,817,289,916,628,220
060855028001,535,352,183,549,359,190,817,534,265,656,406,205
060855028002,621,431,190,628,440,188,842,614,206,726,486,187
060855028003,522,349,173,535,356,179,648,439,196,573,355,178
060855027042,507,333,174,520,338,182,712,490,206,585,379,170
060855027033,700,479,221,721,491,230,955,678,255,719,485,186
060855068041,336,218,118,341,223,118,365,259,98,332,220,91
060855068042,515,351,164,525,355,170,709,523,174,578,385,155
060855031243,239,187,52,242,188,54,401,305,91,360,292,53
060855117072,807,559,248,822,562,260,845,600,221,730,503,181
060855113013,431,360,71,440,365,75,672,577,76,522,434,53
060855113011,713,617,96,718,617,101,745,654,88,738,625,76
060855113021,549,465,84,561,476,85,798,695,89,700,600,67
060855113022,329,279,50,335,284,51,405,357,43,386,333,38
060855113024,559,480,79,571,494,77,697,606,76,633,541,58
060855113023,334,286,48,341,293,48,417,364,46,400,341,37
060855116091,1107,898,209,1134,930,204,1583,1374,172,1249,1044,148
060855115011,539,469,70,551,471,80,478,420,54,571,511,40
060855115012,769,663,106,785,664,121,981,834,126,968,805,113
060855115013,925,804,121,940,804,136,862,741,108,1011,860,90
060855117051,487,409,78,494,413,81,879,737,121,514,425,61
060855115022,1091,994,97,1109,998,111,627,592,27,1005,940,27
060855094011,413,342,71,423,346,77,577,481,81,494,396,65
060855094012,302,231,71,303,225,78,433,345,75,312,243,51
060855107001,333,286,47,343,289,54,501,425,68,353,305,31
060855107002,667,554,113,686,562,124,976,789,159,812,675,88
060855093022,592,475,117,599,468,131,699,536,144,730,565,118
060855108021,474,385,89,483,394,89,468,379,78,497,418,54
060855108022,479,388,91,491,400,91,569,464,93,550,463,62
060855106001,331,276,55,336,277,59,410,346,57,327,275,34
060855106002,986,814,172,1007,825,182,1357,1145,188,974,819,107
060855106003,927,719,208,948,728,220,1214,1011,176,1243,973,179
060855107003,907,696,211,932,696,236,1246,993,222,975,724,180
060855093041,413,332,81,428,338,90,703,572,116,496,408,55
060855108031,786,622,164,804,624,180,745,622,108,661,543,84
060855108032,536,433,103,543,436,107,774,630,125,631,528,78
060855109003,648,519,129,665,523,142,890,752,123,804,647,106
060855109002,848,684,164,870,690,180,1141,955,157,1061,873,130
060855109001,808,658,150,835,675,160,870,729,122,835,693,101
060855114001,362,294,68,370,295,75,413,359,48,404,334,43
060855114002,553,443,110,563,446,117,662,571,81,606,498,66
060855114003,412,329,83,419,331,88,397,341,48,424,351,47
060855114004,597,457,140,604,461,143,740,631,104,621,510,79
060855113012,686,574,112,698,584,114,800,684,92,821,693,81
060855112001,749,613,136,766,631,135,884,770,102,804,676,83
060855112002,824,665,159,838,684,154,849,735,98,888,738,93
060855112003,473,396,77,481,406,75,435,381,47,472,412,40
060855112004,561,487,74,569,495,74,678,586,86,588,518,47
060855111001,844,662,182,867,678,189,1026,877,130,1018,864,114
060855111002,739,599,140,765,615,150,981,837,124,758,620,103
060855111003,661,521,140,676,531,145,894,744,123,716,589,100
060855111004,633,501,132,653,518,135,755,637,105,704,583,92
060855110002,622,525,97,627,526,101,703,570,120,709,579,94
060855110005,727,595,132,735,599,136,859,695,145,817,657,113
060855110001,528,426,102,539,431,108,791,642,133,721,573,102
060855110003,326,255,71,331,255,76,426,344,72,346,276,49
060855110004,561,424,137,574,426,148,777,631,133,623,482,101
060855046011,384,306,78,395,312,83,437,356,73,371,270,76
060855108011,851,710,141,874,736,138,916,773,125,944,789,110
060855108012,1024,813,211,1049,829,220,1253,1053,180,1146,937,153
060855108014,440,341,99,451,345,106,565,470,84,361,289,53
060855108013,477,367,110,490,374,116,623,505,102,655,522,103
060855106004,424,315,109,436,316,120,563,449,100,552,432,90
060855105002,925,678,247,953,694,259,1204,965,218,844,670,134
060855117011,714,496,218,728,503,225,823,631,171,694,504,145
060855117043,1131,734,397,1151,737,414,1225,877,324,1105,734,298
060855105001,565,412,153,578,419,159,853,682,155,602,472,103
060855105003,1148,804,344,1180,822,358,1276,1025,233,1324,974,272
060855104001,715,513,202,749,544,205,1085,874,187,875,667,171
060855104002,517,382,135,534,398,136,430,348,74,421,331,73
060855098012,393,315,78,405,326,79,451,379,66,373,292,55
060855104003,509,381,128,525,395,130,581,466,101,625,493,102
060855102003,880,635,245,901,647,254,1109,879,211,862,633,181
060855103003,572,400,172,582,414,168,644,514,124,615,444,138
060855117012,1025,676,349,1044,687,357,1293,946,317,1079,734,261
060855098013,703,581,122,720,593,127,617,519,88,698,583,75
060855102001,954,679,275,972,686,286,1174,924,220,1045,771,204
060855102002,552,407,145,563,419,144,661,522,123,663,504,124
060855100022,583,416,167,588,417,171,734,578,139,632,468,126
060855100023,641,432,209,647,433,214,731,580,140,608,452,125
060855101001,818,569,249,833,578,255,1071,837,205,993,731,202
060855117022,440,300,140,446,305,141,528,395,115,427,305,97
060855103001,857,626,231,877,643,234,888,716,153,898,697,142
060855103002,853,649,204,887,667,220,1200,967,208,968,723,193
060855099011,694,527,167,705,536,169,790,640,136,654,517,102
060855100015,471,350,121,476,359,117,574,462,102,467,353,86
060855100016,427,322,105,437,331,106,493,396,87,467,360,79
060855100013,664,475,189,675,480,195,712,573,127,651,485,126
060855078051,403,295,108,405,294,111,503,383,111,577,431,113
060855100021,753,558,195,762,561,201,958,754,182,730,563,131
060855100012,945,687,258,963,688,275,1098,889,189,989,744,187
060855100011,459,347,112,462,344,118,526,422,94,504,394,84
060855101002,871,613,258,886,618,268,1026,804,196,824,595,182
060855077041,410,304,106,420,308,112,679,537,132,506,371,103
060855117071,972,671,301,985,684,301,1045,819,206,891,653,181
060855100014,370,259,111,378,266,112,589,475,105,495,373,92
060855117021,1118,767,351,1147,775,372,1400,1045,305,1191,853,269
060855117013,558,370,188,564,376,188,689,506,157,595,422,130
060855117042,297,202,95,303,204,99,522,389,119,422,298,97
060855117041,1262,839,423,1286,846,440,1476,1095,342,1315,913,320
060855093021,812,682,130,819,672,147,793,648,126,886,713,114
060855093033,246,208,38,250,206,44,297,240,47,309,247,46
060855093034,322,266,56,328,265,63,505,410,80,309,247,46
060855094031,393,333,60,398,331,67,633,518,98,534,433,64
060855094032,232,196,36,234,195,39,319,261,49,283,230,34
060855094033,263,223,40,267,222,45,408,334,63,294,237,35
060855094042,226,189,37,228,188,40,309,254,48,298,246,33
060855091092,949,793,156,971,803,168,606,496,93,616,510,68
060855092011,482,411,71,485,414,71,573,477,83,456,381,47
060855092013,176,148,28,178,149,29,488,404,71,348,290,36
060855095001,464,404,60,476,404,72,514,422,79,641,539,55
060855095002,551,467,84,561,471,90,861,715,126,631,530,53
060855095003,611,513,98,616,517,99,708,597,104,695,575,68
060855092021,637,519,118,652,526,126,794,659,116,718,573,103
060855092022,379,300,79,391,307,84,406,337,60,355,282,52
060855092023,288,222,66,296,226,70,405,333,62,424,332,68
060855092024,344,258,86,356,267,89,346,285,59,450,348,75
060855093032,336,260,76,344,264,80,453,369,72,355,286,51
060855091111,642,507,135,654,514,140,890,735,143,819,634,134
060855091071,434,355,79,441,358,83,749,587,143,570,458,76
060855091112,722,564,158,737,571,166,834,681,135,625,497,89
060855091091,585,467,118,593,473,120,1011,839,154,651,523,80
060855091093,307,257,50,315,259,56,631,520,95,565,473,59
060855091082,247,201,46,250,200,50,342,278,55,337,266,48
060855091021,766,611,155,772,612,160,865,708,137,794,624,123
060855091084,487,403,84,491,394,97,575,473,88,505,402,65
060855092012,434,355,79,446,361,85,584,480,91,617,495,79
060855092014,486,389,97,497,397,100,547,433,97,551,434,79
060855096002,369,319,50,380,327,53,458,397,54,494,418,44
060855096003,534,457,77,549,470,79,672,579,79,585,495,52
060855096001,437,354,83,443,356,87,567,492,66,478,399,48
060855098011,587,473,114,604,487,117,910,759,129,718,572,103
060855098014,794,611,183,807,620,187,1006,821,163,848,664,131
060855047001,96,63,33,96,63,33,182,124,53,78,45,27
060855091081,342,277,65,354,283,71,468,383,73,481,373,75
060855091083,326,263,63,334,267,67,496,413,75,381,294,60
060855097002,427,367,60,438,372,66,445,380,53,487,417,41
060855094013,237,199,38,244,202,42,508,422,71,304,247,39
060855099012,456,343,113,462,346,116,557,455,91,516,408,80
060855098022,691,542,149,701,556,145,763,622,129,727,589,105
060855099021,1027,818,209,1046,827,219,1478,1190,256,1000,791,147
060855099022,633,474,159,643,472,171,650,523,113,904,675,174
060855099023,740,531,209,753,539,214,804,647,141,944,688,201
060855098021,542,446,96,553,446,107,723,613,90,671,542,87
060855097003,459,383,76,470,388,82,496,411,75,438,359,53
060855097001,530,454,76,542,460,82,513,445,59,455,393,38
060855094043,639,528,111,654,534,120,509,417,80,492,410,52
060855091072,166,136,30,171,138,33,488,363,107,346,252,70
060855091073,234,192,42,237,193,44,506,389,102,385,300,60
060855094041,426,349,77,436,358,78,639,534,91,550,455,70
060855094044,296,243,53,301,248,53,675,561,94,445,365,57
060855091101,467,373,94,474,375,99,773,623,133,511,396,82
060855084015,565,408,157,573,414,159,652,496,144,585,424,124
060855091102,459,371,88,467,374,93,703,576,113,590,462,88
060855093031,311,256,55,316,260,56,460,373,73,451,363,59
060855093042,627,510,117,637,516,121,746,605,122,700,575,78
060855116082,123,113,10,123,112,11,396,364,23,344,314,12
060855116081,19,18,1,19,18,1,36,35,1,5,5,0
060855130001,123,114,9,125,114,11,197,184,7,81,74,2
060855130006,305,282,23,308,280,28,692,646,27,386,350,12
060855130004,225,208,17,228,207,21,847,795,35,313,282,9
060855130002,586,540,46,591,537,54,254,239,10,418,377,11
060855130003,1,1,0,1,1,0,69,65,3,156,141,4
060855130005,182,168,14,185,168,17,250,234,9,266,239,7
060855115021,379,341,38,386,346,40,238,223,9,684,614,38
060855077042,918,636,282,940,645,295,1259,934,296,1061,757,244
060855077023,1166,819,347,1198,852,346,1380,1045,304,1127,842,236
060855081011,780,563,217,805,582,223,713,530,169,832,611,177
060855081013,638,478,160,644,481,163,950,711,220,677,530,117
060855081022,159,119,40,166,126,40,528,399,113,186,138,36
060855080061,920,642,278,944,661,283,1025,752,239,918,678,179
060855080052,499,359,140,513,368,145,746,556,172,579,425,128
060855080062,462,307,155,477,315,162,536,404,127,537,372,131
060855080031,345,251,94,355,259,96,712,513,179,582,431,117
060855078062,272,200,72,278,204,74,669,502,153,556,418,116
060855078063,118,91,27,123,97,26,570,425,131,320,248,57
060855078064,387,291,96,397,301,96,567,422,132,349,271,64
060855081012,743,549,194,766,569,197,890,665,207,899,667,176
060855077021,920,669,251,948,691,257,1230,936,275,1029,780,205
060855077022,803,560,243,829,571,258,1028,790,229,1035,786,199
060855077013,510,339,171,525,348,177,624,461,149,566,410,128
060855078071,483,362,121,502,364,138,646,481,154,544,410,104
060855078072,661,468,193,682,481,201,1035,777,236,811,612,162
060855078081,445,312,133,459,327,132,492,373,110,430,326,88
060855078082,498,356,142,512,366,146,865,655,194,703,539,142
060855080051,379,268,111,391,275,116,684,512,160,383,277,87
060855080053,352,249,103,362,254,108,375,282,88,414,305,87
060855080032,283,203,80,291,210,81,292,215,68,270,200,52
060855080042,504,363,141,519,367,152,714,508,189,618,456,127
060855077011,432,314,118,440,308,132,348,258,79,470,352,94
060855078052,500,365,135,511,362,149,446,335,102,545,407,111
060855078053,204,161,43,207,162,45,468,347,109,359,286,57
060855078054,460,319,141,466,328,138,691,507,172,620,450,133
060855082033,958,711,247,978,722,256,1177,898,239,956,715,187
060855083052,163,125,38,167,126,41,454,332,110,271,213,44
060855077051,911,632,279,934,662,272,1056,824,208,987,737,189
060855077052,419,305,114,431,315,116,738,577,145,565,429,101
060855077053,495,387,108,509,396,113,667,518,133,544,415,93
060855078061,521,387,134,541,399,142,471,355,108,401,301,85
060855077012,672,466,206,709,511,198,993,762,212,780,585,165
060855078084,794,562,232,817,581,236,1111,841,249,960,715,200
060855068014,338,220,118,348,224,124,483,352,122,395,273,102
060855069004,1200,803,397,1230,819,411,1564,1130,394,1436,980,362
060855071001,537,370,167,543,377,166,590,426,152,584,416,130
060855072031,514,354,160,522,358,164,807,566,216,610,412,159
060855072032,659,439,220,669,446,223,841,601,219,683,470,172
060855072053,732,482,250,748,495,253,961,683,254,898,597,241
060855071002,825,593,232,833,599,234,1109,806,275,924,657,209
060855072061,775,472,303,786,477,309,1056,717,322,854,561,236
060855067032,392,292,100,397,291,106,661,470,174,374,270,81
060855067033,279,208,71,283,207,76,470,320,136,322,231,70
060855070022,761,518,243,772,510,262,688,509,162,618,439,147
060855072054,413,268,145,418,273,145,463,334,123,471,312,130
060855070031,518,371,147,525,374,151,644,495,134,509,370,107
060855070043,319,227,92,324,229,95,467,362,97,360,261,78
060855070021,1030,696,334,1052,709,343,1235,913,299,1148,814,284
060855070041,992,682,310,1007,684,323,1107,804,276,1052,764,236
060855070032,1105,686,419,1125,703,422,1257,854,372,1261,827,367
060855072051,335,222,113,336,222,114,408,292,108,394,267,95
060855072052,991,633,358,1013,659,354,1023,730,271,987,645,292
060855068011,939,632,307,959,646,313,1223,885,308,965,662,237
060855068013,805,555,250,811,561,250,1067,805,244,877,620,211
060855073015,911,541,370,922,546,376,1022,695,304,855,553,250
060855068012,736,494,242,748,500,248,933,656,253,895,608,229
060855072062,776,487,289,790,494,296,944,654,274,818,547,224
060855070042,662,470,192,674,476,198,968,701,244,704,504,169
060855026031,332,233,99,340,232,108,403,300,91,393,273,89
060855026032,448,317,131,456,312,144,496,369,113,393,281,83
060855026042,369,275,94,373,273,100,569,422,128,394,276,92
060855026043,764,572,192,779,578,201,1056,796,237,834,628,152
060855065023,667,521,146,678,519,159,1251,949,270,798,585,161
060855065031,858,642,216,879,656,223,1153,838,290,1032,729,226
060855065021,665,497,168,678,501,177,799,606,169,784,577,148
060855065022,423,316,107,429,317,112,498,376,108,422,313,80
060855065032,890,661,229,906,677,229,1180,847,307,813,586,179
060855065033,511,379,132,518,381,137,952,706,222,706,517,142
060855067031,790,545,245,799,561,238,977,698,256,935,631,248
060855067021,844,618,226,866,612,254,1226,894,302,979,688,220
060855067023,443,340,103,449,337,112,527,392,120,565,409,116
060855066062,800,606,194,816,609,207,1006,760,218,903,670,165
060855066061,219,177,42,226,179,47,333,253,71,287,217,56
060855027031,454,326,128,466,332,134,719,506,192,661,443,170
060855027032,514,368,146,526,376,150,676,478,179,672,456,157
060855123111,658,392,266,670,396,274,975,625,324,844,496,298
060855123121,1411,908,503,1441,914,527,1867,1256,559,1585,973,504
060855123143,656,432,224,661,434,227,1506,962,504,682,443,192
060855123144,307,202,105,311,203,108,504,327,165,330,218,92
060855123051,1555,939,616,1578,942,636,2052,1297,703,1526,901,528
060855123052,663,368,295,672,360,312,841,470,342,721,379,296
060855123141,923,558,365,936,553,383,841,537,280,856,496,291
060855123142,276,177,99,281,176,105,342,220,112,320,199,98
060855123081,1158,655,503,1169,662,507,2086,1314,716,1132,662,398
060855123082,1374,808,566,1402,807,595,2004,1259,703,1546,910,538
060855123102,224,142,82,228,133,95,813,517,274,379,247,106
060855123071,665,401,264,671,392,279,849,517,307,712,413,243
060855123072,1241,728,513,1243,704,539,1621,999,575,1267,725,440
060855123101,1125,757,368,1149,755,394,1744,1185,511,1019,687,274
060855123112,641,387,254,658,394,264,1147,769,354,816,506,264
060855123093,520,312,208,531,309,222,787,506,266,546,317,188
060855123132,408,249,159,415,246,169,689,467,202,618,393,179
060855123073,1228,700,528,1254,701,553,1394,851,514,1348,754,490
060855123083,1188,658,530,1210,649,561,1406,860,513,1171,657,429
060855123091,1149,678,471,1173,676,497,1275,817,427,1149,682,386
060855124022,420,218,202,430,212,218,521,287,224,519,275,214
060855123131,578,381,197,589,392,197,864,566,272,663,425,183
060855123092,715,434,281,728,436,292,933,595,311,902,548,288
060855125051,716,530,186,721,517,204,1169,845,302,842,608,190
060855125132,577,438,139,583,423,160,849,645,188,663,488,130
060855125131,380,291,89,386,288,98,638,456,172,498,348,116
060855125142,432,332,100,441,323,118,675,492,162,464,344,92
060855125102,670,410,260,681,408,273,856,582,258,787,482,255
060855125103,721,474,247,728,463,265,1099,763,317,1112,693,350
060855125111,675,440,235,685,437,248,889,591,288,462,321,120
060855125112,742,465,277,756,464,292,1058,686,353,680,423,213
060855125122,453,300,153,456,298,158,676,454,209,585,387,159
060855126042,463,373,90,463,364,99,716,552,141,556,430,90
060855125052,734,556,178,739,539,200,1159,819,315,961,686,222
060855125092,557,380,177,562,370,192,544,387,146,626,425,162
060855126032,138,105,33,140,103,37,241,168,68,165,115,38
060855126033,232,181,51,231,178,53,697,517,166,394,295,69
060855125121,659,425,234,669,429,240,1024,695,304,980,654,264
060855125093,621,412,209,628,408,220,652,444,195,584,411,151
060855126021,368,228,140,370,225,145,576,380,193,359,231,112
060855126041,370,299,71,372,293,79,637,504,116,429,331,62
060855126031,162,127,35,161,125,36,238,184,49,204,152,32
060855125162,1019,569,450,1036,572,464,807,510,279,703,391,279
060855122003,541,293,248,553,295,258,1361,804,528,714,379,294
060855125101,1209,675,534,1241,689,552,1847,1128,681,1392,810,500
060855124011,732,400,332,738,399,339,1024,560,437,835,463,326
060855125152,827,461,366,846,463,383,1050,615,410,706,397,271
060855125153,478,273,205,485,274,211,860,580,262,608,384,196
060855125151,914,515,399,932,512,420,1405,835,533,1111,664,373
060855125053,555,408,147,551,395,156,864,632,212,540,390,115
060855125091,614,381,233,634,378,256,1602,1031,538,625,391,198
060855125161,1160,718,442,1173,713,460,1508,950,510,1331,785,452
060855125141,183,138,45,185,134,51,558,423,123,392,281,82
060855124013,512,300,212,518,297,221,846,500,327,608,361,204
060855048051,914,647,267,941,638,303,1334,947,360,1009,723,235
060855090011,505,385,120,515,389,126,698,537,145,616,467,105
060855090012,392,297,95,398,299,99,518,398,107,481,367,81
060855048021,388,282,106,392,272,120,697,491,194,647,453,158
060855048022,611,444,167,627,450,177,606,440,144,550,434,89
060855048052,333,244,89,336,247,89,1187,812,330,879,620,208
060855048053,783,595,188,791,589,202,835,635,183,838,580,196
060855087081,583,481,102,591,481,110,1446,1147,263,581,468,74
060855087072,619,504,115,629,506,123,725,573,134,572,454,77
060855088002,277,224,53,281,224,57,481,379,89,409,322,61
060855090021,594,466,128,602,468,134,860,656,176,711,559,112
060855090022,440,347,93,442,345,97,535,414,110,480,371,79
060855048072,792,591,201,812,597,215,1264,973,264,619,485,104
060855048071,337,259,78,343,257,86,215,164,46,191,150,32
060855048073,156,118,38,159,118,41,399,306,85,402,314,68
060855088001,444,347,97,453,350,103,612,481,112,518,406,76
060855087071,407,330,77,412,334,78,494,389,92,553,433,74
060855091022,263,213,50,267,216,51,449,343,96,335,266,39
060855091023,193,155,38,195,156,39,454,354,92,349,278,51
060855086013,471,357,114,476,358,118,483,381,93,435,334,78
060855084044,468,350,118,473,349,124,872,665,180,585,413,136
060855085092,88,69,19,88,68,20,230,177,49,195,146,35
060855085093,158,124,34,160,126,34,108,84,23,189,143,33
060855085091,274,209,65,283,219,64,239,184,49,190,146,29
060855085094,292,227,65,296,232,64,428,332,86,251,189,45
060855085102,338,257,81,350,270,80,745,576,152,624,476,110
060855086023,623,501,122,634,508,126,746,593,133,412,328,60
060855086021,414,326,88,421,322,99,428,344,78,634,473,115
060855086022,250,202,48,253,204,49,280,227,50,373,279,66
060855087052,109,84,25,110,85,25,587,468,105,265,207,40
060855087053,317,249,68,320,244,76,605,479,108,409,321,59
060855086024,270,219,51,273,222,51,471,375,84,186,141,33
060855086011,263,191,72,269,196,73,261,197,57,278,200,63
060855086012,641,466,175,655,477,178,595,448,132,720,518,161
060855048061,360,275,85,371,273,98,498,363,121,403,318,62
060855048062,429,339,90,427,335,92,603,463,122,545,430,82
060855048081,372,290,82,375,284,91,463,358,99,654,487,124
060855084011,304,224,80,309,228,81,386,293,86,344,253,70
060855084012,461,341,120,471,346,125,541,410,119,517,380,103
060855091061,369,280,89,375,283,92,524,411,100,522,400,91
060855091062,449,326,123,457,331,126,374,283,81,230,176,42
060855091063,329,229,100,333,231,102,627,466,138,340,248,69
060855084016,381,270,111,391,280,111,613,467,135,472,335,105
060855084013,384,292,92,396,293,103,664,532,117,590,447,101
060855084014,362,275,87,370,275,95,451,362,80,418,325,67
060855084041,658,471,187,666,473,193,922,710,189,689,493,152
060855084042,641,460,181,649,463,186,740,577,149,736,536,156
060855085071,318,242,76,324,247,77,408,309,92,273,204,50
060855085081,324,236,88,333,240,93,284,219,59,330,236,75
060855085082,299,223,76,304,222,82,381,291,80,499,372,93
060855082052,601,435,166,612,440,172,807,612,181,753,543,164
060855085052,469,348,121,479,353,126,548,423,114,482,361,86
060855085083,418,313,105,416,303,113,833,644,175,478,354,83
060855085084,238,176,62,239,173,66,245,188,52,377,267,86
060855083011,625,465,160,640,474,166,814,618,177,727,541,146
060855085051,573,418,155,587,427,160,471,365,98,476,362,83
060855085053,246,185,61,254,189,65,461,355,95,347,257,63
060855085054,241,181,60,247,184,63,343,262,70,293,219,53
060855084031,357,269,88,364,274,90,371,295,67,302,212,66
060855048023,476,378,98,489,385,104,892,687,183,631,490,92
060855089003,196,153,43,199,153,46,411,321,77,357,267,65
060855089004,216,168,48,219,166,53,392,306,74,440,328,81
060855089001,406,315,91,415,311,104,375,296,72,388,295,68
060855082042,413,309,104,422,313,109,450,348,90,435,327,82
060855082043,531,392,139,537,390,147,607,471,125,613,455,121
060855083012,602,442,160,618,455,163,843,642,183,662,499,130
060855083013,817,590,227,826,604,222,985,752,214,860,649,169
060855082061,398,288,110,409,295,114,391,297,90,391,284,83
060855082062,548,384,164,569,400,169,759,562,175,684,483,148
060855082063,614,433,181,636,444,192,806,597,185,669,467,153
060855089002,284,220,64,289,218,71,251,202,47,404,321,55
060855084043,605,446,159,617,453,164,580,443,120,464,336,90
060855082051,422,295,127,428,298,130,635,475,145,593,412,144
060855082041,412,313,99,422,321,101,814,636,156,687,532,111
060855053012,572,433,139,579,432,147,1052,772,254,546,404,103
060855085031,408,302,106,417,307,110,521,392,115,538,394,100
060855085032,421,328,93,430,334,96,500,387,100,363,281,60
060855085033,387,300,87,395,307,88,458,362,86,439,338,74
060855083031,623,452,171,632,458,174,754,578,162,691,515,139
060855084032,498,382,116,509,387,122,653,529,107,561,435,102
060855084033,421,323,98,430,329,101,516,420,87,423,322,77
060855085034,189,147,42,193,150,43,402,315,77,346,268,57
060855083032,698,508,190,701,510,191,757,577,163,764,586,143
060855083061,206,154,52,209,156,53,312,229,73,403,316,67
060855083053,354,267,87,364,267,97,529,378,136,319,250,52
060855083051,253,191,62,260,193,67,475,345,119,342,272,49
060855087063,423,329,94,431,333,98,570,435,127,402,311,65
060855087061,386,299,87,393,306,87,615,471,134,475,379,70
060855087062,465,357,108,470,363,107,464,355,108,401,308,69
060855083062,1015,747,268,1037,767,270,1379,1051,296,1131,845,223
060855087051,392,299,93,397,306,91,352,283,64,308,239,48
060855082031,546,412,134,558,422,136,545,427,104,464,352,86
060855082032,539,404,135,546,410,136,688,543,132,594,443,116
060855085101,244,183,61,252,192,60,465,358,95,385,296,63
060855057004,513,406,107,521,406,115,844,661,159,720,554,120
060855052022,280,210,70,288,212,76,1048,779,252,359,263,72
060855052021,431,315,116,435,313,122,591,435,146,439,331,81
060855052023,419,303,116,423,302,121,567,413,138,473,352,90
060855052024,271,198,73,273,197,76,458,336,112,312,231,62
060855053032,409,299,110,421,301,120,599,449,140,600,439,120
060855056001,354,269,85,362,269,93,340,260,77,332,253,58
060855057001,302,229,73,307,230,77,425,326,92,366,273,74
060855056002,261,197,64,268,198,70,148,114,33,339,250,67
060855054021,365,262,103,374,263,111,451,317,126,419,291,105
060855054022,673,481,192,692,485,207,781,552,212,805,566,191
060855055001,390,284,106,391,278,113,450,343,97,350,255,71
060855055003,534,388,146,538,380,158,691,528,148,557,386,131
060855055002,616,467,149,625,458,167,899,667,211,734,532,152
060855060002,385,284,101,392,279,113,346,265,81,373,271,89
060855060003,792,600,192,807,593,214,1029,775,233,987,733,188
060855056003,388,304,84,392,300,92,409,309,89,360,279,55
060855060001,436,322,114,444,317,127,507,377,119,488,348,106
060855057002,398,316,82,404,316,88,540,406,126,506,361,109
060855059021,747,550,197,770,556,214,826,626,178,780,582,159
060855059013,347,245,102,359,256,103,433,319,106,353,261,73
060855060004,225,170,55,228,167,61,350,265,78,383,285,73
060855053022,596,441,155,610,437,173,887,658,211,618,448,130
060855053033,291,215,76,296,212,84,307,234,73,336,242,70
060855053041,389,291,98,394,292,102,395,294,93,417,310,80
060855053043,638,455,183,657,463,194,747,558,178,712,522,145
060855053042,284,212,72,293,216,77,377,280,89,337,251,64
060855053051,455,333,122,460,328,132,502,371,122,478,329,118
060855053052,331,240,91,338,239,99,345,257,82,341,236,84
060855053053,470,326,144,473,326,147,817,601,196,642,429,163
060855053054,477,333,144,481,329,152,612,455,146,577,394,143
060855054031,684,511,173,696,517,179,1146,840,270,618,447,127
060855054032,551,410,141,554,406,148,776,571,183,829,622,151
060855061012,810,590,220,829,593,236,1005,755,231,899,670,173
060855054011,426,304,122,437,300,137,471,344,122,481,344,103
060855054015,195,146,49,196,145,51,219,157,57,262,197,47
060855054013,299,221,78,302,220,82,251,178,65,224,165,43
060855049022,556,434,122,565,442,123,600,460,130,586,466,91
060855049021,208,162,46,212,164,48,282,215,61,180,142,28
060855049023,254,198,56,259,201,58,499,382,108,345,275,53
060855050111,506,369,137,511,363,148,817,613,189,572,415,126
060855050112,443,325,118,447,333,114,653,502,141,457,350,80
060855053021,1012,765,247,1033,772,261,1242,917,293,1161,857,223
060855053011,332,246,86,335,249,86,576,419,140,363,271,67
060855053013,438,335,103,446,340,106,671,500,164,476,362,86
060855050071,498,311,187,501,310,191,516,315,187,576,359,172
060855050072,184,116,68,189,119,70,618,375,223,372,242,111
060855050073,383,244,139,393,247,146,443,273,162,372,244,109
060855049032,610,467,143,620,457,163,831,640,179,802,596,153
060855050103,232,173,59,236,177,59,310,234,73,288,209,58
060855050101,293,221,72,294,217,77,635,474,149,566,441,97
060855059012,403,302,101,409,301,108,607,467,128,533,385,115
060855061022,872,644,228,893,641,252,1367,1022,311,1004,724,219
060855049031,83,65,18,84,64,20,342,262,73,209,161,36
060855049033,163,128,35,165,125,40,436,334,94,354,272,62
060855061021,730,526,204,746,522,224,913,673,225,812,569,194
060855061013,666,494,172,678,494,184,829,639,172,623,453,126
060855061034,400,286,114,420,296,124,530,397,121,517,377,114
060855061031,551,399,152,565,402,163,820,604,200,603,428,134
060855061032,339,239,100,347,242,105,434,323,104,349,251,79
060855061033,348,247,101,360,251,109,437,331,98,386,278,88
060855081021,702,543,159,723,540,183,1030,786,233,806,612,152
060855061011,527,376,151,539,374,165,656,486,160,641,446,155
060855053031,464,363,101,466,358,108,553,412,128,412,313,71
060855053034,296,233,63,298,229,69,649,485,151,511,388,87
060855054033,619,456,163,625,443,182,882,651,208,928,658,202
060855054014,224,169,55,224,169,55,527,378,137,202,154,36
060855054012,250,189,61,251,191,60,587,422,152,516,395,90
060855085072,191,146,45,195,149,46,456,347,101,351,265,64
060855045071,326,224,102,329,226,103,414,279,130,371,261,87
060855045072,492,345,147,507,351,156,653,430,201,610,449,130
060855045074,494,328,166,509,336,173,611,411,192,623,448,143
060855045082,466,346,120,483,359,124,878,584,274,380,279,87
060855045051,208,155,53,215,162,53,217,154,59,181,136,37
060855045052,665,495,170,685,510,175,593,422,164,930,693,189
060855045053,256,187,69,264,192,72,492,350,136,280,208,57
060855045102,189,135,54,194,139,55,564,388,164,568,430,109
060855044211,638,420,218,652,431,221,645,438,196,557,409,113
060855044212,514,354,160,536,377,159,885,604,274,697,533,126
060014433012,543,384,159,569,399,170,704,498,195,664,484,148
060855044222,448,313,135,454,311,143,900,610,281,636,467,137
060014415032,337,231,106,354,242,112,905,642,250,557,396,137
060855045063,555,351,204,561,367,194,840,569,261,447,339,90
060855045081,11,8,3,11,8,3,365,259,100,429,314,98
060855044121,648,463,185,660,463,197,326,222,99,245,179,54
060855044181,339,244,95,345,250,95,532,362,162,407,301,82
060855044183,137,100,37,141,103,38,353,240,107,269,197,54
060855044231,773,506,267,794,520,274,1092,737,340,804,565,189
060855044182,611,418,193,628,433,195,1070,701,346,671,498,138
060855045073,413,308,105,421,309,112,501,342,156,451,334,91
060855044131,561,402,159,583,423,160,947,658,273,706,541,138
060855044141,916,646,270,944,668,276,1229,853,355,1065,799,208
060855044142,451,329,122,470,338,132,681,473,198,530,386,110
060855044152,566,391,175,578,395,183,866,572,280,616,439,146
060855044161,677,471,206,690,476,214,780,526,240,741,549,157
060855044162,478,329,149,496,337,159,771,508,250,476,333,116
060855044221,549,396,153,563,388,175,891,603,278,722,541,140
060855044243,494,323,171,508,334,174,549,360,180,617,434,146
060855044244,271,184,87,274,182,92,399,266,126,325,235,75
060855044242,549,356,193,562,366,196,692,454,223,569,408,133
060855044122,256,185,71,262,185,77,556,365,181,326,239,72
060855044213,519,342,177,533,350,183,820,572,239,669,480,152
060855044143,400,286,114,414,288,126,587,398,183,466,338,107
060855044151,641,442,199,662,455,207,915,626,272,1021,748,226
060855045061,284,202,82,288,202,86,549,370,170,323,228,77
060855044123,238,173,65,242,174,68,556,362,179,361,265,79
060855044124,282,204,78,289,207,82,472,308,153,448,337,94
060855044153,541,369,172,555,373,182,674,459,201,543,371,138
060855045062,101,75,26,104,75,29,485,327,149,227,170,45
060855045064,374,278,96,384,276,108,556,377,172,419,315,82
060855045101,393,283,110,408,291,117,605,417,177,783,593,151
060855074011,536,367,169,549,384,165,671,494,166,565,404,133
060855075003,646,416,230,656,428,228,871,641,211,759,542,181
060855076002,671,455,216,688,471,217,891,672,207,632,438,154
060855076001,374,237,137,382,252,130,594,420,161,401,274,105
060855076003,971,619,352,998,642,356,1236,885,324,953,637,253
060855076004,895,568,327,906,579,327,1151,824,302,1042,697,282
060855073021,913,575,338,943,585,358,1149,799,322,1023,667,273
060855073022,504,292,212,511,297,214,608,400,192,557,347,168
060855074014,579,389,190,593,393,200,789,598,181,659,470,155
060855074015,396,272,124,407,275,132,484,355,116,426,298,105
060855073011,365,233,132,374,238,136,515,375,132,432,295,110
060855073012,669,432,237,683,442,241,920,651,248,758,519,196
060855073016,685,416,269,702,421,281,934,646,267,761,496,217
060855074023,596,418,178,604,418,186,896,639,237,671,474,162
060855074021,717,508,209,728,501,227,977,682,272,777,542,189
060855073013,422,269,153,432,272,160,545,377,155,458,301,132
060855073014,348,217,131,354,219,135,438,309,119,460,303,132
060855075001,938,615,323,960,630,330,1166,841,294,1005,691,257
060855075002,738,469,269,748,475,273,948,691,233,796,569,189
060855075004,630,403,227,640,411,229,875,648,212,745,521,184
060855074012,591,411,180,606,425,181,690,511,169,742,538,172
060855074013,702,475,227,720,484,236,996,757,218,751,540,174
060855118001,993,673,320,1004,672,332,1273,904,339,1079,709,287
060855118002,540,387,153,553,385,168,806,581,199,709,476,164
060855118003,600,420,180,612,424,188,683,485,173,641,421,158
060855124021,287,167,120,290,158,132,487,294,178,368,228,119
060855122002,660,335,325,669,335,334,711,398,297,683,366,280
060855135001,315,136,179,320,130,190,404,191,207,372,171,174
060855124024,530,314,216,537,312,225,799,473,305,580,310,236
060855124012,492,281,211,498,271,227,633,368,254,553,313,204
060855126022,536,265,271,547,258,289,730,390,327,606,320,257
060855124023,649,369,280,651,365,286,869,513,330,709,392,263
060855042021,517,335,182,525,326,199,685,474,197,720,457,209
060855039023,303,231,72,305,225,80,458,345,111,319,248,61
060450109004,292,165,127,296,156,140,406,208,187,358,174,161
060450108011,262,159,103,270,158,112,405,237,154,366,196,116
060450108012,481,252,229,492,240,252,723,355,339,657,289,298
060450108015,416,215,201,423,204,219,632,304,302,518,241,229
060450108014,270,141,129,271,128,143,420,198,208,338,143,173
060450109001,471,330,141,482,318,164,366,270,76,261,163,61
060450108013,714,409,305,718,400,318,910,488,396,776,389,306
060450109003,540,309,231,558,307,251,867,515,338,687,367,273
060450117001,566,336,230,570,330,240,451,263,175,407,222,150
060450117002,448,240,208,463,238,225,639,354,263,486,239,205
060450115023,382,229,153,390,222,168,529,312,205,450,249,165
060450117005,64,36,28,64,34,30,183,98,83,152,73,72
060450117003,273,160,113,274,156,118,336,209,113,311,168,116
060450113001,475,263,212,477,261,216,683,384,275,589,317,230
060450115012,419,253,166,431,255,176,632,398,219,538,304,187
060450117004,282,161,121,284,156,128,528,314,190,422,237,135
060450118001,679,474,205,687,464,223,622,394,213,539,333,165
060450108021,377,210,167,380,206,174,277,162,104,289,134,128
060450108022,372,189,183,378,183,195,667,319,323,580,263,262
060450114003,446,298,148,452,298,154,448,290,139,396,239,126
060450114005,296,209,87,304,209,95,423,285,121,341,212,100
060450116001,467,335,132,472,334,138,698,472,199,592,371,167
060450116004,402,267,135,415,273,142,631,405,207,491,291,151
060450114001,575,428,147,593,429,164,691,501,167,583,376,138
060450114002,326,225,101,334,224,110,425,283,127,416,267,112
060450115021,322,215,107,332,223,109,593,390,177,402,247,111
060450115011,343,262,81,353,262,91,386,279,97,333,219,78
060450106021,587,399,188,595,396,199,606,401,185,618,360,171
060450106022,719,463,256,726,456,270,1047,649,358,862,496,269
060450106023,450,290,160,457,286,171,652,395,236,504,284,167
060450107002,565,360,205,583,368,215,731,454,251,598,345,200
060450106013,389,224,165,403,223,180,554,315,222,557,278,212
060450106012,348,245,103,353,237,116,556,376,168,486,278,153
060450107005,224,147,77,228,142,86,344,223,108,295,163,96
060450106011,410,226,184,418,227,191,419,233,173,326,155,139
060450107001,167,106,61,173,110,63,272,168,95,233,129,78
060450107007,259,144,115,268,141,127,340,197,130,247,126,108
060450107003,384,273,111,390,272,118,408,268,135,400,240,112
060450107004,204,135,69,207,127,80,325,204,111,244,136,82
060450107006,207,132,75,216,135,81,358,222,121,271,149,95
060450102001,391,303,88,398,300,98,479,359,106,389,252,78
060450102004,426,317,109,435,311,124,383,270,105,337,216,84
060450102003,265,183,82,279,185,94,521,333,173,448,258,121
060450103001,325,226,99,330,224,106,406,290,109,355,231,101
060450103002,357,254,103,361,250,111,340,239,94,287,187,78
060450103003,429,289,140,437,276,161,609,380,220,512,300,161
060450104001,209,161,48,211,160,51,315,237,72,274,198,59
060450104002,355,272,83,365,271,94,364,273,85,306,208,72
060450103004,653,422,231,665,411,254,729,454,261,580,362,174
060450104004,580,397,183,589,383,206,698,490,199,561,370,166
060450105001,317,234,83,327,227,100,489,338,135,373,248,103
060450105002,318,233,85,319,223,96,374,277,90,313,203,86
060450105005,255,188,67,256,180,76,347,236,99,296,197,79
060450105004,171,125,46,176,125,51,221,152,61,217,140,61
060450110031,317,258,59,324,256,68,453,339,102,461,317,95
060450110042,517,408,109,524,403,121,511,408,93,386,284,53
060450110033,670,492,178,678,478,200,998,712,264,699,460,161
060450110043,682,555,127,683,540,143,843,692,131,709,512,118
060450110032,206,160,46,207,157,50,389,269,111,313,211,68
060450110012,739,654,85,751,653,98,803,695,83,800,605,110
060450112001,565,456,109,572,445,127,782,606,149,661,453,106
060450110011,560,482,78,564,476,88,600,511,69,570,418,78
060450112002,176,137,39,174,131,43,455,342,95,403,276,85
060450112003,331,258,73,335,251,84,409,306,86,338,232,69
060450113003,412,211,201,419,216,203,499,262,222,381,186,171
060450111021,533,413,120,538,402,136,449,343,97,364,238,81
060450111022,471,397,74,473,395,78,621,525,81,511,388,79
060450111023,915,747,168,928,743,185,1339,1091,220,1123,850,201
060450109002,192,98,94,196,96,100,289,162,118,238,115,107
060450116003,171,117,54,171,116,55,328,221,101,242,152,69
060450113004,366,220,146,369,217,152,449,294,135,357,201,123
060450114004,269,162,107,276,163,113,254,153,92,225,123,80
060450116002,298,194,104,304,179,125,461,299,150,371,221,118
060450115022,155,106,49,158,103,55,223,149,70,204,125,67
060450115013,320,212,108,324,204,120,491,327,156,389,233,120
060450113002,421,255,166,429,257,172,780,496,261,653,378,225
060450102002,509,397,112,522,399,123,601,452,131,522,345,117
060450101001,258,185,73,255,173,82,235,158,65,207,114,61
060450101002,183,116,67,182,108,74,258,155,91,200,108,62
060450101003,206,144,62,208,142,66,340,200,122,281,142,102
060450103005,160,122,38,162,122,40,276,203,67,266,167,76
060450105003,276,199,77,283,200,83,436,299,133,357,228,100
060450104003,248,190,58,249,186,63,378,278,88,313,208,72
060450110041,492,421,71,496,424,72,507,444,53,443,336,51
060450118002,317,205,112,325,203,122,413,264,131,389,213,140
060190009021,178,161,17,186,159,27,296,254,36,280,249,17
060190009022,145,128,17,146,126,20,278,235,37,242,213,18
060190009023,231,201,30,237,202,35,392,333,50,234,205,20
060190009012,136,121,15,139,123,16,310,260,42,329,290,29
060190010001,201,181,20,212,185,27,376,319,52,292,263,24
060190011001,222,192,30,223,188,35,276,233,43,248,218,15
060190011002,210,178,32,211,175,36,283,236,47,249,216,26
060190010002,327,273,54,327,260,67,517,423,84,354,308,34
060190018001,276,157,119,280,158,122,429,237,183,334,200,124
060190021002,308,234,74,315,227,88,374,274,95,323,221,75
060190021003,268,202,66,270,199,71,349,263,79,351,239,86
060190022001,273,206,67,274,201,73,321,237,79,247,171,57
060190022002,259,205,54,266,203,63,320,242,75,314,215,73
060190022003,311,242,69,319,241,78,458,334,103,385,261,85
060190023003,331,259,72,339,254,85,431,318,100,345,250,71
060190001001,166,128,38,168,127,41,637,460,151,326,246,57
060190002001,125,107,18,128,107,21,210,167,36,110,94,10
060190005021,206,162,44,209,158,51,350,258,79,262,204,41
060190006011,193,153,40,197,150,47,200,149,48,139,98,29
060190006021,175,139,36,173,130,43,312,231,70,180,140,29
060190007021,274,232,42,281,224,57,320,250,62,389,320,54
060190020002,279,188,91,282,179,103,378,252,116,264,180,72
060190020003,102,80,22,103,79,24,138,102,32,107,79,22
060190006012,189,146,43,195,146,49,315,237,75,181,126,39
060190006013,144,112,32,148,110,38,297,216,69,249,178,48
060190006014,92,72,20,95,72,23,219,158,50,103,78,16
060190003002,146,121,25,147,120,27,284,241,39,169,148,11
060190004003,182,142,40,185,139,46,301,236,55,283,230,39
060190004004,128,106,22,131,102,29,223,174,47,167,132,28
060190005012,132,97,35,134,94,40,256,184,61,230,175,41
060190012011,115,92,23,120,91,29,167,129,35,202,165,27
060190086004,167,115,52,168,117,51,308,212,87,143,114,18
060190009011,185,151,34,190,155,35,224,190,32,193,161,24
060190007011,502,447,55,511,428,83,606,497,89,620,538,54
060190020005,114,89,25,115,89,26,161,125,34,109,73,32
060190002002,235,209,26,237,209,28,499,416,81,294,263,23
060190003001,264,231,33,267,231,36,322,285,34,344,311,27
060190003003,162,140,22,162,140,22,293,254,34,202,185,8
060190005022,82,66,16,82,64,18,159,120,33,116,89,17
060190024002,91,72,19,88,62,26,154,115,36,73,61,12
060190024003,132,105,27,136,98,38,229,174,51,163,128,25
060190023001,208,152,56,214,149,65,338,234,94,216,153,48
060190005011,101,88,13,104,84,20,150,116,32,104,86,12
060190024001,136,105,31,140,105,35,161,122,38,159,125,26
060190025011,134,101,33,136,101,35,167,124,41,153,118,25
060190025012,154,117,37,156,117,39,194,146,48,142,113,27
060190025013,83,67,16,83,62,21,166,122,37,135,100,27
060190025014,109,88,21,111,84,27,293,217,66,225,168,44
060190028001,171,136,35,178,131,47,363,272,85,215,157,45
060190028002,76,59,17,75,56,19,115,87,28,113,83,24
060190028003,95,76,19,97,72,25,196,147,44,151,112,30
060190028004,128,101,27,129,95,34,206,160,46,220,169,40
060190025023,205,163,42,212,152,60,295,224,68,269,212,45
060190025021,93,74,19,95,69,26,271,187,62,84,68,13
060190025022,65,54,11,67,49,18,205,143,48,62,52,8
060190026011,166,141,25,166,126,40,297,220,74,242,195,31
060190026012,221,191,30,226,171,55,321,242,78,283,236,37
060190026013,243,186,57,246,176,70,294,225,68,326,245,58
060190027011,191,148,43,193,139,54,257,193,60,200,155,37
060190027013,161,122,39,163,117,46,274,204,66,192,149,33
060190027012,307,246,61,307,239,68,465,348,113,387,298,79
060190027021,186,153,33,186,141,45,342,247,77,255,195,43
060190027022,192,158,34,193,147,46,332,243,78,260,198,46
060190052041,351,205,146,360,200,160,516,320,180,428,241,156
060190052042,288,154,134,295,150,145,380,238,134,359,198,136
060190052043,268,156,112,272,149,123,421,262,148,317,181,114
060190052032,422,279,143,436,269,167,733,459,257,520,345,139
060190052021,227,143,84,233,142,91,455,279,166,304,192,91
060190052022,299,187,112,305,186,119,544,331,201,365,223,111
060190031042,742,369,373,752,370,382,1095,553,518,791,377,362
060190013041,72,56,16,73,55,18,203,159,40,163,132,25
060190013042,388,312,76,393,301,92,469,373,93,453,385,49
060190013043,86,71,15,89,66,23,274,215,54,176,143,22
060190012021,214,178,36,216,171,45,491,387,93,341,292,33
060190012022,399,321,78,404,309,95,623,496,119,525,451,54
060190027024,60,50,10,64,46,18,222,167,45,87,74,7
060190027023,74,60,14,79,52,27,248,181,51,95,78,13
060190029031,190,144,46,195,135,60,340,243,88,298,218,67
060190029032,266,195,71,273,187,86,451,297,137,309,216,75
060190029033,69,55,14,71,54,17,218,155,58,140,114,21
060190029041,302,223,79,309,209,100,431,300,131,341,245,87
060190029042,249,172,77,254,164,90,342,223,115,271,184,75
060190029051,433,302,131,449,288,161,715,470,225,547,374,139
060190033021,141,103,38,142,98,44,270,197,72,221,161,46
060190033023,177,136,41,181,129,52,347,243,97,253,182,58
060190026021,247,187,60,250,178,72,246,188,49,209,155,39
060190026022,279,211,68,287,204,83,365,286,74,381,285,72
060190026023,189,156,33,191,148,43,285,222,58,237,185,43
060190013011,183,149,34,189,145,44,251,192,52,258,200,42
060190013012,161,129,32,165,125,40,168,132,36,183,143,30
060190013013,153,127,26,158,121,37,182,143,38,197,169,18
060190013015,128,104,24,131,99,32,164,126,35,189,148,29
060190013014,186,155,31,191,146,45,226,178,48,208,186,20
060190013031,124,102,22,129,94,35,200,160,40,122,100,15
060190013032,104,86,18,106,77,29,236,185,46,198,166,22
060190004001,214,182,32,218,173,45,402,310,82,296,236,42
060190004002,179,147,32,183,135,48,332,255,68,236,201,26
060190012014,59,48,11,59,41,18,154,124,30,135,109,20
060190012012,289,228,61,292,220,72,385,293,89,394,313,64
060190012013,290,243,47,296,232,64,482,384,94,254,206,36
060190029062,526,360,166,542,332,210,818,545,262,641,423,177
060190029061,247,176,71,252,168,84,458,305,145,315,219,79
060190030011,175,128,47,175,125,50,314,223,86,197,149,41
060190023002,320,230,90,320,227,93,419,292,116,281,194,62
060190021001,298,214,84,302,205,97,370,261,106,292,196,74
060190021004,250,179,71,253,173,80,458,314,130,353,233,92
060190021005,293,212,81,298,204,94,390,272,112,308,206,81
060190014072,217,150,67,222,151,71,401,286,108,317,258,48
060190014081,367,265,102,378,256,122,341,244,92,518,329,157
060190014071,266,184,82,272,185,87,257,182,69,183,148,27
060190014082,237,164,73,246,166,80,199,145,54,240,154,76
060190014073,125,101,24,127,98,29,426,303,115,181,146,26
060190014074,31,25,6,31,24,7,96,68,26,59,48,9
060190042054,156,97,59,157,95,62,460,297,156,271,150,97
060190047031,347,235,112,353,224,129,487,339,138,532,345,148
060190047043,180,122,58,182,116,66,393,269,111,165,124,36
060190047042,185,125,60,185,122,63,342,236,97,231,156,57
060190047041,495,339,156,499,332,167,654,457,187,545,372,140
060190047032,199,137,62,200,131,69,306,213,87,274,200,65
060190047033,195,135,60,196,129,67,279,192,79,240,171,57
060190047061,458,276,182,466,275,191,659,426,217,519,348,141
060190047062,158,95,63,160,95,65,259,166,85,271,154,104
060190047052,293,176,117,294,174,120,284,185,94,272,155,106
060190047051,262,177,85,269,163,106,430,280,143,354,217,122
060190047063,263,176,87,272,163,109,612,395,202,402,263,119
060190038121,303,119,184,312,121,191,636,309,311,343,137,192
060190038112,498,325,173,503,314,189,864,538,310,693,425,220
060190038101,571,376,195,584,376,208,768,498,252,708,457,217
060190038102,492,312,180,494,304,190,624,382,229,477,284,165
060190038091,506,337,169,516,323,193,905,574,310,758,481,236
060190038092,456,299,157,459,284,175,700,456,227,404,253,129
060190038103,330,212,118,331,211,120,341,225,111,409,250,143
060190022004,326,251,75,329,247,82,447,336,102,336,232,76
060190024004,155,121,34,160,113,47,242,180,61,305,214,72
060190032022,265,181,84,268,175,93,351,242,104,326,220,88
060190032023,279,193,86,282,188,94,469,328,130,392,257,115
060190032024,155,108,47,159,107,52,246,174,68,210,144,55
060190032011,408,261,147,416,242,174,619,404,206,526,334,170
060190032012,461,282,179,468,277,191,786,494,272,583,370,170
060190035003,554,416,138,560,416,144,611,444,152,500,339,122
060190035004,393,272,121,405,274,131,515,367,127,477,312,128
060190036004,390,283,107,391,277,114,553,397,146,407,282,107
060190036005,313,232,81,317,227,90,432,311,114,401,275,103
060190036002,303,214,89,308,215,93,385,272,102,319,214,82
060190036003,329,220,109,336,225,111,411,296,109,358,236,100
060190036001,379,253,126,390,254,136,449,323,117,423,271,118
060190037021,367,268,99,373,263,110,585,392,176,402,278,103
060190037022,196,146,50,199,142,57,452,303,135,314,222,76
060190037023,163,106,57,166,107,59,206,140,63,180,114,55
060190037024,215,139,76,215,139,76,249,170,76,235,148,73
060190037011,304,203,101,311,200,111,498,345,144,376,247,105
060190037012,313,209,104,319,206,113,466,322,134,412,277,104
060190034011,136,101,35,137,93,44,339,226,97,173,132,32
060190034013,147,110,37,152,105,47,319,213,92,169,130,33
060190034012,135,99,36,139,96,43,194,134,56,166,120,38
060190034022,240,166,74,241,160,81,398,275,117,284,189,77
060190035002,262,171,91,266,171,95,300,210,90,279,184,75
060190035005,211,144,67,212,140,72,313,212,92,288,193,71
060190035001,159,116,43,161,113,48,245,167,72,262,185,59
060190033011,410,289,121,414,274,140,759,516,213,511,333,139
060190034021,177,126,51,184,123,61,253,179,74,176,116,51
060190032021,212,141,71,220,133,87,344,231,109,268,172,83
060190033012,318,213,105,323,207,116,348,241,101,364,238,105
060190046011,699,389,310,717,382,335,952,540,387,741,381,324
060190046022,506,228,278,518,232,286,579,315,250,457,219,211
060190048021,371,257,114,381,252,129,595,410,174,582,399,148
060190048023,202,141,61,205,133,72,384,256,119,313,201,96
060190048022,195,135,60,198,127,71,383,250,121,258,163,84
060190048011,345,224,121,348,216,132,569,377,180,482,280,167
060190048012,232,143,89,231,138,93,338,224,108,258,151,88
060190048013,190,138,52,192,134,58,373,268,95,227,174,42
060190049011,492,322,170,504,314,190,702,470,214,548,330,188
060190049012,463,308,155,471,300,171,766,528,226,609,383,189
060190049022,311,185,126,315,184,131,407,239,163,338,171,154
060190051002,260,170,90,264,164,100,423,274,137,304,185,97
060190051003,161,120,41,166,116,50,309,201,101,193,139,45
060190051004,96,72,24,98,69,29,260,167,83,166,118,38
060190051005,283,175,108,286,172,114,398,259,129,335,200,112
060190051001,394,233,161,406,232,174,413,274,136,368,211,129
060190058053,824,391,433,839,378,461,936,465,443,417,196,200
060190058051,267,133,134,272,127,145,652,335,297,357,172,167
060190058052,1058,456,602,1085,450,635,2231,1015,1158,1300,521,707
060190059043,1372,483,889,1395,471,924,1630,598,996,1080,337,699
060190059042,727,339,388,738,333,405,1294,617,642,801,373,381
060190058041,329,154,175,334,153,181,513,226,275,382,157,208
060190058044,245,128,117,251,127,124,386,199,174,300,154,123
060190058045,282,147,135,290,149,141,513,264,234,405,207,165
060190058042,305,154,151,312,160,152,462,235,211,326,162,136
060190058043,684,323,361,689,314,375,1101,473,601,763,311,418
060190052031,376,241,135,383,227,156,608,401,193,453,286,147
060190042081,873,358,515,891,359,532,1030,452,566,908,335,535
060190042101,467,218,249,469,218,251,938,420,509,674,315,328
060190042102,660,290,370,667,286,381,1100,492,595,888,391,458
060190042141,625,251,374,631,251,380,633,281,342,594,235,335
060190042142,514,207,307,527,212,315,526,248,270,516,194,306
060190043012,724,222,502,742,234,508,750,283,455,559,160,372
060190043013,909,281,628,926,293,633,1016,405,596,1115,333,739
060190043021,568,219,349,575,224,351,571,263,302,541,188,332
060190043011,857,231,626,879,247,632,813,333,465,883,267,582
060190042144,739,356,383,750,342,408,976,477,485,769,360,377
060190042143,600,250,350,612,251,361,676,329,333,698,268,399
060190043022,601,242,359,611,245,366,696,319,361,611,246,335
060190043024,524,211,313,537,216,321,620,295,315,519,204,293
060190042131,409,247,162,416,238,178,905,441,444,553,312,204
060190042132,723,344,379,739,347,392,1036,520,497,836,399,399
060190042125,194,129,65,196,131,65,412,265,133,236,149,74
060190043031,608,247,361,622,256,366,837,403,421,737,291,412
060190043032,479,183,296,492,195,297,592,285,296,494,216,256
060190046012,426,233,193,436,229,207,553,320,230,458,213,220
060190046023,407,183,224,419,189,230,454,245,196,371,180,165
060190043023,600,243,357,609,245,364,667,303,355,641,267,343
060190045031,1108,495,613,1123,487,636,1352,639,688,1170,510,605
060190043025,672,277,395,679,281,398,608,278,316,511,223,266
060190043033,1173,516,657,1207,531,676,1330,644,649,1128,492,573
060190045061,751,343,408,771,350,421,953,449,485,738,330,366
060190045062,983,491,492,1000,497,503,1118,582,510,919,434,432
060190045032,1114,535,579,1135,546,589,1549,757,756,1254,597,585
060190045042,400,203,197,411,209,202,672,342,312,525,244,249
060190045043,276,140,136,280,143,137,375,200,167,293,139,137
060190045044,437,227,210,442,230,212,566,315,239,449,217,202
060190045051,699,392,307,709,389,320,1088,598,465,742,371,320
060190084043,179,125,54,180,114,66,117,79,38,113,81,31
060190084031,292,192,100,299,177,122,393,266,123,223,149,70
060190084052,179,111,68,181,101,80,283,190,88,270,175,79
060190084042,231,188,43,230,172,58,403,271,125,335,250,63
060190084041,177,138,39,180,130,50,329,234,87,248,165,69
060190084053,162,85,77,161,82,79,300,192,103,197,114,70
060190084051,156,130,26,157,118,39,213,152,54,133,102,20
060190083012,362,302,60,366,275,91,271,198,70,239,201,29
060190083013,188,155,33,189,141,48,391,281,101,324,267,47
060190083011,118,96,22,119,86,33,152,112,40,141,118,23
060190083032,124,101,23,127,92,35,337,247,86,128,96,26
060190083031,175,144,31,176,128,48,223,164,55,195,156,32
060190083041,34,18,16,34,18,16,100,55,42,56,36,19
060190083043,54,46,8,57,42,15,131,98,33,115,94,20
060190083044,119,99,20,119,88,31,248,184,63,227,180,38
060190039003,189,93,96,195,83,112,498,214,270,389,170,200
060190039004,250,70,180,250,65,185,326,67,259,288,52,230
060190039005,259,79,180,265,74,191,326,114,201,247,89,147
060190040061,429,280,149,435,261,174,936,606,320,568,390,152
060190040053,310,214,96,314,197,117,318,208,106,279,194,71
060190040051,227,162,65,231,149,82,406,272,128,340,239,79
060190041001,522,156,366,527,149,378,670,222,436,550,160,373
060190076001,184,81,103,188,76,112,251,94,154,232,97,127
060190076002,160,60,100,161,54,107,224,101,122,194,90,99
060190017001,322,135,187,327,131,196,533,269,251,361,168,181
060190017003,172,63,109,171,60,111,207,94,108,203,88,112
060190018002,222,99,123,226,94,132,236,133,100,200,111,81
060190018003,337,141,196,341,135,206,446,178,263,377,135,219
060190018004,391,192,199,400,191,209,514,242,264,483,201,255
060190039001,192,54,138,194,54,140,217,93,124,219,71,139
060190039002,231,83,148,234,80,154,234,102,130,241,94,139
060190040041,312,171,141,313,154,159,442,241,195,404,210,178
060190040042,603,333,270,611,303,308,942,511,411,542,295,216
060190041002,235,162,73,240,148,92,400,280,115,303,193,91
060190040031,195,102,93,199,94,105,434,227,201,224,118,93
060190040033,626,295,331,636,288,348,816,430,376,641,312,293
060190040032,171,94,77,173,84,89,322,178,144,248,126,116
060190040052,263,192,71,267,178,89,404,282,118,341,244,85
060190042183,320,149,171,326,147,179,453,236,213,274,120,146
060190082001,85,46,39,81,41,40,65,38,26,77,50,25
060190082002,131,69,62,129,63,66,162,90,69,141,82,55
060190082003,93,52,41,99,48,51,95,56,39,95,53,42
060190082004,159,136,23,163,125,38,262,220,42,204,174,24
060190082005,88,76,12,90,69,21,123,98,24,120,101,14
060190082006,103,57,46,100,48,52,190,107,82,177,97,71
060190083042,58,32,26,59,28,31,77,44,31,86,51,31
060190082007,172,150,22,178,137,41,278,231,47,258,223,29
060190086002,226,136,90,224,130,94,341,204,130,294,174,101
060190086003,192,130,62,188,124,64,257,169,87,221,149,66
060190075001,190,67,123,193,61,132,294,121,170,234,84,138
060190076003,206,100,106,207,91,116,280,134,146,274,137,129
060190077001,360,138,222,361,126,235,467,208,249,423,153,254
060190077002,208,97,111,211,87,124,374,181,190,237,103,129
060190077003,284,132,152,288,118,170,482,232,239,282,120,147
060190080002,311,131,180,318,126,192,453,193,256,379,144,220
060190080003,256,107,149,259,104,155,360,147,196,410,134,245
060190080004,324,115,209,328,111,217,409,147,259,300,100,184
060190081002,394,192,202,399,176,223,489,252,231,417,213,183
060190081003,143,73,70,145,70,75,257,128,124,168,91,69
060190081001,267,124,143,272,118,154,225,121,102,287,125,149
060190078011,80,69,11,83,65,18,89,74,15,85,74,7
060190078012,176,141,35,178,134,44,199,143,53,179,141,30
060190078022,28,25,3,30,24,6,135,96,33,74,64,7
060190078023,109,94,15,109,86,23,233,191,38,172,153,12
060190078024,107,93,14,108,86,22,184,150,30,151,134,12
060190079032,528,310,218,534,274,260,989,492,473,497,265,207
060190081004,346,183,163,348,174,174,615,305,297,275,150,109
060190080001,405,131,274,410,126,284,392,137,248,401,140,239
060190079031,133,60,73,134,59,75,206,90,112,197,106,81
060190016001,865,399,466,880,391,489,1054,546,498,814,365,420
060190017002,274,119,155,276,118,158,347,168,175,313,146,153
060190017004,679,356,323,686,329,357,1237,655,566,749,400,311
060190073002,247,97,150,251,95,156,302,127,175,246,106,135
060190076004,276,90,186,283,91,192,428,184,237,374,153,210
060190073001,215,87,128,220,93,127,267,116,147,241,93,136
060190073005,234,73,161,240,75,165,276,112,162,273,91,170
060190075002,203,63,140,206,62,144,273,113,160,226,82,135
060190075003,180,59,121,181,53,128,252,102,148,196,72,119
060190075004,216,99,117,218,92,126,368,178,187,287,144,130
060190075005,295,131,164,299,125,174,493,197,280,333,137,176
060190074001,169,55,114,170,50,120,209,77,129,182,49,131
060190074002,192,72,120,196,64,132,306,104,194,210,64,139
060190077004,123,57,66,123,49,74,178,78,95,174,75,92
060190078021,60,40,20,60,38,22,116,48,68,78,49,29
060190061012,253,169,84,254,159,95,410,258,143,224,157,62
060190069001,225,153,72,228,145,83,315,219,91,294,206,80
060190069002,155,87,68,158,85,73,193,101,89,139,75,59
060190069003,204,105,99,206,106,100,273,158,113,193,112,76
060190085042,172,134,38,178,123,55,337,254,78,173,132,35
060190060011,744,400,344,757,381,376,1103,580,508,591,311,256
060190060013,495,261,234,505,250,255,742,392,338,587,311,246
060190060012,496,252,244,505,248,257,659,349,300,648,322,295
060190060022,247,178,69,251,164,87,337,240,97,254,186,65
060190060023,435,249,186,438,242,196,620,335,277,526,298,205
060190060021,172,109,63,173,103,70,283,185,91,246,157,74
060190062023,285,224,61,284,204,80,526,385,132,390,305,69
060190062024,360,266,94,367,244,123,491,350,120,404,291,85
060190070021,359,175,184,368,155,213,463,243,217,443,196,233
060190070022,233,151,82,235,141,94,375,253,119,278,180,81
060190070023,266,159,107,274,144,130,495,297,196,353,202,139
060190071021,275,209,66,283,191,92,386,248,135,295,219,65
060190071013,185,109,76,189,99,90,328,186,134,184,107,74
060190071014,192,158,34,192,137,55,404,276,119,295,238,44
060190071011,194,151,43,194,128,66,359,227,122,252,192,49
060190071012,179,134,45,178,113,65,312,209,100,213,156,46
060190070031,431,243,188,439,222,217,695,385,299,505,296,196
060190070032,453,250,203,460,232,228,502,289,213,441,236,195
060190070043,287,150,137,294,138,156,228,138,86,198,97,94
060190070044,501,260,241,512,240,272,910,481,413,702,348,325
060190070041,435,189,246,443,171,272,449,227,220,375,163,197
060190070033,335,196,139,347,178,169,464,247,213,340,184,141
060190070042,402,229,173,406,216,190,584,310,264,493,252,217
060190070035,345,244,101,350,228,122,607,367,231,380,270,93
060190070034,325,222,103,330,207,123,581,342,230,432,290,120
060190085011,189,100,89,187,96,91,317,183,130,270,170,90
060190073003,182,62,120,187,65,122,353,127,221,247,92,146
060190073004,219,75,144,223,76,147,299,104,194,227,83,133
060190074003,281,94,187,290,91,199,416,141,263,371,163,189
060190072044,940,281,659,953,261,692,1464,463,967,1030,302,676
060190072023,728,273,455,742,259,483,1102,391,679,891,307,537
060190072022,260,102,158,264,98,166,396,155,230,327,117,190
060190072041,606,120,486,613,105,508,756,179,565,532,114,400
060190072031,923,194,729,937,184,753,1048,282,740,1039,190,808
060190072043,315,68,247,321,65,256,456,122,325,300,87,187
060190072042,342,120,222,345,112,233,577,199,375,361,111,222
060190072021,594,250,344,597,236,361,658,265,373,471,200,248
060190062021,358,221,137,356,202,154,570,328,234,433,273,141
060190062022,261,211,50,272,200,72,416,307,101,251,200,39
060190061021,299,200,99,298,184,114,469,297,169,351,240,102
060190061022,130,101,29,132,93,39,251,188,63,286,194,77
060190062011,124,96,28,123,86,37,324,235,79,258,204,38
060190062012,233,174,59,238,158,80,322,223,96,249,188,52
060190061023,332,216,116,334,201,133,396,243,145,248,146,86
060190061024,343,209,134,353,205,148,451,269,172,340,197,122
060190061011,470,298,172,478,283,195,680,405,261,515,290,192
060190060024,205,129,76,209,124,85,306,184,118,249,148,93
060190064101,172,51,121,177,52,125,270,77,189,225,57,157
060190064112,744,179,565,757,180,577,778,184,580,727,161,544
060190064113,643,170,473,651,179,472,918,251,650,732,167,529
060190064102,688,214,474,693,206,487,977,268,687,778,201,531
060190063021,556,174,382,565,175,390,691,234,440,621,198,396
060190063022,353,104,249,352,95,257,391,122,262,363,96,244
060190068021,169,133,36,169,118,51,203,146,56,158,126,26
060190068023,347,237,110,349,217,132,460,310,145,333,230,87
060190068024,73,60,13,79,56,23,140,104,36,129,106,19
060190085032,380,324,56,384,299,85,501,385,107,433,366,45
060190085012,199,165,34,204,148,56,239,180,53,241,202,30
060190085013,296,245,51,301,218,83,213,164,46,196,164,24
060190085041,205,174,31,211,159,52,356,278,74,235,204,26
060190085031,137,112,25,138,100,38,204,156,44,232,195,29
060190085033,110,96,14,109,87,22,306,238,58,229,196,21
060190015002,379,234,145,384,225,159,511,289,211,420,252,148
060190067001,682,230,452,686,225,461,679,279,383,671,214,416
060190067003,413,174,239,418,167,251,895,398,476,635,256,344
060190067004,517,190,327,521,184,337,593,244,337,433,160,255
060190067005,372,154,218,374,147,227,509,212,292,413,156,234
060190066061,354,245,109,356,224,132,596,392,192,405,254,128
060190066051,423,258,165,430,237,193,508,290,207,407,218,165
060190063012,693,305,388,708,282,426,774,361,399,691,259,390
060190066031,227,110,117,230,100,130,331,162,161,288,118,153
060190066032,272,141,131,274,125,149,477,241,223,272,132,113
060190066022,256,192,64,255,170,85,423,281,136,225,173,44
060190066023,244,151,93,247,143,104,416,256,153,317,185,108
060190066062,274,210,64,276,190,86,335,256,75,304,221,64
060190067002,177,110,67,177,102,75,232,146,86,194,118,65
060190063011,311,176,135,311,161,150,389,241,144,317,179,127
060190066021,242,159,83,244,145,99,291,194,92,273,176,84
060190066024,146,113,33,146,99,47,299,198,95,194,144,37
060190066063,101,77,24,103,70,33,229,171,54,216,155,49
060190063013,344,123,221,343,111,232,538,207,316,306,112,183
060190065014,316,235,81,318,215,103,517,341,167,392,287,85
060190065013,248,155,93,249,144,105,374,237,130,304,170,123
060190065022,388,292,96,393,275,118,510,350,151,386,294,78
060190068022,170,47,123,173,44,129,258,101,151,182,53,119
060190065012,162,136,26,164,127,37,196,146,48,161,137,20
060190065021,247,192,55,251,184,67,388,289,94,325,261,53
060190065011,127,108,19,130,102,28,190,141,46,165,138,22
060190038113,720,436,284,729,421,308,1151,723,403,765,467,260
060190038122,233,97,136,234,95,139,348,158,183,282,116,152
060190038041,452,271,181,459,266,193,638,375,251,386,237,135
060190064051,1481,362,1119,1501,353,1148,1492,358,1101,1015,226,738
060190064053,548,137,411,554,132,422,820,193,613,770,168,566
060190064062,589,135,454,596,134,462,773,181,576,685,147,494
060190064061,350,84,266,355,81,274,539,126,403,476,105,343
060190064052,722,186,536,736,182,554,892,210,667,736,166,523
060190064092,403,109,294,406,108,298,508,132,367,451,109,315
060190064081,533,135,398,538,132,406,640,169,457,599,141,428
060190064071,872,180,692,880,177,703,1236,289,914,952,174,727
060190064072,344,63,281,350,67,283,368,85,275,255,42,198
060190064093,59,15,44,58,14,44,58,14,44,79,21,54
060190064095,296,76,220,298,78,220,176,47,125,202,56,134
060190016003,500,317,183,504,295,209,817,464,342,585,366,190
060190016002,226,109,117,229,103,126,269,159,110,313,157,143
060190055032,1335,474,861,1361,481,880,1655,689,939,813,285,501
060190055293,1241,383,858,1265,374,891,1753,695,1031,1315,407,859
060190055042,206,74,132,211,76,135,932,393,524,642,234,385
060190055291,614,194,420,632,187,445,914,359,538,661,200,434
060190055033,807,287,520,837,291,546,875,336,524,794,286,471
060190055053,907,394,513,934,398,536,1102,487,586,722,286,404
060190055052,610,254,356,629,260,369,942,417,502,727,288,404
060190055041,620,274,346,631,271,360,915,388,518,721,261,415
060190055292,779,295,484,790,290,500,910,424,465,765,291,446
060190055031,980,355,625,1001,360,641,1307,512,773,1052,399,604
060190055281,754,307,447,766,302,464,888,397,479,890,357,490
060190055161,799,345,454,816,350,466,1056,488,551,896,381,476
060190055163,606,246,360,622,247,375,782,379,386,734,298,405
060190055051,353,162,191,360,160,200,790,351,421,659,281,346
060190055162,660,290,370,677,287,390,1213,603,588,1048,471,536
060190055054,586,239,347,600,246,354,855,381,455,631,249,349
060190055072,852,397,455,870,398,472,1004,500,489,811,362,413
060190055084,673,283,390,689,282,407,663,303,348,544,218,307
060190055083,568,256,312,577,253,324,853,391,448,614,256,331
060190044052,1114,434,680,1137,431,706,1099,488,589,1035,393,611
060190055074,548,244,304,568,254,314,723,331,381,551,225,301
060190055073,670,289,381,693,294,399,1219,543,655,701,285,385
060190055081,564,232,332,572,233,339,700,318,368,593,241,334
060190055071,346,141,205,356,140,216,445,197,239,374,149,208
060190044051,503,223,280,509,221,288,492,232,248,483,205,253
060190055082,770,344,426,785,344,441,1174,536,614,759,326,396
060190044053,476,222,254,487,220,267,537,265,262,578,256,288
060190055091,836,383,453,849,374,475,1179,584,564,972,402,521
060190055093,438,205,233,445,204,241,956,462,467,578,250,295
060190055273,591,255,336,599,264,335,726,323,390,542,236,277
060190055271,814,323,491,822,316,506,809,383,410,952,342,567
060190044042,200,151,49,206,148,58,404,266,124,262,184,61
060190044063,465,215,250,468,215,253,754,370,366,536,222,283
060190044061,327,138,189,332,137,195,367,182,180,330,124,188
060190044062,617,273,344,628,280,348,893,436,435,682,293,351
060190044064,339,174,165,344,179,165,661,322,320,353,162,165
060190055272,184,84,100,189,90,99,292,129,156,231,107,110
060190055261,387,187,200,410,198,212,728,359,346,469,215,218
060190055092,245,121,124,247,119,128,444,219,212,299,139,143
060190056051,677,302,375,693,297,396,661,329,319,659,277,348
060190054072,775,379,396,795,363,432,1021,482,505,821,350,421
060190056062,895,316,579,910,313,597,1239,486,727,956,335,572
060190044102,277,131,146,281,127,154,319,160,152,241,112,112
060190044101,475,237,238,486,230,256,838,418,397,662,313,303
060190044111,574,246,328,581,248,333,727,366,350,623,263,331
060190044041,377,244,133,382,239,143,608,416,179,476,295,160
060190044091,418,211,207,426,208,218,692,306,372,435,213,197
060190044092,526,179,347,540,187,353,634,261,364,530,181,328
060190044093,345,160,185,351,160,191,661,270,377,345,167,157
060190042082,883,412,471,897,410,487,1502,722,752,1109,503,554
060190042083,1211,549,662,1233,544,689,1320,636,663,1146,486,620
060190045041,398,219,179,405,208,197,670,388,268,480,240,197
060190054061,524,288,236,529,274,255,642,338,290,545,247,256
060190054051,570,320,250,576,313,263,921,479,412,656,339,264
060190054052,540,254,286,543,257,286,608,318,273,590,269,291
060190054062,415,194,221,420,198,222,463,245,210,475,215,237
060190054053,622,296,326,636,295,341,670,317,333,644,291,315
060190054063,588,277,311,596,274,322,895,422,444,647,256,344
060190054081,209,135,74,213,130,83,510,319,176,267,167,77
060190054071,504,224,280,512,220,292,632,299,314,570,226,315
060190045053,351,215,136,351,215,136,399,237,149,223,134,74
060190045052,312,192,120,315,193,122,615,363,231,427,259,141
060190054102,717,395,322,734,385,349,778,474,287,860,445,369
060190054031,262,160,102,267,162,105,474,299,160,355,194,132
060190054033,164,101,63,166,102,64,411,258,139,284,155,106
060190054092,497,332,165,510,326,184,701,443,238,556,341,166
060190054091,279,174,105,283,176,107,287,182,98,158,88,57
060190054032,242,142,100,244,145,99,245,155,85,286,159,106
060190054101,250,147,103,254,151,103,283,171,108,274,157,102
060190050001,345,211,134,355,206,149,381,229,148,318,178,119
060190053022,690,431,259,699,414,285,940,588,325,887,521,308
060190053013,483,307,176,485,289,196,732,460,251,615,361,208
060190050002,246,168,78,247,169,78,421,286,124,331,215,96
060190053012,499,280,219,503,271,232,615,367,229,527,282,213
060190053021,501,338,163,506,314,192,898,569,299,623,388,190
060190053011,452,274,178,455,278,177,660,420,220,512,307,170
060190053041,353,220,133,360,222,138,494,314,171,230,140,75
060190053043,449,293,156,459,290,169,912,554,327,643,404,187
060190053051,470,256,214,478,245,233,558,352,193,578,311,240
060190053042,220,147,73,222,143,79,416,259,143,258,172,67
060190053052,439,279,160,440,277,163,725,438,273,552,337,179
060190020001,134,89,45,134,84,50,371,244,112,289,192,78
060190038053,396,263,133,400,257,143,745,474,256,442,294,128
060190038051,214,146,68,218,148,70,504,316,175,496,332,139
060190042051,262,180,82,265,173,92,335,216,112,339,217,102
060190042052,252,173,79,255,166,89,291,186,97,276,177,81
060190042053,533,351,182,536,341,195,805,514,268,590,375,184
060190042162,440,246,194,449,238,211,1029,575,433,415,217,175
060190042161,642,367,275,654,362,292,889,495,376,885,470,361
060190042152,966,542,424,981,531,450,1232,685,519,928,507,380
060190042151,561,338,223,569,332,237,872,481,364,587,338,219
060190042123,646,381,265,660,384,276,1194,692,474,906,511,341
060190014121,798,416,382,820,410,410,1375,717,629,848,450,354
060190059161,330,113,217,331,107,224,472,177,289,385,131,243
060190059162,810,229,581,823,230,593,1165,383,760,788,201,552
060190059111,901,353,548,921,344,577,2144,936,1159,1194,419,716
060190059121,1340,409,931,1360,393,967,4761,1837,2850,1218,326,845
060190056021,545,240,305,554,247,307,568,263,299,517,211,264
060190056024,427,169,258,432,170,262,644,275,351,390,152,212
060190055221,907,268,639,927,275,652,1156,381,751,1013,290,674
060190055223,652,204,448,661,204,457,1065,384,663,662,197,433
060190055251,663,171,492,674,173,501,871,246,607,687,175,490
060190055131,559,185,374,571,189,382,890,319,552,787,266,491
060190055142,822,299,523,839,297,542,877,336,525,757,255,460
060190055121,1166,392,774,1179,390,789,1443,558,857,1109,357,695
060190055132,577,197,380,587,198,389,856,309,532,682,225,426
060190055122,1038,351,687,1048,349,699,1632,618,978,1188,383,748
060190055201,614,210,404,623,202,421,1092,400,672,970,323,598
060190059071,1137,419,718,1163,412,751,1959,748,1173,1309,449,796
060190055202,641,221,420,655,216,439,867,320,535,430,143,263
060190055222,430,138,292,437,136,301,576,194,368,480,153,302
060190055181,999,390,609,1028,393,635,1380,579,774,808,305,453
060190055182,1307,499,808,1330,496,834,2290,954,1279,1300,472,746
060190059142,1660,621,1039,1693,613,1080,1661,658,975,1272,442,767
060190057022,584,214,370,596,208,388,778,290,471,602,210,360
060190057023,551,202,349,559,196,363,699,258,425,631,212,382
060190057012,323,114,209,326,114,212,498,206,281,300,104,177
060190057013,272,102,170,276,103,173,388,171,212,369,132,217
060190057021,346,124,222,351,124,227,607,253,346,401,138,237
060190057024,659,213,446,663,208,455,821,342,467,782,225,512
060190057011,486,207,279,494,204,290,678,281,384,473,181,257
060190057014,282,120,162,287,119,168,318,147,168,277,108,153
060190057041,300,183,117,306,174,132,697,315,362,428,204,197
060190056071,300,137,163,306,138,168,386,184,192,304,136,152
060190056072,267,138,129,275,139,136,597,285,296,390,183,176
060190056073,240,103,137,245,104,141,451,202,237,397,165,209
060190056022,399,213,186,414,214,200,553,267,280,450,220,207
060190056074,203,108,95,209,109,100,355,170,176,218,104,92
060190057043,679,303,376,693,298,395,1194,484,685,781,291,441
060190057042,572,207,365,577,219,358,630,289,329,651,227,387
060190057031,362,118,244,370,118,252,407,153,247,399,127,255
060190057034,539,182,357,547,179,368,681,262,411,583,188,371
060190057032,732,262,470,747,260,487,825,305,499,759,246,475
060190057033,789,261,528,804,261,543,871,345,512,813,268,500
060190059141,554,217,337,568,208,360,892,353,523,689,260,405
060190059131,515,211,304,523,212,311,798,323,458,623,234,357
060190059112,1610,659,951,1640,659,981,1437,584,827,1075,418,611
060190059132,500,205,295,509,207,302,732,294,419,572,214,327
060190058021,954,336,618,967,338,629,1296,496,775,999,338,610
060190058012,569,214,355,575,213,362,617,295,311,743,264,442
060190058013,356,165,191,362,160,202,567,280,275,442,210,209
060190058022,1117,403,714,1142,401,741,1496,588,876,1271,448,752
060190058011,756,297,459,774,291,483,1114,525,559,866,330,489
060190056082,437,172,265,447,175,272,630,303,316,563,209,325
060190056081,541,227,314,547,234,313,622,297,310,613,247,335
060190031022,254,127,127,263,126,137,516,244,258,292,149,128
060190031025,376,230,146,379,224,155,721,364,338,418,236,156
060190056023,334,167,167,337,161,176,639,304,324,438,201,206
060190031021,107,71,36,110,70,40,228,118,103,151,89,52
060190031034,298,159,139,305,153,152,364,189,165,344,149,171
060190031035,217,116,101,222,111,111,288,150,132,294,129,146
060190031041,351,133,218,358,138,220,447,184,258,404,142,247
060190055151,568,149,419,577,149,428,1025,285,714,864,228,604
060190059152,1040,249,791,1053,245,808,1374,381,972,1007,234,730
060190059122,744,207,537,758,205,553,958,269,675,895,252,600
060190059061,955,250,705,969,247,722,1233,307,912,1008,244,734
060190014152,485,322,163,497,300,197,743,501,234,535,360,152
060190014153,201,160,41,206,153,53,506,384,113,298,239,48
060190014151,204,164,40,209,157,52,297,226,68,207,166,30
060190030041,271,149,122,279,149,130,473,295,170,301,172,114
060190030042,294,155,139,302,145,157,479,280,184,361,192,144
060190030012,279,177,102,282,161,121,425,267,151,345,215,114
060190020004,141,92,49,142,91,51,215,140,72,169,101,59
060190086001,258,144,114,260,142,118,330,188,136,349,188,145
060190049021,301,172,129,305,175,130,577,309,244,427,214,181
060190033022,202,139,63,208,136,72,335,231,95,252,164,73
060190033024,221,151,70,220,142,78,293,207,86,265,169,80
060190046021,386,175,211,397,177,220,390,213,170,398,180,194
060190050003,665,370,295,678,373,305,884,504,364,728,381,311
060390011003,287,91,196,292,89,203,323,123,197,316,104,197
060190031023,426,240,186,434,240,194,751,414,317,539,288,215
060190031024,277,156,121,285,159,126,420,232,179,328,174,130
060190031031,295,167,128,300,165,135,474,261,199,375,194,159
060190031032,297,177,120,301,172,129,473,260,200,351,183,149
060190031033,278,152,126,283,152,131,382,211,162,312,162,132
060190042122,1160,693,467,1177,687,490,1519,935,545,1048,624,372
060190042121,410,256,154,425,249,176,412,269,135,568,330,204
060190042124,174,117,57,177,119,58,318,205,102,196,124,62
060190042126,432,250,182,436,244,192,918,527,367,550,302,220
060190042113,818,449,369,831,443,388,1030,595,412,887,481,346
060190042111,642,379,263,652,359,293,959,554,378,746,403,294
060190042112,610,364,246,621,355,266,890,514,352,686,370,263
060190014162,677,470,207,691,452,239,1207,826,363,673,482,159
060190014172,683,453,230,701,442,259,1110,731,366,790,525,230
060190014171,499,323,176,502,311,191,833,502,316,380,250,113
060190014173,430,278,152,434,266,168,714,440,267,668,444,196
060190014132,1041,608,433,1053,596,457,1934,1148,752,1011,563,402
060190014131,849,470,379,866,464,402,1131,631,467,930,521,365
060190055242,780,272,508,797,286,511,1086,417,652,877,308,544
060190055241,1053,369,684,1076,365,711,1731,666,1042,1256,414,804
060190055141,588,179,409,608,183,425,696,273,410,650,186,431
060190055143,439,176,263,449,181,268,606,236,357,508,194,290
060190056061,752,288,464,772,291,481,1027,403,608,787,295,457
060190014111,313,177,136,313,171,142,378,224,149,501,287,189
060190014112,278,147,131,281,143,138,342,202,136,501,268,206
060190014113,602,347,255,614,346,268,917,541,365,234,140,82
060190014114,164,103,61,165,99,66,462,271,182,321,189,112
060190042171,261,198,63,263,196,67,708,450,247,388,277,95
060190014091,701,402,299,710,395,315,880,528,330,598,332,235
060190014161,630,469,161,637,447,190,921,646,260,749,569,155
060190030031,359,225,134,359,223,136,660,446,204,550,355,169
060190030032,290,170,120,297,175,122,659,427,217,414,241,148
060190042182,505,256,249,508,253,255,1260,711,538,525,274,232
060190042172,230,145,85,235,146,89,563,355,196,374,235,119
060190042181,1277,725,552,1294,703,591,1527,856,651,1379,757,567
060190038042,404,265,139,407,254,153,722,478,232,677,450,190
060190038043,623,415,208,632,411,221,808,537,251,640,410,190
060190038082,390,254,136,396,250,146,640,422,196,482,319,135
060190038052,334,230,104,335,217,118,616,410,186,436,286,121
060190038083,248,171,77,257,166,91,495,322,160,369,254,103
060190038071,269,172,97,272,169,103,415,256,151,322,207,95
060190038111,561,365,196,584,370,214,1053,670,363,688,412,234
060190038081,375,225,150,381,218,163,669,403,249,468,291,147
060190038072,333,197,136,337,196,141,501,294,195,426,244,153
060190014182,512,235,277,521,231,290,543,253,283,424,182,224
060190014181,339,155,184,345,154,191,542,251,280,464,199,242
060190059151,1206,411,795,1218,407,811,1422,471,927,1317,411,852
060190064111,123,36,87,123,37,86,319,72,241,177,33,131
060190059041,209,73,136,217,69,148,303,136,166,261,97,150
060190015001,130,66,64,133,66,67,187,91,94,155,77,74
060190084021,98,28,70,101,29,72,205,69,134,141,37,99
060190084022,66,38,28,67,33,34,94,53,40,76,48,28
060190064091,40,8,32,40,9,31,98,27,70,91,22,63
060190064094,33,7,26,33,7,26,24,6,18,36,8,27
060871215011,331,263,68,332,263,69,428,352,69,332,250,58
060871215021,928,770,158,942,771,171,1334,1093,202,949,748,143
060871215012,615,509,106,625,509,116,912,747,143,660,513,105
060871215013,407,331,76,411,332,79,553,452,96,438,344,68
060871214031,671,551,120,681,551,130,829,673,135,806,611,140
060871214032,923,760,163,932,758,174,1184,966,187,891,695,130
060871214021,846,689,157,871,686,185,1193,964,202,951,712,160
060871214011,453,371,82,467,381,86,531,425,93,487,373,77
060871214012,813,667,146,838,685,153,858,706,131,806,617,125
060871009002,750,643,107,765,653,112,980,842,114,771,629,87
060871214022,878,677,201,896,682,214,1088,893,166,976,734,177
060871217021,725,565,160,734,564,170,851,672,159,753,538,150
060871213002,861,670,191,869,661,208,861,687,155,757,570,125
060871213001,440,337,103,452,341,111,684,546,125,648,480,121
060871212001,603,456,147,611,450,161,797,613,162,685,497,137
060871213003,782,577,205,794,573,221,638,504,123,837,614,183
060871211001,390,295,95,399,296,103,551,416,120,514,371,103
060871211002,1542,1136,406,1563,1137,426,1499,1150,314,1363,983,281
060871212003,922,633,289,948,640,308,1220,867,319,1021,662,257
060871212002,1886,1312,574,1922,1324,598,2567,1927,574,2295,1557,546
060871208003,904,570,334,918,567,351,980,709,254,830,511,268
060871208002,1456,952,504,1489,964,525,1743,1230,466,1638,1086,421
060871216011,957,770,187,975,772,203,1060,867,173,1096,845,168
060871216012,865,677,188,884,686,198,998,822,150,923,691,175
060871210001,960,671,289,973,668,305,1041,778,228,799,529,197
060871216022,759,615,144,782,615,167,987,784,179,850,649,142
060871217022,779,621,158,792,623,169,942,746,174,810,600,147
060871205002,836,601,235,860,613,247,1079,812,237,919,638,219
060871216021,500,380,120,511,378,133,634,508,113,473,360,80
060871220052,694,575,119,705,572,133,1090,856,210,874,649,159
060871210002,970,685,285,988,685,303,1357,1009,305,1294,903,278
060871220011,1210,888,322,1224,890,334,1516,1144,338,1194,850,250
060871220012,1627,1264,363,1650,1268,382,2042,1581,408,1678,1212,320
060871217013,329,250,79,333,252,81,339,263,66,233,166,50
060871224011,1366,860,506,1388,849,539,1837,1207,579,1622,1005,493
060871220051,1267,947,320,1296,952,344,1813,1428,340,1335,960,270
060871001001,1345,1030,315,1387,1051,336,1559,1248,273,1305,984,233
060871217012,764,631,133,779,627,152,1166,938,198,967,728,173
060871217011,815,627,188,827,624,203,1091,856,212,899,666,175
060871209011,944,631,313,959,638,321,1044,745,268,865,567,225
060871209021,1154,729,425,1173,738,435,1378,991,347,1303,830,367
060871107001,634,489,145,630,471,159,908,712,184,736,564,127
060871224022,1273,876,397,1297,861,436,1527,1063,420,1211,781,346
060871107002,259,199,60,255,190,65,392,309,77,307,236,51
060871231001,476,334,142,478,321,157,646,450,181,463,320,111
060871223001,245,174,71,243,167,76,382,280,96,211,146,52
060871223003,1119,854,265,1127,835,292,1467,1124,314,1279,954,242
060871223002,439,307,132,444,305,139,357,249,100,455,302,120
060871106012,557,454,103,564,439,125,869,719,131,845,658,139
060871231002,402,283,119,403,271,132,595,434,148,395,274,95
060871224021,1006,667,339,1017,669,348,1196,818,341,1132,731,313
060871220021,2196,1613,583,2236,1620,616,1720,1280,406,1440,1049,308
060871222041,549,373,176,554,374,180,1162,860,274,962,661,256
060871222042,1049,779,270,1068,771,297,1373,1043,289,1432,1024,308
060871221001,886,699,187,899,694,205,1183,919,238,872,664,151
060871220041,1021,748,273,1047,762,285,1440,1116,289,1285,925,258
060871220042,555,421,134,558,407,151,809,632,160,640,459,133
060871221002,846,656,190,860,655,205,1341,1045,268,965,710,183
060871222053,810,605,205,820,615,205,1086,843,217,983,733,198
060871222051,510,360,150,515,367,148,604,458,135,490,340,122
060871222052,527,390,137,536,399,137,736,574,146,657,483,134
060871222031,1269,897,372,1293,905,388,1721,1291,385,1349,961,306
060871222021,1257,900,357,1281,914,367,1626,1198,387,1427,1016,320
060871222032,885,591,294,897,601,296,635,471,151,690,449,192
060871218022,564,435,129,571,427,144,649,495,140,586,437,116
060871218012,402,297,105,408,297,111,481,370,103,472,348,98
060871218011,672,504,168,684,500,184,838,637,179,727,534,134
060871218021,782,602,180,799,594,205,1114,839,236,882,651,171
060871106011,612,518,94,617,502,115,943,773,153,719,601,86
060871106021,627,521,106,626,500,126,1001,838,145,774,640,92
060871104021,216,177,39,218,175,43,329,259,62,284,230,39
060871005002,1377,1200,177,1400,1206,194,1714,1472,186,1480,1232,138
060871012002,290,235,55,295,237,58,632,552,64,362,277,59
060871202003,660,540,120,671,540,131,609,503,95,662,496,98
060871207003,580,425,155,586,428,158,598,449,132,536,385,115
060871202002,681,548,133,684,534,150,1142,900,210,934,700,149
060871202001,976,794,182,985,787,198,1053,855,168,1003,752,162
060871203011,916,698,218,923,682,241,987,727,225,945,673,183
060871203012,1042,819,223,1049,808,241,1214,943,233,1037,749,199
060871204003,883,696,187,891,687,204,1185,903,234,895,633,168
060871207002,1129,867,262,1137,863,274,1343,1062,250,1158,861,205
060871009001,1227,1063,164,1249,1078,171,1407,1200,163,1203,995,121
060871012001,1390,1181,209,1419,1195,224,1853,1605,213,1546,1243,191
060871005001,1532,1339,193,1575,1372,203,1487,1296,155,1568,1317,161
060871006001,636,566,70,649,571,78,843,748,78,654,558,59
060871003002,1041,877,164,1065,894,171,1271,1108,137,1195,974,148
060871006002,1336,1155,181,1365,1172,193,1732,1534,162,1604,1344,166
060871010011,708,644,64,721,645,76,866,780,66,763,653,52
060871011001,1189,1038,151,1216,1051,165,1231,1061,136,1230,1014,122
060871011003,1101,982,119,1118,992,126,1190,1038,123,1183,994,97
060871011002,931,808,123,947,812,135,982,863,104,984,807,109
060871007002,522,485,37,534,491,43,624,559,52,707,597,43
060871010021,578,532,46,591,539,52,737,652,62,599,504,39
060871008011,829,743,86,838,749,89,1015,895,95,752,618,65
060871010012,941,873,68,955,875,80,1042,950,66,997,851,48
060871008012,610,551,59,621,550,71,878,743,96,688,559,57
060871010022,541,490,51,552,489,63,828,698,99,574,472,46
060871010023,503,443,60,512,444,68,660,567,69,510,433,34
060871003001,1142,992,150,1155,1005,150,927,761,138,934,740,106
060871004002,997,942,55,1029,958,71,367,339,14,1237,1078,63
060871008021,881,790,91,893,788,105,938,819,94,933,790,71
060871008022,847,727,120,861,735,126,884,761,101,981,813,96
060871009003,491,408,83,502,410,92,358,307,45,553,450,61
060871002002,1329,1145,184,1342,1144,198,1360,1171,149,1171,942,131
060871002003,1312,1116,196,1332,1120,212,1564,1341,185,1397,1127,157
060871004001,1357,1287,70,1381,1284,97,228,210,10,1308,1137,41
060871104012,147,129,18,146,126,20,300,241,55,218,198,12
060871101011,929,695,234,932,677,255,1346,1054,278,1068,802,222
060871102023,465,351,114,474,344,130,644,499,132,551,411,105
060871225002,434,332,102,438,318,120,364,292,65,495,387,77
060871225001,468,334,134,480,329,151,859,619,225,505,336,132
060871233001,490,320,170,494,317,177,577,382,184,696,453,199
060871225003,494,409,85,494,386,108,711,569,127,519,417,70
060871225004,359,298,61,361,284,77,633,519,101,410,331,54
060871103011,240,213,27,239,205,34,351,298,49,329,289,27
060871103022,165,146,19,165,142,23,353,286,59,301,258,34
060871104011,175,155,20,176,150,26,394,322,61,284,259,17
060871103021,193,168,25,197,164,33,347,298,40,289,246,29
060871105052,349,292,57,355,288,67,535,424,103,468,397,51
060871104022,621,495,126,622,488,134,839,628,193,610,478,101
060871104023,310,253,57,310,248,62,381,310,64,310,260,39
060871101021,318,283,35,318,273,45,394,336,48,326,287,28
060871102011,646,546,100,646,536,110,956,818,126,677,570,70
060871103012,232,207,25,231,200,31,442,379,58,363,320,33
060871105061,394,319,75,393,301,92,440,346,87,353,289,51
060871105062,369,305,64,368,299,69,464,384,71,425,341,56
060871105031,428,347,81,429,327,102,835,692,127,624,506,87
060871105051,400,337,63,403,330,73,678,565,100,526,430,62
060871102021,339,267,72,343,263,80,501,377,116,410,330,59
060871105041,478,399,79,478,391,87,783,647,125,613,512,74
060871105032,312,262,50,316,258,58,460,381,72,379,317,47
060871102022,477,366,111,486,356,130,678,520,145,527,387,111
060871101022,939,715,224,948,697,251,1280,1007,260,1056,816,193
060871207001,738,459,279,749,467,282,1215,811,373,961,595,282
060871208001,1333,851,482,1358,847,511,1558,1091,438,1376,897,392
060871206002,1184,895,289,1197,886,311,1430,1062,313,1334,908,275
060871206001,1482,1044,438,1501,1040,461,1631,1206,372,1607,1071,388
060871203021,868,644,224,883,649,234,958,736,203,785,544,164
060871203022,837,609,228,847,611,236,1181,887,265,955,661,203
060871203013,744,535,209,753,533,220,664,489,150,536,365,115
060871204004,606,476,130,614,468,146,812,617,173,988,689,187
060871209022,1249,849,400,1271,856,415,1818,1308,459,1493,989,402
060871209012,1016,714,302,1038,725,313,1100,796,278,825,553,203
060871204001,572,452,120,580,445,135,812,624,156,812,591,141
060871205001,1352,1046,306,1361,1021,340,1216,929,238,767,563,139
060871204002,524,369,155,530,370,160,669,502,144,770,518,175
060871205003,1086,821,265,1092,806,286,1266,979,233,1158,785,234
060871007001,308,269,39,313,273,40,489,414,59,414,339,29
060871002001,913,793,120,926,797,129,1302,1116,142,1217,983,125
060552003011,858,603,255,873,593,280,1013,730,259,727,483,204
060552003012,361,274,87,364,261,103,639,478,147,406,282,97
060552003013,543,399,144,551,385,166,880,657,207,702,477,179
060552003021,687,445,242,702,438,264,840,590,231,673,421,197
060552003022,456,315,141,467,303,164,712,502,193,538,337,154
060552008022,686,450,236,706,448,258,890,630,247,754,485,221
060552008031,353,238,115,356,229,127,467,346,111,361,228,108
060552011021,521,326,195,534,322,212,605,419,179,594,375,180
060552011022,421,226,195,431,230,201,470,272,187,414,216,160
060552008032,745,460,285,772,464,308,878,570,279,785,498,242
060552008044,282,195,87,287,202,85,439,312,115,354,249,83
060552007031,1314,751,563,1348,758,590,1658,1058,564,1409,808,493
060552008021,291,212,79,296,206,90,398,291,90,306,219,65
060552007032,513,302,211,533,307,226,584,371,204,544,313,192
060552004003,433,318,115,437,315,122,500,375,111,454,312,105
060552005031,388,301,87,393,306,87,420,319,93,379,296,55
060552005032,135,106,29,133,105,28,347,262,79,190,148,28
060552004002,662,512,150,680,520,160,861,667,181,743,547,142
060552002021,224,179,45,226,185,41,292,245,39,216,162,40
060552002022,187,147,40,188,148,40,281,227,45,262,201,38
060552002023,492,394,98,499,393,106,610,488,104,537,408,84
060552002031,429,341,88,438,332,106,471,348,111,494,347,112
060552002032,332,264,68,336,263,73,520,407,102,409,300,74
060552002012,516,383,133,523,377,146,587,440,133,513,375,109
060552002013,373,274,99,374,268,106,535,406,118,424,299,95
060552010031,551,339,212,563,336,227,449,266,169,330,178,123
060552008043,262,197,65,262,189,73,351,275,68,272,193,62
060552011011,804,476,328,822,486,336,904,594,290,810,480,284
060552007042,375,249,126,382,249,133,785,545,228,541,344,157
060552007043,246,174,72,252,174,78,587,410,157,389,262,97
060552007051,1138,681,457,1158,697,461,1029,650,353,1223,724,417
060552007052,303,205,98,305,197,108,454,311,130,337,201,117
060552007041,810,510,300,831,512,319,992,665,305,657,411,199
060552011012,482,298,184,495,317,178,591,395,186,525,332,166
060552002011,378,302,76,379,301,78,507,401,91,446,332,89
060552008042,385,315,70,388,309,79,528,429,85,402,288,83
060552008041,396,324,72,399,315,84,598,471,115,469,350,81
060552005012,328,233,95,333,230,103,461,332,115,372,260,86
060552007062,723,436,287,735,430,305,794,519,252,685,413,228
060552007063,496,307,189,501,306,195,669,445,206,589,364,187
060552007072,681,400,281,700,404,296,850,560,272,686,406,235
060552007071,851,562,289,862,557,305,1040,714,306,860,552,255
060552007061,581,352,229,588,346,242,849,555,278,713,443,224
060552012001,449,266,183,456,265,191,593,369,204,503,282,184
060552012002,871,515,356,880,497,383,1183,742,422,939,558,342
060552006011,762,452,310,768,443,325,969,606,343,837,491,284
060552006021,604,367,237,618,367,251,632,428,189,474,286,155
060552006014,391,253,138,399,244,155,550,357,179,534,334,167
060552006022,457,292,165,465,292,173,695,454,230,537,323,180
060552014011,464,229,235,468,232,236,466,272,180,447,251,162
060552012003,1046,642,404,1059,645,414,1286,816,448,1218,707,427
060552013001,532,381,151,544,384,160,622,453,160,526,365,135
060552013003,413,232,181,425,250,175,412,256,153,498,286,188
060552015002,419,252,167,422,252,170,472,312,155,446,270,140
060552018002,281,123,158,283,119,164,446,184,248,432,159,238
060552016012,395,277,118,405,276,129,529,395,124,439,307,107
060552018001,339,177,162,345,175,170,511,271,225,457,216,217
060552015001,552,361,191,556,357,199,593,404,175,578,377,154
060552016022,255,178,77,259,177,82,267,197,63,292,204,70
060552017004,368,214,154,374,213,161,345,213,121,333,187,110
060552017005,263,178,85,272,170,102,320,218,94,362,237,97
060552017006,237,148,89,245,142,103,248,161,81,281,177,86
060552014031,517,222,295,528,215,313,542,282,248,517,251,236
060552017001,319,183,136,323,181,142,297,180,104,213,123,69
060552019001,355,216,139,362,216,146,306,216,83,277,169,91
060552020001,341,247,94,344,240,104,526,399,116,433,293,112
060552020003,472,360,112,478,355,123,661,515,128,565,422,109
060552020004,616,478,138,629,477,152,721,570,144,615,453,126
060552017002,440,260,180,441,255,186,679,418,228,721,409,218
060552017003,335,198,137,340,196,144,397,245,134,347,196,105
060552016023,344,237,107,348,241,107,439,331,102,355,248,80
060552016024,581,397,184,591,401,190,697,515,169,580,402,142
060552016021,583,408,175,589,411,178,660,497,148,576,403,133
060552016011,531,405,126,540,408,132,611,474,123,575,426,126
060552020002,370,280,90,374,277,97,384,293,76,331,244,66
060552013002,480,319,161,488,321,167,689,494,183,590,408,148
060552004001,786,485,301,802,492,310,944,632,292,827,507,263
060552014012,843,441,402,859,446,413,850,477,358,864,429,395
060552005051,382,276,106,387,276,111,603,439,152,473,326,118
060552005052,418,303,115,418,294,124,399,282,112,337,231,84
060552014013,480,265,215,496,272,224,560,351,202,502,261,203
060552014022,418,237,181,423,230,193,544,328,203,478,275,165
060552014023,826,439,387,850,456,394,1024,607,388,952,514,369
060552014021,435,235,200,435,238,197,510,311,191,459,241,189
060552005041,469,345,124,476,345,131,810,586,211,681,477,159
060552005042,435,322,113,441,319,122,414,301,106,358,252,81
060552005013,688,525,163,705,523,182,961,729,207,817,592,179
060552005011,354,252,102,364,247,117,540,391,134,428,300,108
060552005043,382,264,118,393,275,118,562,393,152,465,314,119
060552005044,695,479,216,697,477,220,1004,701,275,852,578,220
060552006023,526,353,173,533,353,180,698,475,200,557,363,164
060552006024,673,450,223,685,450,235,680,465,197,713,466,210
060552006013,494,327,167,511,326,185,706,493,194,567,356,172
060552006012,488,293,195,493,287,206,657,411,225,551,331,184
060552009001,67,38,29,67,41,26,33,18,15,125,78,41
060552010051,439,303,136,446,300,146,533,375,149,367,251,93
060552010032,438,320,118,448,331,117,901,667,228,533,414,101
060552010071,734,533,201,741,522,219,1078,765,298,744,528,170
060552008023,1287,883,404,1307,885,422,1727,1239,445,1360,865,397
060552010033,680,498,182,695,514,181,1241,914,310,856,669,159
060552010052,468,306,162,477,298,179,732,494,219,574,381,154
060552010061,557,368,189,568,359,209,897,601,274,712,468,196
060552010062,637,420,217,646,412,234,894,600,279,706,442,213
060552010072,679,473,206,692,478,214,1050,733,290,795,566,182
060552010041,892,665,227,898,671,227,1149,854,273,906,678,182
060552010043,554,415,139,562,419,143,1047,769,252,729,542,151
060552010042,504,375,129,509,379,130,937,692,222,615,462,120
060610208061,825,417,408,843,410,433,971,473,468,869,369,423
060610208062,636,291,345,646,283,363,655,317,320,636,276,318
060610209011,353,177,176,362,175,187,532,264,259,313,151,144
060610209012,357,184,173,361,180,181,715,347,347,558,264,243
060610209081,823,330,493,831,324,507,995,469,507,578,227,316
060610209082,643,312,331,655,296,359,901,433,431,787,337,379
060610210451,779,381,398,789,373,416,1243,644,580,790,345,383
060610210452,354,159,195,361,152,209,660,340,301,422,173,218
060610209083,672,367,305,686,354,332,1178,572,568,829,397,335
060610210036,193,97,96,197,96,101,269,132,129,246,103,120
060610209084,417,177,240,421,168,253,516,252,251,457,192,229
060610210384,1122,501,621,1140,494,646,1509,703,770,1272,538,635
060610210031,474,255,219,478,251,227,649,317,322,516,248,222
060610210032,349,142,207,357,143,214,367,175,179,363,134,208
060610210033,478,186,292,489,187,302,585,266,304,552,209,312
060610210471,832,410,422,847,396,451,1085,505,554,780,335,384
060610210472,917,397,520,927,389,538,1372,643,702,1035,438,519
060610210481,582,275,307,593,272,321,904,424,461,742,338,356
060610210482,698,336,362,711,328,383,989,462,507,821,369,392
060610210381,523,231,292,529,223,306,547,254,277,439,180,224
060610210383,595,262,333,598,251,347,1155,537,589,700,286,349
060610210461,328,156,172,337,153,184,428,206,209,339,142,178
060610210462,724,343,381,732,328,404,1044,500,510,723,302,377
060610210402,1643,744,899,1660,749,911,879,406,461,1095,491,567
060610210371,921,413,508,939,404,535,1489,685,774,1010,426,520
060610210382,840,368,472,854,351,503,1038,475,534,995,415,504
060610210463,687,324,363,696,303,393,1096,514,545,795,337,395
060610226001,1003,451,552,1022,445,577,1265,599,634,1100,464,555
060610213251,700,340,360,705,332,373,1417,737,660,1553,772,725
060610213253,1486,739,747,1511,717,794,1950,992,901,1996,953,927
060610213261,245,123,122,253,119,134,643,332,292,40,21,18
060610213262,889,449,440,904,432,472,1587,800,747,105,55,47
060610213272,384,183,201,390,178,212,1398,726,640,785,363,367
060610213273,162,79,83,165,78,87,641,334,293,120,55,56
060610213274,222,116,106,226,113,113,582,300,265,1,1,0
060610213271,254,76,178,257,79,178,629,247,372,235,53,168
060610210392,591,256,335,599,252,347,448,213,228,555,233,310
060610210401,730,310,420,736,312,424,524,254,261,682,282,380
060610210403,784,341,443,789,328,461,662,306,346,781,330,433
060610210442,1262,519,743,1289,504,785,1566,718,816,1174,452,642
060610210443,776,340,436,790,324,466,1229,590,614,940,392,492
060610210431,731,263,468,743,261,482,1284,593,661,643,237,365
060610210432,902,343,559,918,327,591,1242,578,639,981,371,547
060610210441,578,256,322,586,254,332,902,438,442,731,302,385
060610210391,809,375,434,821,380,441,593,292,293,854,407,430
060610213252,849,413,436,869,403,466,1480,763,683,1155,569,516
060610231001,906,433,473,932,441,491,1235,602,610,1076,468,547
060610231002,2669,1269,1400,2722,1247,1475,1989,973,977,1381,600,695
060610213283,805,368,437,819,370,449,1450,707,715,1049,457,519
060610230002,1106,490,616,1126,478,648,1180,565,584,753,313,383
060610231003,1003,416,587,1024,410,614,2055,944,1072,1184,499,603
060610225001,893,420,473,902,412,490,1374,625,722,888,431,417
060610225002,918,345,573,932,345,587,1334,606,705,1133,406,666
060610232001,1314,552,762,1328,542,786,1549,669,838,1303,516,703
060610232002,1400,574,826,1424,564,860,1488,643,810,1019,391,536
060610235012,522,163,359,531,165,366,544,227,309,452,179,254
060610235021,661,216,445,670,212,458,1176,489,667,611,200,368
060610235022,693,223,470,707,222,485,1270,525,721,559,172,356
060610235024,676,223,453,687,216,471,1395,577,791,1033,316,652
060610211234,963,381,582,978,370,608,985,435,526,1158,456,638
060610235011,192,58,134,197,59,138,367,151,207,296,117,167
060610238002,1587,712,875,1600,699,901,1425,687,730,1137,482,618
060610235023,34,14,20,34,14,20,40,17,23,0,0,0
060610236002,1186,540,646,1187,529,658,1116,530,578,1105,480,593
060610236003,858,357,501,865,358,507,766,319,439,986,422,540
060610237002,1323,553,770,1337,537,800,1149,478,658,1450,604,800
060610236001,1681,679,1002,1694,666,1028,1661,825,823,1574,653,868
060610238001,1273,572,701,1286,555,731,1298,645,643,1297,590,669
060610233002,705,276,429,712,265,447,1942,830,1045,1082,390,597
060610233001,711,313,398,723,301,422,1494,684,780,1077,427,561
060610237001,1275,585,690,1288,567,721,1485,740,733,1546,716,787
060610214031,248,115,133,252,113,139,556,231,307,256,107,129
060610239001,483,177,306,492,173,319,585,243,323,617,204,374
060610239002,775,281,494,781,261,520,775,320,427,807,262,491
060610214034,349,165,184,355,163,192,1045,432,580,447,188,227
060610214012,443,181,262,449,173,276,819,334,466,738,255,427
060610214032,312,145,167,315,142,173,519,209,301,331,140,171
060610214033,336,158,178,337,152,185,455,191,253,377,171,171
060610213044,910,286,624,917,273,644,1090,350,708,467,139,295
060610214011,395,145,250,402,142,260,619,249,359,559,196,318
060610214035,433,204,229,442,200,242,661,262,377,503,203,261
060610234003,859,307,552,873,293,580,1164,459,665,551,170,343
060610234002,833,311,522,841,301,540,1168,463,670,1150,395,680
060610234001,335,126,209,342,123,219,405,168,224,431,148,256
060610211301,203,97,106,208,96,112,361,180,171,195,80,94
060610211302,470,218,252,478,217,261,719,358,343,690,289,342
060610213242,737,340,397,756,341,415,1289,646,613,652,276,327
060610213232,728,327,401,743,323,420,889,413,448,357,154,177
060610213233,578,250,328,590,245,345,624,314,297,819,332,426
060610213234,729,327,402,751,328,423,2479,1236,1179,1109,488,542
060610213231,1216,580,636,1241,573,668,1795,874,878,483,209,239
060610213241,821,318,503,836,316,520,876,418,433,975,364,544
060610213243,809,321,488,822,312,510,1073,532,514,782,304,416
060610211232,752,346,406,762,344,418,1317,611,667,876,394,415
060610211231,1384,543,841,1406,541,865,1378,632,712,1389,560,750
060610211221,1300,547,753,1322,540,782,1341,620,684,1209,496,641
060610211222,651,304,347,664,296,368,863,402,436,712,299,353
060610211233,970,373,597,990,372,618,894,400,474,1113,440,615
060610213281,249,48,201,253,47,206,342,87,246,315,58,241
060610213285,191,39,152,195,39,156,211,55,151,222,47,164
060610213041,978,252,726,991,239,752,1213,308,872,989,243,692
060610213042,290,80,210,295,77,218,513,135,368,365,99,251
060610213043,714,199,515,726,190,536,967,264,675,840,222,566
060610216041,793,256,537,803,250,553,880,307,549,666,210,422
060610215014,881,338,543,889,329,560,965,416,524,1017,361,586
060610216031,880,369,511,885,360,525,867,375,473,618,239,347
060610216032,295,135,160,297,132,165,969,416,524,460,200,231
060610205012,490,181,309,500,177,323,686,260,404,478,175,259
060610205013,647,239,408,656,232,424,727,269,431,693,245,400
060610205023,778,279,499,784,266,518,1064,451,590,910,343,500
060610212041,926,308,618,947,304,643,1177,406,738,938,306,567
060610205022,405,151,254,410,144,266,467,174,275,352,128,193
060610204021,902,459,443,923,449,474,946,488,433,900,457,385
060610205021,1453,569,884,1467,553,914,1360,599,726,1253,495,661
060610205011,492,153,339,499,150,349,668,213,439,498,150,317
060610215011,475,170,305,476,163,313,631,229,387,601,215,346
060610215012,712,248,464,724,236,488,720,269,426,740,246,440
060610206072,1119,383,736,1138,372,766,1504,561,897,957,306,585
060610212031,1022,356,666,1042,336,706,1784,624,1104,1321,429,780
060610212032,1136,375,761,1146,362,784,1716,667,1008,1159,350,715
060610212033,877,293,584,893,276,617,1118,393,695,943,292,574
060610206081,1021,322,699,1026,308,718,1419,510,868,1068,340,647
060610211081,240,104,136,241,100,141,427,191,228,285,116,146
060610211082,1368,588,780,1389,569,820,1479,657,782,1017,409,523
060610211093,408,152,256,415,151,264,501,223,265,262,102,143
060610211091,1174,446,728,1189,444,745,1306,581,692,1181,478,627
060610211092,841,339,502,856,337,519,1155,515,610,1218,467,677
060610206071,1200,401,799,1225,412,813,1635,651,948,1214,414,709
060610211291,646,294,352,664,292,372,1064,471,563,719,281,377
060610211292,565,277,288,574,273,301,763,338,404,604,240,307
060610211282,885,416,469,901,404,497,1106,491,585,949,388,479
060610211062,767,311,456,782,314,468,887,395,468,685,269,368
060610211281,351,171,180,355,166,189,616,274,327,382,167,189
060610211033,667,266,401,679,259,420,644,286,340,540,205,294
060610211034,367,151,216,372,144,228,458,206,246,390,151,216
060610211061,269,107,162,274,109,165,513,229,269,417,166,227
060610211031,429,173,256,440,168,272,1240,550,659,450,139,273
060610211032,256,102,154,262,101,161,407,182,219,287,88,174
060610211311,764,305,459,775,290,485,950,432,496,878,334,464
060610228002,801,346,455,825,361,464,1213,607,577,1011,433,510
060610229001,617,269,348,631,269,362,948,436,487,654,274,329
060610230001,590,278,312,602,267,335,880,392,466,671,316,305
060610229003,490,228,262,503,231,272,1494,666,784,633,293,292
060610228001,905,460,445,911,455,456,1195,595,566,922,419,454
060610229002,494,260,234,506,251,255,845,390,435,552,277,230
060610211313,838,381,457,846,391,455,1090,502,559,815,363,400
060610211312,589,295,294,603,288,315,1181,545,607,772,357,373
060610206082,525,158,367,532,152,380,650,198,428,547,171,347
060610206083,475,136,339,485,135,350,586,178,388,445,137,287
060610206013,1146,411,735,1160,406,754,1373,547,790,1117,424,628
060610206014,887,353,534,897,337,560,1070,439,607,978,393,530
060610212042,563,191,372,572,189,383,605,212,381,570,184,341
060610208051,852,385,467,867,366,501,1018,493,501,898,352,470
060610208052,436,205,231,443,199,244,540,260,265,414,180,202
060610208053,324,176,148,327,171,156,571,272,278,386,184,159
060610207121,461,225,236,468,211,257,768,372,378,594,254,296
060610207131,628,301,327,634,290,344,958,463,471,823,345,422
060610207141,941,404,537,952,384,568,1218,493,706,1016,375,572
060610207142,983,417,566,1000,398,602,1166,497,634,1063,413,574
060610207151,650,266,384,657,255,402,893,379,491,638,240,351
060610207103,845,328,517,866,318,548,1192,508,660,822,310,452
060610207152,728,265,463,739,259,480,1029,441,569,862,298,510
060610207101,695,241,454,704,225,479,773,307,447,694,241,400
060610207122,303,144,159,306,139,167,521,251,256,247,102,124
060610207123,581,280,301,594,268,326,652,317,321,538,238,260
060610207132,652,317,335,661,306,355,723,349,353,663,295,325
060610207102,703,309,394,712,299,413,719,321,380,734,329,352
060610207111,709,326,383,709,309,400,792,388,381,717,332,343
060610207112,654,302,352,667,294,373,1085,533,521,847,391,398
060610206062,554,230,324,570,224,346,744,371,359,547,220,284
060610206063,817,343,474,834,343,491,1076,512,542,855,356,455
060610206053,845,355,490,859,350,509,1245,599,623,964,404,503
060610207113,329,167,162,335,165,170,551,271,265,337,169,142
060610207171,231,112,119,231,112,119,685,335,337,328,154,153
060610207172,1000,467,533,1009,466,543,1955,955,957,1204,553,588
060610224001,1697,742,955,1729,739,990,1400,664,699,1175,530,588
060610224002,918,393,525,939,397,542,1276,609,639,1419,621,739
060610210034,108,59,49,109,59,50,618,308,292,192,93,83
060610226003,733,392,341,746,387,359,1453,689,724,775,374,336
060610210035,794,337,457,811,334,477,929,442,465,890,372,463
060610210341,778,360,418,785,346,439,974,477,461,871,370,444
060610210343,292,134,158,297,133,164,417,197,209,330,141,169
060610210342,447,202,245,453,194,259,894,424,446,662,300,322
060610226002,14,5,9,15,6,9,8,4,4,18,8,9
060610206061,1015,378,637,1039,366,673,1233,551,656,1170,461,635
060610206051,1055,388,667,1066,378,688,1352,602,715,1021,397,567
060610206052,1190,423,767,1212,407,805,1618,718,858,1135,384,667
060610206042,1403,530,873,1415,524,891,1944,866,1030,1410,538,790
060610206044,747,297,450,762,297,465,876,370,487,744,288,416
060610206011,769,310,459,787,312,475,1011,451,535,936,356,521
060610206012,1299,512,787,1319,497,822,1376,578,767,1396,554,762
060610206043,459,174,285,465,169,296,502,201,290,467,163,280
060610206041,500,162,338,514,167,347,626,266,347,550,187,327
060610220021,420,166,254,430,158,272,664,263,379,489,171,283
060610220023,687,286,401,700,267,433,689,294,376,530,190,295
060610220024,932,366,566,933,347,586,1139,421,694,953,325,542
060610220022,1060,376,684,1074,359,715,1393,528,828,1255,398,773
060610203001,923,514,409,948,508,440,1354,682,630,966,504,386
060610215022,569,282,287,577,276,301,665,291,357,531,231,255
060610215013,633,257,376,634,242,392,966,439,503,698,254,393
060610215021,1348,615,733,1370,606,764,1687,794,836,1594,689,794
060610218024,493,206,287,499,201,298,653,285,353,397,157,208
060610218025,816,366,450,831,354,477,957,429,511,814,349,413
060610218022,427,172,255,431,163,268,568,253,302,436,170,228
060610218021,526,202,324,534,192,342,755,290,441,655,237,384
060610218023,501,199,302,507,190,317,699,297,385,540,195,309
060610218012,1013,353,660,1025,338,687,1290,520,740,926,317,553
060610218013,350,135,215,355,131,224,439,164,259,357,135,204
060610218014,400,135,265,408,127,281,472,180,275,388,118,247
060610216033,417,157,260,420,147,273,470,204,255,489,168,298
060610218011,1062,378,684,1067,362,705,1190,480,683,1138,398,674
060610202001,1383,439,944,1414,429,985,1661,513,1114,1365,381,875
060610202002,1266,406,860,1287,386,901,1733,538,1161,1558,433,990
060610202003,218,77,141,222,78,144,133,51,82,122,43,70
060610202004,220,68,152,227,68,159,445,137,300,298,81,191
060610219012,971,352,619,984,342,642,1178,436,716,983,316,591
060610219022,1131,465,666,1141,452,689,1297,563,703,1202,492,637
060610219023,325,128,197,328,122,206,415,158,250,392,137,226
060610219021,1094,437,657,1103,422,681,1250,517,701,1105,423,604
060610219011,660,271,389,667,263,404,1040,432,589,670,258,360
060610220132,462,176,286,472,170,302,646,241,391,588,209,343
060610220133,378,141,237,384,139,245,580,217,352,496,177,291
060610220131,504,194,310,506,188,318,554,207,333,388,112,256
060610220112,595,420,175,604,428,176,885,656,205,573,386,144
060610220142,366,265,101,376,272,104,389,291,90,405,282,95
060610220141,275,209,66,285,218,67,333,247,78,245,170,55
060610221001,321,224,97,328,224,104,408,310,93,316,207,81
060610221002,100,70,30,102,70,32,125,95,28,134,84,37
060610222002,425,311,114,433,312,121,453,337,105,447,289,119
060610222001,112,81,31,113,82,31,130,99,31,106,71,29
060610223001,110,78,32,113,78,35,116,91,25,112,73,31
060610223002,192,133,59,191,132,59,294,224,68,246,157,66
060610201042,221,164,57,229,166,63,219,160,50,216,144,57
060610201043,369,253,116,379,259,120,357,262,79,363,223,110
060610201041,208,153,55,211,155,56,295,220,68,232,152,65
060610201052,408,291,117,419,297,122,412,317,88,401,280,94
060610201051,249,176,73,250,176,74,229,175,54,201,129,62
060610201061,298,215,83,303,215,88,414,318,87,369,236,108
060610201062,420,301,119,429,302,127,395,302,87,385,243,111
060610201071,362,281,81,370,280,90,677,514,147,383,277,77
060610201072,328,255,73,333,253,80,592,450,126,356,261,63
060610201073,116,89,27,118,89,29,368,274,78,225,165,41
060610204022,991,478,513,1003,463,540,1281,662,581,1135,519,517
060610204011,843,456,387,856,441,415,1081,564,493,893,454,359
060610204012,243,138,105,250,135,115,346,181,159,255,133,102
060610203002,561,286,275,568,279,289,979,496,459,600,272,279
060610203003,432,192,240,443,183,260,638,327,293,392,169,189
060610216042,1122,382,740,1139,379,760,1492,525,941,1262,442,755
060610220111,194,130,64,196,131,65,444,328,105,196,116,58
060610220143,175,138,37,174,134,40,298,243,52,197,140,43
060014211001,564,521,43,569,523,46,561,520,26,582,528,29
060014211002,837,787,50,845,784,61,1057,989,51,928,857,42
060014215001,878,816,62,889,823,66,1028,966,47,860,792,34
060014215002,845,799,46,856,806,50,940,887,41,929,854,34
060014216001,607,574,33,615,576,39,710,663,31,774,696,39
060133540011,1119,867,252,1138,879,259,1307,1055,225,1215,927,213
060014001001,1054,935,119,1066,944,122,1268,1124,122,1179,1031,85
060014216002,729,688,41,735,692,43,829,775,32,689,619,25
060014215003,795,756,39,799,763,36,823,792,24,825,768,24
060133560021,1311,849,462,1357,867,490,1781,1185,568,1491,960,465
060014216003,543,521,22,551,522,29,587,561,18,564,517,15
060014216004,433,408,25,437,413,24,591,560,17,525,488,17
060014225001,604,571,33,601,561,40,338,306,18,659,578,27
060014225002,261,247,14,271,253,18,525,474,28,510,449,20
060019821001,133,126,7,135,128,7,330,300,17,372,327,14
060014225003,609,565,44,624,572,52,648,594,31,692,622,28
060014224004,465,438,27,473,443,30,501,463,21,484,432,18
060014224001,290,267,23,293,266,27,337,313,14,470,420,22
060014217003,647,619,28,658,627,31,700,656,24,624,562,17
060014224003,557,525,32,567,534,33,646,594,28,722,648,22
060014227001,306,291,15,311,301,10,279,257,14,289,258,10
060014227002,279,256,23,287,262,25,351,313,24,412,362,16
060014227004,260,241,19,267,242,25,213,185,15,332,297,15
060014227003,297,270,27,305,276,29,220,193,16,430,374,19
060014228001,572,532,40,583,532,51,649,599,32,1221,1096,57
060014228002,236,224,12,243,229,14,336,307,19,543,482,21
060014228003,183,174,9,189,178,11,82,76,5,297,266,12
060014237001,571,517,54,581,520,61,695,638,38,832,740,44
060014237003,417,396,21,426,399,27,371,344,20,458,411,20
060014237002,704,667,37,719,679,40,720,679,30,748,672,28
060014238001,496,457,39,499,463,36,481,456,20,531,490,22
060014238002,769,712,57,778,723,55,865,819,35,738,672,33
060014002001,723,667,56,726,672,54,770,720,39,706,642,35
060014043001,779,701,78,789,707,82,863,809,47,778,689,59
060014238003,907,855,52,911,857,54,1029,969,41,1035,950,32
060014004001,994,957,37,1000,960,40,1063,1000,32,982,894,21
060014239021,388,373,15,386,368,18,401,382,9,448,413,7
060014239022,480,467,13,481,467,14,526,509,10,580,539,8
060014004003,793,753,40,797,756,41,768,736,15,840,768,24
060014236011,891,854,37,900,859,41,857,806,31,911,828,26
060014223001,464,449,15,469,450,19,579,544,20,577,527,14
060014223002,782,753,29,794,760,34,927,861,37,922,835,24
060014236022,591,557,34,605,570,35,710,650,42,803,727,23
060014236023,852,804,48,866,817,49,884,819,42,1018,905,45
060014236012,678,654,24,683,656,27,722,687,19,749,684,15
060014235003,639,618,21,644,617,27,619,575,25,633,570,14
060014235001,601,576,25,604,576,28,802,749,30,747,666,20
060014236021,623,580,43,633,582,51,846,789,30,775,666,30
060014228004,392,370,22,401,377,24,279,250,18,465,408,22
060014212001,464,438,26,473,450,23,551,524,22,422,392,18
060014212004,537,505,32,545,515,30,650,605,25,575,524,19
060133910002,1176,1076,100,1196,1102,94,1334,1239,78,1192,1055,69
060014212002,995,940,55,1007,948,59,1029,975,36,1080,989,38
060014212003,572,544,28,583,555,28,632,603,24,549,503,15
060014213001,826,780,46,834,792,42,920,878,36,859,792,28
060014213002,683,648,35,691,657,34,819,783,31,750,690,26
060014201002,532,492,40,540,500,40,478,437,41,628,571,34
060014201003,387,359,28,390,360,30,385,353,31,418,376,26
060014214001,656,618,38,656,617,39,802,752,31,723,665,21
060014213003,637,608,29,645,614,31,726,684,27,690,635,24
060014213004,519,492,27,525,499,26,623,591,22,570,526,20
060014206001,771,724,47,785,736,49,704,656,44,780,718,35
060014219001,542,514,28,551,525,26,651,611,20,513,459,17
060014214002,445,414,31,450,419,31,548,516,22,455,415,13
060014217001,918,882,36,933,890,43,903,858,30,1012,926,28
060014217002,379,366,13,390,373,17,514,488,17,454,414,13
060014224002,351,321,30,359,329,30,412,384,19,429,382,15
060014218001,754,732,22,766,736,30,751,711,21,702,636,17
060014218002,735,708,27,745,719,26,733,705,19,725,674,18
060014223003,599,565,34,614,575,39,827,763,37,703,615,33
060014229011,289,271,18,295,271,24,447,411,23,431,373,17
060014229012,332,312,20,337,311,26,369,339,19,394,343,13
060014229022,242,225,17,248,226,22,352,327,17,267,231,13
060014229021,301,282,19,307,281,26,483,444,25,334,289,13
060014229023,137,128,9,139,128,11,225,205,13,140,120,8
060014230001,829,783,46,836,785,51,784,725,38,922,818,31
060014230002,1058,1012,46,1061,1012,49,689,640,31,997,890,33
060014230003,612,587,25,621,588,33,828,770,39,874,784,25
060014231001,774,739,35,785,743,42,1082,1011,44,916,816,22
060014234001,531,516,15,530,509,21,543,514,18,609,561,8
060014234002,471,459,12,472,452,20,494,471,17,531,492,6
060014234003,743,719,24,752,720,32,805,758,27,800,725,18
060014234004,676,646,30,686,655,31,940,882,31,733,666,16
060014235002,471,453,18,471,452,19,528,500,18,525,473,11
060014239011,591,573,18,604,577,27,606,572,24,645,557,19
060014239012,527,517,10,535,525,10,611,586,10,625,560,8
060014005001,1212,1180,32,1223,1191,32,1263,1194,36,1257,1139,17
060014005003,449,438,11,451,441,10,454,427,12,389,345,7
060014240011,435,421,14,434,421,13,504,471,18,488,436,10
060014240012,380,367,13,381,368,13,453,426,18,375,338,9
060014240013,461,449,12,466,450,16,708,661,27,596,535,11
060014240014,480,468,12,482,465,17,679,634,27,586,524,10
060014007001,629,613,16,640,620,20,786,747,21,669,607,12
060014240021,497,477,20,503,475,28,750,708,25,610,552,17
060014008001,920,885,35,940,886,54,823,774,33,755,673,18
060014240022,475,462,13,481,470,11,681,646,24,577,526,11
060014233002,750,720,30,751,725,26,820,781,25,834,750,21
060014233003,576,557,19,581,556,25,634,601,21,718,663,13
060014233001,647,625,22,654,626,28,604,573,25,644,579,17
060014231003,483,466,17,486,471,15,541,509,21,525,484,13
060014231004,459,443,16,463,450,13,489,464,21,476,439,12
060014231002,405,391,14,410,392,18,427,401,17,481,435,13
060014222001,722,694,28,728,697,31,823,779,31,740,671,19
060014222002,564,540,24,571,545,26,633,591,27,638,571,17
060014222003,586,561,25,593,565,28,663,616,27,658,581,19
060014219002,690,664,26,703,674,29,761,726,24,738,664,24
060014219003,637,604,33,642,611,31,698,661,24,671,615,20
060014206002,755,712,43,766,722,44,793,731,49,827,766,27
060014205002,728,663,65,738,673,65,1025,942,63,797,712,43
060014206003,602,550,52,609,552,57,729,670,46,618,554,35
060014219004,527,503,24,530,500,30,642,605,22,618,565,20
060014221001,483,466,17,489,470,19,472,441,23,502,461,12
060014221002,912,868,44,927,881,46,889,825,39,966,875,34
060014220001,782,742,40,787,752,35,1225,1157,49,793,725,22
060014204012,307,293,14,314,296,18,342,304,28,143,117,5
060014220002,344,330,14,346,332,14,829,774,36,458,409,18
060014204021,126,119,7,129,121,8,392,349,32,178,145,7
060014232001,589,557,32,595,559,36,728,684,29,588,530,14
060014232002,609,583,26,620,596,24,749,699,31,745,681,20
060014001002,728,606,122,742,621,121,877,783,85,734,610,89
060014044001,977,855,122,1014,880,134,1267,1124,122,1132,992,99
060014044004,342,284,58,349,291,58,500,443,48,426,354,53
060014044003,1092,974,118,1104,974,130,1305,1188,97,1090,955,75
060133530013,396,299,97,404,304,100,777,646,117,404,309,71
060014044002,797,721,76,805,718,87,940,856,70,869,759,64
060014042001,638,568,70,645,576,69,680,623,48,595,523,47
060014042002,826,730,96,834,740,94,873,799,60,719,637,61
060014042003,669,601,68,685,615,70,810,741,54,875,766,59
060014261001,716,596,120,732,617,115,748,656,80,765,645,75
060014043002,596,533,63,608,541,67,664,621,35,651,586,40
060014043003,758,649,109,771,666,105,902,838,52,879,766,71
060014002002,621,574,47,620,576,44,734,687,34,671,607,33
060014003003,594,569,25,607,580,27,912,862,29,626,569,20
060014003001,726,683,43,734,690,44,805,743,45,740,667,25
060014003002,903,858,45,914,866,48,1037,983,42,900,817,35
060014004002,777,756,21,781,757,24,855,828,19,822,765,10
060014003004,955,907,48,965,915,50,977,930,32,998,923,29
060014011001,448,430,18,452,432,20,489,462,18,417,379,13
060014011004,612,588,24,620,593,27,1071,1003,41,732,670,19
060014011002,884,854,30,890,857,33,775,720,30,872,780,22
060014011003,511,485,26,511,485,26,439,407,17,574,498,19
060014013001,602,582,20,608,584,24,940,864,52,485,421,15
060014012001,749,720,29,748,718,30,751,711,29,682,634,14
060014041011,784,743,41,791,740,51,925,874,32,786,723,28
060014041013,565,542,23,565,538,27,644,604,23,678,612,26
060014040002,791,747,44,810,759,51,920,871,36,767,704,23
060014041012,598,571,27,603,575,28,658,621,23,572,516,22
060014041022,510,487,23,516,490,26,734,693,28,931,851,32
060014041021,903,858,45,919,868,51,1053,995,38,861,789,26
060014050002,709,654,55,720,663,57,829,770,49,787,712,43
060014261003,728,549,179,748,574,174,951,802,128,872,676,152
060014050003,810,738,72,820,743,77,951,876,61,833,745,46
060014051001,605,546,59,617,560,57,774,718,47,697,629,38
060014049001,578,547,31,587,547,40,613,567,38,578,538,16
060014050001,433,403,30,443,408,35,557,515,35,502,450,29
060014049003,632,584,48,632,576,56,760,709,47,660,583,42
060014049004,745,697,48,751,692,59,812,747,50,780,702,40
060014049002,647,603,44,658,610,48,754,695,49,681,609,36
060014048001,722,673,49,734,670,64,887,823,46,783,694,52
060014048002,710,670,40,719,665,54,852,800,44,790,707,40
060014012002,546,531,15,541,528,13,629,593,22,599,553,9
060014012003,387,373,14,384,369,15,460,435,16,378,347,7
060014040003,455,434,21,465,437,28,530,499,20,493,450,15
060014040001,580,553,27,596,560,36,735,694,27,659,597,23
060014262003,672,603,69,692,613,79,823,743,65,726,648,49
060014039002,479,457,22,486,463,23,508,475,20,603,541,24
060014039003,948,904,44,953,909,44,1048,978,43,855,775,27
060014039001,845,786,59,851,796,55,963,901,39,991,873,46
060014036003,1383,1326,57,1396,1336,60,1695,1581,69,1543,1400,51
060014038002,564,535,29,570,539,31,591,553,26,567,520,16
060014038003,450,430,20,461,441,20,555,521,24,609,556,18
060014038004,871,827,44,881,832,49,1024,965,43,860,787,23
060014038001,425,389,36,431,395,36,480,454,20,500,445,27
060014261004,705,559,146,729,586,143,765,664,86,675,544,93
060014262002,1215,1034,181,1246,1060,186,1474,1338,117,1322,1145,119
060014051002,476,420,56,481,425,56,509,476,28,411,370,27
060014051005,646,592,54,656,600,56,753,699,45,755,685,35
060014261002,496,391,105,507,406,101,541,459,72,471,377,67
060014051003,581,523,58,585,525,60,675,624,39,574,512,37
060014051004,445,419,26,453,423,30,506,473,28,505,467,20
060014052001,767,715,52,773,715,58,755,695,50,781,679,47
060014045021,635,568,67,641,568,73,702,642,48,691,597,53
060014045022,876,781,95,891,792,99,1033,945,73,965,843,73
060014045023,1080,968,112,1092,976,116,1277,1169,89,1089,954,81
060014045024,1181,1062,119,1203,1084,119,1424,1306,100,1272,1125,87
060014046001,737,661,76,749,669,80,864,792,61,771,682,51
060014046002,493,441,52,500,448,52,559,508,40,513,450,34
060014045011,1152,981,171,1168,990,178,1310,1170,124,1147,981,109
060014046003,768,679,89,775,683,92,873,801,60,727,635,54
060014046004,930,820,110,949,837,112,1121,1024,81,1110,989,76
060014301021,1317,867,450,1348,862,486,1640,1118,483,1402,897,421
060133522021,1408,981,427,1448,1005,443,1735,1319,382,1514,1043,353
060014080001,474,417,57,487,425,62,555,504,44,507,448,34
060014047001,590,547,43,599,556,43,658,612,36,756,694,36
060014047002,723,655,68,741,676,65,816,764,44,637,575,33
060014261006,443,333,110,454,345,109,583,492,79,498,393,79
060014204022,156,149,7,160,151,9,453,401,37,207,168,8
060014204011,91,86,5,92,87,5,287,253,24,109,88,5
060014203021,639,570,69,652,576,76,613,544,51,632,536,58
060014203011,887,778,109,900,788,112,1016,903,84,442,380,27
060133830003,963,871,92,974,884,90,1090,984,85,1595,1367,130
060133892002,326,283,43,336,298,38,434,367,52,384,338,25
060014203022,385,339,46,396,345,51,333,303,28,506,435,50
060014202001,490,441,49,499,440,59,837,750,70,546,481,45
060014202002,417,379,38,424,383,41,466,422,41,390,341,28
060014202003,449,411,38,459,417,42,637,571,52,504,438,35
060014201001,529,489,40,526,487,39,578,522,50,561,505,36
060133891002,522,480,42,536,486,50,774,697,63,580,510,42
060014205001,432,397,35,441,407,34,578,528,37,423,366,28
060014262001,1002,878,124,1032,895,137,1143,1038,90,1080,941,85
060014261005,775,607,168,794,630,164,865,733,115,774,631,100
060014283011,1138,874,264,1200,901,299,1297,1011,265,1095,835,201
060014283014,891,683,208,935,707,228,1449,1132,278,969,735,181
060014090002,77,60,17,79,62,17,1,1,0,69,52,13
060014283022,1634,1220,414,1689,1263,426,1942,1579,327,1308,1015,237
060014283023,1061,816,245,1100,852,248,1489,1209,250,1532,1209,255
060014283012,416,325,91,435,335,100,492,387,100,443,340,80
060014283013,416,337,79,433,349,84,701,562,125,716,594,91
060014283021,1071,808,263,1125,851,274,1551,1249,269,1493,1150,260
060014282001,623,505,118,642,510,132,737,622,106,682,551,112
060014282002,924,757,167,953,773,180,1196,997,171,1044,835,163
060014282005,575,480,95,590,488,102,682,572,100,645,526,87
060014271002,780,633,147,796,643,153,821,687,121,767,619,108
060014271003,901,724,177,921,735,186,910,758,131,781,634,109
060014281001,651,537,114,668,542,126,900,747,128,882,721,112
060014281002,675,572,103,687,577,110,792,668,116,784,655,83
060014281003,583,487,96,590,493,97,697,581,101,623,498,76
060014282003,602,516,86,616,520,96,716,601,102,625,506,76
060014284001,868,735,133,900,753,147,1180,990,167,949,769,116
060014285001,535,449,86,555,463,92,698,581,103,548,445,76
060014285003,353,303,50,369,314,55,578,484,82,629,520,72
060014282004,580,503,77,599,510,89,689,580,97,651,527,81
060014281004,456,379,77,473,393,80,618,511,89,481,384,60
060014271001,462,396,66,475,400,75,776,646,112,537,443,69
060014272001,450,386,64,460,389,71,586,487,84,402,328,50
060014272004,262,228,34,266,230,36,375,320,50,293,251,29
060014272002,602,523,79,607,523,84,1035,859,143,767,634,91
060014272003,443,386,57,450,389,61,537,459,74,423,361,40
060014280001,294,254,40,301,257,44,421,353,58,282,236,33
060014280003,401,342,59,409,348,61,562,465,81,416,345,50
060014280002,469,405,64,475,406,69,687,571,96,520,433,61
060014279002,625,504,121,640,516,124,610,510,91,683,543,96
060014284002,477,409,68,488,417,71,617,512,90,481,389,52
060014284003,615,516,99,631,530,101,784,649,113,627,501,78
060014278002,566,468,98,575,474,101,596,507,78,634,511,75
060014285002,408,321,87,424,333,91,488,405,73,573,436,101
060014286001,550,445,105,573,462,111,703,581,105,646,500,114
060014279001,436,372,64,441,377,64,540,453,74,524,443,53
060014279003,366,307,59,372,310,62,395,329,57,432,356,53
060014279005,452,384,68,460,386,74,595,498,80,520,428,59
060014273001,768,640,128,789,645,144,614,523,82,603,487,84
060014273002,830,703,127,852,712,140,932,781,127,779,632,108
060014279004,475,394,81,489,399,90,496,411,69,548,434,78
060014278001,365,304,61,374,307,67,406,342,55,414,332,52
060014286002,879,754,125,904,768,136,952,793,143,590,480,78
060014278003,413,365,48,418,372,46,483,409,62,451,385,39
060014273003,373,327,46,381,333,48,490,415,67,407,341,41
060014273004,281,244,37,291,254,37,424,364,56,338,280,37
060014278004,412,359,53,424,372,52,573,487,76,506,422,52
060014278005,495,436,59,510,444,66,752,637,98,663,560,69
060014273005,425,369,56,436,377,59,634,535,88,384,323,41
060014276002,577,496,81,590,508,82,897,754,125,578,467,77
060014277001,420,359,61,427,362,65,550,466,74,445,367,58
060014277002,851,729,122,867,732,135,822,678,123,852,694,103
060014277004,349,296,53,355,299,56,398,327,60,255,202,33
060014276001,429,382,47,440,396,44,1119,941,155,842,720,71
060014287001,598,490,108,620,505,115,852,715,130,722,595,89
060014287003,133,113,20,134,112,22,992,833,143,409,339,52
060014276003,304,252,52,315,260,55,369,305,56,255,209,30
060014277003,669,552,117,686,562,124,636,527,97,1069,863,136
060014287002,188,159,29,193,163,30,331,275,51,341,272,44
060014008002,548,527,21,556,528,28,653,608,28,609,543,15
060014008003,700,673,27,709,677,32,730,680,30,739,649,19
060014251032,383,361,22,393,367,26,515,463,42,395,359,17
060014009001,593,575,18,608,582,26,802,756,26,711,636,12
060014009002,567,551,16,583,561,22,741,699,21,688,609,13
060014251041,759,733,26,770,735,35,867,805,48,957,871,37
060014251045,125,116,9,126,117,9,125,118,7,122,110,6
060014007003,448,437,11,455,444,11,535,511,13,535,486,6
060014007004,666,640,26,670,647,23,770,738,15,745,675,12
060014007002,701,684,17,709,691,18,834,801,18,729,668,14
060014005002,528,514,14,530,516,14,598,567,13,662,616,8
060014006001,606,584,22,606,585,21,673,635,20,603,553,10
060014006002,370,355,15,370,359,11,449,421,14,398,362,6
060014010001,435,424,11,445,427,18,578,543,18,477,441,7
060014010002,449,438,11,458,442,16,497,465,16,492,451,9
060014010003,619,604,15,627,604,23,672,639,20,653,595,14
060014010004,330,319,11,334,323,11,450,422,13,412,365,9
060014010006,562,546,16,569,550,19,731,684,22,582,523,10
060014010005,567,548,19,575,554,21,651,610,19,533,470,10
060014251042,250,237,13,254,240,14,580,538,29,263,243,9
060014052003,578,538,40,583,542,41,719,664,44,674,584,39
060014052004,716,696,20,732,708,24,807,751,39,842,749,24
060014052002,598,556,42,609,564,45,623,576,30,607,512,45
060014035012,1043,1004,39,1044,998,46,1168,1076,63,1201,1088,39
060014035022,722,685,37,729,695,34,755,705,32,777,704,28
060014035021,464,440,24,469,441,28,552,508,30,490,447,12
060014035011,535,498,37,540,499,41,628,578,34,569,502,33
060014035014,448,410,38,452,411,41,1248,1149,68,494,429,35
060014036002,686,662,24,693,662,31,828,782,27,741,682,21
060014036001,408,387,21,413,393,20,481,449,19,392,356,15
060014037011,723,693,30,728,696,32,872,824,29,844,763,26
060014037012,913,874,39,909,866,43,1028,970,35,1027,925,28
060014037022,822,782,40,825,784,41,777,715,41,821,730,33
060014034011,577,545,32,585,548,37,673,619,39,524,471,19
060014037021,377,358,19,379,360,19,418,386,21,378,336,15
060014034022,541,510,31,549,515,34,677,625,35,610,540,18
060014034012,536,507,29,543,507,36,547,505,28,587,531,23
060014034013,429,382,47,441,398,43,446,383,51,504,418,53
060014033022,352,322,30,362,331,31,609,546,52,519,461,28
060014033012,145,127,18,152,135,17,313,251,53,186,157,17
060014033011,174,150,24,183,161,22,343,274,60,222,188,21
060014033021,361,337,24,365,340,25,615,566,37,358,322,16
060014033023,272,255,17,276,257,19,504,464,31,459,414,22
060014060001,741,683,58,753,686,67,667,554,103,344,288,29
060014053011,538,509,29,547,519,28,617,570,31,627,565,19
060014053013,605,579,26,609,584,25,520,466,40,618,552,18
060014053012,410,393,17,414,397,17,539,483,41,531,474,15
060014053021,621,573,48,636,585,51,778,697,61,671,578,40
060014053022,425,386,39,433,397,36,685,614,52,509,435,35
060014054011,475,439,36,488,453,35,495,415,68,475,409,19
060014060002,186,167,19,193,170,23,304,251,49,245,210,22
060014060004,212,191,21,218,194,24,391,321,65,315,267,28
060014060003,227,201,26,234,204,30,288,232,45,321,273,28
060014054012,309,278,31,323,293,30,459,378,65,386,330,22
060014054013,235,206,29,243,215,28,343,289,49,264,230,17
060014054021,388,348,40,398,359,39,680,565,96,564,486,30
060014054022,290,267,23,295,273,22,370,309,52,316,274,13
060014061001,236,221,15,238,219,19,413,365,44,269,238,11
060014061003,493,450,43,502,451,51,423,366,47,461,398,29
060014061004,424,386,38,436,389,47,509,442,53,627,545,37
060014061002,174,162,12,175,159,16,335,291,34,214,188,8
060014015001,379,360,19,381,363,18,475,435,26,577,494,17
060014015002,273,265,8,275,264,11,295,271,14,261,222,8
060014015003,322,313,9,326,313,13,308,283,15,293,250,7
060014016001,466,456,10,472,455,17,585,539,31,464,400,12
060014017003,456,440,16,464,446,18,1040,966,46,618,531,17
060014014003,376,359,17,384,364,20,711,653,33,477,410,16
060014014001,455,430,25,459,436,23,554,501,32,480,417,14
060014014002,737,703,34,750,709,41,905,824,46,757,650,24
060014013002,466,446,20,468,444,24,828,762,47,635,572,18
060014013003,536,514,22,538,511,27,611,562,34,460,413,13
060014016002,406,388,18,411,394,17,705,648,33,463,408,6
060014028011,406,387,19,410,392,18,418,383,26,459,415,19
060014028012,196,187,9,197,189,8,400,368,23,189,171,7
060014028013,307,293,14,310,298,12,378,345,22,319,289,12
060014026001,355,325,30,366,336,30,479,434,34,411,364,22
060014027001,209,199,10,217,201,16,277,255,17,222,190,9
060014028022,305,287,18,311,291,20,402,361,29,335,291,24
060014028021,125,114,11,127,116,11,186,165,15,168,146,11
060014027002,464,441,23,466,446,20,509,481,24,502,447,12
060014017002,608,573,35,617,574,43,685,635,33,546,483,14
060014018001,402,390,12,409,392,17,413,383,22,478,415,8
060014022001,571,549,22,586,561,25,574,520,34,457,417,6
060014017001,457,432,25,462,432,30,648,599,30,431,378,10
060014018002,313,299,14,319,300,19,344,323,16,334,289,9
060014022002,177,171,6,176,167,9,238,221,10,271,236,6
060014022003,265,255,10,263,251,12,452,419,21,313,273,6
060014105002,309,296,13,320,307,13,534,488,30,343,315,8
060014105001,294,275,19,296,285,11,475,425,29,452,414,12
060014025001,320,294,26,332,306,26,498,454,30,389,349,19
060014025002,163,150,13,168,155,13,291,264,17,270,242,13
060019820001,84,79,5,89,83,6,75,70,3,46,42,2
060014024001,431,410,21,439,414,25,479,440,21,478,430,13
060014024002,541,515,26,545,515,30,639,586,29,626,564,15
060014031001,413,385,28,416,387,29,369,329,33,171,151,10
060014031002,276,258,18,276,258,18,397,355,35,527,468,29
060019832002,176,166,10,180,168,12,385,363,12,425,391,15
060019832001,144,137,7,147,138,9,210,198,7,66,61,2
060014030003,180,152,28,192,158,34,235,191,40,191,151,28
060014030001,268,231,37,281,236,45,369,298,64,323,256,46
060014030002,246,193,53,269,211,58,370,299,63,359,293,58
060014029001,275,253,22,279,254,25,506,452,39,286,236,24
060014029002,256,236,20,259,241,18,435,401,23,327,271,26
060014066011,291,268,23,303,272,31,466,405,49,379,337,21
060014066012,444,412,32,461,425,36,590,490,81,504,436,29
060014066013,461,424,37,473,436,37,617,543,65,513,453,34
060014066014,292,269,23,296,273,23,420,373,46,338,300,22
060014066021,409,376,33,415,384,31,589,516,59,472,423,25
060014065001,555,515,40,565,519,46,694,602,75,625,554,26
060014066022,312,287,25,324,298,26,519,461,44,372,336,17
060014067001,822,758,64,840,774,66,1005,926,56,1016,912,57
060014067005,449,406,43,459,416,43,440,407,23,326,292,18
060014067003,837,786,51,856,798,58,1130,1022,82,928,840,41
060014067004,442,416,26,453,427,26,516,466,37,414,376,19
060014067002,384,356,28,385,350,35,425,386,30,515,453,23
060014068001,424,378,46,434,382,52,489,442,40,385,332,36
060014068002,388,354,34,400,361,39,492,441,40,382,338,28
060014068004,485,454,31,492,454,38,686,619,57,592,543,30
060014068003,514,464,50,530,474,56,755,681,62,552,477,47
060014069002,692,632,60,706,644,62,674,610,51,673,593,47
060014069003,712,663,49,723,675,48,1050,950,79,814,717,40
060014076001,546,517,29,556,519,37,658,616,29,599,549,20
060014078001,409,386,23,418,390,28,536,501,25,436,402,13
060014078002,720,691,29,733,692,41,816,757,49,765,691,27
060014077001,790,753,37,808,764,44,1008,943,45,864,794,29
060014079001,480,427,53,489,432,57,499,449,39,487,416,45
060014079002,466,424,42,466,421,45,500,454,37,538,477,34
060014079003,617,582,35,616,570,46,727,662,53,595,549,24
060014069001,442,407,35,452,414,38,523,473,41,546,486,32
060014080002,1036,908,128,1064,925,139,1188,1067,107,1139,1007,100
060014070001,295,263,32,309,275,34,417,363,48,316,269,29
060014070002,380,344,36,385,348,37,438,381,48,367,309,30
060014070005,269,243,26,275,249,26,428,374,48,294,248,25
060014070003,329,302,27,340,316,24,514,445,58,414,360,27
060014070004,336,308,28,346,322,24,600,522,65,445,385,27
060014076005,271,248,23,272,255,17,393,350,38,312,279,15
060014071021,433,395,38,435,398,37,643,556,72,607,537,33
060014076002,327,309,18,340,312,28,461,422,31,326,298,9
060014076003,440,408,32,446,416,30,513,469,34,520,477,20
060014076004,399,375,24,407,377,30,732,668,48,511,466,14
060014077002,523,494,29,540,510,30,616,576,32,547,506,16
060014077003,547,521,26,553,523,30,531,499,24,553,506,17
060014055004,532,507,25,536,508,28,585,531,44,494,432,24
060014055001,211,193,18,211,193,18,291,259,29,210,187,11
060014055002,305,285,20,306,286,20,561,504,42,398,344,21
060014055003,282,264,18,284,266,18,481,433,36,329,288,16
060014056001,340,320,20,353,329,24,377,340,30,247,217,11
060014056003,611,582,29,617,577,40,714,646,53,869,743,43
060014056002,339,316,23,350,326,24,532,472,45,386,339,19
060014057001,429,407,22,435,408,27,538,488,42,525,456,27
060014057003,385,361,24,392,364,28,450,399,35,394,343,20
060014058004,170,154,16,171,155,16,262,218,37,205,185,10
060014059021,322,286,36,329,291,38,421,346,67,361,313,25
060014059022,325,288,37,330,292,38,511,426,82,438,382,29
060014058003,214,189,25,221,194,27,314,259,50,278,234,21
060014057002,287,267,20,295,272,23,480,430,41,457,397,25
060014064002,440,408,32,450,414,36,572,507,50,464,404,25
060014064001,298,275,23,303,277,26,350,314,30,230,201,13
060014059011,205,187,18,212,190,22,451,373,72,306,267,17
060014059012,294,269,25,301,272,29,468,382,73,336,294,17
060014059013,177,160,17,180,161,19,299,246,49,208,183,12
060014058001,262,236,26,274,239,35,387,317,61,353,303,27
060014058002,205,184,21,212,186,26,312,248,48,290,245,24
060014062011,225,209,16,231,211,20,329,284,43,253,221,17
060014062012,128,120,8,134,123,11,214,183,27,157,138,10
060014062013,215,200,15,224,205,19,343,290,44,291,253,19
060014062014,144,134,10,149,136,13,282,242,36,209,181,13
060014062023,248,227,21,256,233,23,436,370,54,310,277,15
060014062021,139,126,13,142,128,14,258,218,33,185,166,9
060014062022,236,214,22,245,220,25,430,361,54,280,253,14
060014063002,233,210,23,234,209,25,388,335,45,282,242,14
060014063003,185,174,11,191,176,15,268,230,30,237,206,11
060014063004,204,193,11,210,197,13,307,271,34,277,243,13
060014063001,296,265,31,297,262,35,318,271,36,252,213,14
060014065004,321,289,32,326,291,35,454,390,52,363,311,25
060014065002,171,160,11,172,156,16,267,237,27,204,185,9
060014065003,343,307,36,350,309,41,612,522,70,451,387,32
060014071012,409,376,33,412,377,35,472,410,52,290,255,18
060014071011,334,310,24,338,309,29,686,592,77,433,374,27
060014071023,184,168,16,187,169,18,276,242,30,244,212,16
060014071022,255,229,26,256,230,26,294,257,33,313,275,20
060014071024,252,227,25,256,230,26,285,249,31,299,266,18
060014072001,202,184,18,203,181,22,470,403,50,219,199,9
060014072002,261,237,24,265,234,31,455,386,52,316,278,19
060014072003,282,253,29,279,248,31,398,333,50,364,316,27
060014072004,337,304,33,337,300,37,423,357,55,376,331,28
060014073001,304,286,18,308,286,22,271,243,24,352,306,15
060014073002,284,265,19,285,262,23,505,458,38,334,289,17
060014088004,459,423,36,470,439,31,700,620,67,606,562,19
060014088002,272,255,17,283,262,21,461,410,39,371,353,10
060014088003,192,178,14,201,184,17,388,342,37,228,216,8
060014088001,156,152,4,164,156,8,292,270,20,252,238,6
060014089002,306,286,20,317,291,26,458,402,46,419,395,15
060014089001,238,223,15,246,225,21,360,309,36,321,297,11
060014074001,374,342,32,381,350,31,449,397,43,427,386,17
060014074002,163,147,16,165,146,19,340,294,33,240,216,11
060014075001,135,128,7,138,130,8,266,240,21,193,185,2
060014075002,281,267,14,284,268,16,569,514,44,420,394,9
060014075003,233,223,10,241,227,14,322,287,30,237,222,5
060014087003,287,270,17,292,275,17,416,379,25,344,319,13
060014087004,152,145,7,156,145,11,327,299,20,183,171,5
060014087005,293,278,15,294,279,15,517,475,33,398,369,13
060014087002,352,335,17,359,344,15,390,362,24,416,382,13
060014087006,284,270,14,285,275,10,379,350,25,355,337,9
060014077004,522,502,20,527,500,27,543,514,25,535,489,15
060014087001,483,460,23,495,470,25,380,355,22,495,456,22
060014086001,361,344,17,374,357,17,643,593,38,467,430,16
060014086002,467,444,23,479,455,24,567,518,34,467,435,14
060014086003,241,228,13,246,233,13,479,431,28,396,364,11
060014086004,223,211,12,225,212,13,306,279,20,295,277,8
060014085003,168,159,9,174,164,10,273,251,20,250,234,7
060014085004,167,157,10,170,157,13,239,216,19,217,201,10
060014085005,271,256,15,273,248,25,402,355,29,380,344,15
060014085001,243,229,14,248,234,14,290,261,21,296,277,9
060014085002,280,265,15,289,272,17,358,329,26,306,287,8
060014084001,297,281,16,306,287,19,495,459,27,381,351,9
060014084002,196,185,11,204,192,12,325,300,17,281,258,7
060014084003,364,345,19,372,350,22,584,538,33,404,371,12
060014081001,881,745,136,893,750,143,1179,1004,158,1063,867,148
060014081003,593,537,56,609,548,61,827,733,82,718,634,56
060014081004,453,400,53,466,409,57,499,444,45,400,338,45
060014081005,1104,964,140,1129,984,145,1257,1125,117,1163,1019,98
060014081002,595,534,61,612,544,68,841,749,77,687,601,50
060014082001,729,688,41,740,687,53,743,686,44,716,640,30
060014082002,603,569,34,618,588,30,1004,924,55,784,708,32
060014083001,392,365,27,398,368,30,450,418,27,387,344,21
060014082003,366,348,18,374,352,22,563,519,33,431,389,13
060014083002,538,503,35,549,507,42,487,456,27,577,513,28
060014083003,530,496,34,546,503,43,495,458,26,574,508,27
060014083004,291,274,17,292,275,17,457,420,25,300,278,10
060014098001,485,459,26,489,457,32,634,586,40,514,477,21
060014083005,299,281,18,305,286,19,453,421,24,345,313,14
060014097001,232,220,12,235,219,16,271,246,19,238,219,9
060014097004,238,226,12,243,225,18,425,390,28,306,289,10
060014098002,464,436,28,471,437,34,632,569,48,631,578,22
060014090001,402,380,22,411,392,19,685,609,64,557,504,28
060014090003,372,346,26,381,350,31,535,475,42,496,460,17
060014324003,448,361,87,461,366,95,810,609,191,598,473,89
060014094002,362,335,27,371,338,33,572,499,56,476,429,24
060014094003,189,177,12,189,179,10,338,304,34,266,248,11
060014095001,222,204,18,226,206,20,367,327,36,213,196,11
060014095002,170,158,12,171,159,12,331,291,32,270,244,12
060014095003,151,142,9,155,144,11,213,192,21,188,172,9
060014096001,186,178,8,188,170,18,309,283,23,244,228,11
060014096005,219,206,13,223,205,18,376,348,28,307,289,12
060014097002,298,280,18,301,280,21,521,462,38,459,420,17
060014097003,214,202,12,218,204,14,277,257,20,257,241,9
060014251022,167,155,12,170,157,13,289,270,15,375,338,17
060014251031,286,270,16,293,274,19,413,367,37,355,324,14
060014251033,465,436,29,476,444,32,471,432,38,546,495,24
060014251044,283,263,20,290,268,22,276,256,15,266,241,12
060014251043,112,104,8,115,106,9,211,195,12,210,189,10
060014251011,544,460,84,557,473,84,829,739,75,847,685,98
060014251012,225,190,35,230,195,35,65,58,6,44,36,5
060014251021,336,306,30,340,304,36,563,502,51,435,376,32
060014251023,463,422,41,471,421,50,953,847,86,557,484,41
060014100001,545,458,87,550,463,87,643,574,56,635,524,76
060014304002,592,393,199,602,406,196,310,214,88,375,247,98
060014328001,356,266,90,364,269,95,409,324,77,444,324,94
060014100002,1147,1053,94,1169,1057,112,1279,1187,77,1190,1087,68
060014099004,561,516,45,558,509,49,556,511,33,479,439,23
060014099002,358,321,37,367,330,37,534,491,32,350,314,29
060014099003,768,710,58,786,727,59,935,866,57,1145,1042,69
060014099001,407,363,44,419,375,44,588,545,37,311,277,27
060014321001,911,804,107,922,801,121,1076,931,130,962,817,103
060014321002,514,449,65,522,449,73,664,572,82,464,392,51
060014101001,483,454,29,492,456,36,500,450,39,430,396,14
060014101002,494,468,26,508,480,28,583,523,45,564,531,18
060014098003,392,372,20,395,370,25,619,569,37,472,440,18
060014096002,235,218,17,242,227,15,267,246,21,246,230,10
060014096003,138,128,10,142,132,10,227,206,17,197,179,7
060014096004,155,144,11,157,147,10,265,241,20,197,187,5
060014103001,147,142,5,153,147,6,251,224,20,208,191,6
060014103002,174,166,8,182,173,9,309,279,22,238,223,7
060014103003,208,199,9,213,204,9,439,383,33,300,275,10
060014104001,247,236,11,255,240,15,312,284,24,283,266,7
060014104003,458,436,22,472,443,29,622,563,47,645,595,21
060014102001,399,381,18,407,388,19,680,612,52,543,513,16
060014102002,246,234,12,250,238,12,348,313,28,257,243,8
060014102003,338,320,18,346,327,19,330,298,24,296,279,10
060014104002,353,334,19,364,339,25,347,321,26,413,383,14
060014094001,117,109,8,121,113,8,213,191,22,167,151,6
060014093001,256,240,16,271,249,22,543,486,40,328,310,6
060014093003,234,219,15,240,223,17,502,452,38,311,295,7
060014093002,280,263,17,284,264,20,455,415,35,330,307,12
060014323001,379,335,44,379,330,49,672,548,106,458,393,45
060014093004,135,127,8,139,130,9,313,286,24,236,220,9
060014091001,212,203,9,216,204,12,385,344,30,323,289,16
060014091002,281,271,10,287,273,14,351,318,27,294,269,13
060014092001,483,462,21,492,471,21,647,579,52,528,490,19
060014323003,792,658,134,814,678,136,1181,969,189,1016,839,121
060014325021,575,482,93,588,481,107,928,712,202,586,478,77
060014092002,202,189,13,204,192,12,475,423,37,362,328,17
060014371014,310,234,76,313,234,79,255,178,74,183,129,47
060014372005,511,383,128,524,386,138,880,666,201,654,495,126
060014372002,319,255,64,327,261,66,336,255,76,362,287,57
060014372004,409,325,84,420,325,95,1055,797,241,673,524,113
060014372001,285,214,71,291,215,76,604,457,138,342,264,66
060014369001,290,250,40,291,245,46,662,518,123,355,304,30
060014369002,229,179,50,234,180,54,374,283,83,292,230,52
060014369003,279,219,60,284,219,65,460,346,102,388,304,68
060014369004,329,278,51,339,284,55,534,423,99,471,394,45
060014367001,329,266,63,335,274,61,550,432,109,451,358,68
060014367002,509,405,104,513,414,99,633,497,125,584,469,91
060014370001,450,349,101,458,349,109,580,443,129,413,323,68
060014370003,344,266,78,349,269,80,602,456,132,504,397,84
060014368001,455,368,87,462,366,96,1007,761,222,554,448,79
060014368002,541,425,116,551,421,130,749,571,168,655,507,112
060014366021,322,272,50,331,278,53,480,374,97,435,366,52
060014374001,243,195,48,249,195,54,246,195,50,317,249,53
060014374002,702,572,130,715,571,144,652,512,134,734,591,107
060014375001,229,190,39,233,191,42,557,432,112,446,368,56
060014375002,401,332,69,411,336,75,693,539,141,459,375,62
060014376001,537,434,103,545,432,113,571,441,115,570,456,81
060014376002,260,208,52,265,208,57,310,242,63,369,295,52
060014377021,135,110,25,137,112,25,407,315,82,257,209,35
060014377023,71,59,12,71,59,12,289,226,58,177,143,25
060014377011,64,54,10,65,54,11,227,175,47,120,102,11
060014377012,258,219,39,261,218,43,568,439,115,303,263,27
060014377013,112,96,16,114,96,18,247,189,50,164,140,14
060014377022,118,100,18,118,99,19,445,344,91,257,220,23
060014372003,463,372,91,474,383,91,537,409,123,535,425,82
060014370002,372,291,81,383,291,92,330,245,71,431,340,72
060014373001,237,197,40,242,197,45,297,234,58,254,209,34
060014373002,356,295,61,363,294,69,593,467,116,497,410,66
060014373003,213,177,36,218,177,41,337,264,65,294,242,39
060014383001,286,242,44,294,244,50,450,353,89,383,320,44
060014383002,313,266,47,322,267,55,603,478,120,463,393,52
060014383003,229,194,35,237,196,41,353,280,71,306,256,36
060014384001,319,244,75,326,247,79,563,422,129,391,297,74
060014384002,398,302,96,409,307,102,675,509,158,450,344,85
060014371012,539,420,119,555,432,123,704,527,166,815,628,154
060014371022,380,301,79,388,303,85,705,525,167,439,350,66
060014371011,866,670,196,891,690,201,1308,987,304,1322,1062,207
060014371013,480,375,105,491,378,113,697,520,165,446,347,73
060014371023,339,263,76,353,269,84,508,380,122,288,225,47
060014371021,322,258,64,328,257,71,620,462,147,378,302,57
060014382011,297,261,36,305,266,39,562,435,109,397,340,44
060014382012,458,355,103,469,353,116,847,650,187,559,433,103
060014382013,314,256,58,322,262,60,547,409,127,373,314,49
060014382032,517,412,105,525,418,107,961,710,240,705,580,98
060014382041,451,366,85,459,373,86,851,627,216,580,474,85
060014382042,355,289,66,361,294,67,447,341,94,522,427,77
060014382043,861,639,222,876,663,213,1160,852,290,961,739,196
060014382031,509,384,125,522,381,141,727,533,182,731,548,148
060014351044,127,108,19,129,110,19,666,509,140,355,299,37
060014381001,583,458,125,597,469,128,699,533,146,589,456,98
060014381002,296,232,64,301,235,66,431,334,92,322,252,54
060014381003,260,207,53,266,210,56,433,330,96,381,301,64
060014351041,637,505,132,649,514,135,1126,887,215,680,511,118
060014380001,653,508,145,668,500,168,869,643,209,792,592,146
060014380002,421,328,93,429,325,104,596,445,135,446,333,84
060014381004,500,397,103,512,400,112,595,460,129,510,398,86
060014381005,328,263,65,336,266,70,539,409,114,461,363,76
060014403014,479,396,83,496,393,103,723,548,141,579,453,87
060014381006,289,233,56,297,237,60,498,379,107,425,340,64
060014363022,306,260,46,311,256,55,496,396,88,403,322,53
060014363021,797,671,126,819,680,139,487,382,86,550,452,67
060014363023,173,146,27,177,145,32,343,276,63,299,241,40
060014363012,229,194,35,236,196,40,1106,873,197,329,269,40
060014355002,356,291,65,371,298,73,538,448,82,554,428,88
060014355003,278,221,57,285,226,59,478,376,88,387,297,57
060014354001,534,474,60,542,477,65,668,534,118,557,467,60
060014354002,300,255,45,305,260,45,481,384,87,388,322,47
060014354003,379,323,56,383,324,59,595,470,107,528,436,64
060014312002,691,545,146,703,548,155,957,742,197,841,640,148
060014312003,837,641,196,859,647,212,1196,912,267,944,678,207
060014364034,240,193,47,246,191,55,365,275,78,253,187,48
060014353001,336,266,70,346,276,70,554,453,91,428,331,65
060014353002,515,419,96,530,431,99,793,623,147,676,520,100
060014353003,407,311,96,416,310,106,694,516,162,546,407,105
060014351021,914,693,221,939,710,229,1034,802,208,1143,856,216
060014364033,232,189,43,231,182,49,388,311,69,339,255,66
060014364032,403,328,75,409,325,84,422,337,74,353,279,49
060014364031,317,254,63,320,248,72,387,303,72,366,277,61
060014363011,357,299,58,369,309,60,668,531,115,752,638,83
060014366011,320,267,53,329,273,56,520,413,95,415,329,62
060014366012,539,455,84,551,458,93,1017,799,191,723,591,85
060014366023,257,218,39,265,222,43,381,298,77,297,249,36
060014366022,305,253,52,314,259,55,637,503,116,435,346,63
060014366013,365,312,53,378,316,62,655,517,119,560,465,61
060014365001,316,263,53,324,263,61,887,694,172,509,416,64
060014365003,236,198,38,240,197,43,620,481,123,346,283,41
060014365002,299,233,66,309,245,64,506,403,91,414,328,60
060014378001,575,460,115,591,470,121,852,651,182,667,543,97
060014378003,463,362,101,474,358,116,608,464,132,579,451,103
060014378002,299,241,58,308,247,61,467,360,102,374,307,56
060014351043,383,325,58,390,332,58,721,551,151,232,201,18
060014351042,259,206,53,263,208,55,354,282,66,268,202,47
060014379001,279,227,52,280,227,53,521,403,113,377,299,55
060014379002,226,185,41,228,185,43,454,346,97,357,278,53
060014351022,412,326,86,422,331,91,882,685,180,605,516,66
060014364022,637,460,177,654,468,186,612,465,136,744,534,162
060014351023,746,583,163,761,583,178,801,620,164,653,504,120
060014351034,1218,931,287,1260,955,305,1028,794,213,1297,988,233
060014364021,761,563,198,781,563,218,985,731,238,957,703,221
060014364043,484,376,108,496,376,120,615,463,139,465,355,86
060014359001,593,433,160,613,431,182,858,617,222,543,381,125
060014359002,494,359,135,503,360,143,852,614,226,724,530,151
060014359003,418,302,116,425,304,121,673,488,178,587,424,128
060014334004,463,352,111,476,368,108,770,551,210,534,418,96
060014359004,267,187,80,274,194,80,428,304,112,354,244,90
060014358002,494,370,124,504,371,133,585,418,151,491,363,100
060014358003,411,308,103,420,314,106,594,426,153,489,361,103
060014360001,299,224,75,306,223,83,552,392,142,439,320,89
060014360002,656,489,167,668,487,181,1004,717,260,800,598,158
060014361001,375,282,93,382,280,102,433,312,113,403,300,79
060014361003,574,427,147,584,429,155,927,665,239,724,534,151
060014360003,586,439,147,590,430,160,845,613,223,885,669,168
060014358004,409,305,104,418,315,103,574,413,148,472,349,100
060014358001,415,328,87,429,327,102,649,467,168,548,400,120
060014361002,614,471,143,632,469,163,875,665,200,725,565,134
060014357001,262,204,58,266,207,59,424,320,99,386,298,69
060014357002,283,211,72,291,211,80,325,244,72,336,252,71
060014357003,397,295,102,408,297,111,408,308,91,458,343,97
060014357004,325,241,84,337,245,92,438,335,99,485,366,103
060014331021,522,405,117,550,428,122,752,574,166,715,560,133
060014338021,512,422,90,532,424,108,781,594,163,774,622,109
060014338022,525,424,101,534,429,105,792,635,148,714,559,116
060014337001,350,289,61,358,292,66,515,412,99,416,341,50
060014337002,244,200,44,247,200,47,337,268,64,283,233,36
060014340002,241,197,44,246,201,45,387,305,74,277,225,41
060014340003,328,266,62,337,272,65,560,439,105,359,289,52
060014340001,391,318,73,409,328,81,663,543,109,508,406,66
060014339003,164,140,24,164,139,25,297,244,49,201,171,22
060014339004,303,258,45,305,257,48,572,468,93,422,358,47
060014305001,887,728,159,910,736,174,1072,833,216,935,731,148
060014339001,410,358,52,417,358,59,528,428,86,535,457,56
060014339002,263,230,33,267,229,38,317,259,52,330,284,35
060014338011,185,152,33,189,156,33,306,241,59,225,181,31
060014338012,494,413,81,507,427,80,926,730,171,628,506,86
060014305002,546,444,102,556,449,107,1017,780,211,858,660,146
060014305003,507,399,108,520,411,109,780,568,196,588,446,110
060014306002,342,253,89,351,254,97,578,412,150,340,243,75
060014306003,1243,893,350,1274,902,372,1357,962,356,1330,911,325
060014335002,260,180,80,271,184,87,449,309,137,314,221,83
060014335003,490,338,152,507,344,163,734,498,221,574,397,150
060014335004,289,194,95,299,200,99,540,365,161,398,276,107
060014336001,299,218,81,305,218,87,446,323,119,323,242,67
060014336003,522,388,134,534,382,152,752,541,196,654,486,136
060014336004,470,345,125,483,344,139,771,549,201,596,442,123
060014334005,318,210,108,327,218,109,381,258,114,408,289,96
060014334006,431,298,133,445,312,133,569,397,164,463,348,99
060014333005,503,367,136,521,379,142,779,542,213,581,407,131
060014335001,309,216,93,320,218,102,460,315,139,363,255,91
060014333001,550,403,147,573,415,158,833,589,223,641,467,138
060014336002,352,254,98,357,254,103,646,461,169,412,305,88
060014333003,323,242,81,336,245,91,580,411,158,414,302,85
060014333004,467,355,112,484,352,132,742,525,200,579,435,107
060014333002,314,226,88,327,232,95,493,346,135,441,326,99
060014334001,300,232,68,310,239,71,451,339,107,427,331,78
060014334002,374,286,88,385,297,88,468,351,111,457,354,82
060014334003,315,241,74,323,249,74,355,262,83,327,253,58
060014324001,787,602,185,804,599,205,656,498,140,470,363,87
060014324002,204,158,46,207,156,51,1115,824,263,765,576,153
060014326011,399,337,62,410,348,62,638,522,106,416,344,50
060014326023,341,286,55,350,285,65,620,488,117,425,354,52
060014326021,253,212,41,258,211,47,382,301,71,290,243,36
060014331042,192,165,27,197,165,32,418,332,74,301,252,36
060014325013,595,464,131,613,469,144,1064,802,245,792,627,130
060014325023,318,272,46,327,270,57,462,353,100,590,516,51
060014325022,248,204,44,253,205,48,400,306,87,233,184,33
060014325011,313,252,61,325,259,66,473,351,115,323,254,49
060014325012,186,149,37,193,153,40,355,258,85,272,214,40
060014332004,464,348,116,476,359,117,580,425,141,497,369,103
060014332001,569,436,133,583,440,143,787,584,187,554,420,111
060014332002,507,405,102,521,406,115,973,747,214,785,619,125
060014332003,250,204,46,259,209,50,523,412,100,425,343,58
060014331022,605,454,151,623,469,154,821,629,177,634,465,134
060014331031,790,687,103,807,688,119,898,697,187,713,592,91
060014331041,149,130,19,152,132,20,318,269,44,262,224,21
060014331043,453,384,69,465,388,77,851,712,123,712,593,72
060014330001,416,332,84,428,344,84,655,527,119,577,463,90
060014330002,437,346,91,453,360,93,543,441,95,519,403,83
060014330003,284,245,39,290,245,45,332,266,59,235,197,29
060014331032,241,197,44,249,200,49,367,284,75,287,239,36
060014327002,318,244,74,321,248,73,442,349,85,372,290,64
060014326012,773,642,131,793,654,139,1148,934,192,950,763,129
060014327001,547,462,85,550,466,84,542,470,69,490,399,69
060014327003,390,299,91,394,303,91,488,388,90,446,342,75
060014321003,559,471,88,568,478,90,641,550,77,640,528,81
060014326022,439,377,62,448,379,69,694,586,91,555,465,61
060014328002,885,671,214,917,691,226,968,768,180,923,681,192
060014328003,407,315,92,417,310,107,626,486,126,485,362,87
060014322003,853,734,119,867,738,129,1175,990,160,981,825,104
060014322001,432,370,62,442,374,68,523,438,70,478,394,57
060014322002,402,342,60,406,340,66,467,395,63,466,388,60
060014323002,307,272,35,310,269,41,391,321,62,312,265,31
060014312001,687,509,178,702,519,183,827,597,207,706,502,162
060014311001,503,351,152,518,357,161,602,429,156,483,330,116
060014311002,576,454,122,590,460,130,874,662,187,730,544,130
060014310001,370,263,107,373,265,108,617,439,165,538,381,127
060014310002,514,395,119,525,396,129,735,524,196,566,410,117
060014306004,360,250,110,371,254,117,472,329,131,318,216,83
060014306001,586,402,184,595,405,190,673,465,190,626,428,158
060014304001,518,351,167,528,358,170,1052,730,301,837,566,214
060014309002,370,286,84,378,286,92,768,544,203,505,372,100
060014309003,260,191,69,266,192,74,600,425,157,341,243,75
060014309001,672,514,158,689,514,175,940,670,249,785,569,162
060014307001,417,287,130,431,292,139,470,326,129,394,262,107
060014307002,771,535,236,790,539,251,1140,796,309,987,646,277
060014307003,546,367,179,560,369,191,703,489,194,549,360,153
060014303001,846,537,309,861,558,303,993,671,292,1123,702,340
060014303002,540,366,174,555,368,187,700,484,200,609,384,182
060014303003,496,322,174,509,323,186,770,513,231,557,348,174
060014302004,667,463,204,680,462,218,823,577,227,690,461,186
060014302005,668,433,235,689,442,247,996,668,297,808,508,253
060014302001,1218,816,402,1245,828,417,1500,1052,406,1387,945,365
060014302002,625,429,196,637,430,207,808,574,217,742,498,193
060014308003,723,474,249,739,475,264,1088,741,322,976,650,269
060014302003,381,276,105,389,275,114,540,382,143,381,263,94
060014308001,375,260,115,387,259,128,387,267,109,338,219,91
060014308004,643,448,195,664,451,213,937,662,253,738,497,188
060014308002,364,246,118,380,244,136,465,308,147,453,276,134
060014301013,773,504,269,786,514,272,428,281,136,304,186,95
060014301011,582,349,233,601,354,247,740,490,235,490,293,171
060014301012,986,684,302,1014,702,312,1744,1264,443,1677,1187,401
060014351033,778,556,222,800,564,236,1083,819,247,958,702,216
060014301014,535,347,188,557,367,190,1222,906,289,726,513,169
060014351032,870,649,221,895,651,244,1055,798,239,765,580,153
060014355001,286,214,72,297,217,80,346,257,83,297,211,57
060014356021,251,195,56,258,197,61,392,287,99,323,244,63
060014356022,139,119,20,143,120,23,261,193,60,167,139,19
060014356023,314,258,56,320,262,58,529,417,102,548,442,80
060014356024,338,260,78,344,263,81,569,416,141,413,315,79
060014356011,298,252,46,303,250,53,458,370,78,371,309,47
060014356012,374,320,54,385,323,62,584,465,109,416,351,45
060014356013,230,192,38,235,191,44,407,328,69,321,269,36
060014362002,375,318,57,380,315,65,1023,774,226,517,422,70
060014352001,791,640,151,807,636,171,1316,1034,254,1151,908,178
060014352002,700,583,117,711,584,127,1033,820,190,751,618,97
060014364042,468,357,111,479,356,123,574,430,134,500,370,97
060014364041,536,418,118,550,419,131,754,570,171,610,468,113
060014511042,919,544,375,950,565,385,1479,886,557,1014,584,361
060014512014,478,271,207,488,274,214,754,466,268,585,320,218
060014512011,694,429,265,710,431,279,1069,661,376,739,428,269
060014512012,969,549,420,1001,560,441,1308,812,461,1143,636,410
060014512021,867,501,366,889,511,378,2084,1268,769,1015,516,409
060014512022,319,177,142,332,185,147,439,263,165,374,199,140
060014512023,352,196,156,368,207,161,596,355,224,482,257,180
060014511041,828,427,401,864,441,423,1183,664,493,961,488,405
060014512013,438,247,191,454,251,203,619,386,218,611,338,217
060014515051,553,261,292,577,267,310,524,331,181,568,273,244
060014515061,828,514,314,850,516,334,1174,739,399,838,517,256
060014515062,202,142,60,206,142,64,592,371,204,313,224,66
060014515041,678,418,260,707,439,268,936,592,323,750,453,234
060014515052,1143,612,531,1179,616,563,1176,722,428,1300,677,517
060014515013,898,502,396,929,528,401,731,429,283,854,477,311
060014515031,732,429,303,753,429,324,1282,812,430,961,556,334
060014515035,587,350,237,605,348,257,751,478,253,676,395,231
060014511031,314,182,132,323,191,132,10,7,3,1,0,1
060014511032,717,362,355,737,376,361,874,488,363,686,363,278
060014515012,535,307,228,551,322,229,1049,663,368,1005,594,338
060014515032,354,220,134,367,218,149,498,321,166,495,288,164
060014515033,292,177,115,306,177,129,363,235,120,354,204,118
060014515034,292,179,113,306,180,126,558,360,184,428,256,138
060014515011,593,391,202,610,394,216,808,520,266,520,327,156
060014516011,676,412,264,698,422,276,893,586,288,705,423,214
060014514013,714,432,282,741,441,300,1071,676,368,867,513,293
060014516013,776,436,340,798,442,356,958,603,327,957,544,338
060014516022,454,287,167,476,298,178,601,395,193,436,271,133
060014516021,470,308,162,486,316,170,726,475,231,572,357,169
060014516025,298,195,103,309,200,109,430,282,139,258,165,72
060014517011,362,224,138,374,223,151,504,312,178,414,235,144
060014517012,513,315,198,528,313,215,819,509,291,564,322,198
060014517013,305,184,121,315,184,131,466,290,167,419,240,146
060014517041,643,354,289,672,361,311,894,540,336,741,417,277
060014517042,1033,594,439,1063,594,469,1313,820,466,1128,656,393
060014517043,336,183,153,347,187,160,493,303,175,396,221,147
060014511021,684,361,323,712,377,335,792,471,304,768,415,299
060014511023,633,331,302,655,356,299,761,454,293,636,368,227
060014516024,774,387,387,796,390,406,996,588,381,874,432,369
060014517032,1092,625,467,1130,630,500,1566,967,566,1328,751,473
060014511022,752,392,360,769,401,368,1111,667,427,879,475,356
060014517031,708,409,299,717,408,309,877,550,310,724,401,261
060014516023,881,512,369,901,514,387,1189,703,457,1013,562,375
060014516012,979,525,454,1005,542,463,1117,655,441,1101,586,437
060014514012,1397,784,613,1439,813,626,1421,897,493,1424,800,519
060014513001,1343,791,552,1385,792,593,1650,1048,559,1191,654,450
060014514011,313,203,110,319,198,121,827,523,285,583,346,180
060014514032,528,318,210,548,329,219,623,404,203,687,379,237
060014514041,677,430,247,699,427,272,818,521,266,673,422,188
060014514031,304,187,117,309,186,123,423,273,138,349,208,105
060014514043,306,199,107,311,203,108,874,566,287,533,333,151
060014514044,349,225,124,356,227,129,578,380,192,366,229,104
060014514042,348,206,142,356,200,156,682,434,219,484,276,154
060014513002,712,438,274,730,446,284,1055,639,389,841,476,298
060014513003,847,457,390,871,472,399,1187,714,434,967,508,386
060014507521,1650,1138,512,1697,1169,528,2306,1669,591,1435,977,374
060014507461,1040,646,394,1071,652,419,1318,907,382,1246,774,385
060014507011,575,306,269,595,322,273,636,415,207,711,410,247
060014507015,1225,669,556,1264,690,574,1418,897,491,1162,637,436
060014507421,685,425,260,697,423,274,948,620,307,773,477,240
060014507422,776,453,323,805,459,346,814,539,253,969,577,332
060014507423,738,451,287,754,462,292,1174,789,362,823,478,298
060014507411,477,313,164,495,317,178,1063,700,335,608,369,191
060014507014,1113,638,475,1153,642,511,1491,992,463,1183,700,409
060014507412,597,393,204,614,398,216,968,648,297,623,390,184
060014507413,936,591,345,966,602,364,1201,799,374,1022,654,298
060014507012,526,310,216,546,326,220,830,555,253,833,525,260
060014507013,432,229,203,442,232,210,565,356,193,423,227,166
060014506013,747,389,358,766,394,372,782,464,297,686,385,266
060014506063,1250,769,481,1291,784,507,1406,958,417,1181,752,365
060014506071,455,314,141,468,317,151,1115,777,312,470,319,117
060014506073,410,293,117,418,295,123,901,628,249,636,437,155
060014506072,511,328,183,526,330,196,922,631,273,747,469,219
060014506082,663,415,248,678,417,261,792,552,218,829,517,262
060014506081,559,309,250,561,305,256,673,458,200,673,391,248
060014506034,604,379,225,620,382,238,736,489,230,572,349,172
060014506032,668,434,234,681,435,246,901,600,278,864,527,285
060014506033,75,48,27,76,48,28,158,105,49,94,57,31
060014506041,675,421,254,693,433,260,717,494,206,655,399,219
060014506044,370,232,138,381,242,139,433,300,125,388,249,113
060014506052,446,282,164,458,287,171,520,360,150,507,315,152
060014506053,529,321,208,536,326,210,764,528,220,623,360,227
060014507432,235,182,53,242,184,58,679,490,173,24,17,5
060014507431,495,384,111,512,389,123,1117,809,284,640,467,149
060014507433,252,184,68,255,188,67,541,389,138,404,294,88
060014506031,619,394,225,635,401,234,877,583,272,611,379,194
060014506061,997,586,411,1035,622,413,1290,869,393,1324,822,408
060014506012,613,393,220,623,395,228,826,564,249,648,430,182
060014506093,852,530,322,868,533,335,1035,701,311,988,625,295
060014506083,540,328,212,552,335,217,707,470,219,664,413,200
060014506092,860,548,312,874,547,327,1135,793,323,1038,669,307
060014506091,195,131,64,198,133,65,532,368,149,378,266,92
060014507434,399,276,123,406,285,121,686,495,175,392,285,79
060014507441,1195,737,458,1229,744,485,997,720,254,1324,840,394
060014507442,1534,934,600,1575,962,613,1338,939,378,1616,1018,494
060014506042,766,479,287,786,498,288,1154,794,330,1059,670,317
060014506043,433,269,164,444,279,165,499,347,144,445,277,137
060014507451,828,546,282,857,552,305,1810,1260,511,1251,861,320
060014507452,789,468,321,809,484,325,845,587,240,748,490,215
060014507453,624,388,236,642,399,243,878,612,247,729,482,203
060014506051,787,501,286,807,500,307,912,626,265,797,502,236
060014507462,354,230,124,367,236,131,403,276,121,396,257,115
060014506062,758,470,288,778,485,293,886,605,263,758,474,243
060014505011,627,388,239,647,387,260,734,497,223,603,370,188
060014505021,1173,714,459,1208,719,489,1551,1035,488,1398,855,429
060014505022,1161,822,339,1180,824,356,1887,1358,491,1095,756,267
060014504003,650,429,221,669,427,242,1191,822,346,712,463,202
060014505012,863,546,317,884,532,352,856,604,235,942,579,298
060014504004,563,359,204,583,356,227,807,541,249,827,495,266
060014503001,848,581,267,877,594,283,999,698,281,1007,651,263
060014504001,622,375,247,644,372,272,960,642,295,871,518,285
060133451014,544,336,208,559,346,213,824,558,247,761,484,231
060014504002,583,388,195,594,392,202,786,529,245,681,423,210
060014502003,644,468,176,656,472,184,1018,717,276,581,414,130
060014503003,768,525,243,791,535,256,865,613,235,905,603,233
060014503002,284,206,78,288,208,80,571,422,138,258,180,59
060014502001,473,351,122,485,355,130,742,529,196,619,444,141
060014502002,613,441,172,626,438,188,1113,827,258,1013,750,196
060014501021,549,407,142,564,414,150,1763,1389,347,765,562,157
060014501012,674,497,177,692,512,180,909,697,198,870,654,169
060014501011,636,491,145,642,499,143,1465,1151,282,601,459,107
060014501022,408,305,103,417,308,109,653,481,162,465,348,96
060014507511,2430,1776,654,2513,1850,663,3084,2318,721,1712,1291,359
060014507512,586,414,172,606,432,174,1628,1206,401,1145,852,241
060014507522,1100,769,331,1146,810,336,1252,923,308,1198,882,268
060014507502,694,528,166,721,542,179,1448,1084,347,1057,778,224
060014507501,271,204,67,281,206,75,851,651,185,488,356,104
060014401001,836,618,218,855,636,219,985,726,236,911,666,197
060014403371,1023,721,302,1051,750,301,1291,966,304,1152,825,288
060014412004,540,411,129,558,416,142,1224,920,282,881,679,159
060014403381,370,293,77,382,300,82,882,661,208,391,316,55
060014412005,566,423,143,581,424,157,841,629,193,915,659,199
060014403383,299,230,69,311,230,81,721,539,174,544,437,96
060014403362,766,589,177,788,598,190,901,671,216,706,554,120
060014413012,352,246,106,363,253,110,391,286,98,322,230,79
060014403361,420,319,101,430,331,99,803,595,192,703,545,112
060014403081,597,468,129,607,467,140,814,615,187,538,412,106
060014403084,349,275,74,354,271,83,687,517,157,499,382,98
060014402002,423,361,62,427,351,76,557,446,106,451,384,49
060014403082,203,168,35,207,171,36,441,343,83,461,366,80
060014403083,475,392,83,485,400,85,525,408,97,609,502,85
060014403071,782,566,216,803,574,229,1103,765,322,963,708,211
060014414021,741,552,189,762,570,192,933,681,236,855,640,182
060014403072,355,278,77,366,282,84,570,430,131,412,325,70
060014403073,306,241,65,317,246,71,448,338,103,374,297,64
060014403042,505,387,118,514,402,112,854,637,199,607,481,104
060014403061,579,482,97,592,495,97,1243,930,293,777,656,93
060014403062,352,270,82,365,279,86,602,452,144,451,355,76
060014403041,299,233,66,306,235,71,606,463,135,426,348,60
060014403043,511,382,129,521,391,130,792,569,207,582,452,106
060014403312,309,258,51,319,266,53,665,501,150,426,354,49
060014415013,625,484,141,644,503,141,896,681,197,745,578,125
060014415011,614,474,140,631,492,139,949,726,210,687,533,118
060014403053,632,483,149,649,491,158,826,618,197,769,579,151
060014415012,944,726,218,966,743,223,1515,1157,336,1139,907,198
060014415034,702,548,154,719,561,158,1573,1197,356,568,439,101
060014402001,333,289,44,335,284,51,544,432,106,461,395,50
060014402003,355,311,44,353,301,52,540,433,105,433,374,42
060014402004,312,276,36,317,272,45,507,407,99,406,346,40
060014403012,615,486,129,623,491,132,973,743,213,754,610,111
060014403013,604,459,145,619,464,155,853,654,186,726,571,123
060014403011,497,391,106,504,396,108,725,551,163,572,467,85
060014403341,535,426,109,543,427,116,812,609,188,722,589,102
060014403342,731,585,146,746,584,162,957,722,223,817,645,135
060014415223,570,428,142,597,442,155,897,669,215,660,500,138
060014403321,472,360,112,486,377,109,574,441,126,539,435,87
060014403322,649,493,156,668,511,157,855,641,204,768,604,132
060014403332,379,283,96,390,296,94,535,400,124,501,394,88
060014403331,548,385,163,560,391,169,871,633,228,669,493,136
060014403311,448,374,74,460,385,75,881,674,192,581,485,67
060014403051,369,279,90,374,282,92,468,350,110,443,333,87
060014403052,355,276,79,360,277,83,397,298,95,410,313,80
060014415221,406,296,110,415,302,113,553,410,132,488,362,103
060014415211,531,414,117,542,420,122,650,502,138,600,486,87
060014415213,454,336,118,461,339,122,655,478,155,630,469,127
060014415214,339,250,89,346,253,93,358,266,85,316,236,65
060014415241,790,602,188,816,613,203,929,715,197,752,591,124
060014415212,485,385,100,496,396,100,644,503,133,545,451,72
060014415242,148,112,36,152,114,38,501,390,104,375,294,61
060014415033,476,371,105,490,380,110,505,390,106,532,413,94
060014415231,186,145,41,190,149,41,554,429,113,368,294,56
060014415232,420,330,90,434,340,94,462,361,94,288,229,44
060014415233,128,100,28,133,104,29,446,347,92,291,235,45
060014415222,384,283,101,404,290,114,806,599,194,527,393,106
060014414022,522,368,154,536,375,161,1071,775,272,703,510,149
060014414023,388,257,131,402,254,148,577,421,147,526,351,144
060014414011,423,309,114,444,314,130,616,448,158,477,351,96
060014414012,498,364,134,520,370,150,777,567,200,552,407,111
060014414013,259,189,70,264,190,74,333,243,85,471,338,114
060014414015,444,336,108,460,351,109,672,489,172,402,319,67
060014414014,324,243,81,334,249,85,503,368,129,383,296,73
060014416013,416,299,117,425,303,122,473,345,123,542,398,114
060014413011,541,411,130,564,421,143,1060,761,281,704,537,135
060014413021,437,299,138,450,302,148,620,453,156,616,410,173
060014413024,643,444,199,659,451,208,777,574,191,714,513,171
060014413022,352,248,104,363,252,111,386,282,97,394,280,96
060014413023,437,307,130,446,310,136,549,401,137,537,380,131
060014417022,610,451,159,622,465,157,1345,968,355,697,515,148
060014418001,634,466,168,661,487,174,812,601,194,858,619,191
060014416011,252,179,73,260,183,77,316,230,81,283,203,62
060014416012,762,550,212,781,557,224,947,687,243,950,697,198
060014416023,568,420,148,583,425,158,763,549,195,624,464,128
060014416021,595,410,185,606,423,183,979,710,248,785,561,182
060014416022,581,418,163,596,426,170,867,631,221,682,500,144
060014417011,440,331,109,456,350,106,936,676,240,724,539,143
060014417021,360,276,84,368,282,86,679,488,175,484,358,93
060014417012,261,204,57,267,203,64,366,260,92,345,258,63
060014426021,431,298,133,449,300,149,699,505,177,475,332,115
060014426023,364,251,113,378,253,125,656,476,167,464,331,107
060014426022,668,441,227,689,458,231,758,551,195,755,508,202
060014418002,323,231,92,332,234,98,324,243,74,383,266,91
060014419234,209,148,61,215,152,63,755,535,199,369,252,96
060014426011,446,305,141,458,310,148,579,401,166,492,338,127
060014426012,734,497,237,753,493,260,872,614,240,912,598,257
060014427001,434,294,140,445,296,149,507,354,143,550,371,145
060014427002,335,223,112,353,227,126,569,396,159,389,258,107
060014427003,390,260,130,408,265,143,450,313,127,425,281,117
060014425022,423,299,124,433,299,134,803,561,218,584,434,122
060014425021,556,399,157,569,395,174,656,460,179,576,415,131
060014419261,425,332,93,440,341,99,656,475,171,402,316,68
060014419262,226,175,51,233,181,52,486,349,126,540,411,96
060014425011,446,331,115,460,335,125,700,503,184,644,466,132
060014425012,488,356,132,499,353,146,539,389,142,464,334,97
060014428001,905,652,253,923,665,258,1205,862,321,1101,789,252
060014424001,358,267,91,365,268,97,533,388,135,481,357,97
060014424002,495,369,126,506,372,134,653,471,165,555,412,114
060014424003,445,323,122,457,322,135,646,462,171,520,373,120
060014424004,478,348,130,490,347,143,735,526,193,668,483,151
060014429001,613,451,162,630,452,178,928,663,245,809,586,169
060014429003,504,351,153,513,348,165,731,512,205,708,473,180
060014429004,258,196,62,264,196,68,518,371,139,421,320,79
060014429002,623,436,187,632,426,206,1000,686,288,824,573,192
060014423011,492,342,150,502,347,155,653,469,165,515,371,118
060014423012,213,153,60,218,156,62,433,315,110,326,240,68
060014423023,413,288,125,423,293,130,805,581,205,503,365,116
060014430022,548,386,162,564,385,179,760,524,221,557,399,134
060014430023,762,540,222,772,536,236,1092,756,319,984,697,225
060014430021,361,252,109,370,249,121,627,431,181,338,241,84
060014422004,542,379,163,562,396,166,652,461,177,784,567,177
060014423013,415,315,100,426,319,107,682,504,165,531,380,124
060014423022,567,417,150,584,430,154,809,596,196,558,433,94
060014423021,251,190,61,259,195,64,573,422,140,425,331,71
060014430011,444,319,125,456,315,141,739,531,196,561,410,115
060014430012,308,221,87,316,218,98,563,399,148,428,311,88
060014412002,296,219,77,305,220,85,167,124,39,302,212,69
060014412003,784,578,206,807,581,226,1028,766,240,753,532,170
060014412001,399,293,106,414,297,117,397,296,93,356,252,82
060014411001,997,738,259,1031,746,285,1415,1051,334,1359,971,300
060014411002,826,621,205,854,629,225,655,490,152,591,438,121
060014419281,14,10,4,15,13,2,221,170,48,41,33,6
060014418003,609,432,177,615,428,187,663,503,149,633,441,147
060014419232,226,173,53,236,181,55,303,225,69,234,176,43
060014418004,354,267,87,355,269,86,342,262,71,298,217,61
060014419245,485,368,117,501,374,127,721,546,164,504,377,95
060014419243,263,199,64,264,201,63,476,368,100,384,285,70
060014419231,146,113,33,154,120,34,454,339,105,283,213,52
060014419233,118,92,26,123,96,27,358,267,83,210,157,39
060014419271,508,401,107,520,406,114,644,493,136,393,309,63
060014419272,52,42,10,53,42,11,364,282,76,254,200,42
060014419242,655,491,164,669,482,187,1080,801,252,777,582,140
060014419244,30,22,8,31,23,8,21,16,5,43,32,9
060014419241,433,338,95,448,342,106,975,743,209,580,445,94
060014419211,437,338,99,448,344,104,414,309,101,368,284,60
060014419212,396,308,88,408,312,96,794,588,192,701,540,117
060014419291,478,400,78,490,398,92,537,412,112,385,299,61
060014419282,270,226,44,277,223,54,600,466,125,470,363,76
060014419292,90,75,15,92,75,17,244,188,51,169,131,27
060014421003,382,274,108,397,288,109,654,444,205,518,383,116
060014420001,1051,716,335,1079,743,336,1100,821,255,947,705,198
060014421001,936,619,317,971,631,340,1292,948,312,957,659,243
060014421002,655,438,217,685,469,216,871,638,210,816,597,173
060014422002,861,520,341,899,536,363,1322,945,353,984,660,277
060014420002,416,273,143,427,278,149,873,657,201,752,562,163
060014422003,682,451,231,710,480,230,926,648,257,792,559,186
060014422001,613,417,196,629,430,199,1062,746,298,696,514,159
060014431044,385,272,113,397,278,119,765,556,196,461,346,93
060014431041,779,544,235,802,551,251,898,659,223,795,579,181
060014431043,407,281,126,418,281,137,607,442,156,430,311,101
060014431051,765,546,219,782,560,222,1516,1137,354,791,601,154
060014431033,444,314,130,453,317,136,548,395,143,401,295,87
060014431042,316,221,95,324,222,102,619,452,159,438,320,94
060014431052,977,700,277,1009,724,285,1716,1276,408,1330,997,282
060014431024,468,352,116,492,369,123,803,597,196,617,484,106
060014431021,550,385,165,573,398,175,699,514,171,548,410,113
060014431032,590,450,140,608,458,150,547,396,142,435,341,79
060014431031,660,496,164,677,508,169,926,685,225,1122,888,194
060014431023,457,313,144,478,314,164,436,316,116,537,394,122
060014431022,365,255,110,381,259,122,557,410,136,452,330,103
060014432001,1121,751,370,1160,771,389,1851,1344,482,1297,937,307
060014415252,0,0,0,0,0,0,19,14,5,0,0,0
060014415251,86,59,27,90,60,30,470,339,123,124,91,26
060014433211,280,191,89,283,191,92,806,551,239,399,297,83
060014433212,183,125,58,185,125,60,421,285,126,244,179,50
060014433221,526,342,184,538,345,193,633,435,191,471,333,111
060014433011,556,363,193,574,372,202,606,427,174,597,412,154
060014432002,409,256,153,421,268,153,681,494,177,518,360,133
060014433013,243,168,75,250,173,77,323,228,88,276,194,69
060014433222,364,231,133,377,234,143,470,324,141,560,384,145
060014446011,790,559,231,810,563,247,1043,757,263,1095,796,232
060014446012,965,702,263,981,693,288,1582,1166,391,1089,798,236
060014446022,396,297,99,404,293,111,800,591,199,550,402,108
060014446021,697,540,157,716,548,168,1114,822,269,690,527,125
060014441001,1147,835,312,1167,834,333,1260,911,327,1332,957,295
060014445001,207,150,57,211,151,60,353,259,86,241,182,51
060014445002,453,333,120,465,337,128,657,487,160,462,346,100
060014445003,379,292,87,388,294,94,713,520,177,520,392,101
060014443041,558,433,125,583,436,147,948,716,215,615,482,101
060014445004,338,267,71,347,268,79,1011,735,253,688,525,124
060014443042,640,476,164,662,486,176,1769,1336,402,699,533,132
060014443011,553,403,150,568,408,160,638,482,145,728,532,161
060014443012,730,538,192,749,548,201,733,552,168,849,623,185
060014442002,762,571,191,784,568,216,1031,758,260,1081,805,217
060014442003,780,565,215,794,575,219,1232,878,329,994,718,224
060014441002,710,498,212,718,493,225,739,527,198,678,461,168
060014441004,507,342,165,529,352,177,651,465,175,613,413,159
060014441003,516,384,132,530,387,143,785,569,205,646,478,138
060014444001,367,272,95,370,267,103,571,422,143,516,379,108
060014442001,477,359,118,494,361,133,592,430,151,558,407,114
060014444002,463,367,96,468,367,101,919,675,231,591,448,116
060014444003,361,285,76,362,283,79,741,544,184,477,361,95
060014351031,495,312,183,508,319,189,857,600,241,490,314,148
060014506011,286,184,102,294,178,116,445,286,138,403,244,128
060014035013,233,223,10,239,225,14,302,281,13,269,247,7
060014034021,67,59,8,69,60,9,72,62,6,65,56,6
060019819001,28,27,1,28,28,0,18,17,1,34,34,0
060014074003,85,77,8,87,75,12,219,196,18,137,124,8
060014337003,121,97,24,130,103,27,272,219,53,196,159,24
060014330004,291,208,83,303,217,86,346,243,95,325,234,73
060014362001,225,195,30,230,201,29,392,296,87,282,246,23
060014511043,617,277,340,625,274,351,1186,603,558,507,196,277
060133040021,374,143,231,389,128,261,546,205,336,406,163,220
060014443031,3,2,1,3,2,1,1,1,0,0,0,0
060133211032,1133,709,424,1162,727,435,1478,987,454,1177,736,373
060133470002,1315,818,497,1347,828,519,1512,1045,443,1330,864,373
060133560022,1072,853,219,1117,881,236,1669,1340,305,1243,998,190
060133592022,1237,861,376,1271,864,407,1257,904,330,1098,760,286
060133480003,1014,683,331,1048,711,337,1515,1131,349,895,625,216
060133342001,942,583,359,963,589,374,1188,803,371,954,594,312
060133342002,546,291,255,568,307,261,904,554,331,652,379,228
060133452041,1103,590,513,1143,617,526,1310,808,463,1229,703,444
060133452042,868,425,443,906,446,460,1048,571,467,929,442,429
060133461011,1292,802,490,1341,824,517,1707,1185,480,1460,936,421
060133461012,647,379,268,670,389,281,518,330,170,470,270,168
060133461021,1110,555,555,1135,554,581,1697,1018,648,1373,737,543
060133461022,908,446,462,933,446,487,867,503,346,654,343,266
060133461024,662,314,348,687,313,374,895,482,399,747,368,326
060133461023,386,171,215,400,189,211,610,345,255,508,249,234
060133462052,843,389,454,868,417,451,883,516,344,759,392,322
060133342006,597,410,187,613,417,196,933,680,237,774,547,178
060133342003,669,461,208,699,473,226,694,515,170,568,407,129
060133462051,1331,663,668,1378,695,683,2038,1183,814,1637,884,650
060133462061,784,378,406,816,395,421,1017,547,444,819,412,346
060133050003,219,162,57,229,168,61,288,206,76,187,133,46
060133050004,311,209,102,318,207,111,543,382,149,331,247,65
060133072011,454,304,150,466,316,150,627,439,173,443,306,110
060133131021,607,499,108,633,515,118,1168,946,200,686,565,91
060133072012,183,126,57,188,130,58,493,353,128,378,264,91
060133050005,223,169,54,220,162,58,395,289,100,318,229,70
060133071021,117,89,28,120,87,33,219,158,51,146,104,32
060133072041,395,276,119,406,277,129,575,411,146,447,319,107
060133072042,275,190,85,283,189,94,396,278,109,336,234,85
060133072043,490,349,141,500,343,157,813,591,201,652,471,149
060133072052,504,361,143,516,360,156,850,636,199,588,425,134
060133072053,350,248,102,363,249,114,561,391,153,500,339,131
060133072054,465,288,177,481,298,183,814,564,234,629,403,193
060133131062,698,507,191,712,498,214,1045,764,253,907,625,237
060133551181,752,571,181,783,587,196,997,801,183,820,643,136
060133551201,758,557,201,787,578,209,1370,1031,323,1047,795,206
060133551092,351,245,106,358,247,111,507,371,130,530,369,132
060133551073,558,382,176,569,394,175,897,643,237,577,424,126
060133551072,557,339,218,572,346,226,983,617,339,726,461,231
060133551071,824,460,364,843,466,377,999,635,329,818,443,326
060133551182,751,515,236,762,526,236,1051,733,299,826,585,211
060133071011,484,308,176,510,325,185,709,477,207,601,390,179
060133071012,301,192,109,316,197,119,517,343,163,368,230,116
060133080011,473,295,178,483,292,191,912,603,292,739,446,248
060133071013,519,329,190,543,335,208,741,489,240,546,335,181
060133071024,403,265,138,414,265,149,651,454,186,539,364,147
060133050002,214,153,61,224,155,69,344,231,97,280,194,68
060133071023,241,166,75,247,159,88,477,318,141,331,243,69
060133050001,216,163,53,227,169,58,378,263,104,302,201,84
060133060032,389,265,124,403,265,138,596,405,173,475,310,133
060133060031,386,259,127,401,262,139,567,409,151,452,303,121
060133060033,432,272,160,449,278,171,660,448,201,593,364,191
060133080013,520,320,200,531,315,216,806,528,266,642,376,222
060133080014,412,261,151,422,254,168,638,413,214,485,294,166
060133080012,857,551,306,874,539,335,1202,780,396,949,592,297
060133551091,437,287,150,445,291,154,563,368,183,703,436,225
060133551094,617,453,164,635,460,175,991,728,243,766,538,194
060133551192,750,562,188,763,555,208,1299,969,298,966,736,176
060133551191,679,535,144,689,537,152,1051,840,197,818,658,140
060133032071,856,647,209,879,660,219,1299,969,295,952,692,205
060133551093,936,672,264,958,675,283,1469,1070,367,1036,732,258
060133060021,489,316,173,500,319,181,632,402,218,470,300,144
060133060041,510,341,169,534,357,177,818,576,218,669,463,178
060133060022,469,307,162,480,308,172,1001,661,318,670,443,188
060133060042,311,204,107,319,205,114,491,319,158,385,241,121
060133020132,339,172,167,348,170,178,430,222,200,364,195,153
060133080021,566,420,146,575,420,155,1165,876,269,797,596,165
060133080023,253,184,69,260,184,76,299,215,79,419,296,100
060133080022,680,443,237,693,439,254,1118,744,351,940,608,283
060133020094,949,692,257,977,706,271,1404,1052,321,626,460,136
060133551113,516,387,129,533,397,136,877,677,190,641,471,147
060133551112,609,437,172,623,442,181,1052,790,246,916,665,201
060133551111,713,528,185,733,546,187,1248,922,302,956,694,214
060133551101,698,491,207,719,495,224,953,683,254,780,547,174
060133551102,521,392,129,532,398,134,917,694,202,647,468,143
060133020093,386,281,105,398,291,107,482,352,120,471,341,105
060133020092,372,257,115,377,251,126,600,421,172,456,321,115
060133020091,566,409,157,580,402,178,1068,797,252,675,483,163
060133551202,430,336,94,446,342,104,655,483,161,546,422,102
060133032073,402,273,129,411,273,138,609,438,158,520,346,148
060133032072,431,340,91,457,358,99,1017,768,223,616,475,111
060133072051,331,238,93,342,245,97,558,403,137,408,291,94
060133072021,221,183,38,231,190,41,361,302,53,257,194,46
060133072023,195,162,33,205,170,35,437,362,64,365,275,67
060133071022,180,133,47,183,136,47,347,260,79,236,172,52
060133072022,121,89,32,122,91,31,187,150,31,117,85,25
060133331011,431,234,197,449,237,212,615,346,255,477,248,194
060133331021,649,356,293,676,364,312,867,551,304,676,377,263
060133141031,287,222,65,293,225,68,646,481,141,495,394,70
060133142002,473,357,116,486,366,120,786,593,168,609,441,138
060133141032,333,258,75,343,262,81,426,320,93,337,267,46
060133141021,552,441,111,564,448,116,992,770,195,716,569,115
060133141022,296,239,57,305,245,60,548,428,109,425,342,63
060133141062,166,124,42,169,129,40,378,294,74,251,186,49
060133141033,225,180,45,233,180,53,476,364,98,325,261,49
060133141061,296,235,61,299,232,67,534,406,114,370,290,52
060133141052,366,294,72,384,313,71,649,517,118,552,450,73
060133141051,538,411,127,564,424,140,511,393,105,384,310,52
060133142001,270,208,62,282,214,68,490,382,91,345,259,66
060133150002,865,611,254,887,632,255,1295,924,347,1014,725,242
060133142003,323,244,79,330,238,92,689,503,174,349,263,69
060133132031,625,445,180,633,457,176,463,339,115,200,147,40
060133010001,456,206,250,477,205,272,476,210,255,420,181,216
060133010002,265,119,146,276,119,157,518,230,280,375,162,192
060133010004,541,299,242,560,294,266,375,180,185,321,144,159
060133010003,379,211,168,385,206,179,1111,660,420,557,305,215
060133040012,784,439,345,797,442,355,1587,945,609,1264,691,515
060133040011,1100,631,469,1134,632,502,2312,1456,818,1398,804,546
060133462043,939,476,463,972,492,480,1280,777,481,1122,623,428
060133551123,1411,629,782,1455,658,797,1874,1000,846,1525,725,716
060133551122,654,283,371,674,302,372,545,294,247,809,393,375
060133462042,1061,533,528,1098,563,535,1379,834,527,1069,579,425
060133551131,871,475,396,905,489,416,1321,865,435,827,464,309
060133551132,749,425,324,774,439,335,1484,926,543,1130,673,384
060133551222,964,615,349,991,627,364,462,301,152,653,420,204
060133551121,722,298,424,749,301,448,941,418,499,751,310,387
060133551133,633,323,310,652,331,321,849,469,370,689,330,320
060133551223,725,447,278,745,461,284,1057,686,355,1192,760,377
060133031042,1272,715,557,1305,722,583,1649,999,618,1272,727,486
060133020141,919,489,430,941,472,469,1552,815,699,1055,556,439
060133032091,797,478,319,817,480,337,1490,928,537,1112,680,369
060133032023,1075,557,518,1106,562,544,1549,821,681,1145,562,505
060133032092,432,253,179,442,253,189,993,617,356,651,398,215
060133031041,822,441,381,854,437,417,1842,1007,804,1136,649,432
060133031051,772,446,326,799,450,349,1417,870,498,986,581,342
060133031061,720,304,416,738,295,443,901,397,478,753,332,372
060133031063,771,472,299,789,450,339,937,562,352,571,337,200
060133032081,515,262,253,532,268,264,779,418,343,689,345,296
060133031062,367,238,129,378,236,142,1109,702,385,615,386,193
060133032082,1202,587,615,1245,601,644,1886,1011,839,1638,783,775
060133032022,989,518,471,1013,505,508,1469,798,635,1094,559,464
060133032021,1091,622,469,1125,636,489,1731,1008,675,945,507,375
060133031073,352,219,133,364,213,151,583,355,214,367,234,110
060133031071,436,280,156,449,280,169,577,384,181,492,317,147
060133032062,699,383,316,722,375,347,991,584,389,752,407,308
060133032061,980,520,460,1017,516,501,1343,767,553,869,476,350
060133032043,656,338,318,675,338,337,1134,591,511,858,416,373
060133032041,451,252,199,465,241,224,827,504,306,478,244,205
060133032042,283,159,124,293,152,141,501,254,240,467,237,197
060133031074,688,353,335,703,332,371,1158,603,526,714,356,308
060133031072,484,290,194,498,281,217,911,575,319,722,366,316
060133032102,1727,905,822,1774,906,868,969,549,410,901,450,425
060133032101,1297,634,663,1347,652,695,1710,934,759,1455,731,661
060133032111,1138,576,562,1169,566,603,1493,767,684,1193,575,530
060133032112,635,343,292,646,339,307,1229,674,525,789,405,322
060133211031,1140,758,382,1172,774,398,1332,984,321,1209,793,328
060133470001,1449,937,512,1491,954,537,1922,1385,496,1624,1107,407
060133470003,738,474,264,757,476,281,1000,709,273,854,556,235
060133260001,1253,852,401,1293,876,417,1497,1086,379,1284,878,331
060133400033,1069,755,314,1103,778,325,1328,1001,296,1089,775,258
060133400031,513,360,153,527,361,166,695,506,171,573,388,140
060133553061,595,298,297,623,307,316,714,389,310,565,281,238
060133040072,380,160,220,400,162,238,705,344,343,508,214,266
060133040073,654,312,342,673,310,363,880,424,434,589,236,314
060133530012,943,713,230,967,725,242,1080,904,157,1148,883,199
060133383022,683,405,278,700,411,289,921,598,298,754,471,244
060133553023,807,503,304,834,522,312,993,707,271,837,564,230
060133553071,1079,614,465,1120,619,501,1517,965,530,1200,703,431
060133553082,676,379,297,696,387,309,874,562,296,750,435,275
060133553072,1005,620,385,1036,642,394,1383,934,427,1135,693,368
060133553102,594,378,216,607,385,222,840,553,262,689,430,218
060133553101,677,468,209,695,465,230,1001,702,274,785,507,212
060133553083,517,267,250,537,265,272,684,392,268,563,294,220
060133553062,558,299,259,585,306,279,724,422,280,568,307,220
060133553091,718,384,334,749,390,359,910,534,354,762,408,311
060133553063,974,538,436,1015,556,459,821,498,302,715,402,274
060133553065,352,181,171,371,188,183,530,303,218,435,226,180
060133553081,624,292,332,652,299,353,822,447,361,694,330,317
060133553064,229,125,104,237,130,107,804,494,294,676,378,258
060133150001,310,188,122,329,197,132,456,304,141,362,207,126
060133270011,445,323,122,455,322,133,641,458,160,464,333,104
060133270022,217,162,55,225,164,61,422,314,97,293,202,63
060133270023,363,272,91,377,274,103,484,358,111,398,274,87
060133270021,644,460,184,663,468,195,1011,718,265,780,514,206
060133290001,696,451,245,724,466,258,1000,672,297,773,513,214
060133290002,577,374,203,597,382,215,817,564,234,671,442,189
060133290003,377,281,96,390,281,109,612,467,129,482,338,108
060133290004,474,350,124,490,364,126,760,567,177,644,452,146
060133300001,409,288,121,420,287,133,627,437,163,491,340,118
060133552022,156,112,44,159,115,44,1122,822,276,325,234,76
060133300002,676,471,205,693,468,225,969,677,264,703,491,170
060133300004,633,474,159,661,477,184,899,685,194,687,479,152
060133300003,385,265,120,401,266,135,562,390,163,380,261,93
060133280001,290,216,74,301,230,71,398,301,89,344,240,77
060133310002,588,379,209,609,388,221,750,491,235,647,408,191
060133310003,260,170,90,266,175,91,412,269,129,374,236,106
060133310005,519,351,168,536,373,163,682,473,189,521,345,136
060133310001,240,152,88,244,155,89,393,259,124,317,204,92
060133320005,331,206,125,344,212,132,435,277,147,371,233,114
060133320007,228,148,80,231,148,83,348,237,104,251,163,70
060133320001,806,511,295,832,517,315,1027,668,333,850,535,264
060133320006,310,209,101,319,208,111,505,341,152,388,260,103
060133320002,409,255,154,426,260,166,608,386,203,481,310,142
060133320003,448,282,166,461,291,170,668,447,205,545,347,165
060133320004,571,360,211,591,372,219,745,494,234,673,431,201
060133270012,589,383,206,621,388,233,786,519,253,602,366,195
060133280002,333,261,72,345,267,78,544,421,111,248,186,48
060133361031,362,269,93,376,272,104,533,380,134,433,321,88
060133361032,154,118,36,157,118,39,428,347,68,341,249,70
060133361041,109,84,25,111,84,27,282,230,45,211,154,43
060133361042,229,180,49,238,184,54,386,314,64,310,230,59
060133362012,247,183,64,255,184,71,334,240,84,230,170,47
060133362023,158,121,37,167,124,43,467,344,110,297,226,54
060133361011,224,181,43,232,187,45,324,260,54,310,242,49
060133361012,294,238,56,305,246,59,471,381,83,359,280,56
060133361013,137,110,27,143,115,28,266,214,46,217,170,34
060133350002,518,363,155,539,370,169,593,406,171,509,345,134
060133350003,257,191,66,265,198,67,468,338,123,360,265,74
060133371002,717,418,299,743,438,305,825,525,280,683,410,236
060133310006,357,245,112,375,267,108,621,448,158,459,315,114
060133310004,456,293,163,482,298,184,672,446,211,547,340,173
060133332005,584,413,171,603,413,190,814,577,217,660,439,166
060133332004,566,359,207,592,362,230,816,541,252,704,436,221
060133350001,607,393,214,632,387,245,804,526,262,624,381,206
060133340011,786,501,285,810,516,294,997,674,303,813,515,243
060133340012,631,409,222,649,423,226,1103,738,335,854,543,254
060133371001,762,464,298,790,475,315,1005,678,315,899,560,288
060133332001,413,265,148,433,269,164,537,361,159,453,282,146
060133332002,486,302,184,510,309,201,688,455,215,566,352,186
060133332003,538,335,203,561,344,217,693,457,217,611,379,196
060133340071,321,227,94,334,235,99,642,467,154,498,347,124
060133340072,488,350,138,506,360,146,630,464,149,502,351,116
060133340073,635,418,217,646,429,217,797,556,223,668,442,189
060133340061,427,282,145,433,281,152,664,458,191,534,349,148
060133331012,744,477,267,768,478,290,937,608,303,900,573,264
060133331013,459,304,155,474,309,165,706,466,224,552,339,183
060133132042,554,357,197,571,360,211,633,435,184,553,359,162
060133331022,370,243,127,385,246,139,561,331,216,424,269,125
060133331023,622,410,212,644,412,232,872,616,240,749,476,223
060133340081,511,383,128,524,376,148,766,563,187,615,430,135
060133340082,760,526,234,786,537,249,1082,768,289,850,582,214
060133340062,1207,826,381,1244,846,398,1581,1140,409,1187,824,302
060133373004,441,276,165,453,281,172,474,307,163,470,311,137
060133373005,380,237,143,387,242,145,505,356,134,320,216,89
060133340063,540,372,168,558,383,175,796,583,198,591,416,146
060133553092,695,456,239,721,466,255,891,599,275,852,555,245
060133362011,452,342,110,468,348,120,486,367,114,332,251,64
060133362013,145,112,33,151,114,37,181,137,41,141,109,24
060133362022,101,78,23,106,79,27,279,211,63,200,157,33
060133362021,327,243,84,336,244,92,703,509,166,514,371,118
060133372021,225,137,88,232,145,87,339,230,103,309,196,94
060133372023,258,158,100,261,164,97,457,310,138,398,256,120
060133372022,596,382,214,616,391,225,861,578,263,735,478,214
060133372011,406,278,128,412,281,131,579,397,170,355,236,95
060133372012,508,351,157,517,355,162,676,490,165,670,446,180
060133381012,280,186,94,290,191,99,410,286,115,326,207,93
060133381014,227,181,46,235,182,53,555,436,102,213,157,42
060133381022,1173,780,393,1211,797,414,1536,1077,430,1280,834,365
060133381021,430,290,140,449,303,146,625,439,173,491,334,128
060133240042,508,385,123,523,390,133,558,404,138,438,313,94
060133372024,640,434,206,656,431,225,988,697,263,770,502,219
060133382011,997,655,342,1029,656,373,1289,856,405,1083,709,322
060133382012,902,578,324,933,583,350,1112,753,327,898,569,275
060133373002,634,404,230,655,418,237,908,636,242,783,514,221
060133553093,918,562,356,934,544,390,1329,872,425,1073,648,353
060133381011,265,200,65,278,205,73,336,249,82,295,217,59
060133381013,389,302,87,400,304,96,496,375,111,589,433,118
060133373003,349,218,131,355,221,134,490,335,143,426,273,133
060133240023,703,523,180,725,537,188,980,763,194,814,574,187
060133570002,618,469,149,631,473,158,712,539,153,624,443,130
060133570003,520,393,127,534,399,135,703,540,153,574,418,116
060133570001,415,311,104,419,313,106,577,425,135,454,322,93
060133580005,222,167,55,229,169,60,333,254,73,305,225,61
060133462062,1165,552,613,1191,580,611,1299,717,556,1087,550,470
060133551221,775,457,318,798,472,326,1303,842,432,866,530,287
060133551212,862,516,346,894,549,345,1151,793,342,1119,711,355
060133452033,456,241,215,472,252,220,578,336,233,473,257,183
060133452034,965,535,430,1007,565,442,1269,776,464,1034,606,374
060133452031,1341,710,631,1396,738,658,1281,741,512,1039,568,397
060133452032,601,323,278,623,332,291,1315,781,512,1148,653,424
060133462031,1460,803,657,1519,843,676,2127,1314,758,1877,1090,682
060133462041,1265,729,536,1315,737,578,1553,1012,502,1213,704,433
060133462044,349,209,140,364,219,145,556,374,169,494,316,153
060133451143,1323,773,550,1374,800,574,940,618,301,795,494,246
060133451132,1407,781,626,1451,802,649,1857,1179,640,1577,966,522
060133452051,630,386,244,649,402,247,1060,706,328,787,483,258
060133451052,672,417,255,698,432,266,1138,780,334,935,600,268
060133451053,490,285,205,509,287,222,807,520,274,627,364,220
060133451054,600,350,250,635,365,270,930,607,297,769,466,253
060133451144,348,214,134,365,224,141,1363,943,397,818,532,240
060133451131,850,530,320,873,538,335,1022,701,310,1172,740,375
060133451055,281,176,105,291,175,116,345,222,117,303,184,101
060133451051,996,623,373,1033,630,403,1097,717,355,838,517,266
060133451141,850,501,349,893,530,363,1021,684,322,874,529,301
060133451181,1161,691,470,1209,715,494,1499,968,500,943,559,312
060133451142,804,451,353,828,457,371,1062,683,361,1066,596,422
060133462032,631,336,295,655,350,305,786,476,300,549,310,212
060133040061,921,464,457,940,465,475,2002,1003,961,1091,550,478
060133040071,549,247,302,563,239,324,815,363,436,693,281,367
060133040042,494,186,308,513,165,348,781,295,471,579,207,350
060133040032,928,329,599,959,325,634,1272,504,746,1002,372,573
060133040031,788,300,488,813,293,520,1073,451,611,887,319,539
060133040041,1097,417,680,1144,380,764,1627,619,977,1331,453,801
060133840004,517,472,45,522,476,46,606,561,44,528,465,34
060133840002,569,501,68,587,512,75,718,626,77,613,516,58
060133840003,716,655,61,729,667,62,872,793,61,775,680,47
060133840001,644,559,85,651,564,87,710,628,76,642,551,63
060133610002,779,643,136,798,655,143,752,601,135,675,542,98
060133851001,1053,901,152,1077,917,160,1142,990,129,976,826,104
060133852001,412,361,51,423,365,58,490,426,55,361,307,37
060133700003,346,302,44,349,302,47,465,409,48,436,369,45
060133860001,470,419,51,482,429,53,708,608,82,601,513,51
060133820001,286,255,31,298,273,25,345,318,24,301,278,10
060133820003,641,575,66,666,606,60,1032,946,67,879,815,24
060133830001,624,565,59,637,574,63,776,689,71,650,565,34
060133860002,385,345,40,392,351,41,676,594,66,584,509,39
060133870003,378,328,50,384,336,48,572,484,70,430,361,43
060133852002,358,316,42,369,321,48,428,374,46,362,304,35
060133851002,588,514,74,604,520,84,658,587,58,605,524,47
060133870001,456,408,48,465,408,57,505,455,43,530,463,34
060133870002,342,288,54,352,296,56,426,369,51,347,285,46
060133901001,468,415,53,477,418,59,547,491,44,506,444,34
060133901002,511,464,47,519,470,49,599,541,45,518,455,37
060133901003,417,378,39,420,380,40,450,410,35,405,357,27
060133902002,477,434,43,484,434,50,578,532,44,500,444,33
060133880002,739,678,61,756,697,59,812,739,63,721,636,46
060133891001,463,426,37,473,435,38,589,525,50,516,451,36
060133880001,604,557,47,620,577,43,814,737,63,678,597,42
060133902001,636,581,55,643,584,59,720,652,58,646,569,46
060133860003,337,307,30,347,316,31,572,513,51,394,344,26
060133830002,641,578,63,654,591,63,886,809,62,722,634,51
060133892001,187,162,25,192,170,22,313,272,37,263,231,19
060133630001,588,489,99,606,496,110,972,796,158,736,598,97
060133690021,214,183,31,221,186,35,397,324,62,316,266,35
060133602001,631,515,116,644,526,118,1005,825,160,880,691,138
060133602002,460,375,85,468,381,87,733,592,127,538,422,85
060133602003,466,383,83,473,389,84,750,608,127,689,531,116
060133610001,288,233,55,293,240,53,553,431,111,459,358,74
060133610003,602,477,125,611,479,132,1042,816,198,883,681,147
060133601011,494,396,98,509,402,107,764,607,149,634,484,115
060133601012,821,650,171,846,655,191,1122,874,227,954,723,178
060133601013,655,503,152,678,503,175,968,737,209,805,609,162
060133601021,977,758,219,997,756,241,1009,771,222,875,670,156
060133601023,342,265,77,348,262,86,472,366,96,347,261,63
060133630002,874,683,191,903,698,205,1018,804,197,813,618,142
060133630003,746,613,133,762,635,127,913,764,133,771,635,95
060133630004,400,293,107,414,298,116,667,497,154,535,385,116
060133620001,517,463,54,524,464,60,624,549,65,558,481,45
060133620002,605,551,54,613,555,58,675,613,51,528,462,39
060133620003,545,494,51,552,497,55,740,658,68,637,553,49
060133700001,656,578,78,664,586,78,789,692,80,680,579,61
060133700002,365,318,47,368,318,50,364,316,36,372,312,39
060133690022,358,304,54,357,305,52,507,434,59,392,326,37
060133690023,252,216,36,259,221,38,341,287,43,315,266,29
060133922021,379,319,60,382,324,58,680,559,102,351,302,35
060133922022,364,277,87,373,281,92,596,448,135,349,275,58
060133640021,868,704,164,903,726,177,1135,873,234,893,712,144
060133640022,423,317,106,441,327,114,647,510,132,477,374,80
060133591022,724,551,173,736,551,185,1022,782,221,867,662,168
060133640023,445,326,119,465,327,138,774,570,194,649,481,143
060133922023,526,382,144,551,390,161,774,549,209,724,526,157
060133591052,926,721,205,960,745,215,1434,1140,268,935,736,160
060133591051,989,766,223,1016,788,228,1236,980,232,1088,853,185
060133591031,456,343,113,472,348,124,634,481,140,561,426,105
060133592033,1043,803,240,1064,812,252,1446,1076,348,1049,820,188
060133592032,548,443,105,569,455,114,939,769,154,719,604,77
060133592031,893,693,200,919,711,208,1415,1096,295,1150,923,188
060133592041,338,254,84,350,263,87,504,388,111,420,329,74
060133592042,500,377,123,516,387,129,741,565,168,583,458,104
060133592043,931,699,232,967,721,246,1457,1099,348,1250,977,218
060133591032,517,391,126,529,392,137,698,520,162,603,457,116
060133591041,736,610,126,759,650,109,1166,974,177,911,769,114
060133592021,920,677,243,949,686,263,1260,951,290,999,749,220
060133923002,447,345,102,467,373,94,620,487,126,427,355,62
060133580001,471,332,139,501,346,155,761,553,185,552,399,128
060133580002,224,170,54,231,170,61,296,236,56,229,172,42
060133923001,377,292,85,393,316,77,1289,1010,270,748,621,107
060133560013,383,291,92,392,290,102,625,479,134,464,349,91
060133910001,529,469,60,535,469,66,683,615,60,634,554,46
060133920001,743,677,66,757,694,63,857,787,55,806,719,49
060133920003,408,373,35,413,377,36,490,452,32,500,452,26
060133920002,442,404,38,446,404,42,527,489,31,493,450,23
060133020112,566,323,243,576,315,261,723,378,326,616,321,256
060133480002,1141,702,439,1204,746,458,1241,923,291,1477,984,379
060133540021,1509,960,549,1567,1016,551,2019,1537,434,1773,1243,406
060133480001,407,274,133,420,286,134,466,348,109,404,286,94
060133400042,797,578,219,817,598,219,1056,809,223,943,697,196
060133400041,357,253,104,365,261,104,475,362,104,430,305,94
060133500002,551,390,161,570,404,166,767,596,161,455,339,92
060133500004,800,588,212,820,596,224,1124,888,205,968,741,176
060133530021,435,297,138,447,304,143,504,379,121,515,365,122
060133530022,805,571,234,825,591,234,777,597,156,1030,768,208
060133500001,802,627,175,822,639,183,1012,796,191,835,648,130
060133410002,956,700,256,981,708,273,1193,919,245,959,697,199
060133512001,727,514,213,747,525,222,1031,813,194,829,619,163
060133512002,1333,939,394,1389,991,398,1423,1128,266,1351,1012,263
060133512003,1433,1004,429,1478,1030,448,1821,1425,351,1625,1178,332
060133490002,1062,774,288,1089,786,303,1085,848,214,945,703,180
060133490003,563,430,133,583,435,148,755,596,143,662,492,118
060133490001,980,715,265,1014,735,279,1381,1059,284,1124,810,216
060133410003,927,702,225,947,711,236,1211,964,227,1045,785,197
060133521011,1416,933,483,1446,950,496,1948,1492,418,1635,1153,371
060133160001,365,289,76,379,298,81,581,433,129,607,455,112
060133180001,471,368,103,483,372,111,679,530,129,411,291,83
060133180002,474,349,125,484,362,122,487,360,115,511,351,122
060133180003,599,439,160,614,448,166,833,593,225,552,368,146
060133170001,533,399,134,545,399,146,650,475,163,484,346,105
060133190021,456,328,128,476,335,141,533,376,145,423,289,97
060133190024,246,163,83,251,165,86,383,252,123,279,166,87
060133190022,328,235,93,337,236,101,461,325,127,366,239,94
060133190023,721,469,252,739,474,265,894,591,282,1002,625,308
060133190011,562,393,169,577,402,175,855,583,252,752,487,209
060133190012,791,506,285,812,518,294,1152,728,387,838,522,259
060133200031,1331,888,443,1363,895,468,1864,1268,550,1255,822,351
060133200044,1231,787,444,1275,796,479,1526,1018,456,1418,874,441
060133200043,674,454,220,696,461,235,1008,705,274,678,438,184
060133200041,218,128,90,228,123,105,339,206,127,216,133,71
060133211011,846,583,263,865,600,265,1143,792,320,896,602,237
060133212001,633,426,207,655,439,216,901,607,269,734,471,216
060133211012,634,409,225,659,412,247,1008,678,301,836,529,248
060133211013,827,553,274,838,555,283,1367,915,408,963,617,283
060133211014,670,423,247,684,422,262,1019,690,302,612,392,179
060133211023,916,622,294,941,628,313,1327,935,372,1210,816,324
060133211033,343,214,129,354,205,149,294,183,101,509,307,175
060133211021,718,497,221,742,496,246,716,516,181,581,395,146
060133211024,1139,826,313,1163,834,329,1407,1026,346,1063,738,254
060133200042,508,376,132,520,379,141,786,565,199,782,525,194
060133200011,637,420,217,668,427,241,781,474,278,647,413,189
060133170002,379,297,82,393,291,102,564,414,132,516,357,114
060133200012,666,419,247,689,419,270,1026,644,356,927,559,306
060133211022,1017,677,340,1056,688,368,1385,986,368,1241,851,312
060133500003,911,654,257,941,663,278,1086,841,214,951,686,200
060133522011,1067,774,293,1096,785,311,1370,1031,312,1159,816,272
060133522012,783,512,271,797,514,283,996,761,217,764,531,184
060133522013,1322,934,388,1347,955,392,1514,1197,286,1346,996,274
060133521023,1005,680,325,1027,688,339,1092,833,237,944,668,211
060133521022,533,341,192,550,348,202,663,492,152,561,384,133
060133521024,483,306,177,499,312,187,588,425,146,500,340,123
060133521021,808,529,279,834,545,289,1022,763,237,849,586,212
060133451151,1114,652,462,1150,675,475,1509,1017,460,1131,709,361
060133452061,493,299,194,508,302,206,701,467,228,558,350,171
060133650021,337,295,42,349,311,38,579,487,77,407,369,22
060133650022,165,154,11,174,161,13,286,254,20,200,184,8
060133650023,210,185,25,223,195,28,384,336,41,368,338,22
060133780001,869,768,101,891,785,106,1078,966,98,909,780,76
060133922011,416,352,64,428,361,67,574,487,79,566,495,53
060133020051,460,253,207,468,256,212,786,467,296,622,370,210
060133020062,824,471,353,856,467,389,1225,696,497,875,472,333
060133020131,816,446,370,847,452,395,1387,731,629,1009,549,404
060133020052,430,257,173,445,254,191,672,372,281,555,322,192
060133020061,413,238,175,426,229,197,715,406,290,570,313,225
060133020111,796,555,241,819,549,270,1938,1311,582,921,608,271
060133020053,510,307,203,517,295,222,852,515,319,616,371,203
060133020054,353,214,139,364,213,151,644,373,244,560,333,191
060133020072,551,343,208,561,339,222,1006,615,366,824,504,269
060133020142,907,463,444,923,447,476,1501,733,726,1049,512,459
060133020073,486,254,232,493,243,250,775,393,364,573,316,223
060133020122,550,342,208,566,336,230,1187,766,393,724,425,248
060133020121,661,387,274,685,391,294,919,512,379,622,358,216
060133020143,527,266,261,540,248,292,849,486,348,617,296,275
060133020071,901,534,367,920,536,384,1517,918,574,1087,615,408
060133530011,794,567,227,816,586,230,1042,823,201,873,646,165
060133530023,708,510,198,725,525,200,956,764,178,669,511,126
060133540023,1031,684,347,1055,705,350,1241,945,273,950,687,208
060133540024,1038,694,344,1063,710,353,1325,980,327,1112,785,269
060133530024,418,288,130,430,291,139,508,393,98,407,302,86
060133540022,453,302,151,465,315,150,326,251,70,439,321,94
060133212002,339,243,96,351,249,102,625,458,151,503,345,125
060133212004,488,359,129,502,367,135,762,533,210,605,427,136
060133591023,665,546,119,688,554,134,988,794,175,760,612,113
060133591021,395,290,105,408,301,107,595,447,136,424,308,93
060133591033,490,380,110,503,385,118,760,591,159,570,444,99
060133591034,460,367,93,477,374,103,611,491,110,530,416,86
060133592023,741,542,199,760,534,226,1227,922,293,1073,789,237
060133601022,783,629,154,808,632,176,1135,935,184,976,795,145
060133212003,227,162,65,238,165,73,439,311,112,338,236,79
060133220001,242,172,70,253,173,80,320,221,88,210,146,49
060133220002,291,203,88,301,204,97,353,241,103,241,170,56
060133220003,1144,786,358,1189,798,391,1082,769,287,872,597,215
060133220004,904,623,281,938,638,300,1289,925,334,1067,719,268
060133260002,611,412,199,630,418,212,847,609,215,756,491,205
060133230004,461,313,148,474,317,157,686,490,186,542,372,136
060133230002,531,358,173,546,358,188,699,490,193,611,401,164
060133230003,710,516,194,726,512,214,824,599,200,704,494,163
060133240021,887,664,223,907,668,239,1201,900,265,1001,729,202
060133250004,605,431,174,622,434,188,698,530,160,603,440,129
060133250003,884,649,235,916,666,250,1167,883,259,998,717,211
060133250002,255,190,65,265,195,70,448,333,105,361,256,79
060133250005,408,288,120,419,291,128,526,399,119,442,321,94
060133250001,486,355,131,497,362,135,692,524,154,568,412,117
060133400011,368,272,96,382,271,111,480,354,116,407,290,88
060133230001,498,359,139,521,371,150,699,523,158,570,396,118
060133240022,438,326,112,454,329,125,646,488,147,565,400,121
060133220005,356,264,92,365,269,96,508,345,147,351,249,79
060133240041,248,181,67,254,181,73,398,280,102,272,194,60
060133240043,266,199,67,274,201,73,419,302,105,342,247,74
060133240033,98,74,24,101,74,27,420,310,100,317,229,66
060133552021,856,619,237,876,635,241,363,266,89,452,336,95
060133552013,649,480,169,670,499,171,1128,817,296,809,577,193
060133552011,477,350,127,491,351,140,1340,934,379,844,625,180
060133552012,694,521,173,713,542,171,1479,1132,331,1244,949,248
060133132032,409,293,116,416,290,126,1172,857,285,580,425,120
060133132051,496,358,138,505,349,156,674,481,174,996,741,209
060133131053,333,277,56,343,292,51,627,513,107,379,322,44
060133120001,564,487,77,568,484,84,1058,900,137,702,604,70
060133132061,349,284,65,355,284,71,529,426,97,413,342,53
060133132064,261,214,47,268,215,53,449,361,78,362,301,44
060133132062,197,162,35,206,166,40,443,359,77,291,240,36
060133132063,385,311,74,396,309,87,624,492,119,451,363,68
060133132043,430,322,108,446,325,121,800,584,193,644,470,140
060133132041,498,400,98,513,397,116,810,624,170,601,462,111
060133131051,589,439,150,596,435,161,898,661,214,705,510,158
060133131041,428,311,117,443,314,129,643,469,159,538,397,120
060133131042,260,189,71,271,192,79,396,295,94,264,197,58
060133131052,438,317,121,455,326,129,548,406,137,551,406,121
060133131072,571,405,166,590,406,184,955,681,255,533,379,128
060133131061,893,668,225,919,680,239,1424,1069,327,1003,754,194
060133131071,372,269,103,386,277,109,687,505,167,565,422,113
060133131022,489,366,123,495,367,128,877,654,211,810,605,168
060133100003,341,289,52,352,290,62,554,461,83,553,456,58
060133110003,397,315,82,413,324,89,778,587,170,489,407,65
060133110002,339,284,55,352,281,71,615,491,108,503,415,72
060133100002,204,167,37,208,170,38,383,312,67,276,225,39
060133110001,206,168,38,209,169,40,412,325,79,251,195,42
060133090002,291,242,49,299,250,49,426,348,70,312,259,37
060133100001,331,290,41,334,284,50,485,393,73,369,300,47
060133090003,408,335,73,421,344,77,541,432,93,321,258,50
060133100004,273,215,58,282,224,58,442,359,75,358,295,47
060133090001,536,432,104,555,448,107,666,539,117,819,660,125
060133141023,491,376,115,505,391,114,786,615,161,590,467,103
060133780002,1185,1011,174,1203,1013,190,1445,1243,171,1176,966,140
060133800021,386,347,39,393,356,37,923,833,82,478,434,25
060133800012,943,839,104,960,849,111,810,713,82,828,711,67
060133800011,877,781,96,894,792,102,1374,1211,140,982,842,82
060133820004,521,462,59,535,481,54,642,547,73,481,429,26
060133820002,527,469,58,553,503,50,894,816,62,803,742,27
060133810004,562,511,51,575,529,46,801,724,57,746,697,28
060133810001,348,314,34,363,327,36,587,522,44,494,455,24
060133810002,389,353,36,408,367,41,642,578,56,447,413,19
060133790001,335,301,34,349,318,31,475,429,41,348,330,9
060133800022,236,212,24,243,223,20,475,430,36,419,393,12
060133790002,279,254,25,288,262,26,463,428,30,357,340,7
060133790003,304,276,28,320,291,29,474,441,25,372,356,8
060133770004,354,317,37,369,332,37,621,549,65,449,399,25
060133790004,326,295,31,341,313,28,535,477,46,477,435,17
060133770005,413,367,46,426,384,42,535,460,60,381,328,27
060133770002,139,126,13,144,132,12,247,219,25,227,205,12
060133770003,209,188,21,213,196,17,271,240,25,217,202,7
060133760003,184,165,19,187,172,15,296,259,28,209,192,9
060133770001,174,157,17,178,161,17,255,223,28,252,229,15
060133810003,277,248,29,287,259,28,362,316,42,292,260,17
060133750002,123,112,11,125,113,12,277,251,24,218,194,11
060133750003,129,113,16,129,111,18,244,210,26,150,135,7
060133710003,335,294,41,346,299,47,438,375,47,363,309,38
060133710004,295,261,34,303,268,35,497,440,49,363,315,36
060133710005,261,233,28,265,237,28,425,377,43,321,282,28
060133710006,318,284,34,327,288,39,390,341,39,319,279,27
060133740001,425,381,44,433,387,46,496,441,44,385,336,29
060133740002,357,320,37,364,329,35,572,514,55,428,382,28
060133690011,301,259,42,309,271,38,523,445,68,427,377,32
060133710001,267,229,38,273,229,44,392,324,61,323,275,30
060133710002,220,190,30,225,189,36,297,242,46,246,209,25
060133720003,289,247,42,293,246,47,423,346,69,348,295,38
060133720002,282,239,43,287,238,49,537,457,71,407,350,40
060133720004,302,262,40,310,263,47,426,365,53,295,250,30
060133680013,182,165,17,189,167,22,288,252,36,214,193,12
060133720006,286,251,35,295,250,45,399,344,41,313,265,26
060133690013,210,183,27,218,184,34,368,302,59,321,275,27
060133690015,179,154,25,184,158,26,260,220,38,163,142,12
060133720007,212,186,26,221,186,35,287,244,39,202,182,16
060133720005,246,220,26,255,222,33,337,296,38,314,273,24
060133740004,368,329,39,380,338,42,558,496,48,487,420,34
060133730002,251,227,24,259,235,24,348,317,31,275,249,20
060133730003,181,166,15,188,171,17,408,355,38,309,277,20
060133760001,211,189,22,224,203,21,377,338,32,263,246,9
060133760002,254,225,29,266,240,26,622,555,53,463,426,19
060133760004,183,164,19,189,176,13,336,300,25,274,256,9
060139800001,39,33,6,41,34,7,8,3,4,8,7,1
060133922013,617,511,106,637,522,115,1210,946,248,792,673,89
060133650031,640,577,63,655,594,61,902,784,105,740,677,37
060133671004,388,349,39,410,366,44,596,521,64,372,333,20
060133650033,117,105,12,121,110,11,257,223,31,103,90,7
060133922012,202,182,20,209,191,18,322,278,39,294,262,19
060133671001,482,443,39,502,459,43,774,685,73,674,615,36
060133672001,408,350,58,408,349,59,675,562,100,558,475,57
060133740003,277,248,29,290,262,28,389,345,38,311,274,19
060133750001,209,186,23,217,184,33,397,342,46,275,247,17
060133720001,208,174,34,212,175,37,404,341,55,336,281,35
060133730001,370,329,41,381,325,56,579,508,63,418,368,30
060133671003,351,309,42,362,328,34,584,540,41,489,435,25
060133672002,541,464,77,559,485,74,909,748,142,609,521,61
060133650032,133,121,12,137,123,14,404,353,43,349,310,23
060133650034,260,237,23,269,242,27,443,388,48,390,347,26
060133671002,288,261,27,300,268,32,475,423,46,299,267,16
060133560011,351,254,97,358,259,99,598,438,153,482,346,113
060133560012,612,468,144,623,461,162,958,735,213,734,555,149
060133580003,295,206,89,313,214,99,497,359,124,399,286,95
060133580004,305,230,75,313,231,82,501,391,100,370,275,73
060133672003,193,162,31,193,161,32,368,305,59,269,223,32
060133410001,882,661,221,901,673,228,1064,838,210,945,690,196
060133342004,481,351,130,491,357,134,692,547,132,615,462,117
060133342005,423,315,108,433,318,115,544,440,94,476,364,86
060133400043,1011,739,272,1034,751,283,1161,893,241,1024,746,217
060133511043,405,296,109,414,300,114,441,344,93,386,272,99
060133511051,571,406,165,589,419,170,674,526,144,653,456,171
060133383023,1192,867,325,1207,878,329,1500,1148,325,1260,921,271
060133430022,794,531,263,817,542,275,1129,801,305,955,661,245
060133430021,997,717,280,1030,751,279,1209,933,262,929,660,218
060133430023,390,259,131,403,267,136,437,310,118,383,256,106
060133680011,149,135,14,151,135,16,222,193,25,166,147,8
060133680012,410,375,35,419,382,37,451,396,46,346,312,18
060133680014,189,170,19,193,173,20,331,289,41,245,226,15
060133680021,204,178,26,204,175,29,597,501,82,339,301,22
060133680022,136,119,17,138,117,21,401,335,57,308,273,18
060133690014,275,238,37,286,246,40,331,278,44,349,299,33
060133690012,301,259,42,314,274,40,456,395,56,400,347,36
060133660011,315,263,52,319,266,53,498,403,86,361,304,42
060133660012,610,522,88,624,529,95,990,806,167,712,618,65
060133660023,521,451,70,534,453,81,914,758,140,731,645,59
060133660022,372,325,47,378,323,55,617,515,92,465,410,38
060133660021,213,190,23,216,185,31,385,323,53,256,228,20
060133452062,1008,654,354,1058,687,371,1322,921,370,1125,719,335
060133452052,576,389,187,602,410,192,1046,745,276,765,509,210
060133452053,449,307,142,469,328,141,886,660,212,546,365,146
060133451152,753,459,294,773,459,314,1017,674,326,861,523,290
060133451161,597,368,229,622,385,237,896,619,261,791,498,243
060133451162,718,432,286,741,444,297,890,579,290,715,439,221
060133451153,720,451,269,745,458,287,1190,798,368,888,561,271
060133451173,782,486,296,812,501,311,716,470,236,828,529,243
060133451122,518,349,169,530,354,176,969,663,294,661,442,189
060133551213,469,329,140,482,339,143,1024,759,248,551,407,123
060133451182,627,419,208,641,426,215,934,637,279,476,312,135
060133451172,454,303,151,463,304,159,598,429,162,801,521,239
060133451124,1567,1070,497,1624,1101,523,1521,1092,390,1434,1037,327
060133451021,508,310,198,523,319,204,751,490,244,568,348,188
060133451022,800,450,350,824,467,357,1009,636,342,983,588,327
060133451023,487,296,191,504,304,200,733,471,246,566,343,189
060133451111,615,373,242,641,388,253,859,559,283,751,460,247
060133451113,442,252,190,463,260,203,462,296,151,346,206,117
060133451121,541,362,179,562,382,180,978,728,235,542,368,152
060133451033,1090,632,458,1125,655,470,1498,951,521,1263,766,421
060133451013,477,271,206,497,276,221,609,379,214,515,304,182
060133451032,539,307,232,561,311,250,705,439,248,595,357,210
060133451011,356,220,136,366,224,142,533,354,169,410,257,126
060133451012,953,588,365,980,597,383,1231,824,384,983,614,304
060133451031,526,336,190,550,353,197,679,469,196,558,365,163
060133451123,489,313,176,514,330,184,985,693,277,609,397,178
060133451034,258,162,96,265,169,96,351,240,105,224,143,70
060133451171,377,260,117,384,260,124,608,463,135,524,376,128
060133551261,373,268,105,385,280,105,1999,1456,504,307,227,71
060133551262,724,539,185,743,551,192,837,637,180,773,595,148
060133551251,382,274,108,394,288,106,1297,1020,249,975,736,206
060133551242,647,467,180,665,486,179,931,722,190,694,529,134
060133551231,396,289,107,408,303,105,783,593,177,401,307,75
060133551232,352,254,98,365,269,96,579,438,132,343,271,62
060133551241,310,238,72,322,243,79,600,487,105,605,476,108
060133551153,1003,764,239,1030,771,259,1847,1412,407,568,438,105
060133551151,487,357,130,502,371,131,701,508,184,607,461,119
060133451114,259,176,83,269,186,83,321,232,86,340,224,93
060133451112,224,152,72,233,161,72,617,442,164,369,243,102
060133551211,768,564,204,804,589,215,1354,1046,290,938,726,180
060133551252,104,78,26,109,82,27,343,271,66,249,193,47
060133551152,172,129,43,174,128,46,969,757,204,339,264,61
060133551243,233,153,80,237,164,73,681,484,180,359,273,72
060133382034,467,358,109,480,364,116,538,421,105,529,392,98
060133382035,461,352,109,474,359,115,583,450,120,527,391,100
060133382033,404,294,110,406,294,112,549,421,117,430,318,83
060133382041,740,542,198,763,558,205,1089,821,250,851,614,196
060133240031,372,285,87,381,289,92,428,316,99,337,245,70
060133240032,346,266,80,356,270,86,592,461,123,372,271,77
060133382031,381,298,83,391,304,87,542,448,80,529,395,89
060133382032,293,203,90,299,211,88,450,324,117,325,231,71
060133511031,684,479,205,711,493,218,814,615,194,612,427,169
060133511032,827,569,258,856,586,270,1066,802,256,984,676,280
060133400014,697,502,195,725,510,215,949,708,223,772,546,177
060133400032,382,272,110,392,271,121,495,369,114,409,281,99
060133511013,1052,695,357,1083,730,353,1320,996,316,1190,817,338
060133511011,619,439,180,639,459,180,453,347,103,452,327,110
060133511012,638,451,187,658,472,186,733,562,166,597,431,144
060133430031,1331,880,451,1391,908,483,1936,1376,517,1662,1119,455
060133390013,448,324,124,463,337,126,541,404,124,388,286,79
060133390031,674,488,186,696,506,190,1110,843,251,822,601,169
060133390041,861,644,217,878,660,218,1405,1033,345,897,651,200
060133382042,491,350,141,501,360,141,635,470,161,533,382,116
060133430011,658,428,230,687,444,243,740,522,209,658,444,175
060133430013,697,526,171,723,547,176,1034,785,230,951,691,203
060133430014,564,417,147,587,434,153,781,583,187,728,521,159
060133383021,1254,744,510,1317,778,539,1546,1067,455,1316,860,391
060133400012,828,584,244,862,603,259,1130,838,271,988,708,215
060133400013,636,460,176,665,464,201,790,569,208,659,470,151
060133382044,722,501,221,738,510,228,1049,783,248,908,641,215
060133373006,551,349,202,569,357,212,722,527,178,637,398,202
060133373001,728,508,220,754,522,232,902,677,199,780,529,196
060133511041,489,358,131,498,363,135,517,403,108,514,363,133
060133511052,651,462,189,671,482,189,832,644,183,705,502,174
060133511042,544,389,155,559,410,149,644,495,146,565,412,129
060133390011,226,183,43,233,189,44,366,288,67,287,220,47
060133390012,425,343,82,440,356,84,657,518,121,548,418,91
060133430012,386,272,114,396,287,109,578,433,136,468,333,103
060133390032,530,420,110,540,426,114,849,669,164,670,529,95
060133430032,828,541,287,857,558,299,1082,773,285,946,645,237
060133383011,987,620,367,1024,634,390,1249,861,353,1018,643,298
060133553022,507,316,191,521,323,198,707,494,204,570,368,170
060133390042,355,262,93,363,268,95,507,381,116,472,340,109
060133553021,540,333,207,545,335,210,738,498,229,627,392,203
060133383012,622,404,218,636,401,235,789,560,216,709,460,217
060133382043,546,403,143,559,401,158,800,621,165,679,494,148
060490004001,244,89,155,247,82,165,339,115,219,359,103,228
060490003002,423,109,314,424,101,323,430,103,323,299,73,221
060490004002,181,58,123,181,53,128,303,95,202,316,87,216
060490003003,350,90,260,351,82,269,604,156,435,471,108,338
060490001001,581,111,470,590,104,486,402,95,299,330,62,253
060490001004,339,94,245,344,91,253,468,122,335,370,98,252
060490001002,297,87,210,301,78,223,331,103,221,225,57,156
060490001003,194,72,122,194,72,122,309,110,191,324,94,209
060490003001,182,52,130,185,49,136,409,85,317,341,67,260
060490002002,386,75,311,388,67,321,412,90,317,407,77,315
060490002001,241,48,193,243,41,202,331,76,250,316,51,248
060890115012,775,224,551,780,213,567,983,298,670,718,188,498
060890115022,502,123,379,512,111,401,630,168,448,611,142,429
060890119001,712,163,549,723,157,566,859,212,633,738,160,542
060890121011,365,117,248,364,111,253,509,157,339,485,137,312
060890121012,586,201,385,596,183,413,688,213,457,550,155,353
060890121021,335,83,252,339,80,259,400,109,285,355,84,256
060890121022,255,84,171,261,77,184,577,173,387,418,113,273
060890120001,302,83,219,305,72,233,316,95,214,342,83,236
060890120002,358,132,226,358,118,240,668,201,454,443,120,288
060890121013,566,157,409,574,137,437,838,264,553,688,174,461
060890123011,512,161,351,518,154,364,648,194,441,577,175,374
060890120003,213,75,138,216,68,148,381,116,258,256,74,163
060890120004,571,176,395,575,155,420,769,223,525,456,121,302
060890114011,659,208,451,662,192,470,834,260,549,720,197,474
060890114012,582,171,411,596,160,436,753,249,484,626,165,430
060890114022,613,187,426,619,171,448,811,277,518,773,210,514
060890114031,694,194,500,705,182,523,864,250,592,673,149,480
060890114032,511,163,348,515,149,366,792,258,512,638,178,418
060890126062,668,248,420,671,235,436,758,298,444,730,240,402
060890126051,961,240,721,966,227,739,1288,333,928,1116,272,779
060890126041,362,109,253,366,102,264,470,148,315,443,118,300
060890126042,484,112,372,495,106,389,927,222,687,813,186,592
060890122001,693,159,534,696,144,552,872,202,651,758,154,572
060890123021,374,101,273,380,88,292,446,110,327,384,88,273
060890123032,611,143,468,620,133,487,866,205,640,787,165,585
060890118022,928,239,689,932,213,719,1005,260,730,1003,225,733
060890118031,350,97,253,354,88,266,563,155,398,433,113,298
060890118032,459,130,329,465,119,346,601,179,410,516,125,360
060890118033,370,113,257,375,102,273,472,138,326,370,101,251
060890126061,920,306,614,928,290,638,1053,309,723,797,196,545
060890118011,754,190,564,758,178,580,893,227,653,786,181,570
060890118012,495,119,376,498,116,382,618,152,454,510,117,368
060890115021,717,187,530,728,168,560,961,266,679,818,193,581
060890115011,561,132,429,566,125,441,716,179,526,579,125,422
060890119004,574,140,434,576,125,451,732,185,531,618,146,449
060890126034,334,92,242,336,84,252,561,164,382,491,116,344
060890110024,667,222,445,675,212,463,1017,337,657,693,203,444
060890123012,305,90,215,310,87,223,465,132,319,392,114,251
060890101002,226,100,126,233,98,135,319,137,173,277,107,148
060890104001,266,119,147,266,115,151,448,191,246,380,137,211
060890104002,431,189,242,438,186,252,595,253,323,463,166,256
060890110012,455,135,320,461,132,329,591,194,384,488,132,318
060890126031,540,184,356,545,162,383,550,192,351,480,149,303
060890126033,377,116,261,377,101,276,563,179,378,585,167,389
060890104003,269,93,176,276,87,189,301,111,180,354,107,226
060890104004,515,177,338,527,167,360,450,169,272,565,172,361
060890111001,838,260,578,850,245,605,1019,338,654,836,236,548
060890111002,686,208,478,700,194,506,1256,404,818,783,219,515
060890107021,908,354,554,923,338,585,1067,421,616,927,333,539
060890107022,911,338,573,915,313,602,888,335,530,981,335,588
060890108061,736,225,511,750,213,537,993,321,647,878,259,576
060890116002,605,174,431,615,155,460,924,249,655,782,199,539
060890116003,288,89,199,289,81,208,494,155,325,526,152,340
060890127011,573,141,432,584,137,447,600,172,416,522,132,364
060890127012,282,72,210,285,71,214,359,103,247,350,91,238
060890127013,406,104,302,411,100,311,596,172,409,495,127,340
060890125001,358,156,202,356,140,216,365,158,203,306,126,164
060890106011,602,231,371,613,220,393,713,273,423,626,213,365
060890106024,709,264,445,722,250,472,915,341,552,839,304,472
060890106031,351,131,220,356,123,233,197,72,124,275,93,164
060890106032,361,131,230,364,121,243,436,158,267,482,161,285
060890110011,418,131,287,427,127,300,501,172,320,421,120,275
060890110021,540,175,365,548,168,380,633,209,406,592,177,368
060890124003,785,248,537,798,241,557,968,330,623,994,308,625
060890124001,399,154,245,409,147,262,652,251,387,634,220,367
060890123022,417,108,309,425,96,329,509,127,371,444,101,317
060890123023,631,169,462,631,146,485,944,255,669,865,206,614
060890123024,816,215,601,826,197,629,915,243,655,899,209,642
060890124002,402,108,294,403,101,302,489,142,340,479,127,323
060890108041,541,155,386,553,151,402,554,168,376,535,154,350
060890108051,401,107,294,406,103,303,560,143,405,481,113,341
060890108052,710,213,497,721,191,530,966,331,615,851,225,566
060890108071,1162,286,876,1182,268,914,1366,376,971,1286,302,926
060890118021,450,115,335,455,103,352,572,144,419,570,130,403
060890119002,544,131,413,550,126,424,904,230,658,723,163,528
060890122002,308,80,228,313,71,242,444,102,335,328,70,241
060890122003,490,108,382,497,105,392,714,169,531,632,133,468
060890122004,412,113,299,416,102,314,786,187,588,610,147,432
060890123031,908,187,721,927,182,745,1176,275,880,1018,211,771
060890110022,493,170,323,498,162,336,632,232,387,571,184,348
060890110023,308,104,204,311,98,213,565,191,360,533,166,327
060890127021,479,122,357,480,112,368,379,115,258,327,85,226
060890127022,325,82,243,328,76,252,694,206,474,644,166,432
060890127023,339,82,257,341,75,266,489,129,349,434,102,303
060890125002,317,123,194,318,115,203,465,164,287,411,132,259
060890108031,1015,310,705,1030,291,739,1045,342,681,993,269,655
060890108032,253,83,170,258,75,183,512,166,330,419,119,267
060890108053,859,248,611,873,232,641,1178,385,759,957,248,653
060890103002,658,237,421,668,217,451,1038,386,631,859,270,525
060890108042,601,199,402,609,181,428,799,281,503,595,187,377
060890109001,621,213,408,628,204,424,855,304,523,703,230,427
060890109002,669,206,463,681,181,500,998,325,652,849,226,567
060890113001,282,108,174,291,102,189,446,170,265,338,103,207
060890113002,294,110,184,298,102,196,455,167,270,465,138,293
060890103001,551,196,355,555,183,372,747,279,453,644,190,404
060890112091,452,165,287,466,162,304,609,231,357,514,167,307
060890112092,382,129,253,388,121,267,615,218,372,396,119,237
060890112094,213,72,141,217,67,150,486,173,296,306,92,183
060890113003,429,134,295,433,128,305,550,177,358,531,141,346
060890112093,412,150,262,423,147,276,630,237,371,452,146,274
060890114013,513,148,365,521,137,384,673,223,436,551,145,381
060890113004,397,118,279,406,118,288,546,172,359,462,124,301
060890117011,177,62,115,181,57,124,310,105,199,244,72,157
060890107031,568,199,369,579,198,381,814,292,507,579,183,363
060890107032,622,236,386,634,222,412,881,313,551,889,279,537
060890127014,188,45,143,187,43,144,310,90,213,300,72,205
060890119003,652,145,507,657,139,518,709,182,513,553,125,400
060890106023,819,322,497,831,304,527,928,387,513,886,321,500
060890101001,227,102,125,231,97,134,449,198,233,311,130,159
060890102002,441,197,244,451,188,263,533,232,280,421,170,218
060890102001,370,166,204,376,155,221,509,224,271,428,175,224
060890106021,390,173,217,395,171,224,612,282,314,443,179,227
060890106022,516,198,318,525,202,323,638,294,329,597,232,323
060890105002,602,250,352,607,234,373,777,354,400,584,226,312
060890105003,442,201,241,448,194,254,810,349,442,555,210,299
060890106012,621,247,374,634,237,397,596,263,315,652,235,368
060890105001,500,242,258,507,233,274,719,334,365,474,195,231
060890108033,705,212,493,711,199,512,1365,444,895,898,244,596
060890108072,1240,312,928,1263,290,973,1428,396,1010,1158,272,832
060890107042,324,108,216,328,101,227,651,226,406,497,155,309
060890107043,574,192,382,583,182,401,933,326,577,724,231,450
060890107041,514,173,341,521,167,354,586,211,363,460,152,285
060890108062,357,131,226,358,130,228,515,183,315,409,130,244
060890126032,869,262,607,874,237,637,918,292,606,638,168,433
060890114021,904,263,641,917,246,671,1147,364,760,1040,273,712
060890116001,579,188,391,586,171,415,438,151,279,453,139,291
060890117012,558,166,392,565,156,409,961,320,613,821,233,535
060890117031,310,115,195,311,106,205,480,165,304,340,98,217
060890117032,260,76,184,262,69,193,460,160,293,411,103,269
060890117033,267,91,176,271,80,191,508,173,323,456,130,296
060890117021,225,91,134,231,87,144,432,150,274,327,98,197
060890117022,451,164,287,461,151,310,669,225,422,568,174,351
060890117023,315,126,189,319,118,201,512,172,332,354,112,211
060310004023,684,238,446,690,237,453,987,378,582,759,262,463
060310004073,619,223,396,622,222,400,798,322,448,661,241,367
060310004072,474,195,279,482,190,292,635,277,340,483,169,287
060310004071,769,297,472,783,301,482,1135,426,683,798,294,452
060310004054,434,226,208,436,217,219,611,321,265,423,204,184
060310004051,441,191,250,442,183,259,712,270,421,481,173,271
060310004053,173,92,81,178,89,89,462,243,201,320,157,136
060310004022,627,234,393,631,229,402,943,347,573,685,243,403
060310004052,247,94,153,248,93,155,380,171,198,325,120,181
060310016011,132,95,37,133,90,43,189,113,74,160,100,56
060310016012,212,112,100,213,115,98,388,183,196,332,133,173
060310016013,161,112,49,160,101,59,229,134,91,198,138,51
060310002002,269,50,219,273,55,218,309,67,240,326,69,247
060319800001,165,77,88,166,75,91,477,213,231,311,126,136
060310004021,358,100,258,362,97,265,536,129,395,362,97,257
060310012001,403,92,311,411,91,320,440,129,305,430,103,319
060310011001,246,114,132,250,116,134,299,168,121,279,149,114
060310012002,329,81,248,334,81,253,340,79,256,405,92,300
060310013002,338,163,175,340,159,181,573,325,230,405,215,165
060310015001,437,230,207,441,218,223,434,253,172,492,250,209
060310017031,262,188,74,266,170,96,236,157,65,215,168,33
060310011004,154,107,47,159,102,57,233,157,64,197,140,42
060310006031,806,326,480,811,326,485,1403,493,871,779,281,449
060310001003,589,97,492,606,98,508,638,185,448,573,88,457
060310006042,1013,351,662,1029,350,679,1357,490,842,1045,321,654
060310006022,678,232,446,685,231,454,856,308,528,649,231,387
060310002001,458,76,382,470,85,385,507,103,395,485,89,384
060310005001,317,75,242,323,66,257,439,142,289,373,80,269
060310004031,384,142,242,388,141,247,624,249,362,448,158,259
060310004062,335,144,191,332,135,197,473,209,259,386,141,217
060310004032,627,230,397,634,234,400,865,329,513,622,227,355
060310006043,748,275,473,760,265,495,979,344,609,697,259,402
060310009022,111,48,63,111,45,66,161,87,74,119,54,59
060310009023,104,44,60,105,42,63,153,81,72,122,50,59
060310009021,263,175,88,263,159,104,515,268,241,316,168,116
060310011002,287,192,95,293,181,112,504,258,225,324,222,80
060310011003,218,157,61,217,147,70,371,242,119,277,206,56
060310010013,798,307,491,806,285,521,860,423,409,533,192,307
060310010021,114,80,34,113,77,36,283,139,134,207,118,70
060310010023,192,134,58,193,128,65,453,225,217,307,179,106
060310010022,239,158,81,241,144,97,543,269,264,292,165,99
060310005004,271,138,133,273,136,137,401,192,199,381,159,200
060310005002,185,85,100,186,83,103,219,109,107,182,61,111
060310005003,425,224,201,434,222,212,744,368,357,510,299,178
060310010031,507,286,221,509,272,237,777,402,354,517,268,226
060310009012,224,98,126,225,98,127,290,121,162,267,100,151
060310009013,211,92,119,212,91,121,296,149,141,232,92,129
060310007011,771,232,539,779,229,550,1001,325,659,849,224,578
060310008004,161,68,93,160,66,94,223,109,113,175,71,99
060310008002,460,263,197,465,255,210,822,357,439,661,305,323
060310007014,458,132,326,458,137,321,466,195,256,507,159,320
060310008003,208,74,134,209,63,146,274,128,138,229,85,128
060310001001,301,55,246,307,57,250,343,56,285,340,66,265
060310001002,376,67,309,375,63,312,480,86,387,425,66,344
060310007021,636,235,401,644,234,410,764,317,424,654,213,401
060310007022,687,261,426,697,260,437,980,414,546,551,235,282
060310009014,285,149,136,284,146,138,574,263,286,502,213,256
060310008001,217,116,101,223,106,117,305,129,170,322,127,165
060310014011,277,187,90,282,179,103,465,255,189,356,224,107
060310014012,161,107,54,160,102,58,216,126,86,186,134,47
060310014021,133,89,44,129,84,45,200,115,85,160,95,64
060310014022,173,113,60,173,108,65,284,169,115,226,140,68
060310015003,158,107,51,156,100,56,223,124,99,160,92,64
060310015004,143,99,44,151,95,56,219,122,97,199,110,77
060310013001,246,168,78,246,156,90,396,230,155,302,212,73
060310015002,165,112,53,163,104,59,235,136,93,187,134,47
060310017021,295,218,77,294,196,98,404,247,145,322,210,86
060310017022,242,181,61,241,164,77,257,169,88,274,203,70
060310017032,157,118,39,157,106,51,143,96,40,186,133,39
060310006024,458,127,331,466,129,337,616,208,396,616,187,403
060310006041,649,261,388,656,261,395,1002,402,570,815,286,473
060310004061,360,155,205,363,150,213,612,264,333,429,173,232
060310004033,172,63,109,176,66,110,352,134,207,277,102,157
060310010011,344,119,225,347,122,225,575,213,351,398,133,242
060310010012,391,134,257,394,138,256,636,277,345,545,189,322
060310009011,164,77,87,164,84,80,233,114,115,358,118,221
060310010032,359,210,149,365,201,164,487,288,190,384,253,105
060310010033,404,235,169,411,227,184,703,346,337,360,216,116
060310006021,557,167,390,568,167,401,756,266,475,637,201,406
060310006023,491,149,342,494,148,346,591,204,366,494,154,313
060310007012,587,202,385,595,202,393,897,304,575,614,193,382
060310007013,257,99,158,259,98,161,493,168,318,276,96,162
060379108041,1535,442,1093,1557,427,1130,2068,601,1430,1669,438,1177
060379108151,835,229,606,854,233,621,1145,377,747,901,248,603
060379108152,1192,352,840,1208,341,867,1627,516,1081,1291,339,890
060379108153,274,79,195,274,76,198,369,130,235,316,74,230
060379304002,171,97,74,172,88,84,255,136,109,200,102,76
060379304001,37,20,17,38,21,17,56,32,24,36,23,13
060379108141,912,270,642,920,262,658,1104,349,737,960,243,663
060379108142,808,255,553,817,241,576,1075,354,705,945,269,624
060379102131,523,217,306,527,200,327,662,278,374,609,245,346
060378003361,954,576,378,973,576,397,1023,623,381,1079,609,400
060378003353,539,323,216,547,317,230,592,353,227,598,346,211
060378003362,580,293,287,589,285,304,658,388,254,527,256,238
060378001041,2055,1766,289,2076,1770,306,2506,2040,424,2319,1858,293
060378002021,505,351,154,512,344,168,693,462,216,551,376,150
060378003354,491,326,165,506,323,183,498,302,183,637,386,208
060378005041,1047,689,358,1073,693,380,1232,813,397,1251,813,379
060378005061,625,444,181,637,446,191,644,446,189,709,487,181
060378002061,914,530,384,942,521,421,1312,763,531,1096,635,405
060378002062,513,280,233,522,270,252,794,445,342,615,348,237
060378002041,843,511,332,855,509,346,1398,881,499,1050,642,349
060378004061,581,378,203,598,383,215,435,296,136,669,426,200
060378003382,880,538,342,901,544,357,1119,720,383,954,592,314
060378003381,643,377,266,657,382,275,924,596,314,827,455,317
060378003383,693,411,282,702,403,299,971,617,341,764,473,263
060378003331,907,543,364,918,544,374,1459,888,540,1052,610,390
060378003341,468,264,204,472,263,209,499,304,186,379,216,144
060378003384,702,414,288,711,407,304,937,595,329,746,461,257
060378003244,827,503,324,834,503,331,1339,831,480,1002,593,345
060378003243,826,516,310,839,521,318,998,646,334,847,538,265
060378003241,536,351,185,546,348,198,770,501,254,505,319,164
060378003242,1158,705,453,1171,693,478,1718,1110,574,1253,752,442
060378003342,775,453,322,790,455,335,1051,644,385,815,466,307
060378003343,583,362,221,600,369,231,676,413,247,769,450,278
060378003281,604,326,278,609,330,279,715,446,258,604,319,245
060379108081,889,415,474,909,414,495,975,478,482,908,404,439
060379108101,1162,528,634,1181,533,648,1640,754,853,1207,495,647
060379200501,516,199,317,527,197,330,705,266,422,552,176,341
060374804003,770,572,198,783,562,221,999,725,254,861,636,175
060374803042,219,168,51,223,166,57,385,276,101,278,217,43
060374804002,614,428,186,629,428,201,1186,817,334,772,524,205
060374804001,527,357,170,541,357,184,466,328,134,529,348,156
060374803031,295,231,64,302,229,73,483,358,116,336,251,62
060374803032,587,460,127,598,453,145,1092,813,259,748,560,137
060374808041,656,510,146,665,506,159,1137,830,284,809,609,148
060374808042,564,437,127,575,442,133,937,677,240,704,541,117
060374819013,727,561,166,732,542,190,893,672,202,786,582,156
060374819014,799,625,174,818,618,200,1137,852,263,939,700,184
060374803041,381,290,91,389,293,96,773,554,204,467,335,100
060374803043,253,192,61,261,196,65,550,390,148,259,188,56
060374803022,461,312,149,464,310,154,611,436,170,504,338,136
060374803023,482,330,152,492,333,159,746,529,200,609,412,163
060374803021,494,330,164,509,322,187,563,385,165,574,348,187
060374808031,360,297,63,365,290,75,452,352,94,391,301,67
060374808033,373,299,74,375,290,85,473,369,98,378,293,68
060374808034,279,232,47,283,227,56,374,292,78,344,267,59
060374808021,223,171,52,227,168,59,402,294,104,266,207,46
060374808022,832,646,186,848,637,211,1152,838,297,961,738,179
060374808032,279,222,57,280,216,64,471,363,98,354,274,66
060374809011,320,260,60,319,251,68,563,404,152,426,320,76
060374809012,350,274,76,351,266,85,542,388,145,392,294,74
060374809013,295,226,69,301,223,78,551,390,147,383,284,74
060374810011,240,171,69,249,168,81,446,302,137,242,173,57
060374810012,483,318,165,500,306,194,677,458,209,651,432,192
060374810022,559,425,134,572,420,152,1079,721,329,707,531,139
060374810021,555,398,157,559,394,165,841,570,255,585,412,146
060374811011,439,330,109,449,330,119,959,662,270,501,375,105
060374810023,227,161,66,229,161,68,584,401,171,260,181,65
060374819021,633,494,139,645,486,159,1155,859,273,788,609,139
060374809021,520,398,122,530,400,130,982,693,262,654,499,113
060374809022,176,135,41,178,134,44,326,235,89,217,166,38
060374810013,335,245,90,342,236,106,441,311,117,414,304,92
060374816041,319,238,81,323,234,89,400,279,121,358,265,77
060374816042,540,397,143,553,391,162,1043,714,307,626,442,164
060374816061,319,222,97,325,222,103,673,445,206,390,284,89
060374816062,340,249,91,346,252,94,654,439,201,444,324,99
060374816031,465,329,136,478,328,150,870,591,260,588,419,142
060374816032,253,179,74,258,177,81,351,244,106,321,219,88
060374815002,255,178,77,264,176,88,434,289,135,307,209,80
060374815001,449,324,125,466,315,151,755,512,234,523,353,153
060374815003,376,274,102,383,272,111,617,414,199,509,358,128
060374816063,203,136,67,206,137,69,378,252,116,224,165,53
060374819011,344,262,82,354,255,99,405,284,120,426,306,85
060374819012,231,175,56,238,171,67,331,246,85,284,210,55
060374809031,630,452,178,644,443,201,1235,847,360,789,552,193
060374816051,197,143,54,201,144,57,321,219,102,253,189,58
060374816053,186,143,43,191,144,47,362,241,113,231,167,51
060374816052,316,247,69,323,244,79,478,323,151,361,273,74
060374819022,258,185,73,265,185,80,403,281,119,310,219,75
060374818002,502,326,176,521,333,188,774,529,232,551,363,160
060374818001,313,221,92,323,222,101,511,353,154,401,276,98
060376025122,243,198,45,252,197,55,464,352,101,413,346,47
060376025121,211,171,40,217,170,47,353,268,78,295,247,34
060374603014,1033,807,226,1049,806,243,1309,1072,205,1124,851,209
060374604011,477,420,57,484,419,65,586,507,70,488,407,57
060374603011,570,494,76,573,495,78,658,547,95,605,509,62
060374603012,509,450,59,507,439,68,636,550,75,522,451,45
060374603013,432,387,45,426,372,54,525,464,55,438,383,36
060374601015,822,562,260,836,564,272,1061,766,272,897,609,235
060374612001,487,338,149,498,338,160,670,486,173,512,350,135
060374613001,639,443,196,650,446,204,878,608,262,690,474,183
060374601012,1084,845,239,1102,846,256,1314,1056,231,1145,888,201
060374602001,538,463,75,544,469,75,634,522,98,570,466,69
060374603022,393,360,33,400,359,41,563,489,65,471,408,41
060374603023,555,495,60,564,495,69,687,595,80,609,545,40
060374603024,366,326,40,369,322,47,616,526,73,416,361,30
060374603021,470,405,65,475,404,71,601,517,75,498,422,53
060374610004,576,504,72,581,504,77,793,684,98,622,523,64
060374612002,752,515,237,767,513,254,932,674,235,768,522,200
060374612003,494,339,155,505,337,168,634,459,162,498,349,118
060374610002,518,455,63,522,454,68,754,644,92,676,581,54
060374610003,520,459,61,526,460,66,704,608,84,624,526,63
060374610001,315,271,44,317,269,48,460,391,58,403,346,30
060374611002,719,587,132,727,591,136,936,777,141,824,648,129
060374611003,397,338,59,403,337,66,511,436,73,411,344,50
060374611004,356,306,50,358,303,55,556,475,69,512,424,63
060374601011,552,383,169,560,387,173,638,464,159,586,399,147
060374602004,417,346,71,422,344,78,556,466,81,490,402,61
060374602005,801,691,110,813,685,128,988,833,133,837,695,97
060374611001,582,476,106,590,480,110,705,587,108,512,415,71
060374601013,584,463,121,595,464,131,730,594,120,636,494,112
060374601014,508,406,102,516,408,108,612,500,102,511,393,97
060374613002,644,447,197,650,432,218,851,572,262,680,431,206
060374613003,541,380,161,545,368,177,781,512,251,668,415,212
060374625003,1049,742,307,1055,729,326,1417,957,434,1043,690,291
060374613004,770,568,202,784,563,221,1166,831,317,866,590,232
060374612004,765,598,167,777,605,172,922,744,154,810,633,128
060374602002,499,436,63,506,435,71,626,528,85,545,475,43
060374602003,668,547,121,669,531,138,796,668,116,717,578,96
060374303012,2,1,1,2,1,1,0,0,0,2,1,1
060379013001,414,121,293,421,124,297,690,243,429,597,161,396
060374306001,259,131,128,269,131,138,404,231,167,308,173,117
060374306002,695,339,356,716,342,374,953,543,391,716,381,291
060374306003,735,365,370,743,363,380,1092,637,435,872,441,375
060374304003,265,132,133,271,132,139,452,261,184,330,168,142
060374304001,653,308,345,658,317,341,986,583,387,724,371,303
060374304002,339,165,174,339,165,174,428,253,169,371,188,161
060374307012,637,361,276,646,366,280,935,555,362,859,525,286
060374307011,362,178,184,374,180,194,490,281,200,393,193,180
060374307211,300,162,138,307,162,145,435,244,177,439,236,177
060374307212,382,226,156,390,220,170,662,406,244,421,256,143
060374307213,244,131,113,250,131,119,397,226,162,212,114,88
060374307013,385,182,203,398,183,215,341,222,117,450,253,169
060374307014,419,196,223,432,198,234,532,307,218,498,228,241
060374307231,344,225,119,354,223,131,734,473,246,433,273,135
060374307241,492,323,169,504,316,188,999,643,335,605,385,180
060374307232,442,275,167,452,273,179,859,533,309,488,301,160
060374307242,475,299,176,488,299,189,812,504,292,496,307,161
060374317012,312,158,154,323,161,162,502,296,199,388,213,158
060374317013,346,172,174,359,176,183,572,333,234,421,229,176
060374317014,269,137,132,280,138,142,438,258,175,322,162,146
060374317015,525,298,227,537,288,249,921,529,376,676,392,257
060374316002,532,297,235,550,293,257,879,496,369,632,348,244
060374316003,252,128,124,263,128,135,496,277,215,323,178,132
060374316001,347,169,178,362,171,191,598,333,255,417,228,171
060374308011,196,113,83,203,116,87,292,189,103,202,128,63
060374308012,532,333,199,547,337,210,1037,645,370,629,411,187
060374308013,190,115,75,195,116,79,462,289,158,272,179,80
060374308014,385,246,139,393,246,147,870,524,323,497,323,150
060374308024,289,150,139,304,149,155,476,285,180,349,194,135
060374317011,300,153,147,308,154,154,465,270,182,376,206,156
060374308022,346,193,153,361,191,170,626,385,227,424,243,156
060374309021,744,489,255,755,481,274,1318,906,385,858,547,254
060374308023,288,150,138,304,147,157,428,260,161,347,200,130
060374308033,390,244,146,404,258,146,650,373,264,445,260,157
060374308031,275,151,124,284,148,136,404,241,154,319,187,117
060374308032,439,234,205,452,234,218,658,378,270,482,280,174
060374308034,361,201,160,373,197,176,507,305,193,373,221,134
060374308035,229,129,100,240,126,114,316,180,129,270,161,96
060374315021,284,167,117,289,164,125,465,277,178,300,167,118
060374315024,351,198,153,359,200,159,458,276,175,393,221,156
060374304004,399,217,182,418,228,190,569,341,220,469,269,168
060374325021,404,281,123,415,280,135,658,437,208,542,377,135
060374325022,392,276,116,403,282,121,635,422,199,501,341,131
060374320022,225,125,100,232,124,108,393,238,152,252,151,90
060374318003,269,168,101,273,160,113,553,340,203,443,262,159
060374318002,585,333,252,601,324,277,839,526,302,704,416,252
060374800111,533,342,191,545,344,201,917,575,328,522,339,145
060374308021,254,145,109,263,143,120,457,279,169,311,180,114
060374313003,227,145,82,237,145,92,360,237,119,283,184,84
060374313002,392,219,173,402,220,182,492,287,191,446,246,170
060375548011,387,323,64,397,316,81,918,592,298,529,437,57
060375548012,293,169,124,295,170,125,399,258,131,336,206,112
060375545213,705,423,282,722,435,287,1175,721,436,862,548,275
060375548021,630,386,244,646,389,257,924,569,335,747,481,231
060375549001,431,292,139,449,295,154,612,384,218,499,337,134
060375549003,167,111,56,169,108,61,364,227,129,206,136,59
060375549004,520,324,196,540,329,211,931,567,346,665,415,217
060375545161,695,398,297,717,406,311,1180,737,427,929,583,301
060375549002,333,227,106,348,234,114,542,335,193,408,278,107
060375548022,480,314,166,486,304,182,682,394,277,618,412,173
060375548023,435,285,150,447,280,167,476,277,194,459,305,129
060375549005,229,136,93,241,143,98,520,327,186,284,171,100
060375408004,248,232,16,251,231,20,376,336,35,285,258,12
060375409011,241,227,14,245,225,20,485,418,50,416,373,21
060375409012,308,289,19,312,284,28,517,445,55,470,432,22
060375409013,443,407,36,443,398,45,689,609,73,610,563,28
060375409021,362,334,28,361,321,40,595,529,58,448,417,19
060375409023,439,411,28,443,402,41,652,585,54,565,522,25
060375409022,683,647,36,689,646,43,890,812,58,866,807,33
060375409024,26,25,1,24,23,1,36,32,4,1,1,0
060375990001,236,143,93,238,140,98,256,152,97,202,107,81
060375990003,136,82,54,139,82,57,208,124,79,209,110,83
060375990004,393,225,168,398,220,178,603,357,228,491,255,202
060375991002,104,69,35,104,70,34,135,85,44,162,100,47
060375990002,231,126,105,236,125,111,316,188,120,241,126,98
060374083031,1101,865,236,1118,828,290,1659,1198,430,1348,1000,279
060374083012,459,363,96,472,358,114,909,654,231,661,516,109
060374083011,159,126,33,163,124,39,271,200,67,194,152,34
060374083021,1279,954,325,1292,911,381,1704,1222,453,1607,1165,375
060374083014,212,159,53,215,150,65,367,258,103,288,216,57
060379800351,93,58,35,95,55,40,216,139,73,180,123,52
060374083013,339,258,81,341,242,99,538,381,141,420,317,81
060374083032,404,288,116,411,281,130,605,419,171,492,348,115
060374040004,363,257,106,372,249,123,636,423,197,647,434,180
060374040001,329,228,101,335,215,120,463,309,141,353,233,101
060374040002,336,231,105,339,217,122,446,301,137,354,235,102
060374041002,300,233,67,300,227,73,567,411,143,430,324,81
060374044011,227,172,55,230,171,59,401,285,110,308,232,61
060374044012,335,251,84,339,248,91,503,346,141,435,319,89
060374044013,289,222,67,293,215,78,418,301,107,335,247,65
060374043011,363,271,92,365,259,106,544,384,148,457,321,109
060374043012,248,191,57,251,183,68,499,361,131,404,305,74
060374043021,297,217,80,308,220,88,479,336,131,451,325,96
060374045011,73,61,12,74,59,15,285,204,75,125,97,18
060374041003,385,296,89,390,288,102,822,572,235,483,349,102
060374043022,222,162,60,231,164,67,289,201,78,280,199,59
060374045041,326,264,62,332,254,78,846,606,219,485,386,77
060374044021,409,294,115,413,286,127,582,407,168,414,291,94
060374044023,218,164,54,223,161,62,360,239,101,301,222,59
060374045031,606,486,120,612,470,142,912,682,223,777,591,142
060374045042,359,293,66,364,281,83,680,501,162,509,403,83
060374044022,281,216,65,285,212,73,375,260,107,338,249,61
060374044024,214,166,48,218,163,55,349,244,100,333,257,56
060374045012,282,234,48,285,228,57,549,415,125,419,345,48
060374006023,448,300,148,455,292,163,577,406,166,531,353,140
060374006031,945,595,350,967,574,393,1520,959,522,994,620,297
060374008014,454,211,243,459,211,248,1022,565,434,565,286,242
060374006053,735,462,273,743,445,298,757,481,265,953,596,300
060374042011,341,243,98,344,237,107,845,571,255,503,344,130
060374042012,469,334,135,472,323,149,643,425,202,327,218,87
060374042031,296,210,86,302,204,98,678,436,221,303,199,86
060374042032,382,276,106,385,266,119,624,423,192,515,351,143
060374006022,427,298,129,437,289,148,700,464,220,401,266,108
060374043013,256,195,61,255,191,64,456,334,115,221,169,39
060374043014,200,153,47,201,151,50,283,207,71,122,95,21
060374006052,791,467,324,793,442,351,1378,840,506,847,501,286
060374006021,382,261,121,391,251,140,627,363,245,455,275,146
060374006051,405,219,186,403,205,198,471,274,186,536,300,210
060374006032,402,251,151,408,250,158,607,394,195,495,309,146
060374006033,378,227,151,388,228,160,619,382,223,518,299,179
060374046001,488,373,115,492,367,125,806,561,236,643,463,135
060374050022,326,283,43,334,273,61,568,415,141,427,345,60
060374050021,294,253,41,297,244,53,567,413,142,436,353,60
060374050014,384,320,64,386,311,75,633,475,141,503,411,67
060374051011,464,386,78,464,375,89,749,566,165,567,456,83
060374049011,274,229,45,279,221,58,418,311,100,273,215,41
060374049021,397,327,70,404,316,88,680,495,168,551,429,90
060374049031,205,168,37,206,163,43,360,274,78,270,213,42
060374049012,401,331,70,404,321,83,568,419,133,450,354,67
060374049013,413,341,72,420,334,86,705,534,154,696,568,84
060374051012,292,243,49,290,234,56,492,377,103,360,288,52
060374051013,352,297,55,366,294,72,571,436,124,423,330,55
060374051021,499,421,78,505,414,91,792,593,188,695,566,88
060374052011,332,269,63,347,265,82,517,354,155,430,334,76
060374049022,437,344,93,442,331,111,735,519,198,586,439,113
060374049032,367,292,75,371,281,90,689,510,166,450,355,73
060374051022,415,336,79,417,326,91,786,613,158,460,365,77
060374048051,261,214,47,258,203,55,490,364,117,412,332,61
060374048052,198,161,37,196,154,42,292,217,71,238,191,35
060374048042,286,233,53,289,225,64,526,386,125,310,246,52
060374052032,365,291,74,368,280,88,628,433,179,506,386,88
060374052031,375,299,76,378,287,91,557,391,152,471,361,80
060374052021,203,173,30,205,165,40,462,337,113,296,250,33
060374052022,338,282,56,347,274,73,563,409,143,413,336,57
060374047011,473,391,82,479,378,101,879,648,212,614,493,80
060374047021,501,417,84,505,403,102,771,560,192,606,491,77
060374048043,184,148,36,186,142,44,330,229,95,279,217,50
060374048041,421,337,84,425,325,100,663,464,190,531,412,96
060374052012,447,353,94,453,348,105,718,503,207,525,402,93
060374052013,298,236,62,302,233,69,513,386,122,405,317,62
060374050013,300,246,54,308,242,66,430,335,95,423,343,59
060374050012,386,311,75,391,304,87,494,374,105,487,391,71
060374047022,355,297,58,355,290,65,497,368,120,454,372,56
060374047023,257,212,45,260,208,52,386,284,92,320,263,41
060374048063,365,298,67,366,287,79,589,432,140,417,331,68
060374047032,249,213,36,250,203,47,452,335,109,362,298,43
060374047031,304,259,45,306,248,58,421,312,102,364,300,43
060374048062,453,368,85,452,350,102,899,660,213,645,513,95
060374048061,388,317,71,386,301,85,583,432,143,407,329,55
060374069033,459,381,78,465,374,91,728,567,147,645,501,105
060374070012,413,352,61,420,344,76,691,540,143,588,475,83
060374047013,364,307,57,368,292,76,479,353,116,409,341,50
060374047012,251,207,44,255,201,54,474,354,114,335,270,42
060374050011,323,253,70,326,247,79,337,251,80,383,304,58
060374052023,389,311,78,401,311,90,547,392,144,511,395,85
060374070011,243,208,35,244,205,39,393,297,86,341,280,42
060374070013,494,420,74,497,412,85,817,619,180,658,541,86
060374070021,348,291,57,351,288,63,643,482,151,484,388,70
060374070022,395,330,65,397,324,73,657,491,153,574,469,77
060374069032,271,222,49,273,215,58,445,349,93,334,259,55
060374069036,346,287,59,348,270,78,578,404,153,458,365,71
060374069035,252,205,47,254,203,51,452,322,124,306,235,54
060375336011,252,220,32,254,213,41,426,338,79,344,307,26
060375336012,262,228,34,263,222,41,503,396,91,429,380,33
060375336013,163,143,20,163,134,29,281,221,51,238,198,24
060375336022,385,338,47,384,318,66,619,481,118,536,446,51
060375336023,164,143,21,162,134,28,286,227,54,196,164,20
060375338051,386,344,42,397,338,59,537,424,98,523,450,40
060375338052,245,222,23,249,214,35,323,257,54,228,196,22
060375338061,634,570,64,645,555,90,1028,824,178,842,733,73
060375323042,148,126,22,149,123,26,301,237,63,260,220,25
060375338034,299,263,36,305,254,51,613,487,113,547,473,53
060375338042,243,214,29,249,205,44,418,324,84,253,217,26
060375338043,312,275,37,317,261,56,417,325,82,281,238,30
060375338032,283,247,36,288,240,48,437,339,85,352,302,36
060375338033,197,172,25,200,167,33,311,240,62,334,289,32
060375338031,243,208,35,245,201,44,373,297,68,291,245,35
060375338041,223,191,32,226,185,41,391,309,66,280,238,34
060375336033,312,272,40,318,259,59,659,523,122,433,367,47
060375336032,370,323,47,374,310,64,629,498,114,485,416,45
060375344041,319,281,38,320,272,48,415,331,72,320,273,28
060375336021,265,234,31,272,225,47,455,359,87,434,360,39
060375336031,337,297,40,343,291,52,593,473,107,542,475,41
060375532022,390,273,117,400,272,128,621,412,201,460,307,129
060375532011,422,291,131,426,287,139,702,462,221,505,339,142
060375544032,484,397,87,489,380,109,894,662,203,563,426,104
060375544042,566,407,159,572,402,170,1057,743,282,776,565,168
060375532021,335,230,105,340,228,112,481,320,149,399,278,99
060375532023,370,255,115,378,254,124,613,410,191,461,324,116
060375531001,654,489,165,670,471,199,1068,733,314,789,587,158
060375531004,478,294,184,489,281,208,701,462,221,702,419,242
060375532012,317,223,94,321,213,108,485,318,157,403,273,111
060375532013,367,259,108,375,250,125,547,350,181,478,327,132
060375540011,328,205,123,333,198,135,528,331,188,424,275,122
060375540012,281,194,87,282,185,97,403,265,133,302,204,80
060375540014,266,173,93,274,170,104,360,227,128,297,192,86
060375544031,419,338,81,428,332,96,901,655,223,592,442,112
060375544041,294,227,67,302,223,79,455,329,117,382,293,71
060375543013,162,122,40,163,120,43,314,231,75,212,159,38
060375540022,480,346,134,482,338,144,837,561,249,632,445,151
060375540023,279,211,68,278,207,71,359,241,106,243,177,54
060375540021,493,357,136,499,339,160,820,551,245,610,423,150
060375541011,225,160,65,230,158,72,401,268,123,305,198,89
060375541012,372,290,82,378,285,93,893,608,255,502,383,86
060375541061,230,176,54,234,172,62,291,202,81,235,173,47
060375541062,263,200,63,268,197,71,617,428,171,469,345,94
060375531002,293,197,96,298,188,110,380,264,112,363,235,106
060375531003,313,182,131,321,174,147,325,208,106,338,195,123
060375533001,289,201,88,293,199,94,392,251,133,304,216,76
060375533003,358,249,109,357,243,114,583,366,195,442,314,109
060375542042,470,367,103,487,365,122,812,532,261,583,433,111
060375542041,441,329,112,448,324,124,875,587,266,725,524,155
060375542011,239,167,72,245,163,82,292,197,89,303,205,78
060375543011,252,194,58,257,192,65,465,336,117,327,250,56
060375542012,367,250,117,374,245,129,430,285,135,434,302,105
060375542013,505,363,142,518,357,161,724,499,210,626,443,156
060375543012,242,189,53,246,184,62,348,263,80,274,205,59
060375543022,230,179,51,233,174,59,511,386,118,356,269,76
060375541052,323,258,65,331,254,77,714,455,240,402,318,65
060375542032,220,167,53,223,163,60,316,209,101,279,208,56
060375542033,259,198,61,266,194,72,395,276,111,332,249,67
060375542031,400,230,170,403,231,172,666,403,243,566,309,228
060375544051,359,242,117,365,238,127,563,373,178,414,272,120
060375544061,566,355,211,570,353,217,1061,638,397,698,424,240
060375544063,690,386,304,708,384,324,988,629,337,853,472,333
060375544052,388,287,101,397,278,119,553,400,142,512,375,106
060375533002,285,195,90,290,193,97,482,303,168,384,261,105
060375540013,280,193,87,283,188,95,500,314,174,372,252,102
060375544062,354,195,159,363,194,169,495,296,186,387,212,153
060375541063,450,300,150,453,295,158,661,433,214,549,342,170
060375541051,397,329,68,406,324,82,934,610,300,522,411,84
060375543021,510,447,63,517,447,70,788,596,180,628,528,79
060375339011,270,245,25,271,238,33,370,307,51,293,257,22
060375341011,187,170,17,190,161,29,306,256,43,290,258,22
060375341012,168,151,17,170,145,25,249,204,41,257,226,21
060375341021,189,171,18,189,163,26,313,261,45,286,254,21
060375339012,311,282,29,311,277,34,541,446,84,436,384,32
060375340011,268,241,27,270,236,34,443,345,84,361,316,28
060375340012,413,370,43,417,367,50,624,487,119,574,510,41
060375339013,287,256,31,292,251,41,494,387,91,391,341,27
060375339014,177,159,18,181,156,25,297,233,55,233,202,16
060375339021,410,366,44,418,364,54,614,485,116,512,450,35
060375341022,277,245,32,280,237,43,415,320,83,304,259,31
060375341023,232,205,27,236,201,35,369,289,72,254,217,25
060375341024,203,176,27,207,176,31,316,244,65,285,243,24
060375342021,381,342,39,380,330,50,555,447,97,440,387,35
060375342023,199,176,23,196,167,29,348,285,57,266,236,22
060375342031,269,237,32,269,231,38,344,280,62,313,277,26
060375342032,267,238,29,270,235,35,464,380,75,373,329,28
060375340013,205,184,21,210,178,32,353,277,69,295,263,22
060375340021,500,452,48,501,443,58,777,602,150,621,536,50
060375340022,251,221,30,253,201,52,371,292,73,321,278,28
060375342022,284,253,31,281,236,45,446,343,93,343,294,34
060375339022,251,217,34,255,218,37,382,295,77,397,340,32
060375342011,316,280,36,321,275,46,525,429,88,389,340,36
060375342012,268,235,33,271,230,41,413,336,73,295,257,26
060375307001,495,440,55,505,434,71,740,619,109,630,531,59
060375310001,364,327,37,365,310,55,608,489,94,537,459,44
060375310003,522,482,40,524,458,66,767,639,117,648,574,48
060375308021,454,405,49,457,391,66,596,490,84,517,438,47
060375308022,415,373,42,414,363,51,516,428,76,387,338,28
060375309022,536,486,50,540,459,81,774,633,124,572,501,41
060375311021,451,409,42,444,382,62,726,600,105,614,553,36
060375308011,252,227,25,253,219,34,391,331,46,322,276,21
060375308012,233,210,23,232,201,31,382,318,53,294,252,19
060375308013,430,382,48,429,362,67,584,486,78,512,432,49
060375309011,218,201,17,222,197,25,322,277,42,252,223,14
060375309012,248,228,20,248,222,26,443,373,56,336,293,19
060375309013,234,214,20,236,204,32,356,302,48,288,248,22
060375311013,290,266,24,289,257,32,480,408,60,392,348,19
060375310002,201,184,17,199,173,26,320,260,48,279,243,21
060375315031,293,265,28,297,262,35,490,404,76,354,307,30
060375309021,344,306,38,345,288,57,580,474,95,504,431,43
060375304003,506,454,52,504,431,73,766,618,129,579,505,42
060375305001,413,383,30,415,368,47,633,507,102,562,492,37
060375308014,268,241,27,271,228,43,391,327,47,327,275,29
060375306033,496,446,50,495,420,75,810,671,118,651,563,54
060375306032,254,230,24,256,217,39,339,278,51,273,238,21
060374820011,764,518,246,786,503,283,1042,728,296,858,573,253
060375306031,365,321,44,362,300,62,546,454,80,476,406,44
060375305002,340,320,20,339,309,30,455,366,72,411,362,26
060375305003,306,273,33,315,271,44,375,302,60,429,373,36
060375311012,273,250,23,278,244,34,375,320,48,335,296,17
060375311011,150,137,13,155,135,20,248,213,31,224,200,13
060375311014,183,167,16,187,161,26,242,207,30,226,202,15
060375311022,190,173,17,198,171,27,265,221,39,223,201,13
060377007001,425,230,195,436,233,203,694,282,393,519,303,200
060377008011,376,265,111,386,271,115,720,377,328,431,302,116
060377008012,651,445,206,665,449,216,1092,590,492,855,552,273
060377006003,381,215,166,396,221,175,454,213,241,384,231,147
060377006004,428,210,218,447,220,227,771,338,421,529,251,260
060377006005,373,208,165,382,208,174,510,225,282,429,252,166
060372611041,703,495,208,715,500,215,972,743,219,809,573,203
060377006001,507,245,262,517,239,278,779,371,407,613,321,269
060377006002,576,328,248,605,342,263,657,351,306,673,395,255
060377007002,337,147,190,347,147,200,444,177,264,349,160,181
060377007003,658,310,348,688,297,391,1026,411,611,797,404,362
060372690004,753,519,234,764,519,245,1159,690,446,927,624,259
060377008014,246,163,83,247,162,85,339,184,155,246,145,99
060377008013,381,241,140,382,240,142,597,343,244,530,315,193
060372148003,329,279,50,331,278,53,433,356,74,417,344,57
060377008021,464,311,153,475,320,155,740,415,312,584,383,180
060377008022,460,310,150,472,313,159,758,405,346,636,431,172
060377008023,333,223,110,342,224,118,602,323,277,447,274,157
060377009024,606,438,168,618,445,173,818,476,336,717,518,165
060377010001,263,180,83,272,187,85,350,238,111,312,220,79
060377010002,447,315,132,460,322,138,600,409,187,518,373,128
060377010003,462,330,132,470,333,137,506,342,163,505,366,126
060377010004,866,618,248,888,619,269,1140,771,352,917,659,229
060377009021,495,331,164,503,335,168,778,445,323,582,365,194
060377009022,595,402,193,607,398,209,866,485,363,685,452,202
060377009023,678,474,204,690,475,215,1088,719,350,823,574,221
060377009011,285,192,93,292,195,97,444,250,187,377,262,100
060372164011,635,513,122,643,511,132,966,648,307,757,564,157
060377009012,250,168,82,253,169,84,369,210,156,304,209,81
060377009014,483,324,159,490,319,171,693,397,296,515,341,160
060377010005,540,401,139,544,402,142,634,419,204,578,416,136
060377009013,325,216,109,331,217,114,510,287,217,403,260,130
060375737004,667,346,321,686,336,350,903,527,360,744,375,318
060374302001,476,215,261,490,224,266,646,334,303,538,244,263
060374303014,1098,599,499,1122,589,533,1410,813,562,1303,642,562
060374310022,627,388,239,645,384,261,792,518,251,758,431,264
060374310021,682,408,274,702,403,299,931,601,304,802,465,275
060373102012,635,393,242,650,391,259,798,443,351,661,398,235
060373102013,393,248,145,404,252,152,616,354,244,503,294,176
060373103001,314,195,119,323,198,125,484,273,194,366,212,128
060373108003,461,337,124,468,332,136,719,513,192,570,404,128
060373108004,469,341,128,474,335,139,640,454,175,494,331,136
060373108005,637,456,181,650,456,194,827,587,232,696,458,210
060373104002,477,297,180,485,289,196,675,422,245,568,329,197
060373104003,528,324,204,548,322,226,840,507,316,672,414,212
060373106012,712,525,187,717,513,204,1084,757,303,797,562,185
060373106013,443,343,100,451,339,112,951,670,263,425,313,86
060373101001,666,356,310,680,353,327,873,457,404,711,365,304
060373014001,364,223,141,367,226,141,524,270,242,454,240,187
060373101004,633,330,303,640,329,311,909,465,421,767,379,347
060373102011,294,195,99,299,195,104,418,247,169,304,195,98
060373102023,307,198,109,313,198,115,434,241,188,344,210,113
060373014004,361,200,161,363,191,172,515,267,238,453,226,199
060373102021,560,372,188,571,370,201,910,530,354,713,411,256
060373116011,682,494,188,693,493,200,878,655,211,719,501,178
060373116012,335,237,98,337,234,103,595,441,146,415,283,108
060373117006,541,379,162,555,379,176,646,456,175,484,323,135
060373103002,608,341,267,623,342,281,833,460,354,667,355,266
060373103003,369,190,179,381,191,190,568,312,245,400,202,173
060373104001,311,176,135,320,177,143,450,261,181,367,193,148
060373106022,540,363,177,545,355,190,733,477,245,805,527,233
060373101002,590,314,276,601,313,288,826,419,398,638,327,281
060373107011,664,467,197,672,465,207,1164,759,386,927,606,269
060373107043,410,305,105,420,303,117,574,377,189,439,301,116
060373107042,512,383,129,524,381,143,627,415,195,534,365,140
060373107051,588,446,142,599,452,147,1053,690,341,763,526,192
060373116021,629,477,152,637,473,164,724,557,154,653,462,153
060373116023,355,270,85,362,268,94,425,327,91,386,274,91
060373105011,527,406,121,531,400,131,838,614,209,548,415,100
060373105012,500,405,95,505,399,106,737,538,183,686,528,122
060373102014,629,458,171,632,461,171,1012,655,328,739,496,193
060373102022,731,534,197,748,536,212,1163,744,392,861,563,242
060373107041,539,417,122,553,419,134,903,595,285,714,509,162
060373107031,692,538,154,709,536,173,1221,797,399,869,610,202
060373015022,347,268,79,361,263,98,831,408,400,536,369,126
060373117001,825,566,259,839,566,273,879,639,218,928,610,261
060373117002,485,343,142,491,341,150,550,391,147,462,311,124
060373117005,409,288,121,417,285,132,513,365,140,383,258,102
060373117004,381,277,104,390,276,114,667,472,182,509,349,132
060373110001,350,239,111,355,237,118,468,329,138,390,241,116
060373113001,340,233,107,343,230,113,467,325,135,377,232,112
060379800011,2,2,0,2,2,0,12,9,3,0,0,0
060373108001,292,212,80,293,207,86,399,278,110,343,240,86
060373108002,302,218,84,308,218,90,400,281,113,329,230,80
060373109001,462,334,128,473,332,141,722,501,210,563,389,148
060373117003,396,283,113,400,281,119,505,362,135,412,279,106
060373101003,565,311,254,574,311,263,833,419,400,690,373,284
060373106021,463,324,139,464,317,147,453,311,131,523,343,149
060373106011,499,396,103,503,389,114,773,528,225,471,348,91
060373110003,643,435,208,659,431,228,867,575,283,678,441,196
060373110002,666,450,216,678,446,232,908,594,290,746,483,213
060373107032,531,424,107,539,427,112,958,629,304,689,497,147
060373118021,579,453,126,591,453,138,991,721,255,696,519,129
060373118022,550,434,116,553,428,125,945,698,226,658,495,117
060373118011,509,408,101,511,399,112,811,603,192,578,436,97
060373109002,727,495,232,744,490,254,934,633,276,817,507,252
060373109003,334,234,100,336,232,104,573,384,168,440,290,128
060373109004,609,413,196,620,414,206,876,594,259,612,407,173
060373109005,526,338,188,528,335,193,613,419,180,557,361,159
060373109006,499,330,169,505,323,182,679,470,204,556,356,168
060373115002,951,739,212,962,725,237,1202,881,290,1021,748,224
060373115001,918,656,262,930,649,281,1184,875,288,995,689,250
060373115003,928,669,259,940,659,281,1253,924,306,1020,715,254
060373116024,526,422,104,532,421,111,803,613,171,633,481,123
060373116022,685,534,151,691,532,159,1087,826,235,853,645,162
060373113003,739,533,206,756,535,221,963,688,245,789,567,180
060373113002,810,564,246,823,560,263,1057,738,299,855,551,242
060373111001,684,481,203,697,483,214,989,674,286,720,476,203
060373111002,635,452,183,661,469,192,934,643,272,770,521,201
060373111003,417,310,107,423,305,118,547,390,146,464,347,91
060373112001,507,374,133,509,366,143,685,497,182,512,331,137
060373112002,500,372,128,509,366,143,726,522,194,611,415,148
060373112003,484,348,136,490,344,146,633,458,159,532,361,127
060373114001,582,425,157,589,422,167,689,517,159,503,362,108
060373114002,699,511,188,701,509,192,847,626,200,733,480,218
060373118012,606,457,149,615,448,167,677,504,158,727,514,161
060378002023,1481,950,531,1527,976,551,2029,1279,727,1914,1217,604
060378002022,828,473,355,835,466,369,868,542,316,662,382,240
060378001011,1621,1063,558,1654,1075,579,2230,1481,714,1802,1227,503
060378002042,1370,842,528,1389,837,552,1912,1244,638,1523,958,509
060378003372,1024,676,348,1051,684,367,1483,920,524,1159,727,354
060378003371,239,158,81,246,160,86,482,298,171,400,243,130
060378001012,1209,779,430,1239,779,460,1530,999,498,1208,778,369
060378002052,585,365,220,595,368,227,786,492,274,683,396,237
060378002051,746,489,257,756,490,266,1133,711,396,876,544,274
060378001031,1276,1058,218,1303,1069,234,1609,1292,287,1241,934,213
060379200491,628,287,341,642,278,364,488,189,289,414,171,221
060379200492,1443,700,743,1467,666,801,2740,1369,1324,1614,711,800
060379108072,1110,585,525,1128,578,550,1791,1002,749,1580,814,662
060379200401,1302,655,647,1326,635,691,1942,1053,849,1520,651,764
060379108091,1179,381,798,1205,386,819,1691,677,984,1206,362,785
060379200341,1028,520,508,1051,506,545,1999,1123,832,1129,541,532
060379200342,360,202,158,366,199,167,652,345,288,328,169,136
060375410031,461,410,51,471,406,65,721,607,104,661,578,61
060375410032,1143,995,148,1165,988,177,1485,1253,210,1531,1270,185
060379800251,142,130,12,148,134,14,334,296,33,274,248,19
060375434002,606,516,90,619,517,102,839,663,153,852,702,115
060375434003,261,226,35,269,228,41,347,285,58,310,262,40
060375434001,415,347,68,421,340,81,644,472,151,477,381,68
060375437031,311,237,74,319,230,89,518,370,139,459,338,100
060375437032,707,523,184,714,511,203,1239,878,335,877,634,207
060375435014,567,395,172,587,384,203,921,592,318,699,492,183
060375436011,488,337,151,497,335,162,921,613,293,849,601,221
060375436012,462,339,123,471,343,128,715,472,231,631,473,138
060375436072,783,530,253,802,530,272,1308,854,427,884,609,238
060375436071,260,180,80,268,180,88,476,312,156,333,233,80
060375433212,1381,1212,169,1401,1204,197,1314,1135,170,1371,1197,130
060375433213,652,571,81,654,564,90,1404,1185,202,990,862,105
060375438011,888,633,255,915,635,280,1185,769,400,1108,773,278
060375438012,360,262,98,366,264,102,698,467,209,534,394,115
060375438013,210,153,57,216,152,64,433,292,131,271,191,69
060375438041,274,202,72,282,202,80,334,221,107,412,301,94
060375438042,500,346,154,521,355,166,975,630,328,601,414,155
060375433061,768,587,181,781,570,211,1277,903,353,881,647,198
060375439031,477,357,120,489,352,137,825,550,254,559,410,121
060375433063,856,662,194,867,657,210,1363,973,367,1094,827,214
060375439032,735,546,189,757,553,204,1171,801,352,917,675,194
060375439051,92,83,9,94,80,14,184,140,39,133,110,15
060375438032,719,529,190,734,520,214,1160,778,354,825,601,186
060375438031,547,412,135,559,404,155,909,577,314,672,504,139
060375435011,147,101,46,147,100,47,322,206,107,157,108,44
060375435013,539,416,123,550,410,140,969,631,325,704,518,150
060375435012,459,312,147,466,315,151,1061,675,355,612,420,172
060375436073,584,409,175,600,409,191,927,615,287,676,471,161
060379800371,0,0,0,0,0,0,0,0,0,0,0,0
060375437012,397,303,94,409,297,112,712,489,204,559,396,124
060375437043,291,219,72,302,215,87,415,294,117,348,256,76
060375437052,548,430,118,553,420,133,944,666,261,864,650,171
060375437042,351,266,85,361,259,102,519,368,137,419,308,89
060375437011,376,284,92,391,284,107,581,404,166,456,339,93
060375437051,380,294,86,389,292,97,577,407,166,455,343,91
060375437041,221,174,47,228,168,60,342,244,91,225,166,47
060375439052,323,287,36,329,278,51,684,540,119,458,391,39
060375439053,338,270,68,347,267,80,540,392,143,417,327,69
060379800021,0,0,0,0,0,0,3,2,1,0,0,0
060375433221,739,671,68,754,681,73,1002,886,102,897,814,61
060375433222,515,475,40,528,479,49,653,576,70,607,555,37
060375433225,652,580,72,669,591,78,877,765,98,728,646,56
060375433223,1129,1020,109,1147,1028,119,1408,1248,137,1134,1038,73
060375433224,432,404,28,433,402,31,534,497,32,501,462,25
060375431005,334,307,27,337,312,25,609,504,95,472,441,16
060375433041,545,510,35,563,521,42,707,640,54,648,601,25
060375433043,824,767,57,839,774,65,1046,959,71,954,888,42
060375433042,1262,1156,106,1278,1155,123,1717,1549,147,1359,1228,94
060375433062,411,305,106,419,306,113,626,464,148,540,388,133
060375433211,258,231,27,263,227,36,270,242,26,505,434,39
060375433044,679,633,46,688,630,58,805,695,92,771,714,39
060375440011,1,1,0,1,1,0,8,7,1,0,0,0
060375440012,318,252,66,325,253,72,608,456,135,543,428,90
060375440013,430,350,80,435,338,97,742,555,168,516,415,76
060375440021,2,1,1,1,1,0,1,0,1,0,0,0
060375440014,301,243,58,308,237,71,524,377,134,380,294,64
060375440023,494,353,141,498,354,144,790,576,202,608,439,144
060375440022,336,256,80,345,255,90,620,451,157,402,297,84
060379201021,271,150,121,279,138,141,113,54,58,50,28,19
060379201023,1135,545,590,1148,531,617,1651,752,857,1255,499,674
060379201061,994,605,389,1006,585,421,1515,873,607,1118,624,410
060379201182,781,375,406,798,375,423,1152,568,562,1113,476,571
060379201183,1068,508,560,1080,510,570,1582,727,819,1108,521,528
060379201191,774,298,476,790,294,496,1150,453,676,679,283,356
060379201163,1018,408,610,1035,407,628,1407,604,776,1094,448,587
060379201162,802,334,468,813,326,487,1084,451,611,847,315,481
060379203393,74,27,47,75,27,48,119,39,76,717,362,320
060379201161,334,124,210,345,120,225,520,216,296,549,214,304
060379201181,673,297,376,686,303,383,802,340,443,735,317,380
060372756051,484,414,70,491,414,77,638,518,106,1063,868,147
060375545171,1023,636,387,1048,634,414,1580,982,569,1125,725,353
060375545172,570,352,218,589,358,231,990,628,346,719,453,233
060375545183,605,382,223,619,377,242,881,563,299,605,394,192
060375545191,518,331,187,524,331,193,692,442,242,662,434,193
060375545211,1007,603,404,1024,594,430,1326,819,476,1099,685,365
060375545212,587,347,240,596,339,257,936,585,329,765,466,267
060375545221,366,221,145,375,218,157,503,306,189,368,228,124
060375545222,743,440,303,760,442,318,1093,660,410,879,540,309
060375545141,391,263,128,402,268,134,771,481,275,666,444,190
060375545142,492,355,137,507,364,143,708,428,271,586,413,142
060375545151,499,273,226,507,267,240,819,496,314,599,366,204
060375545123,920,571,349,939,565,374,1403,897,480,1035,676,319
060375545182,883,556,327,902,549,353,1428,916,484,1067,704,331
060375545223,825,493,332,847,496,351,1199,725,458,948,584,327
060375545143,612,333,279,633,341,292,817,494,309,728,439,253
060375545111,1006,619,387,1041,617,424,1518,960,537,1155,750,353
060375545112,457,268,189,479,273,206,676,428,236,534,335,174
060375545192,910,536,374,933,543,390,1341,854,470,987,614,329
060375545162,713,410,303,726,403,323,1120,680,422,821,482,294
060375530001,576,405,171,589,391,198,876,603,253,755,523,189
060375546002,512,343,169,518,333,185,832,521,292,580,383,164
060375545131,832,532,300,865,560,305,1381,887,470,829,539,260
060375545181,455,281,174,460,280,180,740,477,248,609,392,192
060375545152,921,549,372,935,534,401,1485,886,573,1136,677,400
060375545122,604,349,255,638,355,283,820,529,279,696,449,213
060375545121,919,585,334,941,595,346,1388,896,471,1018,662,316
060375526022,227,168,59,229,164,65,381,269,105,238,169,53
060374041001,279,220,59,283,220,63,506,365,126,340,264,57
060374041004,215,168,47,217,165,52,387,279,97,292,221,54
060374037211,351,207,144,360,203,157,555,360,182,456,249,174
060374038012,690,428,262,705,416,289,1335,787,515,830,489,280
060374038013,672,412,260,682,401,281,946,557,365,838,475,306
060374037034,336,174,162,341,164,177,460,248,201,340,174,146
060374038021,549,342,207,559,334,225,929,551,352,735,443,242
060374038023,803,480,323,812,467,345,1344,786,533,1036,573,394
060374037021,669,366,303,689,360,329,1134,612,496,788,415,330
060374038022,355,229,126,362,229,133,516,305,198,382,228,130
060374058003,743,526,217,746,492,254,1152,742,393,908,592,258
060374058002,346,233,113,348,221,127,565,357,197,427,275,129
060374057013,363,271,92,370,264,106,740,498,215,564,400,134
060374040003,209,138,71,212,130,82,334,227,103,196,130,56
060374038011,408,252,156,419,249,170,634,400,217,463,284,149
060374059002,651,461,190,647,436,211,876,569,284,816,527,242
060374060001,412,280,132,418,276,142,735,479,244,561,347,181
060374060002,593,397,196,608,393,215,830,547,265,695,432,206
060379203031,504,297,207,509,298,211,829,494,322,582,319,229
060371082022,656,406,250,658,395,263,1533,945,566,719,448,242
060371132311,391,235,156,402,228,174,651,410,234,458,258,174
060371132351,703,407,296,707,404,303,984,589,378,858,485,321
060379304003,157,53,104,158,54,104,168,78,89,217,71,132
060374008012,722,383,339,734,374,360,1025,548,442,836,394,374
060374039011,358,202,156,367,200,167,654,373,267,448,238,180
060374020021,655,462,193,662,449,213,1007,693,288,680,447,199
060374020022,352,260,92,355,255,100,482,341,126,488,336,124
060374020023,611,450,161,614,440,174,649,461,172,627,434,163
060374018011,1088,753,335,1099,759,340,1408,929,449,1296,861,362
060374019012,176,158,18,178,160,18,641,494,128,327,291,10
060374019021,498,416,82,509,426,83,255,200,55,615,485,94
060374019022,998,760,238,1013,756,257,1360,1016,310,1013,689,257
060374020011,689,496,193,698,485,213,1287,915,332,899,601,238
060374017052,544,317,227,554,310,244,706,435,259,711,407,237
060374017071,323,225,98,327,225,102,487,309,163,401,265,110
060374018022,1446,932,514,1461,936,525,1795,1149,608,1440,879,470
060374019023,667,526,141,678,531,147,676,530,140,627,503,95
060374019024,792,567,225,806,569,237,845,626,209,916,729,136
060374002062,1334,781,553,1355,772,583,1648,1004,609,1490,824,563
060374018021,580,390,190,589,394,195,678,492,177,473,311,130
060374002061,1396,776,620,1416,773,643,1676,1054,591,1582,926,562
060374018012,767,517,250,772,518,254,500,359,131,907,578,271
060374020012,407,284,123,407,272,135,615,457,146,503,357,119
060374002051,1453,743,710,1469,745,724,1979,1210,736,1563,821,657
060374002092,885,389,496,895,383,512,1067,491,555,836,366,420
060374017051,874,514,360,889,500,389,1193,742,427,846,471,313
060375323021,368,329,39,369,326,43,545,461,71,481,420,34
060375323022,326,284,42,331,279,52,486,382,94,379,326,35
060375323023,525,456,69,540,452,88,796,628,155,638,533,75
060375323032,890,742,148,893,725,168,1166,889,237,1089,879,156
060375323031,272,230,42,274,222,52,499,391,101,428,338,67
060375323033,160,140,20,159,135,24,326,252,67,229,192,27
060375323041,625,535,90,629,528,101,982,756,200,822,689,88
060375416061,191,176,15,203,179,24,318,263,41,295,269,12
060375416062,161,147,14,169,150,19,277,227,34,246,225,10
060375426021,234,215,19,241,217,24,406,348,50,327,305,14
060375426022,352,326,26,360,327,33,638,548,70,546,499,28
060375426023,280,259,21,285,259,26,428,365,47,359,327,17
060375424022,513,469,44,527,476,51,739,643,88,577,529,24
060375424021,307,284,23,315,287,28,396,334,46,379,344,18
060375416051,164,152,12,168,152,16,309,266,34,298,272,14
060375416052,373,347,26,375,337,38,638,541,76,541,486,25
060375416053,283,266,17,288,264,24,423,369,50,380,349,16
060375416031,124,113,11,126,113,13,265,220,33,250,225,10
060375416032,248,225,23,249,223,26,310,263,39,277,252,13
060375416041,284,258,26,292,258,34,537,445,77,326,295,14
060375416043,189,173,16,195,173,22,408,343,52,303,276,14
060375411003,347,327,20,353,322,31,490,435,50,379,341,21
060375428001,393,368,25,399,368,31,546,470,65,478,450,12
060375428002,483,450,33,488,449,39,819,720,87,666,618,29
060375422001,261,242,19,262,237,25,515,445,60,354,327,15
060375422002,236,219,17,238,217,21,392,337,48,326,296,14
060375424011,283,257,26,282,253,29,335,287,43,301,278,16
060375424012,354,323,31,358,322,36,497,431,60,512,474,25
060375424013,276,256,20,277,254,23,377,330,40,334,306,15
060375424014,301,279,22,303,276,27,583,506,60,486,445,24
060375422005,377,352,25,377,346,31,560,498,51,499,459,14
060375424023,65,60,5,66,61,5,103,86,13,102,90,7
060375412001,399,377,22,407,381,26,564,504,42,544,517,15
060375412003,760,714,46,765,713,52,811,730,66,862,801,34
060375413003,354,329,25,345,311,34,577,519,55,480,453,14
060375413002,329,308,21,331,300,31,538,456,60,513,476,14
060375413001,653,616,37,657,602,55,980,865,93,776,728,24
060375408002,235,216,19,242,219,23,412,362,42,310,286,14
060375426011,96,88,8,99,88,11,164,139,19,170,158,7
060375426012,272,249,23,277,249,28,526,434,70,399,351,21
060375427001,350,323,27,353,317,36,559,480,77,460,423,20
060375427002,302,285,17,306,281,25,499,429,58,395,359,20
060375427003,373,347,26,381,347,34,576,509,63,563,522,24
060375430002,277,254,23,281,253,28,356,324,29,366,336,11
060375430001,600,562,38,601,555,46,838,744,77,773,715,31
060375429001,360,324,36,362,316,46,563,471,80,451,418,23
060375429002,292,268,24,297,264,33,417,356,53,333,304,17
060375425023,206,187,19,215,190,25,368,319,34,258,238,11
060375425022,197,183,14,198,179,19,428,375,43,346,316,17
060375425021,233,220,13,230,210,20,487,425,50,322,293,16
060375431004,534,500,34,542,499,43,747,676,56,641,594,23
060375425011,629,565,64,619,551,68,835,731,85,811,733,46
060375425012,393,354,39,385,342,43,514,454,51,477,431,26
060375432031,166,152,14,166,154,12,333,289,39,204,191,6
060375432032,175,160,15,174,161,13,388,334,48,267,251,8
060375420001,368,339,29,372,333,39,570,483,71,456,417,18
060375420003,433,395,38,435,384,51,755,640,91,655,595,32
060375420002,239,221,18,240,217,23,390,337,43,286,260,16
060375421032,111,104,7,115,105,10,247,204,38,209,196,8
060375421051,325,302,23,333,301,32,527,436,73,378,343,15
060375421062,274,256,18,275,248,27,418,370,48,332,308,15
060375421061,190,177,13,196,174,22,362,304,43,245,223,9
060375422004,236,220,16,238,218,20,370,323,35,324,303,10
060375421052,233,214,19,232,211,21,396,329,52,353,321,17
060375412002,314,298,16,332,312,20,437,401,29,436,417,13
060375412004,598,550,48,613,550,63,1062,956,94,868,805,39
060375418013,261,237,24,264,234,30,351,285,47,367,323,18
060375418021,430,372,58,446,374,72,601,506,86,553,508,24
060375421031,198,182,16,202,183,19,422,335,68,330,301,14
060375421033,258,231,27,262,233,29,330,276,52,285,250,17
060375421042,256,236,20,261,236,25,447,384,54,410,366,22
060375421041,177,159,18,179,160,19,337,282,49,331,302,14
060375432012,405,372,33,411,367,44,612,522,73,584,532,24
060375432033,233,216,17,233,213,20,409,353,45,342,313,12
060375431002,496,467,29,505,464,41,714,622,70,637,584,30
060375431001,313,295,18,318,293,25,513,450,52,483,441,22
060375431003,329,309,20,335,308,27,425,380,34,344,320,12
060375432034,212,193,19,213,189,24,298,256,36,238,221,9
060375432011,417,372,45,419,371,48,476,413,54,435,389,32
060375405023,245,225,20,249,211,38,482,402,65,325,295,15
060375416042,232,207,25,242,210,32,436,361,63,396,350,20
060375417003,224,204,20,231,199,32,280,233,39,296,264,17
060375405022,168,154,14,169,143,26,314,263,41,216,198,10
060374057021,618,435,183,629,421,208,1047,710,320,805,552,204
060374060003,315,203,112,323,201,122,443,275,162,342,210,113
060374060004,434,251,183,453,252,201,569,336,223,495,269,198
060374061032,919,567,352,945,564,381,1372,799,545,1053,639,354
060374061033,398,250,148,408,246,162,679,426,244,488,289,168
060374061011,300,192,108,309,190,119,433,272,157,394,232,131
060374061012,381,244,137,391,240,151,737,454,271,472,281,158
060374061013,377,239,138,386,237,149,612,371,221,452,265,152
060374061031,483,330,153,497,329,168,943,593,321,633,416,172
060374061034,408,276,132,421,274,147,641,408,220,499,320,144
060374037212,662,411,251,678,408,270,800,507,281,649,390,226
060374037213,410,259,151,421,258,163,519,323,191,418,247,149
060374037221,471,322,149,479,318,161,905,586,295,609,389,185
060374037223,373,245,128,379,243,136,644,399,235,364,231,112
060374036014,880,512,368,896,503,393,1227,746,458,999,562,386
060374037222,567,328,239,579,321,258,873,521,336,637,379,222
060374037022,847,451,396,876,445,431,1155,630,504,912,468,388
060374037033,420,241,179,425,236,189,571,340,218,486,276,185
060374037031,759,364,395,772,348,424,893,459,416,758,356,365
060374037032,383,210,173,391,203,188,770,421,332,608,323,250
060374037214,261,157,104,266,153,113,457,300,148,336,199,120
060374036013,840,402,438,854,388,466,1169,622,526,885,417,421
060374036011,330,208,122,337,203,134,540,337,192,431,260,149
060374036012,385,213,172,393,210,183,742,446,282,702,389,271
060374059001,547,363,184,549,346,203,1047,661,358,819,509,255
060374058001,474,324,150,487,328,159,706,477,209,548,354,161
060374057022,558,387,171,570,391,179,875,549,304,670,438,185
060374057012,185,128,57,188,129,59,413,257,145,258,168,71
060375344031,557,483,74,566,480,86,721,579,124,728,628,58
060375344061,273,250,23,271,231,40,480,372,92,365,320,24
060375344062,230,210,20,229,194,35,456,354,85,371,325,25
060375344051,125,114,11,126,108,18,341,276,53,244,217,12
060375344052,268,244,24,270,231,39,521,422,80,333,297,16
060375344053,136,124,12,138,118,20,273,221,42,172,153,9
060375343021,321,294,27,328,285,43,475,389,72,415,365,31
060375361041,175,148,27,178,144,34,331,253,65,168,141,17
060375343022,238,219,19,245,213,32,344,268,65,311,275,23
060375343011,290,257,33,291,245,46,473,381,81,402,344,36
060375343012,317,281,36,315,265,50,523,429,80,451,387,39
060375344042,287,252,35,288,244,44,416,329,76,331,283,30
060377024003,405,356,49,403,349,54,521,449,61,375,319,37
060377024005,334,295,39,333,289,44,437,380,52,366,312,38
060377028021,396,328,68,398,321,77,503,418,79,464,366,72
060377028022,577,476,101,580,470,110,690,567,113,585,459,91
060377028031,188,157,31,189,155,34,354,290,59,265,213,40
060377024001,696,594,102,708,587,121,768,665,87,762,624,94
060377024004,541,478,63,544,470,74,594,513,69,492,414,54
060377024002,389,325,64,392,319,73,456,400,50,543,434,73
060377025022,685,580,105,700,585,115,752,624,109,570,465,75
060377025023,812,696,116,819,699,120,1330,1108,193,1013,822,137
060379800381,40,33,7,41,34,7,1,1,0,4,3,0
060377025014,959,792,167,977,801,176,1370,1139,200,1077,852,162
060377027001,446,355,91,448,351,97,627,512,105,490,391,75
060377025011,463,384,79,469,386,83,570,482,73,555,452,77
060377025015,437,352,85,441,356,85,499,411,84,460,370,73
060377028011,913,762,151,917,759,158,1248,1026,190,1049,846,143
060377028013,708,594,114,714,593,121,663,549,102,737,600,100
060377027002,489,389,100,499,386,113,648,536,108,507,404,79
060377027003,390,310,80,398,308,90,468,386,77,405,322,64
060377028012,638,523,115,646,522,124,945,774,152,690,550,94
060377028032,309,258,51,313,262,51,522,423,86,416,331,61
060377028033,555,463,92,560,466,94,697,563,115,485,386,72
060377026006,652,533,119,663,534,129,826,651,161,775,619,112
060377027004,543,445,98,557,449,108,684,564,116,518,413,79
060377026005,418,330,88,423,328,95,481,379,94,446,339,87
060377026004,815,639,176,824,633,191,1045,829,195,931,705,193
060377026002,607,484,123,614,481,133,621,518,92,654,500,120
060377030033,297,240,57,301,238,63,399,329,60,384,299,72
060377026001,393,315,78,397,314,83,487,410,69,441,333,82
060377026003,433,354,79,439,354,85,507,424,74,426,341,61
060377025021,677,574,103,682,574,108,653,565,74,675,557,86
060377025012,367,323,44,372,322,50,390,340,42,431,368,37
060377025013,401,353,48,408,353,55,495,434,53,434,371,37
060377030032,925,812,113,935,815,120,1166,979,162,888,745,86
060377030034,630,549,81,641,559,82,735,625,94,903,772,84
060377030024,1008,893,115,1011,891,120,1192,1054,127,1117,992,94
060377030031,967,855,112,977,845,132,1425,1196,196,1098,921,109
060376022012,349,257,92,361,265,96,581,398,164,428,303,101
060376022011,331,245,86,340,250,90,591,407,167,270,192,64
060376022013,1273,874,399,1301,875,426,857,587,240,1391,901,380
060376023012,500,380,120,509,373,136,776,557,198,587,428,118
060376023013,594,414,180,600,411,189,904,622,266,684,446,189
060376023014,688,498,190,702,497,205,911,639,258,769,531,183
060376022014,260,204,56,264,195,69,411,295,114,345,255,69
060376023011,536,395,141,546,391,155,795,556,206,615,449,127
060379012101,659,218,441,670,199,471,896,303,561,677,187,437
060379012171,795,163,632,803,154,649,942,267,651,877,168,667
060379201022,213,71,142,217,62,155,291,101,185,296,72,200
060379012091,495,122,373,506,118,388,613,181,418,592,135,425
060379009022,203,47,156,207,52,155,282,80,199,266,66,190
060379009021,459,121,338,462,117,345,599,164,435,522,127,375
060379009012,474,129,345,480,128,352,744,205,509,565,138,381
060379012161,1057,392,665,1068,390,678,1455,594,832,1173,423,674
060379102153,511,306,205,520,301,219,787,477,286,661,346,251
060379102151,379,261,118,384,260,124,635,414,208,557,316,211
060379104012,1032,608,424,1053,611,442,1642,955,654,1276,707,491
060379102121,839,270,569,857,267,590,1172,342,816,946,277,615
060379102122,559,171,388,564,166,398,761,258,481,662,203,427
060379102181,645,297,348,654,286,368,780,379,386,701,297,366
060379111001,417,296,121,424,291,133,755,494,256,562,401,144
060379102182,348,239,109,350,238,112,623,406,198,344,250,69
060379104011,82,36,46,83,37,46,79,36,40,23,9,13
060379107091,579,266,313,596,267,329,858,408,433,698,311,338
060379110011,530,203,327,534,206,328,775,300,448,649,218,391
060379110013,619,209,410,632,219,413,733,301,413,677,227,402
060374033241,341,166,175,349,166,183,516,297,213,297,157,129
060374033242,380,212,168,392,207,185,756,439,306,531,317,186
060374033243,992,529,463,1011,513,498,1412,830,566,1195,654,475
060374033244,283,135,148,289,135,154,442,257,178,233,124,103
060374033252,868,486,382,903,471,432,1436,829,586,1027,577,390
060374033212,717,448,269,737,447,290,1109,673,425,818,487,293
060374033201,748,420,328,767,430,337,1098,654,431,747,441,267
060374033202,1119,606,513,1156,611,545,1448,853,569,1419,805,564
060374033261,580,349,231,593,341,252,953,548,391,709,430,240
060374087073,1003,544,459,1033,539,494,1527,882,623,1054,601,389
060374033283,653,394,259,656,377,279,969,562,381,711,428,244
060374033251,666,352,314,688,343,345,980,568,402,762,416,304
060374033231,483,265,218,493,268,225,708,429,268,457,265,168
060374033233,389,214,175,394,213,181,650,396,248,584,343,214
060374033281,521,301,220,539,294,245,833,488,331,590,352,206
060374033282,558,317,241,577,309,268,981,570,397,647,363,252
060374033232,660,366,294,670,372,298,887,524,350,653,397,231
060374033163,726,416,310,740,403,337,1055,630,404,818,477,303
060374033161,751,449,302,766,430,336,1042,616,405,851,486,309
060374033162,942,543,399,962,535,427,1534,918,590,1042,627,360
060374033172,309,156,153,324,159,165,423,239,176,434,244,168
060374033211,917,503,414,933,494,439,1758,1022,702,1115,634,408
060374033213,248,137,111,252,132,120,337,201,131,224,123,86
060374033191,651,428,223,656,407,249,771,467,291,788,489,246
060374033192,539,344,195,550,336,214,1106,657,428,661,396,219
060374033271,760,452,308,772,446,326,943,577,360,874,509,325
060374033272,387,225,162,393,221,172,489,294,185,442,257,161
060374033051,564,323,241,583,325,258,1005,577,410,670,416,225
060374087033,475,252,223,492,250,242,752,428,314,573,330,213
060375433051,971,775,196,986,757,229,1347,1049,267,1122,859,210
060375518021,399,305,94,402,294,108,711,521,174,633,462,133
060375518022,259,200,59,262,198,64,410,293,107,283,207,61
060375518023,331,255,76,334,250,84,465,335,122,372,270,83
060375511021,149,106,43,149,102,47,328,221,100,213,148,52
060375511023,349,273,76,356,271,85,803,581,209,452,355,71
060375506011,526,406,120,540,399,141,966,664,279,723,530,141
060375506012,317,244,73,328,242,86,394,275,114,289,210,59
060375506014,349,253,96,357,245,112,448,309,124,415,285,104
060375518011,614,433,181,616,422,194,746,496,240,736,517,183
060375518012,313,239,74,318,225,93,497,324,157,436,309,103
060375513001,427,306,121,437,298,139,640,429,189,523,378,111
060375534001,359,284,75,361,279,82,607,442,147,426,330,67
060375534002,292,231,61,290,224,66,452,329,111,406,312,63
060375534003,354,278,76,355,273,82,517,381,127,462,356,73
060375517001,654,527,127,668,518,150,867,633,223,825,641,153
060375515011,649,449,200,653,429,224,1016,650,341,826,553,222
060375515012,446,300,146,449,276,173,710,427,264,608,387,187
060379800121,0,0,0,0,0,0,0,0,0,13,9,4
060375512031,340,255,85,345,252,93,408,277,131,390,282,90
060375512032,619,456,163,630,455,175,1096,763,308,883,636,200
060375512041,400,287,113,405,275,130,811,537,255,539,376,129
060375513002,334,235,99,338,228,110,563,400,154,507,351,121
060375513003,429,339,90,438,328,110,722,465,234,576,406,133
060375512012,663,511,152,678,495,183,902,607,275,830,610,172
060375514023,418,289,129,421,282,139,581,376,192,491,333,130
060375517002,402,301,101,403,293,110,582,406,152,492,358,104
060375517004,417,312,105,419,306,113,584,421,149,465,346,101
060375517003,297,247,50,294,239,55,550,405,144,410,321,59
060375514022,615,422,193,623,414,209,930,619,291,676,471,165
060375515021,426,293,133,428,289,139,601,407,176,559,386,141
060375515023,441,272,169,446,270,176,711,434,266,514,334,154
060375515022,399,273,126,397,268,129,571,388,167,599,409,155
060375512042,497,353,144,504,357,147,856,578,255,657,477,149
060375514021,398,272,126,402,262,140,623,405,211,493,335,130
060375511012,214,167,47,217,166,51,246,178,64,194,145,39
060375511013,247,192,55,250,191,59,584,415,152,402,298,81
060375511011,338,264,74,344,262,82,537,374,154,414,291,93
060375514012,587,433,154,589,425,164,883,602,261,677,486,157
060375515013,274,194,80,277,186,91,501,325,161,349,239,88
060375512011,466,341,125,472,332,140,649,443,200,551,380,145
060375508021,406,281,125,416,278,138,696,453,231,546,374,147
060375508022,237,164,73,243,164,79,399,257,131,314,216,85
060375506021,367,255,112,372,248,124,634,429,194,471,317,130
060375506022,414,289,125,416,275,141,771,524,234,507,342,142
060375507002,499,341,158,511,337,174,777,511,251,612,417,163
060375507003,421,289,132,428,284,144,651,414,226,492,335,134
060375507004,293,202,91,300,199,101,414,273,137,342,236,89
060375507005,431,299,132,439,293,146,738,489,235,591,407,153
060375507006,284,200,84,292,200,92,453,296,148,407,278,107
060375507001,353,241,112,357,233,124,551,354,188,426,300,111
060375506013,334,221,113,341,217,124,591,390,189,352,238,96
060375508013,351,230,121,356,228,128,528,325,193,433,266,146
060375508014,341,216,125,344,211,133,548,334,205,452,269,159
060375508012,397,259,138,400,248,152,430,280,143,490,301,168
060375508011,599,381,218,600,362,238,827,498,310,674,402,236
060375509011,422,319,103,425,313,112,606,425,175,777,553,168
060375509021,394,306,88,401,308,93,579,403,166,329,253,58
060375509022,331,257,74,336,258,78,430,298,123,258,197,46
060375511022,395,280,115,399,274,125,652,446,191,494,364,105
060375505011,700,530,170,703,527,176,1107,756,321,977,726,198
060375505012,314,237,77,316,239,77,562,387,164,338,256,62
060375505021,468,285,183,481,278,203,653,395,242,545,339,183
060375505023,428,266,162,437,253,184,662,390,257,515,315,175
060375505024,343,212,131,350,202,148,491,288,195,373,233,125
060375505022,407,247,160,409,244,165,486,290,188,426,256,148
060375778001,467,328,139,473,306,167,694,456,226,528,376,126
060375510011,457,296,161,464,291,173,761,478,267,574,377,166
060375510012,326,212,114,333,208,125,395,246,140,429,276,132
060375510013,400,261,139,406,256,150,591,369,208,429,279,124
060375510023,422,278,144,429,276,153,496,304,183,467,295,146
060375506024,346,221,125,356,221,135,579,358,206,470,287,165
060375506023,373,238,135,385,238,147,701,436,250,455,286,147
060375509023,332,220,112,335,212,123,415,266,139,385,249,117
060375509024,395,258,137,397,250,147,534,344,181,441,286,134
060375509012,229,163,66,229,153,76,328,210,107,262,179,69
060375509013,356,253,103,356,239,117,648,415,213,468,319,120
060375514011,498,382,116,504,376,128,757,532,210,617,475,112
060375510022,406,269,137,410,265,145,619,380,229,491,310,153
060375510021,353,226,127,355,221,134,614,377,226,449,278,143
060374301011,577,386,191,592,379,213,1033,684,329,712,466,200
060374301012,470,348,122,486,354,132,757,535,208,580,406,138
060374301013,322,228,94,330,226,104,470,318,142,385,256,103
060374300041,312,211,101,324,213,111,468,320,139,364,241,102
060374300043,379,251,128,392,253,139,778,491,274,461,319,124
060374300052,869,572,297,887,561,326,1227,786,418,983,656,276
060374300032,1432,820,612,1470,802,668,1633,1019,582,1596,906,606
060374300033,295,172,123,306,172,134,371,248,120,393,239,133
060374301021,426,331,95,436,333,103,687,489,182,535,393,111
060374301022,343,293,50,353,286,67,517,388,118,425,340,59
060374301023,425,363,62,432,352,80,721,543,158,624,513,83
060374300031,319,223,96,328,228,100,472,313,150,403,245,136
060374300042,426,303,123,430,294,136,505,338,161,482,320,138
060374300051,404,287,117,417,295,122,806,533,257,530,369,132
060374312001,456,391,65,457,385,72,645,497,128,553,477,51
060374312002,332,278,54,328,266,62,501,393,100,413,340,52
060374311002,645,474,171,656,467,189,879,631,232,741,551,147
060374312004,551,380,171,559,375,184,836,560,262,678,465,180
060374314003,300,194,106,305,185,120,478,305,163,408,265,118
060374314002,319,206,113,321,195,126,420,267,143,328,212,93
060374314001,323,173,150,324,165,159,499,279,208,387,211,155
060374312003,237,195,42,236,185,51,384,300,77,274,220,38
060374315022,395,223,172,402,223,179,510,307,197,480,271,188
060374313001,328,186,142,338,186,152,483,281,188,388,217,149
060374314004,326,188,138,337,189,148,509,306,194,379,204,154
060374315023,273,162,111,282,162,120,544,331,200,370,215,136
060375537022,295,264,31,298,259,39,490,407,71,395,351,23
060375421053,143,133,10,143,128,15,281,236,33,255,231,10
060375422003,204,191,13,205,185,20,329,278,41,237,215,10
060375312022,431,397,34,441,390,51,721,602,104,551,486,37
060375313011,218,197,21,222,189,33,335,269,52,287,254,19
060375313012,196,180,16,201,177,24,288,247,37,246,210,16
060375313013,209,190,19,211,183,28,352,291,48,313,277,20
060375315022,342,311,31,348,308,40,610,523,76,514,468,29
060375313014,229,212,17,236,209,27,309,260,40,269,234,18
060375312011,422,389,33,434,389,45,671,569,85,583,523,38
060375312012,436,397,39,446,385,61,672,549,97,512,440,37
060375312021,290,264,26,295,255,40,472,390,71,380,332,28
060375315021,160,146,14,164,145,19,274,232,34,222,201,13
060375315032,181,165,16,183,164,19,344,278,54,279,244,20
060375315041,437,401,36,441,395,46,656,547,92,587,516,36
060375316031,178,165,13,179,160,19,306,253,47,225,198,15
060375303021,356,307,49,357,296,61,462,370,81,409,347,44
060375303022,495,455,40,496,442,54,722,593,104,681,589,48
060375316032,535,496,39,534,476,58,756,640,100,637,555,46
060375316021,208,188,20,216,185,31,344,291,48,284,247,23
060375316023,251,231,20,255,229,26,502,432,62,414,361,31
060375317021,287,255,32,288,244,44,426,352,66,313,272,28
060375315042,308,280,28,311,278,33,512,419,79,412,358,32
060375316041,391,360,31,400,344,56,553,455,73,456,400,28
060375303011,539,475,64,549,455,94,784,646,123,721,618,61
060375303023,342,300,42,343,292,51,485,388,75,381,317,38
060375303024,350,306,44,352,301,51,528,424,96,341,288,35
060375302021,476,400,76,488,400,88,684,530,138,601,489,81
060375302023,318,273,45,323,271,52,489,383,101,393,329,49
060375316042,273,253,20,278,237,41,423,354,56,359,314,22
060375318002,354,317,37,360,309,51,651,524,110,540,478,40
060375318003,214,192,22,218,190,28,360,293,63,300,267,21
060375313022,250,228,22,257,230,27,398,340,53,324,294,16
060375313021,204,187,17,211,188,23,402,339,51,318,282,15
060375313023,219,200,19,215,187,28,302,259,39,288,254,22
060375313024,269,247,22,272,235,37,418,353,54,394,340,29
060375317022,170,151,19,172,144,28,267,223,39,228,198,20
060375317023,323,291,32,333,289,44,515,428,76,475,408,40
060375316022,169,151,18,171,151,20,286,234,41,237,203,20
060375317011,597,547,50,599,528,71,887,734,122,746,637,59
060375317012,436,397,39,433,382,51,702,583,102,607,520,48
060375319013,391,340,51,396,335,61,584,481,97,529,458,46
060375319014,290,250,40,290,246,44,374,307,63,358,309,31
060375319022,466,418,48,473,409,64,761,606,139,611,522,57
060375319023,291,254,37,290,250,40,386,304,70,326,274,34
060375319011,270,237,33,276,235,41,516,418,81,404,345,37
060375319012,267,234,33,269,232,37,488,397,80,333,284,33
060375318001,316,282,34,320,273,47,525,438,73,432,382,32
060375319021,233,211,22,240,206,34,316,253,57,261,225,23
060374631032,505,297,208,517,293,224,687,447,231,530,328,186
060374631033,434,270,164,442,268,174,556,382,162,454,312,113
060374633001,559,376,183,562,381,181,762,536,204,645,438,172
060374642001,311,156,155,313,156,157,415,247,162,319,179,124
060374642005,318,130,188,336,141,195,421,254,164,295,143,135
060374633002,404,270,134,409,277,132,446,314,121,409,278,109
060374631031,314,257,57,328,258,70,621,421,178,422,315,85
060374632001,477,336,141,487,336,151,625,459,150,561,388,142
060374631034,234,168,66,240,168,72,334,230,100,280,185,77
060374631035,580,414,166,587,409,178,858,586,251,725,467,202
060374801023,315,208,107,328,208,120,520,342,170,413,268,121
060374801022,208,136,72,212,135,77,293,191,101,207,138,60
060374812031,511,346,165,519,341,178,1113,717,374,706,472,197
060374812032,478,327,151,486,318,168,703,455,234,467,311,131
060374812033,284,194,90,289,190,99,463,295,151,354,234,99
060374812012,400,248,152,412,247,165,721,436,271,410,253,143
060374812013,225,144,81,229,141,88,501,299,192,328,203,102
060374801021,430,278,152,448,279,169,613,398,199,523,337,157
060374800121,298,192,106,306,193,113,501,314,179,341,212,106
060374800124,308,161,147,318,163,155,477,269,198,328,184,132
060374800021,368,209,159,377,209,168,469,297,163,393,234,142
060374800022,450,252,198,458,252,206,655,411,227,511,294,187
060374800112,575,373,202,594,372,222,1055,674,360,680,422,224
060374800122,451,270,181,460,274,186,729,444,268,477,280,169
060374800123,276,165,111,283,169,114,436,269,160,285,168,101
060374800023,472,282,190,475,281,194,706,455,236,552,334,188
060375002025,775,375,400,780,353,427,1013,554,435,904,414,437
060375001002,617,253,364,629,254,375,874,401,457,754,318,397
060376037021,360,290,70,371,295,76,392,288,101,278,219,45
060376037061,193,156,37,196,156,40,519,379,131,301,240,48
060376037062,292,236,56,299,237,62,654,474,163,439,345,71
060376037022,517,332,185,526,331,195,324,238,86,387,240,122
060376037023,548,347,201,558,349,209,802,483,305,601,369,196
060376037024,521,328,193,536,335,201,766,495,259,642,384,219
060374324011,331,246,85,341,242,99,711,474,221,525,394,103
060374324012,290,215,75,295,210,85,462,310,146,316,246,57
060374324022,285,230,55,291,227,64,473,321,140,348,279,51
060374324023,306,245,61,312,242,70,591,405,171,450,360,65
060374327002,321,267,54,324,261,63,515,369,137,326,263,48
060374327003,276,231,45,281,228,53,345,247,93,328,261,49
060374321025,297,187,110,304,187,117,580,359,211,410,253,138
060374328022,129,100,29,128,92,36,356,235,112,190,149,29
060374328023,161,126,35,164,118,46,405,276,125,200,158,32
060374329022,336,245,91,350,247,103,671,442,225,503,377,107
060374328011,258,210,48,261,201,60,488,342,131,351,286,44
060374328021,159,121,38,161,116,45,503,347,147,245,193,38
060374335052,189,163,26,196,159,37,425,294,121,310,253,41
060374335053,125,96,29,128,92,36,280,196,80,195,159,26
060374334022,244,216,28,247,209,38,444,341,91,298,248,32
060374334032,197,172,25,203,165,38,443,347,90,284,240,28
060374339032,65,59,6,66,58,8,105,82,22,75,66,7
060374338042,124,105,19,124,99,25,198,148,48,148,123,21
060374339031,124,112,12,123,108,15,259,204,51,210,183,17
060374331034,304,233,71,309,226,83,330,214,115,245,200,40
060374331031,265,197,68,271,190,81,642,420,212,427,322,89
060374331032,272,204,68,277,195,82,588,379,196,401,304,82
060374332003,255,193,62,261,186,75,326,234,92,286,211,59
060374335051,225,172,53,236,174,62,447,323,113,307,257,35
060374333051,297,234,63,301,223,78,558,394,155,411,317,64
060374333052,210,165,45,210,156,54,421,298,115,256,200,39
060374332001,204,164,40,208,164,44,364,257,99,246,191,43
060374332004,418,321,97,428,318,110,721,513,201,656,482,129
060374326011,175,135,40,178,132,46,270,190,74,219,169,39
060374327001,499,394,105,499,378,121,729,511,204,598,471,94
060374326012,325,250,75,330,247,83,516,362,146,425,319,84
060374326022,312,231,81,314,226,88,552,376,161,387,293,71
060374326023,286,203,83,289,200,89,452,303,143,332,244,69
060374333061,281,216,65,280,214,66,608,436,160,474,367,82
060374333021,171,133,38,176,133,43,354,257,93,226,179,39
060374339011,304,246,58,308,247,61,567,414,143,387,304,53
060374339012,121,97,24,122,98,24,304,227,68,217,174,29
060374339013,145,120,25,149,119,30,297,218,69,243,200,28
060374340012,407,356,51,408,350,58,775,593,166,426,357,51
060374333062,131,107,24,132,105,27,280,204,69,191,164,21
060374333072,155,127,28,157,125,32,361,264,88,270,231,30
060374328012,123,103,20,123,98,25,211,156,55,161,133,20
060374332002,136,111,25,136,105,31,273,194,76,188,141,36
060374334031,231,192,39,234,186,48,352,255,93,212,175,27
060374334021,173,151,22,175,141,34,338,262,66,221,182,23
060374333041,252,190,62,256,186,70,410,290,115,313,243,56
060374333042,320,246,74,329,240,89,608,425,170,456,357,80
060374333071,318,249,69,320,246,74,512,370,136,361,283,62
060374326013,302,228,74,306,222,84,525,348,169,410,300,88
060374326021,385,284,101,389,273,116,642,420,208,466,350,90
060374326014,365,275,90,372,272,100,666,443,210,489,354,107
060374324021,501,363,138,509,358,151,939,669,257,628,474,121
060374315011,186,119,67,191,120,71,312,206,106,258,169,78
060374323003,294,223,71,298,216,82,358,250,104,362,268,73
060374321011,388,233,155,392,229,163,580,352,222,423,260,145
060374323002,330,222,108,335,225,110,457,312,137,316,214,83
060374325011,544,388,156,555,378,177,928,616,298,710,506,168
060374325012,468,336,132,474,326,148,754,502,240,534,380,126
060374323001,225,177,48,228,168,60,301,209,90,298,226,56
060374321021,384,228,156,386,220,166,674,389,275,474,281,166
060374331033,144,108,36,148,106,42,298,191,98,210,166,34
060374334033,103,86,17,104,84,20,187,137,45,170,142,16
060374339034,291,229,62,293,228,65,451,342,103,345,274,47
060374339033,330,260,70,335,258,77,481,366,108,484,378,77
060374340011,262,218,44,265,219,46,382,281,97,308,251,37
060374340033,195,163,32,199,164,35,248,184,63,244,203,26
060374340032,254,209,45,255,205,50,438,335,94,368,300,49
060374340031,232,190,42,233,189,44,425,328,84,396,331,44
060376201012,1014,592,422,1029,579,450,1235,750,458,1172,646,439
060376201013,928,575,353,947,564,383,1288,806,444,971,581,325
060376201021,511,343,168,516,337,179,660,430,215,474,297,142
060376201023,966,573,393,992,573,419,1324,858,428,1043,603,351
060376201011,743,498,245,770,503,267,984,681,280,821,505,245
060376200011,571,322,249,583,318,265,673,408,249,672,365,261
060376200012,596,336,260,609,333,276,771,475,280,746,407,283
060376200013,809,459,350,834,457,377,1020,652,345,810,440,304
060376200023,481,286,195,495,287,208,649,411,217,525,303,180
060376201022,367,253,114,372,250,122,481,312,161,318,203,91
060376200022,604,362,242,618,362,256,847,531,296,716,410,244
060379800131,5,4,1,5,4,1,14,7,6,2,1,0
060376200021,533,331,202,546,334,212,760,487,257,604,355,197
060375351011,242,223,19,245,212,33,446,368,58,334,301,16
060375351014,296,271,25,300,260,40,533,460,70,381,357,16
060375351022,316,292,24,324,291,33,436,380,52,415,386,12
060375352001,299,274,25,297,268,29,476,410,52,357,334,14
060375349001,149,133,16,146,129,17,263,213,46,203,184,12
060375349002,301,272,29,301,266,35,554,450,90,438,390,25
060375349003,235,210,25,234,205,29,395,317,69,313,283,18
060375328001,234,214,20,234,207,27,429,364,58,296,272,20
060375328002,216,198,18,218,193,25,367,306,49,272,246,18
060375327001,133,120,13,135,118,17,292,240,43,280,256,17
060375327002,213,191,22,217,188,29,381,313,62,350,317,20
060375330021,151,136,15,153,133,20,260,212,44,160,143,9
060375330022,201,181,20,204,176,28,304,251,53,257,230,14
060375329003,305,288,17,315,283,32,442,379,58,437,406,15
060375329001,237,225,12,241,213,28,356,304,47,275,254,9
060375330011,279,254,25,284,252,32,529,441,79,381,351,21
060375330012,310,282,28,310,271,39,479,396,73,343,309,18
060375329002,271,257,14,275,239,36,508,427,66,406,371,17
060375349004,204,183,21,203,175,28,401,327,60,350,327,17
060375350021,194,174,20,196,168,28,337,283,50,246,227,8
060375350022,105,95,10,107,91,16,203,171,31,157,146,5
060375350023,149,134,15,149,131,18,238,202,36,227,214,7
060375350013,188,168,20,186,164,22,293,241,42,307,286,12
060375350012,149,135,14,151,128,23,263,225,38,265,239,9
060375351013,242,222,20,241,214,27,433,374,50,344,315,16
060375351012,395,365,30,398,358,40,555,481,63,475,429,29
060375351021,163,150,13,163,145,18,266,230,29,215,198,9
060375351023,192,176,16,191,171,20,398,352,42,222,208,10
060375352002,334,309,25,339,305,34,622,526,67,482,444,17
060375352003,317,300,17,326,289,37,474,409,53,496,449,27
060375350011,204,184,20,209,176,33,326,269,48,296,264,12
060375353001,270,240,30,270,226,44,428,349,61,351,309,21
060375353002,179,162,17,181,156,25,345,292,50,276,257,15
060375354001,242,223,19,244,215,29,439,361,57,345,311,12
060375354002,186,169,17,185,157,28,358,306,42,290,256,15
060375353004,310,275,35,314,261,53,417,352,58,369,332,22
060375353003,151,139,12,151,133,18,292,254,38,215,202,6
060374089003,1184,585,599,1212,563,649,1648,831,781,1415,679,655
060374016012,1098,546,552,1141,542,599,1609,845,735,1302,599,629
060374017072,416,308,108,420,303,117,682,448,218,581,438,103
060376026013,762,701,61,777,710,67,907,827,74,839,769,53
060376026014,477,440,37,489,448,41,519,469,42,547,500,34
060376029003,310,274,36,321,272,49,390,308,77,359,312,37
060376034001,431,320,111,434,308,126,648,489,146,508,419,72
060376034003,477,345,132,486,341,145,710,461,235,508,346,135
060376035001,272,205,67,279,199,80,364,267,96,392,287,83
060376035002,418,309,109,420,296,124,651,449,190,499,355,114
060376026021,697,643,54,708,645,63,1004,908,77,749,687,45
060376026011,583,538,45,590,536,54,743,690,47,661,610,32
060376026012,439,407,32,441,403,38,607,543,53,435,401,21
060376029001,378,338,40,379,327,52,527,420,100,475,425,34
060376029002,360,322,38,360,311,49,552,439,104,485,432,35
060376026022,546,500,46,561,504,57,867,787,68,729,671,43
060376036001,490,336,154,498,331,167,756,494,235,607,407,158
060376036002,284,187,97,284,179,105,394,267,126,290,198,76
060376036003,589,421,168,601,417,184,847,561,267,673,473,160
060376031012,379,295,84,381,288,93,669,497,161,425,322,79
060376031021,343,271,72,346,264,82,569,407,152,454,355,78
060376031022,307,243,64,309,237,72,456,325,124,329,253,56
060376034002,420,303,117,427,303,124,689,450,226,540,370,134
060376030041,400,317,83,411,322,89,616,476,124,462,357,83
060376030061,393,293,100,402,294,108,666,456,202,412,305,88
060376030062,174,137,37,183,141,42,238,178,55,214,165,40
060376030082,459,375,84,462,372,90,633,489,130,432,342,67
060376030072,545,469,76,554,465,89,873,676,179,515,433,59
060376030051,430,353,77,430,346,84,805,602,184,635,514,87
060376030052,403,324,79,409,321,88,764,572,178,556,440,83
060376030053,377,313,64,378,306,72,570,428,129,411,334,54
060376030081,207,171,36,208,169,39,437,342,87,273,217,44
060376030071,382,339,43,394,337,57,582,458,116,542,466,55
060376031011,398,305,93,404,299,105,583,430,142,490,365,99
060376031013,353,271,82,357,263,94,512,379,124,443,329,91
060376031023,324,245,79,334,249,85,369,262,99,363,281,66
060376032003,424,320,104,437,326,111,567,402,155,466,361,85
060376032001,174,126,48,177,125,52,347,250,97,264,195,57
060376032002,332,240,92,338,239,99,626,440,171,352,256,76
060376033012,365,270,95,372,272,100,496,348,139,424,303,94
060376033021,261,196,65,266,199,67,383,267,106,343,249,75
060376033022,542,397,145,556,401,155,902,634,252,558,401,125
060376033011,240,174,66,243,173,70,403,285,112,281,204,65
060376033013,306,221,85,314,221,93,471,331,130,390,280,90
060376033023,231,164,67,235,164,71,394,273,112,261,186,60
060376035003,321,234,87,324,226,98,544,374,160,402,264,106
060373003011,707,387,320,726,386,340,889,524,349,750,425,283
060373003014,369,202,167,378,201,177,494,300,185,386,218,148
060373008005,219,125,94,225,126,99,280,162,111,211,123,75
060373009014,754,431,323,775,436,339,1226,720,481,1100,645,407
060373003012,484,287,197,488,280,208,658,402,242,553,327,196
060373003013,368,207,161,380,205,175,497,295,192,385,218,149
060373003015,294,174,120,296,170,126,395,242,145,348,208,123
060371013002,454,259,195,462,260,202,573,320,238,462,242,194
060373004006,409,247,162,418,242,176,431,261,156,450,264,167
060373004003,405,244,161,414,245,169,568,335,220,424,247,148
060373004004,309,189,120,316,188,128,354,222,130,343,202,121
060373004005,298,175,123,304,174,130,298,186,110,326,184,123
060373004001,438,274,164,444,274,170,722,425,283,499,297,165
060373004002,388,220,168,402,223,179,501,300,189,460,250,174
060373007014,667,377,290,685,378,307,708,434,262,542,282,227
060373003016,450,245,205,466,242,224,753,440,298,542,293,221
060373005012,493,310,183,511,323,188,729,449,272,550,334,183
060373006012,566,379,187,589,382,207,1008,619,375,758,457,243
060373006011,767,479,288,781,483,298,1646,1006,609,860,525,280
060373006023,653,412,241,662,410,252,1063,624,420,1011,580,364
060373006021,502,317,185,514,316,198,674,397,268,492,283,171
060373006022,329,200,129,336,200,136,483,289,186,457,255,165
060373008002,473,296,177,482,295,187,794,500,279,544,314,192
060373008003,673,411,262,678,404,274,837,520,303,761,427,281
060373008001,754,474,280,769,478,291,1060,619,412,802,467,280
060373008004,453,283,170,461,281,180,537,317,210,507,293,188
060373007015,792,450,342,815,448,367,1195,668,502,578,316,236
060373007011,328,211,117,338,211,127,525,314,203,433,263,152
060373007012,346,213,133,351,211,140,474,283,182,592,361,199
060373010001,479,344,135,488,341,147,575,349,210,463,305,130
060373010002,498,322,176,505,327,178,695,422,258,606,375,197
060373010004,420,275,145,432,279,153,633,381,240,454,275,158
060373011001,342,225,117,347,226,121,488,322,157,353,229,109
060373019011,608,429,179,617,430,187,1123,668,438,832,538,246
060373019021,425,303,122,435,309,126,672,415,249,577,388,163
060373019022,366,254,112,376,257,119,528,320,204,399,260,118
060373007013,427,250,177,438,250,188,659,392,253,571,325,221
060373007021,1180,655,525,1225,653,572,1679,908,751,1322,734,531
060373007022,1109,637,472,1139,646,493,1626,855,744,1433,707,664
060373011003,511,339,172,522,340,182,705,458,222,448,277,150
060373011004,211,148,63,212,148,64,342,214,127,228,143,75
060373011005,407,295,112,411,293,118,631,355,265,444,287,137
060373011006,447,320,127,450,318,132,780,439,328,647,399,215
060373011002,376,247,129,382,249,133,526,350,170,425,274,131
060373016011,245,193,52,251,193,58,486,248,228,371,245,101
060373016014,219,167,52,228,168,60,439,220,208,351,235,94
060373015011,223,152,71,226,152,74,342,171,165,241,151,75
060373015021,436,285,151,442,283,159,839,454,366,561,339,186
060373015023,277,204,73,284,203,81,641,309,316,441,295,116
060373015024,177,126,51,182,129,53,421,202,207,273,181,74
060373012031,523,362,161,537,369,168,851,509,320,723,450,233
060373012032,722,498,224,738,497,241,1035,594,420,881,517,307
060373013001,408,231,177,412,233,179,506,273,229,366,210,135
060373013002,462,275,187,475,279,196,680,360,306,597,342,224
060373014002,487,309,178,494,318,176,679,348,315,611,337,244
060373014003,207,123,84,210,120,90,294,150,142,276,152,109
060373023022,248,195,53,253,195,58,474,300,164,310,223,73
060373023023,176,138,38,180,139,41,352,222,122,325,234,76
060373024011,268,219,49,272,218,54,463,282,170,405,293,94
060373024012,378,306,72,384,303,81,531,330,191,439,318,103
060373015012,260,160,100,265,155,110,371,187,181,371,207,139
060373022023,222,171,51,227,169,58,449,272,170,304,201,83
060373025033,168,125,43,169,120,49,322,173,143,196,123,60
060373025042,119,92,27,120,90,30,254,153,95,177,117,49
060373025052,94,73,21,96,71,25,255,167,82,141,93,39
060373012052,486,317,169,496,313,183,742,415,318,539,311,191
060373012063,298,194,104,305,189,116,491,285,195,399,250,127
060373022021,223,162,61,228,163,65,460,224,227,371,241,113
060373022022,293,218,75,300,218,82,722,367,348,507,324,159
060373012051,265,175,90,269,173,96,377,207,165,342,190,127
060373012041,370,280,90,382,281,101,654,415,227,510,347,132
060373012042,361,269,92,372,272,100,565,346,208,430,290,115
060373025051,285,223,62,285,223,62,684,449,219,464,347,86
060373025053,252,198,54,251,195,56,469,303,155,299,223,55
060373025062,387,312,75,388,301,87,563,374,178,387,287,77
060373017021,324,227,97,331,227,104,669,371,288,435,269,146
060373017022,355,247,108,363,247,116,625,347,273,451,284,147
060373017024,204,141,63,210,142,68,404,224,176,271,173,87
060373012061,357,238,119,371,236,135,736,391,332,489,308,148
060373012062,290,191,99,297,184,113,530,308,207,437,277,134
060373012064,264,176,88,273,176,97,545,296,238,303,192,93
060373023021,251,196,55,251,181,70,438,276,151,396,274,106
060373023024,216,170,46,217,157,60,449,281,160,235,162,62
060373024014,239,187,52,241,174,67,310,197,108,308,215,82
060373018021,581,450,131,587,433,154,1073,667,384,614,410,163
060373018022,458,344,114,465,336,129,958,581,355,519,342,148
060373016021,644,496,148,648,491,157,1048,743,283,772,556,160
060373016022,285,218,67,286,212,74,361,257,98,328,243,68
060373016023,338,257,81,336,250,86,469,337,129,387,289,81
060373024013,336,278,58,343,278,65,583,378,194,296,218,69
060373024015,121,101,20,126,101,25,272,175,90,212,153,51
060373017011,426,296,130,432,292,140,580,327,250,519,342,149
060373018013,302,213,89,307,212,95,462,292,159,384,255,108
060373020041,414,317,97,424,313,111,748,458,276,569,392,148
060373021031,262,190,72,268,187,81,547,305,232,359,235,105
060373021032,386,277,109,395,276,119,785,462,309,548,343,178
060373018011,186,135,51,189,134,55,530,339,179,265,175,76
060373018012,670,489,181,686,489,197,1238,801,410,685,457,189
060373020021,248,175,73,254,178,76,402,239,158,259,162,81
060373023012,477,354,123,489,348,141,883,560,307,657,444,173
060373017023,223,155,68,231,157,74,514,283,223,286,183,93
060373016012,310,213,97,313,210,103,595,344,238,337,228,93
060373017012,504,339,165,506,334,172,772,454,310,626,391,198
060373016013,299,207,92,304,207,97,569,290,265,413,285,106
060373023011,327,243,84,335,238,97,600,374,213,492,336,128
060373010003,330,225,105,333,225,108,574,351,209,512,329,152
060373025061,143,117,26,144,112,32,247,163,78,185,137,38
060373025063,336,275,61,342,265,77,408,242,161,389,286,80
060373021022,304,235,69,312,228,84,568,384,172,386,259,105
060373021023,317,246,71,326,238,88,535,317,212,480,323,130
060373021024,343,264,79,351,264,87,455,311,137,418,291,104
060373021025,414,318,96,424,319,105,483,331,146,387,267,97
060373025031,276,200,76,280,193,87,567,286,271,328,194,108
060373025032,217,158,59,220,152,68,406,232,167,290,172,96
060373021033,280,199,81,290,202,88,664,352,305,399,254,126
060373025041,408,295,113,415,287,128,638,365,261,590,385,173
060373025043,121,88,33,122,84,38,246,140,102,241,157,70
060373021021,490,368,122,497,368,129,836,546,274,573,394,155
060373021042,290,221,69,295,220,75,496,303,185,390,272,100
060373020042,397,319,78,410,316,94,684,399,275,555,401,126
060373022011,171,121,50,177,124,53,292,144,146,263,173,77
060373022012,238,170,68,246,172,74,397,193,196,407,264,120
060373020031,435,328,107,450,329,121,826,480,333,601,392,167
060373020023,153,105,48,158,110,48,289,166,119,233,141,77
060373022013,427,310,117,437,309,128,647,371,266,463,297,135
060373020032,176,137,39,184,136,48,355,188,159,237,151,68
060373021041,203,161,42,205,157,48,253,156,90,200,146,44
060373021043,370,295,75,376,288,88,619,388,220,514,375,114
060373020022,500,344,156,507,351,156,810,477,318,630,386,201
060373019012,627,444,183,636,442,194,946,580,346,784,506,233
060373009011,805,454,351,831,457,374,1159,639,504,937,520,372
060373009012,523,312,211,530,309,221,702,403,285,564,327,207
060373009013,567,329,238,575,330,245,894,500,375,525,288,208
060373009021,500,336,164,513,329,184,510,329,170,436,273,143
060373009022,788,529,259,807,518,289,805,521,268,660,413,220
060374607002,332,189,143,334,181,153,436,257,176,356,209,133
060374608002,861,510,351,866,503,363,1087,706,358,880,550,265
060373012043,346,265,81,362,268,94,683,386,282,486,327,124
060374005011,1122,398,724,1141,400,741,1214,518,674,1041,335,648
060374008011,416,175,241,426,177,249,496,237,248,464,197,241
060374008013,539,249,290,547,247,300,910,434,453,561,238,281
060374010022,697,327,370,709,327,382,894,415,456,727,324,348
060374010023,483,241,242,486,233,253,758,384,350,595,277,269
060374012011,649,310,339,662,303,359,776,390,367,723,317,345
060374004041,931,315,616,952,304,648,1341,543,769,1128,342,718
060374004043,768,245,523,786,246,540,1082,417,637,843,260,534
060374010011,662,245,417,675,233,442,914,371,518,705,262,408
060374010012,505,207,298,519,207,312,638,279,348,580,241,310
060374010013,373,139,234,380,134,246,419,180,231,380,143,217
060374011022,355,184,171,366,182,184,580,307,259,441,205,197
060374011021,404,213,191,423,210,213,864,438,401,490,230,220
060374039013,352,198,154,356,194,162,437,247,176,408,210,173
060374004022,812,355,457,828,349,479,1315,599,686,978,411,495
060374011011,385,173,212,393,171,222,565,252,298,439,192,216
060374012012,643,260,383,666,262,404,853,426,401,879,349,463
060374011012,297,151,146,305,150,155,701,379,303,483,253,193
060374011014,599,321,278,613,316,297,754,394,340,454,237,180
060374039021,266,136,130,273,131,142,379,196,177,316,153,135
060374039022,596,306,290,613,298,315,1009,535,463,692,338,301
060374012032,906,466,440,934,458,476,1439,782,632,1213,584,551
060374012022,429,227,202,439,224,215,591,306,274,480,245,199
060374012031,965,505,460,986,502,484,1351,721,609,1124,535,513
060374039012,309,183,126,314,174,140,492,286,193,385,224,139
060374039023,588,350,238,596,339,257,934,542,371,661,354,263
060374010021,497,220,277,506,222,284,747,334,400,591,258,298
060374011013,490,218,272,498,216,282,701,318,356,600,244,309
060374012023,724,404,320,739,373,366,1034,534,477,873,455,371
060374004021,970,388,582,985,377,608,1412,607,777,1183,428,686
060374004042,512,174,338,519,170,349,664,257,397,706,220,441
060374011023,259,132,127,263,131,132,496,264,222,431,223,181
060290060112,539,123,416,546,121,425,696,177,506,482,92,370
060375016001,1255,739,516,1263,718,545,1642,1002,606,1282,775,421
060374086282,452,278,174,468,284,184,612,362,243,511,315,172
060374086283,319,197,122,333,201,132,678,401,268,515,320,173
060374086291,463,282,181,478,289,189,785,452,322,527,325,180
060374086231,876,557,319,901,547,354,1265,817,426,855,564,261
060374086241,650,388,262,671,382,289,975,608,353,916,558,309
060374084011,629,471,158,636,466,170,890,604,270,737,530,172
060374084012,557,415,142,566,394,172,893,604,262,648,463,145
060374085032,450,269,181,459,258,201,629,369,251,500,310,171
060374085034,602,335,267,616,326,290,954,555,378,653,373,246
060374085033,723,393,330,741,385,356,1083,641,426,848,479,327
060374091003,401,302,99,408,286,122,574,391,165,539,389,123
060374091001,194,149,45,196,142,54,286,201,76,260,188,56
060374091002,343,260,83,348,250,98,501,351,142,406,294,89
060374086313,608,413,195,617,401,216,967,641,299,758,489,222
060374086311,462,306,156,469,296,173,745,498,230,513,343,144
060374086242,362,214,148,368,214,154,538,330,203,397,235,144
060374086252,453,272,181,459,269,190,672,410,255,482,284,175
060374086312,378,268,110,388,265,123,644,430,199,473,330,101
060374085031,582,339,243,595,330,265,648,405,230,752,438,277
060374086251,465,270,195,475,271,204,665,406,250,503,297,183
060374086253,579,340,239,598,342,256,944,576,356,687,414,245
060374086281,678,381,297,706,394,312,880,535,331,580,358,189
060374091004,362,271,91,367,254,113,586,395,178,410,294,97
060374086292,504,303,201,521,308,213,784,480,297,627,379,223
060374084021,510,339,171,522,329,193,790,500,272,549,358,168
060374084022,566,340,226,575,328,247,747,456,278,650,382,242
060374085051,470,291,179,479,294,185,669,403,252,568,364,172
060374085052,458,289,169,463,285,178,674,400,261,486,311,149
060374085041,392,267,125,395,257,138,720,477,220,457,304,134
060374085043,299,204,95,299,195,104,603,380,209,377,253,110
060374084023,1003,687,316,1019,662,357,1509,987,500,1145,783,307
060374085042,554,352,202,570,343,227,935,587,326,630,393,197
060375551062,376,281,95,379,269,110,548,387,146,415,321,72
060375551061,251,189,62,256,184,72,440,311,115,332,254,58
060375552121,413,327,86,420,317,103,788,560,206,536,417,85
060375552111,316,263,53,316,245,71,506,382,121,346,285,48
060375552113,424,347,77,426,325,101,713,529,159,488,385,72
060375552112,323,275,48,324,257,67,467,340,118,385,317,50
060376021041,555,489,66,556,483,73,980,792,164,748,649,65
060376021042,534,468,66,537,461,76,876,703,158,713,618,64
060376021051,437,383,54,450,381,69,696,588,107,376,316,44
060376021052,436,381,55,437,379,58,680,552,127,485,409,50
060376021032,352,305,47,353,298,55,551,438,96,479,382,66
060376022022,323,274,49,326,267,59,576,446,113,431,348,56
060376021061,575,482,93,574,460,114,1039,801,209,791,657,97
060376021063,301,243,58,304,232,72,302,239,61,255,205,40
060376023023,344,214,130,355,213,142,1244,919,300,388,237,127
060376025071,474,427,47,482,424,58,915,750,140,615,538,54
060376025072,388,353,35,398,348,50,701,568,114,532,467,46
060376020021,250,227,23,254,229,25,429,357,70,343,313,21
060376020022,417,377,40,427,379,48,641,519,102,480,427,33
060376024031,257,226,31,261,229,32,417,328,77,301,260,26
060376024032,425,370,55,426,365,61,582,463,101,491,413,54
060376024033,345,289,56,352,284,68,530,392,123,495,401,66
060376024041,366,298,68,377,293,84,508,378,118,488,388,71
060376024043,503,424,79,510,417,93,971,719,227,602,500,68
060376025052,233,204,29,233,200,33,446,354,78,331,290,27
060376024042,382,310,72,390,304,86,562,417,131,445,358,64
060376021031,399,351,48,399,342,57,848,663,160,587,515,44
060376024021,360,289,71,376,287,89,496,372,104,444,350,72
060376024022,452,356,96,463,354,109,688,494,174,542,415,97
060376017002,231,207,24,233,202,31,375,296,71,316,284,21
060376017001,245,222,23,249,217,32,422,333,80,352,319,23
060376021033,531,470,61,535,459,76,767,621,133,659,576,55
060376024024,421,314,107,422,305,117,581,426,142,517,369,116
060376024025,472,345,127,476,333,143,534,401,127,561,391,132
060376025101,307,273,34,313,274,39,529,426,91,332,291,26
060376025102,360,320,40,363,316,47,534,418,104,399,346,37
060376025112,295,262,33,300,266,34,544,444,85,402,352,31
060376025111,374,330,44,376,329,47,623,507,100,461,402,43
060376025041,549,494,55,560,496,64,742,603,116,499,444,33
060376025051,388,346,42,396,346,50,633,501,109,740,642,66
060376023015,3,2,1,4,2,2,0,0,0,0,0,0
060376039012,408,314,94,411,311,100,588,453,129,512,393,99
060376023021,359,222,137,369,222,147,424,273,139,377,231,122
060376023022,340,206,134,350,206,144,465,302,153,367,227,118
060376023024,709,460,249,724,459,265,926,639,261,783,484,248
060376025131,339,300,39,347,309,38,619,506,87,479,424,39
060376022021,311,247,64,317,242,75,517,386,117,450,353,74
060376027001,850,799,51,866,809,57,1163,1060,82,783,729,35
060376027002,1056,976,80,1065,980,85,1179,1078,83,1259,1146,64
060376037051,664,597,67,663,579,84,1051,870,162,870,732,96
060376021062,524,436,88,506,409,97,822,627,174,672,543,92
060376024023,398,305,93,396,301,95,615,447,157,480,351,100
060376025042,317,284,33,320,283,37,440,363,65,364,317,31
060376025061,390,354,36,395,358,37,672,571,89,355,318,22
060376037031,504,333,171,512,328,184,834,553,273,591,415,137
060376037032,386,257,129,393,252,141,598,387,191,446,281,137
060376025062,468,425,43,466,420,46,830,704,110,505,442,42
060376210056,502,320,182,514,321,193,675,465,199,562,338,175
060376210051,344,218,126,339,208,131,488,336,145,413,252,126
060376210053,418,265,153,430,267,163,548,370,164,453,283,132
060376210055,352,225,127,353,220,133,503,344,149,436,269,131
060376210054,479,303,176,484,300,184,598,404,179,521,326,157
060376210052,699,444,255,715,437,278,913,618,265,800,488,248
060376211042,320,205,115,332,210,122,463,314,135,380,239,107
060376211043,391,251,140,396,248,148,566,388,166,438,266,130
060376211045,438,279,159,448,281,167,553,378,160,456,278,135
060376211044,1028,694,334,1065,704,361,1381,934,399,1170,766,302
060376208023,500,297,203,516,298,218,718,470,230,576,342,202
060376210013,951,630,321,966,638,328,1267,905,330,1061,676,302
060376211041,757,534,223,777,537,240,1169,809,315,956,644,234
060376212042,296,190,106,300,188,112,310,196,107,193,111,73
060376210012,589,405,184,598,404,194,773,552,203,600,400,153
060376210011,594,393,201,609,398,211,787,565,204,687,452,175
060376211021,565,375,190,580,382,198,775,549,204,638,419,163
060376211022,941,659,282,958,658,300,1321,932,347,1047,721,260
060371373022,1273,792,481,1289,788,501,1808,1169,607,1431,930,442
060371370002,1250,823,427,1263,813,450,1685,1037,616,1357,903,404
060375335042,242,211,31,246,208,38,414,325,82,290,258,21
060375335043,218,192,26,225,190,35,339,264,68,242,212,18
060375335041,207,181,26,213,179,34,385,303,75,284,251,21
060375331032,244,217,27,242,201,41,386,319,52,313,270,19
060375331031,150,133,17,150,125,25,304,248,41,257,221,16
060375325003,331,296,35,334,288,46,398,317,70,387,340,27
060375331051,322,287,35,324,281,43,533,441,86,413,377,25
060375332011,134,121,13,137,121,16,290,233,49,171,155,10
060375332012,269,240,29,269,228,41,434,349,72,337,297,25
060375326072,194,178,16,192,168,24,218,176,37,149,130,12
060375326075,147,134,13,151,132,19,222,191,30,221,197,16
060375326073,126,113,13,127,111,16,207,175,30,218,187,17
060375326074,132,120,12,135,118,17,182,155,27,189,167,15
060375326071,264,238,26,266,231,35,447,363,77,362,315,26
060375326051,323,288,35,333,285,48,526,421,91,378,330,28
060375331041,159,140,19,160,137,23,317,252,59,204,176,17
060375331042,280,249,31,283,242,41,492,393,89,297,258,24
060375345011,334,294,40,340,284,56,486,387,91,420,353,41
060375345012,290,259,31,296,251,45,433,343,80,329,285,26
060375345022,434,385,49,437,370,67,690,557,121,595,504,58
060375326062,196,174,22,197,168,29,402,327,68,364,318,29
060375326063,150,133,17,150,128,22,301,244,48,294,255,22
060375331083,256,227,29,255,219,36,476,387,82,335,293,29
060375331081,263,237,26,265,230,35,442,347,83,299,257,27
060375331082,208,185,23,209,178,31,454,357,81,400,350,36
060375332041,242,215,27,238,204,34,296,244,52,287,248,25
060375332042,288,256,32,285,240,45,378,313,63,408,351,34
060375332043,293,265,28,292,256,36,536,425,102,430,373,36
060375345013,386,351,35,389,339,50,743,598,128,557,491,36
060375347002,456,410,46,469,397,72,709,576,123,595,510,48
060375355021,362,330,32,369,318,51,627,508,103,426,390,22
060375345021,401,358,43,406,343,63,661,538,107,547,469,53
060375335011,242,215,27,242,211,31,421,343,68,423,371,30
060375335012,249,224,25,249,217,32,356,286,63,300,263,19
060375325002,244,220,24,245,209,36,363,287,70,307,267,24
060375326052,245,217,28,250,209,41,421,337,77,304,268,22
060375326061,216,190,26,215,181,34,257,203,49,199,174,15
060375325001,105,96,9,106,93,13,184,148,35,177,157,13
060379800161,48,37,11,48,36,12,97,66,31,48,35,8
060374033262,240,136,104,243,138,105,324,188,130,299,184,103
060374082122,433,274,159,440,266,174,792,472,312,585,370,178
060374077012,446,372,74,456,365,91,554,415,130,503,392,82
060374077022,475,353,122,490,343,147,673,490,174,616,450,137
060374078021,19,9,10,20,9,11,22,8,12,28,8,18
060376008011,436,407,29,451,416,35,511,482,24,491,454,19
060376008014,455,420,35,470,428,42,563,529,32,507,476,20
060376009121,653,602,51,654,585,69,983,859,105,723,648,44
060376009122,555,514,41,560,507,53,855,734,96,750,674,43
060376009123,308,290,18,311,288,23,376,330,38,313,289,14
060376007023,846,791,55,866,800,66,1006,931,64,941,886,31
060376014022,355,295,60,363,295,68,414,340,65,402,337,43
060376014023,229,195,34,236,197,39,407,331,67,287,245,31
060376015011,249,229,20,252,228,24,380,321,49,354,311,23
060376015012,252,233,19,255,233,22,543,462,69,418,372,23
060376007031,1152,1095,57,1175,1118,57,1418,1341,64,1240,1161,51
060376008021,475,449,26,483,453,30,533,484,40,492,463,16
060376008022,375,354,21,382,357,25,457,419,36,396,371,13
060376008023,403,382,21,413,385,28,633,566,47,511,474,18
060376009022,363,332,31,380,339,41,694,615,62,425,388,21
060376009023,237,216,21,244,218,26,515,452,53,281,261,13
060376008012,421,401,20,443,414,29,553,516,24,479,452,17
060376007021,508,478,30,519,484,35,618,572,37,544,511,21
060376007042,805,735,70,817,737,80,1057,969,72,906,823,54
060376007041,715,663,52,736,671,65,944,892,50,825,769,28
060376012111,401,380,21,406,375,31,554,486,54,488,447,25
060376012112,381,357,24,390,356,34,581,507,60,464,424,24
060376007022,555,529,26,558,526,32,609,559,45,612,586,12
060376013023,523,488,35,535,490,45,523,477,36,415,382,24
060376013024,712,668,44,722,663,59,1195,1062,100,1215,1115,58
060376008013,364,345,19,372,349,23,448,421,26,391,369,11
060376006021,356,333,23,357,329,28,773,692,73,447,413,16
060376019001,478,449,29,488,452,36,809,704,86,560,520,18
060376006012,499,463,36,506,468,38,688,637,44,595,550,28
060376006013,417,380,37,417,379,38,464,424,29,434,395,25
060376005011,684,646,38,710,663,47,815,746,60,781,740,23
060376005012,546,506,40,559,518,41,702,632,57,654,600,35
060376010011,374,337,37,376,336,40,376,343,30,416,373,22
060376010012,597,551,46,609,566,43,694,616,59,617,559,34
060376042001,419,397,22,430,399,31,602,545,50,532,486,31
060376042002,523,490,33,525,493,32,634,570,55,592,551,24
060376042003,540,509,31,540,499,41,773,666,92,719,670,24
060376010023,652,604,48,655,607,48,839,748,75,756,697,33
060376010021,359,334,25,364,331,33,583,513,58,350,320,19
060376010022,480,438,42,489,434,55,780,680,79,614,553,36
060376011003,427,385,42,441,397,44,844,705,119,510,456,34
060376014011,635,592,43,635,574,61,834,727,88,661,597,44
060376014013,464,408,56,468,405,63,609,517,85,519,449,48
060376011002,437,414,23,439,412,27,605,537,54,534,489,13
060376017003,225,204,21,225,197,28,436,345,78,303,271,19
060376018012,393,364,29,394,357,37,658,541,102,495,446,27
060376018011,213,198,15,214,193,21,334,280,52,253,230,13
060376018023,240,215,25,240,211,29,336,282,48,223,196,18
060376019002,355,335,20,365,339,26,532,467,57,476,444,14
060376020032,520,491,29,523,473,50,734,635,87,704,639,33
060376012121,430,392,38,441,392,49,647,554,78,565,505,35
060376012122,314,284,30,318,282,36,427,371,53,347,308,23
060376014012,295,257,38,303,260,43,583,509,63,442,377,44
060376014021,396,351,45,405,351,54,615,509,102,470,415,40
060376011001,355,333,22,362,333,29,525,463,47,412,372,22
060376013022,677,627,50,685,630,55,940,845,76,697,635,34
060376012021,377,338,39,382,329,53,594,495,93,484,433,33
060376012023,282,246,36,285,241,44,438,365,65,384,339,29
060376012022,330,280,50,337,280,57,418,359,59,399,350,34
060376014024,254,222,32,256,223,33,402,329,68,316,272,29
060376012124,234,215,19,240,217,23,364,317,44,287,263,14
060376012123,374,341,33,375,336,39,635,541,78,500,452,29
060376013032,321,302,19,330,304,26,497,451,35,388,361,15
060376013033,589,549,40,601,554,47,955,851,82,728,669,28
060376013012,604,542,62,609,544,65,637,564,62,618,536,55
060376009024,775,717,58,786,717,69,978,882,77,773,707,37
060376013031,381,357,24,389,359,30,525,464,44,526,490,20
060376009021,368,338,30,368,334,34,556,476,67,476,432,28
060376009111,407,381,26,407,363,44,704,600,84,495,437,33
060376009112,713,653,60,718,644,74,908,784,106,761,666,49
060376013011,433,389,44,434,386,48,486,436,43,433,376,38
060377030023,1551,1423,128,1560,1419,141,1802,1675,115,1704,1543,114
060376013021,195,185,10,196,181,15,364,326,31,210,195,8
060376006011,305,287,18,310,292,18,410,377,25,394,367,14
060376020031,461,423,38,459,417,42,819,698,94,554,475,42
060376042004,410,383,27,413,377,36,840,747,75,553,508,27
060374600011,822,477,345,829,472,357,934,574,341,882,493,338
060374600021,826,466,360,835,460,375,1064,626,411,851,471,335
060374605011,903,505,398,909,495,414,1177,746,412,876,486,335
060374606011,716,401,315,725,397,328,860,516,329,726,406,276
060374606012,557,312,245,573,318,255,744,473,258,648,372,234
060374606013,835,464,371,855,465,390,1098,683,399,923,521,344
060374605012,489,271,218,487,263,224,638,406,222,524,287,202
060374605021,701,402,299,720,397,323,982,623,340,745,466,233
060374607005,787,415,372,802,413,389,1097,658,421,846,474,325
060374605013,1349,779,570,1375,777,598,1737,1112,596,1185,699,414
060374605023,782,469,313,802,467,335,1023,660,346,1139,701,378
060374605022,695,362,333,707,353,354,873,553,305,843,488,299
060374607001,386,198,188,393,194,199,517,322,188,441,236,181
060374607003,381,207,174,391,204,187,478,284,190,404,228,156
060374607004,683,328,355,697,326,371,903,552,333,805,412,343
060374606014,469,254,215,475,248,227,719,414,290,551,288,227
060373005033,513,322,191,525,307,218,847,507,326,616,365,203
060373001001,858,530,328,878,533,345,1027,663,347,701,408,250
060373001003,615,376,239,627,380,247,791,510,263,739,445,237
060373001004,771,469,302,786,471,315,1055,668,365,962,564,325
060373001002,525,322,203,536,323,213,718,450,251,748,442,267
060373002002,423,269,154,426,263,163,570,373,187,426,254,149
060373002003,265,171,94,265,168,97,474,317,149,333,198,120
060373002004,295,190,105,297,189,108,414,275,130,296,179,103
060373002005,595,359,236,597,358,239,959,594,333,715,440,235
060373002001,539,327,212,537,313,224,769,471,277,546,334,182
060373005011,589,360,229,609,374,235,857,517,324,657,392,220
060375002041,1073,437,636,1087,430,657,1303,577,705,1066,421,587
060375001003,339,132,207,341,125,216,434,197,230,316,125,176
060375001001,661,258,403,675,250,425,910,390,499,765,287,435
060375040022,325,168,157,326,162,164,527,288,228,415,209,171
060375040023,265,138,127,265,131,134,424,249,171,318,161,132
060375040024,302,148,154,308,148,160,401,230,160,305,146,139
060375040021,513,237,276,528,235,293,635,347,270,555,259,262
060375040025,513,245,268,523,246,277,650,367,270,568,264,265
060375037041,586,323,263,600,325,275,1124,618,489,685,423,244
060375037042,909,451,458,936,457,479,1339,718,600,1132,608,480
060375040011,471,247,224,484,249,235,670,363,294,620,327,247
060375040012,533,264,269,548,263,285,524,257,251,648,318,287
060375040013,455,241,214,458,226,232,936,462,452,536,247,248
060375038021,395,215,180,404,208,196,560,290,257,454,242,181
060375038023,902,478,424,920,464,456,1432,763,645,1112,594,454
060375037051,792,366,426,811,355,456,1107,549,544,937,407,474
060375037052,579,282,297,595,280,315,1039,516,508,697,387,280
060375036011,864,444,420,880,428,452,1353,714,612,1014,513,443
060375036021,641,320,321,650,304,346,853,449,388,713,335,331
060375036022,1051,477,574,1084,480,604,1347,658,664,1188,523,597
060375039022,525,292,233,529,282,247,805,427,354,636,340,252
060375039021,579,292,287,594,284,310,877,452,414,863,389,419
060375039023,560,279,281,572,267,305,820,411,385,563,289,232
060375039012,596,309,287,604,306,298,807,455,343,735,375,315
060375039024,2,1,1,2,1,1,9,6,3,6,3,3
060375039011,378,190,188,386,189,197,572,308,250,467,240,193
060375038022,387,198,189,389,190,199,556,288,256,490,266,200
060375038011,423,235,188,427,228,199,621,348,266,425,226,175
060375038013,493,268,225,499,263,236,893,467,407,591,311,245
060375038012,427,226,201,430,224,206,599,319,262,394,202,166
060375036012,311,187,124,314,180,134,502,276,213,378,214,141
060375036013,326,197,129,329,189,140,475,262,202,401,224,149
060375041011,736,506,230,736,481,255,1277,732,522,908,594,264
060375041012,395,275,120,397,260,137,683,426,244,545,362,147
060375041013,270,187,83,276,181,95,451,280,161,352,240,90
060374077011,228,172,56,229,167,62,482,334,136,422,335,57
060374077013,216,172,44,223,169,54,378,278,90,235,186,33
060374077023,285,226,59,293,222,71,395,287,97,461,350,87
060374077024,508,423,85,511,410,101,691,507,173,571,464,85
060374076022,249,191,58,254,186,68,407,277,122,233,176,48
060374076023,278,223,55,282,213,69,398,280,104,342,274,50
060374077021,355,260,95,356,250,106,656,447,196,376,270,85
060374075012,158,131,27,160,123,37,321,236,77,227,176,35
060374075013,227,180,47,225,169,56,422,298,117,312,226,59
060374076011,345,286,59,347,267,80,574,428,131,427,336,67
060374076012,250,208,42,254,197,57,453,336,106,325,256,49
060374072022,456,385,71,460,368,92,631,455,159,491,393,68
060374073014,219,186,33,220,180,40,409,292,111,321,257,48
060374076013,169,137,32,171,130,41,350,264,78,270,213,46
060374076021,197,156,41,198,150,48,430,300,111,239,181,43
060374076024,212,172,40,212,162,50,272,209,62,311,251,44
060374071022,380,318,62,385,306,79,790,589,169,625,509,83
060374071023,318,270,48,318,258,60,497,372,107,343,284,42
060374071011,243,198,45,250,188,62,344,251,86,289,228,47
060374071012,461,382,79,464,360,104,607,460,136,550,446,81
060374071021,356,289,67,362,272,90,492,360,119,417,326,68
060374069031,108,87,21,110,82,28,205,149,52,166,129,28
060374071013,402,338,64,404,321,83,647,486,143,522,430,73
060374072011,479,397,82,487,385,102,770,564,184,526,418,82
060374072012,311,258,53,317,254,63,564,429,125,384,307,59
060374072021,452,374,78,452,347,105,578,432,128,589,469,91
060372964023,423,305,118,429,300,129,522,359,154,520,351,143
060376099001,327,222,105,327,213,114,432,277,139,377,223,117
060376099002,254,174,80,254,166,88,394,254,130,339,204,106
060374089002,650,342,308,663,333,330,829,435,384,713,351,319
060374016011,485,236,249,493,233,260,586,309,272,576,250,307
060374016023,390,216,174,399,211,188,813,447,349,490,270,181
060374089001,789,436,353,804,422,382,1010,550,447,856,441,359
060374016021,1089,587,502,1119,587,532,1629,895,692,1231,623,509
060374017062,574,387,187,578,388,190,758,523,221,597,395,164
060374015001,788,468,320,808,457,351,1160,669,463,954,529,358
060374022003,913,598,315,925,575,350,1223,793,401,983,653,282
060374015002,710,395,315,726,384,342,953,536,400,888,446,380
060374002093,889,359,530,912,353,559,1085,459,606,867,354,465
060374002081,835,354,481,850,348,502,1049,457,571,1098,444,590
060374002071,983,396,587,1004,393,611,1532,700,807,1203,474,662
060374002072,675,288,387,678,277,401,900,424,456,595,262,299
060374016022,538,293,245,552,285,267,707,398,302,593,318,237
060374003043,514,266,248,522,257,265,689,361,311,589,296,262
060374015003,304,163,141,312,159,153,517,287,215,406,225,155
060374004032,739,349,390,757,341,416,1194,589,585,985,464,455
060374002091,672,259,413,685,251,434,862,370,478,719,284,392
060374002073,632,218,414,646,211,435,846,364,470,629,228,380
060374016013,649,313,336,658,308,350,1122,581,510,706,353,309
060374017061,630,382,248,645,388,257,1104,722,355,853,488,305
060377030022,735,651,84,746,654,92,879,794,77,738,662,63
060377031004,557,519,38,566,523,43,772,706,54,662,601,33
060377031005,430,398,32,436,401,35,639,588,39,493,442,32
060377030021,756,695,61,764,705,59,954,877,67,838,772,40
060375700031,372,209,163,384,211,173,537,304,214,450,259,164
060375700032,342,199,143,351,198,153,482,275,195,377,220,135
060375700033,357,223,134,359,216,143,612,348,248,453,272,154
060375550022,675,403,272,684,396,288,1051,652,378,764,428,275
060375700021,371,198,173,377,205,172,526,290,223,443,241,171
060375700023,442,247,195,450,248,202,599,328,251,524,280,204
060375700011,504,256,248,517,259,258,683,386,278,545,276,232
060375700012,297,150,147,307,153,154,513,291,213,357,179,153
060375700013,514,273,241,530,273,257,739,418,298,607,315,248
060375700014,336,179,157,345,178,167,602,340,247,449,234,183
060375700022,292,168,124,297,164,133,402,225,172,335,177,134
060375709011,513,260,253,528,264,264,803,453,336,627,318,270
060375708001,525,320,205,528,309,219,730,436,269,571,318,207
060375708003,468,279,189,477,277,200,638,398,222,534,304,188
060375708004,371,217,154,380,213,167,536,327,200,496,288,169
060375708005,377,221,156,386,217,169,538,328,201,415,251,138
060375709021,400,209,191,408,204,204,655,361,284,493,256,216
060375709023,460,240,220,472,236,236,683,372,297,543,280,234
060375709012,463,240,223,477,239,238,601,340,251,527,271,223
060375708002,529,307,222,538,307,231,633,410,210,600,332,229
060375709022,597,304,293,609,309,300,756,410,331,674,356,286
060375707012,751,588,163,763,577,186,1328,891,407,877,615,215
060375707015,854,581,273,875,569,306,1192,804,366,951,632,264
060375709015,426,227,199,435,215,220,579,300,267,480,244,210
060375709014,386,196,190,395,193,202,555,288,255,481,245,211
060375709013,631,310,321,643,309,334,932,483,427,725,326,355
060375700034,536,338,198,555,334,221,779,515,240,660,429,171
060375707011,279,179,100,284,176,108,456,305,140,344,217,96
060375707031,575,363,212,581,354,227,892,585,282,656,427,192
060375707032,820,570,250,831,570,261,1102,727,350,903,612,242
060375707013,265,166,99,272,165,107,322,224,97,271,173,81
060375707014,347,217,130,355,214,141,400,274,117,367,219,128
060375713002,480,292,188,485,283,202,545,340,196,489,291,170
060375713003,631,381,250,641,363,278,861,532,304,764,441,268
060375713004,307,187,120,312,180,132,442,261,172,375,216,133
060375713001,561,341,220,571,333,238,789,467,306,636,374,228
060375714001,451,291,160,467,287,180,743,505,231,571,344,190
060375720011,813,601,212,828,594,234,1051,779,244,841,584,200
060375714002,529,352,177,541,340,201,719,475,227,567,343,187
060375714004,553,348,205,569,339,230,784,495,274,635,389,206
060375714003,448,283,165,459,272,187,627,394,222,463,269,166
060375711011,285,143,142,296,142,154,411,217,187,339,158,158
060375711012,346,174,172,358,172,186,487,257,220,381,177,178
060375711015,318,160,158,329,157,172,421,226,188,352,164,163
060375711013,465,244,221,475,237,238,687,383,293,605,309,259
060375711014,553,289,264,560,279,281,745,413,317,626,324,262
060375710001,476,240,236,490,237,253,575,301,265,502,243,228
060375710006,566,286,280,577,278,299,728,378,334,615,300,277
060375710002,400,206,194,410,202,208,648,350,282,457,228,199
060375710004,338,169,169,344,166,178,534,283,237,424,210,190
060375710005,333,162,171,346,162,184,447,244,197,431,206,197
060375711023,406,229,177,413,229,184,546,302,232,447,254,162
060375711024,281,160,121,286,159,127,381,212,162,331,187,119
060375712011,481,259,222,493,260,233,634,370,250,539,283,222
060375711021,338,172,166,346,171,175,443,237,196,390,197,164
060375711022,376,191,185,382,188,194,586,319,246,428,221,183
060375711025,301,154,147,307,152,155,466,258,198,359,180,150
060375710003,439,228,211,444,222,222,675,367,296,491,251,211
060375737001,674,365,309,684,366,318,844,522,307,720,396,286
060375550011,419,273,146,425,257,168,596,371,213,471,288,150
060375550014,313,214,99,309,209,100,308,216,88,347,244,82
060375551053,274,202,72,278,196,82,534,372,148,368,268,75
060375551052,273,202,71,276,194,82,445,309,128,332,243,69
060375551051,373,273,100,378,264,114,757,520,216,434,333,81
060375551072,702,463,239,716,454,262,1047,680,343,797,496,249
060375550021,335,239,96,343,237,106,508,349,146,380,265,87
060375551071,364,255,109,375,255,120,417,304,112,353,234,93
060375550012,343,252,91,349,246,103,671,423,233,323,225,78
060375550013,386,283,103,392,276,116,837,579,234,625,439,149
060375551054,307,215,92,314,214,100,551,394,147,460,308,114
060379008051,497,274,223,508,276,232,575,329,226,497,241,215
060379008052,634,348,286,643,348,295,980,557,400,696,380,260
060379010082,192,116,76,197,117,80,410,233,167,250,138,95
060379008053,434,223,211,445,228,217,506,299,201,477,215,231
060379006061,574,389,185,579,380,199,885,596,259,712,467,197
060379006072,412,271,141,419,266,153,549,369,162,506,300,176
060379006062,148,103,45,151,103,48,307,215,92,245,178,53
060379006071,365,269,96,372,267,105,690,472,194,537,347,153
060379007012,261,167,94,261,160,101,396,234,149,361,211,128
060379007013,393,249,144,388,234,154,544,321,207,397,231,140
060379007031,308,198,110,317,202,115,805,405,379,453,240,178
060379007032,207,132,75,209,127,82,381,244,123,290,169,102
060379007033,425,273,152,426,261,165,684,437,220,518,304,181
060379005061,530,376,154,536,357,179,746,512,214,683,447,201
060379005062,515,365,150,521,345,176,865,579,260,745,496,208
060379005013,655,435,220,665,429,236,1088,719,329,941,636,242
060379005052,580,374,206,593,366,227,958,636,302,773,439,286
060379007011,278,175,103,277,167,110,492,288,187,426,245,153
060379007014,201,127,74,199,120,79,337,199,127,278,159,100
060379005041,364,226,138,370,219,151,641,395,237,478,289,163
060379005042,815,504,311,824,492,332,1192,723,434,757,437,277
060379005043,769,476,293,776,475,301,1087,658,395,817,473,313
060379005093,173,111,62,177,108,69,306,190,105,210,140,56
060379005103,257,175,82,265,171,94,377,239,124,257,160,79
060379005082,603,332,271,608,316,292,937,536,379,785,397,331
060379005081,552,341,211,569,335,234,783,445,316,781,428,300
060379006022,430,306,124,435,288,147,663,454,194,502,332,140
060379008082,347,226,121,353,223,130,624,415,188,447,272,147
060379008041,355,263,92,362,257,105,713,476,217,695,489,161
060379008042,238,175,63,240,171,69,428,285,129,387,274,89
060379010091,1017,394,623,1028,398,630,1228,570,627,1018,401,554
060379003011,826,434,392,837,420,417,1228,695,499,1238,500,682
060379006101,274,171,103,275,161,114,587,361,211,359,205,132
060379006111,656,461,195,669,457,212,1116,742,343,672,444,185
060379012151,766,295,471,777,289,488,946,379,553,852,294,513
060379009011,336,194,142,341,194,147,550,318,213,311,175,115
060379010121,505,268,237,508,266,242,898,497,382,537,263,242
060379011012,985,480,505,999,470,529,1676,786,854,1212,459,679
060379006021,364,260,104,367,244,123,667,454,193,508,334,143
060379010122,989,504,485,996,495,501,1725,919,754,1080,528,483
060379011023,752,294,458,747,283,464,959,384,556,861,333,473
060379006102,412,265,147,414,247,167,603,343,252,486,275,180
060379006112,268,173,95,269,160,109,423,280,131,245,160,74
060379006081,582,394,188,585,395,190,822,548,253,691,439,202
060379006082,329,222,107,331,222,109,450,300,138,354,211,113
060379008061,344,237,107,347,230,117,699,480,206,529,339,162
060379010092,257,145,112,261,141,120,444,241,191,327,168,137
060379005011,481,331,150,487,328,159,627,416,186,501,327,145
060379005051,527,352,175,538,354,184,629,426,199,553,371,156
060379008081,470,304,166,475,301,174,869,504,336,503,287,183
060379008071,717,442,275,729,441,288,1062,634,398,846,503,296
060379006091,244,180,64,247,178,69,372,249,107,383,249,114
060379006092,403,295,108,406,293,113,665,492,156,448,290,133
060379006093,384,282,102,392,282,110,636,467,148,483,335,118
060379007052,631,343,288,633,330,303,904,490,383,861,425,379
060379007051,551,251,300,555,246,309,520,291,213,398,212,159
060379007053,193,105,88,195,103,92,319,182,125,264,133,113
060379005012,437,306,131,445,305,140,748,496,222,581,396,152
060379010071,339,129,210,340,129,211,485,205,270,479,169,285
060379102111,798,311,487,794,306,488,1127,467,637,827,310,470
060379010101,447,225,222,451,223,228,671,353,303,623,277,310
060379010103,371,181,190,374,178,196,752,390,339,517,274,212
060379010104,351,172,179,359,171,188,457,238,205,534,223,281
060379010111,879,440,439,896,439,457,1304,635,638,989,458,467
060379010113,430,215,215,441,216,225,686,342,328,477,221,223
060379008062,449,310,139,448,300,148,861,591,245,587,381,170
060379010072,490,162,328,497,158,339,506,254,247,477,169,288
060379005101,248,179,69,253,178,75,466,319,134,284,181,88
060379005092,145,106,39,148,105,43,383,263,110,243,155,77
060379005102,295,203,92,300,197,103,451,291,144,341,226,96
060379005091,468,322,146,479,314,165,842,548,271,650,414,194
060379010081,587,337,250,597,336,261,575,319,239,799,379,366
060379010093,688,344,344,693,318,375,903,491,392,866,357,454
060379007041,441,315,126,444,311,133,765,439,297,545,327,181
060379007042,144,103,41,143,100,43,398,226,154,266,159,87
060379010141,546,250,296,548,245,303,775,388,363,534,225,272
060379010131,728,337,391,739,332,407,993,502,459,720,311,365
060379010142,953,511,442,969,510,459,1183,637,514,706,326,340
060379010102,438,227,211,445,228,217,782,398,365,653,294,320
060379012141,828,358,470,843,366,477,1402,659,712,969,398,527
060379010112,503,254,249,511,248,263,739,368,353,520,241,251
060379008072,496,277,219,506,279,227,809,480,307,637,346,245
060379012142,412,191,221,425,195,230,711,335,362,575,273,257
060379012152,805,337,468,821,346,475,1318,529,767,1028,361,611
060379010132,666,301,365,678,298,380,1078,547,498,859,391,419
060376039011,660,528,132,674,530,144,1029,781,224,819,643,127
060376039022,372,289,83,378,288,90,575,422,138,507,378,91
060376038012,194,147,47,199,148,51,301,222,74,232,175,41
060376038013,226,180,46,230,179,51,311,229,77,189,144,31
060376038021,528,397,131,539,402,137,905,651,229,609,457,106
060376038011,541,444,97,551,438,113,724,548,158,578,492,63
060376039021,475,374,101,483,369,114,640,465,156,522,388,92
060376040011,383,303,80,389,303,86,708,508,178,513,397,94
060376040012,383,299,84,392,299,93,582,410,155,472,342,99
060376041011,280,225,55,282,220,62,605,437,166,567,433,99
060376041012,263,209,54,271,208,63,465,324,125,352,269,63
060376041013,254,203,51,257,200,57,444,319,121,413,319,70
060376041022,347,258,89,351,256,95,562,391,151,400,282,92
060376041021,328,242,86,335,242,93,502,353,137,354,260,72
060376038022,392,289,103,401,291,110,640,454,171,517,399,88
060376040021,238,181,57,241,177,64,451,316,123,346,258,68
060376040022,469,358,111,477,351,126,805,567,215,562,425,113
060376040023,195,144,51,199,142,57,326,232,87,231,173,47
060376040013,201,148,53,203,144,59,286,205,78,215,159,43
060376040024,224,165,59,227,161,66,335,239,89,255,191,50
060376018022,225,205,20,227,201,26,398,324,64,309,276,21
060376018021,238,220,18,239,216,23,405,338,57,279,259,14
060376015021,388,353,35,397,343,54,665,554,87,454,417,20
060376016001,231,207,24,233,204,29,311,248,53,273,240,21
060376016002,303,271,32,305,267,38,485,404,66,381,334,29
060376016003,243,217,26,245,215,30,418,354,58,295,258,22
060376015022,152,137,15,154,132,22,294,248,40,174,163,7
060379102171,631,371,260,636,357,279,1103,659,415,603,350,210
060379100021,767,406,361,785,404,381,1280,682,554,995,506,419
060379100022,473,243,230,485,239,246,726,400,308,662,315,310
060379100023,484,262,222,487,249,238,590,308,261,523,245,241
060379800311,91,55,36,94,55,39,434,312,108,134,70,51
060379111002,504,350,154,508,338,170,703,464,235,600,378,175
060379111003,514,352,162,516,336,180,788,521,228,637,404,175
060379110012,274,75,199,276,74,202,406,133,267,346,94,235
060376700011,562,305,257,572,310,262,829,473,333,789,412,327
060376700012,674,383,291,692,393,299,925,528,373,593,315,225
060376510024,430,246,184,445,246,199,619,356,252,489,264,189
060376700031,219,119,100,220,110,110,352,195,151,322,168,130
060376700034,776,416,360,793,403,390,960,523,407,890,440,385
060376700032,510,298,212,516,298,218,796,471,303,624,327,243
060376700033,487,266,221,493,261,232,637,361,255,529,259,229
060376701021,737,464,273,750,461,289,1525,906,579,907,558,299
060376701022,349,227,122,354,225,129,653,383,250,312,193,101
060376702012,1263,598,665,1280,587,693,1701,917,751,1334,643,594
060376700021,408,242,166,416,239,177,636,380,233,604,351,207
060376700022,786,473,313,804,466,338,1182,704,443,918,530,328
060376701011,1029,608,421,1044,594,450,1049,648,386,1219,720,424
060376701012,257,156,101,264,157,107,417,251,158,436,260,157
060375704031,233,207,26,238,205,33,373,313,51,332,282,30
060375704032,283,259,24,281,249,32,458,389,65,327,291,22
060375704033,243,220,23,244,214,30,457,384,64,373,327,27
060375718001,711,472,239,721,471,250,893,603,269,691,437,209
060375704041,357,318,39,364,313,51,477,402,67,382,330,37
060375704042,389,347,42,392,340,52,596,492,80,507,430,44
060375759021,518,445,73,527,444,83,1098,889,176,643,503,91
060375759022,467,392,75,482,398,84,720,593,102,549,433,74
060375759023,410,350,60,423,352,71,703,584,100,620,500,79
060375704021,410,349,61,419,343,76,618,505,103,564,475,63
060375704023,351,299,52,359,294,65,548,464,70,447,362,57
060375702023,223,182,41,227,180,47,298,233,61,294,238,47
060375702025,439,362,77,443,349,94,784,587,164,615,507,75
060375758011,172,151,21,176,151,25,307,240,50,261,208,30
060375758012,140,123,17,143,120,23,216,164,32,192,151,21
060375758021,246,215,31,253,221,32,447,348,81,412,339,49
060375758022,502,438,64,510,430,80,684,565,104,500,401,58
060375760011,688,517,171,708,524,184,937,713,198,890,651,178
060375760013,831,692,139,849,694,155,1236,987,214,872,652,161
060375760012,559,418,141,562,420,142,1114,854,234,597,423,135
060375703061,357,291,66,361,292,69,491,392,94,373,298,56
060375703062,283,234,49,290,237,53,418,330,80,312,249,45
060375703031,314,262,52,319,260,59,473,369,90,396,319,58
060375703032,506,417,89,512,409,103,657,518,123,606,480,89
060375702022,243,202,41,247,201,46,387,301,77,335,276,44
060375702024,277,226,51,286,227,59,345,268,72,350,277,58
060375702021,165,139,26,167,138,29,249,192,49,234,195,28
060375702032,178,151,27,180,143,37,395,310,72,268,221,34
060375705021,324,251,73,333,248,85,675,514,143,431,333,68
060375705024,295,230,65,298,224,74,513,383,118,388,289,70
060375705042,532,424,108,541,421,120,816,604,179,679,529,113
060375730022,193,168,25,193,166,27,480,375,87,280,234,25
060375730042,167,143,24,169,139,30,333,266,58,207,174,22
060375732022,358,315,43,358,312,46,542,425,105,526,443,55
060375705041,455,366,89,458,353,105,644,491,144,518,410,80
060375732012,399,336,63,410,335,75,714,569,133,528,436,64
060375731011,338,284,54,343,275,68,530,400,110,312,253,40
060375705031,451,367,84,453,356,97,784,600,161,572,449,86
060375705032,368,301,67,370,290,80,569,423,128,454,347,76
060375705022,416,348,68,422,335,87,677,499,160,529,415,82
060375705023,312,242,70,313,233,80,412,305,102,409,310,72
060375731021,672,585,87,675,576,99,909,733,149,841,706,86
060375731013,302,267,35,307,265,42,453,360,83,363,313,32
060375702031,426,359,67,427,340,87,748,593,129,579,485,65
060375702041,324,253,71,329,246,83,461,353,102,340,269,54
060375702042,504,402,102,507,387,120,993,724,239,683,545,101
060375752021,241,203,38,243,194,49,472,370,89,372,315,40
060375752022,182,155,27,187,154,33,410,317,77,271,224,34
060375752023,126,102,24,125,98,27,231,183,43,169,140,20
060375701001,377,286,91,382,281,101,483,343,124,376,270,92
060375701002,457,342,115,466,330,136,700,500,184,659,475,150
060375730031,557,466,91,558,447,111,709,565,133,644,498,105
060375730043,223,192,31,220,186,34,345,287,51,243,191,31
060375730044,260,224,36,262,220,42,424,349,62,343,270,46
060375731022,353,298,55,355,291,64,487,388,98,419,334,62
060375703042,290,250,40,291,246,45,588,461,112,463,384,55
060375703043,225,192,33,229,190,39,331,261,63,287,234,35
060375717011,296,242,54,296,238,58,577,436,116,417,336,55
060375764011,198,166,32,205,167,38,393,307,72,276,233,24
060375764021,218,188,30,223,194,29,476,384,82,359,304,34
060375764031,305,263,42,311,267,44,522,411,96,349,295,34
060375703041,331,271,60,335,269,66,476,368,92,361,309,34
060375764032,395,348,47,401,340,61,773,611,133,491,397,55
060375706031,255,218,37,259,217,42,481,378,94,362,295,50
060375706032,419,373,46,430,374,56,738,643,77,540,485,30
060375706033,112,100,12,114,100,14,233,201,24,194,170,15
060375706024,224,175,49,229,172,57,455,335,116,318,256,44
060375715051,372,268,104,377,266,111,550,400,144,503,363,111
060375715052,525,388,137,533,388,145,678,476,184,657,471,143
060375719003,773,546,227,796,551,245,937,671,246,842,560,219
060375742022,416,275,141,420,263,157,782,485,280,524,330,158
060379800181,8,6,2,9,6,3,16,11,5,0,0,0
060375750011,527,379,148,531,369,162,780,499,258,564,360,159
060375764012,302,267,35,308,261,47,567,445,99,474,394,42
060375769011,254,220,34,260,216,44,470,362,91,372,305,42
060375769013,270,234,36,269,226,43,498,400,84,367,304,34
060375748002,610,382,228,615,381,234,731,519,197,652,368,231
060375770001,625,515,110,632,507,125,938,745,167,690,536,98
060375770002,645,534,111,659,528,131,1040,821,184,829,639,122
060375770003,520,430,90,530,431,99,743,588,128,605,446,95
060375770004,340,274,66,347,273,74,562,433,108,420,304,73
060375770005,280,212,68,284,209,75,377,272,98,280,193,63
060375765031,515,450,65,521,453,68,1001,862,111,617,506,61
060375745001,889,491,398,900,483,417,1213,706,475,973,517,381
060375745004,816,490,326,833,487,346,1047,636,388,875,495,322
060375715022,385,291,94,388,286,102,619,453,148,350,251,83
060375715023,564,411,153,565,403,162,979,694,258,715,505,171
060375715021,483,360,123,489,356,133,606,421,165,495,351,123
060375717032,235,185,50,244,185,59,375,277,89,300,249,35
060375717033,289,228,61,297,227,70,472,343,111,261,214,37
060375717031,169,131,38,175,132,43,345,251,82,278,231,31
060375717012,361,288,73,364,286,78,663,510,135,455,369,63
060375736013,392,221,171,389,208,181,535,310,207,433,238,162
060375736014,0,0,0,0,0,0,12,7,5,0,0,0
060375736015,0,0,0,0,0,0,0,0,0,0,0,0
060375741004,557,310,247,562,300,262,712,427,278,644,348,250
060375741005,529,295,234,535,286,249,688,405,265,585,323,225
060375719001,714,525,189,726,518,208,878,651,212,839,606,181
060375719002,563,391,172,574,390,184,796,560,212,599,419,142
060375722023,293,222,71,300,221,79,448,329,115,326,246,60
060375722021,387,290,97,395,287,108,523,386,129,442,326,89
060375722022,334,252,82,337,250,87,394,290,102,384,282,83
060375762003,347,296,51,351,296,55,518,426,77,374,286,54
060375762005,536,456,80,548,455,93,683,555,101,439,341,62
060375722013,740,540,200,749,544,205,1052,732,292,887,622,209
060375722014,646,482,164,653,468,185,867,624,214,746,539,167
060375720012,555,414,141,557,408,149,764,574,171,610,432,139
060375720014,577,434,143,575,428,147,754,575,170,695,481,166
060375779004,823,621,202,827,609,218,1108,821,267,931,688,194
060375720013,539,391,148,550,384,166,701,509,170,626,409,167
060375779002,481,346,135,489,340,149,663,491,159,542,364,146
060375732021,244,213,31,247,211,36,443,341,90,359,299,40
060375758031,305,245,60,310,250,60,347,271,66,377,289,64
060375763011,266,215,51,267,216,51,376,298,71,273,210,44
060375763014,130,105,25,132,107,25,174,136,38,192,147,32
060375751011,295,260,35,297,254,43,717,569,126,405,322,54
060375777002,372,325,47,376,319,57,583,441,131,474,409,46
060375777001,368,329,39,374,324,50,507,386,109,465,394,48
060375725001,344,274,70,353,272,81,498,377,109,494,396,75
060375725002,454,394,60,459,380,79,695,528,154,385,304,57
060375777003,428,370,58,433,362,71,669,518,136,592,505,58
060375726001,424,348,76,424,331,93,625,456,159,500,398,73
060375726002,434,333,101,439,321,118,759,554,193,554,424,94
060375727001,255,206,49,258,204,54,424,314,100,325,258,51
060375727003,292,237,55,298,236,62,441,332,107,330,266,53
060375727002,383,289,94,389,292,97,631,448,162,569,440,98
060375726003,294,231,63,299,229,70,532,389,131,425,322,74
060375726004,158,124,34,161,123,38,304,221,76,219,165,38
060375722024,150,114,36,150,112,38,395,277,103,199,155,33
060375731012,245,205,40,243,196,47,393,299,82,310,251,41
060375780001,280,239,41,287,237,50,475,369,91,363,303,41
060375780002,233,199,34,237,195,42,599,468,113,348,303,35
060375767001,715,575,140,733,576,157,838,663,159,753,561,132
060375767003,866,708,158,886,715,171,1142,918,195,1055,817,162
060375768012,497,423,74,509,430,79,610,502,92,499,394,71
060375768022,789,673,116,805,673,132,1099,912,162,950,743,129
060375730021,258,229,29,267,228,39,527,424,96,325,286,21
060375730041,241,203,38,241,194,47,430,341,75,278,230,32
060375771004,811,665,146,824,664,160,973,795,155,872,656,145
060375771005,668,551,117,678,548,130,861,705,132,824,633,129
060375753002,207,187,20,211,188,23,345,260,73,253,224,18
060375753003,263,235,28,269,238,31,447,337,94,324,290,22
060375753001,185,170,15,192,172,20,330,256,68,268,228,24
060375703051,495,417,78,512,407,105,760,586,154,689,554,104
060375703052,74,63,11,74,60,14,379,293,76,261,211,39
060375764022,436,389,47,442,387,55,708,585,102,579,483,60
060375732023,404,357,47,415,355,60,720,553,150,529,444,57
060375733001,414,351,63,419,349,70,793,593,177,562,454,71
060375733002,176,145,31,176,144,32,287,226,59,219,178,30
060375768011,405,362,43,407,352,55,540,453,69,432,352,43
060375768013,803,692,111,820,697,123,1141,951,161,936,735,125
060375752011,178,154,24,185,154,31,326,254,63,243,208,26
060375752012,220,184,36,228,191,37,441,340,92,325,266,44
060375752013,313,266,47,323,270,53,541,424,110,430,362,47
060375765022,361,322,39,365,322,43,390,342,39,416,342,36
060375765023,353,315,38,358,315,43,423,351,59,318,263,27
060375749011,414,266,148,422,264,158,586,368,204,445,284,133
060375749012,413,267,146,422,266,156,539,340,188,437,280,131
060375763023,295,240,55,301,234,67,440,346,83,410,327,51
060375769031,383,335,48,391,335,56,605,492,93,472,381,51
060375769032,356,311,45,358,304,54,591,480,91,418,345,36
060375751031,369,330,39,369,316,53,596,489,83,509,402,61
060375751032,487,416,71,494,405,89,723,584,113,598,474,73
060375751033,286,230,56,293,230,63,493,379,95,409,322,53
060375750022,642,513,129,656,508,148,796,607,169,716,518,137
060375750023,480,365,115,492,364,128,553,414,126,541,381,112
060375732011,332,288,44,333,283,50,675,533,121,458,380,60
060375754011,55,48,7,57,50,7,144,115,29,90,79,10
060375754012,144,125,19,147,127,20,304,232,56,188,158,19
060379800111,16,15,1,17,16,1,24,21,3,9,9,0
060379800331,25,21,4,25,21,4,39,33,6,70,52,12
060375765012,451,391,60,463,389,74,531,448,66,656,503,86
060375766012,617,516,101,630,512,118,838,678,145,954,720,169
060375766013,630,528,102,642,520,122,916,731,160,711,547,109
060375771003,506,395,111,514,391,123,624,489,125,532,380,108
060375772004,772,613,159,784,606,178,1097,858,207,821,603,150
060375772002,518,396,122,526,392,134,764,604,146,637,449,135
060375772003,594,453,141,600,444,156,762,594,149,611,431,120
060375763021,148,126,22,150,128,22,277,227,50,207,164,22
060375763022,117,102,15,118,103,15,213,175,36,196,153,24
060375723011,448,372,76,455,362,93,866,662,181,637,515,84
060375766011,479,382,97,491,378,113,725,578,132,455,340,83
060375766021,596,457,139,600,450,150,773,639,109,543,402,105
060375766022,397,322,75,401,319,82,484,397,68,381,293,58
060375766024,367,307,60,371,306,65,535,432,93,519,401,81
060375766023,349,301,48,358,303,55,464,384,67,370,297,46
060375745003,555,300,255,565,296,269,671,416,243,576,304,238
060375746021,649,338,311,665,331,334,542,326,200,775,392,338
060375718003,294,195,99,298,191,107,485,338,137,355,228,102
060375719004,690,451,239,699,448,251,817,577,221,740,467,212
060375772001,731,564,167,740,561,179,926,733,173,810,571,182
060375771001,695,533,162,710,538,172,959,742,192,692,529,110
060375771002,614,468,146,628,474,154,759,584,150,681,491,150
060375768021,811,697,114,822,697,125,974,825,124,885,699,115
060375769041,460,401,59,460,387,73,740,612,108,584,474,69
060375769042,473,416,57,477,406,71,652,537,95,531,431,57
060375769012,476,406,70,478,395,83,535,429,96,542,425,69
060375758032,312,268,44,313,267,46,444,359,76,366,289,57
060375750021,507,393,114,518,398,120,699,531,144,652,445,146
060375776051,1027,507,520,1040,507,533,1318,829,466,1096,628,392
060375776052,1054,541,513,1068,542,526,1315,699,593,1131,567,508
060375776062,963,672,291,979,674,305,1309,933,352,1037,673,302
060375776053,668,377,291,685,376,309,748,458,273,686,388,248
060375776021,838,538,300,849,525,324,1119,714,383,823,524,256
060375776022,969,516,453,980,504,476,1075,651,409,982,528,388
060375774001,413,265,148,419,265,154,484,326,151,452,293,128
060375774002,315,205,110,322,207,115,448,300,142,346,224,99
060375776061,863,570,293,879,571,308,1056,707,318,907,596,247
060375773001,333,227,106,339,227,112,512,362,132,403,263,115
060375773002,518,369,149,523,364,159,745,534,193,579,391,150
060375773003,330,236,94,334,231,103,508,361,130,403,275,99
060375773004,576,397,179,590,400,190,721,492,213,585,377,167
060375774003,435,293,142,442,292,150,606,394,193,584,358,176
060375774004,474,286,188,487,286,201,622,409,202,536,312,185
060375773005,520,341,179,531,344,187,648,379,251,515,304,175
060375775041,396,198,198,401,198,203,402,241,158,425,220,182
060375773006,324,213,111,334,216,118,412,255,145,347,217,106
060375775012,699,326,373,711,326,385,806,456,339,711,349,321
060375775013,638,314,324,657,319,338,704,405,289,665,338,287
060375775042,355,180,175,359,177,182,462,272,182,461,237,197
060375748001,459,275,184,464,277,187,357,218,135,370,205,136
060375748003,492,295,197,498,296,202,416,271,135,561,342,177
060375754013,217,185,32,218,185,33,485,377,92,324,275,32
060375743005,502,291,211,513,289,224,600,369,215,529,294,209
060375743006,559,325,234,571,322,249,705,433,253,580,324,227
060375749013,524,309,215,534,305,229,642,402,223,584,342,206
060375749014,554,326,228,566,324,242,733,459,256,609,357,216
060375767002,409,315,94,418,314,104,509,392,105,372,259,82
060375742011,470,269,201,483,266,217,552,340,204,513,286,191
060375742012,465,265,200,477,262,215,497,305,183,488,271,180
060375742013,553,339,214,568,332,236,764,484,262,674,394,230
060375742021,321,198,123,329,192,137,449,285,155,371,218,126
060375743003,495,297,198,506,289,217,694,434,243,558,314,210
060375743004,552,329,223,567,327,240,712,445,249,622,348,237
060375744004,659,366,293,673,363,310,865,526,318,716,373,283
060375715042,285,223,62,287,218,69,576,424,141,335,258,59
060375743001,429,245,184,432,240,192,520,323,189,477,260,184
060375743002,447,255,192,451,248,203,590,363,213,470,260,182
060375727004,302,230,72,306,234,72,455,325,127,464,355,88
060375780004,234,170,64,239,176,63,659,456,187,334,250,59
060375740001,543,367,176,550,366,184,688,443,228,592,372,186
060375740002,444,301,143,449,300,149,563,363,186,471,296,149
060375740004,510,299,211,516,304,212,691,446,229,552,310,204
060375740005,869,503,366,893,512,381,1006,631,354,924,514,342
060375706012,484,371,113,489,355,134,750,562,158,635,491,103
060375706023,281,211,70,284,202,82,313,219,76,322,244,54
060375738001,580,330,250,589,316,273,816,474,324,668,366,256
060375738002,580,330,250,594,319,275,797,462,316,716,395,286
060375738003,507,272,235,519,275,244,627,380,234,551,280,231
060375738004,476,255,221,487,259,228,623,381,228,500,272,194
060375740003,504,291,213,524,296,228,628,385,228,551,302,205
060375741001,395,241,154,409,242,167,567,342,209,440,270,138
060375765032,622,543,79,630,547,83,780,669,89,677,563,65
060375741003,474,263,211,480,256,224,653,391,255,507,253,214
060375762004,175,146,29,178,145,33,253,207,35,282,218,39
060375736017,355,188,167,361,181,180,510,289,210,404,210,171
060375736018,392,212,180,402,212,190,543,307,223,445,232,187
060375736019,346,186,160,354,188,166,452,254,184,378,202,154
060375736016,369,195,174,370,182,188,446,250,183,398,212,155
060375759011,274,238,36,273,232,41,468,392,62,365,290,45
060375759012,226,198,28,229,195,34,327,277,43,232,184,28
060375759013,175,152,23,175,149,26,242,199,31,167,131,20
060375759014,167,146,21,167,143,24,247,205,32,226,182,25
060375736011,792,446,346,802,434,368,1021,591,405,900,480,345
060375736012,410,231,179,416,227,189,534,310,214,445,244,171
060375712012,409,225,184,418,224,194,521,305,205,469,250,186
060375712014,436,250,186,443,245,198,553,327,218,477,267,173
060375712013,399,236,163,406,228,178,622,364,244,478,278,159
060375712022,412,245,167,422,244,178,521,315,196,451,245,170
060375712023,674,405,269,686,400,286,874,538,316,740,424,260
060375712021,598,372,226,615,371,244,996,610,359,719,441,228
060375704022,383,349,34,382,339,43,449,386,57,422,384,27
060375706013,157,132,25,162,131,31,333,239,86,256,206,41
060375717041,280,227,53,283,225,58,505,388,98,401,324,50
060375717042,135,109,26,134,107,27,244,187,53,188,148,26
060375717043,302,235,67,307,233,74,527,395,119,399,312,67
060375780003,339,292,47,340,282,58,311,250,61,434,355,54
060375716001,381,331,50,398,335,63,524,442,58,494,430,39
060375775011,710,367,343,717,367,350,943,533,389,747,380,320
060379800061,0,0,0,0,0,0,2,1,1,0,0,0
060375779001,320,213,107,324,211,113,451,311,130,324,216,87
060375744002,439,248,191,451,247,204,528,318,200,528,287,208
060375744003,444,265,179,457,264,193,583,362,205,510,285,189
060375715024,267,179,88,270,175,95,482,338,134,335,221,95
060375718002,641,426,215,651,425,226,673,453,202,674,424,207
060375706022,484,383,101,494,380,114,773,553,190,620,473,112
060375706021,389,309,80,395,303,92,765,554,195,485,384,71
060375706011,469,368,101,477,356,121,755,565,171,622,475,106
060375715043,464,324,140,472,323,149,557,411,139,469,325,115
060375715044,475,344,131,481,340,141,628,458,153,552,386,130
060375715041,445,305,140,453,304,149,647,461,166,539,376,131
060375779003,468,341,127,480,338,142,636,470,153,503,338,134
060375722011,342,270,72,348,273,75,582,441,129,414,302,87
060375722012,264,208,56,272,212,60,397,294,96,324,240,65
060375763012,247,213,34,248,206,42,409,330,66,276,221,38
060375763013,266,230,36,270,224,46,425,344,72,266,206,31
060375762001,265,231,34,269,230,39,504,422,70,409,328,49
060375762002,329,283,46,330,282,48,430,352,66,399,315,52
060375765011,349,305,44,358,308,50,626,520,84,414,345,42
060375765021,652,586,66,663,580,83,920,783,112,860,716,81
060375751021,297,243,54,291,236,55,553,428,108,373,288,58
060375751022,291,251,40,294,245,49,455,362,87,347,271,52
060375751012,552,455,97,560,449,111,634,510,105,672,510,106
060375750012,758,608,150,771,596,175,1098,835,227,893,651,167
060375734032,850,615,235,857,608,249,1086,794,272,759,518,191
060375749021,288,211,77,295,212,83,385,300,77,368,242,90
060375749022,378,278,100,384,278,106,715,551,143,465,327,87
060375749023,699,562,137,719,571,148,1186,896,258,785,583,143
060375737002,478,317,161,491,315,176,687,423,246,555,344,175
060375737003,409,271,138,420,270,150,575,344,215,495,302,159
060375741002,574,351,223,591,352,239,788,465,296,612,341,222
060375744005,373,198,175,382,196,186,493,306,177,424,249,149
060375744001,362,226,136,371,226,145,491,308,174,388,223,136
060375744006,454,284,170,467,284,183,581,363,208,495,297,165
060375781001,351,309,42,358,295,63,910,548,339,521,420,54
060375552021,758,399,359,768,393,375,1062,589,446,850,453,339
060375552022,851,479,372,860,468,392,1188,688,473,941,511,373
060375717013,554,443,111,566,436,130,962,711,232,749,594,116
060375723012,250,201,49,254,194,60,550,414,122,406,326,59
060375754021,244,201,43,244,197,47,607,466,119,335,271,40
060375754022,113,94,19,113,92,21,208,164,40,126,104,15
060375021001,370,266,104,374,260,114,561,395,151,439,315,95
060375021002,538,412,126,535,393,142,938,687,232,762,548,162
060375010023,736,552,184,723,516,207,992,725,253,842,634,177
060375021003,574,426,148,569,406,163,726,506,200,649,459,148
060375022004,622,471,151,624,460,164,969,713,240,821,595,182
060375022003,436,322,114,444,318,126,630,448,169,519,370,120
060375022002,511,386,125,513,373,140,845,581,247,628,451,141
060375023032,552,450,102,561,441,120,817,610,191,635,496,108
060375023031,429,352,77,434,337,97,665,484,161,553,404,103
060375023034,296,248,48,305,245,60,469,343,112,380,307,53
060375023033,253,214,39,260,205,55,353,268,80,300,242,42
060375023035,470,392,78,482,379,103,1067,791,249,943,744,145
060375012002,750,582,168,757,561,196,1105,795,276,899,668,171
060375004031,891,711,180,903,690,213,1439,1000,413,960,721,183
060375010012,400,333,67,405,325,80,728,549,157,574,465,84
060375010021,380,297,83,384,289,95,633,439,172,477,358,96
060375010011,337,254,83,342,246,96,505,361,136,410,291,88
060375010022,594,433,161,609,426,183,865,618,239,776,544,189
060375022001,355,275,80,359,264,95,608,438,156,373,269,80
060375403001,246,226,20,246,217,29,374,309,60,337,313,13
060375403002,375,336,39,381,324,57,514,414,80,488,440,26
060375403003,117,105,12,115,100,15,224,182,34,193,172,10
060375403004,251,217,34,256,203,53,333,268,52,382,330,31
060375402011,59,55,4,60,55,5,211,175,35,156,148,6
060375402012,107,98,9,109,96,13,221,178,35,155,137,7
060375402021,113,103,10,114,102,12,340,275,55,236,215,9
060375402022,156,137,19,159,136,23,322,263,47,241,214,14
060375402023,253,220,33,259,219,40,468,383,71,458,399,42
060375402024,267,229,38,270,230,40,422,342,72,269,232,32
060375402031,452,412,40,459,405,54,614,511,88,553,502,27
060375402032,184,167,17,188,164,24,341,282,50,294,266,16
060375402033,168,147,21,172,145,27,355,292,57,208,185,15
060375401012,381,343,38,388,333,55,583,479,81,508,459,31
060375401013,434,380,54,447,378,69,607,475,111,521,442,47
060375401014,527,473,54,543,463,80,786,626,134,657,588,42
060375405014,279,248,31,287,242,45,461,379,69,353,319,19
060375417001,229,203,26,238,203,35,322,268,47,282,257,14
060375417002,251,221,30,256,220,36,304,251,44,278,252,14
060375401011,173,151,22,178,151,27,361,285,66,307,257,31
060375405011,261,233,28,268,226,42,447,364,68,351,316,20
060375405012,192,170,22,200,168,32,442,365,61,249,222,14
060375405013,267,239,28,275,233,42,466,381,71,361,326,21
060375401021,372,337,35,376,330,46,593,496,84,506,458,27
060375401023,546,498,48,559,497,62,807,662,118,736,664,37
060375401024,378,340,38,383,335,48,566,481,75,503,452,28
060375400001,279,250,29,278,231,47,471,382,82,305,273,19
060375400002,329,293,36,335,280,55,690,550,116,467,413,32
060375401022,394,353,41,399,349,50,624,528,79,567,514,31
060375405021,291,262,29,294,248,46,580,486,77,563,510,29
060375417005,407,364,43,407,354,53,613,515,81,561,500,39
060375417004,327,294,33,331,287,44,498,417,66,352,316,22
060375400003,383,333,50,389,324,65,668,546,101,539,478,35
060375418011,275,245,30,277,239,38,386,316,66,306,283,19
060375418012,428,392,36,439,385,54,687,548,112,535,486,28
060375418023,474,406,68,489,407,82,627,518,91,530,476,29
060375418022,259,227,32,265,225,40,452,367,69,309,275,18
060378005062,210,145,65,213,147,66,301,198,98,232,158,61
060378004122,1342,936,406,1370,942,428,1721,1164,524,1622,1077,433
060378004062,455,277,178,465,276,189,592,376,200,649,395,217
060378004112,778,497,281,792,492,300,865,551,294,807,520,244
060378004111,730,474,256,751,476,275,859,577,265,811,506,266
060378004121,521,333,188,528,338,190,520,352,158,467,289,154
060378004101,845,539,306,852,530,322,1333,910,379,1022,659,279
060376203051,327,214,113,330,209,121,473,323,137,356,232,96
060376203053,309,197,112,309,192,117,395,275,115,345,222,101
060376203055,288,175,113,299,179,120,352,232,119,360,231,112
060376203057,604,372,232,626,379,247,718,477,229,677,430,202
060376203052,855,539,316,870,546,324,1028,669,317,931,603,255
060376203054,377,219,158,390,223,167,429,278,138,414,251,128
060376203056,304,176,128,313,181,132,375,244,125,321,198,100
060376209041,413,236,177,418,233,185,549,355,189,471,293,149
060376209042,534,310,224,559,310,249,748,466,249,643,387,203
060376209043,424,234,190,438,235,203,655,421,221,490,303,147
060376203033,628,368,260,648,365,283,770,516,236,662,405,217
060376203034,459,275,184,471,272,199,605,405,187,500,314,160
060376203011,689,427,262,709,428,281,930,611,296,721,468,218
060376203031,655,414,241,670,413,257,886,583,285,742,503,199
060376203032,660,418,242,678,418,260,843,566,259,692,451,190
060376203013,639,393,246,658,393,265,756,512,220,640,402,182
060376203014,559,338,221,574,346,228,703,475,208,598,373,176
060376203012,628,376,252,643,389,254,791,537,235,639,404,193
060376204003,572,349,223,576,359,217,731,515,200,698,454,204
060376204004,675,396,279,680,402,278,900,633,248,861,532,288
060376204001,1084,648,436,1108,649,459,1281,858,393,1055,627,375
060376204002,396,261,135,404,258,146,525,371,144,390,252,115
060376208022,575,355,220,585,355,230,726,472,231,603,371,187
060376208021,568,345,223,579,345,234,742,477,244,626,382,202
060376208013,363,222,141,374,221,153,464,306,147,416,253,138
060376208011,390,244,146,399,244,155,490,327,154,418,266,127
060376208012,527,337,190,538,332,206,657,438,205,579,367,177
060376208015,379,237,142,390,240,150,487,322,154,411,260,124
060376209011,671,381,290,693,379,314,857,546,293,728,427,250
060376209012,361,204,157,363,198,165,396,254,137,403,239,132
060376209013,346,197,149,355,193,162,443,282,154,372,216,134
060376208014,522,336,186,530,327,203,725,479,224,579,366,177
060376202011,316,207,109,319,205,114,494,336,139,370,246,107
060376202012,324,212,112,333,212,121,441,302,125,354,238,102
060377029003,949,755,194,964,749,215,1762,1292,441,968,697,235
060377029001,959,738,221,972,733,239,1340,1008,304,1104,825,217
060372742021,1095,837,258,1116,853,263,1450,1145,273,1162,892,213
060377029002,1167,975,192,1191,975,216,1778,1360,376,1588,1216,284
060377029004,705,526,179,712,518,194,970,726,227,778,548,186
060375333001,123,112,11,123,108,15,287,241,39,268,239,19
060375333002,381,345,36,382,332,50,480,400,65,426,378,31
060375334011,334,301,33,338,290,48,494,402,81,422,371,34
060375334013,271,245,26,270,237,33,339,279,54,302,265,21
060375334021,401,366,35,403,356,47,667,539,111,587,517,44
060375337012,339,306,33,343,297,46,556,423,116,487,434,31
060375337021,407,368,39,415,357,58,553,425,112,461,399,39
060375337022,208,188,20,212,182,30,315,242,61,243,210,21
060375334012,324,288,36,326,275,51,469,370,78,394,343,33
060375334022,310,277,33,310,267,43,443,356,76,373,318,37
060375334031,430,389,41,434,381,53,541,436,93,523,467,31
060375334032,168,151,17,168,148,20,268,219,45,229,191,26
060375337011,276,249,27,279,242,37,357,272,75,256,232,16
060375337031,278,248,30,277,235,42,409,333,67,354,313,25
060375337032,406,361,45,410,346,64,655,531,102,552,481,39
060374303021,451,270,181,462,266,196,530,341,173,447,253,159
060374303024,570,337,233,577,327,250,804,492,287,627,366,215
060374303025,481,287,194,488,281,207,676,417,236,467,265,165
060374303011,535,287,248,542,283,259,678,378,286,509,261,217
060374303013,704,372,332,717,368,349,886,489,374,673,349,282
060374303022,844,495,349,859,483,376,1096,673,399,995,565,362
060374303023,465,268,197,476,260,216,556,347,197,548,302,208
060374310031,368,255,113,371,251,120,510,353,149,409,269,117
060374310032,918,624,294,929,611,318,1354,906,418,1026,666,298
060374310041,535,377,158,546,373,173,802,563,227,678,445,170
060374310042,571,401,170,586,402,184,778,546,211,669,451,166
060374309012,357,257,100,360,250,110,458,326,120,333,233,79
060374309013,497,357,140,502,346,156,736,521,192,512,360,118
060374309022,309,211,98,315,210,105,572,391,167,387,252,105
060374309011,477,360,117,492,366,126,767,564,185,600,410,147
060374311003,356,266,90,363,268,95,652,472,163,427,309,90
060374311004,372,270,102,383,272,111,730,525,188,502,342,127
060374311001,493,370,123,508,369,139,936,635,272,671,511,113
060374309023,183,125,58,187,125,62,269,183,81,198,132,53
060375302022,543,455,88,543,449,94,777,595,160,670,544,89
060375302041,321,267,54,326,257,69,512,400,108,478,374,76
060375302042,479,413,66,490,406,84,930,714,188,635,520,76
060375302031,391,332,59,393,308,85,818,618,168,561,447,87
060375302032,389,323,66,397,309,88,361,276,75,312,243,50
060375301012,291,221,70,295,218,77,504,377,117,396,291,82
060375301013,258,220,38,257,210,47,332,249,80,288,228,43
060375301014,187,143,44,191,141,50,229,173,56,201,146,40
060375300052,769,503,266,785,483,302,1224,818,393,837,568,231
060375322001,403,336,67,408,332,76,655,509,130,576,482,62
060375322002,219,180,39,222,177,45,514,400,101,371,311,42
060375322003,608,502,106,617,491,126,799,621,158,590,495,65
060375006001,254,217,37,252,209,43,351,275,65,309,263,30
060375301011,399,346,53,398,330,68,703,529,163,599,497,74
060375300051,829,567,262,855,582,273,1271,848,397,1112,758,291
060375300061,659,518,141,669,510,159,1316,897,388,767,558,164
060375300062,295,219,76,304,216,88,412,314,90,398,268,100
060375301022,394,311,83,403,297,106,404,306,91,453,350,76
060375301023,395,312,83,399,294,105,555,399,143,461,360,79
060375301024,433,347,86,437,336,101,597,438,151,554,436,95
060375300073,644,430,214,662,434,228,694,483,196,683,458,190
060375300074,545,358,187,564,366,198,689,489,191,649,432,188
060375301021,352,282,70,358,276,82,485,339,137,344,272,61
060375005001,751,639,112,760,618,142,1258,932,313,1001,808,138
060375300072,650,499,151,663,496,167,1043,748,274,845,632,169
060379800361,96,69,27,102,69,33,192,129,60,129,98,23
060375300071,484,369,115,501,364,137,723,507,198,564,401,130
060375320011,455,380,75,463,367,96,645,488,141,543,446,68
060375320012,383,313,70,390,303,87,538,412,117,510,411,74
060374825223,340,267,73,353,264,89,456,356,92,420,328,78
060375321011,397,344,53,402,333,69,663,505,137,506,421,57
060375321013,377,322,55,382,312,70,750,572,153,620,502,77
060375320022,499,414,85,507,417,90,804,629,159,597,478,87
060375320021,192,162,30,193,157,36,309,241,67,201,176,23
060375321022,532,433,99,534,416,118,790,590,184,650,506,103
060375321021,486,390,96,489,373,116,773,572,187,622,484,102
060375321012,425,364,61,427,360,67,687,544,125,615,509,64
060374825221,388,299,89,400,297,103,628,444,173,479,360,91
060374825222,520,413,107,538,408,130,757,544,197,559,427,102
060374817121,465,351,114,481,341,140,781,509,268,578,423,128
060374817122,295,215,80,303,210,93,598,385,203,391,277,93
060374820024,295,212,83,302,209,93,516,371,133,310,224,71
060374820022,561,398,163,568,384,184,907,667,221,675,462,182
060374820023,581,419,162,597,411,186,1051,711,311,598,425,144
060374827013,298,240,58,304,233,71,554,402,137,477,365,81
060374820021,515,338,177,522,320,202,722,531,177,668,454,187
060374817131,272,189,83,281,181,100,558,342,203,370,252,97
060374817132,146,100,46,147,95,52,253,155,93,166,113,43
060374817141,222,147,75,226,137,89,458,282,167,312,204,96
060374821012,328,233,95,336,227,109,637,447,188,440,313,110
060374821013,460,327,133,480,323,157,785,515,255,642,447,159
060374822011,200,141,59,209,141,68,421,279,135,270,188,66
060374822012,182,134,48,187,132,55,384,248,124,223,161,52
060374822013,256,174,82,265,174,91,471,307,153,293,194,79
060374822021,160,111,49,161,109,52,348,226,118,190,132,49
060374822022,283,193,90,293,193,100,593,387,196,309,208,88
060374826001,598,416,182,614,402,212,617,411,202,647,417,210
060374826002,729,499,230,755,490,265,1024,698,318,742,510,197
060374826003,377,262,115,386,252,134,714,474,231,515,365,127
060374826004,500,323,177,520,322,198,740,496,238,658,428,197
060374821011,222,161,61,233,161,72,415,276,136,278,200,66
060374821022,302,211,91,319,212,107,549,363,175,389,272,100
060374821021,533,400,133,557,402,155,845,561,265,679,488,160
060374827021,414,318,96,426,311,115,602,435,161,451,331,94
060374822023,232,162,70,236,160,76,615,401,206,348,238,90
060374828012,341,247,94,351,243,108,485,335,141,358,253,83
060374828011,343,247,96,347,240,107,537,392,131,435,308,96
060374828013,651,472,179,666,467,199,1059,730,311,776,538,186
060374827011,209,167,42,214,161,53,323,241,78,239,187,42
060374827012,364,291,73,377,288,89,568,421,142,473,370,80
060374827014,224,169,55,226,164,62,267,198,65,248,182,56
060374827022,355,276,79,367,267,100,470,346,115,389,299,69
060374817111,199,129,70,202,125,77,441,272,166,268,186,70
060374817112,228,148,80,235,146,89,511,311,191,312,215,81
060374820012,294,202,92,308,201,107,390,275,111,329,218,100
060374817142,131,87,44,134,82,52,193,119,74,179,118,56
060375304002,565,455,110,577,444,133,776,565,193,662,515,111
060373005032,445,261,184,457,266,191,708,421,274,525,310,178
060373005031,628,397,231,640,379,261,1036,624,398,772,459,258
060379203123,827,403,424,847,393,454,1542,792,707,1180,532,565
060379203261,1291,617,674,1317,612,705,1761,929,800,1527,695,744
060379200431,1611,856,755,1628,841,787,2416,1305,1074,1421,620,744
060375004032,416,329,87,424,317,107,601,433,152,538,420,95
060375003001,1276,802,474,1285,776,509,1711,1059,623,1430,896,459
060375012001,858,588,270,863,575,288,1513,983,489,1192,775,348
060375503012,122,100,22,121,97,24,252,185,61,187,137,35
060375503013,192,157,35,193,154,39,316,232,77,248,200,38
060375503014,280,229,51,281,224,57,456,339,112,365,293,54
060375519001,243,189,54,244,184,60,467,337,119,339,263,61
060375519004,437,321,116,448,315,133,778,537,219,543,390,121
060375527003,362,274,88,364,266,98,525,358,147,449,333,96
060375527004,253,189,64,257,186,71,368,254,104,311,216,71
060375527005,311,233,78,318,231,87,551,388,154,455,318,105
060375778003,499,351,148,503,335,168,796,517,254,642,438,164
060375503011,303,206,97,306,197,109,550,359,175,508,354,128
060375778002,502,359,143,510,346,164,776,507,251,561,389,144
060375502021,439,319,120,446,308,138,707,491,190,648,476,134
060375502024,419,303,116,429,298,131,667,464,185,530,370,129
060375502022,386,282,104,394,274,120,565,399,160,540,395,116
060375502023,231,166,65,236,164,72,315,220,86,221,154,56
060375502011,424,309,115,429,290,139,747,518,217,503,367,111
060375028013,432,299,133,439,296,143,682,435,228,566,400,143
060375502012,289,219,70,294,206,88,578,400,164,410,316,79
060375501012,324,251,73,325,243,82,497,354,135,404,307,77
060375501011,487,376,111,494,369,125,838,593,224,695,530,136
060375501013,297,230,67,301,222,79,472,337,124,391,297,73
060375553002,372,289,83,377,277,100,540,386,143,428,324,79
060375553003,233,181,52,234,172,62,364,257,99,279,216,53
060379800341,16,8,8,16,9,7,20,7,11,14,7,6
060375523011,300,221,79,303,214,89,583,388,175,351,256,76
060375523012,543,412,131,552,400,152,961,668,272,738,538,158
060375523013,226,174,52,231,168,63,380,257,112,411,312,77
060375523021,267,190,77,277,187,90,478,333,134,341,236,82
060375523022,291,206,85,297,199,98,373,260,106,319,220,77
060375523023,406,282,124,412,270,142,538,380,149,516,360,125
060375522004,381,277,104,388,270,118,665,453,193,457,329,99
060375520021,328,250,78,339,246,93,674,470,185,441,334,81
060375522001,223,177,46,230,172,58,895,596,271,311,236,57
060375522002,178,141,37,180,136,44,610,407,184,215,161,39
060375522003,202,149,53,210,148,62,492,343,142,262,190,53
060375520022,352,276,76,356,273,83,594,415,166,568,434,103
060375520011,400,286,114,411,278,133,570,392,153,449,334,89
060375520012,325,249,76,327,241,86,641,439,182,464,351,87
060375520013,270,205,65,271,199,72,440,303,123,324,244,60
060375519003,280,199,81,287,194,93,477,332,134,388,279,91
060375521004,237,181,56,244,180,64,395,264,131,313,237,59
060375521005,334,255,79,341,253,88,524,358,160,438,336,77
060375521001,332,246,86,337,236,101,610,404,195,461,334,103
060375521003,305,227,78,312,219,93,494,321,159,425,301,98
060375521002,300,221,79,309,218,91,569,379,175,428,323,85
060375524001,216,169,47,217,164,53,405,288,113,250,191,51
060375524002,307,242,65,310,232,78,587,415,161,365,276,72
060375527001,526,404,122,531,393,138,799,558,221,684,509,137
060375527002,245,185,60,251,181,70,379,267,106,287,213,62
060375528001,223,170,53,226,168,58,309,228,77,235,180,44
060375528002,517,387,130,525,381,144,909,657,231,804,582,182
060375528004,406,297,109,416,291,125,553,380,166,616,443,143
060375528003,300,216,84,306,213,93,341,231,104,377,271,91
060375529004,435,311,124,439,303,136,1059,707,322,663,480,145
060375529005,344,246,98,351,242,109,551,362,174,323,235,72
060375530003,470,354,116,476,348,128,690,479,193,539,403,111
060375530002,351,254,97,356,248,108,598,419,173,401,271,105
060375529003,346,247,99,351,236,115,543,362,181,313,221,82
060375529002,277,198,79,281,188,93,507,330,166,463,359,82
060375529001,182,131,51,184,124,60,229,170,59,199,138,53
060375526011,248,211,37,250,201,49,390,306,76,404,334,43
060375526014,331,277,54,340,265,75,542,386,141,427,352,48
060375526023,234,174,60,236,171,65,559,406,139,365,269,75
060375547001,349,274,75,355,274,81,597,437,140,475,380,66
060375547002,355,288,67,365,290,75,567,423,129,479,391,62
060375547003,326,268,58,335,268,67,523,394,118,412,339,51
060375546001,529,351,178,545,343,202,940,598,326,664,428,198
060375553001,136,99,37,139,98,41,262,175,79,301,211,76
060375553004,336,244,92,342,241,101,502,340,154,343,243,88
060375526012,261,227,34,268,226,42,415,324,81,356,307,32
060375526013,262,227,35,268,226,42,375,291,73,351,300,34
060375526021,493,327,166,508,339,169,818,557,243,638,436,172
060375519002,364,257,107,362,250,112,636,434,188,481,344,116
060376702011,765,382,383,775,379,396,973,552,401,886,445,383
060376702021,1392,660,732,1429,663,766,1756,968,748,1487,723,663
060376704171,1326,663,663,1341,659,682,1863,1120,707,1426,758,590
060376705001,931,316,615,946,319,627,1318,567,723,1124,396,661
060379104051,222,163,59,229,161,68,599,401,182,437,309,98
060379104041,352,250,102,352,242,110,361,243,109,364,249,90
060379104042,671,473,198,676,456,220,812,544,247,746,514,179
060379105043,131,100,31,133,96,37,202,144,53,164,119,35
060379105041,331,252,79,337,245,92,528,369,135,370,267,79
060379105042,439,332,107,446,325,121,653,461,170,540,384,122
060379105051,310,230,80,317,222,95,479,321,148,378,267,90
060379105052,404,299,105,414,291,123,681,459,209,471,328,115
060379105021,315,240,75,313,229,84,592,414,162,364,264,79
060379105022,332,250,82,332,237,95,601,420,162,414,294,89
060379106011,339,251,88,339,243,96,543,378,155,383,282,83
060379106012,300,234,66,292,220,72,530,380,138,382,275,82
060379106022,319,235,84,318,228,90,453,314,126,403,294,88
060379800041,0,0,0,0,0,0,0,0,0,7,1,5
060379104052,273,211,62,273,206,67,355,267,83,342,247,69
060379104053,182,141,41,184,139,45,372,267,84,327,236,65
060379106021,426,315,111,430,301,129,716,515,189,595,413,145
060379107211,460,339,121,467,327,140,734,502,212,501,350,122
060379102183,423,202,221,430,197,233,676,337,325,488,214,247
060379102142,598,365,233,611,352,259,781,476,292,705,418,252
060379106013,573,433,140,571,414,157,987,706,268,680,489,146
060379102103,1054,526,528,1070,514,556,1475,760,685,1142,523,553
060379102172,973,633,340,983,619,364,1545,926,584,1152,661,416
060379104013,758,447,311,788,451,337,1031,639,370,837,486,306
060379102161,644,293,351,654,300,354,873,389,465,712,298,368
060379102162,1101,586,515,1111,570,541,1544,838,674,1079,533,471
060379102141,550,334,216,562,321,241,878,506,350,752,434,277
060379107181,556,425,131,566,413,153,857,620,213,674,498,133
060379107133,580,460,120,588,451,137,755,548,185,632,476,111
060379103011,642,224,418,647,218,429,867,349,501,706,241,423
060379103021,553,193,360,560,189,371,741,309,420,640,223,384
060379103022,590,240,350,599,240,359,750,319,418,536,198,310
060379102101,1120,553,567,1140,529,611,1642,825,784,1410,646,694
060379102102,564,263,301,581,246,335,802,387,400,509,214,267
060379103023,723,310,413,746,303,443,1106,477,600,886,347,490
060379103024,669,279,390,677,283,394,1038,449,564,936,359,521
060379102152,955,636,319,968,625,343,1279,788,466,1170,685,407
060379107162,888,609,279,899,605,294,1311,844,437,1116,748,305
060379107141,567,454,113,568,433,135,924,679,223,708,521,143
060379107142,288,237,51,292,232,60,440,322,104,348,251,76
060379107061,723,576,147,729,558,171,1203,867,305,916,700,172
060379107062,628,503,125,634,490,144,1095,823,254,759,587,133
060379107121,766,562,204,769,531,238,1221,833,359,877,628,202
060379106081,413,295,118,418,277,141,671,460,196,510,313,147
060379106082,339,243,96,346,231,115,531,370,155,404,260,109
060379107183,483,384,99,489,370,119,762,578,170,570,429,107
060379107182,297,239,58,302,237,65,507,385,113,379,289,69
060379107171,623,491,132,628,484,144,880,655,207,771,588,148
060379107191,261,208,53,264,202,62,405,286,111,336,250,66
060379107131,501,398,103,505,385,120,748,527,206,503,375,110
060379107202,348,270,78,354,262,92,790,543,228,541,394,117
060379107201,641,484,157,651,470,181,936,663,245,712,516,155
060379107072,829,569,260,835,547,288,1407,951,422,986,669,261
060379107071,313,219,94,315,213,102,463,315,139,437,294,116
060379107151,615,451,164,619,427,192,896,607,266,704,512,159
060379106051,537,416,121,541,404,137,813,561,220,677,495,135
060379106061,477,348,129,481,336,145,744,514,212,557,386,135
060379107152,389,292,97,393,283,110,643,449,183,483,330,124
060379107153,651,481,170,662,469,193,959,664,274,870,597,216
060379106052,461,332,129,463,318,145,808,562,223,602,416,149
060379106062,232,167,65,233,161,72,353,245,97,267,180,69
060379106071,386,284,102,394,275,119,601,402,183,448,313,102
060379107212,243,173,70,246,169,77,390,276,108,338,253,63
060379107161,837,552,285,844,537,307,1183,785,383,998,652,283
060379105011,208,171,37,211,164,47,519,363,141,235,182,40
060379105012,236,195,41,239,185,54,426,314,98,377,272,80
060379105013,183,150,33,185,144,41,369,269,83,313,239,53
060379107132,387,300,87,390,295,95,658,474,164,503,376,107
060379107192,669,555,114,679,531,148,1215,900,287,831,629,156
060379102143,810,426,384,825,418,407,1129,619,485,920,438,429
060379106072,446,340,106,450,318,132,737,504,216,613,423,151
060379012181,1017,381,636,1047,386,661,1497,601,870,1259,452,731
060376703281,473,214,259,491,222,269,616,322,275,498,244,226
060376703282,584,243,341,592,246,346,812,428,366,656,309,305
060376704161,861,425,436,878,429,449,999,583,395,1051,538,438
060376703283,1283,616,667,1305,615,690,1696,892,758,1521,744,672
060376703262,880,418,462,891,416,475,1032,548,464,958,468,424
060376703263,365,167,198,381,175,206,448,237,202,375,184,170
060376703261,741,329,412,756,332,424,1065,574,470,799,398,357
060376703241,608,310,298,628,320,308,747,450,282,618,321,259
060376703242,656,328,328,682,346,336,776,472,291,636,327,266
060376703244,843,427,416,860,428,432,1129,652,453,919,478,387
060376703243,848,391,457,859,390,469,1021,548,450,738,354,339
060375536012,555,446,109,565,444,121,623,458,152,562,448,88
060375535043,307,261,46,312,257,55,448,356,83,380,319,45
060375362022,345,293,52,349,279,70,534,412,110,410,341,57
060375536022,340,303,37,352,300,52,596,487,92,493,435,31
060375536023,192,172,20,193,169,24,281,230,44,240,210,16
060375535041,451,386,65,456,370,86,706,559,130,547,473,53
060375535042,307,276,31,310,272,38,461,376,71,423,382,29
060375535021,386,333,53,392,321,71,687,534,138,473,407,47
060375535022,447,396,51,455,388,67,909,702,181,550,469,50
060375535031,489,412,77,500,406,94,847,672,160,678,562,85
060375536021,315,261,54,324,257,67,529,386,130,497,408,68
060375537011,50,45,5,51,44,7,441,336,97,191,174,10
060375537012,196,175,21,203,174,29,296,248,44,223,199,12
060375537013,252,225,27,253,218,35,372,300,57,281,252,20
060375537021,444,390,54,440,378,62,716,582,110,529,485,36
060375538023,417,361,56,426,357,69,798,630,148,630,560,52
060375538022,602,512,90,599,489,110,865,685,165,809,666,108
060375538011,158,131,27,161,128,33,259,204,51,204,169,27
060375538012,134,119,15,136,117,19,187,154,27,118,103,11
060375538021,229,183,46,233,177,56,358,279,67,301,235,48
060375539014,227,190,37,233,185,48,374,292,72,282,237,37
060375539011,369,296,73,369,289,80,684,503,165,473,386,66
060375539012,383,301,82,387,293,94,599,437,146,476,388,69
060375539013,482,369,113,484,356,128,703,521,163,678,542,106
060375539022,330,274,56,334,257,77,538,407,114,440,362,58
060375539023,305,255,50,314,243,71,598,457,122,439,362,57
060375536011,434,404,30,440,388,52,842,698,119,713,629,58
060375539021,406,323,83,417,306,111,592,461,120,507,393,88
060375538013,318,282,36,324,276,48,758,608,128,518,451,51
060374608001,1095,639,456,1101,629,472,1300,847,424,1128,687,364
060374609002,439,400,39,436,379,57,759,650,88,616,543,42
060374609004,479,415,64,486,410,76,646,555,87,499,435,46
060374609005,303,259,44,312,259,53,416,349,55,409,349,43
060374609001,494,447,47,493,430,63,799,680,99,545,459,61
060374609003,425,379,46,431,379,52,576,489,74,533,465,32
060374616001,449,394,55,451,383,68,496,415,73,451,393,37
060374616004,291,254,37,293,249,44,353,302,48,318,274,28
060371810001,506,401,105,512,389,123,711,549,152,570,434,110
060374617002,484,371,113,494,370,124,438,359,76,518,399,94
060374600022,687,392,295,694,386,308,990,588,385,837,440,349
060374630001,394,250,144,401,254,147,471,335,130,408,248,134
060374630002,701,447,254,713,451,262,1039,732,287,783,472,258
060374615011,451,388,63,455,384,71,582,490,84,443,380,41
060374615012,419,361,58,422,357,65,635,520,96,574,479,59
060374615013,657,565,92,663,559,104,882,730,129,674,570,64
060374621001,463,404,59,469,403,66,631,500,116,409,338,46
060374621003,631,550,81,635,545,90,689,586,86,667,557,72
060374624001,575,433,142,582,431,151,718,554,147,668,511,115
060374624002,470,377,93,467,372,95,466,374,84,467,366,73
060374624003,364,294,70,365,291,74,484,381,94,406,323,61
060374619011,474,415,59,473,397,76,850,697,130,625,528,57
060374620012,369,326,43,371,320,51,575,473,81,429,369,38
060374621002,564,488,76,567,477,90,908,777,112,933,785,99
060374625002,627,434,193,634,424,210,781,545,221,643,448,161
060374626001,612,445,167,615,439,176,714,508,188,604,435,135
060374626002,573,413,160,580,405,175,715,518,173,635,457,146
060374625001,659,424,235,666,419,247,829,569,248,660,442,177
060374629001,787,534,253,799,525,274,1090,743,325,866,563,240
060374629002,451,308,143,457,303,154,600,422,167,554,384,137
060374615021,449,396,53,453,384,69,604,512,88,576,498,48
060374615022,440,388,52,445,378,67,763,634,109,647,554,59
060374615023,214,187,27,217,186,31,386,327,47,247,217,18
060374615024,350,304,46,351,303,48,601,506,82,436,380,34
060374620011,534,478,56,541,477,64,878,754,105,550,486,41
060374620021,219,192,27,221,189,32,441,362,67,359,310,32
060374620023,225,201,24,228,198,30,366,302,56,299,262,23
060374620022,283,247,36,287,243,44,507,419,73,413,353,40
060374622011,444,366,78,446,362,84,596,473,114,429,353,53
060374623011,558,470,88,567,470,97,836,673,146,661,528,85
060374623012,331,281,50,339,281,58,511,411,84,370,296,45
060374623013,470,397,73,481,398,83,734,599,117,709,553,109
060374627003,506,382,124,512,377,135,734,542,175,506,390,87
060374623023,352,287,65,359,287,72,510,398,98,413,320,61
060374627002,363,288,75,366,280,86,576,441,119,408,307,73
060374627004,334,273,61,336,271,65,481,369,100,402,313,60
060374627005,450,369,81,457,368,89,654,497,135,444,339,72
060374627001,385,272,113,388,273,115,517,384,121,398,291,88
060374628001,621,438,183,622,436,186,927,661,244,725,511,176
060374629003,442,319,123,451,314,137,632,456,170,535,380,130
060374632002,720,515,205,733,514,219,813,603,193,709,501,169
060374632003,265,205,60,268,207,61,429,301,118,349,261,66
060374634004,770,608,162,777,605,172,1172,872,267,847,630,156
060374628002,470,372,98,475,365,110,788,598,174,613,440,132
060374638001,490,341,149,492,340,152,579,416,154,520,330,159
060374638002,594,417,177,604,423,181,693,534,150,629,480,124
060374638003,641,446,195,646,444,202,767,555,197,715,478,197
060374638004,673,471,202,682,470,212,806,618,174,715,544,141
060374639001,526,360,166,530,359,171,713,518,179,767,519,199
060374639002,544,417,127,546,411,135,500,387,102,549,396,116
060374640005,611,471,140,622,472,150,741,577,145,715,543,127
060374640001,558,379,179,570,381,189,695,518,172,593,391,174
060374640002,492,318,174,505,321,184,508,393,108,566,399,133
060374640003,659,479,180,670,481,189,864,636,208,706,509,158
060374640004,611,414,197,628,416,212,732,546,170,617,443,134
060374806011,526,434,92,531,426,105,620,509,96,569,434,95
060374635001,628,494,134,635,491,144,990,757,204,571,436,93
060374635002,604,446,158,612,444,168,673,531,134,789,599,136
060374635003,703,557,146,712,557,155,1117,881,205,843,664,121
060374636024,390,326,64,396,328,68,501,410,78,436,357,58
060374636023,668,557,111,675,558,117,885,734,129,730,607,89
060374637002,1007,718,289,1018,720,298,1670,1230,401,849,594,203
060374636021,370,294,76,378,297,81,615,490,107,519,402,86
060374636022,613,488,125,627,493,134,1095,909,159,732,557,127
060374636012,655,540,115,658,536,122,860,697,144,709,558,113
060374636013,590,487,103,592,483,109,693,546,134,726,556,125
060374625004,433,297,136,437,296,141,673,443,213,612,395,176
060374636011,524,432,92,534,436,98,659,544,102,526,409,83
060374636014,622,514,108,636,517,119,879,726,136,685,552,91
060374614001,550,376,174,563,374,189,722,495,210,665,423,202
060374634001,510,412,98,514,407,107,678,522,139,524,395,94
060374634002,678,513,165,686,508,178,767,596,159,723,524,152
060374637001,665,416,249,675,412,263,685,483,193,618,372,206
060374639003,842,520,322,855,515,340,981,681,281,892,571,277
060374614002,344,255,89,352,255,97,459,370,88,421,322,82
060374614003,417,312,105,420,305,115,508,408,96,484,373,93
060374616002,698,585,113,708,572,136,859,718,124,860,698,117
060374617001,362,303,59,363,293,70,413,354,54,345,294,35
060374616003,488,439,49,491,434,57,860,704,142,582,499,51
060374619012,199,179,20,203,179,24,338,276,55,209,179,18
060374619021,192,149,43,196,149,47,204,169,33,141,104,27
060374619022,470,364,106,480,364,116,622,510,102,561,406,113
060374622021,593,481,112,605,475,130,890,717,147,429,337,61
060374622022,375,303,72,380,300,80,662,545,105,511,402,75
060374622012,328,277,51,336,274,62,458,363,87,339,277,42
060374622013,397,335,62,406,331,75,578,482,83,459,374,56
060374624004,321,274,47,321,266,55,600,470,116,494,390,74
060374634003,389,290,99,395,286,109,477,368,100,437,312,98
060374641023,325,138,187,343,144,199,458,266,182,404,198,180
060374619013,473,412,61,473,393,80,593,490,90,481,401,41
060374623021,443,359,84,449,357,92,625,497,107,480,366,70
060374623022,324,263,61,331,263,68,476,382,82,298,228,44
060375004044,420,317,103,425,307,118,546,388,148,664,487,135
060375004043,437,342,95,441,335,106,691,508,171,583,441,119
060375004042,326,259,67,328,256,72,441,328,102,364,288,57
060375004041,250,207,43,250,201,49,435,313,112,367,290,56
060375025001,477,394,83,483,374,109,726,552,159,584,457,93
060375026021,307,256,51,306,238,68,713,551,148,476,363,85
060375026022,462,379,83,469,362,107,757,558,189,535,402,96
060375026023,384,307,77,389,301,88,629,457,155,506,383,92
060375004021,295,260,35,299,257,42,572,446,121,344,297,34
060375004022,243,212,31,247,211,36,475,360,108,330,282,37
060375009001,441,359,82,445,346,99,518,390,114,528,402,93
060375009002,379,313,66,383,301,82,576,436,129,508,394,85
060375009003,505,423,82,514,422,92,727,567,151,611,482,98
060375006002,236,206,30,237,199,38,354,281,62,291,253,24
060375006005,343,293,50,346,286,60,549,426,111,486,405,52
060375006003,221,188,33,223,181,42,336,253,76,261,207,42
060375006004,290,246,44,290,239,51,436,327,98,353,283,45
060375007001,334,268,66,339,261,78,469,354,106,350,269,66
060375009004,213,170,43,214,166,48,515,396,107,317,238,59
060375007002,386,307,79,392,300,92,576,426,137,477,373,94
060375007003,411,336,75,415,327,88,546,404,129,443,346,77
060375007004,412,339,73,415,331,84,565,423,133,481,383,71
060375007005,300,247,53,303,241,62,461,348,109,404,323,59
060375007006,180,152,28,180,143,37,292,215,69,234,185,32
060375008002,604,493,111,619,487,132,955,726,211,813,641,132
060375008003,674,563,111,674,548,126,988,752,219,800,640,121
060375008001,366,305,61,366,298,68,524,398,118,450,363,69
060375024011,486,393,93,489,384,105,730,540,174,678,529,115
060375024022,625,513,112,624,495,129,854,649,189,720,579,98
060375024021,572,476,96,579,469,110,821,634,166,699,569,92
060375024012,307,251,56,311,242,69,505,370,122,414,337,57
060375024013,581,478,103,585,458,127,814,600,200,725,593,95
060375025002,513,426,87,517,425,92,823,628,181,643,534,73
060375026031,850,696,154,863,671,192,1130,819,283,1021,808,156
060375026042,332,265,67,335,256,79,527,394,123,454,358,76
060375026041,453,359,94,454,343,111,657,492,161,517,398,89
060375026043,418,356,62,426,339,87,640,475,150,476,383,73
060375026032,320,271,49,324,260,64,489,355,125,430,351,61
060375004023,439,375,64,442,365,77,833,634,175,561,455,77
060374017073,508,388,120,512,377,135,679,471,187,566,429,109
060374017074,909,624,285,925,624,301,1387,975,382,875,600,228
060374090001,229,181,48,229,173,56,446,307,122,300,228,48
060374025011,193,168,25,192,160,32,425,311,100,255,212,29
060374025012,348,301,47,350,291,59,792,590,179,523,439,59
060374025031,206,170,36,205,164,41,439,322,103,303,247,37
060374021011,436,347,89,440,335,105,775,534,213,558,441,89
060374021021,623,487,136,634,475,159,1097,802,266,748,576,125
060374021012,332,297,35,339,293,46,521,404,104,479,417,39
060374021013,320,277,43,323,270,53,504,388,100,397,335,41
060374021022,542,417,125,548,401,147,939,634,281,687,525,124
060374022001,626,403,223,629,387,242,801,547,236,704,427,232
060374022002,674,454,220,682,451,231,1156,763,369,841,533,247
060374028031,170,142,28,170,135,35,362,261,93,197,167,23
060374029021,344,280,64,345,269,76,645,470,160,437,350,61
060374024032,633,486,147,647,487,160,1043,745,271,750,563,140
060374090004,358,243,115,367,239,128,560,395,147,483,326,124
060374024031,276,232,44,282,234,48,432,328,93,353,287,44
060374024041,625,563,62,634,532,102,21,18,3,773,592,73
060374024052,429,374,55,435,366,69,900,739,152,550,471,53
060374024051,232,203,29,237,200,37,363,286,67,248,212,23
060374024061,141,120,21,143,119,24,310,237,64,346,281,42
060374024063,445,380,65,451,373,78,482,367,101,493,391,65
060374024062,235,201,34,238,199,39,325,249,68,310,258,34
060374023011,524,411,113,534,398,136,953,682,238,665,513,107
060374023012,445,348,97,455,340,115,862,628,206,706,546,110
060374023041,261,204,57,266,199,67,566,420,130,322,265,36
060374023042,159,131,28,158,121,37,291,218,64,211,163,30
060374088001,171,138,33,174,135,39,242,186,55,227,171,39
060374088002,301,253,48,302,250,52,523,410,102,311,261,43
060374023033,275,207,68,280,198,82,375,276,94,288,208,52
060374023032,169,128,41,173,122,51,325,236,81,257,183,48
060374023031,198,149,49,201,142,59,403,288,100,274,191,54
060374026021,268,197,71,274,194,80,382,264,103,320,215,78
060374026022,371,273,98,382,270,112,484,347,115,468,314,116
060374026023,563,407,156,564,390,174,654,461,184,598,405,151
060374026011,288,215,73,289,208,81,421,295,121,324,233,79
060374026012,266,198,68,265,191,74,433,306,125,371,263,89
060374026013,174,134,40,177,132,45,464,320,128,329,231,74
060374027032,579,444,135,598,451,147,983,728,231,802,617,142
060374027052,554,427,127,561,415,146,836,618,194,715,536,138
060374027063,268,207,61,275,205,70,441,321,109,300,225,54
060374027022,139,113,26,139,109,30,275,204,63,231,180,37
060374027024,245,189,56,245,184,61,454,337,103,457,342,78
060374027051,292,224,68,292,221,71,297,225,68,275,209,48
060374027021,182,160,22,182,150,32,527,389,121,369,290,56
060374027023,125,103,22,120,96,24,190,141,43,229,178,33
060374028011,161,135,26,162,132,30,405,318,71,281,233,38
060374028012,166,142,24,168,138,30,242,188,43,181,151,26
060374027031,416,324,92,425,319,106,840,626,199,605,457,116
060374027062,211,166,45,219,165,54,394,285,99,312,235,61
060374027061,399,323,76,403,314,89,657,476,166,305,242,48
060374090002,322,238,84,323,232,91,509,345,149,347,236,89
060374090003,581,427,154,586,417,169,978,649,315,623,437,143
060374025042,209,172,37,209,168,41,353,259,84,279,225,36
060374025032,353,291,62,359,283,76,533,388,124,400,325,51
060374030003,496,411,85,504,401,103,709,533,155,609,485,84
060374025041,250,205,45,251,203,48,382,282,98,341,279,42
060374030001,509,421,88,512,407,105,890,663,201,639,509,91
060374030002,280,241,39,280,233,47,468,355,97,356,293,41
060374028013,156,135,21,155,132,23,249,201,45,259,203,36
060374028032,244,203,41,244,197,47,405,293,104,302,250,37
060374088003,156,137,19,157,135,22,241,190,43,157,124,21
060374029022,367,289,78,370,282,88,617,453,147,510,388,88
060374029032,508,416,92,516,410,106,844,620,207,600,488,79
060374029041,331,264,67,335,258,77,545,396,129,429,331,68
060374028041,130,107,23,132,104,28,326,234,83,268,215,35
060374029031,274,226,48,277,222,55,540,395,132,338,280,43
060374029023,358,293,65,369,285,84,680,487,165,521,401,80
060374029042,408,330,78,420,323,97,499,359,122,490,377,75
060374033182,652,419,233,662,423,239,968,643,302,705,445,227
060374033171,949,630,319,971,621,350,1395,855,514,1137,695,379
060374033183,773,459,314,792,450,342,1175,699,453,925,585,289
060374033173,655,385,270,675,389,286,868,532,316,740,471,228
060374033181,443,297,146,458,299,159,705,446,251,577,407,150
060374033184,402,230,172,412,231,181,661,416,235,507,299,185
060379011021,758,270,488,763,270,493,970,373,574,731,241,433
060379011022,315,113,202,324,115,209,684,263,400,573,205,325
060379103012,1136,370,766,1168,357,811,1611,618,957,1311,364,866
060379011011,755,292,463,768,283,485,1193,442,715,988,353,564
060374063001,694,366,328,705,363,342,1118,623,476,855,458,363
060374054001,273,200,73,282,196,86,478,322,149,356,255,88
060374054002,374,271,103,379,266,113,608,406,191,478,332,121
060374054004,293,214,79,300,208,92,486,327,151,390,279,95
060374053012,340,230,110,347,230,117,634,417,201,475,317,130
060374054003,394,283,111,397,278,119,659,437,205,474,329,118
060374055001,366,256,110,372,252,120,544,366,171,495,329,141
060374057011,349,229,120,350,233,117,505,346,148,411,280,105
060374013031,960,459,501,978,449,529,1418,729,669,1105,552,503
060374035001,664,324,340,673,314,359,909,473,417,671,341,297
060376704131,921,473,448,934,473,461,1333,813,488,1193,648,483
060376704132,1120,611,509,1142,611,531,1616,1014,564,1180,670,462
060376704051,896,449,447,910,440,470,1210,716,465,966,500,418
060376706043,355,181,174,361,177,184,369,218,143,366,192,153
060376706031,859,442,417,876,442,434,1215,706,492,1130,626,462
060376704181,990,527,463,1006,518,488,1133,676,428,812,435,323
060376704071,796,455,341,816,445,371,1387,848,504,927,518,352
060376704072,476,272,204,489,265,224,758,464,276,704,421,244
060376704073,645,380,265,657,369,288,855,542,294,768,469,256
060376704182,948,496,452,972,499,473,1228,740,467,1136,606,470
060376704162,890,464,426,909,470,439,1391,812,551,856,471,344
060376706042,908,475,433,923,478,445,1345,768,550,753,403,304
060376707022,619,281,338,625,278,347,810,416,375,691,316,345
060376707012,882,444,438,904,443,461,1240,684,530,890,434,408
060376707023,540,244,296,546,244,302,713,364,329,620,288,304
060376707024,770,345,425,789,356,433,1053,546,487,1000,468,471
060376706041,1579,749,830,1602,746,856,1931,1043,852,1515,739,690
060372964011,974,575,399,993,561,432,1293,763,511,1287,734,469
060376707013,604,309,295,626,313,313,793,434,335,780,396,337
060376707025,552,253,299,557,257,300,806,413,375,665,311,318
060376704052,367,201,166,373,200,173,565,334,223,393,220,154
060376707011,1013,567,446,1018,561,457,1429,783,608,1201,681,469
060376707021,338,149,189,343,145,198,479,252,218,293,128,142
060376707014,433,257,176,452,264,188,627,348,267,503,284,184
060376213261,398,266,132,415,270,145,515,336,165,468,282,147
060376213263,621,407,214,639,406,233,872,556,291,696,421,222
060376214001,847,509,338,867,505,362,1116,717,370,876,523,295
060376214002,673,404,269,692,404,288,845,547,272,784,467,264
060376214003,343,200,143,350,200,150,429,268,150,337,193,122
060376214004,526,301,225,528,296,232,641,394,227,521,280,200
060376513042,543,315,228,555,311,244,676,402,260,590,342,209
060376213262,441,282,159,447,277,170,639,409,220,488,296,158
060376213012,873,544,329,885,542,343,1192,776,375,928,588,277
060376213011,804,561,243,824,568,256,1065,732,309,862,559,243
060376213014,729,440,289,744,437,307,911,600,294,745,425,259
060376213241,657,425,232,669,419,250,909,588,300,791,485,258
060376213243,518,336,182,527,329,198,757,491,247,565,345,184
060376213242,474,291,183,487,294,193,655,430,213,676,408,220
060376212012,1003,607,396,1035,616,419,1362,872,451,1114,649,384
060376212013,1012,627,385,1052,636,416,1047,704,321,1242,739,411
060376212043,744,454,290,757,454,303,1355,847,473,913,530,327
060376212041,416,254,162,424,254,170,190,120,66,380,216,145
060376212011,938,608,330,963,610,353,1704,1152,508,1158,712,358
060376207031,444,289,155,455,289,166,563,390,161,498,318,145
060376207033,693,448,245,710,450,260,945,651,271,767,493,220
060376207011,820,552,268,831,552,279,1210,853,319,1022,650,281
060376207012,853,566,287,874,575,299,1221,844,349,886,573,246
060376207013,589,388,201,601,396,205,766,525,227,676,435,192
060376206022,361,214,147,382,219,163,532,329,188,458,248,176
060376206023,370,220,150,383,221,162,503,322,174,496,271,192
060376206024,621,377,244,634,368,266,811,521,273,704,413,244
060376206011,446,299,147,450,296,154,668,476,176,481,315,136
060376206012,529,356,173,538,355,183,771,550,202,633,411,175
060376206013,523,357,166,531,350,181,788,567,205,588,370,164
060376206014,683,502,181,696,507,189,1029,739,263,823,553,188
060376205212,407,287,120,414,293,121,642,479,151,509,338,133
060376205221,567,398,169,571,397,174,724,525,176,658,449,165
060376205223,708,477,231,720,478,242,900,639,232,762,490,217
060376205214,386,269,117,392,272,120,565,406,146,443,291,122
060376205222,835,558,277,854,564,290,1169,809,320,917,598,260
060376205211,490,350,140,501,360,141,734,523,195,549,363,143
060376205012,364,227,137,367,228,139,486,321,149,398,239,126
060376205013,523,329,194,532,334,198,690,456,212,568,346,181
060376205011,481,341,140,488,336,152,651,436,191,609,401,158
060376205014,356,233,123,362,232,130,477,319,141,419,264,126
060376205016,492,366,126,498,358,140,741,516,205,599,414,139
060376205015,309,197,112,316,198,118,423,294,116,344,213,108
060376205213,281,201,80,281,200,81,384,286,91,330,221,81
060376207014,844,561,283,856,564,292,1007,700,292,906,586,257
060376213013,877,559,318,890,561,329,1179,771,373,977,607,299
060376207041,915,596,319,938,595,343,1316,891,385,1037,673,294
060376207032,521,345,176,530,343,187,652,455,182,533,344,150
060376207042,634,413,221,649,410,239,893,609,258,711,466,193
060376206025,520,345,175,524,332,192,725,471,237,560,354,165
060376206021,490,279,211,501,271,230,650,405,231,547,307,199
060376505013,464,221,243,476,221,255,593,325,260,551,265,248
060376514011,569,305,264,578,306,272,730,404,312,615,311,268
060376704061,782,389,393,806,395,411,1090,645,432,966,522,404
060374322012,564,391,173,570,369,201,977,636,319,674,470,181
060374322021,355,260,95,369,261,108,531,347,176,429,303,109
060374322011,310,217,93,318,212,106,527,354,172,372,260,94
060374322022,185,137,48,193,140,53,379,258,119,229,171,49
060374322023,387,290,97,404,292,112,705,473,220,441,329,93
060374329012,217,159,58,223,163,60,521,339,173,363,267,79
060374329013,176,128,48,180,127,53,292,191,99,211,157,47
060374813001,366,266,100,374,263,111,509,335,170,378,278,86
060374813002,306,213,93,309,205,104,519,339,174,421,303,100
060374329021,359,261,98,374,264,110,616,403,204,436,323,93
060374329011,392,288,104,406,300,106,745,485,254,505,375,108
060374823031,179,132,47,185,136,49,413,274,131,265,209,42
060374823032,247,186,61,255,189,66,669,445,210,350,262,70
060374823033,272,201,71,285,208,77,561,370,183,398,303,76
060374824041,229,175,54,236,176,60,352,245,100,259,196,49
060374824042,519,387,132,529,383,146,784,557,215,681,488,162
060374336012,510,371,139,521,367,154,898,599,284,670,514,125
060374336011,360,261,99,376,265,111,667,443,216,474,335,112
060374824011,266,198,68,278,199,79,535,362,172,333,247,70
060374823041,211,166,45,212,160,52,440,304,131,280,223,41
060374823042,194,153,41,195,147,48,420,284,129,263,213,40
060374825021,230,186,44,236,181,55,361,251,107,300,238,49
060374825022,253,205,48,257,197,60,397,272,118,348,276,56
060374825032,293,233,60,302,234,68,584,397,174,384,311,53
060374825212,550,422,128,565,416,149,936,617,302,661,501,120
060374824031,521,412,109,533,421,112,938,640,279,712,567,109
060374825031,205,161,44,212,165,47,434,295,131,281,224,40
060374336021,403,301,102,415,294,121,843,573,253,534,411,101
060374824012,263,196,67,265,192,73,592,398,186,359,278,64
060374082131,335,221,114,347,218,129,557,353,193,425,263,140
060374082132,311,206,105,324,203,121,810,515,281,532,355,147
060374086263,548,323,225,564,328,236,671,409,258,565,351,180
060374086271,578,343,235,597,340,257,788,465,311,678,407,234
060374086272,319,188,131,330,188,142,456,276,175,395,239,138
060374087221,538,327,211,554,323,231,1071,624,431,814,492,269
060374087251,269,174,95,275,172,103,322,200,116,415,259,131
060374087241,193,125,68,200,124,76,452,281,162,293,197,81
060374086262,257,163,94,263,165,98,417,265,145,252,162,75
060374087071,619,350,269,627,357,270,994,566,412,713,414,264
060374087252,569,367,202,580,364,216,913,552,342,548,342,168
060374087242,212,138,74,215,135,80,557,348,200,361,223,110
060374087243,81,53,28,84,53,31,275,171,99,172,106,52
060374087222,570,333,237,594,329,265,831,499,326,703,414,249
060374087032,590,332,258,616,325,291,1023,605,402,831,477,309
060374087072,464,234,230,475,232,243,883,480,391,468,251,190
060374087053,476,275,201,480,275,205,915,507,396,544,309,210
060374087253,391,250,141,401,247,154,638,387,239,427,269,130
060374087051,306,193,113,312,187,125,463,288,165,402,248,129
060374087052,604,382,222,620,370,250,1009,581,403,659,408,209
060374082133,316,218,98,324,216,108,402,269,125,215,146,58
060374082121,611,364,247,628,356,272,1066,619,429,748,494,233
060374086261,273,183,90,281,184,97,504,308,186,213,147,60
060374013112,631,321,310,642,309,333,1007,510,478,790,379,347
060374013114,626,311,315,634,300,334,939,473,442,721,329,341
060374004031,949,424,525,968,431,537,1204,569,607,1063,446,559
060374013041,1325,605,720,1340,590,750,1926,925,968,1502,703,722
060374013043,859,389,470,867,385,482,1139,569,553,949,444,456
060374013111,736,320,416,746,311,435,1106,514,571,800,340,412
060374003044,463,212,251,472,207,265,513,271,232,558,265,260
060374003045,554,250,304,563,243,320,743,382,347,614,273,300
060374003041,557,327,230,562,315,247,917,501,394,614,330,239
060374012021,573,311,262,590,301,289,855,402,427,641,323,287
060374013122,1120,548,572,1133,533,600,1465,736,701,1309,615,613
060374013042,465,219,246,468,213,255,749,378,357,506,203,280
060374013121,884,433,451,902,409,493,1260,622,611,1055,478,521
060374003042,403,241,162,410,235,175,851,465,362,495,270,187
060374013113,488,252,236,496,245,251,673,350,307,593,353,195
060373203003,387,339,48,393,327,66,619,495,106,497,431,44
060373203004,412,360,52,411,343,68,527,428,93,510,433,58
060371066491,329,277,52,330,262,68,462,353,101,385,302,65
060373203001,379,328,51,376,306,70,632,501,116,542,459,53
060373203002,335,288,47,329,269,60,602,482,108,473,402,48
060373202011,176,145,31,176,136,40,338,250,74,241,196,32
060373202022,366,306,60,365,288,77,563,428,122,439,352,66
060373202023,243,200,43,241,185,56,420,313,93,292,238,39
060373202024,292,239,53,292,225,67,393,296,86,299,245,40
060373201012,417,328,89,414,313,101,643,483,151,506,400,79
060373202012,326,257,69,326,245,81,595,452,128,497,372,93
060373202021,546,421,125,540,402,138,712,530,162,587,430,116
060373201021,419,352,67,424,345,79,750,575,155,624,492,92
060373201022,370,310,60,372,302,70,613,472,129,484,405,51
060373201011,515,410,105,522,396,126,887,650,216,648,511,100
060373202013,199,168,31,200,161,39,439,334,99,305,250,42
060374802011,677,403,274,692,405,287,892,585,291,699,430,239
060374802012,481,281,200,489,281,208,622,409,203,470,275,176
060374801024,277,168,109,292,172,120,493,306,181,333,208,104
060374802022,343,214,129,350,212,138,366,241,119,443,269,150
060374811022,93,61,32,96,60,36,289,184,101,159,106,44
060374811023,300,212,88,305,208,97,639,433,193,418,303,93
060374802021,283,181,102,290,179,111,274,192,81,340,217,106
060374802023,339,216,123,344,212,132,350,244,97,413,244,148
060374811021,311,220,91,315,214,101,573,386,173,346,250,78
060374802013,607,412,195,623,413,210,777,523,236,678,437,210
060374811012,395,291,104,406,289,117,689,465,211,412,307,88
060374811033,340,225,115,355,234,121,461,294,154,420,283,111
060374811034,246,160,86,255,165,90,322,206,109,259,170,73
060374814011,341,232,109,344,221,123,993,643,324,434,300,114
060374814012,442,295,147,453,299,154,558,366,183,577,382,171
060374811031,281,208,73,287,209,78,544,341,190,388,290,73
060374811032,275,205,70,282,202,80,521,334,183,347,260,65
060374814013,143,102,41,148,100,48,285,188,92,161,113,39
060374814041,170,120,50,178,118,60,292,191,101,212,143,58
060374814042,375,266,109,389,262,127,752,486,251,523,363,135
060374814043,218,153,65,228,151,77,372,240,128,221,149,61
060374823011,267,198,69,278,197,81,445,308,130,302,225,58
060374823013,145,111,34,153,111,42,347,232,104,254,192,49
060374823014,129,99,30,135,99,36,290,195,89,219,163,46
060374823012,152,116,36,157,116,41,272,184,82,186,139,39
060374814031,213,156,57,221,155,66,393,264,122,254,189,51
060374814032,299,212,87,310,219,91,575,378,193,395,285,92
060374641021,553,317,236,560,307,253,716,412,282,567,334,205
060374641022,469,268,201,478,262,216,630,365,251,499,294,184
060374641011,436,215,221,455,219,236,601,364,227,493,274,187
060374641012,366,167,199,377,171,206,531,317,207,452,234,187
060374641024,494,237,257,514,242,272,609,363,232,562,306,219
060374641013,337,141,196,351,146,205,523,307,207,335,161,154
060374642006,558,281,277,576,284,292,803,486,306,603,338,225
060374642002,276,137,139,283,139,144,395,234,153,299,170,115
060374642003,339,178,161,357,177,180,619,362,238,408,233,153
060374642004,360,187,173,378,186,192,627,378,233,412,236,155
060379203341,341,190,151,351,190,161,424,227,190,304,157,130
060379203343,989,548,441,1024,553,471,1296,725,542,928,511,354
060379200182,659,266,393,679,261,418,851,387,440,696,272,383
060379200181,407,165,242,418,161,257,601,274,314,426,167,232
060379201111,736,350,386,744,345,399,1288,630,630,921,403,459
060379201112,783,366,417,785,357,428,973,496,456,863,377,430
060379200171,591,285,306,604,281,323,768,374,379,472,191,251
060379201123,618,304,314,626,297,329,761,390,358,572,277,266
060379201151,539,251,288,545,244,301,557,282,266,637,285,314
060379201152,530,270,260,538,263,275,725,389,322,442,206,210
060379203122,871,402,469,896,405,491,986,450,515,804,353,398
060379201153,799,417,382,810,413,397,886,499,374,959,511,394
060379203291,622,328,294,639,326,313,1222,685,513,841,426,352
060379203292,1133,585,548,1160,580,580,1263,645,593,1223,585,564
060379203311,752,382,370,762,377,385,965,499,447,1052,509,485
060379203312,721,371,350,732,363,369,1051,563,470,644,311,298
060379200314,657,368,289,673,371,302,1209,661,529,777,431,292
060379203142,440,177,263,447,172,275,838,396,424,509,204,270
060379203321,481,158,323,490,162,328,395,222,166,597,170,391
060379203421,207,154,53,207,148,59,379,248,118,250,183,51
060379203322,406,131,275,412,134,278,565,247,312,346,86,238
060379203344,853,466,387,881,467,414,843,471,353,825,445,335
060379203141,818,362,456,833,348,485,1227,510,687,930,394,478
060379203313,473,248,225,482,239,243,503,270,225,367,177,170
060379203431,318,230,88,322,222,100,606,394,188,410,288,93
060379203432,462,321,141,471,310,161,496,326,155,521,312,183
060379203422,134,101,33,135,97,38,385,257,124,263,195,57
060379203221,560,283,277,571,282,289,868,452,402,635,310,295
060379203342,672,339,333,685,338,347,920,480,425,951,423,475
060379203402,378,236,142,387,235,152,394,257,127,262,165,81
060379203281,863,458,405,883,461,422,1347,736,585,960,477,430
060379203222,916,479,437,935,482,453,1142,612,514,921,470,406
060379203401,381,199,182,388,200,188,565,288,256,404,211,167
060379203132,668,340,328,683,337,346,933,530,386,778,372,343
060379203131,761,393,368,780,386,394,1069,580,464,935,450,410
060379203133,1024,467,557,1047,474,573,1003,476,504,797,342,398
060379203121,507,221,286,526,219,307,712,336,358,379,169,182
060379200381,651,405,246,664,398,266,862,477,369,770,486,226
060379200382,420,260,160,429,257,172,553,306,235,396,235,133
060379200391,784,399,385,801,388,413,960,510,427,808,379,374
060379200172,680,333,347,697,323,374,867,418,425,816,348,409
060379200173,631,289,342,651,289,362,827,394,411,725,290,377
060379200441,906,446,460,937,445,492,1290,617,634,932,414,440
060379200452,1279,599,680,1322,604,718,1736,868,833,1684,758,837
060379200453,417,206,211,434,209,225,587,294,284,320,153,145
060379200442,241,119,122,249,118,131,358,177,165,274,123,127
060379200451,390,180,210,400,179,221,533,266,250,397,178,187
060379200202,1290,555,735,1320,543,777,1646,761,847,1424,571,750
060379200203,725,310,415,744,304,440,1061,482,549,783,323,406
060379200201,866,376,490,879,366,513,1267,589,645,961,400,500
060379200281,889,447,442,919,434,485,1924,1041,847,1201,576,551
060379200291,723,350,373,748,339,409,1044,543,478,885,413,418
060379200151,1400,635,765,1438,634,804,2030,945,1049,1560,699,778
060379200152,1463,650,813,1500,651,849,2238,992,1205,1570,633,855
060379200161,486,251,235,504,249,255,512,267,238,448,216,204
060379200162,1696,732,964,1718,719,999,2343,1086,1217,1939,852,980
060379200301,365,219,146,373,215,158,725,450,259,342,205,109
060379200302,848,526,322,864,520,344,816,483,319,1017,571,388
060379200303,1037,588,449,1050,594,456,1869,1052,778,1026,533,446
060379200312,1221,590,631,1263,587,676,1129,616,501,1261,602,592
060379200132,1600,839,761,1635,833,802,2231,1126,1061,1048,440,537
060379200481,837,488,349,847,497,350,1157,659,470,711,378,282
060379200292,418,212,206,428,203,225,601,312,279,369,182,166
060379200293,185,94,91,191,91,100,250,129,115,348,172,157
060379200355,341,202,139,344,189,155,551,332,211,384,215,140
060379200482,537,310,227,543,288,255,672,366,289,534,288,208
060379200483,468,270,198,472,252,220,797,434,342,584,317,226
060379200353,298,195,103,303,187,116,561,356,197,360,215,123
060379200352,713,448,265,726,447,279,1052,617,413,831,493,291
060379200354,384,241,143,389,229,160,652,412,229,451,253,163
060379200311,244,157,87,246,152,94,63,38,25,422,260,133
060379200351,494,320,174,502,312,190,784,506,261,599,358,205
060379200313,594,278,316,613,281,332,783,394,378,660,290,348
060379201091,1284,596,688,1307,602,705,878,490,377,863,427,396
060379201142,681,385,296,697,388,309,1061,614,434,712,396,274
060379200421,676,371,305,688,364,324,931,478,436,587,302,258
060379200422,484,261,223,495,256,239,594,305,279,468,241,209
060379200423,440,249,191,449,243,206,556,286,261,558,295,231
060379200411,742,379,363,748,362,386,1011,567,424,905,498,355
060379201101,680,320,360,691,322,369,826,423,389,784,359,383
060379201102,761,358,403,776,359,417,1079,554,507,707,327,337
060379200432,1249,754,495,1266,743,523,2281,1342,899,1568,968,519
060379200131,929,508,421,942,510,432,848,463,371,631,318,274
060379203293,785,381,404,796,373,423,944,467,458,584,270,283
060379203302,482,253,229,491,248,243,569,304,252,416,206,183
060379203303,695,318,377,707,306,401,1143,583,540,622,302,280
060379203304,700,320,380,710,307,403,1147,586,543,965,426,474
060379108082,635,304,331,653,295,358,911,443,445,872,382,427
060379108071,1123,552,571,1148,541,607,1451,738,688,1033,471,497
060379203301,731,413,318,746,410,336,256,138,115,601,320,241
060379201212,875,503,372,900,499,401,2049,1184,827,679,343,306
060379201143,398,218,180,407,217,190,460,273,177,430,215,185
060379201144,348,189,159,353,188,165,741,439,285,483,284,163
060379201211,1088,666,422,1109,654,455,1402,803,576,1271,741,447
060379201213,861,512,349,886,506,380,1744,984,737,714,433,231
060379201121,613,307,306,619,298,321,789,401,367,779,390,341
060379201141,728,346,382,738,339,399,878,458,404,761,357,355
060379201122,779,377,402,790,370,420,911,452,443,891,416,416
060379201201,1046,563,483,1073,553,520,1598,882,690,1507,751,676
060379201202,410,230,180,419,226,193,548,304,234,314,162,134
060379201092,915,435,480,935,429,506,1689,891,766,1294,644,575
060379201093,384,206,178,394,216,178,536,280,245,695,324,352
060379203411,188,127,61,193,126,67,353,230,114,278,174,85
060379203412,185,125,60,191,124,67,395,222,171,313,165,133
060379200461,463,295,168,471,275,196,747,489,239,517,288,187
060379200473,191,153,38,196,152,44,307,228,72,257,184,53
060379200471,276,221,55,282,218,64,542,397,126,428,303,90
060379200472,202,162,40,206,159,47,343,252,80,185,132,38
060379200133,764,398,366,775,390,385,1358,735,594,1287,654,546
060379200425,451,292,159,460,291,169,651,419,221,453,261,166
060379200424,454,295,159,461,291,170,948,611,320,530,303,196
060375027001,470,363,107,495,372,123,758,523,212,668,508,124
060375027002,479,354,125,494,358,136,798,540,241,589,438,119
060375028012,694,460,234,708,438,270,935,598,315,805,525,229
060375028014,428,306,122,433,292,141,667,456,195,527,364,135
060375028015,380,286,94,385,274,111,481,331,136,425,299,103
060375042001,397,276,121,400,272,128,1141,770,356,845,599,196
060375027004,1155,893,262,1191,896,295,1437,1011,387,925,707,162
060375042002,428,310,118,428,295,133,723,519,183,636,449,152
060375028011,340,239,101,341,224,117,471,317,140,521,349,140
060375027003,440,336,104,447,322,125,651,449,183,512,384,96
060375029012,785,583,202,799,558,241,1143,768,348,938,663,227
060375030001,165,132,33,165,124,41,269,196,71,203,157,35
060377012011,484,352,132,493,358,135,450,351,97,505,382,101
060377012012,572,421,151,593,428,165,681,531,144,651,490,127
060377012014,568,417,151,583,421,162,611,467,127,669,511,133
060377012022,914,777,137,936,776,160,1036,865,157,973,823,108
060377013023,793,642,151,816,642,174,966,783,165,935,740,143
060377013042,783,610,173,793,609,184,970,746,206,725,543,144
060377013043,1173,896,277,1189,896,293,1683,1297,354,1472,1106,298
060377017023,529,440,89,537,441,96,757,627,117,545,425,84
060377018023,445,373,72,459,383,76,525,417,97,555,445,74
060377018024,273,238,35,280,241,39,352,292,53,331,273,38
060377019021,925,740,185,948,740,208,1292,979,284,1095,807,214
060377019023,616,506,110,633,513,120,901,714,170,498,390,76
060377013022,810,664,146,828,668,160,997,799,180,899,722,127
060377014024,648,515,133,655,509,146,869,683,171,805,616,143
060377015013,1037,840,197,1063,858,205,1327,1051,250,1168,909,192
060377016012,925,703,222,939,716,223,1214,953,240,1080,852,181
060377016013,443,349,94,449,354,95,472,384,88,411,332,66
060377016014,593,485,108,597,484,113,718,588,126,627,501,98
060377012021,886,712,174,901,726,175,1105,904,179,946,746,156
060377012013,428,314,114,437,318,119,526,403,110,472,359,87
060377012015,404,298,106,411,301,110,520,403,112,440,336,82
060377019022,269,217,52,276,217,59,423,316,99,397,296,78
060377014021,474,376,98,484,384,100,548,427,113,575,445,96
060377014022,1219,983,236,1238,994,244,1387,1051,309,1281,993,206
060377014023,811,610,201,826,628,198,992,755,223,895,667,173
060377017013,769,661,108,779,666,113,987,824,148,873,723,108
060377018011,403,339,64,412,341,71,491,402,80,532,421,76
060372676003,348,290,58,353,291,62,476,384,86,391,309,58
060377018021,623,553,70,639,562,77,788,665,105,809,674,83
060377018022,454,391,63,459,391,68,489,391,79,470,393,48
060377018013,802,710,92,811,717,94,1213,1046,142,919,776,78
060377023004,695,594,101,703,586,117,909,776,119,757,618,89
060377023005,914,773,141,919,765,154,1044,878,150,958,786,111
060377016011,336,242,94,339,244,95,409,314,80,371,272,78
060372643052,715,537,178,723,536,187,984,743,233,886,661,193
060377015011,888,745,143,900,749,151,958,789,158,942,760,137
060377015012,651,538,113,661,545,116,792,647,130,709,566,107
060377015022,570,482,88,570,485,85,790,658,120,635,520,79
060377015023,610,513,97,622,509,113,769,628,119,725,564,114
060377016022,787,662,125,806,676,130,986,812,148,870,705,112
060377016023,370,309,61,380,316,64,536,444,80,416,337,54
060377016021,747,642,105,758,641,117,920,771,134,792,657,93
060377017012,530,440,90,536,441,95,652,524,114,592,479,85
060377017011,296,239,57,301,240,61,342,270,66,325,253,53
060377017021,413,338,75,417,340,77,485,384,93,494,391,74
060377017022,457,391,66,462,396,66,669,535,117,524,437,48
060377015021,426,361,65,425,365,60,562,469,86,504,416,60
060377018012,287,242,45,291,245,46,428,354,67,287,235,32
060377018014,767,682,85,793,698,95,1156,975,151,946,798,87
060377020022,678,593,85,692,594,98,813,698,100,784,662,70
060377020023,842,748,94,855,738,117,1007,881,104,969,829,72
060377022012,406,342,64,408,341,67,447,384,56,408,328,53
060377022014,460,405,55,473,412,61,643,559,80,537,451,57
060377022015,356,312,44,364,316,48,468,402,59,399,342,42
060377022013,537,450,87,542,444,98,739,628,93,607,485,78
060372713003,702,559,143,705,562,143,910,725,160,878,680,134
060377023001,633,529,104,643,528,115,791,664,115,681,564,85
060377023003,597,506,91,600,498,102,709,604,99,622,500,82
060377022011,615,520,95,630,531,99,744,623,98,726,577,105
060377021024,433,358,75,439,363,76,506,400,98,416,333,56
060377021025,356,308,48,364,313,51,409,345,57,397,331,37
060377021026,400,353,47,403,350,53,465,410,48,427,362,37
060377021027,877,777,100,887,777,110,979,830,123,959,809,92
060377022021,454,387,67,459,390,69,576,476,88,510,422,59
060377022022,382,317,65,391,321,70,455,388,66,401,327,57
060377022023,398,317,81,408,323,85,486,408,72,465,365,78
060377022024,504,405,99,512,409,103,563,469,87,581,458,92
060377022025,392,331,61,395,334,61,502,417,77,431,349,55
060372713004,673,514,159,679,519,160,881,705,160,729,549,130
060377023002,636,535,101,645,537,108,763,635,114,696,570,90
060372731001,348,301,47,350,299,51,501,423,70,513,432,55
060377021022,321,287,34,322,285,37,425,364,59,369,317,32
060377021023,306,274,32,311,273,38,383,322,51,348,296,29
060377013021,913,740,173,931,741,190,1129,899,211,1014,801,153
060377020021,751,643,108,768,650,118,979,814,147,908,744,107
060377020024,774,668,106,777,663,114,961,804,137,842,695,91
060377021021,644,513,131,652,519,133,909,716,173,760,580,132
060377013041,907,695,212,923,687,236,1007,784,218,913,698,186
060377013044,427,327,100,431,327,104,556,431,121,419,323,77
060379200282,501,280,221,508,273,235,713,398,302,539,279,226
060379200283,893,496,397,909,487,422,1539,861,650,993,507,414
060374305014,739,491,248,757,497,260,894,591,281,773,482,233
060374305013,402,269,133,416,272,144,548,362,176,425,270,125
060374305023,671,417,254,686,417,269,985,650,311,697,420,229
060374305024,296,196,100,303,196,107,437,291,135,344,220,103
060374305026,723,469,254,733,465,268,926,614,285,784,498,236
060374305022,890,537,353,902,527,375,1084,701,354,1044,610,362
060374305025,505,318,187,510,306,204,600,397,185,554,335,182
060374305021,405,235,170,411,234,177,503,331,160,415,226,163
060374305011,607,380,227,619,379,240,672,443,211,706,430,227
060374305012,585,366,219,594,364,230,739,488,233,681,417,219
060375734011,454,347,107,462,353,109,575,435,134,551,406,122
060375734021,19,13,6,21,16,5,31,23,8,0,0,0
060375734022,273,211,62,275,207,68,465,342,112,315,233,59
060375734023,468,363,105,472,357,115,745,550,169,537,404,98
060375734031,612,427,185,613,425,188,866,620,222,580,387,157
060375734024,511,365,146,526,374,152,937,688,231,851,591,197
060375734025,688,502,186,697,495,202,851,630,199,735,516,163
060374338041,281,238,43,283,229,54,687,514,150,500,414,55
060374335061,265,234,31,266,225,41,479,376,88,373,328,29
060374335062,175,155,20,177,151,26,391,294,93,260,219,27
060374341002,354,309,45,357,298,59,528,397,116,446,368,55
060374341001,110,97,13,112,96,16,220,166,53,156,133,18
060374341005,246,201,45,249,196,53,430,303,116,289,234,39
060374341003,241,200,41,245,193,52,418,296,112,297,241,40
060374338043,373,314,59,369,291,78,444,324,113,472,382,68
060374338031,469,385,84,474,365,109,617,439,162,538,427,81
060374341004,225,188,37,224,179,45,332,244,75,225,182,29
060374338032,434,346,88,438,336,102,710,516,172,552,425,93
060374340041,595,490,105,603,471,132,1021,740,245,775,608,123
060375361021,439,329,110,442,313,129,634,447,175,554,400,123
060375361022,479,365,114,481,346,135,748,524,204,659,481,151
060375362011,435,346,89,436,330,106,822,589,216,611,448,127
060375355011,264,240,24,267,233,34,453,344,90,409,358,32
060375355012,292,260,32,295,255,40,471,374,84,419,371,29
060375355022,483,439,44,492,425,67,694,541,129,594,532,36
060375357011,425,377,48,429,369,60,667,537,113,529,460,38
060375357012,463,407,56,468,391,77,726,577,120,599,518,51
060375360001,234,209,25,234,202,32,305,245,51,276,241,19
060375358041,504,452,52,508,431,77,818,643,148,639,563,47
060375359013,354,313,41,357,297,60,587,470,108,481,424,35
060375359014,279,257,22,286,246,40,507,396,95,348,314,20
060375356031,171,153,18,171,149,22,271,220,46,260,231,18
060375356032,426,378,48,433,371,62,737,599,127,480,427,29
060375359012,382,327,55,383,316,67,534,396,122,458,382,54
060375360002,433,376,57,441,364,77,785,626,141,702,602,63
060375359022,353,293,60,355,286,69,524,404,114,436,361,57
060375359023,328,275,53,331,264,67,570,444,118,477,392,62
060375359024,540,453,87,548,427,121,832,648,168,743,617,88
060375357013,404,352,52,411,340,71,604,492,96,549,476,49
060375357022,238,216,22,240,208,32,417,336,69,319,283,23
060375357023,197,177,20,196,167,29,295,241,50,246,217,19
060375357024,346,310,36,346,293,53,569,461,97,483,420,38
060375357021,256,232,24,261,227,34,394,321,66,339,301,23
060375361031,165,141,24,168,139,29,316,248,60,264,223,30
060375361032,632,542,90,635,523,112,1133,867,238,858,701,113
060375355031,423,382,41,428,373,55,714,576,122,622,547,46
060375356071,266,244,22,276,237,39,371,307,55,426,379,25
060375356072,288,262,26,296,256,40,462,374,72,449,395,28
060375356073,128,115,13,125,111,14,281,232,46,169,147,15
060375356074,234,212,22,234,206,28,341,281,54,204,177,16
060375356041,310,284,26,313,271,42,501,409,81,389,355,22
060375356061,277,254,23,278,240,38,580,493,73,398,358,24
060375356042,415,373,42,416,359,57,631,520,98,490,419,39
060375356052,360,329,31,360,309,51,573,484,83,476,416,33
060375359011,377,320,57,384,314,70,455,351,103,442,367,58
060375356051,333,303,30,335,292,43,538,445,81,414,374,28
060375358032,230,208,22,231,201,30,445,356,77,339,295,28
060375358033,158,143,15,161,139,22,321,262,54,267,234,22
060375358021,416,369,47,422,355,67,590,469,108,520,459,36
060375358024,474,420,54,478,403,75,807,635,151,625,552,44
060375358031,257,231,26,259,224,35,429,344,71,338,289,34
060375358042,544,482,62,550,463,87,787,622,152,725,628,65
060375361033,494,434,60,503,422,81,784,602,163,591,499,64
060375361043,423,366,57,426,347,79,462,366,91,567,462,71
060375361042,232,209,23,238,207,31,428,330,82,327,287,24
060375358022,144,127,17,145,123,22,258,204,51,192,171,14
060375358023,397,346,51,401,333,68,551,434,106,461,399,38
060375359021,438,360,78,442,356,86,642,494,138,549,463,66
060375362012,475,386,89,481,364,117,786,575,188,585,458,92
060375362023,390,317,73,390,294,96,584,437,132,475,372,75
060375362021,334,283,51,340,271,69,464,355,95,383,312,53
060374806021,618,494,124,625,496,129,752,600,135,611,465,110
060374806022,366,271,95,371,274,97,443,348,87,407,317,67
060374806023,374,304,70,377,305,72,767,626,128,623,483,105
060374806012,423,347,76,426,340,86,451,372,72,477,364,79
060374806024,474,352,122,479,354,125,454,357,89,458,328,102
060374806013,642,520,122,657,510,147,1046,856,164,681,533,100
060374805004,615,485,130,625,485,140,740,588,142,594,453,104
060374807032,800,658,142,809,660,149,959,779,164,845,662,133
060374807041,595,477,118,607,472,135,824,655,149,698,531,130
060371831032,621,536,85,626,514,112,889,712,153,997,784,139
060374807022,1250,952,298,1265,958,307,1565,1208,323,1217,878,273
060374805001,767,577,190,787,580,207,941,731,182,797,589,165
060374805002,985,740,245,1004,738,266,1171,909,232,1071,802,204
060374805003,533,401,132,544,402,142,635,496,125,540,403,110
060374807042,839,637,202,847,632,215,1122,887,203,993,758,177
060374807043,530,399,131,541,397,144,767,594,153,585,438,106
060374807021,973,728,245,984,728,256,1214,899,289,914,644,219
060374807031,815,610,205,821,598,223,1035,832,182,869,655,163
060374825211,312,236,76,319,233,86,509,337,163,393,287,81
060374825213,360,267,93,361,255,106,691,475,205,487,377,89
060375035013,438,279,159,443,274,169,703,431,254,488,311,156
060375035011,457,290,167,466,280,186,829,513,297,598,349,212
060375035012,785,502,283,804,485,319,1509,940,537,1004,610,326
060375032021,582,410,172,596,404,192,957,622,316,641,449,151
060375033022,691,483,208,692,468,224,1254,783,432,807,550,208
060375029011,451,319,132,457,310,147,646,434,204,534,363,143
060375029013,448,328,120,454,319,135,632,421,194,543,373,143
060375031061,405,258,147,407,256,151,718,426,262,545,353,164
060375033023,392,241,151,397,236,161,609,387,213,477,296,147
060375033021,611,412,199,617,403,214,937,576,340,813,512,251
060375035021,493,294,199,500,288,212,698,421,268,550,301,215
060375035022,434,258,176,441,254,187,656,391,254,512,284,192
060375037012,833,452,381,851,433,418,1232,684,527,1001,528,412
060375034013,477,263,214,483,253,230,661,360,287,503,264,212
060375037011,781,416,365,803,392,411,1130,593,511,878,469,357
060375037021,1120,581,539,1133,562,571,1551,833,690,1345,665,610
060375037022,853,446,407,866,418,448,1272,655,583,950,460,425
060375030003,267,222,45,268,210,58,435,315,104,354,283,55
060375030004,293,244,49,293,232,61,413,301,101,327,260,51
060375031031,377,284,93,380,279,101,537,379,145,412,311,78
060375031052,383,262,121,385,257,128,729,498,213,513,352,131
060375032023,332,241,91,338,230,108,621,407,193,472,326,118
060375031062,161,109,52,162,107,55,278,189,82,192,134,49
060375031032,309,234,75,311,230,81,401,275,118,395,293,80
060375031034,256,202,54,259,199,60,371,262,100,347,262,66
060375031033,155,118,37,155,115,40,294,201,86,216,162,44
060375031041,475,369,106,475,359,116,765,558,193,656,493,122
060375030002,282,239,43,284,233,51,463,344,103,375,298,56
060375032011,535,341,194,534,332,202,647,410,222,719,423,244
060375032012,533,337,196,547,338,209,708,458,234,651,406,203
060375032013,313,198,115,320,198,122,417,264,142,390,243,122
060375042003,357,284,73,362,266,96,745,524,203,526,393,103
060375032022,244,165,79,245,158,87,436,294,131,332,212,98
060375020052,536,345,191,543,326,217,915,610,280,633,392,206
060375020051,411,284,127,425,279,146,595,393,189,570,368,164
060375031051,372,254,118,382,255,127,608,396,196,460,320,111
060375031063,352,240,112,362,241,121,646,418,205,472,327,117
060379203263,861,511,350,884,505,379,1357,779,553,1021,580,393
060379203262,376,226,150,389,226,163,758,448,296,496,283,190
060379203383,776,416,360,786,409,377,1156,673,462,633,335,266
060379203392,1172,633,539,1197,619,578,1728,1009,690,1477,827,574
060379203382,971,514,457,997,517,480,1418,825,572,991,511,426
060379203391,1582,807,775,1605,789,816,2211,1179,1006,1081,476,548
060379203381,687,358,329,712,361,351,730,380,337,732,390,298
060371041242,539,398,141,546,395,151,893,627,240,713,520,154
060371041243,212,135,77,213,124,89,285,163,106,233,122,83
060371042042,316,260,56,321,254,67,556,426,119,382,312,50
060374801011,405,221,184,423,221,202,793,483,296,513,285,189
060374801012,195,115,80,206,118,88,347,220,121,212,132,66
060374812011,203,131,72,207,127,80,372,220,145,253,154,82
060374321022,317,190,127,325,187,138,539,318,215,404,241,141
060374321024,195,118,77,204,120,84,320,198,122,252,157,86
060374319003,354,196,158,360,195,165,608,364,231,430,252,155
060374320023,256,141,115,262,141,121,440,264,173,280,165,98
060374320021,544,301,243,563,296,267,872,493,355,650,351,260
060374320024,415,224,191,430,226,204,648,377,252,511,287,191
060374321023,297,160,137,308,163,145,435,255,176,347,196,129
060374319001,244,138,106,250,136,114,345,207,131,266,151,100
060374319002,321,182,139,329,179,150,527,315,199,396,224,148
060374801013,394,228,166,416,231,185,597,364,224,462,270,165
060374318001,486,254,232,507,259,248,802,448,331,566,314,224
060374320012,293,161,132,298,165,133,436,276,154,279,178,87
060374321013,345,193,152,349,193,156,537,325,203,404,236,148
060374315013,396,253,143,413,254,159,714,451,256,477,303,146
060374320011,405,243,162,410,236,174,706,445,247,640,403,202
060374315012,421,258,163,433,258,175,690,432,246,524,323,173
060374321012,401,231,170,408,228,180,709,403,294,544,313,201
060378001032,422,328,94,432,333,99,538,421,108,444,323,92
060378005063,724,463,261,737,463,274,824,593,208,717,502,189
060376500011,401,231,170,412,239,173,596,366,217,533,317,184
060376500012,288,168,120,295,171,124,418,258,154,313,186,109
060376500013,670,425,245,694,428,266,1062,700,341,815,511,251
060376500014,345,206,139,357,213,144,481,304,164,369,226,121
060376500041,261,162,99,267,162,105,526,323,192,370,220,119
060376500043,387,240,147,391,242,149,667,431,219,406,249,126
060376500042,242,155,87,243,156,87,396,251,133,299,190,83
060376500031,479,326,153,488,322,166,898,567,305,662,424,193
060376500032,338,228,110,343,227,116,499,312,169,365,233,111
060376503001,334,191,143,333,186,147,445,282,155,362,210,129
060376503002,586,350,236,588,344,244,698,442,241,636,375,214
060376514012,528,278,250,538,281,257,767,420,336,631,315,277
060376500015,321,208,113,335,209,126,518,344,164,348,221,106
060376500044,294,192,102,297,194,103,491,311,167,417,270,112
060376501021,272,158,114,276,153,123,308,195,104,357,206,126
060376501022,611,354,257,625,345,280,789,495,280,716,412,255
060376502003,545,326,219,555,323,232,891,533,336,665,394,228
060376501013,651,394,257,672,387,285,936,592,317,758,443,265
060376501014,484,296,188,505,287,218,674,418,240,527,299,199
060376501011,600,391,209,621,413,208,973,623,329,702,470,209
060376501012,403,241,162,412,242,170,525,342,173,413,251,134
060376507011,358,198,160,365,197,168,490,281,198,409,217,164
060376507012,881,480,401,892,472,420,1162,679,459,931,495,377
060376507022,765,415,350,779,410,369,939,561,362,875,456,341
060376503003,440,294,146,448,295,153,709,444,248,649,411,193
060376503004,475,302,173,486,305,181,863,523,323,643,386,207
060376503005,566,378,188,586,380,206,884,572,288,726,459,218
060376511021,552,332,220,570,333,237,964,588,350,632,353,231
060376512212,351,220,131,355,216,139,625,381,230,483,286,164
060376512211,619,389,230,631,385,246,1131,639,463,705,423,224
060376509012,375,246,129,383,248,135,601,385,202,479,300,149
060376509013,584,363,221,597,362,235,709,456,248,635,373,217
060376509014,684,437,247,693,428,265,801,494,280,649,378,229
060376502002,394,234,160,402,232,170,572,330,224,414,232,147
060376502004,721,427,294,738,423,315,1074,656,396,880,487,333
060376502001,448,250,198,465,256,209,593,355,223,469,258,172
060379800051,0,0,0,0,0,0,1,1,0,0,0,0
060376509041,218,142,76,222,136,86,439,279,150,291,183,96
060376509042,534,347,187,544,336,208,741,469,253,562,356,184
060376509033,287,172,115,294,169,125,545,343,190,398,234,139
060376505021,1190,658,532,1211,659,552,1657,960,662,1176,609,493
060376509031,583,348,235,601,343,258,848,532,295,690,395,250
060376509032,491,310,181,508,312,196,729,467,253,587,347,194
060376505022,756,378,378,780,386,394,1042,597,422,1046,538,426
060376506031,958,502,456,984,499,485,1163,721,419,1160,605,481
060376506032,679,394,285,692,386,306,948,571,358,743,415,281
060376506062,614,377,237,624,372,252,1095,676,392,797,482,274
060376506071,591,380,211,607,385,222,964,627,321,728,468,225
060376504011,414,202,212,429,207,222,528,307,204,521,246,231
060376506051,809,518,291,822,519,303,1083,709,350,935,558,317
060376511012,884,496,388,910,494,416,1342,799,511,980,526,393
060376507021,668,356,312,690,362,328,854,508,331,699,332,315
060376509011,624,414,210,639,419,220,929,578,313,682,425,209
060376504015,301,157,144,309,156,153,323,188,130,329,165,142
060376506042,280,191,89,284,192,92,618,354,245,320,217,82
060376507023,694,362,332,704,357,347,988,563,398,796,415,332
060376504012,308,178,130,312,173,139,403,246,150,331,189,124
060376504013,426,250,176,436,243,193,557,342,198,479,271,175
060376504014,435,254,181,443,247,196,539,329,196,446,253,166
060376506043,412,292,120,421,296,125,854,519,314,543,368,140
060376510011,519,283,236,531,283,248,653,365,275,512,271,206
060376510012,504,286,218,510,280,230,659,387,255,519,287,200
060376510021,422,218,204,433,219,214,701,390,292,578,295,247
060376510022,553,281,272,566,280,286,691,395,280,590,299,257
060376511011,1129,581,548,1151,578,573,1431,837,564,1520,792,634
060376510023,418,237,181,428,234,194,624,359,252,486,260,192
060376510013,737,413,324,744,404,340,1197,713,450,909,489,358
060376510014,398,219,179,404,215,189,536,319,205,443,231,177
060376508022,459,289,170,468,286,182,478,309,162,511,319,164
060376508012,625,395,230,636,386,250,600,386,205,433,275,134
060376508011,792,497,295,802,492,310,1034,655,370,818,523,256
060376512012,883,427,456,905,429,476,1167,611,526,960,462,432
060376512011,551,270,281,566,277,289,769,399,347,615,317,264
060376512013,349,165,184,355,164,191,358,202,147,368,172,169
060376511022,755,441,314,779,439,340,1004,600,382,758,422,292
060376512223,820,475,345,843,482,361,1052,623,408,877,499,328
060376512222,389,236,153,398,237,161,743,464,263,621,361,225
060376512014,637,306,331,655,296,359,780,420,340,770,374,354
060376513022,977,537,440,996,537,459,948,561,360,744,399,302
060376514021,404,223,181,417,226,191,569,333,230,453,254,170
060376514022,696,393,303,713,400,313,858,525,325,904,498,350
060376514023,859,478,381,885,479,406,1245,707,516,834,470,313
060376514024,358,198,160,369,199,170,516,300,207,448,248,172
060376512221,697,411,286,703,401,302,1368,796,535,957,523,373
060376513021,458,258,200,465,257,208,656,390,252,506,277,194
060376513023,398,202,196,405,202,203,412,228,172,353,186,151
060376513024,417,218,199,425,215,210,508,300,196,455,227,195
060376513025,463,240,223,472,237,235,572,336,225,549,273,235
060376513041,394,231,163,399,231,168,542,320,208,420,252,138
060376513044,283,164,119,286,163,123,484,286,189,375,204,147
060376513045,472,264,208,482,260,222,581,341,225,519,292,192
060376513026,494,257,237,503,252,251,540,317,214,482,241,209
060376513043,769,455,314,781,455,326,1126,658,439,831,468,307
060376506041,252,179,73,257,181,76,488,319,157,264,176,67
060376506044,219,156,63,224,157,67,454,296,146,270,180,68
060376506061,358,233,125,369,235,134,750,486,249,474,304,141
060376505012,400,189,211,409,189,220,496,271,215,448,212,210
060376505011,542,274,268,553,268,285,779,424,339,628,320,264
060371437003,670,559,111,676,554,122,795,660,127,682,555,99
060379800391,0,0,0,0,0,0,0,0,0,1,0,1
060374081381,204,168,36,203,161,42,389,298,83,472,360,83
060374081382,517,432,85,521,414,107,692,519,152,467,402,45
060374081383,262,226,36,261,207,54,526,398,116,402,344,39
060374081391,305,267,38,310,260,50,593,467,114,412,364,31
060374081392,428,366,62,433,354,79,622,480,128,510,435,48
060374081401,412,347,65,410,333,77,708,540,145,572,475,63
060374081402,172,151,21,173,143,30,348,269,72,279,230,31
060374081411,226,185,41,228,179,49,418,319,90,313,252,42
060374081412,422,346,76,429,336,93,709,540,146,604,480,89
060374081413,368,292,76,372,280,92,636,465,159,375,292,60
060374081373,372,266,106,379,266,113,573,380,180,437,303,112
060374066023,421,285,136,417,272,145,694,454,227,548,373,141
060374075021,228,180,48,231,175,56,455,320,119,312,236,54
060374075023,276,218,58,280,215,65,430,318,108,327,260,48
060374079011,349,276,73,353,272,81,569,418,141,411,310,79
060374075011,295,240,55,296,230,66,529,376,143,374,306,55
060374073012,324,263,61,326,254,72,467,331,126,421,329,67
060374073013,297,246,51,299,236,63,459,327,125,362,295,50
060374073021,280,234,46,287,227,60,448,343,101,362,291,49
060374073022,311,259,52,311,250,61,478,363,106,378,302,54
060374073023,239,203,36,238,193,45,380,289,86,280,225,42
060374075014,174,136,38,175,133,42,281,197,80,218,158,41
060374075022,326,256,70,327,242,85,600,403,168,462,344,90
060374079012,302,237,65,304,226,78,482,342,138,398,288,89
060374078023,450,355,95,449,337,112,812,586,202,650,502,112
060374078022,354,278,76,357,268,89,647,471,162,515,408,77
060374078012,440,349,91,450,342,108,686,497,178,588,443,113
060374078013,294,235,59,300,230,70,572,410,150,445,335,85
060374078011,339,276,63,347,270,77,510,364,134,341,267,59
060374080041,665,470,195,673,455,218,1043,726,301,850,609,203
060374073011,303,238,65,310,229,81,474,340,131,373,293,59
060374066012,618,429,189,629,424,205,935,603,312,690,476,176
060374080031,582,431,151,594,424,170,873,598,255,780,573,164
060374080032,684,477,207,701,473,228,1119,739,367,809,560,214
060374066022,359,249,110,351,234,117,718,473,229,449,305,111
060374079013,345,272,73,351,258,93,498,345,144,397,301,77
060379800171,148,109,39,149,107,42,204,138,62,106,69,31
060377032001,682,646,36,684,650,34,862,812,34,707,664,24
060377032002,528,498,30,532,498,34,660,612,35,579,540,24
060377032003,389,367,22,397,365,32,543,505,31,424,387,16
060377032004,572,539,33,574,534,40,691,647,43,604,553,30
060377032006,545,514,31,543,502,41,780,719,53,585,535,23
060377031002,703,655,48,717,666,51,815,775,39,794,730,37
060377032005,730,686,44,739,692,47,828,777,38,807,743,33
060377031003,641,588,53,657,599,58,755,697,46,723,664,37
060377031001,490,460,30,496,464,32,539,513,24,504,475,14
060377031006,330,309,21,339,312,27,466,439,27,375,346,14
060374034011,489,285,204,498,284,214,723,452,256,576,350,196
060374034012,428,245,183,447,246,201,606,351,248,470,280,165
060374034021,704,406,298,730,411,319,1178,733,425,847,521,288
060374034041,311,188,123,324,183,141,485,294,182,499,280,187
060374034042,513,331,182,520,318,202,632,383,239,506,324,164
060374034071,384,228,156,397,227,170,444,270,169,302,183,105
060374034092,900,560,340,926,544,382,1462,891,549,958,564,333
060374034072,388,232,156,405,232,173,819,502,302,369,225,126
060374034091,737,458,279,762,463,299,839,511,315,732,444,247
060374034031,787,461,326,820,472,348,1182,721,447,861,537,292
060374034022,408,236,172,422,236,186,650,394,245,462,272,166
060374034081,326,212,114,333,208,125,368,228,134,350,228,106
060374034083,694,451,243,715,443,272,1097,686,400,814,532,246
060374034033,471,279,192,498,282,216,763,462,288,725,467,226
060374034013,817,496,321,833,482,351,1451,910,524,979,624,313
060374034082,376,240,136,387,232,155,646,402,233,420,272,123
060374034084,368,234,134,375,225,150,448,280,164,410,266,122
060374034085,483,298,185,499,287,212,604,374,220,650,392,222
060374034032,546,310,236,559,314,245,775,488,280,622,398,208
060375348031,278,247,31,280,238,42,531,413,102,405,350,35
060375348032,245,216,29,248,208,40,445,359,74,362,311,31
060375348041,345,313,32,348,303,45,649,540,89,492,436,33
060375348042,263,243,20,264,235,29,457,386,62,347,314,19
060375348021,370,332,38,366,318,48,540,427,96,425,365,38
060375348022,221,197,24,221,190,31,364,291,68,296,255,26
060375347001,556,500,56,556,479,77,839,678,144,752,644,69
060375348033,320,278,42,320,270,50,543,443,89,500,431,45
060376001001,474,443,31,478,439,39,766,675,75,476,443,19
060376001002,228,209,19,231,206,25,415,361,38,324,303,15
060376001003,389,354,35,393,349,44,603,525,64,495,459,22
060376002012,313,282,31,319,285,34,467,406,53,414,363,16
060376002013,217,197,20,223,200,23,308,269,37,262,229,10
060376002021,328,295,33,329,292,37,591,513,65,424,383,23
060376004003,450,424,26,451,416,35,500,461,32,525,489,21
060376004004,569,540,29,573,537,36,812,745,51,667,627,23
060376002022,588,554,34,595,556,39,992,872,97,775,717,27
060376002023,335,315,20,339,317,22,491,426,54,348,324,11
060376002011,303,280,23,307,281,26,490,452,31,415,381,21
060376003021,583,546,37,586,544,42,600,530,54,707,661,25
060376004001,332,317,15,332,318,14,545,503,28,461,438,11
060376004002,250,239,11,250,240,10,348,320,18,259,248,6
060376003022,320,299,21,334,310,24,468,428,33,352,325,15
060376003023,352,334,18,361,334,27,499,454,39,421,391,17
060376003032,149,143,6,152,143,9,322,286,30,191,180,7
060376003033,183,168,15,181,164,17,362,312,38,287,260,13
060376003043,119,115,4,123,115,8,230,197,23,142,134,4
060376003041,274,245,29,276,246,30,400,347,40,373,334,28
060376003042,145,130,15,145,130,15,268,238,27,186,172,12
060376028011,324,302,22,328,303,25,644,566,54,490,445,18
060376028021,403,374,29,413,376,37,480,432,42,426,392,18
060376028022,343,317,26,348,316,32,524,468,46,395,369,11
060376028012,441,408,33,447,408,39,876,791,71,636,581,30
060376028023,355,328,27,358,327,31,400,366,34,565,514,31
060376028024,517,481,36,525,482,43,629,566,53,634,582,34
060376003031,230,210,20,232,209,23,446,395,46,316,287,16
060372920011,367,308,59,374,307,67,759,582,159,569,456,82
060375435021,326,254,72,328,245,83,603,395,190,426,318,89
060375435022,240,187,53,244,182,62,465,309,148,305,229,64
060375435023,624,400,224,630,380,250,800,525,253,742,466,234
060375435031,610,386,224,620,386,234,991,625,346,757,498,217
060375435033,626,422,204,633,422,211,1129,731,374,726,494,192
060375436062,699,498,201,710,494,216,1094,715,355,793,560,186
060375436052,573,416,157,593,426,167,870,585,267,700,508,152
060375436051,774,522,252,782,500,282,1115,750,339,924,607,265
060375436031,815,556,259,814,555,259,1232,849,363,934,606,282
060375436032,890,715,175,886,683,203,1159,810,323,1014,771,188
060375436061,269,191,78,273,188,85,410,271,131,384,268,93
060375435032,308,195,113,312,194,118,485,305,173,365,236,112
060375411001,191,180,11,195,178,17,323,283,32,263,236,14
060375411002,364,342,22,367,338,29,559,479,70,491,445,24
060375430003,459,419,40,455,415,40,554,490,55,593,540,29
060374053021,453,328,125,455,312,143,827,541,262,499,356,119
060374053011,350,255,95,360,247,113,892,594,281,535,388,111
060374053022,531,369,162,539,359,180,786,527,249,625,429,161
060374053023,491,323,168,503,324,179,738,487,234,615,393,177
060374081332,278,228,50,283,216,67,601,443,149,452,343,89
060374055004,280,194,86,282,185,97,415,274,131,373,254,98
060374055003,423,292,131,430,283,147,553,373,175,507,337,142
060374055002,505,343,162,506,332,174,610,401,194,569,369,169
060374056001,584,393,191,591,386,205,648,420,217,523,338,159
060374055005,204,138,66,209,138,71,651,409,226,451,298,131
060374056002,436,297,139,442,291,151,529,337,180,437,283,136
060374079021,542,412,130,552,398,154,867,602,259,642,472,139
060374056003,256,174,82,261,173,88,456,296,152,351,225,109
060374056004,297,203,94,305,201,104,457,296,153,354,234,105
060374056005,367,251,116,376,252,124,562,365,186,355,239,95
060374062011,344,235,109,354,237,117,755,487,251,512,344,136
060374068012,533,355,178,545,357,188,834,551,271,759,521,213
060374063002,565,333,232,578,331,247,924,552,352,697,370,291
060374063003,622,325,297,634,313,321,708,411,288,642,338,283
060374064135,555,348,207,559,334,225,856,539,302,693,449,210
060374064133,395,249,146,403,241,162,568,348,214,432,258,154
060374064134,561,354,207,569,342,227,858,506,342,639,379,227
060374064131,291,210,81,291,213,78,505,348,147,397,283,93
060374065001,279,199,80,279,198,81,427,299,125,358,246,92
060374065002,571,397,174,572,389,183,1081,696,367,724,480,202
060374067021,264,189,75,269,187,82,657,433,206,417,291,101
060374067024,442,308,134,448,294,154,860,560,284,648,416,189
060374068011,301,218,83,311,218,93,463,308,147,459,313,121
060374068013,451,327,124,462,329,133,708,468,224,626,429,166
060374080051,578,322,256,594,315,279,855,514,321,639,358,252
060374080052,468,294,174,475,283,192,797,482,301,518,301,193
060374074001,623,455,168,640,445,195,996,689,289,660,472,141
060374067011,398,292,106,400,290,110,698,452,228,526,368,123
060374067012,566,408,158,572,398,174,777,523,241,572,398,143
060374067022,306,221,85,313,212,101,572,384,178,441,295,128
060374067023,525,359,166,518,329,189,713,478,223,542,384,125
060374064136,263,164,99,270,160,110,402,253,143,307,174,118
060374064132,391,254,137,397,246,151,593,377,207,493,328,137
060374081351,746,523,223,752,504,248,1213,805,389,988,689,258
060374081372,298,216,82,302,216,86,702,472,215,363,252,91
060374081331,403,282,121,415,269,146,643,413,221,240,180,50
060374081333,420,299,121,428,289,139,739,487,241,615,426,159
060374081361,544,378,166,560,370,190,830,545,278,774,504,225
060374081362,521,351,170,531,349,182,659,447,204,580,387,163
060374081341,892,611,281,909,605,304,1373,910,449,1035,718,276
060374081352,304,219,85,309,214,95,531,354,172,402,281,103
060374069034,420,302,118,434,312,122,628,425,193,452,309,116
060374062012,428,314,114,426,298,128,705,488,195,565,398,134
060374065003,499,343,156,505,330,175,775,500,266,604,424,147
060374065004,492,349,143,496,345,151,879,602,268,624,433,150
060374066011,576,385,191,579,370,209,801,506,281,668,441,191
060374066021,486,335,151,490,322,168,790,508,268,628,394,200
060374066013,601,405,196,610,398,212,856,547,296,669,439,199
060374080053,311,200,111,313,192,121,754,454,283,669,446,184
060374080061,864,620,244,870,606,264,1456,905,515,862,605,212
060374081371,212,171,41,213,161,52,470,316,145,281,213,48
060377001023,658,566,92,651,562,89,810,637,155,854,681,125
060377002006,645,566,79,651,568,83,690,557,123,681,568,81
060377003001,642,570,72,643,571,72,747,639,100,704,607,73
060377005012,460,400,60,463,398,65,584,487,90,467,389,59
060377005021,718,611,107,726,608,118,1072,876,188,843,689,124
060377001013,446,381,65,450,384,66,520,404,103,485,382,78
060377001014,627,535,92,632,540,92,788,620,159,845,644,165
060377002003,507,466,41,516,475,41,701,609,79,521,462,41
060377002005,469,417,52,475,420,55,586,494,85,470,405,49
060377003003,1042,946,96,1053,955,98,1282,1097,169,1081,943,95
060377003002,979,888,91,988,893,95,1011,852,153,1104,959,115
060377005022,1024,927,97,1032,927,105,1141,980,151,1086,950,98
060377005023,503,446,57,500,437,63,634,545,83,454,390,46
060377005011,808,714,94,818,719,99,1020,837,165,1010,863,119
060377005013,678,579,99,686,584,102,769,632,127,692,588,87
060377002001,445,396,49,448,398,50,551,468,77,497,432,47
060371898011,679,588,91,684,588,96,1113,920,174,605,512,63
060377002002,735,671,64,740,675,65,934,780,143,720,630,60
060377002004,717,642,75,731,653,78,1030,877,139,761,665,72
060377001012,569,489,80,575,491,84,752,589,148,726,587,110
060377001015,394,349,45,395,346,49,416,330,83,450,360,73
060377001011,612,546,66,616,544,72,882,687,174,431,348,58
060377001022,598,523,75,603,518,85,929,694,217,565,462,72
060377001021,557,481,76,558,478,80,712,537,158,613,492,85
060377004001,876,772,104,890,775,115,1044,846,188,956,819,109
060377004002,271,244,27,274,245,29,439,373,62,330,287,34
060377004003,1015,898,117,1028,906,122,1143,941,182,1014,881,104
060377004004,510,443,67,518,451,67,605,516,87,609,524,67
060377003004,701,605,96,707,613,94,901,750,138,776,658,93
060371352051,731,485,246,737,483,254,926,628,293,787,536,222
060378003385,302,169,133,310,163,147,613,346,252,319,173,131
060378003251,927,518,409,948,523,425,1123,658,443,939,513,384
060378003252,1000,533,467,1020,541,479,1076,632,425,1127,588,488
060378003351,816,428,388,834,434,400,1061,601,434,744,401,293
060378003352,1124,581,543,1148,583,565,1328,759,547,1349,722,553
060375002023,343,199,144,348,192,156,491,282,201,432,244,165
060375002024,508,277,231,515,265,250,614,351,253,542,286,230
060375019001,502,300,202,504,284,220,741,443,272,608,350,221
060375019003,427,263,164,432,254,178,586,356,216,486,298,153
060375020053,260,178,82,265,172,93,520,340,162,385,257,106
060375016003,454,263,191,460,256,204,580,358,209,514,290,195
060375016004,417,239,178,425,235,190,482,295,181,473,269,183
060375017001,465,280,185,472,268,204,521,308,201,462,267,169
060375018021,425,268,157,427,261,166,503,325,168,428,260,143
060375018022,261,170,91,260,165,95,446,287,145,340,217,103
060375015042,319,224,95,326,223,103,557,380,167,364,253,89
060375016005,354,216,138,359,211,148,349,228,111,377,215,137
060375019004,279,185,94,282,183,99,474,289,173,362,243,97
060375020031,360,245,115,365,240,125,570,414,149,510,347,138
060375020032,238,185,53,245,180,65,527,383,135,317,248,51
060375013021,567,385,182,574,381,193,665,458,201,627,398,197
060375013023,228,168,60,237,166,71,424,290,128,282,187,72
060375013011,492,360,132,499,360,139,675,458,201,513,360,118
060375019002,299,177,122,304,169,135,484,299,183,357,198,140
060375015011,1051,695,356,1066,678,388,1277,839,414,1233,779,381
060375013022,595,437,158,608,428,180,1237,839,366,766,519,181
060375015031,348,256,92,353,249,104,579,376,190,397,279,86
060375014001,393,291,102,404,282,122,518,374,132,416,283,99
060375015033,535,364,171,541,346,195,826,527,280,605,376,178
060375015034,296,221,75,297,212,85,645,448,160,392,272,80
060375015041,371,265,106,375,258,117,609,401,194,457,305,119
060375015032,298,196,102,305,193,112,380,247,131,276,173,86
060375034021,709,398,311,726,385,341,1140,622,495,777,421,304
060375035023,482,265,217,489,252,237,734,413,296,642,334,273
060375016002,396,250,146,396,248,148,732,454,259,563,348,178
060375018023,452,303,149,446,292,154,607,391,198,562,356,165
060375017003,398,252,146,399,241,158,571,361,195,472,285,157
060375017004,336,215,121,338,203,135,508,325,176,360,221,120
060375018031,376,296,80,379,287,92,642,455,163,505,377,89
060375018032,344,277,67,350,267,83,693,515,163,454,341,84
060375018042,101,82,19,104,79,25,255,179,68,127,96,23
060375014003,341,247,94,347,241,106,459,341,106,450,325,97
060375017002,411,261,150,417,254,163,717,454,252,473,287,160
060375033011,425,267,158,432,265,167,637,383,237,512,308,172
060375033012,436,267,169,445,272,173,681,412,254,502,298,169
060375002033,1032,519,513,1050,514,536,1412,741,646,1148,545,537
060375034011,483,235,248,492,223,269,769,396,359,596,276,295
060375034012,658,346,312,678,333,345,884,454,415,743,377,323
060375002031,411,196,215,410,189,221,567,290,266,470,196,240
060375002032,459,238,221,474,232,242,559,305,243,514,256,226
060375020041,344,250,94,350,240,110,475,347,114,392,275,98
060375033013,461,299,162,462,286,176,711,434,271,545,335,184
060375034014,383,211,172,386,191,195,597,334,254,473,265,175
060375002021,378,175,203,380,172,208,479,245,220,370,165,179
060375002022,290,134,156,293,133,160,462,237,211,374,165,180
060375034022,640,368,272,656,359,297,963,546,397,681,375,261
060375034023,419,247,172,430,242,188,629,355,261,439,249,159
060375034015,450,250,200,456,241,215,793,442,339,598,317,251
060375013012,546,398,148,555,394,161,821,574,236,642,456,150
060375014002,233,177,56,240,177,63,387,282,92,332,243,64
060375015043,208,158,50,214,158,56,358,264,84,306,224,59
060375018041,310,242,68,311,235,76,516,378,124,380,274,74
060375020042,504,408,96,519,393,126,853,632,207,659,521,105
060375406001,520,486,34,528,486,42,691,594,83,667,608,35
060375406002,228,212,16,232,211,21,424,362,52,322,293,17
060375407002,387,357,30,392,355,37,674,582,70,491,457,14
060375407001,295,275,20,304,281,23,455,392,54,402,368,23
060375404001,170,148,22,171,141,30,260,218,34,233,213,12
060375404002,241,210,31,239,198,41,292,249,38,286,260,15
060375408005,487,450,37,489,445,44,766,679,65,480,438,21
060375414011,271,249,22,271,244,27,582,504,60,412,378,17
060375414012,227,212,15,227,208,19,395,346,42,326,303,14
060375414021,143,133,10,144,131,13,211,183,28,196,179,9
060375414023,202,190,12,204,184,20,391,336,37,292,264,11
060375408001,238,221,17,242,222,20,344,310,29,259,240,13
060375414022,178,168,10,179,163,16,308,273,30,235,215,10
060375415001,250,228,22,253,224,29,400,334,56,374,340,19
060375415003,324,297,27,322,283,39,521,450,62,440,403,23
060375415002,220,201,19,229,204,25,390,329,49,341,312,15
060375408003,311,289,22,314,289,25,427,378,35,363,331,16
060379001042,391,232,159,398,211,187,647,366,260,534,282,218
060379001043,479,283,196,484,262,222,687,393,261,600,332,221
060379001021,149,63,86,153,65,88,269,128,141,219,125,94
060379001031,366,215,151,371,201,170,613,362,233,537,291,208
060379001032,413,234,179,424,240,184,657,390,250,534,265,217
060379001033,425,239,186,432,229,203,675,375,275,462,258,162
060379001041,443,245,198,452,237,215,658,364,264,545,268,239
060372717041,388,312,76,400,316,84,487,401,79,456,363,70
060372717031,481,401,80,494,404,90,563,459,89,471,381,62
060372760003,610,445,165,616,444,172,823,605,201,703,495,173
060372760005,478,351,127,483,348,135,577,424,139,485,347,117
060372127021,554,452,102,564,458,106,774,606,159,640,531,83
060372127023,305,254,51,310,250,60,323,254,68,351,293,45
060372161001,309,254,55,314,253,61,377,301,76,311,265,40
060372161003,366,323,43,370,325,45,477,411,58,390,333,35
060372162011,573,495,78,573,492,81,618,540,76,526,446,62
060371064051,341,276,65,347,270,77,449,335,104,376,301,58
060371064052,282,227,55,285,219,66,535,397,125,452,351,79
060371065201,529,412,117,534,384,150,778,548,216,652,484,135
060371065203,327,259,68,328,239,89,502,362,128,430,333,73
060371831031,629,540,89,634,528,106,913,777,120,675,549,87
060371831041,845,715,130,853,693,160,998,798,184,726,584,103
060371112043,752,419,333,756,416,340,1018,586,417,739,389,323
060371131021,725,391,334,734,391,343,1080,600,459,890,495,352
060371131022,670,369,301,679,369,310,890,495,378,803,419,346
060371112041,1120,683,437,1139,681,458,1455,880,550,1381,824,480
060371112042,869,549,320,901,559,342,1126,731,385,1037,659,323
060372756043,2208,1866,342,2248,1891,357,3362,2793,513,1317,1081,180
060371014002,660,399,261,666,392,274,810,457,327,614,347,224
060371014003,460,282,178,465,277,188,660,370,272,590,348,199
060371131011,709,397,312,729,398,331,977,556,399,827,443,335
060371131012,837,471,366,853,474,379,1127,641,461,936,531,345
060371132121,476,294,182,485,286,199,716,429,274,577,319,230
060371132131,1029,615,414,1041,611,430,1554,943,584,1151,659,435
060371132132,559,369,190,567,368,199,882,588,275,649,411,195
060371041031,486,408,78,491,397,94,795,612,170,672,554,83
060371133232,431,314,117,436,306,130,781,525,242,535,385,121
060371133231,630,436,194,641,437,204,870,584,272,870,552,275
060371133011,346,201,145,351,202,149,425,260,156,396,207,164
060371133221,896,530,366,914,536,378,1136,678,430,969,577,350
060371133031,1002,626,376,1026,636,390,1343,853,461,1172,719,392
060371133222,856,534,322,872,527,345,1101,710,369,977,586,337
060371133241,436,321,115,439,310,129,945,615,309,522,376,117
060371133012,948,623,325,975,622,353,1648,1139,487,994,647,297
060371133032,604,398,206,609,398,211,910,567,328,731,458,230
060372043003,353,335,18,351,321,30,523,454,59,427,373,28
060372043001,355,332,23,353,314,39,571,482,75,509,445,37
060372753132,617,500,117,626,501,125,953,753,185,561,437,92
060372753121,957,744,213,969,756,213,1158,901,236,1162,908,212
060372756052,528,445,83,534,447,87,901,742,141,595,482,89
060372766011,547,376,171,553,370,183,697,502,185,633,429,165
060372781022,668,507,161,679,510,169,733,575,144,680,491,148
060372781023,578,403,175,584,406,178,708,503,193,435,285,120
060371032021,789,403,386,816,402,414,1083,570,491,972,493,426
060379800211,28,23,5,27,21,6,18,12,6,8,6,2
060371916102,493,446,47,499,438,61,729,610,108,548,471,46
060371925201,501,452,49,499,429,70,792,635,138,618,533,55
060371926102,201,181,20,202,175,27,303,252,46,226,192,20
060371926103,420,373,47,422,357,65,609,478,112,529,443,50
060372117032,518,445,73,527,440,87,776,602,159,596,500,67
060372117041,348,294,54,355,291,64,438,332,99,330,278,38
060372117042,463,387,76,470,383,87,674,489,167,482,403,56
060371926101,306,273,33,308,264,44,467,374,83,360,307,32
060371927001,342,307,35,347,303,44,504,424,77,393,337,33
060371927002,514,456,58,521,447,74,808,649,143,599,512,57
060372087201,260,219,41,268,215,53,691,550,126,426,357,40
060372087202,223,188,35,230,185,45,296,217,71,171,145,16
060372111231,303,254,49,312,252,60,559,450,98,316,253,51
060372122041,252,216,36,258,211,47,421,315,96,271,230,27
060372211201,166,153,13,172,153,19,332,273,56,324,296,18
060372211202,225,208,17,229,204,25,351,284,60,361,326,22
060371814001,555,477,78,552,457,95,733,579,141,610,515,70
060371816001,667,585,82,665,565,100,1170,946,185,994,828,117
060371319003,489,386,103,490,371,119,693,520,156,572,425,113
060371319004,328,258,70,330,250,80,461,348,102,423,315,84
060371323011,512,397,115,523,384,139,770,538,219,774,597,146
060371323021,337,249,88,343,237,106,377,267,109,439,321,91
060371154041,313,228,85,319,231,88,479,326,142,417,299,97
060371154042,408,297,111,419,305,114,690,470,205,528,377,121
060371327003,629,471,158,637,465,172,573,414,151,626,458,129
060371327001,318,238,80,320,233,87,321,233,85,349,250,74
060371327002,411,333,78,421,325,96,1035,745,268,658,504,117
060371041081,362,324,38,362,314,48,731,609,106,466,419,29
060371041082,405,346,59,413,339,74,778,623,137,585,500,57
060371041083,285,244,41,290,241,49,468,380,81,366,323,28
060371042011,249,228,21,258,228,30,402,340,54,316,288,18
060371042012,317,290,27,327,286,41,533,451,70,478,428,26
060371042013,285,257,28,289,250,39,454,382,63,437,392,25
060371044011,256,232,24,261,220,41,433,358,61,354,308,27
060371044012,320,289,31,323,277,46,460,381,74,439,387,31
060371044041,229,209,20,233,205,28,406,340,56,307,268,22
060371044042,267,241,26,270,233,37,503,411,80,398,348,27
060371152041,517,386,131,525,381,144,955,671,260,759,520,187
060371152042,592,455,137,595,452,143,853,619,217,595,437,121
060371098001,384,247,137,393,244,149,562,366,185,455,290,145
060371098002,340,233,107,340,223,117,477,316,158,384,257,100
060371098004,405,278,127,411,267,144,635,422,207,514,347,135
060371174041,391,239,152,391,233,158,581,360,216,500,297,177
060371174042,355,216,139,356,212,144,536,329,197,440,258,155
060371974102,679,617,62,683,613,70,758,673,76,712,596,70
060371974103,489,447,42,492,443,49,566,509,47,532,456,40
060371974201,658,606,52,663,593,70,834,713,98,753,650,54
060371974202,741,686,55,745,671,74,953,847,90,771,674,48
060371190031,307,277,30,315,261,54,456,368,71,349,292,38
060371190032,259,221,38,258,211,47,476,372,88,371,312,40
060371190042,397,334,63,393,308,85,698,529,153,503,408,68
060371192012,292,245,47,295,238,57,407,324,77,379,309,49
060371194001,334,282,52,332,270,62,508,398,98,443,365,55
060371173031,879,590,289,897,583,314,1296,852,419,1122,751,320
060371154012,336,245,91,341,240,101,435,290,137,487,327,135
060371154013,389,284,105,395,279,116,835,521,297,382,255,106
060371311001,574,412,162,576,401,175,819,563,240,651,449,167
060371312001,500,356,144,504,346,158,754,519,219,610,417,156
060371312002,516,368,148,525,365,160,688,468,201,566,389,149
060371312003,329,234,95,330,224,106,460,316,133,378,260,97
060371343021,322,203,119,325,196,129,478,299,168,396,244,130
060371343022,623,386,237,631,369,262,849,516,314,737,452,246
060371343023,532,344,188,536,337,199,745,457,266,587,360,189
060371274001,87,73,14,88,70,18,238,177,56,201,161,29
060371274002,361,290,71,366,283,83,483,363,114,367,288,62
060371274003,400,317,83,403,311,92,559,420,131,401,309,71
060371274004,189,158,31,188,151,37,390,279,101,276,222,40
060371272101,183,155,28,185,147,38,313,240,65,261,213,35
060371272201,217,188,29,221,177,44,428,320,98,329,270,43
060371272202,282,231,51,286,224,62,364,271,85,320,251,52
060371272203,385,310,75,393,305,88,704,482,211,423,325,74
060371210102,357,280,77,365,272,93,571,389,173,445,345,81
060371212211,182,152,30,184,145,39,288,205,79,222,185,26
060371212212,353,286,67,356,273,83,540,412,114,492,397,65
060371218021,239,198,41,245,192,53,384,281,97,306,254,42
060371218022,421,348,73,426,335,91,730,542,174,628,499,100
060371343033,452,313,139,459,309,150,705,466,223,471,316,125
060371343034,578,396,182,592,385,207,895,584,297,696,452,207
060371048231,403,339,64,404,321,83,653,490,143,451,376,57
060371212101,450,360,90,458,354,104,596,441,144,475,377,72
060371212102,219,176,43,222,171,51,284,207,68,319,246,60
060371212221,223,183,40,226,178,48,621,455,149,331,272,34
060371343041,252,165,87,253,159,94,333,227,99,431,282,127
060371343042,651,438,213,660,429,231,628,424,188,728,476,212
060371343062,438,307,131,449,304,145,530,373,145,538,362,148
060371190011,584,428,156,590,421,169,856,605,225,700,526,139
060371197002,376,275,101,380,273,107,701,478,199,542,408,111
060371197003,411,308,103,419,305,114,709,514,177,586,453,114
060371343052,120,94,26,120,90,30,279,189,83,164,126,28
060371343051,183,143,40,183,138,45,321,218,96,256,199,44
060371343053,170,133,37,170,128,42,510,346,152,239,186,41
060371343061,318,248,70,322,242,80,561,394,153,301,233,53
060371132343,195,137,58,196,134,62,498,334,151,400,281,95
060371132344,239,174,65,240,171,69,375,252,113,241,173,53
060371342012,289,219,70,290,212,78,427,288,131,283,205,59
060371342013,404,299,105,403,292,111,608,422,165,456,332,96
060371340022,580,400,180,589,397,192,1000,660,314,772,529,199
060371342011,372,257,115,378,255,123,442,296,142,336,232,86
060371199001,338,276,62,344,271,73,562,425,127,464,370,71
060371199002,464,370,94,465,361,104,687,524,153,643,504,107
060371201052,242,189,53,244,187,57,315,230,79,291,226,51
060371132371,1040,611,429,1056,602,454,1529,914,588,1367,762,537
060372421001,377,349,28,390,359,31,425,354,51,501,470,12
060371219002,427,349,78,434,342,92,651,481,164,705,579,80
060371221211,296,254,42,295,243,52,481,359,109,365,300,46
060371221222,197,169,28,195,163,32,495,362,123,299,247,32
060371221221,150,129,21,150,126,24,341,254,84,188,155,21
060371222002,380,331,49,384,320,64,627,475,130,501,422,53
060371061142,348,284,64,351,277,74,618,469,135,417,340,51
060371061143,496,399,97,504,387,117,840,635,188,661,547,81
060371310212,342,257,85,346,248,98,540,385,150,383,285,76
060371310211,226,170,56,227,163,64,535,387,137,372,275,75
060371232051,274,235,39,275,231,44,475,370,94,330,282,33
060371232052,154,134,20,155,132,23,294,224,60,187,158,19
060371241031,398,343,55,400,335,65,650,503,138,543,431,81
060371113023,474,313,161,481,314,167,720,446,252,532,338,167
060371113022,328,227,101,329,225,104,400,262,127,326,213,94
060371113024,263,182,81,264,181,83,416,271,133,318,207,92
060371151031,364,328,36,362,322,40,627,440,167,503,326,146
060371241041,354,300,54,358,291,67,640,489,137,496,396,66
060371241042,185,157,28,187,151,36,287,221,61,196,155,26
060371253105,174,146,28,178,145,33,297,252,37,224,187,21
060371253104,194,161,33,194,159,35,389,331,48,232,195,21
060371253103,281,239,42,285,237,48,415,349,55,292,243,29
060371253221,326,283,43,330,283,47,569,487,72,400,332,41
060371236011,249,194,55,252,200,52,466,340,119,331,260,58
060371236012,631,487,144,641,484,157,897,570,307,733,518,179
060371236021,448,348,100,451,356,95,749,541,190,554,431,97
060371347101,443,316,127,453,310,143,881,586,273,661,463,159
060371347201,347,248,99,351,245,106,577,387,172,447,316,106
060371347202,489,358,131,495,354,141,762,508,234,588,422,132
060371347203,350,269,81,354,263,91,496,342,143,336,249,66
060371314002,345,267,78,349,261,88,418,306,106,370,277,75
060371314003,529,411,118,534,400,134,809,594,202,647,484,130
060371314001,738,579,159,756,572,184,1210,898,289,984,757,168
060371061123,462,332,130,466,312,154,906,616,266,555,377,146
060371061131,566,435,131,571,418,153,834,621,195,787,568,170
060371061132,477,372,105,484,357,127,721,523,188,571,404,130
060371061141,288,225,63,292,213,79,629,470,146,354,293,36
060371234101,463,375,88,464,369,95,773,546,211,599,467,103
060371234102,250,203,47,253,200,53,402,280,115,258,199,44
060371278042,458,360,98,463,351,112,576,394,172,511,369,96
060371278043,379,301,78,382,294,88,483,353,121,386,279,73
060371278031,421,347,74,419,342,77,785,561,206,350,276,54
060371278032,472,390,82,471,384,87,836,597,221,659,523,101
060371279102,453,364,89,457,358,99,816,576,223,589,456,97
060371278053,228,192,36,233,192,41,288,218,64,236,189,33
060371278061,230,194,36,236,194,42,367,278,82,319,257,45
060371281022,305,259,46,314,259,55,627,474,138,492,392,67
060371064061,1085,749,336,1095,715,380,1667,1159,479,1255,815,377
060371065101,520,368,152,527,361,166,731,495,219,650,432,179
060371065102,484,347,137,485,337,148,901,610,271,632,464,129
060371282201,386,303,83,391,299,92,585,400,172,481,342,109
060371282202,407,320,87,409,314,95,621,426,183,461,330,104
060371060101,439,317,122,451,313,138,803,543,243,507,350,139
060371064062,260,203,57,263,197,66,365,267,92,334,242,72
060371064063,289,227,62,292,219,73,471,345,120,374,278,75
060371276031,275,213,62,277,208,69,556,400,141,497,375,90
060371276041,296,236,60,300,232,68,321,236,76,230,168,47
060371276042,386,308,78,394,302,92,600,437,150,428,321,79
060379800081,17,14,3,17,14,3,147,108,37,40,31,8
060371276032,215,179,36,217,175,42,400,304,84,218,159,45
060371273002,520,417,103,533,418,115,468,336,121,541,420,97
060371277121,278,228,50,286,223,63,511,378,121,346,258,64
060371277122,343,280,63,348,272,76,502,371,118,543,404,100
060371276052,384,336,48,388,329,59,893,677,192,553,464,61
060371276061,284,234,50,289,232,57,304,237,63,253,198,39
060371276062,510,422,88,521,418,103,874,672,185,709,553,108
060371277111,661,519,142,674,510,164,909,679,212,725,539,142
060371247001,484,356,128,492,363,129,671,464,196,517,386,112
060371247002,566,426,140,574,431,143,692,513,171,571,430,120
060371321011,561,432,129,567,428,139,682,516,152,563,415,110
060371321012,343,267,76,346,264,82,670,506,151,492,364,96
060371321013,422,325,97,425,321,104,561,423,127,464,342,90
060371276051,180,158,22,182,155,27,288,221,60,150,127,16
060371112051,612,414,198,622,410,212,956,584,350,684,439,201
060371321023,857,649,208,874,642,232,1253,895,325,859,633,176
060371320021,305,233,72,309,231,78,533,378,147,431,287,111
060371320022,305,230,75,307,226,81,498,353,139,379,273,79
060371320023,498,376,122,504,374,130,706,498,195,500,351,117
060371091001,333,236,97,341,231,110,452,322,120,343,233,95
060371091002,568,436,132,588,432,156,727,512,191,662,477,148
060371092001,278,194,84,283,192,91,403,263,136,354,243,92
060371093002,446,306,140,453,300,153,684,446,225,585,381,171
060371255011,762,654,108,752,641,111,916,772,124,719,592,81
060371255012,657,566,91,649,555,94,861,704,139,706,577,84
060371096011,381,269,112,387,262,125,562,394,155,441,316,105
060371096013,296,229,67,299,214,85,510,371,132,401,299,79
060371096014,455,344,111,458,326,132,787,567,207,557,407,121
060371329001,506,386,120,516,383,133,692,492,191,596,412,148
060371329002,610,420,190,611,395,216,1066,650,401,748,465,241
060371199003,447,360,87,452,356,96,613,444,162,503,392,89
060371171022,428,321,107,429,318,111,753,541,198,553,412,114
060371172011,357,264,93,360,266,94,460,330,123,417,320,83
060371310241,305,244,61,312,243,69,567,410,146,361,278,70
060371310242,404,327,77,409,322,87,570,401,158,446,341,82
060371323012,230,185,45,235,182,53,489,355,127,309,244,51
060371323022,305,247,58,313,242,71,758,547,197,485,378,84
060371325021,621,488,133,627,473,154,1043,698,320,723,548,139
060371325022,400,297,103,407,285,122,608,395,197,485,357,105
060371317021,831,614,217,844,600,244,1078,759,301,1078,755,256
060371325011,514,401,113,520,398,122,941,660,262,614,462,124
060371325012,392,293,99,397,294,103,617,439,167,510,374,112
060371198011,304,248,56,303,240,63,460,343,110,374,301,53
060371198022,341,281,60,344,275,69,490,366,117,399,317,63
060371198012,442,372,70,443,362,81,735,554,161,585,476,79
060371331021,761,563,198,767,555,212,938,628,291,807,563,198
060371331022,244,182,62,247,180,67,469,309,150,393,276,96
060371319001,386,305,81,394,307,87,533,389,134,445,328,88
060371319002,392,312,80,401,313,88,594,437,140,475,348,95
060371281023,200,170,30,204,168,36,298,227,69,209,166,28
060371281021,269,228,41,274,227,47,463,362,94,408,327,52
060371311003,360,263,97,366,262,104,513,352,151,431,296,112
060371321021,129,100,29,133,100,33,233,174,54,186,139,36
060371321022,668,494,174,670,491,179,990,722,247,890,641,200
060371278041,170,141,29,173,141,32,378,284,85,222,173,35
060371278051,129,107,22,131,107,24,322,245,69,244,191,38
060371278052,268,222,46,271,221,50,458,350,99,282,222,44
060371349011,460,326,134,469,328,141,722,437,269,581,398,157
060371349012,303,213,90,309,215,94,395,243,147,276,187,74
060371349013,410,290,120,422,295,127,564,390,167,429,293,116
060371134261,742,496,246,747,481,266,1047,695,326,819,543,223
060371134281,352,233,119,356,225,131,445,295,144,373,242,108
060371134271,377,267,110,378,255,123,706,474,217,509,349,124
060371134272,240,175,65,240,166,74,488,327,149,386,270,89
060371134282,378,246,132,377,236,141,611,392,206,428,273,124
060371351021,484,314,170,488,310,178,698,441,243,531,334,165
060371351022,563,356,207,571,351,220,562,363,189,615,370,212
060371351023,431,274,157,438,271,167,622,391,221,513,307,181
060371285002,447,357,90,453,357,96,623,484,127,548,413,102
060371285004,506,396,110,510,396,114,690,542,135,462,345,88
060371286023,659,510,149,677,512,165,857,667,176,715,542,143
060372766081,840,678,162,859,682,177,752,584,153,571,416,120
060371092002,408,285,123,413,283,130,635,407,213,512,342,141
060371092003,201,141,60,205,140,65,531,342,179,256,176,68
060379800221,62,43,19,63,43,20,0,0,0,79,54,21
060371093001,300,200,100,308,199,109,451,291,146,454,285,143
060371093003,310,208,102,315,204,111,483,315,158,530,332,170
060371395051,261,186,75,270,188,82,456,281,167,315,207,94
060371395052,393,280,113,407,284,123,683,399,268,473,306,142
060371395041,717,516,201,731,512,219,1180,728,432,855,574,236
060371393021,389,308,81,399,309,90,810,572,227,595,412,154
060371393022,445,352,93,456,353,103,662,467,185,515,382,106
060371393023,157,124,33,161,125,36,265,186,74,229,170,47
060371393012,364,245,119,366,243,123,572,322,234,467,293,153
060371393013,753,512,241,755,506,249,1086,629,429,804,529,235
060371153011,552,369,183,560,362,198,601,425,168,657,428,188
060371153013,436,291,145,441,286,155,483,328,144,475,305,140
060371245001,608,462,146,614,458,156,785,578,197,592,432,130
060371246001,403,323,80,408,324,84,546,408,125,428,329,79
060371246002,537,433,104,546,436,110,709,555,144,602,468,111
060371047031,125,108,17,126,103,23,312,250,56,235,197,24
060371047042,203,175,28,204,167,37,406,325,72,293,246,30
060371047032,182,152,30,183,147,36,250,204,45,237,200,23
060371047041,429,378,51,431,362,69,410,327,73,428,367,37
060371047043,194,174,20,194,169,25,370,307,54,236,202,20
060371370001,912,593,319,933,600,333,1249,798,424,1086,688,347
060371903031,636,568,68,642,567,75,785,620,153,637,493,108
060371903032,243,218,25,247,221,26,337,248,80,310,235,58
060371903022,442,388,54,449,391,58,585,429,138,525,387,109
060372013011,461,412,49,467,400,67,672,552,107,498,426,45
060372013012,493,426,67,502,414,88,844,690,128,672,566,68
060372031001,175,159,16,176,151,25,297,240,48,225,195,17
060372031002,300,270,30,305,261,44,461,372,74,329,285,28
060372031003,294,269,25,303,260,43,566,455,90,424,375,26
060371349052,466,305,161,470,306,164,839,580,248,643,426,186
060371393011,557,363,194,563,363,200,710,451,254,559,375,159
060371957103,245,215,30,248,214,34,480,386,81,379,324,39
060371958021,380,338,42,384,338,46,523,415,96,354,300,36
060371958022,370,329,41,371,325,46,533,421,98,462,391,48
060371991201,346,308,38,350,297,53,735,615,101,514,435,51
060371991202,323,295,28,322,284,38,451,377,63,464,386,34
060371351131,328,246,82,331,246,85,523,359,153,383,265,95
060371351161,170,124,46,172,122,50,291,213,74,260,181,67
060371351162,292,220,72,298,216,82,397,291,101,440,322,96
060371351152,210,146,64,215,145,70,826,549,250,353,240,99
060371371034,436,311,125,447,311,136,774,534,230,668,466,174
060371371031,373,281,92,377,280,97,419,298,115,426,311,91
060371256001,456,345,111,463,343,120,511,380,123,482,336,122
060371256002,512,379,133,522,379,143,621,463,147,521,361,135
060371255022,656,561,95,663,557,106,840,684,139,641,514,88
060371255021,520,416,104,528,416,112,721,558,147,594,444,117
060371390012,686,543,143,693,537,156,1043,738,279,714,523,148
060371390013,367,279,88,374,281,93,577,421,145,423,315,83
060371390014,361,280,81,366,280,86,457,318,132,413,296,91
060371392001,435,327,108,441,329,112,563,395,155,482,340,117
060371392002,318,234,84,322,230,92,422,287,125,369,256,85
060371392003,382,281,101,385,276,109,552,375,162,513,354,120
060371392004,677,492,185,693,501,192,1121,646,454,609,414,157
060371393033,501,364,137,512,371,141,689,465,210,534,359,141
060371393032,256,187,69,259,190,69,529,358,161,484,344,113
060371416001,1023,774,249,1030,760,270,981,713,253,766,555,174
060371417003,352,256,96,358,252,106,347,249,91,289,203,73
060371895012,688,626,62,696,632,64,709,625,69,657,565,59
060371895011,468,414,54,474,417,57,587,514,60,514,431,49
060371895022,499,449,50,505,446,59,661,565,81,452,383,44
060371894001,822,722,100,817,711,106,1052,923,118,884,757,97
060371894002,427,385,42,430,388,42,571,494,67,506,440,43
060371894003,744,668,76,750,673,77,885,776,97,792,686,78
060372643053,518,395,123,528,402,126,644,495,137,566,448,90
060372623021,694,480,214,713,484,229,1072,782,273,985,711,229
060372623022,684,494,190,697,492,205,804,600,198,1036,768,216
060372654102,480,343,137,494,353,141,623,455,160,516,385,109
060371288021,677,566,111,686,570,116,936,728,191,787,625,114
060371288023,523,434,89,528,438,90,703,544,143,583,461,89
060372712002,393,337,56,396,337,59,626,517,96,410,337,48
060372110001,484,405,79,489,399,90,557,387,162,517,402,95
060372110002,361,248,113,368,245,123,436,306,126,373,254,103
060372044101,182,159,23,183,151,32,199,163,27,207,170,21
060372044102,221,210,11,221,194,27,284,241,38,278,244,16
060372044201,283,263,20,285,257,28,530,447,66,371,332,15
060372044202,151,141,10,152,136,16,225,195,24,168,152,7
060372048101,358,333,25,359,321,38,664,558,92,479,426,32
060372048103,316,291,25,315,282,33,412,345,56,460,416,27
060372039001,197,182,15,200,177,23,290,246,39,261,228,17
060372039002,485,446,39,489,431,58,632,529,89,515,446,37
060372048102,224,204,20,225,197,28,469,404,55,393,362,17
060372267021,174,158,16,172,149,23,270,230,34,279,247,16
060372267011,250,226,24,249,216,33,362,311,48,326,291,19
060372267012,194,175,19,180,161,19,346,293,45,280,248,15
060372267022,148,135,13,134,121,13,323,275,41,243,215,12
060372352021,434,409,25,421,388,33,898,790,80,533,478,27
060372352012,373,346,27,373,343,30,479,440,39,401,374,22
060372352013,352,326,26,359,328,31,557,501,40,441,402,22
060372352022,563,521,42,576,525,51,632,566,55,665,618,28
060372379003,413,374,39,418,371,47,618,563,41,471,442,19
060372381004,442,402,40,450,401,49,531,493,35,514,473,22
060372379002,438,396,42,442,397,45,500,458,36,544,498,26
060372381001,396,363,33,401,361,40,742,670,53,615,560,29
060372751021,370,331,39,372,327,45,428,370,50,394,332,38
060372752001,435,390,45,437,387,50,661,570,75,537,450,56
060372752003,457,413,44,462,408,54,616,533,72,508,427,49
060372380004,364,341,23,368,339,29,507,461,29,505,473,12
060372380005,533,502,31,545,502,43,643,592,35,546,523,10
060372384004,558,519,39,570,520,50,699,640,45,593,549,27
060372400102,333,305,28,334,297,37,572,496,60,484,445,19
060372402001,165,154,11,166,147,19,255,228,25,214,199,10
060372402002,401,371,30,409,361,48,655,565,67,527,489,21
060372402003,359,335,24,361,321,40,543,482,52,472,437,19
060371033001,817,359,458,834,342,492,1009,471,512,988,434,481
060371033002,826,418,408,845,407,438,1011,495,488,1038,479,495
060372407001,203,185,18,206,188,18,379,329,45,305,286,11
060372407002,213,199,14,215,196,19,257,223,25,286,267,6
060372408001,242,223,19,240,217,23,315,277,32,280,262,8
060372407005,209,196,13,212,193,19,298,262,34,305,289,10
060372412025,226,206,20,229,207,22,369,332,29,269,245,12
060372412021,341,311,30,345,312,33,375,340,28,315,289,14
060372412022,283,261,22,289,265,24,414,371,38,288,272,11
060372412024,190,175,15,194,176,18,321,285,28,255,232,10
060371065202,469,382,87,472,368,104,727,537,175,607,466,107
060371066043,307,253,54,308,242,66,669,515,141,414,335,61
060371070203,355,304,51,357,287,70,610,483,113,492,415,51
060371070101,312,263,49,315,248,67,540,432,101,439,365,57
060371070102,387,325,62,392,308,84,621,480,123,489,400,67
060371070204,290,239,51,289,231,58,407,314,86,303,244,41
060371070202,288,239,49,289,228,61,489,367,105,337,271,46
060372013021,398,325,73,398,320,78,492,399,83,380,297,65
060372013023,472,376,96,477,375,102,830,671,144,496,388,84
060372013022,682,556,126,688,550,138,797,651,131,693,538,118
060371066042,355,268,87,362,262,100,536,395,131,412,313,72
060371436031,766,634,132,775,634,141,969,785,165,735,575,113
060371436032,378,314,64,380,312,68,476,386,81,363,285,56
060371061111,563,387,176,571,368,203,770,518,236,628,439,162
060371061112,1000,693,307,1023,677,346,1553,1058,457,1244,842,334
060371899062,495,414,81,507,416,91,760,607,141,636,490,109
060371899071,464,403,61,470,403,67,690,552,128,631,508,90
060371899061,544,480,64,553,487,66,697,556,124,498,412,55
060371042031,397,355,42,403,339,64,718,596,96,533,463,41
060371042032,431,388,43,442,373,69,600,505,73,509,447,36
060371043213,149,133,16,150,128,22,245,201,36,211,185,15
060371132111,837,479,358,850,469,381,1142,705,420,755,416,295
060371132112,949,571,378,965,553,412,1272,809,439,1025,583,387
060371895021,571,511,60,576,503,73,775,651,109,489,395,58
060371896002,435,383,52,438,380,58,620,524,88,408,340,45
060371134283,367,235,132,371,228,143,545,351,187,460,293,138
060371861003,822,653,169,827,644,183,864,678,167,859,638,166
060371862011,342,288,54,342,282,60,567,443,109,368,292,55
060371862012,680,581,99,681,569,112,947,775,157,714,579,101
060371862022,407,339,68,409,335,74,630,498,116,466,368,72
060371043221,217,197,20,219,192,27,416,335,65,303,269,20
060371043211,178,162,16,180,157,23,291,240,47,203,182,13
060371043222,136,122,14,136,119,17,324,269,52,228,203,14
060372012001,652,584,68,656,561,95,907,759,137,905,771,91
060371043101,195,176,19,197,167,30,345,289,50,292,266,15
060371043102,324,292,32,329,278,51,505,417,73,429,390,18
060371060202,447,330,117,452,315,137,653,464,177,552,388,132
060371060203,548,408,140,552,389,163,849,609,219,667,505,126
060371953003,868,799,69,875,801,74,916,780,113,916,765,88
060371094001,365,285,80,377,280,97,575,415,145,447,336,84
060371095001,266,225,41,270,220,50,462,370,82,358,298,43
060371095002,423,358,65,427,348,79,694,557,123,577,477,68
060371011102,402,263,139,403,256,147,693,372,307,455,279,150
060371012221,404,267,137,409,265,144,766,428,319,570,376,150
060371012211,211,138,73,215,136,79,401,214,176,277,167,92
060371014001,250,159,91,249,154,95,375,213,156,285,176,91
060371034021,333,204,129,340,200,140,620,348,252,442,256,157
060371034022,299,185,114,306,181,125,445,251,182,416,239,150
060371094002,269,214,55,280,216,64,534,384,134,439,339,73
060372963001,603,383,220,618,375,243,950,608,324,641,400,201
060372963002,253,164,89,259,160,99,429,281,139,323,206,96
060372963003,743,500,243,760,487,273,1270,831,409,837,547,243
060372964022,247,174,73,252,172,80,329,219,99,310,208,86
060371112011,454,298,156,463,289,174,633,391,228,549,331,184
060371112012,623,382,241,632,370,262,900,535,343,743,423,266
060371066451,505,301,204,515,295,220,718,419,293,609,350,229
060371066461,701,439,262,716,429,287,1061,643,398,903,506,353
060371066462,492,326,166,504,312,192,761,473,273,590,392,163
060371200201,390,333,57,389,324,65,526,394,118,452,372,52
060371200301,315,274,41,314,269,45,570,427,126,483,402,47
060371991101,302,271,31,300,264,36,408,338,62,399,326,42
060371991102,424,383,41,426,371,55,554,456,87,472,398,47
060371992021,370,332,38,369,321,48,607,506,83,556,462,55
060372933021,747,480,267,763,480,283,931,607,306,725,456,226
060372933022,511,340,171,520,336,184,887,575,292,650,421,186
060371111001,478,324,154,485,324,161,710,450,240,639,425,175
060371111002,577,394,183,584,392,192,866,550,293,695,466,190
060371114022,684,462,222,699,477,222,1033,660,351,789,516,229
060371114021,379,260,119,387,266,121,700,435,246,500,332,138
060371060201,622,479,143,620,455,165,1070,786,259,766,579,141
060372932041,386,266,120,394,275,119,665,466,185,535,364,143
060372932031,462,320,142,472,329,143,859,563,263,644,438,168
060371436021,544,443,101,550,442,108,600,484,108,540,426,88
060371436022,878,706,172,898,716,182,1163,938,214,1032,808,189
060371436061,632,533,99,642,537,105,760,611,135,659,522,98
060371436023,839,709,130,850,704,146,1070,872,177,830,687,114
060371081021,426,253,173,438,252,186,836,504,316,463,290,147
060371082031,932,605,327,942,592,350,1383,826,536,1071,687,353
060371082032,463,278,185,476,274,202,675,403,261,527,297,203
060371082041,655,398,257,671,393,278,882,568,302,779,491,248
060371097002,660,473,187,668,455,213,1006,692,294,816,549,200
060371097003,373,273,100,377,264,113,492,339,147,411,288,100
060372410012,214,197,17,214,195,19,355,311,32,279,255,12
060372411101,352,319,33,355,317,38,600,512,70,429,387,19
060372411201,172,159,13,170,157,13,285,246,27,233,213,9
060372411203,124,113,11,122,110,12,279,247,28,221,202,9
060372411204,160,145,15,162,145,17,226,197,23,214,193,11
060371098003,383,246,137,391,242,149,654,418,224,505,321,163
060371814002,465,383,82,464,375,89,590,467,115,456,360,70
060371814003,677,560,117,678,544,134,1049,811,220,883,690,146
060371172021,547,376,171,552,364,188,834,574,246,641,424,185
060371172022,406,277,129,412,271,141,568,382,172,501,330,145
060371173012,525,347,178,542,342,200,767,497,250,614,401,175
060371173013,408,287,121,413,280,133,616,404,198,420,286,110
060371340011,242,190,52,247,185,62,284,216,64,272,203,53
060371345211,148,116,32,152,115,37,309,234,69,280,212,48
060371345212,96,75,21,96,73,23,359,267,78,235,189,33
060371907011,341,293,48,338,286,52,434,340,83,460,365,69
060371907012,205,184,21,204,182,22,324,264,58,237,204,17
060371907021,185,169,16,188,168,20,258,206,50,233,203,18
060371908022,198,176,22,199,175,24,358,289,65,266,221,28
060371097001,489,357,132,499,350,149,807,547,238,637,450,154
060371173011,564,367,197,590,367,223,777,496,265,681,406,229
060372381002,388,362,26,394,362,32,655,588,41,556,518,22
060372382004,409,378,31,417,379,38,694,622,51,566,529,22
060371976001,271,248,23,271,248,23,234,203,26,215,186,16
060371976002,519,478,41,519,464,55,532,454,62,671,583,49
060371977001,663,600,63,660,590,70,831,661,139,846,717,77
060371881001,724,647,77,731,638,93,840,702,123,602,499,63
060371881002,432,385,47,438,384,54,532,424,96,825,679,94
060371881003,470,420,50,476,408,68,525,439,77,381,317,40
060372080022,464,424,40,464,415,49,722,605,95,538,473,31
060372080011,477,435,42,495,437,58,856,708,124,521,444,43
060372080021,428,390,38,441,390,51,648,540,87,482,412,35
060371096032,389,286,103,396,283,113,632,454,162,529,378,117
060371096033,369,279,90,373,275,98,692,504,169,487,355,106
060371096041,225,168,57,226,161,65,412,294,109,261,188,58
060371096042,287,216,71,290,209,81,426,303,115,363,262,79
060371096043,341,252,89,343,239,104,564,401,151,509,360,122
060371245002,623,495,128,629,494,135,835,624,186,630,486,107
060371096031,425,321,104,427,320,107,626,461,146,568,396,124
060371192013,442,378,64,445,364,81,676,530,126,580,497,56
060371192021,151,127,24,151,122,29,322,246,66,261,212,33
060371192022,288,245,43,288,236,52,425,334,84,331,270,43
060371190033,345,309,36,349,290,59,501,413,82,430,366,45
060371192011,256,209,47,259,199,60,472,358,104,381,307,59
060371194003,560,455,105,561,436,125,939,715,204,755,604,117
060371233031,209,161,48,213,161,52,328,209,115,273,199,62
060371233042,182,139,43,185,140,45,345,217,122,268,192,59
060371233043,311,239,72,319,241,78,447,280,155,355,255,79
060371238001,398,303,95,401,301,100,612,403,198,442,324,93
060371193411,498,404,94,504,397,107,879,605,250,684,527,120
060371193421,296,244,52,301,243,58,601,466,123,371,307,43
060371193422,190,155,35,193,153,40,369,275,84,344,284,40
060372951033,659,385,274,668,379,289,826,494,316,816,448,316
060372951031,778,476,302,791,459,332,1035,618,402,978,571,356
060379800151,184,118,66,190,115,75,525,336,177,252,143,96
060371908011,383,340,43,386,339,47,510,411,89,360,304,38
060371908012,358,306,52,357,299,58,503,380,108,481,378,77
060371918101,287,263,24,288,262,26,413,347,56,413,358,30
060371918102,279,256,23,282,256,26,372,315,48,298,259,22
060371044031,316,281,35,317,271,46,478,398,63,445,386,37
060371045002,402,364,38,404,350,54,609,512,77,550,481,43
060371048221,419,361,58,423,351,72,717,576,117,587,491,61
060371045001,164,146,18,165,139,26,323,273,43,244,210,21
060371046101,301,270,31,302,255,47,651,541,87,476,432,29
060371046202,337,303,34,342,289,53,531,439,71,461,414,33
060371253102,371,316,55,376,312,64,466,397,66,335,267,49
060371253211,544,475,69,551,470,81,785,644,115,503,411,61
060371253212,462,412,50,466,407,59,771,639,110,550,457,60
060371132381,263,215,48,265,208,57,448,336,95,408,300,83
060371132382,423,345,78,430,338,92,699,525,148,511,376,103
060371132383,239,175,64,245,173,72,305,208,94,194,143,39
060371909011,134,122,12,136,119,17,203,171,28,160,134,17
060371909012,316,285,31,318,278,40,571,479,80,509,420,62
060371909013,292,266,26,292,256,36,264,221,36,238,201,25
060371048211,429,358,71,430,347,83,686,528,142,532,425,73
060371171021,350,270,80,356,264,92,546,393,145,478,343,106
060371171011,526,390,136,536,388,148,882,623,242,633,467,132
060371171012,357,264,93,363,262,101,578,409,159,444,327,92
060371193402,180,156,24,183,151,32,356,291,58,312,258,36
060371193401,81,70,11,81,67,14,267,218,43,197,162,23
060371201031,78,68,10,80,66,14,176,145,28,144,118,17
060371201032,106,92,14,106,88,18,363,297,58,303,251,37
060371201081,316,264,52,321,257,64,465,354,97,275,226,33
060371132321,1055,639,416,1066,621,445,1483,922,538,1069,643,374
060371132322,694,437,257,706,432,274,1057,660,379,860,504,310
060371285001,539,435,104,538,424,114,885,676,195,837,649,140
060371287032,453,366,87,450,355,95,659,501,144,511,394,89
060371201041,286,230,56,283,219,64,516,382,124,344,279,48
060371201051,372,290,82,372,284,88,492,369,111,479,376,78
060371200202,202,170,32,202,167,35,280,216,58,343,280,49
060371201071,135,113,22,137,114,23,284,220,58,205,170,23
060371201072,184,154,30,186,155,31,434,327,97,248,207,27
060371201061,100,82,18,99,77,22,226,175,46,147,120,21
060371201063,164,134,30,161,126,35,427,315,105,228,187,33
060371201062,126,103,23,123,96,27,226,163,60,130,107,19
060371174072,190,160,30,192,159,33,498,376,110,241,203,27
060371174081,345,291,54,348,286,62,660,490,154,448,359,66
060371175301,86,72,14,87,71,16,240,178,57,148,118,22
060371175303,286,233,53,291,232,59,442,323,107,305,242,45
060371434012,470,388,82,477,387,90,622,502,112,456,360,75
060371435003,790,654,136,800,649,151,1032,830,184,842,669,134
060371435004,551,458,93,559,457,102,729,594,123,567,452,88
060371439021,834,682,152,851,681,170,1200,960,218,953,771,147
060371173032,411,276,135,416,271,145,505,346,151,415,268,119
060371341042,511,387,124,523,380,143,620,436,172,488,357,106
060371347102,166,130,36,165,125,40,503,353,139,354,270,64
060371347103,187,147,40,188,142,46,392,275,109,263,201,47
060371341031,551,396,155,563,389,174,1064,684,365,734,520,179
060371341041,479,328,151,487,318,169,1017,662,333,729,494,192
060371200101,267,225,42,270,225,45,350,272,72,286,240,33
060371275201,197,165,32,204,170,34,540,416,110,292,249,29
060371275202,167,140,27,173,145,28,394,305,81,221,188,22
060371021031,611,341,270,625,337,288,908,446,447,691,361,287
060371021042,325,192,133,329,187,142,479,245,224,462,246,193
060371174043,631,476,155,650,475,175,1079,720,339,794,549,189
060371313003,610,474,136,613,463,150,985,715,250,799,599,153
060371313001,491,377,114,494,369,125,723,529,183,623,464,122
060372947012,111,89,22,113,86,27,264,201,58,170,139,24
060379800141,50,29,21,48,28,20,38,31,7,22,15,7
060371252003,487,407,80,494,405,89,660,540,112,543,428,86
060371433012,882,734,148,890,726,164,1256,997,239,873,681,148
060371433011,452,375,77,457,374,83,620,491,111,473,364,79
060371311002,277,202,75,284,201,83,431,292,127,352,244,91
060371910002,534,473,61,542,478,64,729,555,149,643,532,67
060371910003,419,364,55,421,361,60,863,673,169,271,222,31
060372962201,126,103,23,128,100,28,256,191,59,188,147,29
060372962202,345,282,63,348,274,74,680,503,158,506,400,81
060372962203,262,216,46,267,211,56,392,292,92,294,233,47
060371431011,532,390,142,536,387,149,571,424,140,567,392,142
060371431012,717,528,189,716,516,200,784,569,202,865,601,213
060371431021,1101,863,238,1111,864,247,1365,1060,280,1285,970,240
060371436051,510,413,97,522,422,100,940,753,167,602,484,79
060371831011,316,283,33,317,279,38,420,361,53,376,310,45
060371831012,603,538,65,606,521,85,705,594,99,639,536,65
060371831013,651,584,67,657,569,88,833,694,119,717,598,77
060371200102,347,299,48,352,293,59,331,255,69,432,353,56
060371832211,323,290,33,322,283,39,361,305,49,356,302,36
060371832222,592,506,86,604,496,108,904,745,135,647,508,98
060371832223,544,486,58,548,479,69,590,496,82,748,623,86
060372913002,298,195,103,304,201,103,530,356,164,329,211,101
060372753114,720,552,168,727,552,175,850,669,161,884,635,191
060372756032,497,411,86,502,403,99,459,363,78,500,397,77
060372755001,286,249,37,290,248,42,392,322,61,260,216,27
060372755004,500,451,49,503,439,64,1056,859,168,606,523,42
060372764003,416,289,127,425,291,134,543,397,134,467,320,122
060372764004,394,270,124,401,274,127,485,360,115,374,249,104
060372780012,614,424,190,627,425,202,888,646,220,717,477,191
060372244101,263,235,28,266,232,34,391,324,55,360,307,28
060372244102,327,297,30,332,291,41,438,362,64,315,261,25
060372244201,175,159,16,176,155,21,284,232,42,251,203,18
060372244202,175,156,19,178,154,24,264,218,39,249,211,20
060372774001,31,28,3,31,28,3,26,20,4,248,223,14
060372774002,22,22,0,24,22,2,0,0,0,179,161,10
060371212222,195,167,28,199,162,37,492,375,103,276,227,32
060371212223,346,295,51,357,289,68,644,487,144,581,481,76
060371918201,516,455,61,519,452,67,778,656,106,440,367,49
060371918202,334,308,26,337,304,33,471,403,58,411,349,37
060371918203,267,246,21,270,244,26,308,263,40,262,223,23
060371210104,338,265,73,344,251,93,486,346,132,455,353,76
060371210101,209,167,42,212,160,52,329,212,106,289,213,57
060371210103,238,176,62,240,170,70,413,262,133,321,227,78
060371210202,418,308,110,428,304,124,692,442,232,482,349,111
060371218012,219,180,39,222,174,48,366,272,86,265,215,38
060372071011,340,292,48,346,287,59,617,484,113,336,276,43
060372071012,160,137,23,163,135,28,447,384,51,265,218,33
060372071031,103,88,15,105,87,18,231,183,42,155,127,19
060371190041,277,234,43,276,217,59,445,338,100,295,241,41
060371871011,646,547,99,649,541,108,797,652,133,683,558,92
060371871012,771,656,115,778,648,130,1000,816,167,810,658,111
060371871021,461,396,65,465,391,74,672,541,114,537,442,68
060371048241,187,162,25,188,154,34,298,241,52,256,219,29
060371048242,259,218,41,258,205,53,441,334,96,406,331,59
060371175304,165,133,32,167,131,36,317,228,84,247,196,36
060371175302,231,186,45,235,184,51,401,287,106,271,214,40
060372060101,444,385,59,443,379,64,855,699,133,427,346,50
060372071021,522,448,74,532,448,84,896,688,176,509,407,74
060372071032,244,209,35,248,209,39,416,325,79,276,220,41
060371198021,446,378,68,452,372,80,736,564,157,612,503,80
060371190012,587,467,120,602,445,157,929,700,198,748,587,128
060371220003,270,207,63,277,202,75,446,284,150,368,272,78
060371838101,476,435,41,477,427,50,731,639,70,519,443,40
060371838201,401,358,43,402,351,51,593,502,76,428,354,44
060371851012,696,636,60,695,618,77,868,759,94,658,566,49
060371851011,351,316,35,352,312,40,461,399,54,427,356,41
060371911101,503,436,67,507,422,85,826,586,223,603,449,117
060371911102,168,146,22,169,141,28,263,188,72,199,149,39
060371241021,293,252,41,296,245,51,498,390,93,404,333,46
060371241022,386,345,41,385,336,49,574,463,94,407,331,48
060371241051,248,216,32,252,212,40,388,305,73,317,251,47
060371241052,277,242,35,280,235,45,443,347,84,369,292,56
060371224101,430,349,81,439,344,95,685,544,133,469,389,61
060371224102,156,126,30,158,124,34,265,209,51,186,153,24
060371233011,635,494,141,651,492,159,853,569,264,731,527,169
060371271021,212,171,41,215,167,48,334,231,92,285,218,52
060371271023,412,334,78,419,324,95,694,499,176,438,347,73
060371271022,231,188,43,236,183,53,491,351,125,343,271,58
060371832202,437,391,46,436,378,58,842,714,104,465,399,38
060371832203,430,386,44,428,373,55,584,490,78,544,466,52
060371836101,304,276,28,301,263,38,393,335,46,435,378,38
060371836201,818,751,67,832,740,92,1120,963,129,848,734,59
060371256003,445,322,123,452,323,129,550,411,128,443,309,113
060372073041,359,327,32,362,323,39,410,337,64,494,418,45
060372073051,497,430,67,509,438,71,553,476,62,410,345,35
060372073071,479,431,48,487,430,57,593,505,73,691,594,52
060372073081,487,440,47,495,438,57,719,602,98,521,450,40
060371204001,560,437,123,566,426,140,1103,734,349,703,533,137
060371204002,365,273,92,368,263,105,648,432,205,512,377,109
060371912031,354,296,58,353,291,62,563,430,121,472,359,80
060371912032,245,205,40,244,202,42,340,261,73,256,197,43
060371197001,339,224,115,352,233,119,568,350,206,445,300,113
060371220001,427,306,121,433,303,130,831,481,329,634,435,168
060371220002,475,327,148,480,318,162,769,451,298,564,384,159
060371216001,478,352,126,483,347,136,754,441,296,644,442,168
060371193101,409,338,71,416,337,79,794,616,163,548,444,73
060371216002,237,176,61,237,171,66,399,236,155,303,210,80
060372073062,411,374,37,411,374,37,438,383,42,396,344,26
060372073061,283,243,40,290,247,43,358,296,47,282,242,22
060372075022,561,444,117,606,473,133,971,768,182,686,551,113
060372075021,480,401,79,505,418,87,535,414,107,580,478,69
060371271031,487,396,91,490,396,94,794,591,184,570,445,81
060371271041,429,347,82,436,346,90,757,539,202,478,368,82
060371974101,730,679,51,732,668,64,832,738,72,795,688,53
060371271042,316,255,61,324,252,72,546,377,160,462,352,88
060371904013,354,327,27,357,327,30,515,431,74,417,341,54
060371904012,411,375,36,414,376,38,590,491,85,480,394,62
060371904011,375,346,29,377,346,31,521,434,75,403,332,48
060371203001,259,188,71,259,180,79,448,312,127,346,257,77
060371203002,381,294,87,385,281,104,480,335,129,569,426,112
060371203003,349,279,70,349,272,77,438,316,114,381,304,62
060371210201,360,276,84,369,275,94,786,502,270,463,349,93
060371218011,467,387,80,468,371,97,908,695,187,634,502,92
060371255023,443,370,73,449,369,80,657,526,115,489,375,78
060371863011,277,239,38,278,233,45,341,275,56,237,192,32
060371863012,167,149,18,169,146,23,313,259,47,276,232,28
060371863013,203,181,22,207,178,29,363,302,54,264,222,26
060371863021,658,571,87,660,559,101,765,641,111,661,549,83
060371864011,500,446,54,508,432,76,746,620,113,603,518,57
060371836102,633,581,52,639,567,72,822,718,85,701,603,46
060372134021,299,260,39,299,248,51,485,358,121,376,318,39
060372134023,314,273,41,316,261,55,501,366,125,348,296,37
060371232031,188,173,15,193,169,24,416,333,70,285,242,27
060371232032,118,108,10,119,105,14,267,213,45,180,153,17
060371232041,156,144,12,158,139,19,284,227,49,206,176,19
060371232042,348,299,49,350,289,61,643,500,126,469,369,74
060371230201,395,344,51,398,336,62,666,493,148,552,455,61
060371230202,267,232,35,268,226,42,448,357,78,330,277,34
060371852021,497,459,38,497,445,52,629,549,68,403,350,30
060371852022,549,498,51,548,484,64,760,672,72,634,543,55
060371852023,396,370,26,396,357,39,605,525,67,373,322,28
060371990021,268,249,19,266,239,27,337,282,49,310,269,23
060371221201,421,360,61,426,346,80,713,546,156,602,500,70
060371221202,569,468,101,581,458,123,820,599,198,754,618,100
060371221212,273,224,49,280,219,61,423,305,109,360,290,55
060371853102,309,285,24,310,277,33,441,376,52,387,335,29
060371853202,283,262,21,285,253,32,475,407,54,432,375,34
060371990022,345,307,38,350,292,58,550,440,104,325,277,29
060371340021,308,248,60,310,242,68,415,300,110,235,185,42
060371349042,278,224,54,279,218,61,661,474,175,434,341,78
060371349041,381,277,104,384,276,108,544,390,146,445,317,107
060371903021,457,389,68,463,388,75,602,443,142,630,450,148
060371231031,495,398,97,501,399,102,651,491,146,485,378,78
060371231032,558,448,110,566,445,121,1010,757,226,732,558,135
060371066041,484,385,99,488,376,112,764,563,184,616,473,111
060371066492,479,387,92,487,377,110,557,420,125,490,384,86
060372325003,283,266,17,289,266,23,399,358,35,381,348,16
060372325004,218,206,12,224,210,14,364,322,32,294,270,10
060372346001,421,392,29,425,395,30,621,547,57,515,475,19
060372346002,307,285,22,305,280,25,432,390,33,387,351,18
060372011102,466,408,58,471,399,72,584,473,102,496,417,54
060372011101,325,287,38,325,278,47,464,378,78,375,313,43
060372011201,431,374,57,437,366,71,913,726,164,642,529,73
060372011202,412,359,53,416,353,63,499,401,90,412,344,46
060371231041,331,276,55,335,271,64,441,328,104,370,291,56
060371231042,399,334,65,405,329,76,615,456,146,532,420,76
060371243001,310,262,48,313,257,56,394,323,67,336,274,40
060371243002,369,322,47,370,322,48,631,504,107,487,388,63
060371901021,480,426,54,484,428,56,753,625,111,564,466,62
060371919011,564,501,63,570,497,73,790,659,114,682,568,72
060372414001,233,213,20,234,214,20,411,367,33,343,313,17
060372414002,434,403,31,433,397,36,577,522,44,535,496,23
060371235101,512,414,98,523,418,105,804,570,220,590,456,109
060371235102,397,309,88,398,308,90,674,435,226,503,374,103
060371281011,565,453,112,569,448,121,938,681,232,711,539,131
060371905201,316,274,42,322,270,52,457,330,118,387,269,87
060371912011,417,357,60,424,349,75,669,456,202,588,386,161
060371912012,647,520,127,653,492,161,1043,578,450,928,506,344
060372756041,817,655,162,827,657,170,805,666,125,848,686,126
060372756042,406,325,81,411,325,86,528,436,82,566,457,85
060371233032,387,324,63,393,317,76,660,458,188,494,388,81
060371234201,423,357,66,428,347,81,772,535,219,536,433,76
060372247011,254,223,31,261,221,40,170,137,27,333,271,39
060372653011,2455,2277,178,2528,2332,196,925,753,159,4402,3893,271
060371233012,526,446,80,531,432,99,781,615,151,647,524,97
060371233041,427,352,75,440,349,91,631,436,179,583,438,115
060371239012,532,441,91,535,427,108,733,568,157,607,460,111
060371351132,394,297,97,398,296,102,653,444,193,450,312,113
060372656021,470,332,138,474,332,142,729,501,219,486,348,122
060372656022,674,476,198,683,477,206,941,671,254,767,549,186
060371151011,845,590,255,856,575,281,866,581,267,916,624,250
060371151044,300,228,72,302,220,82,435,330,93,387,286,74
060371151042,222,169,53,224,163,61,454,308,136,295,218,56
060372742022,537,422,115,542,424,118,650,513,126,569,425,106
060371234202,163,124,39,162,121,41,336,226,107,227,163,56
060371234203,129,100,29,130,96,34,371,247,116,284,199,70
060371237001,148,113,35,151,112,39,312,181,125,190,134,46
060371237004,308,239,69,310,234,76,467,290,169,358,259,84
060371235201,571,424,147,569,418,151,903,581,302,642,455,145
060372657011,895,686,209,910,693,217,1114,778,324,1019,777,198
060372657022,376,282,94,384,286,98,473,325,141,425,313,93
060371237003,402,323,79,407,315,92,606,408,187,435,323,88
060371238003,648,500,148,655,491,164,1047,677,348,735,521,172
060372932042,295,210,85,299,210,89,424,303,117,310,212,80
060372932032,177,126,51,180,126,54,400,281,108,323,219,84
060372932061,303,226,77,310,226,84,353,267,83,312,220,74
060371238002,741,573,168,757,572,185,1086,766,292,841,601,190
060371044032,236,212,24,237,203,34,358,292,56,312,277,23
060371236013,588,463,125,594,454,140,912,635,259,552,411,110
060371244001,373,301,72,378,294,84,502,352,140,371,282,71
060371279201,468,386,82,480,391,89,780,555,203,587,463,91
060371279202,404,332,72,412,332,80,596,427,156,445,348,71
060371281012,328,264,64,331,261,70,496,364,123,354,270,66
060372047001,418,386,32,424,375,49,562,476,73,488,426,38
060372047002,361,327,34,366,320,46,537,456,69,453,395,39
060372036011,291,269,22,291,254,37,336,287,45,312,273,22
060372036012,286,265,21,285,249,36,422,352,62,367,320,26
060372036021,416,383,33,417,361,56,647,532,98,516,450,35
060371810004,694,551,143,701,535,166,870,668,185,775,573,165
060371815002,710,559,151,711,537,174,870,681,168,779,577,153
060371815003,529,458,71,527,444,83,621,516,97,568,465,72
060371891022,620,566,54,624,571,53,777,692,71,663,579,58
060371891023,646,584,62,653,590,63,771,685,70,628,535,65
060371231043,361,288,73,366,284,82,597,442,144,472,361,84
060371833001,370,326,44,371,317,54,462,391,60,321,268,36
060371833002,284,251,33,288,247,41,377,321,50,312,256,34
060371833003,467,412,55,470,400,70,777,647,116,594,485,77
060371834012,358,321,37,359,314,45,449,380,66,341,292,35
060372011203,256,217,39,257,208,49,297,235,57,286,229,37
060371835102,509,457,52,502,439,63,686,585,91,634,550,52
060371835101,428,382,46,432,372,60,661,551,94,519,429,63
060371992011,178,159,19,176,152,24,375,312,53,216,177,20
060371992012,290,260,30,287,247,40,429,348,69,341,284,30
060371992013,227,205,22,227,196,31,371,297,61,299,251,25
060371992022,452,405,47,446,385,61,577,479,82,411,344,40
060371883001,604,502,102,616,505,111,771,609,149,653,506,115
060371883002,594,500,94,602,495,107,841,676,154,650,505,118
060371883003,518,444,74,527,437,90,756,607,135,517,416,81
060371909021,372,332,40,376,328,48,561,460,87,420,355,42
060371909022,370,331,39,376,329,47,542,446,85,406,345,41
060371909023,194,173,21,196,171,25,285,236,44,217,185,21
060372085021,234,207,27,234,198,36,389,297,79,277,234,31
060372085022,211,179,32,213,172,41,305,227,70,243,204,27
060372085023,218,184,34,221,178,43,349,259,80,227,190,24
060372086203,337,299,38,339,288,51,456,344,100,359,302,40
060371239022,494,398,96,503,397,106,693,506,171,548,413,108
060371251011,625,513,112,638,511,127,885,702,167,649,485,135
060371252001,590,517,73,595,510,85,901,736,142,589,474,80
060371239021,510,422,88,514,414,100,598,451,130,584,457,96
060371241023,418,345,73,416,340,76,411,336,70,436,349,61
060371917101,244,215,29,244,212,32,248,194,47,225,192,24
060371917102,382,336,46,383,331,52,616,516,93,542,461,57
060371924103,317,270,47,321,268,53,411,349,55,367,305,47
060371924104,406,343,63,408,340,68,559,480,68,546,455,71
060371914201,483,441,42,487,437,50,794,690,83,627,533,52
060371914202,253,231,22,255,229,26,313,273,33,300,260,23
060371244003,563,321,242,570,319,251,777,482,280,678,403,247
060372284102,202,186,16,205,185,20,341,297,37,284,255,11
060372284101,229,211,18,229,208,21,365,315,40,271,243,10
060372311001,215,198,17,217,195,22,352,306,39,258,233,11
060371344241,772,448,324,784,440,344,1112,694,398,797,502,254
060371344242,646,401,245,649,393,256,835,542,277,776,487,270
060371032012,622,341,281,627,333,294,792,413,362,531,326,181
060371032011,645,372,273,647,364,283,1456,805,601,979,517,394
060371031021,272,165,107,282,165,117,438,233,193,390,208,156
060371031022,205,125,80,210,122,88,387,203,171,258,157,88
060371031023,344,201,143,349,196,153,515,273,232,403,222,160
060371031024,220,134,86,221,129,92,379,204,171,300,181,103
060371031011,663,360,303,677,354,323,956,493,437,652,344,270
060371031012,305,168,137,308,162,146,441,225,203,400,197,179
060371031025,333,187,146,335,175,160,510,270,228,396,209,160
060372404011,282,260,22,292,261,31,523,449,55,419,386,20
060372404012,295,274,21,304,274,30,535,459,61,426,395,17
060372404013,224,206,18,232,208,24,355,304,40,320,293,15
060372404021,258,237,21,264,237,27,361,315,37,321,298,13
060371011221,789,449,340,812,447,365,1128,591,511,899,467,378
060379800261,3,2,1,3,2,1,5,3,2,4,2,2
060371011101,498,310,188,509,306,203,935,503,412,632,378,207
060371011222,486,285,201,497,283,214,761,409,338,686,364,276
060371013001,416,231,185,426,229,197,647,344,292,545,284,220
060371012202,445,280,165,451,282,169,1005,546,434,678,404,221
060371013003,321,177,144,323,172,151,427,225,192,362,188,151
060371013004,261,144,117,266,140,126,394,209,180,331,168,135
060371908021,440,385,55,441,384,57,605,504,89,531,438,60
060371908023,225,195,30,226,195,31,233,190,39,219,182,25
060371011103,295,179,116,307,180,127,458,245,203,364,218,118
060371012212,361,246,115,365,240,125,644,357,266,517,343,138
060371012201,266,175,91,268,174,94,518,278,231,467,261,169
060372965002,394,316,78,399,313,86,704,517,167,494,389,71
060372965003,225,181,44,230,179,51,380,277,91,278,218,40
060372181201,437,388,49,438,377,61,827,656,159,539,463,45
060372181202,236,209,27,238,204,34,366,298,65,225,195,19
060372181203,167,150,17,167,147,20,231,192,33,174,152,13
060371278062,224,185,39,226,182,44,236,185,47,261,205,43
060371278063,293,242,51,298,239,59,382,290,82,331,262,55
060371852031,521,472,49,532,466,66,663,570,78,535,471,35
060371852032,429,387,42,433,375,58,614,525,75,494,420,43
060371853101,511,469,42,510,453,57,628,537,80,667,578,51
060371853201,432,397,35,436,383,53,619,528,79,536,463,48
060371955002,772,668,104,774,656,118,801,696,83,723,604,85
060371955003,524,467,57,531,461,70,607,542,60,559,475,51
060371956002,366,337,29,365,329,36,484,413,55,371,317,31
060371956003,267,245,22,266,239,27,295,256,34,282,241,24
060371956004,335,309,26,335,302,33,442,386,48,423,366,31
060371958041,339,308,31,337,297,40,490,418,63,383,319,38
060371958042,621,567,54,623,557,66,663,564,87,598,506,52
060371917201,389,346,43,390,338,52,660,523,118,425,365,40
060371917202,291,259,32,293,253,40,416,326,78,283,241,25
060379800091,3,3,0,3,3,0,33,27,6,5,5,0
060371242011,354,290,64,359,287,72,500,383,107,413,318,70
060371242012,429,350,79,433,347,86,552,426,120,363,285,59
060371242013,182,150,32,182,146,36,261,201,55,224,174,36
060371317022,237,178,59,240,174,66,337,235,95,284,209,61
060371882022,466,394,72,473,394,79,576,484,87,524,427,79
060371882023,369,311,58,375,316,59,451,376,67,377,304,62
060371239011,648,538,110,654,521,133,1165,878,255,754,593,115
060371882011,776,710,66,793,718,75,922,829,85,813,722,63
060371882013,604,554,50,614,558,56,783,700,69,543,482,40
060371952011,1055,958,97,1067,966,101,1250,1112,117,910,792,74
060371882021,509,428,81,513,426,87,618,515,93,554,455,79
060371952021,566,516,50,573,519,54,677,604,65,612,541,48
060371952022,569,519,50,570,519,51,602,537,59,523,452,46
060371952023,595,544,51,602,545,57,832,732,86,700,597,68
060371892022,326,293,33,331,296,35,391,316,69,368,311,42
060371892023,652,583,69,660,584,76,708,569,126,625,525,71
060371893002,605,502,103,614,504,110,714,558,151,633,477,129
060371893003,375,331,44,380,332,48,493,409,79,384,324,45
060371174071,69,59,10,69,58,11,164,125,35,90,75,10
060371175202,125,107,18,127,106,21,367,281,78,193,162,22
060371310231,603,475,128,609,468,141,880,620,236,683,518,132
060371318011,590,447,143,596,440,156,1155,813,318,836,608,188
060371893001,713,626,87,718,626,92,833,731,90,808,697,88
060371253222,245,220,25,249,221,28,409,347,53,243,202,24
060371254041,943,840,103,949,839,110,1707,1466,203,919,751,100
060372292001,270,241,29,279,236,43,424,362,52,305,282,13
060372292002,359,331,28,367,319,48,589,500,73,428,388,19
060372294201,332,304,28,332,291,41,501,431,62,449,398,25
060371905101,622,543,79,626,535,91,1077,835,221,706,547,111
060371905202,454,389,65,456,387,69,744,529,201,597,434,119
060371277112,260,210,50,262,205,57,296,219,70,225,174,37
060371283021,567,461,106,564,447,117,598,478,113,721,565,112
060371082021,751,501,250,773,501,272,1450,929,503,756,514,215
060371082023,814,515,299,825,506,319,1334,836,474,988,643,303
060371924201,380,328,52,385,320,65,561,455,100,418,355,44
060371925101,393,337,56,398,333,65,609,481,121,416,352,48
060371925102,388,333,55,393,329,64,772,603,149,516,433,59
060371253101,379,319,60,385,316,69,544,428,107,466,365,69
060371390011,563,428,135,571,432,139,938,689,230,645,495,112
060379800241,85,65,20,88,67,21,58,43,15,98,77,17
060371287042,687,542,145,701,540,161,814,626,170,708,540,136
060371287031,898,741,157,910,723,187,1199,921,262,763,588,143
060371911201,521,451,70,529,448,81,688,496,175,589,464,91
060371911202,296,250,46,303,253,50,571,432,130,441,350,70
060371916201,480,416,64,477,402,75,838,630,189,566,467,67
060371237002,289,213,76,296,216,80,378,219,151,285,186,85
060371413061,559,451,108,556,446,110,727,540,171,504,392,91
060371413041,859,695,164,856,691,165,1007,747,239,893,687,162
060371810002,609,466,143,617,451,166,712,524,177,636,439,162
060371810003,370,277,93,375,268,107,502,371,124,385,265,103
060371810005,915,732,183,914,705,209,1159,878,261,1072,777,236
060371813001,531,428,103,531,416,115,721,549,158,563,429,103
060371813002,426,331,95,430,322,108,649,496,145,467,343,102
060371813003,716,563,153,716,547,169,955,730,205,742,551,145
060371286012,364,305,59,372,309,63,675,514,146,500,383,83
060371286013,302,254,48,308,256,52,488,374,107,427,330,70
060371286021,375,313,62,380,311,69,484,361,107,367,282,63
060371832221,372,320,52,373,311,62,423,357,57,399,320,57
060371320011,443,331,112,452,325,127,550,389,149,492,342,113
060371320012,343,257,86,353,252,101,418,294,112,404,280,94
060371832212,870,768,102,874,749,125,1154,970,159,800,650,98
060371902011,413,368,45,420,367,53,630,463,149,700,553,84
060371902012,290,260,30,291,254,37,465,381,75,312,265,28
060371910001,347,311,36,349,303,46,764,554,191,379,283,66
060371913022,358,314,44,361,305,56,520,334,179,454,336,87
060371957201,349,323,26,351,318,33,402,344,47,427,366,34
060371975001,714,661,53,720,653,67,833,735,78,702,608,54
060371975003,321,299,22,326,296,30,395,359,32,286,250,21
060371834011,521,469,52,521,458,63,740,613,112,508,429,51
060371834021,400,355,45,401,349,52,644,531,105,409,345,46
060371412021,349,277,72,360,284,76,478,376,93,391,302,72
060371412022,583,465,118,593,471,122,762,594,156,725,556,135
060371412023,450,356,94,461,360,101,572,451,111,434,335,81
060371272102,351,282,69,357,283,74,680,513,155,966,757,155
060371272103,562,448,114,571,448,123,1317,965,327,707,544,127
060371836202,266,244,22,270,243,27,317,274,36,246,215,14
060371837012,335,293,42,334,285,49,484,404,66,414,341,49
060371837021,541,450,91,537,437,100,623,518,91,583,463,87
060371871022,881,771,110,887,747,140,1518,1228,269,934,775,109
060372371014,199,184,15,203,177,26,290,252,35,272,249,15
060372371012,141,130,11,139,122,17,251,219,31,215,193,11
060372371013,180,165,15,178,155,23,272,230,34,227,207,12
060371835201,541,498,43,541,483,58,594,521,57,483,416,33
060371835202,437,400,37,435,386,49,694,608,69,599,510,42
060371394011,301,186,115,306,186,120,486,277,198,306,181,108
060371394012,496,352,144,504,347,157,892,510,365,698,481,185
060371394021,525,341,184,533,340,193,681,433,238,626,416,182
060371394022,362,229,133,369,228,141,506,313,185,447,284,146
060371394023,302,190,112,307,190,117,418,239,175,336,216,108
060371395021,565,361,204,576,361,215,1003,573,415,710,448,226
060371837011,439,396,43,440,385,55,543,455,69,402,339,30
060371838102,548,508,40,550,495,55,818,704,92,536,453,48
060371838202,451,418,33,448,402,46,717,606,91,472,387,49
060372281002,267,250,17,267,238,29,454,383,58,382,350,15
060372288001,226,205,21,225,198,27,410,356,42,316,283,18
060372288002,240,218,22,239,210,29,413,352,45,341,303,18
060371851021,819,681,138,819,673,146,1014,871,124,931,741,149
060371851022,885,800,85,888,784,104,825,729,80,958,825,79
060371154031,319,227,92,326,230,96,529,353,167,385,275,96
060371154032,315,225,90,322,227,95,507,335,159,395,279,97
060371898021,612,536,76,615,533,82,699,560,127,646,538,78
060371898022,348,305,43,350,305,45,415,341,71,349,297,38
060371898012,388,340,48,389,339,50,470,384,84,349,297,40
060371899051,343,288,55,345,286,59,591,479,105,625,483,94
060371899052,589,489,100,595,490,105,769,610,144,579,440,96
060371437002,654,516,138,653,514,139,803,610,180,687,512,140
060371852041,605,517,88,605,511,94,773,648,112,527,438,62
060371852042,301,276,25,303,270,33,377,326,44,274,238,22
060371863022,887,782,105,894,775,119,1094,919,153,939,794,95
060371912041,499,438,61,502,427,75,673,474,185,598,469,91
060371958031,657,612,45,657,601,56,901,815,74,681,599,41
060371958032,513,474,39,519,470,49,666,599,60,576,502,40
060371882012,487,439,48,489,441,48,491,438,47,748,652,65
060371954001,445,411,34,452,414,38,530,479,46,481,429,32
060371954004,681,637,44,693,639,54,811,733,63,741,664,41
060371955001,951,886,65,961,880,81,1158,1049,97,1024,908,58
060371832201,286,248,38,291,245,46,424,352,62,249,200,32
060371951003,668,610,58,678,614,64,826,750,65,644,571,50
060371951004,962,888,74,967,884,83,1163,1068,84,958,866,66
060371954002,698,650,48,704,651,53,825,731,75,778,694,48
060371954003,528,489,39,532,491,41,699,628,61,574,514,38
060371864012,248,220,28,251,214,37,306,251,54,247,215,23
060371953001,308,289,19,305,283,22,416,357,53,403,348,35
060371953002,389,365,24,387,358,29,487,415,61,511,444,44
060371837022,549,472,77,545,452,93,738,594,130,714,575,95
060372126101,434,357,77,441,350,91,719,537,169,524,431,65
060372126102,418,347,71,427,341,86,727,562,155,455,377,53
060372126201,389,315,74,395,308,87,723,538,171,483,389,69
060372126202,316,258,58,321,253,68,740,554,174,422,344,52
060372127011,618,484,134,629,478,151,868,651,206,666,519,107
060371993001,515,454,61,513,435,78,828,704,105,701,585,73
060371993002,856,770,86,857,751,106,1007,850,130,802,669,71
060371994001,288,260,28,291,256,35,460,400,54,326,274,31
060371994003,441,396,45,441,386,55,565,468,82,488,412,39
060371905102,329,294,35,330,286,44,546,423,113,412,337,50
060372015012,395,348,47,399,335,64,479,395,68,381,314,41
060372015014,529,462,67,539,448,91,801,645,131,731,608,75
060372016021,262,225,37,268,222,46,367,293,63,359,300,37
060372016022,332,283,49,336,279,57,496,398,89,429,359,50
060372014011,672,599,73,682,585,97,1192,987,183,781,656,75
060372014012,464,404,60,468,394,74,731,603,115,841,692,94
060372015032,334,301,33,338,293,45,549,457,82,358,305,32
060372016023,250,217,33,258,214,44,383,304,66,322,268,36
060372294202,313,296,17,308,280,28,565,475,70,438,385,29
060372014021,632,555,77,638,541,97,757,610,126,604,496,71
060372014022,343,292,51,346,289,57,375,307,63,405,332,49
060372014023,374,320,54,377,316,61,449,365,77,377,309,47
060372347001,230,214,16,233,212,21,335,297,34,313,290,11
060372348001,250,231,19,253,230,23,348,306,37,250,233,11
060372348003,264,240,24,268,245,23,325,290,32,323,291,18
060372372022,240,225,15,247,225,22,303,275,26,271,250,11
060372015011,270,242,28,274,233,41,430,342,78,329,271,41
060371972001,443,376,67,454,370,84,721,593,120,519,418,75
060371972002,389,331,58,396,323,73,717,562,139,495,384,74
060371972003,231,194,37,230,188,42,393,340,47,278,228,39
060371151041,379,257,122,383,258,125,478,341,134,177,116,52
060371151043,291,198,93,296,199,97,531,360,158,217,139,63
060371990011,319,283,36,326,273,53,781,624,137,485,405,45
060371998021,166,147,19,169,143,26,277,221,44,195,164,21
060371998011,262,235,27,266,227,39,494,397,80,310,263,31
060371999002,181,160,21,177,151,26,316,260,50,180,157,17
060371994002,291,263,28,297,263,34,505,430,65,392,328,35
060371973001,703,661,42,701,651,50,860,775,71,803,712,43
060372699031,478,429,49,487,430,57,567,485,67,533,438,55
060372699092,572,512,60,580,513,67,778,675,85,609,510,56
060372718041,443,392,51,449,391,58,560,478,69,494,403,56
060372718031,487,443,44,494,442,52,593,514,69,652,577,46
060372325002,321,302,19,327,299,28,464,412,39,392,361,17
060371959011,1004,963,41,1007,956,51,1155,1056,75,1098,958,53
060372364001,646,607,39,650,606,44,808,750,42,682,628,26
060372364002,835,782,53,838,773,65,881,820,46,940,880,34
060371941021,617,491,126,623,489,134,857,655,188,684,515,131
060371941022,627,463,164,627,456,171,798,583,204,634,439,160
060372941102,245,199,46,245,188,57,382,290,89,340,259,59
060372941103,280,228,52,284,218,66,371,284,82,374,283,67
060372941202,181,160,21,181,158,23,382,294,81,271,234,20
060371437001,699,576,123,703,570,133,790,661,118,898,724,138
060371897021,520,441,79,522,444,78,635,528,98,467,385,60
060371897022,629,559,70,631,561,70,846,721,105,691,576,77
060372094021,145,123,22,149,122,27,290,215,69,211,173,24
060372094022,147,123,24,152,123,29,242,178,57,201,166,23
060372094031,272,224,48,279,224,55,277,208,66,220,179,25
060372094032,125,103,22,129,103,26,222,165,53,183,149,21
060371914101,432,398,34,433,382,51,613,494,103,558,481,48
060371914102,594,557,37,600,538,62,854,685,143,661,571,50
060371959031,493,456,37,506,457,49,705,628,62,604,526,45
060371959032,334,309,25,343,309,34,494,433,50,344,301,25
060371957101,456,420,36,457,410,47,679,582,82,540,458,48
060371957102,359,327,32,357,317,40,563,480,70,389,325,39
060372084011,251,206,45,254,198,56,384,304,68,403,335,45
060372084012,364,300,64,374,291,83,581,430,134,364,304,40
060371956001,260,241,19,262,237,25,379,320,45,289,245,26
060371957202,455,421,34,461,418,43,474,407,55,486,416,35
060372293001,250,233,17,256,225,31,474,403,59,366,331,17
060371240001,393,277,116,398,278,120,661,442,207,401,275,104
060371249031,892,695,197,900,693,207,1359,956,376,952,685,211
060372118021,372,315,57,378,315,63,611,454,144,339,282,38
060372123041,337,292,45,339,285,54,429,344,76,314,269,25
060372124101,203,174,29,206,172,34,344,254,82,222,181,29
060372124103,174,149,25,177,147,30,246,197,43,212,182,16
060372124102,231,198,33,236,196,40,420,322,87,274,230,28
060372124201,254,219,35,257,215,42,371,294,65,332,274,39
060371249032,442,370,72,444,368,76,641,491,135,543,409,96
060372946101,309,263,46,313,258,55,351,261,78,332,273,39
060372946102,512,431,81,523,424,99,790,586,178,803,651,110
060372947013,196,164,32,196,157,39,402,301,90,200,171,21
060372945101,343,285,58,346,281,65,617,477,131,411,334,54
060372945102,323,272,51,328,268,60,549,420,116,486,399,57
060371066481,647,540,107,658,521,137,1314,1015,270,721,591,97
060372119102,273,232,41,278,231,47,379,293,78,285,238,31
060372121011,256,207,49,261,207,54,372,299,64,288,233,36
060372121021,309,258,51,313,255,58,309,229,74,197,157,31
060372121022,297,240,57,303,240,63,496,384,102,373,301,47
060372215001,415,363,52,419,359,60,667,560,99,529,471,35
060372215002,285,249,36,284,244,40,459,384,67,353,310,27
060372944101,323,242,81,328,236,92,634,455,160,424,322,81
060372944102,599,451,148,601,434,167,952,690,240,660,498,128
060372944212,132,100,32,134,97,37,266,194,68,204,154,39
060372944213,137,105,32,138,100,38,240,173,61,234,174,47
060371240003,629,496,133,635,493,142,834,626,193,695,526,136
060371240004,613,465,148,623,467,156,882,665,206,724,532,161
060371434022,231,187,44,234,186,48,275,218,52,260,205,44
060372319011,404,369,35,411,352,59,631,526,88,528,470,36
060372319022,235,213,22,236,202,34,419,357,60,330,298,20
060372328001,245,226,19,248,219,29,389,328,54,303,277,17
060372971202,323,240,83,324,231,93,590,416,165,407,296,87
060372976013,263,173,90,269,170,99,522,333,175,382,223,125
060372976021,329,208,121,335,207,128,405,256,137,280,161,91
060372976023,483,313,170,491,306,185,543,346,186,487,297,153
060372125011,442,383,59,441,377,64,595,472,109,514,435,51
060372125022,352,312,40,351,306,45,444,338,97,315,270,26
060372132011,180,159,21,182,155,27,330,257,66,262,226,22
060372132013,200,177,23,200,173,27,432,345,79,291,246,29
060372131001,239,200,39,246,198,48,505,380,115,341,278,46
060372131002,308,259,49,316,258,58,370,279,89,277,228,36
060372213041,344,292,52,353,293,60,539,418,106,462,380,49
060372213042,206,180,26,210,179,31,355,277,69,217,188,16
060371288011,570,456,114,577,456,121,698,551,136,524,397,98
060371288012,814,653,161,824,653,171,1188,911,255,885,673,164
060371289103,607,489,118,621,485,136,948,705,227,844,633,167
060371284004,441,362,79,444,358,86,721,572,137,537,412,92
060371374011,360,255,105,363,255,108,670,471,192,470,322,124
060371374013,896,617,279,905,622,283,1041,709,310,1003,675,275
060371374022,681,462,219,700,472,228,905,610,279,671,455,179
060371374023,686,481,205,693,478,215,1093,784,285,831,580,207
060371375021,389,286,103,400,292,108,520,364,150,472,346,109
060371375022,768,554,214,777,555,222,900,627,264,770,546,190
060371375023,833,585,248,839,590,249,966,650,301,840,562,235
060372085012,322,280,42,324,274,50,398,321,66,340,278,43
060372086101,397,343,54,403,332,71,645,506,129,470,376,67
060372086201,274,238,36,278,228,50,368,292,70,313,248,46
060372218101,322,299,23,327,295,32,366,302,52,389,343,26
060372219002,185,173,12,185,168,17,206,173,30,248,219,15
060372226001,261,244,17,267,244,23,352,309,38,332,296,18
060372226002,502,462,40,513,456,57,716,606,89,711,637,39
060372226003,322,300,22,324,296,28,436,381,47,388,349,21
060371374021,1039,720,319,1060,728,332,1464,989,447,1168,796,317
060372222001,510,468,42,518,464,54,768,659,96,680,600,40
060372222002,357,321,36,359,312,47,526,451,62,416,362,22
060372318002,105,94,11,107,90,17,195,166,25,163,146,10
060372319021,165,148,17,167,141,26,291,246,37,231,205,14
060371375012,687,471,216,691,464,227,1173,739,409,998,650,293
060371375013,493,327,166,502,329,173,912,629,266,581,383,176
060371375041,1002,636,366,1020,644,376,1139,716,402,743,466,245
060371380001,1053,742,311,1067,739,328,1374,940,415,1080,731,293
060371375011,307,208,99,313,206,107,554,352,194,448,300,125
060371380002,402,284,118,406,280,126,598,435,159,508,350,131
060371380003,798,571,227,809,562,247,1168,825,325,917,625,246
060372427001,187,175,12,189,177,12,296,258,30,316,294,10
060372427003,273,253,20,281,260,21,495,431,53,503,470,17
060371398021,866,565,301,878,561,317,1061,642,402,876,564,282
060371398022,1014,622,392,1028,618,410,1312,800,490,1152,712,398
060372240201,241,217,24,244,218,26,392,328,53,290,247,28
060372240202,153,139,14,156,140,16,351,301,41,346,293,33
060372098201,197,169,28,202,165,37,396,303,79,293,247,28
060372098202,163,140,23,164,136,28,277,214,57,245,209,23
060372100102,136,118,18,141,115,26,172,134,38,148,129,14
060372100103,275,236,39,282,235,47,327,251,66,270,227,24
060371397041,1230,843,387,1244,842,402,1659,1050,585,1413,990,377
060371397031,1147,691,456,1167,692,475,1868,1119,731,1223,722,457
060371433021,345,280,65,353,283,70,414,339,71,382,304,60
060371433023,598,482,116,614,490,124,738,595,134,663,521,117
060371433022,700,568,132,710,570,140,898,725,163,862,684,137
060372246002,196,172,24,198,169,29,267,222,38,253,225,18
060372283101,206,191,15,207,181,26,345,297,41,273,245,14
060372283201,166,154,12,167,144,23,230,195,28,200,177,13
060372286001,365,337,28,366,320,46,566,483,71,491,444,27
060372286002,256,236,20,260,225,35,433,373,55,337,302,21
060371397011,402,286,116,413,291,122,550,375,166,493,365,110
060371414003,940,681,259,958,692,266,1185,811,350,1045,715,273
060371998022,186,167,19,189,162,27,364,298,56,259,221,24
060371999001,225,200,25,226,195,31,450,364,71,310,265,29
060371288022,696,587,109,697,579,118,864,679,172,674,548,95
060371201082,381,310,71,392,308,84,603,460,126,375,310,45
060371041241,495,394,101,497,379,118,804,583,200,567,436,101
060371397051,535,374,161,551,381,170,692,457,225,642,470,143
060371397053,747,515,232,755,513,242,801,524,268,910,661,210
060371416003,725,562,163,735,562,173,1226,960,246,730,566,131
060371415001,1561,1095,466,1586,1103,483,2131,1524,587,1661,1196,397
060371414002,522,361,161,533,365,168,708,506,189,633,422,183
060371042041,246,224,22,258,218,40,454,389,51,390,346,25
060372111241,238,199,39,242,195,47,398,307,81,310,256,38
060372111242,171,143,28,174,141,33,374,293,76,244,205,29
060372111221,208,177,31,204,168,36,284,219,58,169,136,24
060372111222,296,251,45,297,239,58,583,451,117,214,166,34
060372113201,220,193,27,222,183,39,324,263,55,195,163,19
060371413062,714,565,149,724,563,161,998,743,236,956,728,188
060371416002,556,425,131,559,424,135,901,709,181,1068,817,206
060372283202,269,247,22,274,242,32,402,344,47,370,343,16
060372285001,245,224,21,248,218,30,414,355,53,314,291,15
060372285003,122,113,9,125,111,14,263,226,33,200,183,6
060371289101,622,493,129,635,488,147,875,637,219,678,499,146
060371289102,585,452,133,592,452,140,705,518,178,654,488,141
060371413032,585,466,119,597,469,128,795,607,174,633,471,128
060371413042,487,399,88,496,399,97,692,531,152,544,416,99
060371414001,674,527,147,686,527,159,1036,742,274,725,536,149
060372122031,149,129,20,149,124,25,411,330,72,122,104,11
060372122032,264,228,36,266,220,46,400,293,96,287,244,26
060372122042,153,137,16,159,136,23,353,260,85,268,229,24
060372123032,283,245,38,286,237,49,578,464,102,256,217,23
060371417002,892,666,226,906,668,238,1062,821,228,1030,775,221
060372612001,1400,986,414,1418,992,426,1608,1035,550,1601,1108,418
060372612002,711,488,223,722,496,226,1024,667,342,604,438,147
060372073042,353,304,49,356,306,50,528,462,51,568,477,49
060372077111,543,471,72,555,469,86,887,700,169,532,436,67
060372077122,369,318,51,373,319,54,452,368,71,503,413,63
060371287041,597,465,132,609,465,144,712,547,152,693,531,135
060372701021,371,337,34,375,337,38,495,433,51,525,454,40
060372701022,676,603,73,684,605,79,750,655,80,607,525,50
060372701011,382,346,36,384,346,38,525,459,55,501,434,38
060371247003,796,682,114,799,674,125,1196,954,223,997,806,139
060371247004,602,489,113,607,491,116,684,548,127,607,476,103
060371412011,830,707,123,838,696,142,1004,785,198,866,704,99
060371412012,602,504,98,608,500,108,921,728,173,628,500,91
060371411022,911,715,196,919,717,202,1223,975,226,989,751,198
060371411012,627,521,106,636,518,118,823,628,181,767,586,132
060371411013,546,450,96,552,447,105,615,469,136,614,468,110
060371417001,416,322,94,422,322,100,502,397,101,436,336,86
060371439022,748,581,167,760,574,186,875,690,173,955,745,170
060371913011,337,303,34,335,292,43,463,392,68,345,296,36
060371913012,385,346,39,383,333,50,593,494,89,483,415,49
060372246001,295,263,32,298,257,41,456,396,53,344,301,21
060371439013,1015,806,209,1028,803,225,1098,850,232,866,681,157
060371439011,613,520,93,619,520,99,874,717,150,735,608,99
060372422012,214,197,17,218,196,22,383,325,46,318,293,12
060372422022,193,176,17,200,178,22,344,296,35,289,268,10
060372423001,283,262,21,284,252,32,425,358,54,350,323,15
060372423002,157,143,14,158,139,19,303,262,36,273,251,13
060372431001,396,360,36,401,354,47,567,489,60,554,520,19
060372431002,224,204,20,229,204,25,424,354,49,404,379,9
060372431003,140,128,12,143,128,15,233,199,25,204,194,6
060371432001,828,691,137,842,696,146,1111,910,183,717,556,116
060371432002,601,505,96,607,504,103,713,586,116,525,404,87
060372723011,410,338,72,417,336,81,384,328,51,427,337,60
060372723012,532,443,89,541,441,100,582,495,80,588,466,80
060371438011,1044,841,203,1063,851,212,1141,875,251,1080,848,185
060371438012,434,354,80,442,360,82,665,545,112,560,443,92
060371438022,672,499,173,668,494,174,815,612,191,664,491,146
060372170011,466,319,147,470,319,151,609,372,236,514,362,136
060372170021,700,545,155,710,541,169,1032,643,364,830,617,169
060372170023,718,552,166,730,559,171,928,635,287,811,610,168
060371439012,525,377,148,528,374,154,684,496,178,535,379,141
060371438021,474,390,84,475,392,83,599,496,95,535,442,64
060371897041,405,336,69,409,333,76,411,338,69,423,331,75
060371897031,422,362,60,425,364,61,491,410,74,479,389,72
060371897032,355,296,59,360,296,64,572,469,94,310,235,56
060371897042,349,287,62,353,287,66,800,655,132,511,413,66
060372430012,218,199,19,217,196,21,324,273,36,281,255,15
060372430021,217,198,19,218,196,22,343,289,41,312,288,13
060372430022,307,282,25,308,278,30,420,371,43,421,388,21
060372372023,252,228,24,259,227,32,392,333,53,343,312,16
060372372024,319,294,25,324,293,31,477,417,52,437,396,19
060372373002,311,288,23,320,287,33,458,418,38,344,319,16
060372373005,248,232,16,256,231,25,403,359,39,355,323,17
060372110005,534,352,182,545,351,194,689,515,172,598,402,175
060372110003,359,273,86,365,269,96,451,333,112,437,333,85
060372110004,462,358,104,468,354,114,843,632,194,464,357,82
060371896003,534,457,77,535,458,77,816,685,121,627,545,62
060371901011,311,272,39,317,274,43,444,347,80,377,300,50
060371941011,553,488,65,554,490,64,573,462,101,587,489,69
060371896001,751,668,83,757,667,90,1012,868,113,846,722,72
060371941012,926,786,140,935,793,142,1359,1060,279,967,787,127
060371941023,409,353,56,415,354,61,474,401,66,360,308,38
060371997001,470,441,29,478,439,39,467,376,74,471,408,30
060371997002,407,371,36,415,369,46,700,598,88,593,509,46
060371998012,287,255,32,297,252,45,412,336,63,404,346,37
060372611031,1011,866,145,1021,865,156,1116,849,252,997,838,129
060372717033,438,385,53,451,388,63,544,462,65,488,403,58
060372717032,492,425,67,502,426,76,525,450,64,432,359,50
060372611021,321,216,105,328,217,111,517,386,126,432,306,116
060372611023,933,635,298,952,640,312,1632,1088,527,841,554,256
060372655231,454,369,85,464,368,96,473,360,105,501,404,72
060372655232,401,324,77,409,324,85,465,352,106,445,357,64
060372656012,772,604,168,793,607,186,1052,785,250,905,709,156
060371942003,672,576,96,677,575,102,688,544,137,1139,958,135
060371942001,523,432,91,525,430,95,619,492,122,639,520,96
060371943001,434,337,97,437,338,99,506,403,99,408,320,82
060371943002,424,346,78,428,345,83,471,375,90,418,331,78
060371942002,489,436,53,496,437,59,726,615,100,493,434,43
060371915001,365,304,61,374,301,73,368,275,81,272,211,47
060371915002,366,305,61,376,303,73,534,404,120,421,329,71
060371915003,344,295,49,345,286,59,669,504,150,524,417,78
060371943003,551,497,54,555,498,57,760,643,106,515,456,44
060372734031,359,322,37,367,326,41,553,475,66,478,412,37
060372734032,260,229,31,265,229,36,310,266,43,250,215,19
060372735023,407,368,39,413,370,43,520,431,78,520,446,41
060372735021,427,386,41,432,388,44,521,454,54,456,394,33
060372735022,415,379,36,423,382,41,521,461,48,501,450,29
060372413001,239,228,11,239,221,18,353,324,26,286,268,12
060372413002,313,299,14,314,290,24,464,427,30,374,351,15
060372672021,536,438,98,552,443,109,750,572,161,645,510,103
060372672022,586,482,104,599,485,114,782,608,159,650,516,100
060372672013,490,412,78,497,413,84,729,577,138,496,397,71
060372672023,302,246,56,312,248,64,373,299,74,334,266,52
060372671011,904,748,156,917,745,172,1226,932,273,1007,800,151
060372671012,423,349,74,426,346,80,523,414,106,432,342,65
060372671022,1033,814,219,1047,806,241,1249,945,280,1148,896,202
060372671021,472,360,112,483,360,123,538,383,151,556,428,110
060372679011,551,407,144,563,409,154,886,633,237,518,368,132
060372679012,711,515,196,726,516,210,916,671,234,742,516,197
060372679023,546,394,152,556,394,162,727,534,187,579,465,93
060372652012,345,256,89,352,256,96,395,272,120,598,465,111
060372652031,388,285,103,394,284,110,584,400,177,475,354,104
060372652032,352,274,78,362,276,86,425,334,82,424,330,77
060372651001,548,381,167,560,386,174,778,516,254,622,443,148
060372652011,566,417,149,575,417,158,734,501,224,593,442,128
060372657021,548,394,154,556,399,157,712,471,232,583,412,148
060372655221,317,254,63,323,254,69,446,343,95,387,299,65
060372655211,312,248,64,312,247,65,477,366,100,389,299,67
060372655222,344,278,66,349,277,72,511,383,119,377,294,61
060372656011,489,381,108,498,386,112,596,438,151,501,392,90
060372655212,241,196,45,244,196,48,369,282,78,340,266,53
060372655241,273,224,49,278,224,54,376,280,90,281,220,44
060371114023,343,246,97,347,245,102,628,385,227,429,299,105
060372657023,350,273,77,355,277,78,426,295,123,396,312,70
060372673002,468,408,60,477,410,67,609,495,101,536,444,58
060372673003,483,420,63,491,423,68,586,474,97,565,468,61
060372677001,652,566,86,662,569,93,921,770,130,664,548,72
060372655242,741,596,145,754,592,162,986,737,237,873,700,130
060372673001,404,350,54,408,351,57,672,546,111,497,415,53
060372079021,1036,891,145,1055,887,168,2244,1819,369,399,327,45
060372079012,375,304,71,385,304,81,714,572,125,672,534,103
060372079011,323,262,61,330,261,69,644,526,102,349,284,43
060372079022,441,360,81,454,359,95,499,402,86,382,314,44
060372240102,328,288,40,335,288,47,453,371,70,320,260,38
060372690002,452,352,100,460,354,106,553,443,100,489,397,80
060372695002,422,354,68,421,353,68,443,312,129,420,349,54
060372697003,386,331,55,387,330,57,379,293,80,375,311,45
060372697004,397,338,59,399,338,61,420,321,92,444,371,52
060372698001,552,475,77,561,480,81,836,711,106,653,549,67
060372697002,458,417,41,473,426,47,654,567,74,544,471,40
060372698002,873,785,88,897,800,97,1177,980,171,988,857,76
060372674061,786,679,107,804,679,125,981,807,159,788,654,88
060372674052,689,590,99,698,590,108,914,747,148,841,694,91
060372674041,380,325,55,388,326,62,399,326,64,496,401,62
060372675042,598,518,80,610,518,92,854,715,124,753,617,86
060372675021,595,509,86,608,514,94,789,653,122,644,525,75
060372675022,560,473,87,571,477,94,812,676,123,661,530,84
060372675041,562,479,83,571,479,92,822,681,126,596,489,73
060372676001,525,433,92,537,437,100,633,506,110,555,432,92
060372623032,440,307,133,450,310,140,513,373,136,444,316,109
060372623033,543,400,143,553,406,147,512,384,125,591,455,116
060372640001,476,319,157,485,321,164,591,423,165,540,391,126
060372640003,512,353,159,521,354,167,690,477,204,498,353,131
060372623031,731,548,183,746,549,197,851,625,215,715,553,136
060372640002,689,519,170,704,520,184,919,653,255,702,529,144
060372641021,504,398,106,510,397,113,681,540,134,438,336,81
060372641022,841,673,168,850,677,173,1023,810,201,1109,873,193
060372641031,640,497,143,653,501,152,781,606,163,635,502,101
060372376002,167,155,12,170,150,20,277,240,33,219,201,8
060372376003,152,140,12,156,136,20,249,217,31,217,204,7
060372376004,115,107,8,119,105,14,198,173,23,146,137,5
060372377102,275,255,20,281,250,31,547,470,65,386,358,13
060372641032,535,413,122,545,417,128,711,548,153,575,459,85
060372643031,586,476,110,594,473,121,809,621,174,604,480,91
060372643041,303,246,57,309,246,63,391,307,78,347,275,55
060372643032,541,440,101,548,438,110,743,583,146,622,493,96
060372761022,440,413,27,448,414,34,567,502,58,507,456,30
060372911301,291,237,54,296,236,60,369,294,75,372,312,45
060372911303,268,219,49,274,218,56,366,286,71,350,289,41
060372912101,283,236,47,285,233,52,362,271,81,307,257,31
060372396021,240,224,16,244,219,25,368,317,39,303,275,13
060372396022,271,252,19,272,244,28,384,331,41,357,323,15
060372643042,719,586,133,732,586,146,1053,833,201,811,645,127
060372654201,435,335,100,439,332,107,117,90,26,490,370,93
060372654202,509,391,118,515,390,125,212,176,34,563,427,107
060372651002,651,442,209,662,445,217,809,538,265,589,434,133
060372653032,333,304,29,343,309,34,360,295,52,452,388,31
060372653041,505,460,45,525,475,50,553,486,53,784,667,60
060372653042,229,209,20,236,214,22,192,169,18,288,248,19
060372653033,284,254,30,290,255,35,310,254,45,352,305,26
060372653071,374,350,24,382,356,26,680,541,122,467,409,30
060372653072,342,319,23,349,325,24,310,254,45,457,400,30
060372654101,355,269,86,365,279,86,517,381,133,439,356,72
060372621001,261,181,80,263,180,83,440,292,138,336,231,94
060372621002,349,240,109,346,237,109,619,416,196,386,267,108
060372621003,934,631,303,936,633,303,1118,728,373,859,580,242
060372622002,1167,724,443,1191,724,467,1230,766,443,1328,855,416
060372622003,433,303,130,443,308,135,652,432,208,495,355,114
060372622001,527,365,162,539,370,169,753,502,242,679,479,159
060372015041,603,535,68,608,517,91,1081,881,173,701,586,73
060372623011,1439,1014,425,1463,1018,445,1699,1223,447,886,593,256
060372624002,986,717,269,1012,735,277,1381,978,377,1216,909,261
060372624001,635,411,224,656,419,237,703,524,169,703,487,173
060372063022,277,239,38,282,236,46,143,118,19,271,214,43
060372625011,519,383,136,523,386,137,643,486,147,544,404,111
060372625012,464,342,122,468,344,124,540,422,112,479,356,98
060372625013,1085,810,275,1091,816,275,1225,953,254,1190,888,241
060372628021,866,684,182,876,691,185,934,724,192,926,734,152
060379800191,84,58,26,85,58,27,83,57,25,111,78,28
060372761011,615,543,72,619,539,80,921,798,104,646,546,62
060372948102,177,155,22,180,148,32,370,279,76,318,268,31
060372948301,280,246,34,285,239,46,525,403,107,416,353,41
060379800281,7,3,4,7,3,4,3,2,1,10,6,4
060372627041,720,532,188,732,543,189,879,679,185,891,675,162
060372627042,1119,808,311,1133,813,320,1525,1146,349,1048,760,228
060372780011,508,353,155,511,344,167,734,529,191,592,400,148
060372972012,380,279,101,387,270,117,636,428,191,398,277,94
060372972023,187,140,47,190,134,56,280,179,97,222,151,55
060372973002,477,322,155,492,317,175,686,437,241,506,318,157
060372975022,331,243,88,338,236,102,514,324,178,380,255,98
060372063011,299,266,33,301,262,39,529,414,97,514,427,52
060372260021,294,265,29,296,264,32,439,359,66,312,260,28
060372047003,282,262,20,282,252,30,272,239,32,273,244,15
060372051102,135,127,8,137,125,12,317,275,36,220,197,8
060372051101,238,224,14,239,220,19,525,454,60,369,332,16
060372051202,179,168,11,179,164,15,293,244,42,262,237,10
060372060501,484,443,41,489,427,62,800,689,97,557,485,43
060372611022,599,397,202,612,408,204,700,452,240,736,497,208
060372084021,297,263,34,301,262,39,489,394,79,357,304,36
060372085011,286,250,36,291,250,41,370,287,72,313,267,32
060371899031,610,513,97,618,522,96,428,333,89,627,490,101
060371899032,202,170,32,204,169,35,702,545,146,307,238,46
060371899041,416,353,63,418,355,63,708,563,131,484,380,77
060371899042,410,348,62,414,352,62,604,479,111,489,385,77
060371944021,586,536,50,591,530,61,672,578,89,617,542,60
060371944022,571,514,57,575,509,66,688,588,93,677,592,67
060371944011,628,546,82,631,544,87,851,712,131,747,621,98
060371944012,459,411,48,463,410,53,624,529,89,535,463,53
060371944023,507,439,68,512,439,73,623,534,88,563,484,61
060372911101,521,487,34,534,491,43,607,541,54,601,561,25
060372911102,316,291,25,322,298,24,681,600,64,412,379,19
060371920021,386,345,41,391,344,47,441,375,63,413,347,48
060371920022,311,277,34,313,276,37,388,300,83,383,323,43
060371919021,660,536,124,662,527,135,865,629,222,731,551,134
060371919022,698,603,95,704,602,102,857,715,135,691,569,86
060371920012,665,560,105,659,547,112,998,736,245,820,635,137
060371920011,371,318,53,377,316,61,487,372,103,414,346,48
060371920023,505,416,89,510,412,98,643,501,136,575,448,96
060372149041,383,303,80,388,300,88,522,362,154,424,324,81
060372149031,270,212,58,273,209,64,376,259,111,260,199,51
060372149032,277,222,55,281,220,61,388,270,114,332,256,61
060372947011,125,106,19,126,99,27,214,170,44,157,128,22
060372948302,176,151,25,179,144,35,237,178,55,187,158,21
060372149042,210,175,35,214,174,40,320,219,94,286,228,50
060372149021,348,290,58,355,289,66,526,399,120,454,360,78
060372149022,554,443,111,555,440,115,879,664,203,602,465,122
060371349051,681,532,149,686,512,174,1484,1084,376,666,487,146
060372164021,465,370,95,478,376,102,680,456,218,498,376,101
060372164022,466,369,97,477,374,103,686,459,220,593,451,115
060372164012,331,264,67,337,267,70,550,368,176,467,343,107
060372163011,705,594,111,715,594,121,953,778,168,857,722,98
060372678002,425,345,80,424,345,79,523,425,94,509,408,78
060372678003,641,520,121,643,523,120,931,747,165,709,563,108
060372264101,281,262,19,283,252,31,431,369,47,351,314,13
060372264102,229,211,18,230,204,26,321,278,34,261,233,12
060372679021,555,454,101,568,459,109,654,527,119,564,461,77
060372679022,688,562,126,697,565,132,818,627,179,772,625,117
060372693003,479,386,93,490,391,99,540,446,89,508,414,74
060372711001,405,318,87,406,323,83,448,364,81,447,348,77
060372711002,376,304,72,384,305,79,393,318,71,377,294,63
060372693002,500,405,95,507,409,98,519,434,83,512,424,71
060372693004,448,358,90,452,358,94,548,431,103,472,379,72
060372693005,386,308,78,389,308,81,484,387,91,407,329,64
060372691003,351,232,119,355,232,123,534,301,225,394,253,118
060372170012,319,188,131,322,180,142,461,213,240,377,208,149
060372170013,228,134,94,225,126,99,338,155,176,266,145,106
060372691002,244,151,93,248,149,99,359,167,187,252,151,87
060372691004,515,328,187,522,328,194,780,395,368,540,342,169
060372691001,551,335,216,551,324,227,863,500,351,595,389,186
060372695004,487,317,170,501,322,179,715,450,254,529,370,143
060372037101,248,234,14,255,230,25,428,362,57,335,301,15
060372037102,319,295,24,322,283,39,475,399,62,355,316,19
060372037201,312,288,24,312,280,32,553,478,57,490,423,35
060372037202,364,331,33,361,313,48,487,421,58,431,374,27
060372129001,354,308,46,361,306,55,399,313,76,259,211,26
060372129002,487,414,73,498,413,85,894,708,169,650,531,67
060372695001,437,320,117,441,324,117,548,318,224,466,361,96
060372695003,658,433,225,683,444,239,832,564,252,712,502,186
060372920012,279,214,65,285,211,74,583,397,167,477,340,100
060372693001,425,328,97,433,330,103,492,396,88,437,350,73
060372164013,363,294,69,364,289,75,572,384,182,448,334,88
060372170022,490,395,95,496,399,97,791,546,228,577,447,98
060372976012,270,183,87,277,180,97,405,258,136,302,186,91
060372976022,579,387,192,590,375,215,804,512,270,676,421,209
060372975021,579,370,209,591,373,218,926,576,313,662,409,213
060372975012,539,324,215,548,323,225,646,399,227,574,331,208
060372975013,457,248,209,468,247,221,516,299,211,513,266,208
060371864041,346,307,39,346,299,47,699,592,89,511,434,47
060371872001,538,469,69,546,466,80,750,625,106,616,507,68
060371872002,575,513,62,583,500,83,775,641,119,609,522,52
060372753113,500,440,60,502,437,65,761,601,146,581,478,67
060372755002,322,276,46,329,276,53,430,350,69,384,310,48
060372755003,312,264,48,315,265,50,420,343,73,349,286,43
060372696011,264,246,18,268,249,19,563,468,77,336,299,18
060372696012,268,250,18,273,252,21,433,370,51,276,246,14
060372696013,312,291,21,317,294,23,454,382,62,320,284,18
060372696021,606,525,81,607,526,81,734,607,108,647,558,68
060372696022,294,255,39,296,257,39,453,378,67,348,301,39
060372089021,78,67,11,77,64,13,191,139,48,128,110,12
060372089022,54,47,7,56,47,9,110,81,27,91,81,7
060372089041,226,197,29,230,193,37,228,164,56,170,149,13
060372089042,102,90,12,105,89,16,233,170,58,176,155,13
060372091051,207,181,26,210,177,33,411,311,88,257,224,20
060372091061,397,340,57,399,334,65,532,415,100,489,398,60
060372091041,267,236,31,273,231,42,483,377,91,323,280,25
060372699032,907,802,105,920,802,118,1186,1016,142,976,830,91
060372699051,458,403,55,465,403,62,609,525,73,413,352,38
060372713001,377,306,71,380,303,77,537,451,75,439,355,60
060372713002,432,350,82,439,348,91,618,522,85,460,374,64
060372715001,479,386,93,486,385,101,546,453,84,567,446,88
060372715003,746,578,168,757,584,173,906,720,168,741,568,128
060372717042,767,653,114,775,652,123,1055,862,170,835,685,101
060372717021,609,525,84,620,528,92,659,546,96,595,490,69
060372717023,423,367,56,434,371,63,786,651,115,689,563,79
060372716001,358,304,54,361,306,55,572,482,77,350,293,39
060372716003,444,376,68,450,376,74,436,373,55,375,306,48
060372716002,537,452,85,543,451,92,563,473,75,566,460,74
060372716004,467,395,72,475,398,77,959,819,121,664,552,76
060372718011,350,302,48,351,302,49,446,380,59,361,299,42
060372718012,649,561,88,657,563,94,980,832,130,723,596,86
060372718042,544,484,60,550,484,66,721,618,89,635,539,62
060372718032,704,647,57,712,645,67,914,791,105,657,568,50
060372124202,207,179,28,208,175,33,313,249,55,234,199,21
060372132012,217,189,28,220,182,38,466,358,99,286,236,35
060372133101,231,191,40,234,185,49,403,308,92,334,287,30
060372133102,283,234,49,291,227,64,450,343,104,389,329,36
060372133201,262,219,43,266,211,55,463,348,104,243,210,23
060372133202,193,165,28,194,159,35,303,232,70,224,194,20
060372115001,410,330,80,410,322,88,492,385,101,414,330,64
060372115002,668,548,120,671,536,135,1030,805,209,734,595,103
060372732001,333,302,31,337,304,33,473,419,48,371,329,22
060372732002,356,327,29,370,333,37,504,445,48,466,411,28
060372732004,438,401,37,448,404,44,570,503,44,499,436,32
060372733003,431,396,35,443,395,48,520,466,48,455,401,28
060372732003,252,230,22,257,235,22,357,318,31,297,267,17
060372736003,502,462,40,509,472,37,529,479,40,568,511,35
060372736002,366,333,33,372,338,34,427,387,35,412,366,25
060372731002,842,741,101,846,738,108,1188,1037,130,427,355,53
060372731003,431,388,43,433,384,49,493,428,62,762,649,73
060372737001,438,387,51,444,390,54,538,465,62,486,404,51
060372737002,417,375,42,426,381,45,554,478,60,456,384,43
060372737003,533,481,52,538,486,52,561,497,54,588,514,52
060372714001,362,276,86,363,277,86,398,320,74,385,300,68
060372714002,557,432,125,562,434,128,662,535,116,596,460,111
060372714003,925,728,197,932,728,204,1178,946,208,1039,805,190
060372721004,445,363,82,453,361,92,562,454,102,485,391,66
060372721005,312,254,58,316,252,64,388,318,63,392,314,54
060372715002,337,276,61,340,276,64,398,329,66,381,306,56
060372719022,618,510,108,621,509,112,726,587,122,613,491,86
060372721001,538,439,99,546,440,106,695,563,123,581,459,97
060372392021,340,315,25,338,306,32,564,494,60,456,424,20
060372392022,136,126,10,135,123,12,252,221,25,193,178,9
060372392023,148,138,10,147,134,13,316,280,32,250,232,12
060372719012,553,469,84,559,467,92,596,507,83,517,420,65
060372719021,411,333,78,415,336,79,436,372,61,419,341,58
060372719023,840,705,135,836,698,138,1012,849,141,988,820,117
060372719011,400,347,53,406,343,63,513,432,72,423,341,51
060372719013,305,264,41,309,261,48,387,326,54,344,279,43
060372721003,437,364,73,439,359,80,501,421,74,451,356,69
060372721002,440,372,68,442,368,74,452,380,65,472,375,65
060371901012,278,244,34,284,245,39,356,283,64,314,250,43
060371901022,356,315,41,362,315,47,510,410,87,373,299,57
060371902021,344,304,40,347,305,42,430,338,79,339,281,37
060371902022,444,393,51,450,394,56,538,451,75,508,420,55
060371862032,488,451,37,488,441,47,587,494,84,525,456,37
060371902023,237,211,26,241,212,29,449,361,76,283,230,28
060372317103,230,209,21,238,209,29,393,327,58,310,277,18
060372317202,105,95,10,105,93,12,190,159,29,149,135,6
060372317203,260,240,20,268,244,24,328,272,50,379,343,15
060372321201,198,180,18,199,174,25,319,270,48,293,267,16
060372321202,220,201,19,225,197,28,307,257,45,279,251,15
060372321203,352,309,43,363,307,56,608,500,90,471,418,26
060372317101,123,109,14,125,106,19,178,149,25,165,147,10
060372317102,242,216,26,248,209,39,349,286,49,319,284,18
060372427002,314,291,23,319,287,32,595,520,57,452,414,18
060372095101,119,104,15,120,100,20,197,153,42,127,108,16
060372095102,180,158,22,182,153,29,333,256,70,209,175,25
060372095201,196,172,24,204,168,36,314,243,67,220,185,26
060372095202,92,79,13,92,76,16,149,114,35,143,118,18
060372216022,325,305,20,326,291,35,354,278,67,366,335,14
060371919012,619,549,70,622,546,76,969,812,129,738,604,77
060372948101,189,164,25,192,159,33,334,257,66,260,227,22
060372948201,213,186,27,217,181,36,357,274,69,272,235,23
060372141002,519,365,154,528,366,162,676,442,231,546,377,147
060372141003,246,180,66,250,179,71,410,250,153,292,206,77
060372141004,602,452,150,607,447,160,803,434,350,653,462,168
060372970011,509,279,230,517,276,241,711,411,285,524,282,210
060372970012,277,167,110,284,164,120,393,239,146,340,199,116
060372974003,355,184,171,362,189,173,446,260,179,441,231,191
060372189002,341,321,20,342,312,30,526,453,59,453,417,21
060372214011,355,324,31,360,321,39,429,366,52,328,294,20
060372115003,600,469,131,603,467,136,561,448,107,623,486,106
060372751023,466,397,69,471,395,76,556,456,86,338,283,34
060372751022,232,197,35,235,196,39,601,499,92,505,422,51
060372117011,392,317,75,394,311,83,583,458,112,399,326,53
060372117012,368,298,70,374,296,78,528,420,103,416,337,64
060372117013,242,195,47,240,191,49,375,301,71,235,196,31
060372117031,480,418,62,488,410,78,781,617,150,699,574,82
060371918103,286,268,18,287,266,21,394,337,50,312,278,15
060372114101,395,319,76,400,308,92,686,509,161,473,374,75
060372114102,167,134,33,168,129,39,232,173,53,174,135,29
060372114201,507,435,72,507,420,87,809,597,192,631,518,82
060372114202,322,273,49,323,261,62,389,286,92,310,250,44
060372118031,245,199,46,246,189,57,468,350,107,278,222,42
060372118041,175,142,33,176,139,37,294,220,69,210,168,31
060372118042,349,280,69,354,269,85,613,459,140,371,291,60
060372118032,307,250,57,309,238,71,571,427,130,302,239,46
060371279101,309,246,63,314,244,70,440,312,121,343,266,58
060371904021,553,488,65,559,491,68,672,534,127,593,474,85
060371904022,255,225,30,257,226,31,378,298,74,375,301,54
060372094011,275,244,31,282,239,43,540,399,129,358,297,35
060372094012,249,219,30,251,213,38,324,238,78,193,160,18
060371977003,362,310,52,367,303,64,585,466,101,380,298,54
060379800101,47,41,6,47,41,6,56,47,9,40,34,4
060372033001,304,274,30,308,264,44,559,447,91,460,389,48
060371284003,444,366,78,450,363,87,559,442,106,415,318,71
060371413051,527,419,108,537,428,109,852,639,198,660,513,119
060371413052,563,450,113,572,453,119,909,686,208,647,503,115
060372121012,244,206,38,247,203,44,570,429,129,284,230,41
060372123031,236,204,32,237,199,38,353,283,62,271,233,20
060372088021,369,326,43,378,322,56,425,328,86,511,430,45
060372088022,290,255,35,293,249,44,239,177,59,312,261,28
060372212101,212,193,19,216,191,25,301,233,64,299,264,21
060372212102,422,388,34,424,381,43,547,448,85,536,464,33
060372213022,343,308,35,349,302,47,522,432,80,458,392,33
060372221001,355,331,24,364,334,30,555,486,51,489,438,26
060372111211,156,137,19,157,134,23,241,185,48,210,170,27
060372111212,311,272,39,310,264,46,498,384,99,467,377,62
060372060102,220,193,27,221,193,28,403,325,66,68,56,7
060372060201,222,195,27,224,195,29,948,608,250,389,321,34
060371331011,308,210,98,312,212,100,466,288,167,378,234,125
060371331012,322,220,102,326,222,104,499,313,178,433,287,121
060371061122,583,450,133,589,435,154,842,604,223,717,520,152
060371924101,473,423,50,480,418,62,653,550,90,493,419,52
060371924102,397,355,42,402,351,51,588,495,81,469,408,40
060372092011,475,407,68,476,399,77,770,614,125,280,229,35
060372093003,234,200,34,235,196,39,294,220,64,239,194,30
060372282101,295,273,22,301,267,34,362,304,49,347,317,18
060372282102,290,263,27,295,256,39,539,460,69,434,396,23
060372282203,224,208,16,229,201,28,408,346,51,309,277,17
060372283103,222,204,18,224,198,26,300,259,35,228,208,12
060372283102,175,163,12,179,159,20,297,258,35,267,238,13
060372161002,547,508,39,558,514,44,622,557,58,601,530,39
060372294101,239,221,18,242,208,34,415,354,51,316,283,12
060372294102,197,183,14,197,171,26,354,308,44,239,216,10
060372181101,554,504,50,561,505,56,737,620,98,739,651,57
060372181102,314,287,27,317,285,32,474,405,57,340,298,28
060372764001,443,296,147,453,296,157,543,393,137,474,314,128
060372764002,422,279,143,428,276,152,539,389,134,433,287,118
060372764005,408,281,127,414,283,131,545,395,137,489,346,121
060372321101,191,177,14,191,175,16,313,269,38,296,279,10
060372321102,286,264,22,287,258,29,450,376,61,405,374,14
060372213021,389,340,49,394,332,62,697,574,117,478,405,45
060372188001,313,289,24,318,290,28,537,455,72,417,367,17
060372188002,291,268,23,292,264,28,431,370,59,343,303,21
060372911201,453,418,35,461,423,38,643,572,60,533,484,27
060372912102,492,417,75,509,417,92,853,650,182,566,441,90
060372912103,270,225,45,280,225,55,624,469,138,379,297,60
060372189001,587,535,52,602,538,64,808,697,97,641,572,40
060372214012,458,416,42,464,417,47,822,707,95,623,567,29
060372187021,336,313,23,339,312,27,464,406,46,404,367,18
060372187022,276,258,18,281,259,22,438,384,45,364,332,15
060372216011,308,287,21,316,282,34,500,429,63,440,385,25
060372216012,255,238,17,257,230,27,498,422,60,391,341,22
060372098101,154,132,22,157,128,29,223,171,46,170,140,19
060372098102,114,98,16,115,94,21,231,177,48,174,143,18
060372221002,290,268,22,299,277,22,466,418,41,369,336,14
060372221003,217,200,17,223,207,16,263,233,29,243,220,10
060372219001,461,401,60,474,397,77,455,348,88,550,460,53
060371066421,407,231,176,416,242,174,625,338,279,483,270,187
060371066422,450,269,181,456,265,191,655,354,289,512,295,191
060371066431,1004,560,444,1020,560,460,1329,711,590,1152,644,439
060372225002,453,418,35,457,409,48,666,553,94,517,463,27
060372225003,359,332,27,364,328,36,517,442,62,496,448,26
060371318021,386,286,100,392,283,109,497,341,138,532,384,124
060371318022,286,214,72,296,212,84,383,274,106,346,247,80
060372189003,468,440,28,471,437,34,740,648,72,539,491,18
060372190102,439,411,28,438,401,37,561,497,55,551,510,23
060372193001,281,264,17,284,259,25,452,401,43,323,295,14
060372193002,280,263,17,287,262,25,464,413,44,284,258,16
060372193003,410,389,21,414,387,27,779,692,69,472,435,23
060372220011,431,394,37,437,397,40,586,511,67,469,433,20
060372220012,527,482,45,533,486,47,713,609,88,603,544,34
060372190201,520,480,40,528,477,51,861,756,86,618,553,35
060372190203,348,322,26,350,320,30,576,511,54,435,389,25
060372225001,293,265,28,302,261,41,462,383,68,349,309,20
060372190202,442,403,39,448,406,42,667,584,71,487,438,30
060372190101,404,373,31,404,367,37,483,416,57,482,450,21
060372220021,296,277,19,297,273,24,453,388,52,349,316,15
060372220022,249,232,17,251,231,20,329,287,38,314,286,14
060372220023,277,257,20,277,253,24,434,375,50,341,312,17
060372220024,337,314,23,341,312,29,515,449,58,436,393,19
060372426001,155,138,17,153,133,20,272,234,30,231,210,11
060372426002,221,196,25,225,194,31,456,387,49,326,308,7
060372426003,211,189,22,212,186,26,224,191,26,224,215,4
060372212201,168,144,24,169,139,30,302,235,60,267,231,23
060372212202,322,276,46,326,267,59,473,367,94,360,310,32
060372216021,227,196,31,229,189,40,332,262,68,262,226,22
060372197003,558,514,44,576,518,58,748,657,80,686,613,40
060372198001,230,214,16,231,210,21,316,280,34,274,254,11
060372198002,330,314,16,329,306,23,469,408,51,339,313,15
060372198003,274,262,12,274,254,20,399,348,41,318,293,12
060372201002,320,294,26,324,294,30,443,386,50,367,337,22
060372197001,420,397,23,424,392,32,623,542,69,482,441,26
060372197002,291,275,16,294,271,23,403,353,39,347,316,18
060372200003,265,250,15,267,250,17,393,346,33,292,273,12
060372200004,291,275,16,294,275,19,355,317,30,331,305,14
060372200005,353,332,21,354,332,22,551,487,49,485,441,21
060372200001,540,506,34,546,508,38,664,596,58,517,468,26
060372200002,454,424,30,467,437,30,526,477,48,488,445,23
060372187011,320,296,24,323,290,33,508,442,60,348,305,25
060371916101,562,512,50,575,513,62,771,641,112,674,572,63
060372403012,271,252,19,278,253,25,378,327,43,318,298,13
060372403022,157,147,10,159,145,14,235,205,27,170,158,8
060371925202,347,313,34,348,298,50,459,368,84,418,365,35
060371926202,357,319,38,355,306,49,449,357,82,361,310,30
060371926201,304,269,35,306,257,49,484,385,88,422,359,35
060371112021,517,326,191,526,326,200,713,421,275,577,345,197
060371112023,777,512,265,780,498,282,1177,727,432,929,569,301
060372112011,172,156,16,173,154,19,171,143,24,145,125,13
060372112012,304,275,29,304,270,34,509,410,86,388,337,33
060372112021,535,475,60,540,458,82,817,659,139,525,446,46
060372113101,221,197,24,225,197,28,396,335,55,259,222,25
060372113102,330,294,36,332,292,40,612,513,85,424,364,41
060372113202,346,307,39,349,300,49,534,440,83,387,329,35
060372083021,164,147,17,167,147,20,222,182,38,174,153,15
060372083022,242,219,23,248,219,29,310,256,49,253,217,24
060372084022,321,291,30,325,288,37,514,423,82,468,402,42
060371891021,548,419,129,553,423,130,676,505,161,592,465,102
060371892021,500,381,119,504,385,119,578,433,138,521,392,112
060372973001,321,180,141,325,179,146,580,331,233,533,290,208
060372975011,334,203,131,340,201,139,330,204,121,356,207,129
060372086102,403,340,63,416,341,75,696,524,153,468,381,71
060372086202,224,188,36,232,190,42,504,379,110,360,293,54
060372083011,168,152,16,171,152,19,401,316,71,321,284,26
060372083023,359,324,35,367,324,43,633,500,112,405,356,34
060372035002,222,201,21,233,201,32,306,250,51,261,223,20
060372032003,255,240,15,260,235,25,391,326,55,321,287,15
060372042001,244,218,26,244,209,35,415,360,47,306,266,19
060372042002,298,268,30,300,257,43,549,467,69,331,290,19
060372038001,198,180,18,198,172,26,308,260,40,249,218,16
060372038002,253,231,22,253,220,33,317,270,43,297,258,20
060372038003,300,272,28,300,258,42,469,395,61,373,324,23
060372038004,271,248,23,272,238,34,371,313,48,338,294,24
060372046001,484,454,30,489,440,49,709,594,92,560,486,35
060372046002,275,260,15,271,253,18,443,383,48,365,322,21
060372060531,217,188,29,223,183,40,326,263,55,269,225,28
060372060532,313,273,40,313,259,54,559,463,82,474,401,44
060372741001,357,269,88,362,272,90,794,617,162,464,328,106
060372741003,446,336,110,453,340,113,472,367,96,448,319,102
060372211101,143,120,23,145,116,29,217,158,54,135,114,14
060372211102,258,215,43,263,210,53,537,434,90,392,329,40
060372766013,449,309,140,456,306,150,568,404,149,1166,864,231
060372766014,638,456,182,649,447,202,757,571,167,644,436,166
060371340012,344,278,66,354,266,88,545,409,121,349,280,50
060371345201,222,178,44,224,168,56,558,400,142,329,262,48
060371349061,232,189,43,237,182,55,459,355,97,259,202,40
060372742024,326,267,59,332,273,59,446,350,87,431,338,72
060372742023,385,318,67,391,325,66,425,333,78,459,375,64
060372035001,145,129,16,150,126,24,207,172,35,176,149,16
060372035003,230,206,24,241,206,35,318,257,58,261,223,21
060372060521,863,770,93,872,756,116,1444,1193,226,642,542,64
060372060541,426,367,59,436,358,78,820,644,152,586,486,59
060372041101,251,232,19,254,223,31,339,286,42,309,270,25
060372041102,169,156,13,170,149,21,219,190,28,191,170,16
060372041103,229,212,17,229,201,28,374,312,49,268,235,22
060371393031,332,244,88,337,250,87,557,376,170,594,423,139
060371395061,329,226,103,331,219,112,474,277,186,417,281,120
060371395062,426,292,134,430,284,146,707,413,277,510,342,147
060372041201,267,249,18,269,241,28,361,311,45,274,242,21
060372041202,266,248,18,266,239,27,457,386,61,338,301,26
060371395022,436,271,165,443,277,166,703,444,258,496,308,166
060371396003,396,269,127,400,271,129,477,318,153,419,272,124
060371396002,657,458,199,664,461,203,898,607,276,690,459,194
060371396001,995,690,305,1004,690,314,1371,906,442,1111,771,297
060371397013,532,358,174,539,360,179,626,399,217,460,308,130
060371193102,335,280,55,339,275,64,465,347,107,457,368,65
060371193202,198,166,32,201,163,38,403,301,91,288,241,30
060371193203,278,236,42,283,233,50,379,283,87,265,223,28
060372048201,225,208,17,226,197,29,237,198,34,234,207,16
060372048202,280,259,21,279,242,37,420,355,51,296,260,20
060372049101,198,177,21,196,168,28,516,425,75,345,301,29
060372049102,259,231,28,259,222,37,458,383,68,443,386,37
060371046102,191,175,16,192,166,26,336,280,51,295,254,26
060371046201,228,209,19,229,198,31,346,289,52,313,266,28
060371048212,238,221,17,238,209,29,371,302,60,346,301,25
060372051201,492,463,29,493,446,47,790,661,104,543,499,21
060371232033,190,161,29,192,156,36,295,226,64,199,157,31
060372217101,369,332,37,368,321,47,496,407,75,439,394,22
060372217102,197,177,20,197,171,26,286,233,43,229,206,11
060371411021,405,322,83,411,324,87,550,428,113,450,337,94
060371246003,596,469,127,600,467,133,714,558,143,674,508,131
060372264201,189,172,17,184,164,20,364,300,57,289,259,13
060372264202,233,213,20,232,205,27,382,318,59,313,283,14
060372264203,327,299,28,329,290,39,460,380,70,351,320,15
060371434011,1128,940,188,1136,936,200,1475,1201,252,1127,926,158
060372247021,332,286,46,348,287,61,273,219,40,501,418,56
060371434013,712,597,115,724,595,129,984,786,179,802,640,123
060372270103,191,175,16,195,170,25,312,255,49,263,234,14
060372270102,182,168,14,189,164,25,299,243,48,258,227,14
060372270101,156,145,11,162,140,22,287,238,46,216,195,12
060372734042,329,290,39,337,290,47,419,348,58,424,349,54
060372734041,332,290,42,339,291,48,412,345,58,393,330,38
060372281001,216,202,14,214,193,21,295,249,40,223,206,9
060372281003,202,184,18,200,178,22,312,260,41,249,228,8
060372270201,230,214,16,229,207,22,413,340,54,335,304,14
060372270202,164,151,13,161,147,14,259,220,31,230,214,10
060372227001,365,316,49,376,312,64,584,487,82,835,702,74
060372311002,214,193,21,214,183,31,120,107,13,256,218,25
060371907022,356,313,43,361,313,48,391,330,53,364,299,38
060372218102,161,139,22,164,137,27,319,268,45,192,164,21
060372218201,130,112,18,130,108,22,129,97,29,138,117,15
060372218202,253,218,35,255,213,42,287,211,65,319,268,36
060372407003,327,299,28,334,307,27,495,428,55,388,357,13
060372407004,248,231,17,254,235,19,379,330,45,320,301,11
060372317201,438,386,52,440,379,61,469,388,70,586,527,32
060372411102,185,172,13,186,166,20,273,241,28,246,230,10
060372411202,262,244,18,259,235,24,388,337,42,324,303,12
060372284201,150,140,10,156,139,17,302,261,38,220,201,8
060372284202,147,137,10,149,133,16,287,250,32,236,215,8
060372285002,214,198,16,219,192,27,345,297,44,266,242,12
060372318001,130,117,13,132,116,16,235,205,29,195,176,12
060372318003,192,173,19,192,170,22,352,301,40,261,235,14
060372318004,160,144,16,161,142,19,265,229,30,236,213,13
060372375001,201,186,15,202,182,20,329,279,44,326,298,17
060372375002,211,195,16,214,194,20,345,296,47,262,241,14
060372377101,269,246,23,276,252,24,429,369,50,368,340,15
060372282201,134,128,6,135,124,11,251,216,32,178,168,6
060372282202,144,139,5,142,132,10,278,239,35,202,189,7
060372699062,747,674,73,756,679,77,782,690,76,760,658,57
060372699071,661,598,63,671,603,68,826,734,76,783,684,57
060372699052,530,473,57,539,476,63,624,535,74,548,470,49
060372287101,316,296,20,320,287,33,561,489,55,489,448,20
060372287201,172,161,11,172,156,16,238,217,19,209,196,8
060372287202,203,191,12,206,185,21,329,300,27,278,258,11
060372287102,193,178,15,199,176,23,330,276,46,236,213,13
060372287203,224,206,18,230,204,26,360,306,51,294,266,17
060372291001,322,294,28,324,290,34,622,520,83,501,458,21
060372288003,222,208,14,225,204,21,315,274,35,284,260,11
060372289001,276,256,20,282,248,34,415,368,43,414,375,22
060372291002,208,192,16,214,191,23,385,331,48,301,278,13
060372213031,217,194,23,216,189,27,421,348,64,263,231,19
060372213032,144,129,15,145,127,18,229,189,36,172,150,12
060372293002,186,170,16,186,160,26,310,261,39,260,232,13
060372293003,170,156,14,170,146,24,330,289,41,209,189,10
060372702001,362,329,33,364,331,33,489,420,56,414,362,31
060372702002,377,338,39,383,339,44,469,407,57,366,310,34
060372702003,466,419,47,472,421,51,735,636,88,596,504,55
060372328002,315,291,24,324,288,36,507,431,66,410,380,20
060372134011,292,252,40,292,248,44,430,329,91,344,294,32
060372134012,162,140,22,163,138,25,270,212,53,275,236,25
060372134022,191,165,26,190,161,29,224,164,53,180,152,17
060372327021,507,469,38,511,461,50,748,643,84,600,546,28
060372327022,181,169,12,188,169,19,307,268,35,210,193,10
060372327011,411,381,30,419,369,50,613,528,73,493,457,15
060372371021,257,237,20,260,227,33,433,379,51,289,270,11
060372371022,316,290,26,318,278,40,511,439,59,374,342,14
060372376001,157,144,13,161,140,21,265,223,32,211,191,8
060372392011,170,159,11,177,159,18,301,253,41,222,204,9
060372392012,176,165,11,183,165,18,311,257,41,221,202,10
060372392013,126,117,9,130,117,13,230,194,30,146,135,8
060372393102,173,161,12,175,157,18,293,252,35,235,216,9
060372393101,171,160,11,171,153,18,313,272,41,236,223,7
060372393103,168,156,12,168,150,18,244,206,35,216,200,7
060372312102,371,342,29,378,334,44,620,526,77,506,458,32
060372312202,241,218,23,247,213,34,390,326,51,299,269,22
060372393201,238,223,15,242,223,19,343,293,38,280,260,10
060372393202,256,240,16,261,240,21,419,359,49,311,291,11
060372393301,163,150,13,164,145,19,292,258,31,237,221,10
060372393302,211,195,16,214,189,25,381,338,40,330,305,14
060372395011,192,173,19,196,167,29,333,291,38,249,224,14
060372395012,150,142,8,155,140,15,260,227,27,224,206,8
060372395013,169,159,10,170,154,16,334,292,35,263,245,7
060372395022,161,149,12,159,142,17,309,261,41,209,192,9
060372395023,137,127,10,140,123,17,243,206,32,200,182,11
060372395021,178,160,18,179,153,26,293,253,33,222,203,11
060372398011,183,164,19,186,159,27,308,267,33,203,182,12
060371873001,930,847,83,937,847,90,1123,1013,94,886,787,60
060371873002,868,789,79,873,781,92,1033,941,76,953,862,56
060372397011,303,282,21,310,276,34,497,423,64,404,373,18
060372397012,239,215,24,242,212,30,443,379,59,352,330,16
060372397023,288,270,18,292,264,28,432,380,45,303,284,13
060372398012,173,160,13,176,155,21,294,247,43,224,202,12
060372398013,167,153,14,168,149,19,265,225,38,199,183,10
060371863023,612,536,76,618,529,89,778,659,110,669,562,79
060371864031,337,294,43,340,284,56,519,418,85,401,328,52
060371864032,502,438,64,507,429,78,672,545,111,551,456,67
060372398022,194,181,13,199,179,20,331,286,34,235,207,16
060372398023,208,196,12,209,194,15,348,307,38,288,261,13
060372398024,184,173,11,188,172,16,294,256,33,225,205,10
060372049202,224,203,21,225,200,25,275,232,40,347,306,19
060372060511,386,358,28,389,357,32,504,438,57,477,416,30
060372397021,183,168,15,184,164,20,248,214,26,188,176,6
060372397022,142,130,12,145,129,16,248,218,26,199,187,6
060372383102,335,311,24,344,302,42,564,482,68,415,372,22
060372383202,136,125,11,140,123,17,214,182,25,142,125,10
060372383203,114,106,8,114,102,12,250,215,28,159,142,10
060372195002,426,394,32,432,395,37,533,474,52,465,419,29
060372362031,676,627,49,691,633,58,955,865,71,912,830,50
060372362052,134,126,8,137,127,10,250,223,21,184,166,9
060372362051,499,465,34,503,463,40,717,639,58,576,528,25
060372362062,234,220,14,238,221,17,548,504,35,191,176,8
060372340012,444,415,29,452,420,32,491,451,38,494,458,21
060372342001,474,446,28,493,460,33,588,544,43,536,500,21
060371977002,248,214,34,248,209,39,346,276,63,258,202,38
060372313021,211,196,15,213,197,16,299,260,32,268,242,14
060372313022,229,211,18,233,214,19,331,290,31,265,241,11
060372313023,227,214,13,230,214,16,368,326,35,332,305,18
060372313011,536,491,45,550,496,54,768,661,87,635,581,29
060372315001,505,449,56,512,439,73,627,546,73,564,510,35
060372316011,298,264,34,303,260,43,488,422,57,399,357,26
060372342002,357,330,27,363,334,29,362,331,23,361,322,23
060372342003,539,502,37,549,507,42,509,460,45,564,504,35
060372340021,705,657,48,713,656,57,1044,926,92,860,786,46
060372340011,380,355,25,383,353,30,438,402,32,339,310,19
060372340013,402,377,25,412,380,32,436,404,22,440,405,18
060372340022,412,385,27,420,386,34,521,482,39,514,475,23
060372343021,691,646,45,702,649,53,860,800,43,802,740,33
060372343022,338,319,19,340,321,19,574,539,25,380,357,9
060372343012,472,444,28,473,444,29,581,539,37,534,499,19
060372314003,401,375,26,414,381,33,648,564,66,466,431,24
060372315002,481,446,35,488,444,44,630,559,67,595,547,28
060372315003,473,438,35,483,435,48,636,548,70,538,489,27
060372063031,230,180,50,238,191,47,270,197,62,329,267,43
060372343011,384,364,20,390,367,23,627,578,38,433,403,17
060371837013,364,329,35,366,321,45,531,448,68,391,331,29
060372043002,156,148,8,155,144,11,240,210,26,194,171,11
060372314001,441,410,31,441,405,36,646,567,61,512,462,26
060372195001,316,287,29,325,292,33,473,409,51,368,332,22
060372361011,546,496,50,565,507,58,820,722,93,595,544,39
060372361012,352,328,24,356,327,29,668,595,57,388,358,16
060372364003,651,608,43,661,618,43,1126,1051,53,745,686,34
060372119101,225,204,21,229,202,27,401,322,69,268,235,21
060372119103,275,249,26,279,247,32,384,308,66,267,235,21
060372119221,238,208,30,242,206,36,403,311,84,252,212,26
060372119222,286,251,35,290,248,42,527,415,101,371,311,39
060372362061,257,238,19,259,236,23,464,414,38,318,292,14
060372314002,337,316,21,344,316,28,584,509,60,415,388,14
060372362032,185,172,13,186,172,14,342,304,30,269,248,12
060372362042,280,262,18,289,269,20,386,342,34,404,379,13
060372361022,689,656,33,708,663,45,707,635,55,814,748,28
060372362041,416,394,22,426,394,32,570,508,47,656,608,25
060372351001,519,489,30,530,496,34,784,728,46,602,560,19
060372351002,562,527,35,565,527,38,731,671,44,635,584,26
060371313002,310,234,76,311,230,81,453,333,112,369,273,75
060372347003,432,396,36,438,394,44,690,633,47,555,510,23
060372347004,261,238,23,267,238,29,439,398,32,279,257,13
060372346003,416,386,30,409,373,36,475,435,32,430,393,21
060372346004,690,656,34,697,655,42,816,763,46,832,777,31
060372349022,380,341,39,390,348,42,600,530,58,481,447,21
060372349023,267,243,24,273,247,26,503,450,47,398,373,16
060371204003,429,344,85,440,346,94,676,478,189,550,422,102
060372351003,591,550,41,591,547,44,779,721,43,635,585,33
060372351004,588,557,31,592,556,36,691,649,39,591,549,28
060372345021,286,270,16,292,269,23,419,376,32,338,311,15
060372345022,239,225,14,243,225,18,325,291,26,268,242,12
060372345023,400,378,22,407,378,29,594,535,50,476,432,24
060372324021,313,285,28,314,284,30,864,769,77,317,286,20
060372324022,621,574,47,625,572,53,924,815,82,696,636,34
060372324013,262,247,15,268,246,22,447,401,46,368,343,17
060372345011,420,389,31,425,394,31,485,422,48,604,565,21
060372345012,608,572,36,622,578,44,609,537,63,654,588,42
060372091032,164,145,19,168,142,26,487,390,79,289,249,22
060372091031,106,94,12,107,91,16,255,200,48,223,193,17
060372092021,175,156,19,179,153,26,334,267,55,228,197,17
060372322003,238,223,15,237,221,16,462,393,57,295,273,9
060372324011,195,184,11,196,184,12,331,291,38,268,248,10
060372323002,277,247,30,282,250,32,509,442,63,339,314,14
060372323003,240,220,20,248,224,24,384,334,47,287,265,10
060372326011,436,394,42,444,393,51,708,601,90,543,506,19
060372361021,375,353,22,382,362,20,464,432,25,400,362,14
060372325001,356,323,33,362,320,42,586,495,73,475,443,17
060372372011,236,218,18,244,213,31,397,343,47,328,300,16
060372372012,291,267,24,302,262,40,429,370,52,379,342,21
060372372013,214,197,17,218,194,24,284,247,34,248,226,12
060372372021,266,238,28,272,238,34,378,322,51,338,305,18
060371924202,598,521,77,611,505,106,899,721,158,664,563,69
060372077121,639,553,86,653,550,103,1509,1210,269,635,520,78
060372374021,312,289,23,319,286,33,525,469,42,384,355,14
060372374022,285,266,19,288,261,27,441,393,44,370,343,12
060372374023,278,259,19,278,256,22,491,436,43,341,320,11
060372347002,242,225,17,244,222,22,369,333,31,318,295,12
060372373001,340,308,32,343,308,35,399,356,34,403,366,17
060372373004,439,405,34,444,404,40,500,456,44,482,443,20
060371864042,222,196,26,222,192,30,370,299,61,307,259,31
060371951001,742,678,64,751,681,70,790,692,82,824,723,68
060371951002,362,331,31,371,336,35,474,422,47,398,353,32
060371955004,423,387,36,428,387,41,521,459,53,484,436,30
060372352011,296,273,23,305,279,26,405,370,29,340,313,15
060372373003,445,409,36,447,402,45,591,526,50,539,502,20
060372760001,724,538,186,741,542,199,1384,1048,303,651,457,152
060372760002,609,453,156,618,452,166,735,548,171,685,493,158
060372761012,326,282,44,333,285,48,366,316,42,401,335,38
060372761021,906,784,122,917,787,130,1322,1147,138,1122,935,127
060372771001,502,360,142,507,360,147,566,407,149,528,374,122
060372771002,439,326,113,441,328,113,632,457,168,453,334,94
060372760004,649,485,164,659,481,178,795,592,187,679,496,155
060371816002,654,547,107,653,521,132,784,626,144,663,515,110
060371834022,557,458,99,556,439,117,593,483,98,577,445,99
060372360014,446,411,35,446,402,44,587,542,33,527,462,38
060372771003,510,405,105,514,411,103,688,517,154,491,380,83
060372772001,359,289,70,362,292,70,458,384,63,479,374,77
060372772002,303,253,50,309,255,54,423,355,58,399,322,56
060372352023,373,346,27,384,350,34,538,490,42,424,400,16
060372379001,309,282,27,311,287,24,416,381,33,385,362,14
060372379004,309,284,25,315,290,25,430,397,33,384,363,12
060372381003,380,350,30,389,348,41,453,422,30,414,377,25
060372384003,426,395,31,438,405,33,572,526,40,500,458,20
060372378003,254,231,23,257,232,25,354,317,32,333,305,17
060372378004,417,383,34,423,386,37,499,458,40,495,451,22
060371232061,515,431,84,519,419,100,922,705,192,701,568,94
060371242031,204,179,25,209,181,28,325,260,65,171,145,19
060371242032,356,311,45,361,312,49,694,544,130,448,372,49
060371243003,431,377,54,434,377,57,640,520,111,580,466,75
060371242041,391,346,45,394,334,60,592,486,95,426,338,55
060371242042,304,269,35,306,259,47,513,423,80,353,282,46
060372140001,317,182,135,319,179,140,460,324,133,312,167,133
060372140003,373,230,143,374,228,146,607,326,274,435,255,164
060372140004,334,206,128,335,203,132,609,328,276,446,264,166
060372144001,649,598,51,656,600,56,749,633,104,655,576,56
060372144002,569,529,40,572,527,45,655,553,89,555,494,36
060372144003,419,391,28,421,390,31,429,344,78,433,390,23
060371945001,431,360,71,434,361,73,626,492,123,471,381,71
060371945002,569,459,110,575,461,114,690,552,137,641,522,99
060372163021,821,724,97,826,722,104,996,838,140,830,707,85
060372163022,794,699,95,809,699,110,1072,881,174,864,732,94
060372145012,381,330,51,385,329,56,497,409,79,483,403,60
060372145011,197,172,25,200,172,28,240,199,39,198,166,23
060372145013,321,279,42,324,279,45,403,331,65,314,261,36
060372151011,655,582,73,662,580,82,939,828,99,797,682,78
060372145051,416,353,63,419,350,69,710,598,103,386,318,49
060372145042,419,357,62,423,356,67,762,639,111,442,365,56
060372145041,507,439,68,520,446,74,944,780,145,733,613,85
060372145031,314,270,44,322,271,51,576,477,88,338,278,46
060372145033,353,300,53,357,295,62,165,138,27,177,145,27
060372145032,255,215,40,257,213,44,704,584,113,363,296,53
060371320013,474,355,119,479,355,124,750,532,202,561,394,123
060371171013,237,193,44,239,190,49,445,317,120,324,256,51
060371172012,232,189,43,235,186,49,368,261,99,256,202,40
060371172013,194,158,36,193,154,39,448,318,121,310,244,49
060372146003,517,441,76,516,437,79,641,530,105,544,462,65
060372148001,608,523,85,613,530,83,710,555,146,645,556,63
060372148002,435,373,62,441,369,72,481,387,86,440,362,60
060372146001,414,358,56,416,351,65,564,466,91,399,333,54
060372146002,385,323,62,388,319,69,411,340,70,391,320,55
060372147001,440,374,66,443,369,74,685,557,116,501,417,59
060372147002,404,342,62,407,338,69,454,374,76,419,352,50
060372147003,467,397,70,471,393,78,520,425,89,450,374,56
060371194002,312,255,57,314,247,67,489,377,108,447,373,53
060372168001,490,419,71,485,411,74,592,479,100,516,426,69
060372168004,417,364,53,415,359,56,529,444,82,402,344,47
060372168002,438,392,46,446,393,53,668,576,79,554,481,52
060372168003,331,295,36,335,295,40,392,337,50,350,303,33
060372167001,564,512,52,574,521,53,858,757,82,715,638,55
060372167003,554,512,42,563,517,46,586,519,67,594,537,41
060372169013,421,389,32,426,393,33,578,522,46,477,431,31
060372167002,506,463,43,511,466,45,739,645,86,600,526,49
060371224201,345,293,52,350,289,61,486,376,103,450,377,52
060371224202,293,244,49,300,245,55,426,324,88,285,241,34
060371224203,240,200,40,245,200,45,442,349,86,413,348,48
060372183005,405,372,33,405,368,37,573,495,59,496,440,28
060372703001,403,376,27,408,368,40,551,480,58,441,390,24
060372697001,606,525,81,613,525,88,694,572,101,756,636,73
060372703002,653,570,83,657,559,98,727,630,88,680,603,47
060372182201,411,374,37,412,377,35,461,406,49,378,336,25
060372182202,731,669,62,733,664,69,886,772,97,825,732,54
060372182203,158,144,14,158,145,13,345,301,35,273,246,18
060371349062,266,221,45,272,219,53,527,406,110,552,419,96
060371349072,275,229,46,281,227,54,497,382,104,165,125,29
060371349071,300,250,50,307,248,59,440,340,92,335,254,59
060371236022,301,237,64,307,236,71,336,245,86,169,130,32
060371236023,377,296,81,385,296,89,493,363,118,197,151,35
060371174052,95,83,12,96,79,17,172,135,32,152,128,16
060371174051,132,115,17,133,109,24,337,262,63,208,177,21
060371175101,88,76,12,88,72,16,198,153,37,142,121,14
060371175103,65,57,8,67,55,12,171,134,32,102,86,11
060371203004,424,345,79,418,339,79,783,545,221,506,403,82
060372182101,188,175,13,191,170,21,306,269,35,223,198,13
060372182102,340,316,24,345,306,39,634,548,71,509,451,28
060372182103,232,215,17,237,210,27,334,289,38,256,226,15
060372183001,359,331,28,365,327,38,500,436,56,439,391,24
060372183002,339,314,25,348,319,29,275,247,26,361,318,20
060372183003,333,308,25,339,312,27,407,365,32,390,345,23
060372183004,358,326,32,357,326,31,502,450,44,433,388,27
060372186001,315,289,26,320,293,27,439,384,45,339,303,19
060372186002,265,248,17,266,246,20,341,304,30,339,312,14
060372186003,376,346,30,379,349,30,539,462,58,440,391,26
060372187012,528,496,32,533,492,41,579,521,50,577,533,21
060372360012,699,648,51,714,659,55,834,775,48,705,652,37
060372360013,433,405,28,441,412,29,556,518,34,553,511,27
060372360011,1044,966,78,1065,975,90,992,916,63,1092,994,60
060372184002,376,353,23,376,349,27,469,416,43,439,397,28
060372184003,260,244,16,259,240,19,345,305,33,277,253,18
060372185001,456,421,35,462,419,43,628,550,65,482,427,34
060372949001,282,235,47,285,224,61,527,414,97,407,333,51
060372949002,258,216,42,260,203,57,319,254,59,321,265,40
060372185002,467,423,44,475,425,50,687,613,63,553,486,38
060372199021,506,473,33,504,465,39,755,666,77,618,552,30
060372199022,299,279,20,302,277,25,363,319,39,245,218,13
060372199023,215,202,13,214,198,16,333,294,34,260,235,11
060372199011,295,277,18,297,274,23,562,492,56,440,393,25
060372199012,289,274,15,295,272,23,619,545,63,441,397,23
060372201001,325,295,30,323,292,31,421,366,47,327,291,25
060372396011,210,195,15,213,187,26,352,301,42,275,256,9
060372396012,257,237,20,262,231,31,444,377,58,378,356,12
060372199013,310,298,12,316,294,22,497,439,47,382,348,21
060372015013,186,168,18,187,162,25,396,316,68,245,213,21
060372015031,351,318,33,351,305,46,588,487,81,415,360,34
060372016011,672,593,79,683,568,115,946,766,166,753,634,74
060372184001,337,315,22,343,318,25,544,478,55,407,370,19
060372184004,250,234,16,256,237,19,408,360,41,312,284,15
060372690001,426,351,75,432,356,76,487,404,78,405,336,54
060372690003,349,294,55,358,298,60,445,364,71,359,300,42
060372690005,490,404,86,504,415,89,635,520,100,583,483,77
060372242002,227,205,22,227,195,32,290,240,44,214,182,18
060372243101,167,149,18,169,142,27,334,263,65,208,175,16
060372243102,125,110,15,126,106,20,221,174,42,172,146,13
060372243201,330,301,29,326,284,42,464,383,71,377,330,32
060372243202,184,163,21,182,155,27,293,230,56,221,186,17
060372712001,532,456,76,536,456,80,730,617,96,580,477,68
060372701012,607,539,68,615,540,75,745,656,74,665,582,48
060372699061,524,470,54,533,474,59,830,734,81,555,487,42
060372699081,391,350,41,400,352,48,525,441,72,400,341,33
060372699072,476,426,50,483,429,54,618,548,59,558,473,50
060372722021,436,380,56,444,386,58,623,538,78,468,399,47
060372722022,796,702,94,808,713,95,1025,890,116,876,734,90
060372738003,252,224,28,257,225,32,325,283,39,312,265,30
060372739021,508,439,69,515,441,74,625,531,82,572,486,66
060372739022,393,340,53,397,340,57,486,414,63,423,355,47
060372739023,312,270,42,319,268,51,383,324,50,330,275,36
060372741004,471,400,71,476,401,75,790,652,124,589,472,81
060372741002,476,408,68,482,409,73,589,498,78,456,370,58
060372754001,634,528,106,642,527,115,706,591,101,691,551,102
060372754002,704,595,109,717,595,122,832,697,119,787,644,98
060372754003,553,467,86,564,469,95,1230,1029,177,488,401,59
060372753111,467,392,75,462,387,75,561,464,90,528,423,73
060372753112,544,468,76,544,463,81,739,611,118,606,491,76
060371048232,217,189,28,222,182,40,370,299,64,286,246,28
060372752002,425,381,44,431,381,50,700,584,101,543,455,58
060372751011,480,378,102,496,384,112,676,533,133,549,404,119
060372756031,356,284,72,361,281,80,308,251,50,420,325,73
060372756033,374,297,77,376,291,85,293,239,48,382,296,67
060371310221,243,185,58,244,180,64,521,361,147,318,240,60
060371310222,402,307,95,403,298,105,708,490,200,454,338,87
060372781021,361,245,116,366,247,119,507,355,144,312,200,90
060372766012,509,363,146,519,362,157,674,483,180,523,370,116
060372766071,306,228,78,308,224,84,631,488,130,268,193,58
060372766072,561,417,144,559,409,150,351,274,72,371,264,80
060372766051,685,545,140,692,546,146,1033,818,190,812,607,152
060372766052,307,246,61,311,250,61,465,373,80,334,255,56
060372920021,242,171,71,246,169,77,351,232,115,246,166,61
060372920022,236,169,67,240,165,75,323,213,106,255,171,63
060372765003,563,415,148,577,425,152,702,522,169,355,257,76
060372765001,298,221,77,308,225,83,280,218,58,575,418,123
060372765002,260,234,26,266,233,33,271,213,55,430,351,49
060372770001,660,448,212,663,443,220,871,619,233,731,487,203
060372770003,721,494,227,732,500,232,853,650,183,770,525,195
060372770005,614,409,205,615,406,209,709,505,190,664,440,183
060372770004,402,279,123,411,285,126,466,354,99,391,271,99
060372770002,604,434,170,610,433,177,703,505,182,613,424,150
060372312201,396,354,42,404,345,59,732,612,106,526,468,37
060372312101,247,231,16,252,226,26,363,313,43,269,248,13
060372316031,166,154,12,173,154,19,385,331,46,264,246,12
060372316022,280,260,20,291,257,34,390,338,46,365,329,20
060372316032,249,228,21,255,227,28,480,407,58,356,322,17
060372316021,232,212,20,236,212,24,326,280,40,199,182,11
060372322001,245,220,25,246,215,31,264,232,32,346,318,15
060372322002,235,212,23,240,209,31,301,259,36,299,276,13
060372323001,413,378,35,418,379,39,643,549,80,528,483,21
060372326022,374,346,28,376,338,38,805,687,97,525,479,28
060372326021,392,362,30,394,352,42,645,556,77,566,512,30
060372371011,206,191,15,213,188,25,315,270,35,300,274,15
060372374012,292,270,22,297,266,31,473,413,49,398,370,15
060372374013,321,298,23,321,292,29,490,422,53,395,367,15
060372374011,259,245,14,265,243,22,355,313,42,332,312,11
060372378001,304,270,34,309,269,40,501,430,56,423,389,18
060372378002,354,317,37,359,312,47,476,426,49,409,381,23
060372377201,199,183,16,205,185,20,337,291,36,299,275,13
060372382001,528,483,45,538,486,52,531,478,49,572,530,26
060372382002,469,427,42,468,424,44,507,464,38,575,541,25
060372383201,220,195,25,227,193,34,378,330,35,290,258,17
060372403021,296,270,26,299,272,27,478,407,55,373,342,14
060372403011,149,136,13,150,137,13,281,243,32,244,226,9
060372404023,224,212,12,226,212,14,385,344,34,350,322,18
060372412011,296,276,20,297,275,22,488,431,40,375,344,20
060372382003,383,361,22,393,366,27,564,519,30,487,455,16
060372384001,425,393,32,433,392,41,534,495,39,479,443,22
060372384002,597,549,48,608,557,51,761,703,50,659,615,27
060372380002,379,351,28,380,353,27,532,497,33,482,452,20
060372380003,398,369,29,400,374,26,600,554,34,508,473,19
060372380001,276,259,17,277,263,14,409,379,25,357,332,13
060372380006,526,500,26,538,511,27,664,616,40,570,534,19
060372412012,245,226,19,247,223,24,367,332,33,307,283,15
060372412013,167,154,13,171,154,17,273,240,26,247,227,12
060372422021,254,228,26,266,235,31,415,357,41,402,378,14
060372405001,273,257,16,275,250,25,409,352,44,333,295,16
060372405002,237,223,14,241,224,17,396,353,39,302,280,11
060372405004,228,215,13,233,212,21,414,368,38,271,245,12
060372400201,361,326,35,366,316,50,553,486,55,454,414,20
060372400101,174,161,13,173,158,15,433,370,49,277,252,14
060372400203,227,212,15,231,208,23,401,348,49,277,259,14
060372400202,283,259,24,287,255,32,417,364,44,328,303,11
060372406001,192,178,14,195,180,15,322,272,41,239,222,9
060372406002,165,154,11,167,154,13,327,278,35,233,217,9
060372406003,220,206,14,224,206,18,363,314,39,312,288,13
060372406004,244,227,17,247,229,18,393,334,44,343,313,14
060372420003,123,111,12,122,106,16,265,225,32,163,147,10
060372423003,157,140,17,156,137,19,348,293,41,245,219,16
060372422011,244,228,16,249,226,23,440,377,51,372,346,14
060372420001,261,243,18,267,249,18,388,324,47,295,271,8
060372420002,278,253,25,282,251,31,453,387,52,424,386,20
060372430011,228,213,15,228,207,21,418,370,41,331,306,14
060372405003,227,215,12,231,217,14,431,385,42,294,279,9
060372408002,225,212,13,227,211,16,378,328,44,308,284,15
060372408003,214,201,13,211,196,15,422,368,47,317,290,13
060372409021,294,271,23,299,273,26,470,401,56,389,358,16
060372409022,242,223,19,246,223,23,368,317,43,313,292,12
060372412023,160,148,12,164,150,14,322,283,32,258,236,8
060372409012,227,209,18,227,207,20,360,307,44,323,294,15
060372409011,193,178,15,192,176,16,335,288,41,318,291,15
060372410013,353,322,31,357,319,38,431,375,46,389,356,16
060372410011,217,199,18,220,196,24,368,323,33,301,280,12
060372410021,255,231,24,258,236,22,534,457,60,345,314,18
060372410022,274,249,25,277,244,33,383,323,50,357,324,17
060372410023,258,235,23,264,235,29,382,325,45,334,305,15
060372912201,154,125,29,157,124,33,376,281,86,304,236,48
060372912202,345,283,62,357,282,75,423,315,98,315,248,52
060372912203,119,99,20,122,99,23,246,179,56,216,182,22
060372127022,375,310,65,383,317,66,822,641,167,476,385,63
060372943011,387,300,87,392,296,96,606,441,153,483,370,82
060372943012,287,219,68,290,217,73,393,284,99,379,294,69
060372945201,279,232,47,277,221,56,442,334,98,361,290,50
060372945202,276,230,46,278,222,56,546,416,123,468,379,65
060372943022,512,424,88,519,419,100,829,638,171,609,489,85
060372943021,312,260,52,316,251,65,551,433,102,451,360,59
060372941101,442,359,83,435,329,106,658,488,152,542,418,92
060372942001,275,223,52,277,219,58,443,336,99,352,281,56
060372942002,455,373,82,458,363,95,728,550,153,556,439,89
060372942003,351,286,65,354,280,74,569,425,126,489,383,76
060372946201,360,315,45,367,311,56,533,414,104,465,394,52
060372946202,250,218,32,257,217,40,368,286,73,311,264,35
060372946203,265,232,33,269,229,40,372,286,77,355,300,36
060371975002,410,383,27,413,377,36,637,571,53,544,485,30
060372966001,291,228,63,299,230,69,501,374,117,392,297,74
060372966002,292,218,74,296,218,78,484,342,133,375,271,81
060372966003,231,173,58,236,175,61,386,271,105,258,184,56
060372969011,394,315,79,401,311,90,624,449,158,511,373,103
060372969021,265,200,65,266,198,68,466,336,120,382,276,84
060372972011,563,399,164,576,387,189,841,570,242,750,510,191
060372972021,474,325,149,483,327,156,710,455,238,551,363,154
060372972022,453,305,148,464,306,158,696,448,235,545,347,162
060372398021,183,175,8,188,173,15,320,283,36,244,231,7
060372969013,330,221,109,336,220,116,562,346,197,355,234,104
060372969023,410,276,134,420,273,147,656,415,220,486,317,141
060372970022,498,321,177,510,314,196,775,492,269,587,364,184
060372970023,433,260,173,447,260,187,451,285,165,536,304,194
060371114011,818,530,288,823,512,311,1247,804,421,909,578,275
060372974002,1186,626,560,1198,615,583,1480,812,633,1096,564,460
060372976011,396,259,137,407,256,151,566,367,190,440,270,144
060371286022,421,349,72,425,344,81,548,411,123,421,329,71
060372383101,182,167,15,184,167,17,613,542,57,286,265,6
060372017001,406,355,51,406,343,63,670,553,96,542,446,55
060372017002,502,439,63,511,432,79,639,530,91,632,517,70
060372017003,343,294,49,346,294,52,672,566,96,522,427,59
060371923001,560,469,91,565,471,94,652,531,113,565,467,75
060371923002,393,286,107,399,289,110,501,348,146,474,334,117
060372032002,398,365,33,394,352,42,555,471,76,436,383,29
060372032001,226,209,17,228,202,26,398,332,52,309,272,20
060371096012,332,225,107,336,220,116,549,374,162,389,271,100
060372964021,530,378,152,539,370,169,607,422,178,562,376,154
060372676002,266,215,51,272,218,54,394,316,71,332,257,58
060371952012,631,578,53,635,578,57,888,797,79,772,677,56
060371175102,238,197,41,237,183,54,281,218,55,316,263,40
060371175201,307,254,53,308,237,71,338,257,71,360,299,46
060371959021,486,453,33,488,451,37,493,456,33,551,493,28
060371959022,539,504,35,543,503,40,585,531,41,568,505,29
060371211021,220,122,98,227,124,103,454,247,196,312,171,121
060371211022,264,128,136,273,129,144,317,149,158,289,137,135
060371219001,435,377,58,439,365,74,585,449,120,553,456,65
060371230102,304,265,39,309,258,51,586,448,123,433,367,42
060372260011,298,269,29,299,259,40,461,403,54,422,368,26
060371066482,136,112,24,135,109,26,383,288,83,286,231,44
060371070201,203,167,36,203,163,40,350,261,76,274,219,38
060372739025,435,368,67,441,377,64,466,375,86,481,405,45
060371249021,486,415,71,487,408,79,838,522,303,564,446,83
060371249022,515,433,82,518,427,91,571,445,111,652,502,113
060371043103,325,293,32,331,275,56,507,415,71,450,390,38
060372718013,215,186,29,217,186,31,298,247,43,223,184,26
060371192023,603,528,75,609,515,94,901,698,179,823,702,82
060371094003,313,230,83,315,218,97,560,402,140,402,295,86
060371041052,404,361,43,406,347,59,624,506,104,434,368,39
060371041053,307,268,39,313,257,56,630,478,132,594,488,71
060371047011,185,167,18,182,160,22,261,213,44,228,195,20
060372911302,377,331,46,386,330,56,701,556,133,574,508,41
060372722011,565,485,80,565,478,87,762,631,112,575,458,78
060372722012,417,358,59,417,353,64,531,459,60,466,368,63
060372739024,419,362,57,425,357,68,550,467,72,456,386,51
060372316012,273,246,27,279,243,36,433,369,48,371,341,18
060372289002,152,141,11,154,139,15,268,238,30,241,219,13
060372123051,312,268,44,319,259,60,578,439,121,378,308,40
060372123061,166,143,23,169,138,31,304,229,66,180,148,19
060372123062,202,174,28,205,167,38,330,247,71,220,180,23
060372717022,343,300,43,357,308,49,570,457,101,346,280,40
060372672012,309,262,47,313,263,50,417,318,91,332,266,44
060372711003,401,328,73,407,324,83,526,424,94,480,372,80
060372766062,897,708,189,901,701,200,1475,1161,281,1125,841,221
060372653012,4,4,0,4,4,0,0,0,0,0,0,0
060372652041,324,270,54,329,268,61,440,347,85,414,342,50
060372653031,310,280,30,322,289,33,445,385,54,544,462,43
060371861001,436,361,75,440,352,88,597,470,115,474,359,87
060371861002,413,344,69,418,335,83,566,445,109,508,393,87
060371861004,362,292,70,364,284,80,503,397,98,335,252,66
060372140002,449,289,160,449,284,165,545,323,217,456,283,158
060372118022,303,256,47,306,256,50,523,393,120,300,249,35
060372118023,230,194,36,230,193,37,377,279,89,170,140,20
060372074001,280,235,45,283,233,50,684,472,201,453,380,51
060372075012,269,224,45,271,221,50,367,253,108,435,336,69
060372075011,417,348,69,422,344,78,486,335,142,558,431,89
060372736001,303,275,28,308,279,29,322,293,29,355,318,23
060371371041,789,547,242,799,546,253,992,642,338,898,620,236
060371371042,362,244,118,368,244,124,525,339,178,498,319,155
060371413031,686,551,135,695,549,146,986,748,220,736,564,127
060372733001,659,597,62,669,603,66,876,749,103,763,669,42
060372733002,263,242,21,268,240,28,354,320,31,364,331,16
060372324012,331,298,33,335,293,42,488,423,57,497,453,22
060372753131,966,747,219,965,742,223,1120,882,210,1087,830,214
060372049201,310,283,27,310,271,39,418,352,62,417,364,27
060372971101,422,357,65,432,344,88,651,487,145,569,432,90
060372971102,390,306,84,399,294,105,713,527,155,551,409,103
060372962102,249,202,47,253,198,55,369,266,91,350,278,53
060372965001,301,249,52,311,249,62,374,271,88,351,279,52
060372966004,364,287,77,373,289,84,516,390,113,435,331,79
060372653061,465,415,50,476,423,53,592,533,43,769,656,59
060371132341,372,238,134,383,233,150,402,281,110,410,251,137
060371132342,312,201,111,317,194,123,363,244,110,424,258,141
060371060102,591,416,175,603,409,194,903,596,292,776,543,197
060371066452,886,472,414,904,457,447,1157,617,521,1000,510,432
060371173021,400,256,144,400,246,154,671,416,241,491,306,156
060371173022,387,249,138,388,239,149,596,373,213,447,279,141
060371395042,350,253,97,358,251,107,623,406,205,452,304,122
060372941201,177,157,20,179,156,23,404,305,85,267,230,21
060372125021,274,233,41,273,229,44,638,470,155,332,279,37
060371913021,354,315,39,352,306,46,454,381,68,379,302,54
060372404022,299,274,25,303,275,28,495,435,51,409,382,16
060372260022,117,97,20,116,97,19,122,98,22,171,138,18
060372060512,479,445,34,480,443,37,523,448,62,461,398,30
060372944211,217,159,58,217,156,61,450,291,151,259,200,47
060372063021,178,141,37,182,138,44,142,109,31,276,214,43
060372073032,213,181,32,216,178,38,482,405,66,242,203,22
060372073031,360,307,53,365,303,62,574,461,102,437,370,40
060372240101,306,271,35,313,270,43,602,504,87,276,226,30
060372122021,277,253,24,289,253,36,449,353,88,337,282,33
060372122022,128,117,11,135,117,18,220,174,43,131,111,13
060372134013,137,126,11,144,126,18,280,220,55,199,166,20
060372162012,543,475,68,550,475,75,945,784,146,583,497,67
060372119211,320,269,51,324,266,58,738,569,154,497,403,63
060371230101,429,375,54,444,373,71,802,640,140,482,410,47
060371132122,604,369,235,614,359,255,946,550,369,722,398,275
060371193201,199,172,27,200,167,33,551,380,156,314,263,33
060371112052,242,164,78,249,168,81,308,201,98,298,200,87
060371112053,395,268,127,402,270,132,579,381,186,433,290,126
060371344231,801,466,335,814,444,370,1123,706,401,926,526,357
060372678001,367,300,67,371,299,72,459,371,81,424,340,57
060371064071,256,212,44,257,204,53,365,279,75,398,325,49
060371064072,139,114,25,139,110,29,548,415,120,190,156,22
060371064081,427,357,70,431,346,85,551,422,114,506,419,60
060371064082,70,58,12,71,56,15,350,265,77,129,106,15
060371899072,542,487,55,547,486,61,622,498,116,568,477,64
060372933042,349,264,85,349,260,89,552,399,141,427,322,82
060372933071,292,221,71,295,219,76,569,364,189,333,252,62
060372933072,161,123,38,163,122,41,399,267,121,234,176,44
060372962101,220,175,45,223,172,51,325,239,78,244,198,37
060371891011,524,483,41,529,482,47,657,578,65,580,488,53
060371891013,401,370,31,406,370,36,456,407,42,431,370,31
060371371032,351,271,80,352,270,82,665,472,181,407,298,87
060371371033,404,313,91,409,313,96,570,405,155,319,233,68
060372111243,267,222,45,271,219,52,439,339,88,311,260,37
060372087101,448,378,70,450,372,78,637,507,116,473,383,67
060372087102,325,274,51,326,270,56,479,381,88,359,290,51
060372088011,306,263,43,308,253,55,585,455,116,226,187,25
060372088012,185,159,26,185,152,33,300,234,58,132,110,15
060372089031,171,147,24,172,141,31,296,214,73,298,246,33
060372089032,124,107,17,124,102,22,349,274,67,182,151,21
060372932062,266,220,46,271,221,50,513,392,110,333,274,41
060372932052,198,164,34,203,166,37,435,331,93,289,236,37
060372932051,227,188,39,232,190,42,544,415,115,267,218,34
060371273001,500,398,102,508,400,108,646,461,169,662,491,135
060371892011,697,640,57,705,645,60,974,800,154,822,687,91
060371892012,680,626,54,686,625,61,802,669,116,706,607,69
060371891012,384,356,28,390,356,34,528,462,61,471,396,53
060371251013,520,444,76,528,444,84,572,447,112,633,494,95
060371251012,441,377,64,449,378,71,586,452,125,435,340,65
060371252002,561,473,88,570,470,100,721,584,122,619,501,91
060371251021,678,562,116,681,564,117,887,718,153,723,567,115
060371251022,382,315,67,383,317,66,448,372,75,404,319,64
060371240002,570,462,108,576,456,120,703,569,122,598,461,110
060371254021,722,627,95,734,628,106,953,785,148,804,634,118
060371254022,378,328,50,383,328,55,507,391,110,433,334,72
060371254023,771,672,99,783,672,111,1035,884,124,890,723,104
060371254031,413,366,47,417,363,54,553,460,75,549,442,67
060371254032,483,429,54,488,425,63,658,555,85,599,488,66
060371432003,605,497,108,614,499,115,749,604,131,683,543,103
060371285003,270,222,48,274,221,53,371,284,79,265,204,46
060371286011,480,394,86,479,388,91,667,513,142,535,412,95
060371284001,422,339,83,430,330,100,485,376,99,428,328,79
060371284002,410,330,80,418,322,96,505,399,97,439,334,80
060371282101,443,388,55,443,378,65,644,520,111,516,435,58
060371282102,267,235,32,270,230,40,486,392,83,414,347,46
060371283022,244,217,27,252,216,36,549,428,109,311,256,40
060371283031,118,105,13,121,103,18,263,199,58,167,137,22
060371283032,250,224,26,256,221,35,682,531,138,368,305,46
060371434021,669,557,112,676,556,120,782,632,139,772,627,111
060371411011,732,598,134,748,601,147,1095,872,202,769,593,146
060372348004,339,309,30,343,316,27,360,326,32,377,346,21
060372349011,258,238,20,263,237,26,483,429,46,347,318,17
060372349021,219,197,22,216,194,22,466,409,45,301,273,14
060372913001,312,199,113,319,201,118,458,287,155,373,233,119
060372913003,279,178,101,282,178,104,404,257,138,392,253,121
060372723021,752,640,112,761,641,120,1095,899,167,874,699,118
060372723022,657,560,97,666,562,104,981,790,163,762,610,102
060372723013,402,344,58,406,346,60,526,424,88,387,315,50
060372128001,454,381,73,465,381,84,660,531,117,546,450,60
060372151023,566,516,50,579,519,60,445,375,66,649,554,65
060372151022,347,317,30,355,318,37,305,254,46,377,321,37
060372151012,401,362,39,406,360,46,516,454,55,441,377,40
060372151021,558,518,40,564,515,49,707,596,101,653,565,51
060372169011,537,502,35,540,502,38,557,512,44,516,475,29
060372169022,781,736,45,788,739,49,761,681,66,820,739,48
060372169021,402,368,34,401,367,34,473,427,41,444,405,24
060372171022,352,323,29,356,325,31,443,400,35,366,327,23
060372171023,437,402,35,445,406,39,521,472,39,436,388,29
060372171012,406,373,33,409,373,36,720,650,55,488,449,22
060372171011,403,376,27,408,376,32,534,486,40,477,438,24
060372169012,467,439,28,474,440,34,497,454,39,511,460,31
060372171021,557,513,44,569,516,53,809,736,59,596,524,45
060372172001,348,313,35,352,316,36,514,452,54,428,372,36
060372172002,254,234,20,261,236,25,416,376,33,276,247,18
060372172003,425,393,32,432,395,37,575,521,46,478,425,30
060372141001,426,328,98,428,326,102,530,268,261,502,382,104
060372132021,239,211,28,242,195,47,416,309,97,286,241,27
060372132022,324,283,41,325,264,61,570,418,134,366,312,35
060372214021,424,380,44,428,367,61,589,476,99,494,429,39
060372214022,305,274,31,310,265,45,413,334,70,336,293,27
060372699091,232,207,25,234,206,28,338,284,46,273,234,21
060372699082,351,313,38,354,312,42,538,450,80,393,335,31
060372377202,186,170,16,191,165,26,343,290,44,296,268,15
060371397012,725,485,240,732,486,246,885,576,297,769,541,200
060371397015,301,202,99,304,202,102,391,257,127,343,225,97
060371244002,467,327,140,478,328,150,729,425,290,556,350,168
060371973002,401,374,27,402,372,30,430,382,40,402,351,29
060371973003,645,600,45,646,593,53,828,738,75,750,654,53
060371412013,334,277,57,340,276,64,515,408,98,422,329,70
060371211011,261,210,51,267,210,57,371,274,92,346,264,67
060371211023,250,200,50,256,201,55,402,290,100,349,266,68
060371021071,827,439,388,838,404,434,1288,610,657,1003,464,477
060371222001,410,337,73,418,328,90,719,538,167,602,474,93
060371021051,263,199,64,267,195,72,367,262,101,302,215,66
060371021052,227,172,55,232,168,64,385,273,104,272,196,59
060371043212,146,135,11,145,129,16,215,179,34,188,168,12
060371047012,253,235,18,256,224,32,489,395,75,299,263,18
060371047013,100,92,8,101,88,13,202,159,32,138,122,9
060371021041,790,502,288,798,495,303,1276,661,595,1013,632,323
060371041051,364,315,49,370,300,70,580,437,125,379,310,47
060372093001,304,260,44,305,247,58,457,339,99,344,293,29
060372093002,143,123,20,144,117,27,240,181,53,185,157,15
060372100101,149,127,22,148,120,28,223,167,48,166,142,15
060372674051,483,413,70,491,413,78,483,388,83,487,404,53
060372674033,392,337,55,396,335,61,493,408,75,477,392,58
060372674032,422,363,59,427,361,66,483,399,73,504,418,60
060372675031,689,580,109,696,582,114,1000,822,156,792,650,101
060372643061,935,749,186,946,751,195,1302,1016,263,1065,834,180
060372643051,539,408,131,547,414,133,699,532,152,546,437,78
060372672011,385,326,59,392,328,64,489,371,109,410,329,55
060372627061,945,692,253,964,705,259,1070,811,240,926,704,180
060372627063,379,282,97,386,287,99,487,369,110,377,288,71
060372627062,655,417,238,674,426,248,749,557,187,821,538,226
060372626043,699,468,231,703,456,247,958,709,234,777,545,196
060372626012,1441,933,508,1465,944,521,1775,1208,533,1505,1011,411
060372626042,735,519,216,742,526,216,948,698,231,897,654,193
060372626041,373,269,104,375,269,106,563,418,137,623,458,132
060372626045,1069,745,324,1081,758,323,1401,1021,358,1011,716,256
060372626044,427,305,122,427,302,125,505,390,104,367,267,85
060372626011,533,335,198,540,339,201,692,467,211,568,370,166
060372628022,414,332,82,416,333,83,644,493,141,583,466,87
060372628023,824,597,227,836,606,230,935,709,212,716,533,150
060372738001,763,663,100,776,672,104,841,714,109,846,723,81
060372738002,428,380,48,435,382,53,526,453,62,470,407,43
060371065103,380,272,108,382,269,113,823,557,246,546,402,120
060371064031,312,259,53,310,242,68,496,370,116,412,325,64
060371064032,254,211,43,258,202,56,392,297,91,367,293,51
060371064033,303,255,48,307,248,59,266,203,56,398,322,53
060371095003,303,254,49,306,243,63,473,347,114,442,331,79
060371066031,668,420,248,678,418,260,896,547,330,750,451,258
060371066032,633,383,250,644,379,265,887,509,362,726,457,238
060371066432,394,206,188,397,202,195,537,291,237,378,207,147
060371066433,351,200,151,357,194,163,541,301,235,374,213,141
060371066411,970,595,375,980,576,404,1318,739,551,1120,666,401
060371066423,407,247,160,410,237,173,698,385,305,505,299,183
060371081031,775,452,323,789,453,336,1069,611,437,903,528,334
060371081032,677,382,295,688,379,309,873,482,370,682,397,250
060371081041,816,466,350,826,465,361,1102,655,426,893,510,343
060371081011,923,532,391,937,524,413,1346,714,596,1055,597,399
060371081022,353,185,168,365,188,177,517,289,224,327,173,136
060371081023,730,383,347,749,388,361,978,538,418,657,352,267
060371112013,353,213,140,354,203,151,465,280,183,341,193,125
060371113031,562,387,175,564,373,191,821,504,297,658,437,193
060371113032,930,593,337,942,570,372,1307,803,474,1106,676,354
060371151013,621,372,249,633,370,263,776,505,264,716,411,263
060371173024,555,360,195,560,350,210,827,544,259,686,440,206
060371151012,1059,650,409,1079,647,432,1292,814,450,1134,679,397
060371173023,578,342,236,587,337,250,664,421,229,589,346,218
060371132372,434,283,151,442,275,167,648,400,236,429,237,169
060371113021,557,351,206,574,355,219,761,477,272,648,403,220
060371134241,688,496,192,697,487,210,1187,820,347,736,530,164
060371134242,378,255,123,381,247,134,468,323,137,418,296,99
060371134231,352,243,109,358,240,118,496,318,167,387,250,110
060371134232,438,304,134,445,300,145,727,470,241,531,344,152
060371862031,891,764,127,892,759,133,1083,916,149,1001,819,128
060371862021,316,261,55,317,254,63,412,344,65,294,232,50
060371815001,555,444,111,568,439,129,652,513,132,606,449,115
060372766061,726,537,189,742,546,196,964,773,167,655,504,117
060372951032,669,408,261,682,406,276,692,440,234,700,442,230
060372964012,435,255,180,442,245,197,586,345,234,328,178,134
060372933011,1057,605,452,1082,600,482,1714,1012,670,1414,823,529
060372933041,600,455,145,607,453,154,808,585,207,757,555,162
060372933061,362,217,145,361,205,156,386,252,130,455,263,164
060372933062,432,261,171,436,247,189,658,423,220,532,306,193
060372969022,307,212,95,315,206,109,532,348,165,373,240,108
060372970021,482,303,179,492,296,196,705,445,240,577,359,176
060372969012,252,209,43,259,206,53,414,282,117,287,210,54
060372971201,289,226,63,296,219,77,546,408,120,395,292,77
060372974001,366,189,177,380,197,183,527,301,208,422,222,176
060371153023,383,285,98,385,278,107,362,267,88,435,313,97
060371153022,202,154,48,205,150,55,445,323,108,347,268,59
060371153021,187,142,45,189,139,50,410,299,100,315,244,55
060371132391,160,108,52,163,107,56,248,161,82,143,94,42
060371132392,303,205,98,305,200,105,613,394,203,419,274,121
060371132312,586,353,233,598,340,258,797,492,291,697,391,261
060379800231,3,2,1,4,2,2,13,8,5,3,2,1
060371317011,712,551,161,717,526,191,1145,795,326,822,633,158
060371317012,510,390,120,520,382,138,943,657,267,650,487,132
060371316004,346,255,91,350,247,103,494,328,162,419,304,91
060371341011,498,326,172,508,328,180,890,580,291,723,482,209
060371341012,819,553,266,831,547,284,1206,779,399,932,616,270
060371341032,587,384,203,606,379,227,868,570,283,736,463,236
060371343031,294,205,89,301,205,96,526,351,163,374,260,88
060371343032,357,249,108,359,247,112,583,384,177,483,329,120
060371345222,196,159,37,199,153,46,445,312,121,303,236,45
060371345221,242,197,45,247,191,56,352,254,92,288,222,45
060371345223,233,189,44,235,181,54,329,242,86,291,225,45
060371330001,427,333,94,433,331,102,660,466,181,557,416,114
060371330002,465,363,102,473,361,112,670,476,181,669,501,137
060371330003,368,287,81,373,283,90,628,455,164,453,343,83
060371348021,460,358,102,466,351,115,708,505,188,540,396,100
060371348022,505,393,112,510,385,125,768,535,216,647,475,121
060371348011,538,404,134,547,397,150,810,572,217,705,513,152
060371348012,391,289,102,398,286,112,541,377,156,477,343,104
060371344232,786,467,319,800,473,327,1055,634,401,922,522,351
060371344221,592,371,221,598,358,240,1007,657,331,772,469,261
060371344222,1378,863,515,1417,869,548,1942,1278,638,1530,944,509
060371344212,532,325,207,548,329,219,629,416,208,637,397,214
060371344211,626,397,229,641,399,242,778,488,273,633,400,203
060371345203,330,265,65,333,253,80,577,416,144,472,354,85
060371345202,227,182,45,227,173,54,270,196,67,231,173,42
060371351111,324,230,94,326,226,100,332,224,104,370,253,90
060371351112,444,315,129,446,307,139,452,299,137,507,329,150
060371351113,298,210,88,304,208,96,376,250,114,319,212,93
060371352021,509,320,189,518,317,201,692,446,236,525,327,169
060371352022,573,357,216,584,355,229,831,529,285,675,420,218
060371352023,749,475,274,758,465,293,1085,689,380,824,517,264
060371352011,649,456,193,662,448,214,1029,678,324,881,575,255
060371351151,401,280,121,411,277,134,881,600,260,462,314,129
060371352041,939,576,363,960,566,394,1409,901,483,1149,706,390
060371352042,380,247,133,384,244,140,562,375,182,442,271,148
060371352043,600,382,218,613,369,244,893,581,299,775,491,248
060371373011,1088,683,405,1106,672,434,1388,860,504,1245,772,412
060371373021,827,572,255,829,566,263,1052,698,339,938,623,277
060371352012,330,198,132,335,197,138,490,296,183,388,229,138
060371372023,330,236,94,337,234,103,415,282,124,335,220,95
060371372021,220,159,61,223,159,64,229,155,68,387,265,99
060371372032,624,424,200,634,416,218,785,505,267,667,421,205
060371372022,409,297,112,416,298,118,851,577,254,381,262,97
060371374012,666,479,187,671,473,198,935,644,275,811,559,213
060371397014,542,374,168,551,375,176,754,518,225,715,496,192
060371397052,549,380,169,565,387,178,703,475,217,562,409,131
060372062011,204,171,33,207,172,35,176,144,25,279,238,31
060372062012,421,367,54,426,358,68,720,596,113,232,196,25
060372062021,641,552,89,652,544,108,848,695,133,496,420,55
060371435001,608,507,101,615,508,107,738,607,123,670,528,103
060371435002,648,539,109,657,540,117,828,693,118,655,522,102
060372348002,267,246,21,273,244,29,432,376,44,284,260,14
060372349012,347,323,24,348,324,24,610,547,53,456,425,18
060372128002,360,324,36,364,321,43,485,400,76,436,364,45
060372128003,395,351,44,399,352,47,653,539,101,497,417,49
060372162021,719,668,51,727,664,63,943,843,85,769,699,37
060372162022,626,565,61,625,561,64,823,718,91,719,626,57
060372172004,417,391,26,423,393,30,462,418,39,453,408,24
060371034023,264,160,104,273,158,115,363,210,143,359,200,138
060371034024,385,233,152,393,226,167,516,286,220,424,242,157
060371034011,824,489,335,837,476,361,1170,632,497,921,511,354
060371021072,427,205,222,439,197,242,559,269,285,413,179,213
060379800201,4,2,2,4,1,3,0,0,0,0,0,0
060371211012,276,222,54,282,214,68,501,371,118,382,280,77
060372201003,363,330,33,360,327,33,494,426,56,402,358,31
060371923003,526,458,68,530,458,72,617,519,88,546,464,61
060372674031,308,255,53,320,259,61,404,326,68,350,273,52
060372674042,557,465,92,576,468,108,1075,857,199,665,526,95
060372677002,760,651,109,770,652,118,1020,870,135,803,664,93
060372242001,191,175,16,191,166,25,305,249,46,233,201,21
060371061121,620,462,158,632,447,185,948,675,257,794,585,163
060371064053,249,203,46,253,199,54,458,344,103,375,302,56
060371112061,386,231,155,398,234,164,590,364,223,432,251,154
060371112062,429,255,174,435,257,178,585,349,222,439,254,154
060371112022,611,391,220,622,395,227,915,542,359,693,418,232
060371113041,356,281,75,356,272,84,564,416,137,479,339,104
060371113042,306,242,64,305,234,71,492,363,119,419,297,91
060371152032,201,149,52,204,145,59,219,154,57,288,201,65
060371152031,588,436,152,600,425,175,500,354,130,1190,924,174
060371112063,407,247,160,414,252,162,538,334,195,470,280,167
060371112064,378,227,151,385,229,156,557,330,217,459,269,170
060371112065,431,258,173,441,256,185,596,361,224,566,327,215
060371153012,285,189,96,284,184,100,577,386,174,377,241,116
060371153014,293,194,99,289,187,102,440,300,132,339,218,105
060371152021,581,423,158,592,409,183,745,499,223,701,473,175
060371152022,669,496,173,681,485,196,925,627,274,716,509,165
060371152023,450,351,99,457,345,112,824,572,234,546,406,111
060371154011,329,228,101,334,221,113,630,413,204,471,311,137
060371154014,396,275,121,398,264,134,543,339,197,384,252,112
060371134251,209,174,35,210,168,42,415,301,101,291,227,45
060371134252,380,316,64,380,304,76,778,566,191,473,370,73
060371316002,399,306,93,403,292,111,580,384,192,497,367,101
060371316003,314,240,74,321,233,88,435,295,135,381,284,75
060371316001,513,368,145,521,351,170,903,595,275,651,428,187
060371349043,472,345,127,477,342,135,553,399,147,564,395,133
060371344213,741,473,268,759,469,290,932,586,328,836,525,271
060371352052,433,257,176,442,260,182,616,393,206,491,282,190
060371372031,306,221,85,311,218,93,487,320,162,366,241,104
060371398012,1041,687,354,1063,691,372,1370,783,574,1132,739,349
060371398011,601,356,245,607,359,248,848,494,336,676,440,216
060371041032,594,510,84,589,476,113,801,624,153,746,626,83
060372948202,140,122,18,142,115,27,268,198,60,229,192,23
060670070261,717,507,210,727,494,233,1482,1035,423,272,189,74
060670070163,828,584,244,845,582,263,1367,963,362,963,676,223
060670070171,480,298,182,491,295,196,557,340,203,470,287,156
060670070263,451,322,129,453,310,143,788,576,195,214,136,68
060670070202,500,340,160,504,341,163,605,425,166,488,329,127
060670070203,783,523,260,797,529,268,970,683,263,760,505,202
060670071011,109,41,68,110,38,72,122,46,72,108,41,58
060670071072,256,173,83,257,167,90,393,287,98,266,170,77
060670071064,520,366,154,524,363,161,757,491,243,541,351,163
060670071081,955,706,249,980,702,278,1596,1115,446,1113,799,260
060670071091,1059,662,397,1072,658,414,1143,751,379,887,542,316
060670071111,777,561,216,786,556,230,1405,994,379,903,642,194
060670071092,1141,710,431,1157,709,448,1293,886,393,982,627,318
060670071082,522,407,115,528,403,125,1210,923,268,392,299,73
060670071101,817,597,220,831,585,246,1175,843,298,819,577,188
060670071052,839,617,222,851,598,253,1484,1067,387,1157,836,254
060670071061,415,307,108,416,300,116,679,493,169,527,378,117
060670071062,1090,779,311,1100,774,326,1514,1067,398,1154,828,262
060670071051,812,586,226,823,571,252,1169,827,318,947,671,217
060670071053,465,331,134,472,325,147,785,533,232,601,424,133
060670072061,608,210,398,622,205,417,794,256,517,625,199,383
060670072062,830,284,546,844,273,571,1235,402,800,978,340,560
060670072071,528,169,359,533,164,369,675,225,434,549,168,345
060670072021,398,166,232,402,151,251,629,237,385,480,187,263
060670072022,395,174,221,404,157,247,568,225,330,438,172,236
060670072072,436,169,267,445,160,285,666,231,421,508,182,288
060670072081,246,100,146,252,94,158,329,125,195,255,98,145
060670072082,654,266,388,656,243,413,1020,388,607,784,294,444
060670072091,474,194,280,483,183,300,722,274,429,552,216,310
060670072073,397,151,246,404,145,259,732,244,465,543,185,314
060670072092,588,223,365,596,211,385,871,347,510,701,260,405
060670072083,470,192,278,473,174,299,677,258,399,559,206,320
060670072023,317,119,198,323,114,209,520,179,336,366,138,204
060670071073,398,277,121,407,274,133,688,491,177,461,315,115
060670071071,782,544,238,796,537,259,1015,707,279,834,563,213
060670070262,433,311,122,440,305,135,690,507,166,456,304,132
060670070252,537,395,142,543,395,148,939,682,231,571,419,131
060670070251,541,398,143,547,398,149,798,585,196,532,375,122
060670070161,564,410,154,577,410,167,710,511,186,594,405,151
060670070162,408,302,106,415,302,113,735,518,189,567,399,131
060670070282,358,281,77,360,271,89,657,501,141,446,335,90
060670070283,390,299,91,394,296,98,1062,809,233,192,145,39
060670070172,573,437,136,587,436,151,845,607,221,577,437,107
060670071031,827,638,189,827,617,210,1167,886,252,872,640,184
060670071032,349,264,85,353,255,98,658,478,163,509,374,108
060670071112,611,431,180,619,429,190,749,546,187,655,457,160
060670071102,756,533,223,765,532,233,882,628,238,824,574,204
060670071063,622,457,165,631,438,193,942,666,238,708,508,163
060670067033,362,258,104,362,252,110,614,453,147,524,389,111
060670067031,264,183,81,268,183,85,540,391,138,361,244,91
060670067032,322,229,93,323,225,98,481,355,114,349,260,72
060670070011,385,301,84,392,292,100,618,429,174,469,349,90
060670072043,504,343,161,510,341,169,789,541,228,584,389,159
060670072042,310,167,143,315,160,155,448,235,201,366,201,144
060670070272,203,165,38,205,161,44,466,363,91,283,221,43
060670070271,180,146,34,183,144,39,271,210,53,140,110,21
060670070192,274,220,54,273,217,56,696,549,138,90,71,13
060670070191,143,116,27,144,113,31,264,206,51,176,137,27
060670070281,475,371,104,474,358,116,689,517,159,577,431,117
060670070212,419,329,90,424,320,104,735,550,164,491,370,92
060670070071,642,530,112,646,506,140,1033,784,231,747,552,152
060670070073,515,415,100,520,399,121,725,541,164,637,487,117
060670070131,450,351,99,452,340,112,517,391,118,467,354,88
060670070234,475,348,127,479,338,141,492,356,132,476,355,96
060670072041,552,295,257,551,279,272,695,371,315,552,305,218
060670067043,283,202,81,285,198,87,346,250,92,376,258,95
060670065022,175,115,60,174,110,64,285,179,101,192,138,47
060670065011,292,226,66,295,220,75,447,317,114,317,263,38
060670065013,302,246,56,305,236,69,545,408,129,363,304,44
060670065021,289,220,69,289,207,82,502,343,146,297,208,73
060670067041,158,120,38,157,113,44,381,274,99,256,181,63
060670067042,163,124,39,163,117,46,317,227,84,244,172,57
060670064001,265,162,103,269,155,114,390,222,160,301,153,120
060670064002,219,128,91,223,124,99,369,193,162,312,158,124
060670073013,116,79,37,119,85,34,179,135,36,121,69,33
060670064005,196,150,46,198,145,53,337,239,92,241,169,62
060670064004,196,153,43,196,146,50,309,233,75,221,153,55
060670066001,240,194,46,240,188,52,408,294,91,265,196,51
060670063001,301,205,96,301,193,108,488,316,153,353,228,104
060670063002,306,211,95,309,205,104,428,284,131,313,203,94
060670064003,193,132,61,196,126,70,306,201,97,201,128,46
060670070201,555,365,190,568,369,199,837,606,209,695,440,195
060670070101,343,253,90,347,248,99,588,424,147,389,272,87
060670070102,610,448,162,617,441,176,832,617,186,730,510,164
060670070103,270,199,71,271,194,77,411,303,94,308,214,69
060670070221,324,249,75,330,246,84,341,278,54,244,195,31
060670070222,337,267,70,345,265,80,690,562,109,423,343,53
060670070114,330,262,68,335,259,76,563,421,130,371,271,73
060670070111,273,216,57,275,212,63,527,408,106,228,165,44
060670070112,535,423,112,543,419,124,712,536,165,690,503,144
060670070121,682,530,152,691,522,169,868,663,180,795,606,138
060670070122,597,456,141,605,450,155,857,642,192,643,478,122
060670070113,324,256,68,328,251,77,411,321,77,430,313,83
060670070132,419,324,95,425,320,105,695,515,164,578,430,109
060670070233,379,287,92,379,281,98,448,338,100,412,305,79
060670070232,371,297,74,376,293,83,541,420,107,401,307,65
060670070116,122,101,21,123,101,22,266,225,34,182,144,24
060670070231,230,185,45,234,185,49,494,378,103,372,286,60
060670070241,636,507,129,643,502,141,952,766,169,586,456,92
060670070211,721,566,155,730,546,184,1387,1017,338,844,613,176
060670070012,196,154,42,196,146,50,285,196,80,204,148,45
060670070013,180,141,39,182,134,48,293,204,79,204,147,46
060670070072,180,141,39,181,134,47,525,376,134,272,195,61
060670067052,178,148,30,178,143,35,395,285,99,287,233,37
060670067051,101,83,18,103,82,21,162,116,40,108,89,13
060670067053,221,183,38,223,179,44,371,267,92,247,201,32
060670067054,280,229,51,286,223,63,390,295,83,265,215,33
060670068031,302,247,55,310,242,68,522,395,113,388,289,73
060670068032,178,143,35,180,138,42,268,209,59,163,128,31
060670065012,237,199,38,237,190,47,364,282,68,259,213,33
060670067061,237,201,36,241,190,51,437,346,84,352,289,47
060670067062,290,237,53,297,232,65,614,460,139,256,206,45
060670066002,232,186,46,233,182,51,382,287,89,262,198,48
060670066003,204,142,62,208,143,65,292,195,92,226,170,42
060670066004,181,127,54,183,125,58,275,182,83,222,155,47
060670066005,231,162,69,235,160,75,458,305,133,272,188,65
060670068011,258,188,70,264,187,77,471,315,129,326,243,56
060670063003,199,141,58,201,140,61,308,203,99,245,166,65
060670063004,169,118,51,170,117,53,262,177,76,178,124,44
060670068021,112,86,26,115,86,29,274,199,61,226,174,40
060670068022,156,119,37,156,118,38,314,231,68,277,191,59
060670069021,145,112,33,146,108,38,189,146,43,140,103,31
060670069022,319,235,84,323,232,91,463,341,114,261,184,59
060670055021,132,87,45,131,83,48,327,213,102,210,138,62
060670069023,235,171,64,239,169,70,402,288,103,200,141,41
060670069011,278,202,76,281,198,83,341,237,86,425,274,118
060670069012,398,288,110,403,282,121,319,229,82,477,305,133
060670062021,242,154,88,245,150,95,403,247,141,265,164,83
060670062022,347,230,117,351,230,121,555,366,176,484,307,145
060670055022,503,337,166,509,323,186,703,454,237,488,321,137
060670054021,382,265,117,385,261,124,728,544,166,588,373,166
060670054022,309,251,58,317,252,65,443,350,78,394,287,76
060670074171,325,169,156,325,162,163,465,210,243,359,132,197
060670074172,595,313,282,595,300,295,1137,538,572,630,299,288
060670074273,431,222,209,435,213,222,719,395,301,498,243,219
060670074303,591,288,303,599,281,318,957,479,454,742,355,335
060670074311,531,257,274,539,246,293,883,441,418,594,268,276
060670074312,615,297,318,623,285,338,956,454,480,690,315,322
060670074274,389,194,195,395,186,209,615,321,274,426,208,188
060670074272,605,318,287,610,308,302,854,471,361,726,357,315
060670074304,952,486,466,971,475,496,1373,698,645,961,480,420
060670074301,140,75,65,142,72,70,405,213,180,257,132,110
060670074302,479,256,223,489,247,242,858,446,395,659,338,281
060670074261,284,173,111,289,162,127,524,299,210,379,192,156
060670074262,243,147,96,247,139,108,442,230,199,298,149,128
060670074271,422,225,197,425,219,206,647,336,291,452,224,198
060670074391,585,293,292,595,283,312,854,440,405,712,345,316
060670074392,812,408,404,822,390,432,1345,646,667,873,431,385
060670074381,746,389,357,760,379,381,1417,684,711,770,405,323
060670074351,485,236,249,490,220,270,766,337,407,477,246,193
060670074342,528,290,238,538,280,258,887,454,410,609,330,237
060670074343,457,256,201,458,238,220,770,384,365,640,325,255
060670074341,284,157,127,288,150,138,514,266,233,311,172,122
060670074021,423,232,191,428,225,203,706,360,319,534,264,228
060670074031,485,293,192,488,286,202,711,390,296,542,297,200
060670073011,516,312,204,519,303,216,875,513,335,624,341,227
060670074023,309,179,130,308,172,136,450,240,199,364,190,145
060670074024,311,182,129,314,176,138,458,244,200,330,174,134
060670074022,501,268,233,507,259,248,848,443,370,615,322,238
060670074032,578,344,234,583,329,254,974,501,452,646,357,237
060670074142,452,228,224,451,218,233,692,343,324,535,260,236
060670074282,518,261,257,521,252,269,794,340,444,509,242,237
060670073012,209,124,85,212,120,92,353,198,137,272,144,102
060670074162,520,296,224,529,290,239,851,463,362,709,374,285
060670074233,537,351,186,543,339,204,695,440,231,495,304,155
060670074232,234,162,72,239,158,81,496,338,139,454,303,115
060670074231,9,6,3,9,6,3,269,183,75,113,77,29
060670074321,689,327,362,704,313,391,1073,498,548,764,350,351
060670074322,841,393,448,859,383,476,1309,611,669,943,435,437
060670074371,949,450,499,967,443,524,1392,641,709,1000,485,440
060670074372,525,247,278,536,244,292,843,396,422,624,271,306
060670074361,640,323,317,659,315,344,1028,477,529,859,398,404
060670074373,775,380,395,794,367,427,1288,584,684,1005,513,426
060670081271,623,299,324,632,280,352,954,406,529,689,310,320
060670081272,816,368,448,825,352,473,1315,561,716,996,411,508
060670081301,361,178,183,364,165,199,535,245,277,381,161,195
060670074281,503,279,224,505,263,242,734,386,337,460,229,199
060670074291,457,252,205,460,241,219,780,409,356,492,276,181
060670074141,530,284,246,533,280,253,772,431,324,682,337,295
060670074292,316,169,147,319,168,151,536,227,295,279,157,101
060670074293,317,169,148,317,167,150,601,324,263,447,250,164
060670074221,380,210,170,384,206,178,698,350,327,522,240,246
060670074222,207,114,93,209,113,96,372,185,174,317,161,132
060670081302,532,273,259,537,258,279,768,354,388,624,274,305
060670081303,345,170,175,350,161,189,466,228,228,352,166,159
060670081313,310,152,158,315,148,167,383,182,188,306,137,143
060670081311,301,141,160,305,134,171,478,225,240,335,150,163
060670081315,425,235,190,430,232,198,422,228,176,289,144,120
060670081312,37,20,17,38,20,18,323,174,135,167,84,71
060670081331,395,210,185,397,206,191,560,295,244,428,210,186
060670074161,589,312,277,597,304,293,895,458,408,726,367,307
060670074151,462,249,213,467,242,225,545,282,252,416,211,176
060670074152,629,355,274,637,344,293,879,479,379,660,350,263
060670075011,408,200,208,408,195,213,581,295,267,473,226,211
060670075012,295,145,150,300,144,156,507,255,233,335,155,149
060670075013,221,108,113,221,106,115,273,140,129,232,108,103
060670081281,393,174,219,399,172,227,576,247,311,424,166,232
060670081282,378,164,214,390,164,226,560,238,309,478,186,261
060670081131,776,361,415,790,347,443,1271,566,649,1013,396,537
060670081132,327,160,167,333,153,180,452,213,224,353,147,175
060670081431,750,324,426,759,310,449,1116,510,564,878,353,461
060670081432,581,242,339,591,228,363,751,331,394,572,195,337
060670081111,604,270,334,613,257,356,858,402,426,651,265,328
060670081112,743,312,431,753,296,457,1001,438,533,794,304,429
060670081113,578,251,327,582,237,345,840,367,446,707,280,374
060670081114,640,270,370,652,268,384,784,296,460,720,317,352
060670081291,589,296,293,605,293,312,739,376,342,606,269,290
060670081292,561,281,280,570,275,295,908,453,422,712,317,338
060670081321,837,360,477,847,353,494,1013,482,512,757,313,399
060670081322,815,354,461,830,348,482,1210,534,650,984,405,516
060670081314,772,371,401,785,359,426,994,484,490,797,351,402
060670081341,487,257,230,494,251,243,538,291,230,476,210,226
060670081342,696,366,330,702,355,347,1014,545,435,920,431,426
060670081351,297,144,153,302,142,160,382,203,166,315,144,147
060670081352,443,215,228,451,213,238,694,370,300,590,268,276
060670081353,461,229,232,468,217,251,518,258,246,432,190,209
060670081354,495,246,249,503,235,268,648,323,309,509,219,256
060670081361,285,139,146,287,133,154,487,235,237,419,190,201
060670081362,669,326,343,682,319,363,893,432,438,620,282,299
060670081191,521,242,279,525,238,287,896,452,418,618,255,312
060670074241,389,217,172,394,209,185,760,403,334,494,264,192
060670074242,355,198,157,360,191,169,470,248,206,339,180,130
060670074131,347,184,163,352,177,175,733,351,352,460,236,197
060670074132,450,241,209,452,227,225,808,404,380,582,307,240
060670074133,361,185,176,367,180,187,565,284,268,412,202,178
060670075041,345,177,168,352,173,179,415,206,196,362,165,170
060670075042,408,210,198,418,205,213,603,300,284,417,204,180
060670060033,218,131,87,220,127,93,223,135,81,204,118,72
060670060032,534,319,215,538,313,225,680,408,245,566,326,199
060670060031,634,393,241,636,379,257,941,544,367,775,446,270
060670060022,289,188,101,288,178,110,704,448,230,556,328,181
060670060041,327,213,114,330,206,124,410,260,134,323,190,106
060670060043,386,209,177,390,201,189,363,195,163,329,157,149
060670059012,791,408,383,797,391,406,889,499,371,635,353,233
060670060021,288,152,136,291,148,143,440,227,199,362,169,165
060670060042,519,275,244,525,266,259,441,256,174,417,223,163
060670055023,470,350,120,478,345,133,782,558,195,676,479,150
060670062023,141,105,36,142,103,39,170,128,37,162,110,42
060670061013,317,202,115,319,199,120,566,370,182,404,226,151
060670062031,230,147,83,230,143,87,309,205,95,303,178,101
060670062032,497,308,189,503,303,200,519,342,163,483,312,136
060670062042,393,238,155,395,234,161,645,398,226,567,344,180
060670062041,529,313,216,534,309,225,804,446,335,621,361,214
060670061011,527,316,211,536,308,228,782,503,257,477,280,158
060670061012,615,371,244,625,357,268,840,530,286,675,378,253
060670056011,376,233,143,379,228,151,398,265,124,418,246,143
060670056012,477,299,178,484,296,188,747,498,228,503,296,173
060670061021,370,232,138,377,228,149,485,314,155,376,219,130
060670061022,480,301,179,488,295,193,741,482,240,587,351,197
060670061023,354,222,132,358,216,142,430,284,139,321,194,109
060670075015,369,240,129,375,238,137,568,358,190,511,312,141
060670075014,373,209,164,376,207,169,732,383,329,489,264,190
060670075031,443,249,194,445,245,200,494,259,223,380,203,152
060670075032,323,192,131,324,184,140,523,316,191,433,230,167
060670081172,455,238,217,458,233,225,553,292,250,441,217,197
060670081332,352,182,170,356,181,175,584,306,260,457,223,205
060670075033,120,71,49,121,70,51,240,122,107,154,82,59
060670075034,375,226,149,380,218,162,447,229,204,354,187,137
060670076041,728,382,346,736,372,364,932,540,361,768,398,308
060670076042,699,378,321,707,365,342,1021,625,352,742,405,265
060670079031,350,179,171,355,172,183,436,212,207,353,153,168
060670079032,526,285,241,536,274,262,652,324,310,499,229,233
060670079033,281,146,135,282,139,143,383,190,186,296,132,142
060670079034,512,276,236,516,268,248,667,356,283,616,285,285
060670079035,480,244,236,485,238,247,630,318,294,504,231,236
060670076031,695,364,331,703,355,348,910,514,374,885,447,375
060670076032,582,308,274,591,303,288,815,436,350,540,292,210
060670076021,455,252,203,461,248,213,669,384,267,565,294,225
060670076022,497,277,220,505,274,231,616,362,237,552,281,228
060670059014,772,401,371,779,391,388,887,515,355,687,340,302
060670059011,710,369,341,715,360,355,849,519,316,903,480,353
060670059013,951,480,471,964,468,496,1157,617,501,1026,484,461
060670076023,626,346,280,629,334,295,732,414,300,632,315,272
060670076024,359,198,161,362,192,170,441,248,180,363,185,149
060670059042,433,238,195,439,234,205,599,337,249,479,250,192
060670059043,474,253,221,484,252,232,459,256,193,433,229,174
060670059044,863,475,388,875,474,401,1134,635,460,936,500,365
060670059031,451,265,186,459,261,198,772,467,275,689,367,262
060670059032,272,157,115,275,154,121,250,155,90,259,138,98
060670059041,427,238,189,433,231,202,540,305,223,417,215,167
060670081192,562,262,300,569,246,323,628,282,326,604,256,305
060670081193,386,184,202,390,173,217,421,202,209,351,148,177
060670081343,628,323,305,630,317,313,860,440,387,709,336,313
060670081194,485,237,248,490,231,259,649,315,315,501,205,248
060670081195,356,170,186,357,165,192,495,229,253,364,149,182
060670081372,402,184,218,405,181,224,503,256,234,446,195,221
060670081171,335,170,165,341,165,176,458,230,215,343,168,143
060670079041,664,325,339,672,315,357,936,455,442,673,284,333
060670079042,685,339,346,696,336,360,849,427,399,721,323,343
060670079043,600,296,304,611,293,318,743,376,346,597,276,279
060670079044,379,193,186,387,189,198,479,239,220,426,196,193
060670079051,952,477,475,965,476,489,1175,617,524,1104,547,484
060670079061,1268,649,619,1279,634,645,1517,816,664,1287,627,556
060670079062,502,268,234,506,259,247,641,350,274,569,273,254
060670079052,1104,542,562,1119,540,579,1431,757,636,1058,524,467
060670078011,587,310,277,594,306,288,975,514,438,732,371,307
060670078012,717,379,338,730,375,355,864,462,383,672,338,287
060670078013,453,236,217,460,231,229,565,309,245,461,224,206
060670078014,577,300,277,586,295,291,710,390,308,655,314,296
060670078021,587,331,256,591,321,270,886,512,349,654,347,260
060670055051,636,389,247,638,378,260,653,395,238,591,346,199
060670055053,418,298,120,420,292,128,611,406,177,432,279,116
060670056013,267,168,99,272,165,107,484,324,142,355,237,100
060670055052,219,167,52,220,163,57,458,300,136,297,219,56
060670055061,346,254,92,352,255,97,411,309,87,325,222,69
060670055062,365,279,86,369,275,94,570,429,119,390,269,83
060670055081,248,185,63,251,178,73,307,218,84,221,155,50
060670055091,450,348,102,457,349,108,708,543,135,631,437,138
060670055103,444,349,95,449,344,105,658,501,132,509,373,90
060670055104,231,183,48,232,180,52,359,269,75,281,209,47
060670056051,476,325,151,482,319,163,784,527,230,610,386,178
060670056014,606,369,237,613,365,248,622,417,183,593,395,165
060670057024,391,239,152,396,235,161,383,250,122,434,253,154
060670057025,572,338,234,576,329,247,600,382,202,589,340,203
060670054046,389,230,159,392,225,167,400,267,127,356,216,118
060670054043,423,275,148,425,269,156,531,372,147,404,260,114
060670055083,394,267,127,399,262,137,597,434,149,473,316,125
060670056061,516,275,241,523,273,250,616,359,245,549,295,227
060670055102,422,323,99,428,316,112,537,404,114,459,324,98
060670055101,143,110,33,144,107,37,243,188,46,144,107,24
060670056062,553,376,177,565,373,192,683,459,200,554,349,161
060670056052,534,344,190,542,336,206,902,591,286,609,376,183
060670056063,380,247,133,382,239,143,565,340,203,377,233,116
060670056064,320,207,113,323,202,121,420,257,155,328,205,99
060670055082,499,371,128,508,362,146,648,475,156,558,389,126
060670054045,577,294,283,583,292,291,619,368,231,621,337,249
060670054041,535,308,227,537,303,234,613,417,192,485,286,170
060670060023,397,250,147,403,241,162,444,283,147,375,214,125
060670060024,384,243,141,394,235,159,474,300,155,392,223,131
060670060025,371,234,137,376,225,151,544,346,181,475,270,157
060670057011,699,406,293,714,397,317,855,524,312,719,400,262
060670057012,436,230,206,439,227,212,545,317,220,445,223,193
060670057013,527,309,218,533,301,232,689,427,246,608,342,216
060670058013,898,483,415,905,472,433,1078,624,422,909,520,323
060670058011,499,276,223,505,270,235,599,353,224,538,300,194
060670058012,715,385,330,715,375,340,961,549,390,825,434,333
060670058014,605,328,277,612,324,288,663,380,262,568,307,221
060670057021,570,331,239,577,323,254,673,424,229,609,354,208
060670058031,938,458,480,949,456,493,1169,672,478,913,479,379
060670057022,644,357,287,652,361,291,738,461,260,667,380,234
060670057023,742,411,331,754,417,337,904,566,317,757,429,266
060670054044,849,447,402,854,448,406,1077,668,387,874,490,324
060670058032,741,375,366,752,376,376,830,481,333,768,412,314
060670058033,605,332,273,610,334,276,753,464,278,663,375,249
060670077011,417,232,185,417,222,195,458,249,195,404,206,164
060670077012,652,363,289,656,349,307,930,504,398,776,386,329
060670077013,319,178,141,322,169,153,433,249,169,355,173,154
060670077014,331,185,146,335,175,160,450,260,176,363,177,159
060670077015,505,282,223,510,268,242,726,419,284,643,336,260
060670077021,944,548,396,956,536,420,1051,632,401,970,544,372
060670077022,313,181,132,317,178,139,480,287,182,375,211,143
060670078022,438,246,192,438,238,200,664,385,261,462,244,184
060670078024,629,356,273,629,347,282,459,280,169,448,243,174
060670077023,1032,561,471,1042,567,475,1109,657,429,1040,577,405
060670078023,637,362,275,635,352,283,853,516,309,732,407,278
060670058041,717,346,371,724,351,373,799,483,299,679,365,273
060670058042,984,547,437,991,533,458,1250,767,456,1026,552,411
060670081242,770,327,443,777,310,467,1190,489,671,766,315,398
060670081422,417,188,229,425,183,242,485,217,257,392,168,193
060670081401,510,239,271,518,231,287,720,312,390,517,216,265
060670081421,623,294,329,642,292,350,1069,477,563,687,296,346
060670081251,1076,460,616,1088,436,652,1433,629,778,1122,424,620
060670081252,394,160,234,399,152,247,561,235,312,465,177,253
060670081253,724,302,422,733,283,450,1040,435,580,871,330,483
060670081241,1264,484,780,1277,475,802,1544,608,892,1410,549,775
060670081402,543,251,292,549,236,313,846,364,456,621,258,321
060670081412,434,201,233,440,189,251,654,281,352,507,206,266
060670081371,372,161,211,376,160,216,656,302,340,479,208,242
060670081411,335,145,190,338,144,194,453,201,239,326,140,164
060670081413,244,106,138,249,106,143,282,144,131,306,123,161
060670081414,310,191,119,311,188,123,523,280,220,449,211,196
060670081415,294,181,113,294,179,115,562,305,240,454,219,193
060670081203,233,152,81,235,151,84,694,361,310,541,265,234
060670081381,226,131,95,228,130,98,479,244,223,326,157,143
060670081382,515,260,255,523,258,265,772,363,391,441,222,176
060670081201,635,284,351,647,276,371,739,298,414,615,229,346
060670081202,620,276,344,632,271,361,740,331,382,549,228,283
060670081451,615,234,381,624,228,396,776,306,441,646,221,379
060670081452,629,252,377,641,245,396,792,318,451,642,231,364
060670081453,333,132,201,341,129,212,502,202,283,387,138,219
060670081454,641,261,380,653,245,408,855,338,492,695,258,390
060670081441,311,128,183,315,121,194,437,176,246,336,126,189
060670081442,1030,428,602,1044,426,618,1365,622,699,1055,455,518
060670081455,567,211,356,573,207,366,726,298,412,607,213,347
060670081456,508,194,314,519,193,326,671,280,370,528,194,294
060670082033,958,342,616,973,323,650,1193,442,724,1003,334,596
060670082032,791,296,495,802,286,516,983,355,609,814,273,500
060670082112,468,153,315,467,145,322,609,210,390,484,159,296
060670082111,963,317,646,973,305,668,1285,440,818,1039,336,632
060670082031,604,227,377,612,221,391,833,339,471,627,238,337
060670082081,405,140,265,410,134,276,545,192,337,425,136,257
060670082084,467,188,279,475,179,296,679,290,372,520,187,288
060670082082,407,177,230,410,167,243,570,239,318,512,196,274
060670082083,431,187,244,439,179,260,613,289,310,464,180,244
060670082091,986,431,555,995,427,568,1245,585,630,1035,449,522
060670082101,1418,526,892,1439,526,913,1754,800,914,1442,556,804
060670082092,1228,540,688,1255,538,717,1624,779,796,1337,553,697
060670082103,579,252,327,594,249,345,759,364,378,697,283,366
060670082102,1126,473,653,1152,484,668,1298,587,684,1095,470,552
060670084021,801,346,455,818,360,458,233,111,117,797,351,376
060670084022,576,265,311,595,267,328,772,370,378,450,179,225
060670084023,1068,462,606,1107,452,655,1404,641,721,1126,458,562
060670085011,1258,569,689,1287,571,716,1586,787,769,1433,643,668
060679883001,44,19,25,45,20,25,922,439,459,798,345,384
060670085014,441,207,234,448,202,246,598,337,250,346,157,163
060670085013,603,299,304,620,299,321,796,453,322,706,351,301
060670085093,940,464,476,967,469,498,1204,659,513,974,487,422
060670085102,583,276,307,593,274,319,704,376,310,476,207,246
060670085103,934,432,502,951,424,527,1118,563,522,960,440,450
060670085122,666,307,359,678,311,367,1113,593,495,630,327,253
060670081383,536,258,278,542,255,287,533,274,250,455,202,222
060670081393,365,222,143,373,221,152,770,455,292,596,319,219
060670081391,230,138,92,235,137,98,266,155,104,199,104,77
060670081392,381,232,149,390,231,159,482,287,184,374,202,139
060670081221,418,183,235,427,182,245,539,265,262,416,161,225
060670081222,834,367,467,854,366,488,1218,595,593,833,322,452
060670081223,345,155,190,353,155,198,502,241,248,403,167,199
060670082041,1041,441,600,1058,439,619,1405,616,754,1150,474,585
060670082042,1069,456,613,1088,453,635,1310,588,680,1018,426,506
060670080071,756,336,420,765,337,428,925,451,452,642,281,304
060670080072,690,314,376,699,315,384,1075,521,528,884,386,418
060670080081,847,405,442,859,401,458,1052,531,494,908,399,452
060670080082,826,395,431,845,393,452,1046,532,495,795,362,382
060670080083,747,391,356,754,378,376,1038,520,482,829,395,371
060670080093,679,389,290,687,381,306,882,512,343,754,390,294
060670080094,573,314,259,576,305,271,654,376,264,532,268,217
060670080062,726,334,392,738,335,403,803,390,386,746,347,349
060670082062,1190,503,687,1205,480,725,1515,605,857,1153,456,597
060670082061,325,141,184,329,131,198,479,214,251,385,153,198
060670082074,339,151,188,342,144,198,540,251,266,408,166,197
060670082071,280,117,163,285,110,175,461,202,243,339,130,172
060670082072,301,125,176,309,119,190,449,195,236,339,130,172
060670082073,787,375,412,792,361,431,746,349,372,782,342,366
060670082063,820,357,463,832,351,481,1245,552,653,1015,401,521
060670080051,518,258,260,523,249,274,620,338,269,526,268,236
060670082075,396,190,206,395,182,213,640,318,300,458,200,214
060670080052,1391,687,704,1404,669,735,1800,948,808,1383,645,635
060670080053,719,344,375,727,342,385,769,378,363,786,390,341
060670080061,849,382,467,866,379,487,1077,536,514,895,397,427
060670080064,729,341,388,737,331,406,907,462,422,776,312,406
060670084032,939,504,435,948,490,458,1326,745,534,974,510,389
060670084033,649,347,302,658,341,317,892,492,365,733,377,297
060670084041,269,140,129,273,137,136,397,207,180,329,156,150
060670084042,544,284,260,555,279,276,665,351,298,534,251,242
060670084043,475,222,253,490,223,267,665,327,323,177,80,84
060670084031,548,254,294,560,258,302,1061,577,455,718,328,334
060670085051,526,244,282,539,249,290,512,282,216,427,195,200
060670085052,560,285,275,574,289,285,558,313,232,450,223,197
060670085082,796,400,396,811,394,417,986,559,401,875,458,353
060670085083,1234,615,619,1267,614,653,1699,915,742,1120,552,488
060670085063,224,117,107,229,119,110,455,255,188,359,184,149
060670085062,163,85,78,167,87,80,402,227,166,296,153,123
060670085061,295,154,141,301,156,145,429,241,177,318,164,132
060670085071,717,368,349,733,380,353,1074,551,500,800,379,362
060670085012,892,400,492,913,387,526,1137,538,560,938,400,463
060670085091,683,323,360,706,332,374,952,513,411,725,349,329
060670085092,480,224,256,484,220,264,650,331,302,519,233,248
060670085101,1084,489,595,1106,482,624,1432,716,677,1196,538,575
060670085121,1335,624,711,1357,633,724,2176,1128,998,1161,543,555
060670085131,837,433,404,852,436,416,1520,838,650,1129,584,473
060670085132,571,268,303,585,269,316,786,438,325,408,194,188
060670080101,376,179,197,389,176,213,503,260,226,384,182,171
060670080102,632,299,333,649,294,355,707,343,349,712,310,344
060670080103,727,363,364,745,362,383,948,499,416,710,319,337
060670080091,552,271,281,562,262,300,594,320,262,546,264,241
060670080092,455,222,233,464,217,247,772,415,338,554,267,245
060670080104,649,333,316,657,329,328,927,487,408,749,356,333
060670080063,903,433,470,910,419,491,1167,599,540,959,454,442
060670085041,392,204,188,398,201,197,904,514,368,364,185,149
060670085042,1304,680,624,1320,666,654,1689,963,682,1491,731,642
060670085043,286,155,131,288,151,137,333,187,140,221,114,92
060670085081,1048,537,511,1063,534,529,1377,769,571,1107,596,423
060670085072,704,360,344,720,371,349,1014,563,431,788,388,334
060670053011,129,99,30,130,99,31,281,209,66,150,125,19
060670053013,125,99,26,124,98,26,313,251,53,166,137,20
060670005011,308,268,40,310,265,45,424,355,55,336,264,35
060670005012,449,390,59,451,386,65,566,473,70,462,364,52
060670006001,293,255,38,293,251,42,373,312,56,135,105,21
060670006002,241,210,31,243,207,36,483,398,67,233,184,26
060670007001,280,213,67,282,207,75,694,519,156,515,385,91
060670008001,219,172,47,220,169,51,142,107,32,270,200,50
060670008002,419,325,94,422,318,104,278,209,63,523,387,96
060670011031,39,30,9,39,29,10,99,79,19,24,20,2
060670011033,275,210,65,282,206,76,475,368,87,145,109,22
060670005022,255,218,37,258,218,40,264,235,28,223,189,17
060670005021,437,374,63,443,373,70,487,426,47,545,457,44
060670011022,304,262,42,309,262,47,385,302,71,299,240,32
060670011021,244,210,34,248,210,38,254,198,46,278,224,29
060670011032,138,117,21,140,117,23,140,110,26,146,117,19
060670021001,410,346,64,410,344,66,468,401,55,391,305,44
060670021002,305,260,45,307,258,49,463,395,53,289,227,32
060670021003,251,211,40,252,211,41,333,281,38,285,218,34
060670012022,583,489,94,586,490,96,476,388,65,529,425,69
060670012012,673,580,93,675,570,105,857,723,99,699,564,72
060670012011,279,235,44,281,236,45,367,308,44,224,180,23
060670012021,306,256,50,309,258,51,284,234,40,356,289,48
060670013003,588,513,75,593,502,91,726,619,84,631,517,53
060670004004,335,290,45,340,287,53,429,366,54,341,281,37
060670004005,437,376,61,445,374,71,579,489,76,495,410,52
060670004002,326,285,41,329,282,47,425,361,41,354,289,35
060670004003,407,355,52,412,355,57,508,439,51,419,347,40
060670004001,436,380,56,439,379,60,549,484,55,427,365,37
060670014002,328,283,45,330,281,49,488,405,70,337,260,46
060670014003,620,536,84,622,526,96,785,643,119,690,541,86
060670014001,343,292,51,342,285,57,454,377,67,398,325,41
060670013001,467,399,68,475,397,78,576,485,75,508,402,49
060670013002,495,423,72,497,418,79,599,501,79,529,412,53
060670018001,530,453,77,537,450,87,749,614,115,418,340,47
060670019004,300,261,39,304,258,46,450,373,56,346,275,41
060670020001,249,212,37,252,213,39,723,605,101,314,253,33
060670020002,509,436,73,515,439,76,663,566,82,512,394,66
060670020003,284,246,38,289,248,41,357,305,47,382,305,45
060670019003,456,403,53,463,401,62,563,481,60,534,430,64
060670019001,325,287,38,326,283,43,475,409,52,395,316,48
060670019002,347,304,43,350,302,48,392,331,44,335,261,42
060670003001,543,408,135,543,396,147,608,471,122,524,405,93
060670053012,168,128,40,169,126,43,474,399,63,2,2,0
060670003003,1081,824,257,1085,810,275,1202,943,229,1088,822,204
060670015001,502,378,124,506,377,129,599,472,111,507,372,103
060670015004,409,321,88,412,319,93,470,372,95,418,317,72
060670015005,734,584,150,741,581,160,1006,799,184,783,613,115
060670002001,481,357,124,481,349,132,618,474,123,476,349,98
060670002004,575,427,148,578,418,160,617,477,123,554,409,112
060670003002,458,339,119,464,335,129,458,374,78,474,364,82
060670002003,684,504,180,687,496,191,801,640,142,658,484,132
060670016022,884,613,271,895,610,285,994,736,238,909,626,213
060670002002,579,430,149,580,424,156,691,551,123,592,438,118
060670016011,614,452,162,616,445,171,702,535,151,602,437,127
060670015002,678,492,186,685,492,193,714,565,134,691,490,162
060670015003,431,314,117,437,314,123,532,425,97,464,351,75
060670016021,743,471,272,751,473,278,846,591,231,775,490,215
060670016012,520,386,134,526,381,145,725,547,164,576,413,126
060670016013,453,336,117,458,329,129,587,426,146,467,335,100
060670018002,376,320,56,376,320,56,446,386,54,397,322,44
060670018005,602,525,77,608,523,85,753,637,90,546,444,53
060670017021,760,621,139,765,615,150,959,783,155,781,599,125
060670017022,667,527,140,675,521,154,833,655,151,701,520,126
060670017023,409,305,104,418,307,111,587,434,135,490,340,113
060670017011,868,651,217,884,649,235,1069,817,226,736,502,179
060670001001,1191,771,420,1203,751,452,1381,953,391,1284,838,355
060670001002,585,425,160,586,420,166,680,503,160,567,399,135
060670001003,457,333,124,456,326,130,534,399,127,478,336,115
060670052011,264,236,28,271,232,39,137,114,19,299,237,40
060670052012,371,332,39,382,327,55,481,402,68,495,391,67
060670054032,673,453,220,672,442,230,792,582,194,783,533,210
060670054031,717,481,236,714,468,246,688,497,175,631,427,167
060670054042,370,227,143,370,221,149,530,365,154,402,246,124
060670052023,754,495,259,761,489,272,814,572,227,707,434,215
060670052022,170,115,55,171,114,57,355,257,92,139,110,19
060670052041,343,240,103,347,235,112,387,275,98,280,191,68
060670052051,302,202,100,312,200,112,711,513,183,320,201,100
060670052052,387,271,116,394,266,128,617,434,154,532,359,129
060670052042,414,266,148,422,262,160,618,423,184,510,322,158
060670052043,601,362,239,609,356,253,692,436,234,637,359,228
060670029003,372,294,78,382,294,88,501,403,94,400,296,74
060670029004,699,556,143,716,552,164,743,590,138,697,495,144
060670022001,428,371,57,431,365,66,601,517,69,404,353,35
060670022002,318,276,42,321,271,50,550,473,61,257,224,20
060670023001,430,335,95,431,332,99,565,460,91,375,280,61
060670023002,580,464,116,581,460,121,624,522,94,591,464,89
060670023003,686,527,159,689,521,168,792,633,137,687,541,108
060670023004,409,311,98,411,307,104,493,386,91,408,300,75
060670024003,456,368,88,459,368,91,544,455,78,464,370,67
060670027001,287,245,42,290,237,53,379,321,46,417,344,54
060670026001,543,461,82,546,450,96,687,565,88,578,447,74
060670025002,704,595,109,713,595,118,899,778,105,554,464,67
060670026002,469,398,71,471,394,77,500,432,58,483,402,58
060670026003,524,445,79,527,442,85,569,495,64,508,424,61
060670025001,570,478,92,579,481,98,599,518,71,562,464,69
060670022003,413,332,81,414,322,92,575,470,91,473,373,72
060670022004,525,421,104,526,410,116,603,493,96,485,384,74
060670024001,1015,742,273,1025,734,291,1131,883,230,1020,765,205
060670024004,578,424,154,579,419,160,620,484,130,555,416,113
060670024002,976,714,262,982,718,264,1122,867,241,945,712,188
060670039001,616,460,156,614,454,160,663,500,148,526,376,114
060670039002,586,411,175,585,402,183,771,591,159,628,456,130
060670039003,615,430,185,613,423,190,804,604,180,562,408,111
060670033003,995,745,250,996,735,261,1067,807,235,1011,749,213
060670033001,746,560,186,747,562,185,827,638,174,686,515,125
060670033002,700,536,164,715,542,173,902,703,182,818,607,151
060670035011,348,275,73,349,268,81,457,357,84,362,272,63
060670035012,563,445,118,564,434,130,612,474,113,524,391,92
060670035013,286,226,60,290,222,68,408,327,79,360,271,64
060670035021,569,429,140,580,430,150,633,473,157,513,367,118
060670035022,338,254,84,344,255,89,476,349,115,397,281,90
060670035023,303,229,74,308,229,79,440,316,105,341,237,78
060670027002,331,297,34,339,292,47,575,493,59,376,302,35
060670027003,237,212,25,237,209,28,310,269,34,207,168,17
060670027004,367,329,38,373,326,47,533,455,56,398,332,36
060670037003,337,280,57,339,271,68,580,474,89,388,325,46
060670037002,171,142,29,171,136,35,270,226,40,186,157,24
060670018003,271,236,35,273,235,38,370,325,41,247,204,25
060670018004,474,413,61,477,412,65,543,460,58,489,394,47
060670028001,363,320,43,366,316,50,469,384,63,382,304,35
060670028002,205,179,26,203,174,29,290,237,38,252,202,24
060670028003,378,331,47,378,326,52,556,465,78,348,297,39
060670036001,508,404,104,517,398,119,679,526,132,514,399,77
060670036002,244,193,51,246,190,56,396,304,79,269,208,40
060670037001,265,214,51,268,209,59,469,371,85,323,265,43
060670044022,316,228,88,318,215,103,512,373,113,437,316,90
060670044023,218,175,43,217,169,48,353,264,78,274,210,42
060670044011,226,183,43,230,177,53,340,259,66,195,152,30
060670044012,198,155,43,196,148,48,321,246,64,257,195,42
060670044021,194,156,38,197,151,46,267,197,66,194,150,31
060670044014,200,147,53,200,140,60,277,207,64,221,164,45
060670030022,573,440,133,578,428,150,757,569,167,590,432,125
060670030023,435,341,94,434,332,102,607,474,122,487,372,94
060670031023,270,203,67,277,199,78,433,322,99,307,213,73
060670044013,315,247,68,318,244,74,373,285,81,288,214,49
060670045011,265,215,50,265,199,66,426,314,101,304,237,51
060670045012,150,113,37,154,113,41,325,239,77,220,170,34
060670046021,318,248,70,325,244,81,516,381,127,359,273,66
060670046022,126,98,28,127,96,31,171,122,41,107,83,19
060670046023,255,188,67,254,182,72,543,387,144,304,227,64
060670046031,199,152,47,203,148,55,250,183,67,186,149,34
060670046032,207,158,49,209,152,57,441,310,113,314,241,56
060670046041,214,158,56,215,154,61,265,193,72,205,157,42
060670046042,355,261,94,362,253,109,518,360,144,519,377,112
060670046043,312,226,86,312,217,95,401,288,105,322,229,76
060670032022,212,155,57,216,151,65,368,261,101,287,200,66
060670032023,213,156,57,214,154,60,366,236,125,289,216,58
060670032021,236,175,61,236,169,67,420,294,114,294,205,68
060670047012,239,177,62,240,171,69,523,357,154,283,210,52
060670048011,251,183,68,253,181,72,239,157,82,179,135,35
060670047021,356,278,78,357,274,83,574,426,131,487,345,120
060670045021,192,151,41,193,147,46,338,243,86,237,186,42
060670045022,202,161,41,204,160,44,410,324,74,333,260,53
060670045023,299,237,62,302,235,67,342,273,63,272,214,43
060670047011,344,254,90,347,245,102,380,272,102,302,217,75
060670047022,299,232,67,298,229,69,446,339,103,307,235,61
060670047023,213,159,54,215,152,63,411,286,109,294,222,60
060670050021,343,255,88,346,247,99,553,388,157,436,333,81
060670050022,284,211,73,286,204,82,399,278,112,336,258,63
060670029001,703,575,128,710,569,141,931,744,163,766,606,118
060670029002,576,471,105,580,465,115,642,514,114,600,472,91
060670030021,702,531,171,715,515,200,864,642,204,739,529,171
060670031021,251,187,64,259,183,76,371,271,85,296,201,74
060670031022,377,282,95,383,272,111,536,398,126,421,290,106
060670030011,433,301,132,436,286,150,614,419,182,401,291,82
060670031011,295,219,76,297,209,88,418,303,96,293,206,66
060670030012,371,258,113,378,247,131,434,290,127,503,330,128
060670092013,236,116,120,243,116,127,304,155,149,248,114,125
060670031012,228,168,60,231,163,68,305,225,70,248,173,55
060670031013,284,211,73,286,203,83,447,328,102,299,213,67
060670031014,219,162,57,219,155,64,308,227,73,250,178,57
060670032024,267,198,69,272,188,84,403,281,111,318,214,71
060670032041,379,281,98,387,268,119,565,411,140,346,266,64
060670032042,199,147,52,202,140,62,251,177,68,201,153,37
060670032031,187,153,34,192,153,39,342,255,81,243,200,33
060670032032,242,197,45,247,197,50,543,404,127,355,291,49
060670032043,267,219,48,272,216,56,444,318,121,339,259,62
060670048012,269,211,58,271,205,66,430,307,111,295,233,46
060670048013,257,204,53,261,200,61,471,339,121,305,249,45
060670048014,265,212,53,266,208,58,439,328,110,269,221,36
060670048022,335,249,86,340,243,97,529,366,151,421,312,87
060670048021,549,380,169,551,374,177,853,566,270,669,463,159
060670040054,543,385,158,546,378,168,511,382,121,572,397,151
060670040061,345,246,99,349,242,107,643,475,151,541,391,105
060670034002,689,518,171,698,515,183,808,615,173,660,487,138
060670040141,564,428,136,573,427,146,750,570,158,649,475,139
060670040161,1202,792,410,1225,780,445,1426,1006,393,1201,778,356
060670040153,970,661,309,986,656,330,1312,955,331,1059,719,283
060670040151,572,390,182,579,380,199,695,496,188,559,393,140
060670040053,551,375,176,556,365,191,794,565,214,644,451,162
060670040052,295,212,83,300,214,86,367,285,74,275,205,58
060670040062,630,452,178,634,454,180,902,689,180,727,533,152
060670040063,517,361,156,520,358,162,662,477,177,543,372,148
060670040064,543,378,165,545,372,173,576,414,153,558,381,154
060670040051,686,472,214,690,464,226,743,539,188,616,424,155
060670040081,1196,860,336,1214,844,370,1438,1086,330,1158,838,264
060670040082,700,512,188,718,503,215,802,597,187,679,497,151
060670040152,505,361,144,516,347,169,730,532,185,647,456,157
060670040181,592,422,170,593,400,193,777,586,179,739,517,184
060670040182,394,279,115,391,268,123,640,466,160,546,374,138
060670040171,659,470,189,662,455,207,806,589,194,636,452,147
060670040201,371,275,96,376,269,107,561,427,121,480,353,103
060670040202,415,287,128,424,287,137,487,373,106,445,328,94
060670040191,723,539,184,732,527,205,967,724,225,825,592,185
060670040172,583,407,176,586,402,184,749,550,175,641,453,157
060670040192,454,327,127,457,327,130,610,460,128,526,384,118
060670040111,705,496,209,716,495,221,880,631,232,677,479,172
060670040112,918,621,297,926,609,317,1058,761,279,874,592,247
060670040122,575,381,194,578,369,209,723,509,202,572,385,162
060670040123,698,467,231,699,450,249,948,711,221,840,570,222
060670040121,478,320,158,480,311,169,578,434,136,438,298,115
060670034003,924,671,253,925,652,273,1000,747,235,763,561,164
060670040142,555,405,150,558,392,166,802,599,188,659,484,140
060670034001,438,358,80,452,361,91,750,588,145,541,425,98
060670040131,888,635,253,901,624,277,1105,813,272,1030,712,254
060670040132,772,544,228,788,539,249,989,715,253,800,542,214
060670038001,619,469,150,618,446,172,857,611,217,607,463,102
060670038002,409,334,75,416,327,89,591,458,124,466,359,78
060670041002,457,337,120,451,312,139,586,419,158,555,385,137
060670038003,238,194,44,238,188,50,348,267,72,262,205,42
060670038004,310,253,57,314,249,65,407,312,84,282,219,46
060670041003,287,226,61,293,219,74,441,330,101,340,274,52
060670041001,331,258,73,336,252,84,559,412,127,482,367,84
060670042012,549,455,94,550,438,112,816,638,158,604,508,79
060670042013,619,485,134,624,472,152,872,643,190,701,551,110
060670042011,239,203,36,241,195,46,323,253,58,283,235,30
060670042021,532,456,76,535,453,82,604,491,102,496,427,56
060670042031,493,422,71,499,418,81,837,668,145,689,585,83
060670042022,392,341,51,397,337,60,547,436,93,416,363,38
060670042023,324,282,42,328,280,48,597,477,101,443,385,41
060670042032,471,399,72,477,387,90,814,640,151,592,493,73
060670043021,397,328,69,403,321,82,653,508,125,477,384,69
060670049083,374,294,80,375,286,89,625,463,151,482,380,76
060670049081,249,205,44,247,196,51,416,317,92,279,227,38
060670049072,85,74,11,86,72,14,146,115,27,90,78,8
060670049071,279,239,40,280,232,48,471,376,88,355,301,32
060670049082,262,229,33,268,227,41,395,311,78,290,246,26
060670043013,389,300,89,392,298,94,559,412,135,416,328,61
060670043022,421,322,99,429,321,108,751,545,188,538,428,82
060670096013,173,133,40,173,117,56,264,182,76,211,166,38
060670043012,198,160,38,202,159,43,337,254,69,234,198,28
060670043011,293,236,57,299,235,64,514,395,107,353,301,42
060670049061,470,358,112,470,341,129,644,476,150,470,364,86
060670049062,260,199,61,261,189,72,411,308,98,326,252,58
060670096014,553,455,98,559,441,118,900,689,200,726,564,120
060670096012,492,400,92,492,389,103,671,504,151,554,433,90
060670096011,240,197,43,242,191,51,394,293,91,248,194,42
060670096331,324,265,59,327,259,68,512,383,107,368,299,55
060670096332,344,270,74,344,258,86,538,405,112,396,321,58
060670049041,554,404,150,562,394,168,782,565,193,633,424,171
060670049043,434,321,113,435,308,127,715,511,189,539,394,118
060670049042,595,446,149,603,424,179,849,616,214,709,510,166
060670050033,428,315,113,431,310,121,563,373,177,421,297,106
060670050032,231,169,62,232,167,65,426,294,121,304,233,58
060670050031,392,289,103,391,282,109,659,456,188,422,328,77
060670050041,142,103,39,146,104,42,263,175,84,192,136,48
060670050042,296,218,78,299,213,86,525,373,143,396,297,79
060670050043,187,139,48,188,135,53,329,236,88,225,177,39
060670049103,298,224,74,299,216,83,279,217,57,317,251,55
060670049101,359,272,87,359,259,100,502,343,153,428,335,75
060670049092,602,470,132,610,476,134,668,516,144,456,366,70
060670049091,24,19,5,24,19,5,148,112,32,91,72,14
060670049102,114,89,25,116,90,26,402,310,84,325,259,50
060670050023,681,513,168,688,512,176,1001,744,239,737,537,169
060670096341,370,313,57,371,307,64,762,581,161,522,425,71
060670096342,193,164,29,193,159,34,366,273,85,198,164,28
060670096343,259,219,40,262,216,46,411,321,86,283,234,39
060670096402,299,230,69,300,219,81,557,398,151,380,296,69
060670096413,323,248,75,320,235,85,498,354,133,387,299,71
060670096411,281,217,64,287,215,72,448,327,112,373,270,86
060670096401,265,204,61,270,202,68,455,346,99,238,200,27
060670096412,355,273,82,365,272,93,570,419,143,454,329,106
060670093191,546,397,149,555,395,160,1088,745,322,553,405,118
060670093201,362,277,85,366,270,96,503,358,138,384,300,66
060670093202,488,366,122,495,363,132,714,483,217,536,390,119
060670093203,386,298,88,392,289,103,508,367,134,384,294,72
060670096082,572,460,112,580,453,127,987,732,225,608,475,109
060670096101,359,282,77,361,278,83,622,468,137,424,327,69
060670096102,594,457,137,602,443,159,987,723,240,622,464,115
060670096103,495,384,111,501,375,126,789,589,183,516,392,90
060670096093,540,420,120,543,410,133,904,665,217,595,465,104
060670096092,196,155,41,195,150,45,352,255,84,247,197,39
060670096091,561,417,144,555,403,152,907,651,233,589,460,102
060670096141,972,713,259,973,683,290,1397,1002,362,1046,725,253
060670096142,635,443,192,646,437,209,916,626,263,739,497,202
060670096084,394,315,79,399,308,91,697,555,124,501,398,80
060670096081,360,284,76,369,286,83,517,372,133,441,342,81
060670096083,572,444,128,578,447,131,1130,794,315,605,474,103
060670052021,617,369,248,626,366,260,842,539,281,652,382,222
060670091061,710,478,232,715,472,243,943,647,271,777,488,238
060670091062,622,420,202,630,417,213,790,538,230,685,435,206
060670091051,343,238,105,348,233,115,532,373,138,446,280,122
060670091052,291,202,89,294,198,96,408,286,107,330,207,91
060670091053,353,244,109,360,242,118,435,305,113,337,211,93
060670091063,509,341,168,505,328,177,603,422,166,429,265,136
060670091072,957,640,317,968,621,347,1399,886,464,1142,689,343
060670052044,397,239,158,402,235,167,589,373,199,444,249,159
060670052045,351,211,140,356,208,148,419,267,143,373,209,134
060670091101,145,103,42,147,100,47,222,167,46,197,152,35
060670091102,259,183,76,260,177,83,304,229,63,238,184,44
060670091111,716,446,270,723,448,275,922,556,349,838,488,283
060670091112,427,273,154,429,273,156,775,544,207,608,410,161
060670091081,560,341,219,570,334,236,734,442,273,549,315,195
060670091082,450,266,184,459,261,198,631,380,236,501,281,184
060670091092,700,426,274,705,405,300,904,564,305,762,429,270
060670091093,535,329,206,546,324,222,708,456,223,502,290,176
060670091094,422,256,166,427,243,184,565,329,220,436,235,166
060670091083,523,290,233,531,286,245,651,377,252,699,388,266
060670091091,408,227,181,417,225,192,601,341,240,468,248,182
060670089092,246,146,100,250,141,109,392,234,149,350,193,129
060670091071,426,254,172,432,245,187,410,246,156,393,217,145
060670089091,549,306,243,553,308,245,788,461,300,587,310,231
060670089111,323,179,144,326,180,146,467,271,176,292,158,110
060670089112,234,131,103,236,131,105,417,255,145,410,252,130
060670089101,546,296,250,552,288,264,712,398,299,562,285,239
060670089102,647,349,298,654,344,310,923,525,371,701,379,269
060670090061,515,293,222,524,287,237,821,504,294,660,366,247
060670091031,605,356,249,618,356,262,942,525,385,686,386,241
060670091032,447,263,184,455,262,193,623,348,257,543,306,191
060670090041,776,475,301,778,465,313,1062,605,429,815,487,267
060670090042,444,272,172,442,264,178,692,399,279,467,271,157
060670090051,698,428,270,706,420,286,1107,646,429,824,483,277
060670090062,655,392,263,660,384,276,968,534,402,721,430,236
060670090063,158,94,64,160,93,67,316,174,131,218,130,72
060670090052,179,122,57,181,114,67,274,182,85,200,106,79
060670089131,343,173,170,348,168,180,544,265,261,384,183,167
060670089132,537,262,275,547,257,290,685,319,346,656,294,305
060670089133,536,302,234,546,292,254,795,446,322,510,258,213
060670089121,383,208,175,389,201,188,513,266,232,440,224,184
060670089122,628,348,280,639,337,302,839,459,355,623,319,256
060670089123,371,200,171,378,194,184,448,233,202,391,199,163
060670089051,494,264,230,500,256,244,565,310,246,514,252,211
060670089052,489,252,237,499,250,249,604,336,253,683,337,271
060670089053,420,219,201,423,212,211,722,400,296,526,274,199
060670089073,368,197,171,369,191,178,573,310,248,416,202,175
060670089074,325,174,151,328,169,159,457,246,196,318,154,133
060670089081,625,309,316,629,293,336,869,428,422,712,336,320
060670089082,703,385,318,711,365,346,999,488,480,830,431,330
060670089071,278,167,111,282,158,124,475,259,205,447,251,159
060670089072,434,260,174,439,247,192,629,345,273,435,227,172
060670090081,391,227,164,398,224,174,500,305,175,373,209,141
060670090082,369,215,154,371,209,162,379,222,149,399,211,151
060670090104,374,244,130,381,244,137,618,391,216,401,257,119
060670090083,352,206,146,353,199,154,617,362,241,469,261,177
060670090102,325,213,112,330,213,117,455,315,118,296,197,78
060670090103,246,164,82,250,164,86,455,314,118,320,213,84
060670090101,391,255,136,396,254,142,684,431,231,394,262,104
060670088031,195,108,87,198,106,92,344,178,155,57,34,15
060670090071,281,187,94,285,187,98,469,290,162,303,196,89
060670090072,270,179,91,272,180,92,510,334,156,366,230,108
060670090113,1095,566,529,1108,565,543,1354,714,610,1079,532,481
060670090111,571,294,277,577,292,285,792,422,353,778,391,335
060670090112,192,100,92,193,100,93,500,270,223,57,30,27
060670092012,310,135,175,315,133,182,415,187,223,595,313,244
060670091113,575,349,226,585,355,230,854,502,327,635,368,212
060670091121,602,382,220,600,363,237,858,567,268,679,436,196
060670091122,614,390,224,613,371,242,871,509,339,648,376,218
060670093263,836,393,443,850,388,462,969,507,436,847,407,392
060670088023,423,214,209,427,208,219,586,302,272,500,240,218
060670088022,284,140,144,288,138,150,512,259,243,351,166,157
060670088032,208,109,99,211,106,105,394,207,175,354,173,146
060670088021,424,202,222,431,202,229,598,304,287,430,201,203
060670051011,378,265,113,384,256,128,591,354,221,494,333,131
060670051012,551,373,178,552,358,194,820,549,254,609,417,162
060670051021,584,365,219,585,354,231,889,574,296,683,465,185
060670051022,686,365,321,710,352,358,988,509,462,790,388,369
060670093181,495,343,152,502,344,158,844,584,246,589,423,139
060670093192,240,168,72,245,169,76,404,275,117,262,193,55
060670093193,255,184,71,259,183,76,402,272,117,430,317,92
060670093161,584,431,153,590,420,170,904,583,302,650,442,172
060670093162,469,348,121,479,341,138,802,532,245,601,434,131
060670093171,796,533,263,800,517,283,1520,993,496,878,577,244
060670093172,491,313,178,496,296,200,692,450,226,518,336,142
060670093173,675,473,202,682,468,214,1039,690,319,772,505,214
060670093342,447,299,148,459,301,158,691,464,215,487,342,123
060670093353,279,205,74,285,202,83,582,398,174,425,312,95
060670093213,689,492,197,697,483,214,1011,689,303,777,552,183
060670093211,276,205,71,280,200,80,415,288,119,315,233,68
060670093212,685,472,213,686,464,222,1048,701,326,806,573,191
060670092011,1273,835,438,1291,827,464,2346,1488,820,853,521,288
060670093113,731,429,302,744,430,314,1000,579,403,745,432,259
060670093111,412,248,164,421,249,172,629,371,243,476,285,159
060670093112,872,544,328,884,539,345,1247,760,464,1084,669,352
060670093124,633,393,240,634,385,249,846,535,298,668,410,224
060670093123,810,542,268,823,532,291,1168,726,409,869,588,237
060670093122,456,320,136,465,313,152,840,569,254,538,381,134
060670093121,274,187,87,281,185,96,476,325,146,347,248,83
060670093291,292,200,92,299,197,102,357,218,132,298,189,94
060670093292,369,252,117,375,247,128,500,306,186,493,310,155
060670093261,696,408,288,712,406,306,1105,672,413,742,455,247
060670093262,590,319,271,603,318,285,950,576,357,595,330,235
060670093302,719,412,307,735,400,335,1355,734,591,738,426,272
060670093301,767,415,352,780,402,378,1087,585,482,854,475,336
060670089083,381,165,216,388,170,218,473,223,248,391,194,183
060670087021,1158,566,592,1170,561,609,1181,655,504,1049,536,458
060670087033,1005,479,526,1014,473,541,1185,638,528,997,509,441
060670087022,875,420,455,883,411,472,990,546,432,904,463,396
060670087032,242,124,118,244,127,117,486,279,189,325,167,131
060670087031,1035,529,506,1037,518,519,1213,696,488,971,491,413
060670087034,506,257,249,509,254,255,849,480,345,707,358,298
060670087062,120,64,56,121,64,57,54,29,25,127,61,54
060670087061,313,166,147,315,166,149,1000,558,420,36,17,15
060670087071,395,228,167,400,223,177,463,269,182,372,212,133
060670087072,30,17,13,30,16,14,11,6,5,29,15,12
060670087074,324,176,148,325,167,158,890,489,382,395,204,165
060670087075,862,500,362,869,488,381,1078,628,424,827,473,293
060670087076,413,221,192,422,214,208,540,297,232,483,248,200
060670087081,562,297,265,576,288,288,852,448,381,600,297,245
060670087082,14,7,7,14,7,7,47,28,19,39,20,17
060670087083,2,1,1,2,1,1,23,14,9,3,2,1
060670087084,0,0,0,0,0,0,135,80,51,2,1,1
060670087085,2,1,1,2,1,1,0,0,0,3,2,1
060670087086,456,239,217,464,232,232,616,326,276,515,256,210
060670086022,474,145,329,480,143,337,579,210,358,444,146,276
060670087042,30,17,13,31,17,14,23,14,9,22,13,8
060670087043,615,353,262,627,351,276,883,522,346,588,335,216
060670087073,93,54,39,95,54,41,430,254,164,80,47,28
060670087041,350,200,150,356,200,156,746,440,290,508,287,185
060670086021,356,113,243,362,108,254,459,165,286,327,105,205
060670093361,450,167,283,458,155,303,516,213,298,490,169,301
060670086011,1382,469,913,1407,465,942,1335,497,807,1096,366,652
060670086013,1059,351,708,1068,348,720,1410,536,847,1166,394,714
060670086012,938,323,615,942,315,627,1328,547,755,1153,422,675
060670094042,801,260,541,810,242,568,1101,394,687,880,280,564
060670096182,572,392,180,580,380,200,935,632,276,646,446,160
060670099004,181,81,100,183,77,106,293,142,146,214,96,108
060670096352,492,307,185,495,297,198,701,458,226,564,368,164
060670099001,431,220,211,437,209,228,624,330,285,494,253,212
060670096453,414,271,143,422,270,152,568,378,187,403,272,112
060670096451,799,530,269,812,528,284,1124,752,357,896,600,248
060670096442,863,579,284,875,577,298,1103,763,319,887,595,241
060670096441,595,396,199,603,394,209,764,532,221,582,389,158
060670096181,437,307,130,442,295,147,620,421,181,499,345,123
060670096452,429,277,152,431,273,158,675,475,188,546,364,150
060670096171,456,254,202,462,245,217,664,389,260,554,317,203
060670096172,1541,827,714,1566,804,762,1496,871,588,1398,762,554
060670096183,595,385,210,599,377,222,839,567,260,689,446,203
060670096222,347,225,122,347,218,129,455,306,141,443,238,176
060670096225,306,187,119,312,186,126,503,340,148,381,234,130
060670096224,1357,866,491,1380,849,531,1662,1102,531,1278,816,394
060670096223,677,414,263,689,410,279,924,609,297,785,491,254
060670096221,504,330,174,512,322,190,848,595,240,594,398,164
060670096492,217,149,68,221,145,76,449,301,144,333,218,102
060670096493,449,304,145,456,297,159,668,457,198,544,362,161
060670096481,693,462,231,706,459,247,1173,787,365,930,623,258
060670096482,320,214,106,322,211,111,511,340,163,369,246,107
060670096491,743,500,243,760,492,268,1265,861,382,630,428,163
060670096351,740,471,269,752,462,290,983,665,299,743,487,211
060670096353,885,606,279,896,593,303,1360,967,377,959,632,272
060670096462,870,609,261,890,609,281,927,635,282,837,569,221
060670096531,135,50,85,136,44,92,212,89,113,145,52,80
060670096533,184,69,115,186,61,125,202,75,123,208,72,124
060670096143,604,417,187,616,413,203,959,652,284,853,583,223
060670096431,532,359,173,542,352,190,886,604,262,632,415,176
060670096433,852,565,287,873,561,312,1133,765,338,918,612,252
060670096421,523,362,161,532,361,171,911,641,255,727,512,175
060670096432,501,341,160,505,329,176,669,455,196,559,355,171
060670096434,493,323,170,505,324,181,631,426,191,488,319,137
060670096161,668,375,293,677,367,310,913,532,357,741,414,286
060670096162,366,206,160,369,200,169,474,276,187,373,207,143
060670096163,993,581,412,1012,580,432,1300,804,456,1045,640,334
060670096164,508,292,216,519,291,228,891,533,335,563,333,195
060670096324,585,393,192,588,382,206,648,429,209,578,384,165
060670096321,474,316,158,480,315,165,691,462,215,491,329,137
060670096322,731,500,231,740,494,246,1208,794,390,810,561,213
060670096323,1119,720,399,1134,710,424,885,581,288,675,472,173
060670096501,31,23,8,31,22,9,254,181,70,26,20,6
060670096502,28,23,5,27,22,5,597,424,162,145,100,38
060670096503,20,16,4,20,16,4,614,442,168,96,68,27
060670096512,712,419,293,720,418,302,2316,1476,800,1110,687,360
060670096511,353,208,145,357,206,151,607,371,232,729,424,272
060670096473,648,459,189,667,464,203,995,683,294,885,634,206
060670096472,510,361,149,518,362,156,867,604,249,633,450,145
060670096471,656,454,202,665,451,214,1004,676,306,712,498,168
060670096461,612,416,196,625,417,208,750,509,230,542,345,166
060670096372,925,620,305,940,629,311,1467,1027,421,1056,714,277
060670096373,691,466,225,710,467,243,1079,734,323,871,603,219
060670096371,334,225,109,339,227,112,502,364,130,378,253,98
060670098001,480,252,228,489,247,242,538,262,260,424,216,177
060670098002,218,105,113,222,105,117,507,241,255,277,125,136
060670099003,191,89,102,194,90,104,246,101,137,269,125,130
060670099002,407,180,227,412,175,237,454,223,224,346,155,172
060670096391,333,239,94,337,234,103,397,276,119,266,197,59
060670096392,264,191,73,269,188,81,531,366,159,307,227,69
060670096393,477,344,133,484,336,148,682,482,191,560,395,133
060670096122,880,593,287,890,585,305,1154,758,370,759,497,209
060670096123,987,661,326,1000,649,351,967,624,319,792,482,262
060670096121,448,296,152,455,295,160,560,368,180,550,330,187
060670096111,383,249,134,383,238,145,578,382,182,383,247,116
060670096112,779,510,269,781,482,299,1181,776,371,1453,961,399
060670096522,1424,946,478,1445,927,518,1160,812,337,618,428,158
060670096521,58,39,19,60,39,21,609,441,156,35,25,9
060670093351,401,278,123,410,277,133,815,536,267,539,391,121
060670093352,448,308,140,457,304,153,867,564,290,492,360,111
060670093231,1343,726,617,1369,701,668,1796,965,782,1636,854,685
060670093232,1117,631,486,1131,600,531,1590,963,583,1000,594,354
060670093343,492,325,167,501,324,177,800,534,256,494,335,136
060670093341,934,604,330,957,600,357,1382,882,483,1046,674,323
060670093331,713,466,247,724,452,272,1113,710,383,685,468,186
060670093141,556,375,181,562,362,200,1068,687,354,771,506,221
060670093142,960,569,391,973,554,419,1253,722,509,1092,637,389
060670093143,419,224,195,424,221,203,549,300,240,425,197,202
060670093081,701,353,348,725,348,377,1010,534,448,711,358,289
060670093082,1139,572,567,1165,560,605,1383,729,611,1212,536,588
060670093083,601,307,294,610,295,315,802,422,354,663,301,315
060670093071,644,303,341,657,299,358,1023,505,491,806,377,370
060670093072,895,486,409,911,473,438,1069,576,462,997,556,394
060670093073,712,309,403,726,308,418,889,403,456,653,275,329
060670093091,787,354,433,800,342,458,922,434,464,876,333,469
060670093101,544,246,298,557,241,316,885,417,443,642,287,304
060670093102,604,271,333,614,261,353,980,426,524,769,333,376
060670093092,355,159,196,359,152,207,465,209,244,379,145,204
060670093103,715,327,388,728,323,405,862,417,420,738,335,348
060670093104,555,257,298,563,254,309,702,333,347,474,223,215
060670093105,373,194,179,384,183,201,547,280,249,545,231,273
060670093312,931,512,419,945,508,437,1276,756,498,984,596,331
060670093313,582,316,266,586,308,278,875,526,337,778,466,269
060670093321,630,306,324,635,305,330,928,461,449,708,293,380
060670093362,538,270,268,549,259,290,769,367,386,595,253,308
060670093363,839,320,519,850,300,550,1092,439,625,795,331,423
060670093311,531,299,232,536,289,247,691,414,266,537,302,205
060670093314,756,440,316,768,433,335,1145,672,454,694,399,257
060670093281,329,195,134,333,189,144,715,420,279,398,235,142
060670093282,1012,596,416,1030,576,454,1544,909,598,1120,665,403
060670093283,520,273,247,533,266,267,888,526,347,502,286,186
060670095021,682,243,439,695,232,463,1161,414,715,917,331,525
060670095033,279,122,157,284,116,168,316,141,166,311,124,167
060670094031,949,282,667,950,258,692,1140,363,750,1000,292,652
060670094091,815,330,485,829,317,512,1236,505,703,688,277,371
060670094081,731,254,477,752,247,505,961,335,612,802,306,445
060670095022,1046,436,610,1065,418,647,1413,570,794,1145,454,601
060670095023,405,194,211,407,184,223,613,298,289,464,206,223
060670095031,312,151,161,321,148,173,482,227,237,365,160,176
060670095032,200,96,104,207,96,111,308,148,151,249,109,121
060670095041,694,329,365,697,312,385,1035,481,535,613,287,293
060670095024,405,198,207,408,188,220,606,306,283,487,221,230
060670095012,469,221,248,475,212,263,703,326,361,586,296,261
060670094102,429,192,237,441,185,256,647,290,342,638,270,322
060670094103,734,324,410,748,309,439,989,436,526,707,297,359
060670094092,880,393,487,895,380,515,1301,589,674,989,418,512
060670094101,748,300,448,760,288,472,1081,430,612,844,329,452
060670094043,647,202,445,654,186,468,796,258,523,734,233,467
060670094044,885,268,617,895,246,649,1105,353,721,897,280,573
060670094041,757,208,549,768,201,567,1058,320,709,835,239,552
060430002003,331,133,198,329,132,197,405,142,252,358,110,226
060430003021,415,181,234,416,179,237,476,227,241,430,185,216
060430004001,471,387,84,467,390,77,588,483,81,536,403,76
060430001011,556,277,279,560,279,281,449,215,226,466,212,217
060430001012,543,237,306,549,235,314,559,244,300,489,195,264
060430004002,127,65,62,126,66,60,144,84,58,152,71,68
060430003023,402,148,254,405,145,260,717,270,434,600,194,364
060430002001,858,257,601,863,246,617,1089,339,728,865,254,567
060430002002,281,89,192,278,84,194,358,117,236,304,91,197
060430001013,607,232,375,617,230,387,575,256,307,524,195,297
060430001022,386,98,288,389,95,294,704,194,497,603,140,437
060430001014,290,84,206,295,85,210,444,137,294,385,105,260
060430001021,561,228,333,569,223,346,843,336,481,725,267,410
060430003011,630,223,407,637,222,415,561,204,343,464,139,306
060430003013,498,192,306,500,195,305,750,302,429,596,198,365
060430003012,845,272,573,848,258,590,1082,363,691,923,239,609
060430003022,375,125,250,378,119,259,527,172,346,457,124,306
060270002001,503,232,271,512,232,280,596,288,298,557,237,288
060270002002,319,107,212,322,104,218,378,146,221,357,96,237
060270001001,660,271,389,668,265,403,907,401,494,739,260,433
060270001002,649,282,367,657,276,381,677,275,389,578,200,343
060270004002,553,297,256,566,297,269,804,433,348,619,281,299
060270004003,459,246,213,463,239,224,627,342,266,495,225,238
060270004004,232,139,93,235,134,101,379,237,127,288,146,113
060270003001,692,301,391,697,299,398,861,415,432,747,278,415
060270003002,747,236,511,756,241,515,915,323,578,826,233,540
060270004001,280,201,79,287,193,94,595,424,153,392,228,113
060270005001,453,215,238,453,202,251,451,203,242,400,160,220
060270005002,645,296,349,648,285,363,942,453,465,799,293,422
060270008001,181,127,54,177,117,60,226,146,73,225,134,73
060270008002,280,114,166,279,111,168,250,106,134,242,84,133
060270008003,289,140,149,287,133,154,459,231,213,445,191,226
060270008004,250,117,133,255,116,139,414,211,187,287,109,155
061130101044,237,163,74,239,159,80,377,267,98,234,150,66
061130101051,441,320,121,447,313,134,653,446,191,574,404,137
061130101042,326,225,101,328,219,109,278,195,75,267,170,77
061130101041,415,298,117,419,290,129,630,434,188,651,430,171
061130101032,281,186,95,284,178,106,727,417,290,500,314,159
061130102011,686,457,229,691,445,246,1330,877,433,587,367,189
061130102031,214,128,86,216,126,90,540,348,179,278,163,95
061130102032,287,205,82,288,196,92,636,428,189,454,304,116
061130102044,338,242,96,338,231,107,378,258,113,255,172,66
061130102041,294,210,84,294,201,93,474,319,142,328,220,84
061130102012,542,331,211,546,318,228,558,366,186,553,312,205
061130102033,217,128,89,218,126,92,689,439,227,300,173,103
061130102034,124,75,49,127,74,53,198,129,66,65,39,24
061130102042,261,159,102,263,159,104,351,230,118,308,185,107
061130102043,628,383,245,629,369,260,747,478,243,666,379,242
061130103151,514,334,180,517,323,194,743,469,253,512,292,180
061130103121,1059,654,405,1075,631,444,1531,924,580,1003,598,338
061130103122,639,405,234,651,391,260,937,563,352,764,422,287
061130103141,867,539,328,877,527,350,1249,757,474,770,459,267
061130103131,1165,763,402,1174,746,428,1070,690,350,1470,988,392
061130103132,968,614,354,982,604,378,1719,1068,602,980,580,338
061130103102,700,435,265,715,424,291,717,462,237,615,377,195
061130103103,299,195,104,303,190,113,366,235,123,299,193,84
061130103123,339,195,144,349,188,161,413,248,153,511,268,214
061130103101,350,229,121,355,223,132,445,287,148,379,246,103
061130104021,648,404,244,651,390,261,1001,606,376,720,431,243
061130103104,526,345,181,530,334,196,819,527,272,621,402,168
061130104022,944,589,355,937,561,376,1370,825,514,1034,619,348
061130101021,441,232,209,436,213,223,496,267,218,340,155,162
061130101031,315,190,125,310,173,137,510,285,216,360,216,125
061130101033,551,369,182,547,341,206,766,420,315,573,373,162
061130101043,335,235,100,333,223,110,585,380,196,362,215,125
061130106021,462,413,49,468,414,54,623,539,69,546,463,48
061130106022,438,400,38,438,389,49,648,568,58,465,390,33
061130106024,261,239,22,260,232,28,370,316,38,380,320,27
061130105012,767,700,67,775,703,72,701,625,52,1481,1237,100
061130107014,318,291,27,318,289,29,449,409,34,460,387,35
061130107011,780,690,90,781,685,96,509,451,43,552,460,52
061130107013,268,241,27,269,241,28,383,342,35,386,331,30
061130107041,1088,937,151,1088,931,157,1010,886,99,1267,1054,128
061130107012,544,496,48,545,493,52,986,866,89,825,717,47
061130107032,646,574,72,652,569,83,548,486,54,441,376,32
061130107033,417,368,49,423,366,57,922,802,98,772,656,64
061130107034,340,300,40,344,298,46,483,424,46,361,305,31
061130107031,397,355,42,396,350,46,517,452,50,536,459,36
061130105111,540,455,85,543,453,90,589,508,70,592,477,86
061130105112,989,831,158,994,826,168,1115,960,131,862,722,95
061130105122,785,673,112,794,677,117,734,635,86,1102,937,100
061130105131,527,458,69,529,456,73,435,374,51,583,508,44
061130105132,714,597,117,720,603,117,1081,932,127,580,480,58
061130105081,658,530,128,658,522,136,652,562,77,630,505,94
061130105082,677,555,122,682,561,121,639,549,78,944,769,113
061130105011,185,168,17,188,170,18,557,433,112,11,11,0
061130105121,638,519,119,644,517,127,961,829,113,812,661,104
061130105051,348,249,99,346,241,105,248,178,61,298,214,62
061130105052,561,417,144,558,411,147,950,761,172,435,258,153
061130106023,404,371,33,407,371,36,561,483,61,457,384,20
061130106111,755,666,89,758,651,107,902,778,99,845,692,86
061130106092,936,797,139,950,786,164,940,780,134,1119,893,147
061130106025,410,366,44,416,369,47,543,467,59,432,368,38
061130105054,594,488,106,604,497,107,772,635,117,886,708,117
061130105091,604,518,86,602,516,86,771,665,92,814,665,94
061130105092,1098,930,168,1104,929,175,1108,963,122,899,746,109
061130105104,638,527,111,645,528,117,534,461,62,801,634,117
061130106091,537,448,89,543,446,97,505,414,77,542,433,74
061130106102,1114,908,206,1121,895,226,1463,1203,224,898,687,140
061130106101,413,326,87,417,326,91,632,521,95,686,551,92
061130106081,453,379,74,457,380,77,835,692,126,410,350,30
061130106084,236,204,32,234,197,37,411,331,63,342,293,23
061130106082,581,472,109,586,476,110,630,525,88,917,734,126
061130106071,532,403,129,537,409,128,758,627,113,745,584,120
061130106072,428,342,86,425,335,90,531,436,79,393,316,57
061130106074,710,542,168,713,546,167,696,578,104,692,541,112
061130106073,491,336,155,493,336,157,530,429,90,525,371,127
061130106051,1187,922,265,1191,924,267,1342,1107,202,1141,887,182
061130104013,568,435,133,577,441,136,683,554,108,551,412,91
061130104014,539,383,156,542,383,159,576,455,107,523,375,98
061130105101,433,335,98,437,335,102,437,372,56,635,504,89
061130105102,858,744,114,856,732,124,942,813,112,502,428,48
061130106083,330,265,65,331,266,65,299,247,44,313,249,43
061130105053,1033,777,256,1045,796,249,1246,1021,192,948,722,159
061130105103,393,345,48,393,344,49,606,522,72,912,766,78
061130106052,466,358,108,469,362,107,703,576,108,579,446,98
061130104012,574,337,237,570,329,241,807,483,301,671,421,214
061130110011,797,413,384,803,396,407,1136,603,506,823,436,335
061130110012,393,281,112,392,274,118,1101,584,488,465,310,124
061130110013,610,388,222,610,375,235,1067,623,417,786,417,310
061130110023,585,296,289,586,282,304,547,321,219,546,265,242
061130110022,544,234,310,547,230,317,516,276,233,574,250,292
061130112032,579,251,328,586,249,337,543,292,243,637,279,323
061130111011,501,294,207,499,285,214,758,436,303,608,351,206
061130111012,533,307,226,530,289,241,721,418,287,565,329,194
061130112031,795,404,391,794,385,409,768,409,340,843,421,364
061130112041,825,389,436,830,366,464,954,532,392,821,372,389
061130112042,643,341,302,645,315,330,864,519,322,802,416,326
061130110021,479,208,271,480,201,279,533,285,238,550,252,257
061130111022,313,195,118,310,183,127,663,443,205,389,242,125
061130112043,374,230,144,372,210,162,1082,745,307,488,315,141
061130112101,495,358,137,487,335,152,602,415,172,514,355,133
061130111032,946,629,317,945,615,330,644,417,205,482,293,148
061130112081,804,541,263,811,534,277,1171,807,334,570,380,154
061130112082,884,593,291,886,583,303,2002,1375,572,1265,837,343
061130108001,541,338,203,538,330,208,537,336,191,618,375,204
061130108003,164,119,45,165,115,50,384,255,121,228,159,55
061130109011,802,488,314,801,461,340,891,552,312,787,453,272
061130109012,299,187,112,301,177,124,464,289,162,307,178,104
061130109013,445,289,156,451,279,172,789,494,278,506,304,160
061130108002,392,268,124,393,253,140,531,338,182,392,250,115
061130112083,339,152,187,338,140,198,484,261,215,353,179,146
061130109021,583,369,214,583,347,236,872,538,303,653,378,231
061130109022,569,376,193,568,367,201,909,560,315,659,404,196
061130111031,463,313,150,465,301,164,625,414,196,540,354,144
061130112102,485,340,145,489,331,158,646,430,199,586,398,151
061130109023,405,277,128,403,269,134,555,370,168,484,310,135
061130111021,307,202,105,309,195,114,419,278,129,390,252,107
061130111023,354,232,122,355,224,131,555,370,173,450,290,124
061130112091,679,456,223,683,448,235,1146,780,335,978,655,261
061130112111,550,370,180,550,360,190,748,513,217,628,417,170
061130112092,499,332,167,495,325,170,651,450,186,489,330,131
061130104011,524,211,313,530,194,336,645,282,346,597,247,298
061130113011,469,235,234,472,231,241,586,322,246,341,177,144
061130113012,216,133,83,218,127,91,305,191,107,255,162,75
061130113031,549,343,206,551,338,213,628,385,228,656,382,239
061130113021,452,266,186,458,273,185,563,332,214,497,284,170
061130113022,1,1,0,1,0,1,0,0,0,2,1,1
061130113023,806,453,353,814,435,379,1343,728,576,783,427,305
061130113041,397,278,119,400,266,134,570,390,164,476,306,141
061130112071,499,180,319,503,178,325,477,199,269,303,118,166
061130112072,858,351,507,855,325,530,932,395,501,874,352,469
061130114003,232,108,124,232,102,130,469,212,247,468,202,232
061130115001,624,298,326,624,283,341,312,151,156,323,151,148
061130115002,152,70,82,152,68,84,328,160,166,356,169,166
061130115003,590,281,309,594,266,328,1049,503,519,962,426,477
061130115004,163,80,83,165,78,87,503,242,250,356,158,178
061130115005,189,95,94,184,83,101,380,186,191,248,112,120
061130114001,506,220,286,509,191,318,472,223,241,421,170,225
061130114002,204,115,89,203,104,99,648,300,339,450,230,201
060290052071,396,110,286,400,115,285,296,87,209,252,66,173
060290052073,247,80,167,250,83,167,347,120,219,312,100,200
060290052031,587,171,416,599,183,416,843,248,582,696,174,487
060290052033,249,64,185,250,66,184,344,91,245,348,83,242
060290052032,719,194,525,726,194,532,938,241,683,834,187,605
060290052061,365,79,286,372,78,294,407,95,300,369,75,280
060290052051,239,64,175,243,64,179,429,116,300,352,87,241
060290052052,465,122,343,476,141,335,681,177,483,567,124,417
060290052063,241,78,163,242,83,159,407,131,264,331,95,217
060290052062,339,106,233,346,113,233,479,152,318,412,114,274
060290052053,286,92,194,291,100,191,449,146,295,326,92,217
060290005092,483,74,409,488,76,412,960,246,698,448,81,353
060290005091,545,79,466,548,79,469,650,128,514,672,105,548
060290048012,167,142,25,165,131,34,194,153,38,193,157,28
060290048013,211,180,31,212,169,43,356,284,68,230,189,32
060290049013,276,213,63,281,206,75,381,255,122,305,239,48
060290049011,101,78,23,102,75,27,223,151,70,150,120,24
060290046061,278,199,79,282,192,90,526,332,170,371,246,104
060290048011,238,183,55,240,181,59,295,206,88,300,234,58
060290050031,264,183,81,266,179,87,424,275,143,327,227,88
060290050032,197,138,59,198,133,65,437,281,140,356,249,88
060290050062,398,268,130,401,263,138,566,356,196,447,298,129
060290050061,405,281,124,412,275,137,491,319,166,360,249,96
060290049041,316,233,83,320,221,99,435,292,137,342,252,74
060290049042,313,230,83,318,220,98,499,330,156,363,266,79
060290049033,202,146,56,205,136,69,354,227,122,288,220,57
060290049034,226,163,63,227,151,76,281,181,98,263,202,52
060290049031,235,168,67,235,156,79,341,216,117,263,200,50
060290046074,178,148,30,181,143,38,314,231,76,238,200,28
060290046071,187,155,32,189,150,39,205,152,51,200,168,24
060290046072,202,169,33,207,163,44,430,317,105,282,238,33
060290048023,269,231,38,272,222,50,357,266,90,316,267,44
060290048021,198,170,28,200,163,37,418,298,103,308,250,40
060290048022,113,97,16,112,92,20,303,226,72,93,81,9
060290046073,110,94,16,109,87,22,177,134,38,145,117,20
060290049012,236,176,60,237,167,70,284,194,88,219,163,49
060290050052,307,229,78,310,220,90,400,273,122,368,266,92
060290050051,179,129,50,178,122,56,379,254,121,240,173,56
060290046052,458,310,148,462,295,167,832,527,294,547,407,107
060290049032,243,173,70,247,165,82,379,244,133,281,211,52
060290052083,667,129,538,671,128,543,683,126,544,592,82,494
060290052082,553,185,368,557,193,364,742,283,445,634,183,413
060290052081,239,76,163,242,83,159,284,103,176,240,67,159
060290055092,322,82,240,325,81,244,429,106,308,382,83,263
060290055101,382,112,270,386,116,270,582,169,394,520,129,347
060290055091,334,89,245,335,84,251,421,100,302,352,73,253
060290055102,362,71,291,367,75,292,568,129,426,521,104,381
060290047021,194,165,29,200,155,45,328,249,63,271,222,32
060290047023,177,147,30,180,136,44,204,155,46,168,138,26
060290047022,114,98,16,115,90,25,221,171,44,200,162,23
060290047042,134,90,44,135,84,51,257,176,81,162,117,41
060290047043,287,190,97,291,178,113,317,203,98,232,152,56
060290047032,90,64,26,90,61,29,263,180,75,229,164,51
060290047031,356,254,102,358,243,115,543,373,162,455,340,89
060290047041,274,199,75,271,190,81,474,332,131,274,209,48
060290001061,478,134,344,486,131,355,1019,272,705,715,159,505
060290051031,603,140,463,609,140,469,661,163,492,700,135,528
060290001041,572,110,462,578,113,465,679,149,526,669,119,520
060290001052,677,156,521,683,161,522,1293,292,966,913,170,699
060290001021,454,104,350,462,110,352,818,190,611,551,104,420
060290001022,393,96,297,400,103,297,663,161,485,528,105,396
060290005082,596,133,463,608,140,468,639,123,508,571,91,461
060290005081,410,76,334,415,79,336,457,86,360,426,67,343
060290001051,633,169,464,644,166,478,998,289,691,789,158,573
060290054051,203,75,128,208,73,135,396,154,227,330,114,184
060290054052,429,157,272,435,150,285,712,269,415,622,209,352
060290054061,378,139,239,385,138,247,383,146,218,283,98,156
060290054021,447,153,294,451,156,295,627,221,376,531,170,314
060290054063,520,172,348,531,169,362,711,261,403,611,196,368
060290054022,645,195,450,657,202,455,760,248,471,636,192,390
060290054023,696,242,454,709,239,470,855,317,506,715,219,431
060290054083,436,153,283,443,151,292,661,250,385,503,158,294
060290054082,470,151,319,481,150,331,691,248,415,521,149,324
060290054071,617,208,409,627,214,413,868,262,560,772,225,472
060290054081,473,157,316,482,152,330,633,226,373,617,166,390
060290054084,182,73,109,189,71,118,373,145,218,315,85,191
060290054091,362,123,239,365,116,249,664,240,401,499,146,304
060290054092,784,267,517,791,253,538,991,351,592,813,236,494
060290054072,644,182,462,650,174,476,1049,297,696,740,175,494
060290053002,227,80,147,231,78,153,564,213,332,431,133,259
060290054093,364,128,236,369,124,245,417,154,243,355,109,212
060290055093,1202,337,865,1219,328,891,1465,448,965,1145,296,770
060290054062,657,217,440,663,201,462,818,277,513,683,204,421
060290052072,451,177,274,453,178,275,679,296,371,561,200,333
060290054102,210,59,151,216,57,159,384,121,248,328,87,214
060290040011,305,164,141,309,153,156,516,274,232,322,173,134
060290040021,174,89,85,172,81,91,332,163,162,307,159,133
060290040022,526,283,243,530,268,262,707,368,324,625,325,269
060290041011,696,341,355,701,329,372,721,341,371,557,274,258
060290040012,250,158,92,252,144,108,404,232,164,320,198,103
060290041023,198,123,75,199,113,86,364,210,150,274,166,92
060290041012,176,90,86,174,84,90,246,121,124,213,108,96
060290041013,263,126,137,263,116,147,479,219,248,346,167,158
060290041022,155,76,79,157,76,81,305,144,151,318,156,140
060290041021,226,149,77,226,139,87,552,288,250,308,199,100
060290009143,855,312,543,863,309,554,882,346,523,891,295,553
060290009133,553,195,358,557,195,362,592,221,358,324,107,203
060290009132,332,147,185,337,142,195,686,283,392,433,168,246
060290051044,758,244,514,764,243,521,355,110,240,407,112,280
060290051041,850,231,619,855,232,623,963,311,634,732,206,497
060290051042,593,153,440,597,160,437,815,236,576,781,205,556
060290005103,340,85,255,343,89,254,458,127,322,399,112,270
060290005101,489,139,350,491,145,346,889,259,613,710,199,483
060290038183,570,176,394,580,173,407,1017,359,633,730,209,484
060290038141,597,164,433,602,172,430,999,277,701,701,192,477
060290005102,564,156,408,568,148,420,942,270,649,658,169,463
060290038142,514,118,396,522,133,389,785,210,562,619,149,444
060290009131,289,136,153,292,129,163,629,290,323,406,171,211
060290056001,301,107,194,312,106,206,320,98,211,254,75,156
060290056002,266,101,165,270,97,173,485,170,304,418,136,247
060290031251,285,194,91,284,197,87,471,314,144,407,269,116
060290030011,321,227,94,328,223,105,534,357,163,408,280,107
060290030012,195,132,63,198,131,67,283,190,89,224,150,62
060290030022,82,62,20,84,59,25,183,116,59,135,90,36
060290031252,169,113,56,171,110,61,325,212,106,243,163,69
060290031332,408,186,222,416,182,234,592,282,300,484,201,251
060290031322,399,203,196,402,185,217,754,394,341,624,288,297
060290031371,280,184,96,286,180,106,510,318,177,386,241,120
060290031372,266,176,90,267,171,96,416,265,145,306,183,106
060290031361,350,231,119,353,222,131,550,336,202,415,253,134
060290031131,451,264,187,457,260,197,732,440,272,579,334,213
060290031132,284,172,112,291,161,130,479,279,191,411,227,166
060290031121,416,200,216,418,202,216,641,336,293,531,236,263
060290031123,288,153,135,294,150,144,430,220,198,383,192,170
060290031331,317,149,168,321,143,178,444,207,228,365,163,184
060290031321,442,210,232,445,202,243,723,337,369,595,268,302
060290032171,342,199,143,344,195,149,634,374,245,507,292,191
060290032102,621,362,259,629,356,273,1201,693,482,743,420,287
060290031122,387,223,164,390,210,180,660,397,235,524,292,201
060290031241,344,174,170,347,171,176,624,329,283,460,226,204
060290032092,349,242,107,353,236,117,640,394,236,458,312,131
060290032161,557,335,222,565,321,244,1010,605,382,767,455,275
060290032112,330,221,109,338,221,117,519,315,193,419,288,116
060290032111,323,208,115,328,206,122,677,430,235,507,343,147
060290031242,513,284,229,518,262,256,890,481,390,626,308,278
060290032181,219,127,92,221,127,94,801,445,341,261,156,89
060290032182,272,158,114,276,158,118,584,324,250,60,36,23
060290032183,217,125,92,220,126,94,511,285,218,378,226,127
060290029011,304,187,117,305,181,124,497,290,193,398,222,140
060290029012,247,140,107,249,137,112,396,226,161,326,176,126
060290032101,707,443,264,710,429,281,1120,680,413,803,507,252
060290029021,354,232,122,354,224,130,534,303,207,526,330,171
060290029022,402,221,181,410,220,190,622,343,252,508,272,206
060290031301,500,251,249,505,257,248,868,446,395,655,317,294
060290032191,367,241,126,371,236,135,863,501,341,531,316,179
060290032192,647,407,240,659,399,260,1295,712,549,730,383,304
060290060091,453,101,352,452,105,347,456,118,328,396,79,300
060290060101,996,252,744,1008,248,760,1215,371,820,1056,253,751
060290060092,1021,266,755,1026,277,749,1415,411,972,1103,273,784
060290060102,975,235,740,993,236,757,1246,360,872,1073,247,768
060290055113,473,208,265,481,202,279,442,204,220,333,139,175
060290055112,169,73,96,167,69,98,144,67,76,110,45,61
060290055111,598,266,332,610,266,344,638,308,324,487,188,268
060290055081,370,151,219,373,147,226,623,291,310,525,189,303
060290065002,158,46,112,159,44,115,589,238,335,609,216,344
060290055083,349,161,188,350,163,187,543,283,242,438,190,228
060290055122,253,96,157,256,96,160,326,142,173,296,106,168
060290055082,361,123,238,362,125,237,578,235,322,465,161,278
060290055121,530,229,301,539,223,316,837,402,413,696,256,391
060290060062,509,118,391,519,123,396,368,99,261,319,66,238
060290060122,545,111,434,552,112,440,787,163,605,673,128,507
060290060111,934,205,729,946,207,739,1374,331,1023,1103,215,834
060290060121,610,133,477,619,130,489,918,230,662,680,143,495
060290065001,352,101,251,361,102,259,435,119,292,397,96,264
060290032221,617,110,507,626,98,528,838,174,651,698,126,544
060290060031,720,189,531,729,195,534,675,175,483,562,127,397
060290060032,378,109,269,383,109,274,764,204,541,688,184,465
060290060033,627,162,465,634,167,467,774,204,545,632,136,447
060290060061,930,207,723,950,213,737,1127,294,797,903,204,652
060290060063,370,76,294,374,79,295,670,165,494,538,101,414
060290060034,349,107,242,356,114,242,607,201,375,510,135,330
060290028132,110,68,42,110,66,44,200,120,77,155,92,49
060290028133,267,188,79,270,182,88,516,335,172,373,224,113
060290028143,354,192,162,359,195,164,546,301,230,455,242,185
060290028242,98,63,35,99,63,36,190,129,56,148,96,38
060290028241,78,51,27,79,50,29,174,117,52,152,104,36
060290028243,118,77,41,118,75,43,171,115,52,137,94,33
060290028141,235,145,90,237,138,99,345,203,132,277,152,107
060290028142,197,120,77,198,116,82,362,212,141,308,169,122
060290028154,217,132,85,214,125,89,368,218,142,315,175,123
060290028151,252,133,119,254,135,119,322,176,133,265,138,107
060290028153,226,119,107,226,121,105,389,215,161,329,173,133
060290028152,138,73,65,138,73,65,249,135,102,226,119,90
060290031341,675,365,310,682,357,325,1280,690,570,810,433,323
060290031292,168,84,84,174,82,92,824,378,427,443,202,216
060290031291,374,186,188,381,181,200,615,279,315,560,255,272
060290032172,382,225,157,388,218,170,592,337,248,506,274,203
060290031244,178,87,91,180,85,95,354,186,162,206,89,103
060290031243,265,128,137,270,126,144,492,260,225,346,147,172
060290031245,91,43,48,92,43,49,5,2,3,125,55,62
060290059001,114,48,66,119,47,72,181,78,95,176,70,89
060290059002,182,78,104,186,78,108,258,115,138,228,95,120
060290059003,361,161,200,360,153,207,563,240,296,433,177,221
060290060041,492,120,372,496,120,376,520,122,391,431,93,317
060290060042,185,57,128,188,59,129,245,72,171,271,70,188
060290058052,423,159,264,429,152,277,471,196,258,351,126,202
060290058031,273,111,162,277,109,168,384,167,200,296,108,162
060290055131,589,209,380,596,210,386,685,257,405,536,174,315
060290055132,159,64,95,161,63,98,308,128,169,241,87,132
060290058063,226,93,133,228,93,135,362,149,196,264,96,144
060290058032,370,160,210,374,160,214,622,282,318,501,197,259
060290058062,566,214,352,569,211,358,952,388,538,699,257,393
060290058061,334,139,195,338,134,204,716,299,398,435,161,237
060290058043,605,271,334,620,268,352,692,315,351,654,278,317
060290058041,296,135,161,302,132,170,622,303,296,364,159,171
060290058042,13,6,7,13,7,6,238,121,103,157,69,72
060290058051,363,125,238,363,124,239,764,332,411,533,191,302
060290055141,297,60,237,298,57,241,321,82,237,287,55,221
060290028252,321,155,166,321,154,167,453,232,213,352,160,161
060290028251,181,86,95,181,85,96,309,163,137,341,155,159
060290028131,287,142,145,288,139,149,448,245,190,384,186,179
060290061011,459,166,293,465,171,294,589,212,359,595,146,418
060290061024,647,196,451,660,198,462,872,272,572,558,166,351
060290061021,191,68,123,193,75,118,308,120,179,281,80,179
060290061012,528,169,359,534,170,364,649,214,422,463,137,297
060290061022,492,145,347,500,148,352,657,206,433,464,120,313
060290061023,353,100,253,357,99,258,624,190,415,428,141,250
060290061013,240,99,141,241,98,143,398,153,234,348,117,203
060290055142,474,127,347,480,126,354,645,193,438,577,146,388
060290055143,379,94,285,378,92,286,495,138,351,446,102,327
060290065003,190,52,138,191,46,145,299,93,196,267,64,185
060290031311,438,227,211,444,229,215,552,284,257,519,243,241
060290031313,408,209,199,414,211,203,826,422,382,613,287,281
060290031302,432,249,183,437,247,190,776,469,293,565,341,191
060290032091,404,222,182,404,213,191,649,353,281,508,276,203
060290001031,313,90,223,318,97,221,434,128,293,308,75,216
060290001032,197,63,134,199,67,132,311,96,207,229,56,157
060290001033,325,101,224,328,104,224,520,156,350,478,116,328
060290002022,197,68,129,195,71,124,428,132,290,310,80,207
060290002023,269,93,176,271,98,173,501,160,330,368,96,243
060290002014,116,39,77,122,44,78,272,83,177,183,48,127
060290003002,178,60,118,180,62,118,260,90,163,249,72,158
060290003003,136,53,83,137,55,82,236,77,152,181,56,109
060290003004,108,36,72,109,40,69,154,50,101,129,35,86
060290004001,164,58,106,168,63,105,316,97,207,292,83,186
060290004002,188,65,123,190,69,121,365,116,237,296,84,187
060290004003,207,67,140,214,76,138,388,125,255,304,86,201
060290002011,167,52,115,168,54,114,296,96,183,234,61,155
060290002012,161,58,103,162,59,103,270,95,165,236,66,151
060290003001,221,81,140,223,83,140,317,111,197,257,74,171
060290007011,436,215,221,439,213,226,644,325,295,513,233,249
060290007012,267,138,129,263,133,130,403,221,182,365,170,175
060290008002,227,126,101,227,125,102,425,233,180,318,158,142
060290008003,258,141,117,260,140,120,429,226,186,324,155,148
060290008004,207,112,95,210,112,98,284,152,127,229,110,105
060290008006,224,128,96,225,128,97,337,195,130,267,143,107
060290008001,277,159,118,279,157,122,481,278,187,390,209,159
060290009021,511,228,283,515,210,305,750,366,365,611,270,299
060290009141,518,225,293,524,216,308,680,318,348,589,234,321
060290009022,543,270,273,548,273,275,749,367,365,669,292,333
060290009085,162,82,80,162,81,81,300,146,144,235,103,117
060290009031,622,272,350,622,273,349,961,442,496,761,300,407
060290009032,185,80,105,185,80,105,255,125,123,235,110,106
060290009041,244,133,111,243,128,115,358,186,168,296,152,121
060290009043,382,214,168,384,214,170,660,340,306,538,271,238
060290009033,367,180,187,375,179,196,513,266,240,392,169,200
060290009084,296,140,156,299,140,159,491,234,239,378,162,189
060290009082,258,123,135,260,122,138,382,182,185,288,124,144
060290009081,361,158,203,361,149,212,431,195,222,404,158,222
060290006012,353,137,216,357,149,208,436,210,218,316,136,164
060290006011,159,61,98,162,66,96,293,127,160,326,133,180
060290006032,79,47,32,78,44,34,217,118,91,179,98,70
060290006031,91,55,36,91,53,38,202,124,69,158,99,48
060290009092,650,230,420,656,233,423,688,253,421,665,218,419
060290009122,385,157,228,389,158,231,649,298,336,505,182,301
060290009091,496,157,339,498,155,343,637,237,385,583,180,380
060290009142,219,82,137,222,81,141,406,163,233,264,84,162
060290009111,314,147,167,319,143,176,378,182,191,392,169,202
060290009112,377,176,201,381,171,210,680,324,339,453,195,233
060290018011,243,138,105,247,136,111,403,236,156,293,150,125
060290018014,344,185,159,350,177,173,433,239,188,452,213,215
060290018015,367,176,191,370,172,198,548,268,268,515,222,265
060290018012,80,40,40,80,38,42,272,133,128,133,58,66
060290018013,154,88,66,157,87,70,276,161,107,228,117,97
060290018042,311,150,161,314,146,168,466,242,210,388,180,184
060290018041,715,318,397,725,322,403,960,437,495,756,308,402
060290018031,406,158,248,407,161,246,574,238,332,483,167,293
060290018032,290,111,179,298,114,184,314,133,171,275,86,168
060290018033,167,64,103,170,65,105,383,164,206,306,95,189
060290009083,406,188,218,406,188,218,569,258,289,544,231,279
060290009062,377,205,172,377,199,178,535,278,246,422,216,168
060290009063,148,88,60,150,87,63,310,175,129,240,132,90
060290038062,718,206,512,723,206,517,952,310,625,690,190,471
060290038061,780,254,526,782,244,538,1082,391,662,940,269,618
060290038063,456,146,310,459,147,312,619,232,373,483,139,319
060290005051,895,194,701,903,204,699,1146,280,854,915,195,680
060290005052,967,213,754,985,230,755,1307,340,950,1119,230,836
060290010012,496,194,302,496,190,306,689,292,386,614,222,369
060290005071,1007,220,787,1016,227,789,1396,349,1024,1055,217,806
060290005072,429,130,299,436,131,305,565,187,373,443,121,298
060290038181,495,134,361,502,133,369,792,223,553,587,159,390
060290038171,619,170,449,623,180,443,894,259,622,720,198,491
060290006022,123,80,43,125,80,45,236,159,66,182,109,54
060290006021,109,71,38,111,71,40,264,183,74,205,124,61
060290009042,369,207,162,375,211,164,488,247,227,427,214,194
060290011061,164,125,39,166,122,44,307,209,86,233,163,47
060290011072,139,111,28,138,106,32,215,151,56,168,118,36
060290011071,125,87,38,126,85,41,152,104,46,144,105,31
060290009071,511,267,244,513,262,251,737,377,339,620,303,278
060290009061,303,183,120,302,177,125,418,241,170,325,185,121
060290009051,302,160,142,304,157,147,390,209,171,323,167,139
060290009052,276,147,129,282,145,137,476,255,207,404,207,175
060290007022,514,231,283,513,225,288,785,347,413,652,272,335
060290007021,353,140,213,351,138,213,443,186,252,365,137,207
060290038111,603,145,458,611,152,459,837,220,597,700,162,496
060290038112,332,78,254,334,85,249,542,119,413,465,90,352
060290038123,320,97,223,324,102,222,550,166,370,323,76,230
060290002021,148,54,94,150,63,87,250,93,151,221,54,145
060290011013,158,102,56,160,104,56,348,232,111,254,159,77
060290011011,230,159,71,234,163,71,375,261,107,333,221,90
060290011012,191,101,90,193,104,89,329,179,143,326,160,150
060290009121,320,110,210,326,129,197,578,243,325,405,161,227
060290002013,142,47,95,144,49,95,240,79,154,176,49,124
060290011051,89,63,26,88,58,30,144,97,43,129,92,33
060290011052,158,112,46,158,104,54,279,181,82,228,159,56
060290011053,158,115,43,164,108,56,253,173,79,198,142,50
060290011041,160,98,62,160,97,63,250,161,82,230,139,73
060290011042,171,104,67,172,104,68,259,166,86,238,147,74
060290005041,932,166,766,945,166,779,1203,254,927,1104,170,883
060290005042,387,120,267,389,118,271,438,156,274,439,118,299
060290005043,250,83,167,254,86,168,485,174,296,422,126,271
060290010032,386,241,145,392,238,154,606,358,231,491,287,179
060290010031,182,106,76,180,103,77,343,203,131,231,127,88
060290010022,244,138,106,247,136,111,474,267,193,406,232,147
060290010021,236,135,101,239,134,105,441,247,177,363,209,128
060290010013,208,99,109,207,98,109,327,145,172,286,126,143
060290038073,590,116,474,595,118,477,854,174,660,697,119,538
060290038102,655,154,501,664,154,510,889,238,638,745,163,548
060290038071,382,82,300,383,90,293,536,103,421,452,78,350
060290023031,172,118,54,173,117,56,260,151,101,215,142,67
060290023032,218,159,59,226,156,70,337,215,108,210,156,46
060290023041,206,156,50,208,141,67,243,169,70,230,157,60
060290023042,129,99,30,130,88,42,311,212,90,303,212,75
060290023051,149,113,36,148,106,42,259,188,67,222,168,41
060290023052,300,230,70,299,215,84,408,288,104,356,255,71
060290038172,456,136,320,454,129,325,740,240,488,591,166,389
060290038122,497,221,276,502,219,283,814,351,437,606,218,350
060290038173,605,180,425,610,179,431,768,243,498,644,167,430
060290038121,652,231,421,661,234,427,882,313,545,775,248,489
060290005061,524,173,351,536,177,359,416,144,266,311,89,201
060290005062,69,23,46,69,23,46,188,67,118,273,79,175
060290005063,73,24,49,73,24,49,461,163,287,298,86,192
060290038082,248,91,157,251,87,164,456,178,263,367,116,228
060290038083,498,162,336,499,165,334,805,285,493,621,209,372
060290038182,550,135,415,551,134,417,699,186,500,661,145,479
060290038211,772,257,515,783,258,525,1028,376,632,897,278,572
060290038203,399,137,262,402,144,258,599,234,352,457,148,292
060290038072,319,82,237,323,83,240,478,126,345,383,87,275
060290038081,668,186,482,679,184,495,1001,294,687,789,182,569
060290023033,259,159,100,263,155,108,316,176,126,267,168,84
060290028041,764,238,526,772,251,521,872,303,563,765,233,511
060290028042,744,232,512,752,252,500,976,349,610,901,286,587
060290028071,822,177,645,835,182,653,926,232,680,901,205,666
060290028073,295,108,187,296,109,187,451,195,250,385,146,223
060290028074,522,147,375,530,150,380,733,228,491,608,184,402
060290028181,788,295,493,795,297,498,1033,425,585,956,332,574
060290028182,779,297,482,783,295,488,1067,465,581,877,307,524
060290028192,711,326,385,714,311,403,1054,495,543,880,379,443
060290028191,555,227,328,564,238,326,878,386,464,707,289,391
060290028171,294,148,146,297,147,150,360,180,168,317,142,150
060290028173,222,120,102,227,122,105,423,240,169,357,193,143
060290028174,272,140,132,277,140,137,382,193,176,362,163,171
060290028172,285,155,130,291,155,136,477,246,212,388,183,174
060290028164,218,122,96,222,126,96,401,231,157,317,164,134
060290028163,205,116,89,208,116,92,329,173,145,256,125,114
060290028162,364,206,158,365,207,158,608,350,236,470,242,197
060290038263,604,142,462,611,139,472,936,205,708,298,52,236
060290038251,647,182,465,654,177,477,1423,431,958,596,154,413
060290038143,884,229,655,895,211,684,1455,404,1026,1285,309,918
060290028201,539,231,308,555,239,316,823,371,440,636,263,338
060290028161,202,111,91,206,111,95,328,190,129,269,147,109
060290038221,558,139,419,567,140,427,877,256,599,675,160,481
060290038201,534,137,397,544,139,405,690,206,471,578,146,403
060290038213,306,68,238,309,66,243,441,102,336,432,90,323
060290038151,765,257,508,777,251,526,1206,381,797,964,276,621
060290038161,419,106,313,424,108,316,647,205,425,571,147,398
060290038162,681,160,521,681,149,532,1090,251,820,843,193,613
060290038101,625,143,482,630,139,491,788,206,574,678,144,508
060290038191,479,144,335,483,143,340,697,239,449,662,199,428
060290038194,306,93,213,307,93,214,483,171,310,230,71,148
060290032031,1242,304,938,1253,303,950,1353,383,927,1145,243,848
060290028072,280,110,170,281,110,171,343,147,188,327,122,186
060290028111,993,242,751,995,243,752,1279,415,845,1047,304,705
060290028211,463,200,263,468,197,271,736,320,394,615,236,342
060290028212,332,132,200,336,130,206,508,209,294,425,167,242
060290028062,404,176,228,410,175,235,449,222,213,456,222,211
060290028061,179,76,103,182,75,107,333,160,162,271,123,133
060290038152,467,128,339,476,126,350,759,227,516,769,198,532
060290038153,491,129,362,496,130,366,780,245,519,642,154,460
060290028222,690,204,486,696,200,496,926,331,580,708,200,470
060290028223,429,134,295,434,135,299,547,207,329,442,147,272
060290028113,439,158,281,447,164,283,613,268,339,537,191,319
060290028112,446,161,285,453,168,285,609,263,333,515,181,307
060290028233,517,263,254,531,255,276,787,385,380,695,315,344
060290028231,208,104,104,213,102,111,439,221,207,241,106,120
060290028232,412,207,205,418,200,218,527,266,250,547,239,270
060290038212,748,204,544,754,190,564,1092,363,705,871,251,581
060290038202,514,116,398,515,117,398,952,268,677,812,209,574
060290028213,597,281,316,604,273,331,915,419,467,697,269,376
060290028204,266,118,148,270,113,157,489,225,250,354,136,189
060290028205,373,173,200,375,164,211,525,247,265,430,173,231
060290031352,440,234,206,444,226,218,733,392,337,832,402,380
060290032201,376,194,182,376,187,189,795,394,386,56,21,33
060290028202,399,199,200,400,189,211,643,301,319,515,222,268
060290028221,618,216,402,619,220,399,760,314,431,671,223,407
060290032121,909,303,606,920,295,625,1215,507,685,1131,380,694
060290032123,466,166,300,467,157,310,791,339,443,382,142,227
060290032124,498,208,290,501,200,301,744,352,378,615,255,337
060290032122,468,196,272,471,188,283,734,347,374,512,210,279
060290032131,471,135,336,475,130,345,1029,377,631,320,106,194
060290066001,205,118,87,208,111,97,320,142,173,244,137,96
060290033031,421,70,351,429,83,346,476,87,379,399,50,329
060290033043,56,23,33,57,23,34,373,81,282,465,86,364
060290034003,187,49,138,185,57,128,257,67,183,195,51,138
060290034002,183,49,134,182,54,128,275,74,192,209,53,147
060290034001,202,52,150,204,61,143,399,103,285,381,99,267
060290035005,339,54,285,343,56,287,481,81,389,428,64,355
060290033051,563,197,366,577,204,373,614,210,388,553,164,347
060290033052,185,68,117,189,70,119,250,88,160,246,77,151
060290033053,456,165,291,467,173,294,833,306,499,647,204,380
060290033082,450,136,314,462,144,318,588,179,395,523,152,347
060290038272,290,40,250,292,43,249,507,92,408,474,77,378
060290038231,832,122,710,841,126,715,1135,210,908,892,131,734
060290038271,458,94,364,462,94,368,727,158,553,341,64,257
060290038222,828,139,689,837,135,702,1041,201,822,841,134,677
060290045001,88,77,11,89,69,20,168,130,29,97,84,8
060290045002,143,73,70,143,67,76,262,152,106,184,116,63
060290033041,338,59,279,339,62,277,456,86,365,400,71,308
060290033042,262,32,230,265,34,231,399,47,347,345,38,291
060290033071,461,213,248,461,204,257,422,197,222,453,186,241
060290033081,306,106,200,313,109,204,439,148,280,312,91,198
060290038262,358,51,307,364,55,309,469,83,378,406,65,327
060290038261,230,33,197,233,34,199,422,76,342,175,33,134
060290038242,952,158,794,962,159,803,1089,221,854,1015,187,791
060290038192,277,60,217,285,61,224,494,112,379,392,85,300
060290038193,449,98,351,458,98,360,478,108,361,475,98,365
060290038241,59,8,51,60,9,51,186,53,128,129,27,99
060290038232,1005,167,838,1018,160,858,1415,275,1121,1189,196,948
060290036001,74,18,56,74,17,57,136,34,101,158,29,119
060290036002,145,35,110,150,35,115,310,78,226,239,47,184
060290035003,132,45,87,135,48,87,202,55,143,166,51,109
060290036004,263,63,200,263,60,203,373,94,268,313,63,234
060290036003,245,39,206,245,38,207,283,49,226,243,37,200
060290035002,238,62,176,245,70,175,350,87,251,271,71,185
060290035004,424,56,368,432,62,370,668,103,555,553,75,471
060290035001,429,76,353,431,81,350,289,52,234,174,25,145
060290044031,291,186,105,297,179,118,426,231,184,310,192,95
060290044032,188,115,73,192,108,84,340,180,150,155,103,44
060290044021,203,141,62,203,139,64,272,176,95,420,269,123
060290044022,74,52,22,75,52,23,111,72,37,122,95,22
060290044042,275,145,130,272,134,138,347,167,169,266,136,118
060290044043,330,209,121,337,196,141,399,218,176,297,203,80
060290044041,303,126,177,304,122,182,585,253,312,378,152,198
060290043032,203,145,58,205,134,71,442,285,145,307,195,89
060290043051,267,125,142,269,121,148,282,127,150,179,104,64
060290043031,473,329,144,478,309,169,790,519,249,592,368,183
060290044023,202,142,60,204,132,72,353,237,110,275,212,43
060290043041,239,151,88,245,139,106,529,310,207,280,166,88
060290031351,727,408,319,736,393,343,802,437,352,624,349,243
060290032213,517,254,263,519,249,270,1004,485,494,655,293,318
060290028203,451,180,271,457,178,279,650,276,364,539,214,288
060290031031,138,94,44,138,90,48,240,148,82,173,110,55
060290031032,197,133,64,200,132,68,516,346,152,273,181,75
060290031033,136,90,46,139,89,50,201,131,67,169,109,53
060290063011,313,231,82,319,226,93,379,267,102,307,232,63
060290063012,170,123,47,175,119,56,382,263,107,298,221,64
060290063031,262,210,52,258,196,62,432,327,98,364,292,57
060290063041,157,126,31,154,116,38,209,159,48,199,162,34
060290063042,148,122,26,154,117,37,216,167,47,202,167,32
060290063043,54,44,10,54,41,13,180,134,38,88,69,14
060290063033,115,93,22,117,90,27,191,144,45,161,128,23
060290063032,149,120,29,151,115,36,222,165,51,182,141,25
060290062023,293,244,49,293,223,70,422,310,96,231,188,31
060290062024,141,120,21,144,110,34,355,267,81,228,184,33
060290062021,147,123,24,147,113,34,226,169,53,224,180,30
060290062022,112,50,62,116,50,66,186,118,65,158,68,84
060290012022,140,112,28,138,106,32,239,168,61,231,177,37
060290012023,97,82,15,104,78,26,166,119,43,150,118,21
060290013012,115,94,21,118,88,30,199,140,56,179,141,27
060290013014,51,40,11,50,38,12,92,64,25,104,76,21
060290013011,150,126,24,148,111,37,241,171,61,185,149,28
060290013021,95,74,21,97,72,25,159,104,44,121,91,22
060290014012,127,99,28,129,99,30,207,147,54,180,131,37
060290014013,242,153,89,245,155,90,400,245,144,367,224,119
060290013013,57,46,11,57,42,15,130,89,35,121,87,28
060290013022,79,62,17,76,53,23,140,96,40,124,88,32
060290015001,156,117,39,158,119,39,186,123,55,198,147,42
060290015002,81,60,21,83,61,22,157,108,47,137,105,26
060290015003,97,73,24,98,73,25,151,107,42,155,115,30
060290021001,46,40,6,47,40,7,98,78,18,82,72,7
060290021003,101,87,14,103,84,19,154,124,27,147,130,11
060290021004,73,62,11,75,62,13,135,108,25,130,113,11
060290022021,114,96,18,115,96,19,199,159,38,170,146,15
060290022022,83,71,12,83,70,13,162,128,30,119,105,11
060290022023,116,99,17,115,96,19,186,150,36,170,151,13
060290021002,88,77,11,86,73,13,110,86,20,113,100,7
060290022011,118,106,12,121,100,21,178,140,28,164,145,12
060290022012,103,91,12,103,85,18,184,149,33,167,152,14
060290031281,304,233,71,300,225,75,433,305,122,317,234,64
060290031272,198,155,43,201,149,52,405,276,112,316,228,69
060290016002,168,117,51,167,114,53,270,175,91,181,96,74
060290017001,366,159,207,372,156,216,454,214,217,366,149,188
060290017002,401,176,225,406,177,229,486,240,240,526,223,266
060290017003,646,281,365,657,279,378,904,383,499,713,260,408
060290032072,376,275,101,379,265,114,605,414,177,435,318,94
060290017004,208,107,101,210,104,106,258,122,129,241,115,107
060290016001,276,184,92,281,188,93,495,297,174,321,195,97
060290020011,186,151,35,187,151,36,250,199,50,238,201,30
060290020012,237,196,41,241,191,50,369,279,72,293,250,30
060290020022,258,210,48,261,211,50,515,399,103,404,334,55
060290020021,164,136,28,164,132,32,321,240,62,307,259,32
060290032141,161,139,22,160,133,27,331,244,80,150,113,31
060290032082,290,238,52,295,224,71,513,356,136,393,286,86
060290025013,233,182,51,232,171,61,346,243,91,271,221,37
060290026001,141,109,32,142,105,37,228,161,58,195,141,40
060290026003,208,164,44,211,155,56,275,204,66,236,177,49
060290025031,163,134,29,165,134,31,246,204,38,253,203,40
060290026002,173,138,35,176,135,41,288,192,87,209,160,38
060290032071,386,298,88,389,284,105,666,472,179,580,441,102
060290031261,175,121,54,180,124,56,291,208,77,239,163,60
060290031263,279,188,91,278,184,94,477,301,162,392,268,104
060290032081,375,296,79,378,289,89,582,427,141,470,355,82
060290024032,88,65,23,92,65,27,233,165,57,204,152,41
060290025021,122,110,12,126,108,18,279,206,63,242,210,19
060290025032,97,88,9,97,85,12,128,99,29,147,128,11
060290024021,231,166,65,235,156,79,347,219,120,279,194,76
060290024022,268,192,76,272,183,89,565,360,197,324,223,85
060290031262,193,134,59,197,137,60,324,224,85,275,187,68
060290031282,411,265,146,418,251,167,653,387,251,533,323,182
060290031271,360,276,84,367,260,107,615,421,182,490,355,109
060290019022,181,103,78,186,104,82,265,159,98,239,125,92
060290019023,164,94,70,165,96,69,237,147,85,208,111,82
060290019024,347,195,152,348,192,156,550,319,208,503,255,199
060290019021,163,104,59,168,101,67,307,172,126,217,118,77
060290019011,287,149,138,295,148,147,456,242,199,382,178,170
060290019012,306,152,154,311,146,165,400,201,189,341,154,166
060290019013,208,104,104,211,104,107,341,171,163,266,122,129
060290019014,171,92,79,174,90,84,273,152,114,228,111,97
060290030021,205,150,55,208,151,57,347,231,106,277,205,66
060290032142,242,94,148,247,90,157,444,193,240,389,143,227
060290032151,456,181,275,464,172,292,534,227,299,506,187,296
060290025012,134,109,25,135,105,30,217,163,46,174,133,34
060290027021,127,78,49,126,75,51,245,138,101,186,93,77
060290027012,178,98,80,176,91,85,279,155,118,212,111,91
060290027011,318,174,144,327,170,157,520,282,220,463,238,197
060290027022,203,116,87,205,117,88,352,203,144,282,155,114
060290027023,147,84,63,149,85,64,224,125,89,183,98,76
060290024011,460,240,220,459,223,236,739,359,366,618,298,288
060290024031,188,87,101,192,83,109,230,109,119,203,88,107
060290025011,157,138,19,159,137,22,221,165,48,236,189,39
060290064041,180,131,49,181,129,52,243,158,76,199,139,51
060290064042,145,115,30,146,111,35,247,168,72,195,157,31
060290014021,144,111,33,144,106,38,257,182,67,205,152,44
060290014022,186,143,43,186,140,46,284,206,73,276,200,59
060290014011,151,119,32,154,119,35,250,176,67,215,161,44
060290012021,69,55,14,68,49,19,146,96,41,120,92,18
060290012024,45,37,8,45,33,12,99,69,28,91,69,14
060290064034,92,78,14,94,71,23,192,148,44,172,133,27
060290064033,205,170,35,205,152,53,248,189,54,199,152,30
060290064031,131,101,30,132,100,32,142,111,26,119,90,22
060290064032,101,78,23,102,77,25,227,175,46,186,139,38
060290064061,176,149,27,179,144,35,292,231,54,215,175,31
060290064062,173,144,29,175,140,35,262,201,50,203,158,32
060290064052,141,119,22,141,113,28,186,139,38,207,165,30
060290064063,162,138,24,164,132,32,286,230,56,180,156,24
060290064051,159,120,39,158,117,41,230,156,72,179,129,44
060290023021,158,129,29,159,127,32,279,212,61,255,204,40
060290023022,170,142,28,170,138,32,218,167,48,199,161,31
060290012011,242,189,53,239,179,60,316,217,92,252,184,52
060290012012,131,104,27,134,100,34,238,165,70,229,162,49
060290051032,405,73,332,410,80,330,456,82,371,389,76,297
060290046051,148,29,119,146,27,119,155,36,117,148,32,112
060290066003,533,142,391,533,138,395,637,168,466,572,141,405
060290039002,126,26,100,127,27,100,158,38,119,141,35,101
060290046011,0,0,0,0,0,0,1,1,0,1,1,0
060290053001,26,21,5,28,22,6,58,39,17,56,20,21
060290039001,340,97,243,347,104,243,891,346,523,101,24,75
060290032202,283,108,175,288,110,178,684,306,363,244,88,142
060290032203,139,37,102,141,36,105,318,141,171,142,36,105
060290032152,338,144,194,341,139,202,601,291,297,440,194,232
060290062012,218,76,142,220,69,151,352,142,201,239,94,135
060290062011,188,102,86,189,93,96,273,143,124,235,121,106
060290057001,61,32,29,62,32,30,150,87,51,126,52,63
060290057002,6,3,3,6,3,3,3,1,2,0,0,0
060290010011,206,82,124,204,85,119,260,104,150,218,77,130
060290032212,133,51,82,139,57,82,569,258,301,0,0,0
060290066002,222,69,153,224,67,157,379,142,227,289,101,170
060290032211,90,35,55,91,40,51,415,202,202,0,0,0
060290032083,241,176,65,242,172,70,566,358,192,269,189,68
061050001011,256,99,157,261,94,167,362,123,230,294,99,178
061050001021,980,431,549,993,399,594,611,304,289,570,249,278
061050001012,892,401,491,914,386,528,707,327,360,635,245,319
061050001022,575,246,329,587,229,358,965,418,509,810,297,430
061050001013,240,119,121,242,111,131,368,177,176,363,148,173
061050001023,475,205,270,484,194,290,727,331,376,601,241,304
061050005001,200,93,107,203,92,111,516,217,271,335,134,169
061050005002,265,133,132,270,125,145,517,249,244,445,185,215
061050005003,190,82,108,190,79,111,179,78,97,312,114,166
061050002001,505,275,230,511,272,239,660,367,266,639,318,251
061050002002,302,149,153,301,143,158,317,155,155,260,99,129
061050005004,369,134,235,369,126,243,329,105,215,324,85,200
060090003012,501,194,307,514,183,331,754,261,475,630,209,376
060090003013,547,206,341,556,190,366,774,261,497,704,218,430
060090001242,845,277,568,866,273,593,473,159,299,409,123,267
060090001211,750,304,446,769,291,478,909,337,552,768,273,428
060090002203,726,224,502,743,211,532,1126,317,786,909,234,619
060090003011,757,317,440,779,308,471,781,295,470,727,273,402
060090003021,694,291,403,718,279,439,825,336,460,820,325,416
060090002213,987,340,647,1007,325,682,969,308,637,772,236,487
060090002212,776,249,527,788,226,562,1187,351,816,956,281,623
060090002211,878,231,647,898,220,678,1147,310,815,946,234,664
060090002221,967,289,678,989,274,715,1202,333,844,969,256,653
060090002222,929,223,706,949,224,725,1254,292,939,1031,239,738
060090003022,505,231,274,515,226,289,489,207,265,507,199,259
060090004004,200,86,114,203,79,124,322,132,180,248,94,133
060090001222,228,97,131,233,96,137,350,155,193,353,139,193
060090004001,374,139,235,383,130,253,280,101,170,256,80,152
060090004005,192,81,111,197,74,123,275,110,156,295,100,167
060090004006,182,76,106,190,71,119,343,137,199,339,119,188
060090004002,172,63,109,177,60,117,293,106,179,239,73,142
060090004003,413,158,255,424,147,277,652,254,386,563,211,306
060090005011,598,293,305,604,288,316,718,376,328,609,274,291
060090005012,958,488,470,985,480,505,1358,707,621,1160,565,513
060090005041,206,106,100,206,103,103,306,167,136,265,131,120
060090005042,86,45,41,88,44,44,155,82,70,150,80,64
060090005061,443,224,219,458,224,234,465,247,209,409,194,185
060090005051,310,148,162,314,148,166,463,227,225,395,163,202
060090005052,250,124,126,255,123,132,290,149,129,263,119,120
060090001221,1109,584,525,1140,569,571,1001,521,462,871,404,406
060090001223,810,369,441,838,361,477,1329,588,707,1194,482,617
060090001213,712,282,430,729,269,460,862,344,497,669,240,389
060090001212,621,253,368,632,238,394,914,372,523,807,297,451
060090001232,617,201,416,631,192,439,520,165,344,360,105,237
060090001241,562,183,379,576,171,405,1045,329,695,626,173,419
060090001231,676,225,451,685,225,460,895,288,583,811,237,523
060090002202,727,225,502,743,212,531,1074,319,739,870,249,584
060090002201,812,236,576,828,231,597,1364,403,932,1138,315,746
060350402002,255,105,150,258,99,159,331,136,193,308,104,176
060350402001,364,145,219,363,141,222,433,165,266,336,107,191
060350402003,398,94,304,397,87,310,538,128,404,468,104,337
060350403022,620,115,505,631,113,518,885,163,708,795,138,627
060350404001,703,108,595,703,94,609,613,74,531,533,76,436
060350405001,595,110,485,602,108,494,775,128,634,651,111,507
060350405002,742,138,604,748,138,610,1057,187,853,923,158,714
060350406001,419,115,304,426,112,314,525,134,383,498,118,354
060350403021,440,90,350,446,85,361,649,123,512,588,108,447
060350403023,666,163,503,672,159,513,836,183,641,756,150,557
060350403031,360,84,276,362,81,281,573,139,426,490,111,353
060350401001,228,30,198,229,34,195,256,46,206,248,31,211
060350401002,334,58,276,341,58,283,435,93,331,409,75,313
060350403033,222,61,161,229,58,171,323,86,233,270,76,177
060350403051,658,174,484,665,170,495,885,244,625,678,162,481
060350403053,406,123,283,410,119,291,605,166,429,477,131,316
060350403032,335,79,256,338,82,256,438,120,306,406,101,273
060350406003,217,52,165,225,52,173,401,90,306,408,68,312
060350403042,169,48,121,168,49,119,275,90,172,221,59,135
060350403041,280,86,194,284,80,204,548,162,368,343,96,221
060350403052,295,91,204,299,87,212,277,78,188,346,104,218
060350401003,139,19,120,142,21,121,133,28,104,135,16,111
060350406002,19,6,13,20,9,11,74,21,50,9,2,7
060350404002,58,7,51,58,7,51,120,15,101,126,18,100
060110001001,201,87,114,208,84,124,174,86,79,155,71,70
060110001002,336,120,216,340,109,231,338,129,207,264,101,151
060110001003,586,258,328,591,232,359,868,366,484,766,350,379
060110001004,365,160,205,372,144,228,600,260,332,424,191,208
060110003021,264,85,179,272,79,193,261,65,191,234,59,163
060110002001,403,165,238,412,149,263,468,189,270,425,171,230
060110002003,296,124,172,307,111,196,513,233,272,446,197,220
060110002005,187,51,136,197,48,149,382,121,254,291,86,187
060110002004,398,122,276,405,110,295,356,120,227,300,90,191
060110003012,384,207,177,390,195,195,882,473,383,681,357,279
060110003022,232,170,62,235,157,78,308,221,80,256,196,47
060110003011,194,113,81,196,104,92,318,189,124,268,162,88
060110002002,441,122,319,449,104,345,469,135,321,362,99,237
060110004001,219,54,165,221,44,177,343,92,243,323,71,235
060110004002,281,64,217,286,56,230,420,111,305,363,90,258
060110004003,199,61,138,202,54,148,284,74,207,211,63,138
060110005001,96,33,63,96,31,65,264,97,158,199,68,111
060110005002,146,63,83,150,53,97,196,88,105,147,65,79
060110005003,259,83,176,260,76,184,257,86,168,278,96,165
060110005004,168,64,104,174,59,115,260,104,149,203,78,115
060390011005,260,78,182,259,81,178,382,127,251,324,99,217
060390011001,194,71,123,200,67,133,265,113,151,247,86,142
060390011004,246,103,143,242,85,157,341,160,175,294,118,157
060390005171,577,234,343,583,227,356,585,234,339,480,180,270
060390005161,977,264,713,993,258,735,1400,420,938,1127,284,783
060390005142,469,174,295,480,172,308,812,313,483,666,240,386
060390005141,170,62,108,173,61,112,367,146,218,258,97,154
060390005144,198,116,82,201,112,89,203,131,69,147,95,43
060390005143,274,211,63,272,196,76,479,354,110,360,265,68
060390005062,1063,511,552,1082,483,599,834,412,401,687,323,317
060390005151,261,156,105,264,146,118,424,240,175,302,177,112
060390006041,180,137,43,180,126,54,284,206,74,213,146,54
060390006043,228,177,51,233,164,69,319,230,81,249,171,62
060390006042,85,66,19,87,61,26,242,172,59,108,75,26
060390005094,918,249,669,923,240,683,1389,396,959,1079,267,759
060390005093,491,132,359,494,127,367,615,178,422,528,131,370
060390011002,1163,355,808,1175,337,838,2065,729,1290,983,269,676
060390001023,183,60,123,189,61,128,573,171,389,389,111,260
060390005091,870,237,633,873,226,647,1038,316,713,922,235,644
060390005092,426,117,309,430,109,321,526,160,361,451,115,320
060390002042,317,72,245,322,75,247,307,72,229,214,45,162
060390002031,174,38,136,179,37,142,217,55,160,195,42,145
060390002032,165,48,117,175,47,128,208,59,147,172,41,128
060390002011,107,53,54,106,49,57,431,232,191,362,186,154
060390002043,981,304,677,989,296,693,1304,422,863,1035,325,665
060390002012,137,69,68,138,65,73,56,30,26,45,24,19
060390005061,422,203,219,433,190,243,644,321,315,557,264,261
060390005063,514,245,269,522,227,295,817,398,392,657,310,297
060390005152,688,327,361,697,304,393,868,425,419,742,351,339
060390003022,388,138,250,389,137,252,535,192,330,456,147,278
060390002041,288,116,172,288,110,178,675,251,411,428,127,277
060390003025,175,53,122,176,54,122,206,69,136,221,67,140
060390003012,176,75,101,179,75,104,322,146,166,250,117,119
060390003013,259,108,151,265,106,159,214,91,121,161,73,84
060390003024,120,48,72,125,50,75,236,98,138,188,72,114
060390003023,129,51,78,129,48,81,183,75,106,193,70,115
060390003021,215,89,126,219,86,133,454,183,259,369,145,205
060390003011,255,105,150,260,102,158,377,151,210,286,124,145
060390005122,757,300,457,766,297,469,987,417,539,1328,540,717
060390005121,790,385,405,799,359,440,1092,547,531,764,376,327
060390005133,349,167,182,356,163,193,658,361,279,537,280,214
060390005132,266,65,201,264,76,188,348,103,235,327,90,223
060390005111,152,99,53,152,93,59,326,200,120,214,139,62
060390005112,296,189,107,299,177,122,468,286,170,292,188,83
060390005102,424,292,132,434,272,162,749,484,240,472,307,123
060390005113,545,388,157,549,367,182,586,353,208,452,292,124
060390008011,222,130,92,221,123,98,241,134,101,219,117,86
060390007011,956,439,517,972,413,559,1164,534,613,943,404,487
060390008021,102,55,47,105,49,56,172,93,73,158,88,60
060390008024,87,49,38,87,44,43,183,103,75,159,90,60
060390008012,206,125,81,208,121,87,356,217,130,254,139,103
060390009021,125,99,26,125,91,34,275,195,79,285,218,59
060390007023,353,177,176,355,166,189,430,211,205,363,166,178
060390007022,382,187,195,385,179,206,551,269,278,458,208,229
060390007024,170,83,87,173,81,92,312,152,153,270,121,133
060390007021,834,355,479,851,347,504,1266,583,654,471,194,249
060390007012,457,218,239,464,210,254,1040,495,518,864,386,424
060390005131,401,193,208,406,187,219,693,366,314,507,253,222
060390006023,114,87,27,114,86,28,254,187,60,170,129,33
060390005101,301,194,107,305,170,135,504,328,168,357,222,118
060390009032,212,166,46,216,160,56,483,332,137,381,279,76
060390009022,158,124,34,157,116,41,632,437,178,164,121,34
060390009011,141,114,27,142,108,34,193,136,48,143,110,25
060390009012,140,113,27,141,106,35,217,158,57,165,129,29
060390009031,118,96,22,123,92,31,211,147,53,168,123,30
060390006021,191,105,86,196,93,103,283,157,121,230,128,87
060390006033,185,139,46,186,132,54,295,206,82,206,158,35
060390006032,84,62,22,85,60,25,194,136,52,120,92,21
060390006031,188,139,49,189,134,55,344,241,95,231,177,43
060390006022,126,93,33,130,93,37,187,145,38,135,106,25
060390008022,69,51,18,73,50,23,119,82,32,106,74,26
060390008023,63,45,18,66,44,22,98,67,26,85,58,20
060390005182,115,80,35,116,78,38,277,179,94,191,133,45
060390005181,187,131,56,188,124,64,255,165,88,271,191,65
060390001032,477,159,318,484,158,326,580,212,357,533,164,341
060390001033,595,189,406,600,185,415,794,263,517,590,179,377
060390001034,633,201,432,643,199,444,812,262,539,725,217,467
060390001112,805,256,549,808,250,558,650,213,424,630,182,409
060390001091,669,184,485,675,183,492,903,259,631,795,205,550
060390001021,303,96,207,307,100,207,400,137,257,310,98,205
060390001022,302,110,192,308,108,200,376,140,226,362,119,223
060390001031,751,258,493,759,250,509,606,221,373,624,192,399
060390001043,359,119,240,361,118,243,470,172,288,376,117,237
060390001044,718,239,479,726,237,489,775,277,479,758,234,480
060390001024,333,126,207,339,121,218,499,189,297,440,146,268
060390001025,415,155,260,422,150,272,593,226,350,515,173,310
060390001111,467,157,310,470,153,317,636,221,401,511,154,328
060390001041,361,121,240,364,119,245,513,187,313,455,142,286
060390001042,546,184,362,547,179,368,866,314,530,766,239,479
060390001061,1276,423,853,1292,424,868,1600,570,987,1239,381,785
060390001062,684,229,455,692,229,463,910,305,581,762,229,489
060390001101,325,100,225,328,100,228,551,170,373,440,121,298
060390001102,682,208,474,688,206,482,1003,322,668,811,229,540
060390001104,275,83,192,276,81,195,328,104,218,322,90,216
060390001103,572,175,397,576,173,403,694,221,462,680,192,455
060390001063,592,198,394,597,198,399,815,281,506,665,203,425
060390001092,641,160,481,648,168,480,394,98,289,341,78,248
061030002021,1152,326,826,1166,302,864,860,192,654,691,143,513
061030002023,692,177,515,702,164,538,954,214,721,858,178,640
061030002022,372,109,263,375,99,276,529,117,402,449,99,328
061030003001,1158,270,888,1171,259,912,1177,257,892,990,213,736
061030004003,794,190,604,804,176,628,1337,357,961,1093,263,785
061030004002,965,214,751,973,200,773,1055,243,791,735,157,540
061030005001,451,137,314,454,127,327,750,273,453,1112,369,650
061030004001,913,239,674,928,217,711,1149,320,812,958,242,673
061030005002,329,114,215,335,111,224,423,150,266,302,97,184
061030005003,151,54,97,154,52,102,475,180,290,381,114,255
061030005004,225,91,134,225,87,138,369,155,208,231,85,134
061030006001,695,270,425,700,237,463,933,337,571,684,223,416
061030007013,165,64,101,167,63,104,258,112,138,186,65,109
061030007011,500,171,329,507,156,351,809,265,522,555,161,353
061030008001,308,90,218,315,83,232,387,108,270,355,91,236
061030008002,237,66,171,238,63,175,361,102,253,299,82,197
061030007021,329,133,196,335,129,206,585,223,344,421,144,239
061030007022,492,167,325,503,155,348,650,216,402,521,182,302
061030007012,340,127,213,344,118,226,613,219,369,490,173,280
061030001001,375,135,240,376,122,254,419,133,271,398,112,247
061030002011,507,142,365,510,124,386,499,135,352,436,116,299
061030002012,914,254,660,923,223,700,1495,408,1045,1089,293,743
061030006002,614,198,416,627,180,447,918,308,590,691,214,440
061030006003,665,188,477,672,168,504,802,225,557,646,168,434
061030001004,335,101,234,334,84,250,508,140,358,426,108,291
061030001002,803,222,581,818,204,614,1020,277,720,824,200,574
061030001003,267,82,185,269,70,199,476,138,327,416,108,290
061030003003,328,94,234,331,87,244,424,106,313,377,86,272
061030010002,779,222,557,785,211,574,907,283,616,740,227,490
061030011011,322,87,235,321,76,245,475,146,324,443,116,306
061030011012,333,87,246,341,81,260,453,140,306,393,103,273
061030011022,294,118,176,295,104,191,594,243,328,484,189,247
061030011024,302,118,184,305,105,200,471,195,267,397,163,204
061030008003,195,58,137,197,56,141,374,113,253,319,91,213
061030009001,289,75,214,288,74,214,423,124,290,333,96,227
061030003002,321,143,178,320,134,186,511,220,273,427,165,234
061030010001,599,163,436,604,154,450,922,278,621,806,231,528
061030010004,400,142,258,403,133,270,492,191,299,391,144,228
061030008004,225,87,138,228,84,144,340,140,190,303,124,153
061030011021,209,81,128,213,75,138,263,104,146,234,87,129
061030011023,146,56,90,152,53,99,178,75,102,154,58,88
061030009002,455,171,284,463,150,313,664,242,406,539,176,333
061030009003,460,148,312,465,125,340,619,203,403,507,146,329
061030010003,255,88,167,257,81,176,418,156,245,392,140,221
060690005011,964,556,408,976,548,428,1370,813,533,1133,599,465
060690005013,438,260,178,443,249,194,704,424,268,536,307,191
060690005021,614,395,219,619,375,244,993,625,345,631,381,213
060690005022,520,356,164,521,338,183,1034,694,317,666,457,171
060690001001,655,277,378,665,256,409,634,274,347,568,237,292
060690001002,707,372,335,715,362,353,811,390,405,598,293,270
060690001003,284,118,166,292,112,180,304,132,168,285,120,144
060690008022,9,5,4,6,3,3,570,324,237,5,3,2
060690008024,384,168,216,394,159,235,474,215,254,385,160,196
060690001004,496,249,247,499,247,252,588,309,269,466,230,198
060690002005,222,107,115,223,103,120,343,189,149,246,113,121
060690002006,603,431,172,618,437,181,789,536,230,601,401,160
060690002007,424,199,225,429,197,232,521,269,241,424,197,207
060690002001,272,122,150,272,116,156,327,150,171,290,129,154
060690002002,84,59,25,83,58,25,341,236,99,206,138,60
060690002003,570,387,183,559,368,191,684,486,185,616,405,159
060690002004,291,146,145,290,142,148,438,227,203,353,181,147
060690007022,328,165,163,337,163,174,559,274,267,436,215,198
060690006021,442,252,190,446,238,208,702,443,242,550,319,204
060690006023,488,284,204,497,275,222,668,424,226,583,340,201
060690007024,617,360,257,627,344,283,1124,631,466,586,332,227
060690006012,634,382,252,643,364,279,795,503,277,603,349,212
060690004003,168,118,50,168,113,55,249,169,72,192,133,46
060690004005,470,337,133,471,318,153,614,422,174,466,319,120
060690007011,539,384,155,542,366,176,922,641,257,546,374,137
060690004004,282,187,95,286,184,102,428,286,130,344,219,98
060690004006,245,167,78,242,157,85,307,230,75,261,193,60
060690005012,613,418,195,608,391,217,841,521,308,818,457,320
060690007021,962,580,382,970,547,423,1089,701,359,846,551,246
060690006024,31,17,14,32,16,16,19,12,7,43,24,17
060690007023,33,18,15,34,17,17,42,26,15,46,27,18
060690006022,325,189,136,330,179,151,499,316,175,389,205,160
060690006011,851,497,354,871,471,400,1221,747,435,991,573,353
060690006013,289,133,156,290,121,169,359,184,172,218,101,106
060690008011,765,341,424,776,329,447,1010,500,490,838,369,421
060690008012,901,400,501,913,389,524,1301,645,641,1070,460,549
060690008021,324,114,210,334,108,226,372,145,226,345,83,238
060690008023,436,178,258,444,169,275,521,227,278,480,195,251
060690003002,178,134,44,177,125,52,494,368,112,188,141,32
060690003003,409,326,83,408,312,96,748,576,153,486,386,67
060690004002,203,147,56,205,142,63,279,213,62,227,161,55
060690004001,412,296,116,412,286,126,589,438,142,454,320,107
060690005023,363,264,99,361,251,110,459,352,95,401,280,95
060690003001,488,423,65,491,395,96,722,581,123,524,447,48
060690007012,320,254,66,323,241,82,554,438,106,415,338,59
060690005024,245,204,41,247,193,54,409,322,84,324,259,46
060650456181,0,0,0,0,0,0,1,1,0,112,102,3
060659401002,0,0,0,0,0,0,35,4,30,39,6,33
060539900000,0,0,0,0,0,0,0,0,0,0,0,0
060670096532,0,0,0,0,0,0,536,366,163,0,0,0
060319818001,0,0,0,0,0,0,359,238,103,16,4,12
060319801001,0,0,0,0,0,0,210,57,150,98,25,69
060739901000,0,0,0,0,0,0,0,0,0,0,0,0
060959800001,0,0,0,0,0,0,0,0,0,0,0,0
060139900000,0,0,0,0,0,0,0,0,0,0,0,0
060014415253,0,0,0,0,0,0,150,105,41,1,1,0
060759901000,0,0,0,0,0,0,0,0,0,0,0,0
060419901000,0,0,0,0,0,0,0,0,0,0,0,0
060855120582,0,0,0,0,0,0,546,409,130,0,0,0
060855120581,0,0,0,0,0,0,661,490,154,0,0,0
060855120583,0,0,0,0,0,0,833,617,195,0,0,0
060290031312,0,0,0,0,0,0,1,0,1,0,0,0
061090042013,0,0,0,0,0,0,44,27,13,6,4,2
060239901000,0,0,0,0,0,0,0,0,0,0,0,0
060459901000,0,0,0,0,0,0,8,7,1,0,0,0
060879901000,0,0,0,0,0,0,0,0,0,0,0,0
060979901000,0,0,0,0,0,0,0,0,0,0,0,0
060790114001,0,0,0,0,0,0,724,354,347,796,586,124
060799900000,0,0,0,0,0,0,0,0,0,0,0,0
061030005005,0,0,0,0,0,0,382,148,220,208,67,131
060375991001,0,0,0,0,0,0,0,0,0,0,0,0
060839900000,0,0,0,0,0,0,44,32,10,0,0,0
060819901000,0,0,0,0,0,0,0,0,0,0,0,0
060379902000,0,0,0,0,0,0,0,0,0,0,0,0
060014272005,0,0,0,0,0,0,67,56,10,39,34,4
061119901000,0,0,0,0,0,0,0,0,0,0,0,0
060379010031,0,0,0,0,0,0,934,517,388,673,341,294
060590626531,0,0,0,0,0,0,726,487,230,0,0,0
060590524304,0,0,0,0,0,0,366,232,126,0,0,0
060590524392,0,0,0,0,0,0,378,252,119,0,0,0
060590524395,0,0,0,0,0,0,552,365,173,0,0,0
060376508021,0,0,0,0,0,0,890,572,302,419,265,128
060379903000,0,0,0,0,0,0,0,0,0,0,0,0
060590524337,0,0,0,0,0,0,662,441,209,1983,1281,609
060590524339,0,0,0,0,0,0,247,164,78,0,0,0
060590524334,0,0,0,0,0,0,354,235,112,0,0,0
060590524336,0,0,0,0,0,0,393,261,125,0,0,0
060590524335,0,0,0,0,0,0,810,538,257,0,0,0
060590524338,0,0,0,0,0,0,690,457,220,0,0,0
060599901000,0,0,0,0,0,0,0,0,0,0,0,0
060379901000,0,0,0,0,0,0,0,0,0,0,0,0
060379800031,0,0,0,0,0,0,2,1,1,1,0,1
060590524222,0,0,0,0,0,0,699,401,286,0,0,0
060590524305,0,0,0,0,0,0,453,294,153,0,0,0
060590755181,0,0,0,0,0,0,401,267,122,1,0,1
060019900000,0,0,0,0,0,0,0,0,0,0,0,0
060659800041,0,0,0,0,0,0,2,1,1,3,2,1
060530141094,0,0,0,0,0,0,9,6,3,328,205,92
060014100003,0,0,0,0,0,0,11,11,0,3,3,0
060610213284,0,0,0,0,0,0,1558,792,735,0,0,0
060610213282,0,0,0,0,0,0,900,450,422,0,0,0
060530141093,0,0,0,0,0,0,731,505,205,0,0,0
060014415031,0,0,0,0,0,0,69,49,19,0,0,0
060619900000,0,0,0,0,0,0,0,0,0,0,0,0
060375421063,0,0,0,0,0,0,0,0,0,0,0,0
060730092031,0,0,0,0,0,0,991,673,291,0,0,0
060290046031,0,0,0,0,0,0,0,0,0,0,0,0
060290046062,0,0,0,0,0,0,0,0,0,0,0,0
060590525182,0,0,0,0,0,0,520,352,157,0,0,0
060590524391,0,0,0,0,0,0,414,275,130,0,0,0
060590524393,0,0,0,0,0,0,306,203,96,0,0,0
060590524394,0,0,0,0,0,0,534,354,167,0,0,0
060590320663,0,0,0,0,0,0,1014,487,511,0,0,0
060590320664,0,0,0,0,0,0,1292,621,651,0,0,0
060590320665,0,0,0,0,0,0,938,450,473,0,0,0
060590320661,0,0,0,0,0,0,925,445,467,0,0,0
060670085084,0,0,0,0,0,0,435,270,153,0,0,0
060670070115,0,0,0,0,0,0,146,124,19,0,0,0
060730203042,0,0,0,0,0,0,592,303,278,469,204,235
060855043182,0,0,0,0,0,0,673,395,270,456,344,96
060379800301,0,0,0,0,0,0,0,0,0,0,0,0
060375766020,0,0,0,0,0,0,0,0,0,0,0,0
060590524371,0,0,0,0,0,0,376,228,140,0,0,0
060590524372,0,0,0,0,0,0,396,240,151,232,138,84
060014403382,0,0,0,0,0,0,189,140,45,145,116,25
060839801001,0,0,0,0,0,0,2,2,0,6,5,1
060590423202,0,0,0,0,0,0,241,142,95,225,129,85
060590639091,0,0,0,0,0,0,673,444,213,383,243,117
060590755162,0,0,0,0,0,0,198,151,43,0,0,0
060290008005,0,0,0,0,0,0,0,0,0,0,0,0
060379202001,0,0,0,0,0,0,378,185,182,248,147,81
060590524216,0,0,0,0,0,0,851,572,270,0,0,0
060590524213,0,0,0,0,0,0,553,370,176,0,0,0
060710021091,0,0,0,0,0,0,366,258,100,248,168,63
060750615072,0,0,0,0,0,0,0,0,0,0,0,0
060971513105,0,0,0,0,0,0,133,102,24,176,139,20
061119800001,0,0,0,0,0,0,0,0,0,0,0,0
061110036181,0,0,0,0,0,0,0,0,0,0,0,0
061110054042,0,0,0,0,0,0,1039,533,480,873,409,395
060759902000,0,0,0,0,0,0,0,0,0,0,0,0
060290043021,0,0,0,0,0,0,107,50,54,153,46,93
060375304001,0,0,0,0,0,0,7,5,2,0,0,0
060530141042,0,0,0,0,0,0,0,0,0,0,0,0
060290060021,0,0,0,0,0,0,0,0,0,2,2,0
060952530001,0,0,0,0,0,0,0,0,0,165,54,102
060290051043,0,0,0,0,0,0,622,223,387,411,134,263
060179900000,0,0,0,0,0,0,0,0,0,0,0,0
060659810001,0,0,0,0,0,0,0,0,0,50,21,27
060710022072,0,0,0,0,0,0,0,0,0,487,348,112
060759804011,0,0,0,0,0,0,0,0,0,0,0,0
060750179032,0,0,0,0,0,0,0,0,0,0,0,0
