GEOID20,Tot_2018_ag,D_2018_ag,R_2018_ag,Tot_2018_gov,D_2018_gov,R_2018_gov,Tot_2020_pres,D_2020_pres,R_2020_pres,Tot_2016_pres,D_2016_pres,R_2016_pres
060971525011,852,651,201,864,649,215,1137,897,216,885,639,184
060971525013,426,318,108,434,312,122,537,395,124,459,308,107
060971522044,524,380,144,534,376,158,719,531,172,468,346,97
060971526011,573,370,203,581,368,213,700,469,217,877,560,255
060971526012,1424,972,452,1448,957,491,1689,1239,399,1471,1006,370
060971526021,666,460,206,678,455,223,773,532,219,799,527,210
060971525012,649,483,166,660,475,185,816,604,185,711,482,167
060971525021,663,469,194,676,463,213,866,640,209,697,481,173
060971525022,496,361,135,502,356,146,645,478,153,593,412,144
060971517024,533,409,124,541,413,128,602,473,116,700,515,143
060971505011,374,291,83,380,287,93,451,353,87,422,307,85
060971505012,678,495,183,682,495,187,837,638,181,767,558,161
060971505022,395,303,92,400,302,98,420,327,88,446,325,96
060971516021,698,508,190,700,499,201,773,596,168,747,534,177
060971503041,449,354,95,454,349,105,503,379,118,488,348,109
060971503042,726,574,152,732,564,168,1007,809,177,768,555,170
060971502052,694,526,168,705,532,173,951,745,194,604,445,134
060971522051,440,293,147,449,292,157,516,368,140,471,321,121
060971522052,395,313,82,399,312,87,520,392,115,452,308,112
060971502053,634,473,161,642,466,176,770,584,172,702,508,155
060971503063,829,640,189,839,641,198,1146,932,194,871,660,156
060971502061,408,300,108,413,295,118,511,389,109,434,313,96
060971502062,400,287,113,405,289,116,331,237,87,426,304,106
060971524022,649,407,242,660,409,251,1108,776,305,1005,599,348
060971524012,1045,704,341,1062,709,353,1066,768,277,1620,1094,434
060971524013,712,454,258,725,456,269,916,640,262,1191,788,336
060971513091,572,374,198,586,379,207,689,460,210,623,378,202
060971505021,527,415,112,536,419,117,543,427,103,590,437,115
060971502043,677,490,187,684,482,202,869,648,203,737,536,163
060971501001,688,472,216,697,467,230,956,673,263,729,488,186
060971501003,254,164,90,255,160,95,259,170,83,278,171,85
060971516023,1111,782,329,1128,785,343,1241,947,281,1137,813,285
060971506123,389,231,158,388,216,172,476,292,175,442,234,165
060971517011,848,656,192,857,650,207,1033,813,194,869,625,187
060971515033,793,537,256,809,529,280,940,686,235,825,595,179
060971515043,711,509,202,728,517,211,847,647,182,655,467,141
060971515031,801,568,233,810,565,245,963,704,236,880,615,205
060971515032,639,457,182,650,462,188,767,583,165,682,484,155
060971515041,640,462,178,651,463,188,757,580,159,763,541,173
060971524011,1176,811,365,1191,806,385,1422,1011,383,1186,811,300
060971526013,501,351,150,506,340,166,585,439,134,534,367,135
060971526014,900,622,278,908,609,299,1103,820,256,916,630,232
060971526015,375,271,104,379,267,112,446,351,88,385,280,88
060971516011,484,331,153,487,329,158,533,403,128,507,345,140
060971516012,782,541,241,793,545,248,825,598,219,840,581,230
060971516013,882,630,252,893,636,257,971,746,217,906,647,231
060971517022,526,362,164,538,364,174,640,484,143,530,390,109
060971502041,562,406,156,573,400,173,676,528,137,627,454,139
060971502042,709,553,156,721,550,171,814,647,145,759,568,147
060971502031,867,622,245,880,618,262,1137,842,274,925,641,229
060971535012,705,536,169,710,532,178,846,635,192,714,514,135
060971535014,712,533,179,717,526,191,845,603,223,719,491,162
060971535024,789,598,191,804,602,202,993,745,228,783,556,156
060971535013,618,452,166,626,443,183,729,513,199,637,429,145
060971532023,255,181,74,261,178,83,374,261,104,299,208,67
060971533012,449,300,149,463,298,165,617,425,177,536,354,136
060971510003,671,477,194,684,477,207,845,635,194,796,556,190
060971512052,933,629,304,948,628,320,1161,784,347,938,605,262
060971509015,471,380,91,477,381,96,612,489,111,442,341,74
060971509021,587,444,143,599,445,154,716,545,153,521,379,104
060971506112,289,202,87,298,206,92,380,277,96,306,208,76
060971512031,402,283,119,411,285,126,377,282,88,511,344,127
060971512032,726,515,211,739,514,225,1098,699,361,698,468,172
060971512033,530,377,153,543,379,164,658,500,144,582,394,143
060971512034,690,513,177,706,515,191,880,689,170,770,531,176
060971513011,585,423,162,595,416,179,727,514,189,656,431,163
060971513102,556,403,153,562,394,168,768,568,179,581,385,144
060971513111,454,321,133,464,323,141,730,528,183,526,359,131
060971508001,467,381,86,476,384,92,573,470,91,500,390,69
060971508003,443,363,80,454,364,90,515,426,82,445,350,62
060971508004,1211,940,271,1240,950,290,1469,1170,263,1208,933,196
060971509023,449,358,91,459,362,97,531,429,87,479,375,73
060971509024,403,343,60,409,346,63,493,418,66,427,349,53
060971508002,538,456,82,545,453,92,660,545,99,557,439,67
060971507012,1041,813,228,1059,809,250,1297,1019,248,978,739,177
060971507013,555,475,80,566,478,88,827,689,113,607,501,72
060971507014,434,346,88,449,352,97,500,408,80,455,357,68
060971507024,576,451,125,593,458,135,708,570,120,587,456,93
060971509011,467,391,76,471,393,78,459,388,64,537,425,76
060971509022,481,387,94,491,388,103,589,466,109,531,400,93
060971507021,769,574,195,780,564,216,953,723,207,801,578,167
060971507022,545,397,148,550,393,157,643,481,145,554,403,114
060971507023,883,660,223,905,663,242,1038,795,212,966,707,197
060971506092,463,331,132,471,327,144,562,401,151,476,313,136
060971506093,451,332,119,458,328,130,578,419,142,486,339,113
060971506094,407,300,107,416,297,119,505,368,123,453,317,104
060971506101,510,377,133,518,371,147,650,472,159,569,397,132
060971506102,984,706,278,1003,702,301,1241,895,314,1047,725,255
060971506103,383,281,102,388,277,111,500,362,123,433,301,100
060971506031,862,649,213,872,637,235,1133,836,271,949,693,192
060971506021,548,391,157,553,384,169,707,518,173,730,499,179
060971506023,900,638,262,911,627,284,1156,817,313,979,655,246
060971506113,556,400,156,572,402,170,709,524,167,475,327,114
060971506121,1324,936,388,1350,932,418,1701,1242,425,1450,982,364
060971506011,522,380,142,528,373,155,668,483,167,668,461,151
060971506012,260,195,65,265,196,69,341,258,71,599,421,133
060971506013,265,200,65,271,201,70,379,290,80,285,199,64
060971506014,753,556,197,769,555,214,1106,816,256,379,258,90
060971506114,481,332,149,496,338,158,668,481,171,576,387,148
060971506122,245,172,73,249,172,77,344,257,79,275,181,71
060971506111,446,307,139,460,312,148,565,403,146,505,339,129
060971506074,1364,900,464,1387,891,496,1981,1356,579,1466,953,413
060971506073,460,302,158,474,304,170,564,391,164,502,330,138
060971506091,722,523,199,738,525,213,1029,766,244,799,574,181
060971506071,512,367,145,525,367,158,659,474,169,551,381,134
060971513112,504,352,152,515,354,161,620,445,161,586,397,149
060971513113,535,372,163,547,373,174,763,518,219,648,429,167
060971513115,489,352,137,502,355,147,938,635,288,496,323,137
060971512061,239,188,51,242,184,58,873,664,185,559,395,118
060971512063,519,391,128,527,385,142,674,482,170,653,445,153
060971513081,1233,868,365,1255,847,408,1292,851,410,982,628,288
060971513104,548,394,154,563,388,175,392,242,143,327,213,84
060971513114,414,289,125,422,289,133,576,412,147,504,343,127
060971514061,603,488,115,611,483,128,877,666,187,406,297,80
060971514031,848,648,200,866,635,231,1365,1031,305,1217,889,236
060971514042,277,225,52,279,226,53,397,306,72,314,232,54
060971514032,684,506,178,699,497,202,999,736,240,816,575,180
060971515051,324,222,102,325,213,112,381,281,87,329,226,79
060971514052,465,358,107,476,351,125,727,526,177,697,491,141
060971514051,125,95,30,126,92,34,200,147,48,162,110,35
060971514054,334,251,83,338,245,93,522,383,126,436,294,101
060971514053,185,128,57,184,128,56,265,187,65,220,147,53
060971513092,1409,970,439,1433,963,470,1529,1034,469,1271,805,378
060971513093,837,582,255,859,577,282,765,577,170,616,404,174
060971530032,237,185,52,242,185,57,323,246,71,296,215,56
060971530033,479,370,109,483,366,117,683,510,150,601,441,105
060971518001,691,569,122,696,571,125,826,668,146,843,639,147
060971523003,772,582,190,778,582,196,962,750,191,748,555,149
060971523001,744,583,161,754,579,175,853,681,150,816,616,143
060971524023,636,476,160,644,472,172,806,620,161,678,494,142
060971520001,460,383,77,467,384,83,602,497,84,577,451,78
060971520002,350,294,56,352,294,58,439,360,70,371,287,53
060971522033,353,289,64,358,286,72,467,374,81,374,292,52
060971522034,526,449,77,535,445,90,700,590,82,557,442,68
060971521002,324,253,71,330,252,78,442,361,68,344,256,65
060971522014,404,337,67,408,333,75,428,358,57,384,301,54
060971522032,432,369,63,440,365,75,646,556,80,420,331,53
060971523002,605,481,124,608,478,130,681,557,107,602,461,96
060971523004,475,371,104,483,372,111,523,423,92,497,378,86
060971522011,417,327,90,420,326,94,556,439,96,473,353,82
060971522012,491,401,90,496,397,99,626,523,90,510,394,78
060971522013,495,408,87,504,407,97,552,470,76,504,396,73
060971528042,486,376,110,499,369,130,609,448,140,612,443,114
060971528032,365,293,72,372,284,88,520,400,108,425,311,77
060971528033,234,198,36,239,196,43,349,287,56,274,207,42
060971530012,605,460,145,618,452,166,826,611,181,649,462,133
060971530014,279,230,49,281,227,54,420,336,69,310,231,51
060971530013,640,487,153,650,475,175,841,629,183,698,495,142
060971513052,444,354,90,450,353,97,598,424,144,517,372,103
060971513051,563,449,114,569,446,123,808,622,162,650,466,129
060971513053,513,386,127,515,376,139,803,581,198,583,399,133
060971513061,309,221,88,316,214,102,577,402,155,351,230,91
060971513062,398,276,122,408,268,140,539,402,121,489,312,138
060971513101,228,163,65,232,158,74,333,245,79,247,161,64
060971513103,335,239,96,343,233,110,449,331,106,385,252,100
060971513012,332,254,78,336,249,87,416,300,104,386,264,84
060971513013,476,379,97,481,370,111,688,551,117,546,390,109
060971513071,743,513,230,754,508,246,994,680,284,820,552,213
060971513073,531,357,174,542,351,191,700,496,190,600,386,165
060971513074,510,346,164,521,341,180,680,468,196,568,372,152
060971513082,591,410,181,605,404,201,667,458,192,629,426,163
060971513083,368,257,111,376,255,121,894,654,219,774,536,186
060971513063,657,449,208,663,436,227,866,595,253,940,609,266
060971513072,467,311,156,476,307,169,619,393,209,514,323,154
060971541002,671,427,244,677,423,254,881,583,271,746,457,223
060971539051,465,328,137,466,330,136,595,448,134,503,340,121
060971539033,421,320,101,430,321,109,530,415,105,474,351,87
060971539031,590,433,157,596,437,159,699,536,152,602,441,124
060971530064,610,469,141,623,465,158,873,648,202,811,549,195
060971539053,168,104,64,169,101,68,210,146,60,184,106,63
060971527024,105,61,44,104,59,45,146,83,58,133,75,47
060971527023,630,442,188,638,436,202,892,609,264,745,490,194
060971529063,477,293,184,484,287,197,626,401,215,498,285,180
060971540003,835,582,253,851,574,277,1131,805,298,747,478,215
060971529031,299,224,75,303,221,82,448,308,126,375,252,93
060971529032,483,370,113,493,367,126,741,584,139,573,433,98
060971529041,692,510,182,711,508,203,940,712,209,698,502,144
060971529043,639,464,175,647,457,190,835,576,232,703,471,177
060971538073,212,145,67,217,145,72,248,170,72,254,162,76
060971529044,554,402,152,563,393,170,704,507,176,600,405,153
060971527022,464,318,146,468,311,157,720,516,188,645,434,163
060971527011,543,333,210,552,335,217,660,438,210,780,483,242
060971529061,896,561,335,910,553,357,1133,744,366,953,596,298
060971540001,319,206,113,324,200,124,342,244,92,327,217,85
060971540002,344,237,107,339,226,113,336,237,91,340,223,92
060971539052,824,583,241,834,578,256,1094,815,248,1119,788,265
060971528011,356,231,125,361,227,134,512,357,139,566,356,164
060971528014,521,354,167,531,347,184,895,635,237,862,557,226
060971529052,611,422,189,616,411,205,1105,788,291,710,472,187
060971529053,510,352,158,514,343,171,660,468,179,534,359,141
060971529042,382,279,103,387,273,114,600,436,149,376,256,93
060971530053,634,405,229,647,408,239,790,537,234,726,477,189
060971529062,959,724,235,970,720,250,1176,859,286,1033,700,246
060971542011,376,265,111,381,258,123,503,356,140,417,267,121
060971542012,448,298,150,454,289,165,599,398,183,478,302,143
060971542013,233,157,76,235,152,83,321,217,96,256,161,76
060971542014,378,260,118,390,261,129,504,350,145,414,262,122
060971542023,863,596,267,876,582,294,1236,842,358,965,615,279
060971542022,289,199,90,293,196,97,377,261,111,320,201,94
060971542021,465,302,163,475,304,171,609,392,195,486,283,149
060971542024,970,649,321,979,637,342,1262,843,390,1056,669,304
060971539024,352,254,98,354,253,101,460,347,102,375,268,82
060971539021,614,473,141,621,466,155,916,704,185,675,503,129
060971539022,300,224,76,305,225,80,367,281,77,299,218,61
060971539034,637,478,159,643,477,166,744,584,153,666,492,130
060971539041,678,515,163,691,511,180,840,652,168,737,548,136
060971539023,345,265,80,348,260,88,449,348,87,408,306,76
060971539032,394,306,88,401,302,99,492,387,92,440,335,74
060971538041,742,486,256,748,481,267,1053,688,339,882,555,256
060971538042,669,435,234,677,430,247,894,632,248,727,457,216
060971538061,406,251,155,420,255,165,526,325,182,458,276,146
060971538063,562,359,203,575,358,217,769,548,208,559,350,173
060971538072,716,444,272,742,448,294,888,587,275,762,459,242
060971538071,1123,728,395,1138,720,418,1475,971,473,1226,788,348
060971538082,616,421,195,622,418,204,632,463,158,657,437,166
060971538091,724,473,251,734,464,270,1005,673,316,787,489,239
060971538113,821,554,267,835,543,292,1082,715,330,884,553,267
060971538112,353,238,115,367,239,128,469,304,149,380,235,116
060971538081,627,424,203,629,410,219,786,516,250,633,403,187
060971538062,184,129,55,185,128,57,236,165,68,210,142,49
060971538092,783,525,258,791,513,278,1084,770,292,839,531,242
060971538093,380,255,125,388,250,138,521,348,163,426,263,127
060971538101,418,274,144,430,269,161,555,366,173,575,368,162
060971538111,850,590,260,867,581,286,1288,862,390,930,617,240
060971538102,357,254,103,367,252,115,523,378,129,424,288,103
060971538083,699,495,204,718,489,229,752,531,196,673,457,166
060971537051,283,234,49,281,223,58,345,283,49,301,221,51
060971537112,252,208,44,251,207,44,363,286,68,327,230,53
060971537111,547,441,106,549,445,104,659,515,124,557,396,91
060971537101,305,254,51,307,251,56,409,331,69,328,248,54
060971534031,639,504,135,649,501,148,772,575,174,679,497,138
060971534044,708,582,126,717,574,143,853,682,145,734,541,122
060971543041,338,261,77,344,256,88,523,400,118,376,246,87
060971543071,452,359,93,458,356,102,598,496,91,606,446,118
060971543042,397,319,78,403,318,85,269,202,60,351,249,62
060971530021,409,326,83,413,326,87,566,435,117,470,342,81
060971534032,730,624,106,731,608,123,946,792,126,765,606,95
060971534041,478,399,79,484,397,87,564,469,82,527,406,76
060971534052,612,514,98,620,515,105,718,599,105,707,557,91
060971536023,937,752,185,940,726,214,1066,847,196,918,666,177
060971536022,452,377,75,456,372,84,565,458,93,517,384,86
060971536021,588,493,95,594,487,107,633,522,99,552,434,74
060971536012,389,322,67,389,313,76,585,481,94,504,391,75
060971536011,599,491,108,606,484,122,693,565,112,570,445,83
060971530052,380,246,134,391,247,144,454,318,125,506,334,130
060971533013,613,474,139,620,472,148,888,682,180,685,498,125
060971533014,359,279,80,362,272,90,468,355,96,346,242,72
060971533021,486,377,109,496,379,117,716,560,136,738,538,139
060971533011,316,241,75,320,237,83,451,335,103,347,250,55
060971533022,553,392,161,560,389,171,792,565,209,586,398,143
060971533023,426,320,106,431,317,114,696,518,152,366,266,68
060971532012,283,216,67,285,211,74,441,333,87,338,240,66
060971530022,611,489,122,617,492,125,856,666,156,654,485,110
060971530062,308,218,90,314,223,91,399,284,104,340,235,79
060971530051,552,329,223,564,340,224,632,401,214,532,326,158
060971530054,420,307,113,430,304,126,509,359,136,466,314,110
060971515052,421,280,141,423,270,153,505,355,140,469,305,128
060971515064,888,654,234,901,656,245,1203,906,264,1023,733,224
060971505013,365,291,74,370,292,78,424,337,77,402,302,75
060971503032,828,569,259,837,563,274,877,639,220,848,563,217
060971503031,396,292,104,402,289,113,578,449,121,454,323,105
060971503051,270,211,59,271,210,61,393,286,100,298,196,79
060971503052,569,441,128,577,439,138,548,432,102,644,489,121
060971503053,536,419,117,540,418,122,708,570,120,571,439,84
060971503054,161,125,36,163,126,37,218,177,39,171,131,28
060971503061,246,192,54,248,191,57,314,257,57,326,250,59
060971503062,363,284,79,369,284,85,469,381,81,389,302,59
060971517021,252,198,54,255,197,58,321,254,60,300,213,70
060971517023,493,388,105,503,387,116,620,502,102,550,403,114
060971518002,393,310,83,400,309,91,473,359,99,408,288,88
060971518005,317,249,68,320,249,71,400,304,81,364,262,75
060971503033,309,226,83,317,227,90,411,309,91,363,253,82
060971503034,1128,858,270,1142,855,287,1282,1045,228,1189,869,272
060971503043,537,392,145,549,392,157,700,528,157,598,416,135
060971503044,580,425,155,597,429,168,735,553,166,620,432,142
060971502032,711,511,200,718,506,212,811,587,203,756,523,189
060971501002,293,165,128,300,161,139,338,220,112,322,184,115
060971525023,408,306,102,417,299,118,541,398,125,439,294,101
060971515042,605,440,165,611,439,172,757,576,157,643,450,144
060971515061,773,570,203,784,571,213,926,711,192,828,600,173
060971517012,560,431,129,573,433,140,707,548,143,586,428,112
060971515063,426,313,113,430,315,115,568,428,123,477,343,104
060971515062,333,247,86,338,247,91,416,315,89,375,271,79
060971518004,794,618,176,818,622,196,935,724,190,829,623,138
060971518003,406,335,71,404,325,79,494,394,93,436,321,82
060971516022,725,519,206,731,522,209,771,599,163,746,527,194
060971502051,518,396,122,526,393,133,621,498,113,624,462,128
060971502033,775,617,158,786,616,170,1022,837,170,869,660,161
060971522043,308,240,68,314,240,74,392,297,84,370,255,88
060971522041,543,421,122,552,422,130,719,571,130,594,431,127
060971522042,734,516,218,738,508,230,903,676,212,762,532,174
060552019002,240,149,91,240,145,95,292,200,87,242,152,74
060971506072,276,183,93,281,184,97,381,241,131,313,182,104
060971512051,487,328,159,494,327,167,620,422,184,514,329,143
060971507011,459,360,99,465,357,108,624,502,109,500,377,90
060971511001,555,344,211,567,338,229,715,450,248,599,342,194
060971512062,490,337,153,498,333,165,665,442,197,533,335,151
060971512041,738,569,169,754,565,189,1042,758,249,858,597,186
060971510001,541,346,195,553,344,209,714,485,216,589,367,178
060971510002,567,372,195,577,368,209,701,474,215,603,381,177
060971511002,1076,686,390,1102,681,421,1341,858,454,1189,710,391
060971511003,547,358,189,556,353,203,693,454,227,598,365,193
060971506022,558,394,164,568,391,177,703,505,185,603,406,148
060971506032,298,223,75,303,219,84,381,283,88,313,222,61
060971506033,286,205,81,288,200,88,357,271,84,306,210,72
060971506036,433,307,126,439,301,138,566,409,142,497,337,120
060971506034,723,491,232,742,484,258,940,675,245,835,545,230
060971506035,429,312,117,438,308,130,632,463,153,459,317,100
060971535011,517,368,149,519,362,157,672,470,189,530,339,141
060971512042,561,419,142,571,420,151,659,498,137,544,362,132
060971512043,223,167,56,226,167,59,323,249,64,257,175,62
060971509014,259,207,52,263,208,55,336,266,63,280,211,50
060971509012,319,255,64,321,252,69,408,327,73,362,281,60
060971509013,452,363,89,458,360,98,584,468,101,487,376,80
060971519004,341,287,54,344,289,55,476,394,70,423,330,54
060971530023,228,191,37,231,191,40,319,252,55,275,205,42
060971530024,266,222,44,268,219,49,405,318,66,320,236,48
060971530025,250,209,41,253,207,46,338,267,56,268,198,41
060971531042,175,142,33,177,139,38,566,443,105,221,164,40
060971522031,353,293,60,358,291,67,434,365,59,373,298,54
060971528031,333,256,77,341,252,89,485,357,113,408,293,82
060971528041,250,193,57,256,189,67,399,294,92,296,214,56
060971514041,360,302,58,363,304,59,469,366,95,416,302,78
060971519001,219,183,36,224,187,37,298,250,41,289,220,46
060971519002,238,200,38,243,203,40,333,279,43,291,221,49
060971519003,320,267,53,326,272,54,464,388,66,367,284,52
060971521001,379,290,89,382,286,96,305,233,63,499,368,99
060971524021,261,198,63,263,196,67,365,278,75,362,265,74
060971521003,320,268,52,325,266,59,450,381,60,403,319,48
060971530011,349,292,57,355,290,65,481,390,75,423,318,67
060971514062,367,287,80,372,277,95,543,403,126,427,311,81
060971541004,336,200,136,341,197,144,404,276,117,335,198,112
060971541001,254,173,81,260,174,86,323,221,94,281,181,78
060971541003,443,283,160,448,277,171,540,352,172,481,301,145
060971527021,513,340,173,525,335,190,763,528,224,774,499,219
060971527012,360,251,109,369,250,119,500,349,139,387,261,94
060971527013,511,342,169,524,345,179,634,443,178,585,387,155
060971529051,480,325,155,487,318,169,618,417,193,570,368,171
060971527014,365,257,108,373,255,118,522,364,143,398,274,96
060971527015,506,355,151,516,352,164,671,473,182,600,403,166
060971539042,343,221,122,343,219,124,437,300,130,362,230,104
060971538103,769,559,210,792,554,238,1064,769,262,903,623,215
060971528013,405,276,129,409,267,142,763,520,224,633,403,174
060971528012,275,189,86,279,184,95,601,418,173,657,424,172
060971537054,598,462,136,608,465,143,706,546,144,662,475,131
060971529033,98,74,24,99,73,26,147,115,28,95,72,15
060971529034,272,206,66,276,204,72,365,286,71,292,221,48
060971537073,365,308,57,369,307,62,317,259,52,387,298,57
060971537071,310,248,62,314,249,65,338,258,70,349,246,71
060971537072,246,209,37,248,211,37,291,240,46,277,213,37
060971537081,264,225,39,265,223,42,297,245,43,276,216,35
060971537082,232,192,40,234,192,42,278,227,48,301,230,46
060971537091,334,280,54,338,280,58,636,518,99,356,271,53
060971537092,364,303,61,370,301,69,462,373,78,381,288,60
060971537103,413,350,63,414,347,67,519,430,75,437,343,59
060971537102,411,341,70,415,339,76,413,335,69,452,339,75
060971543044,202,160,42,204,160,44,296,230,58,221,160,44
060971531024,161,130,31,162,126,36,244,193,44,202,151,35
060971531032,370,299,71,374,292,82,529,421,95,372,280,66
060971531033,147,124,23,148,122,26,246,195,44,0,0,0
060971531041,335,282,53,339,279,60,605,479,109,399,314,53
060971531043,230,192,38,233,189,44,210,166,38,500,390,70
060971531023,296,237,59,299,232,67,667,522,125,346,263,56
060971531031,570,454,116,572,444,128,708,536,151,638,469,120
060971530055,703,517,186,715,510,205,965,688,250,791,536,193
060971530056,414,304,110,420,299,121,560,400,145,454,307,110
060971530063,592,440,152,601,431,170,849,630,195,666,450,156
060971530061,327,237,90,333,235,98,434,311,110,368,251,92
060971535023,631,510,121,637,510,127,729,610,102,683,516,104
060971534053,616,522,94,620,523,97,756,624,113,536,409,76
060971534042,808,697,111,815,692,123,937,807,114,815,662,93
060971534043,470,386,84,474,380,94,552,449,89,502,381,76
060971535021,474,383,91,479,381,98,568,452,97,495,373,76
060971535022,382,309,73,386,308,78,459,366,79,468,353,71
060971534034,419,363,56,421,357,64,474,411,52,419,349,44
060971532021,259,182,77,266,182,84,382,276,97,318,216,71
060971532022,425,339,86,429,337,92,502,362,129,399,274,90
060971530065,422,313,109,430,309,121,526,401,114,460,317,104
060971530066,504,375,129,514,368,146,713,541,155,565,392,127
060971531021,228,190,38,235,189,46,383,301,69,290,227,39
060971531022,208,174,34,214,174,40,336,277,48,262,211,33
060971537121,471,376,95,473,371,102,506,394,103,447,335,78
060971537122,738,577,161,745,581,164,879,702,160,771,562,143
060971537113,431,340,91,437,343,94,584,451,121,450,321,87
060971537052,485,368,117,494,369,125,570,435,118,521,373,105
060971537053,560,440,120,567,441,126,723,553,149,612,438,120
060971543061,722,601,121,722,587,135,839,694,127,741,558,110
060971543062,757,634,123,761,623,138,918,746,148,803,610,122
060971543053,444,372,72,447,369,78,520,427,79,464,335,70
060971543051,325,244,81,325,240,85,383,293,84,355,250,79
060971534061,349,292,57,350,291,59,414,348,59,417,323,59
060971534051,770,616,154,783,625,158,913,723,168,744,553,124
060971537083,179,151,28,180,152,28,217,174,34,169,129,26
060971537084,224,188,36,229,191,38,283,226,47,234,179,35
060971543043,270,203,67,271,200,71,339,263,73,273,190,59
060971543052,229,170,59,228,167,61,295,226,65,236,167,54
060971543081,506,404,102,503,399,104,586,495,82,409,328,65
060971534062,486,419,67,491,418,73,601,510,73,517,413,61
060971534063,529,459,70,536,461,75,675,574,80,596,482,66
060971534033,467,409,58,470,405,65,553,489,54,487,408,46
060971530031,319,242,77,324,241,83,432,330,95,375,271,75
060971530034,483,366,117,488,364,124,684,521,145,559,405,114
060971532011,673,505,168,688,505,183,1126,813,283,794,550,175
060816044002,490,344,146,504,349,155,741,535,192,453,335,94
060816051002,542,437,105,550,444,106,645,499,138,607,482,93
060816054005,521,402,119,525,403,122,727,576,140,649,496,114
060816051001,822,611,211,834,615,219,1100,847,234,888,664,178
060816053001,633,508,125,643,504,139,849,683,156,675,533,107
060816053002,694,528,166,707,531,176,872,684,174,804,619,144
060816054001,328,240,88,334,240,94,424,332,85,369,271,77
060816054004,524,402,122,529,405,124,689,533,136,594,456,104
060816054002,460,337,123,471,337,134,601,473,119,529,384,105
060816054003,595,445,150,613,429,184,834,650,164,710,556,115
060816055012,647,521,126,659,510,149,773,621,138,654,512,105
060816055011,506,410,96,511,405,106,671,536,120,619,490,100
060816055021,383,292,91,386,290,96,463,368,89,420,321,80
060816055022,675,510,165,679,506,173,859,678,165,736,564,140
060816056002,600,354,246,623,359,264,942,644,276,600,373,183
060816056001,500,281,219,516,287,229,573,382,179,471,297,145
060816053003,501,366,135,513,376,137,627,494,125,473,364,88
060816053004,375,274,101,385,280,105,427,343,81,486,370,93
060816050002,373,267,106,378,268,110,503,393,108,467,346,101
060816052001,457,339,118,466,344,122,598,485,98,491,370,99
060816052002,503,377,126,510,376,134,618,476,122,562,425,110
060816052003,422,318,104,435,317,118,506,392,104,468,355,90
060816052004,483,358,125,491,363,128,604,467,128,534,402,108
060816050003,1491,1032,459,1535,1039,496,1946,1442,464,1708,1188,426
060816056004,1198,720,478,1234,741,493,1431,953,442,1390,870,431
060816050001,634,453,181,647,454,193,1007,747,238,614,449,133
060816050004,449,301,148,463,301,162,577,429,140,495,328,141
060816049001,802,539,263,834,543,291,1113,777,318,898,602,254
060816050005,374,251,123,385,251,134,509,377,124,420,280,120
060816058003,400,266,134,412,272,140,480,356,113,440,310,110
060816056003,586,351,235,604,358,246,822,559,244,575,361,179
060816057004,711,436,275,731,450,281,886,615,248,823,541,233
060816057001,677,406,271,695,414,281,836,589,225,685,436,198
060816058002,514,350,164,524,351,173,633,488,135,556,404,128
060816064001,640,472,168,653,474,179,614,464,142,563,426,110
060816057002,621,385,236,634,404,230,839,586,238,677,442,203
060816065004,563,379,184,584,387,197,664,512,138,620,441,141
060816068001,865,603,262,889,602,287,1053,823,214,918,654,219
060816057003,741,433,308,758,444,314,925,639,266,787,483,261
060816069001,548,430,118,552,438,114,646,535,98,538,430,89
060816065003,507,357,150,519,358,161,624,483,130,532,394,108
060816068002,851,612,239,865,615,250,1129,837,276,945,682,226
060816039002,595,443,152,602,440,162,814,603,186,657,470,155
060816044001,496,347,149,509,353,156,767,543,208,551,390,133
060816045002,632,417,215,653,418,235,851,604,230,679,455,183
060816044003,446,315,131,460,321,139,726,530,182,657,503,117
060816049002,499,339,160,520,339,181,737,496,228,552,366,158
060816047001,934,635,299,996,638,358,1444,1009,409,1032,723,268
060816047002,344,227,117,362,236,126,540,368,160,383,268,99
060816048003,658,472,186,681,469,212,874,642,216,750,552,162
060816045001,908,628,280,936,639,297,1219,854,328,1012,714,260
060816046002,489,318,171,515,326,189,488,341,138,519,341,154
060816048002,553,397,156,567,393,174,699,508,181,613,443,135
060816048001,705,510,195,728,506,222,958,674,259,728,531,161
060816039003,382,270,112,389,269,120,522,393,122,450,312,122
060816046001,649,421,228,684,434,250,891,624,240,708,459,210
060816023002,673,564,109,681,547,134,1026,792,222,919,743,143
060816042001,236,197,39,231,189,42,383,304,75,288,233,42
060816042002,219,185,34,217,180,37,344,272,67,266,216,38
060816042003,547,450,97,543,446,97,883,674,200,716,596,92
060816041031,505,396,109,508,395,113,839,633,189,638,506,104
060816041041,380,308,72,382,299,83,585,461,114,801,638,122
060816041042,358,290,68,360,282,78,542,428,106,422,336,66
060816041023,340,285,55,348,287,61,491,386,95,287,232,44
060816041032,500,392,108,511,397,114,838,631,194,602,468,107
060816039001,308,232,76,309,227,82,380,287,89,335,244,77
060816039004,321,239,82,322,237,85,420,312,102,357,257,76
060816039005,335,252,83,340,250,90,462,341,113,363,262,76
060816039006,202,151,51,204,150,54,292,213,71,262,188,54
060816040002,564,420,144,569,412,157,734,544,177,626,464,131
060816040003,567,429,138,574,421,153,752,568,174,717,544,149
060816040001,350,258,92,351,250,101,468,347,115,397,293,84
060816024002,947,687,260,982,700,282,1228,913,302,1060,777,236
060816041022,450,375,75,456,376,80,690,516,156,351,281,55
060816041021,133,111,22,135,112,23,191,151,36,169,138,26
060816038011,735,544,191,753,541,212,1172,822,326,772,557,181
060816038022,461,319,142,471,313,158,560,394,155,497,342,129
060816038023,827,573,254,849,565,284,1077,762,292,906,622,236
060816038021,1010,720,290,1032,715,317,1319,992,301,1089,725,298
060816069002,798,626,172,812,641,171,968,798,153,874,694,150
060816019021,509,416,93,509,409,100,665,542,111,548,439,88
060816019022,324,262,62,326,254,72,505,388,108,361,294,52
060816019024,579,466,113,589,460,129,898,687,191,684,550,101
060816019011,489,383,106,495,370,125,598,463,130,530,403,100
060816019012,626,490,136,638,493,145,1019,779,223,738,578,134
060816019013,311,244,67,316,237,79,455,352,99,354,272,66
060816019023,268,216,52,272,213,59,422,324,86,370,285,69
060816020013,967,778,189,986,771,215,1346,1037,283,1092,855,199
060816020011,492,394,98,501,392,109,687,542,135,576,446,108
060816022011,357,281,76,364,280,84,519,408,109,417,326,78
060816022013,362,289,73,362,282,80,545,423,106,390,316,58
060816020012,250,202,48,255,200,55,333,264,65,268,208,51
060816022021,282,244,38,283,239,44,654,523,116,341,287,37
060816022022,352,303,49,348,296,52,549,441,96,413,347,43
060816001003,407,339,68,410,338,72,543,421,112,326,267,43
060816020022,410,307,103,411,300,111,680,510,158,484,362,101
060816020021,659,555,104,664,541,123,986,793,173,758,615,103
060816021001,267,226,41,269,224,45,418,337,74,330,275,44
060816021002,231,195,36,234,195,39,322,263,57,268,221,36
060816021003,180,153,27,183,153,30,288,235,52,211,175,30
060816022012,319,256,63,313,248,65,509,396,102,370,300,56
060819843001,0,0,0,0,0,0,0,0,0,0,0,0
060816023001,485,409,76,494,398,96,828,657,159,603,482,89
060816018002,714,539,175,720,529,191,979,721,244,775,571,169
060816018001,1047,788,259,1049,771,278,1542,1140,381,1192,884,267
060816018003,667,516,151,676,516,160,1002,772,216,805,610,163
060816017001,430,344,86,434,341,93,581,455,116,443,347,73
060816017002,659,527,132,679,533,146,989,773,203,865,670,163
060816024001,368,267,101,375,264,111,537,386,142,398,294,87
060816024003,516,397,119,530,402,128,767,588,162,631,494,108
060816024004,880,642,238,894,635,259,1190,846,329,949,711,198
060816086001,442,334,108,459,342,117,577,463,105,489,364,94
060816086003,693,541,152,712,541,171,971,768,185,785,583,151
060816085011,405,324,81,412,320,92,554,442,105,453,351,79
060816087001,965,746,219,987,741,246,1191,947,226,1036,790,198
060816087002,563,430,133,570,420,150,778,604,156,656,487,129
060816087005,859,674,185,880,674,206,1050,845,183,935,730,160
060816088001,579,445,134,590,455,135,698,544,137,597,457,110
060816088002,655,487,168,665,490,175,770,607,142,659,490,128
060816088003,414,302,112,427,309,118,528,410,107,453,326,97
060816088004,548,410,138,565,414,151,711,551,144,592,430,124
060816088005,897,677,220,923,683,240,1140,883,230,1118,820,234
060816070002,1280,879,401,1309,882,427,1635,1191,412,1381,965,345
060816089001,724,503,221,741,508,233,889,704,166,774,561,173
060816089003,1044,817,227,1059,811,248,1431,1132,263,1129,869,202
060816089004,443,308,135,453,318,135,529,405,111,470,330,115
060816089002,624,498,126,625,510,115,830,657,145,727,570,123
060816096011,1563,1144,419,1596,1146,450,1913,1513,363,1797,1354,360
060816090002,745,569,176,753,562,191,933,744,171,1015,783,184
060816087003,389,301,88,400,305,95,431,341,83,382,288,71
060816087004,586,451,135,597,454,143,671,533,131,657,495,124
060816082002,767,564,203,782,561,221,1430,1076,327,807,594,163
060816082001,707,501,206,725,502,223,748,565,171,797,567,183
060816083001,843,597,246,863,600,263,1033,763,247,913,663,214
060816083002,461,330,131,477,335,142,646,490,143,502,369,111
060816081002,835,604,231,854,615,239,1308,1000,289,932,685,207
060816081001,484,357,127,499,367,132,657,507,141,530,396,110
060816080011,771,576,195,780,567,213,1089,843,222,863,630,182
060816080012,274,203,71,279,202,77,392,304,80,259,190,54
060816080131,936,675,261,952,669,283,1113,864,223,1012,738,212
060816080251,295,229,66,298,226,72,696,517,171,327,256,55
060816080252,942,723,219,958,717,241,553,425,117,970,725,207
060816080253,261,196,65,264,196,68,336,256,80,303,236,51
060816080021,851,613,238,867,621,246,978,755,208,1032,765,225
060816080022,368,268,100,374,274,100,487,370,109,424,317,92
060816080023,334,242,92,339,247,92,446,341,98,366,275,80
060816080241,839,602,237,869,616,253,1100,822,261,937,666,229
060816080132,326,239,87,329,238,91,439,342,88,326,234,74
060816080231,410,287,123,420,289,131,615,475,128,449,323,100
060816080232,729,530,199,748,536,212,970,747,205,818,581,195
060816080133,339,251,88,347,249,98,431,334,85,319,239,63
060816079002,315,236,79,315,234,81,134,105,26,99,72,23
060816080242,41,29,12,41,29,12,414,320,89,45,31,12
060816061001,667,519,148,680,515,165,908,698,195,778,600,148
060816061002,449,350,99,458,346,112,580,445,123,501,385,96
060816061003,292,228,64,298,227,71,383,299,82,337,259,63
060816077012,707,567,140,714,545,169,1102,847,230,837,664,139
060816077011,421,337,84,422,324,98,568,449,110,527,412,91
060816077021,477,373,104,483,362,121,694,545,134,560,430,104
060816077022,494,385,109,500,375,125,718,562,138,536,412,98
060816078001,612,461,151,627,450,177,817,606,198,690,514,144
060816078002,573,425,148,577,429,148,800,585,195,643,475,136
060816079001,648,481,167,649,475,174,905,681,203,1107,814,249
060816079003,393,292,101,394,289,105,738,541,178,330,249,65
060816084001,685,550,135,694,545,149,1042,819,204,861,663,152
060816084002,424,341,83,431,340,91,696,526,153,549,424,100
060816084003,271,217,54,273,216,57,376,285,83,305,237,56
060816085021,587,438,149,600,441,159,807,621,179,680,508,137
060816085022,402,299,103,416,304,112,583,448,129,484,364,95
060816085012,692,517,175,703,504,199,852,656,186,807,587,180
060816085013,486,367,119,492,359,133,567,439,123,546,400,116
060816075002,1364,1147,217,1385,1145,240,1905,1519,356,1348,1113,169
060816085014,422,337,85,426,332,94,527,414,98,464,356,81
060816075001,607,503,104,624,502,122,902,717,170,649,507,105
060816076001,484,377,107,493,384,109,774,621,133,478,372,87
060816076002,281,225,56,287,228,59,335,272,55,310,244,52
060816076003,347,283,64,351,284,67,415,325,80,371,299,56
060816076004,427,345,82,431,347,84,521,422,86,467,374,73
060816063001,628,511,117,639,518,121,877,717,152,759,589,128
060816063002,444,340,104,449,337,112,575,455,110,463,352,93
060816064003,501,377,124,503,372,131,671,528,133,534,394,114
060816063003,480,380,100,493,378,115,612,492,110,566,437,103
060816062021,497,430,67,505,436,69,736,602,122,582,492,66
060816062022,465,395,70,466,389,77,627,512,101,510,419,66
060816062011,300,264,36,307,270,37,482,395,82,351,309,30
060816062012,453,399,54,460,404,56,668,545,112,554,478,50
060816060003,334,264,70,337,264,73,418,333,82,367,291,61
060816060002,605,479,126,612,479,133,770,608,147,690,549,115
060816060001,523,417,106,539,429,110,779,613,148,647,506,103
060816059021,305,247,58,308,247,61,356,286,58,344,272,50
060816059022,627,513,114,635,516,119,791,640,132,706,551,115
060816059013,286,229,57,288,228,60,359,282,69,289,231,41
060816059012,460,365,95,467,373,94,638,498,122,531,418,79
060816059011,368,296,72,372,300,72,467,365,91,461,367,68
060816058001,463,315,148,468,316,152,577,435,126,513,377,113
060816064002,410,315,95,413,316,97,485,392,88,449,335,95
060816064004,432,336,96,438,340,98,558,447,102,479,359,98
060816065001,430,304,126,442,305,137,523,409,106,440,328,88
060816065002,559,407,152,564,404,160,654,512,130,600,463,110
060816066001,504,397,107,510,393,117,666,530,130,568,433,101
060816066002,565,429,136,572,432,140,722,573,142,627,473,116
060816066003,490,363,127,497,370,127,631,493,124,546,411,103
060816067001,438,311,127,443,322,121,557,433,114,447,333,91
060816074001,930,718,212,955,724,231,1220,958,233,1020,752,214
060816067002,866,633,233,882,641,241,1098,851,222,999,724,229
060816074002,327,250,77,336,250,86,427,332,85,349,262,75
060816074003,663,506,157,685,515,170,874,694,165,805,610,162
060816072001,572,458,114,582,449,133,690,544,129,722,562,123
060816073002,864,665,199,874,650,224,1076,839,216,922,704,174
060816072002,703,576,127,708,564,144,963,762,190,830,649,138
060816071002,662,503,159,667,500,167,803,624,159,743,564,148
060816071003,523,388,135,533,390,143,647,506,133,572,425,122
060816071001,356,255,101,365,257,108,433,336,87,385,274,89
060816073001,677,495,182,683,488,195,813,630,164,733,533,167
060816073003,405,291,114,417,295,122,474,368,97,428,307,100
060816070001,350,240,110,357,241,116,415,302,107,369,261,91
060816064005,319,248,71,325,254,71,450,362,82,520,393,102
060816115001,369,233,136,374,228,146,461,336,113,376,256,94
060816125001,621,528,93,627,528,99,697,587,98,640,559,52
060816115002,612,392,220,618,393,225,729,529,188,665,472,161
060816106022,435,337,98,444,346,98,543,444,88,429,329,78
060816106012,367,297,70,375,290,85,514,418,82,459,383,51
060816115003,526,330,196,531,324,207,628,462,155,556,380,138
060816114004,731,394,337,736,406,330,844,560,259,780,471,255
060816113004,650,489,161,657,489,168,764,605,146,697,532,130
060816114002,349,209,140,364,213,151,404,300,91,500,341,116
060816129001,946,761,185,957,758,199,1068,927,128,940,774,124
060816114003,690,409,281,689,399,290,875,646,209,753,490,193
060816133002,654,475,179,670,479,191,812,623,174,648,464,139
060816130002,688,521,167,696,527,169,830,679,136,834,647,141
060816114001,461,299,162,469,304,165,584,428,143,362,260,76
060816086002,377,284,93,385,292,93,520,405,103,435,330,79
060816103042,750,548,202,770,561,209,1021,781,218,907,681,183
060816090001,559,418,141,576,431,145,749,591,150,407,309,82
060816095001,1090,815,275,1104,809,295,1346,1080,239,1228,921,235
060816091001,332,263,69,333,257,76,432,340,80,364,274,69
060816095002,1511,1108,403,1534,1107,427,1863,1481,340,1464,1093,292
060816135021,1072,825,247,1083,825,258,1288,1010,254,1149,858,235
060816136002,460,363,97,466,358,108,562,449,102,522,392,97
060816136003,210,169,41,210,165,45,317,248,58,238,174,47
060816136001,870,683,187,882,680,202,1055,863,171,1008,767,184
060816136005,1205,974,231,1208,957,251,1283,1042,214,1152,884,192
060816136004,366,289,77,372,285,87,444,360,77,382,294,63
060816135022,628,468,160,634,471,163,749,581,156,644,481,129
060816135023,856,644,212,872,644,228,1035,822,198,905,677,184
060816135024,774,609,165,782,601,181,982,786,186,814,617,150
060816135012,1073,787,286,1082,773,309,1376,1018,322,1160,842,249
060816135011,900,663,237,911,655,256,996,770,204,806,587,172
060816137021,471,348,123,479,350,129,536,407,117,463,341,93
060816137024,218,169,49,221,168,53,286,218,65,226,170,45
060816137023,753,583,170,766,581,185,939,709,207,857,640,163
060816137022,461,318,143,464,315,149,643,465,164,326,229,80
060816137011,1057,803,254,1069,801,268,1432,1105,292,1197,883,244
060816137012,1184,769,415,1189,772,417,1500,1094,373,1323,887,341
060816138002,455,307,148,457,304,153,529,355,163,610,410,155
060816138003,539,433,106,541,431,110,677,524,131,613,456,109
060816138004,417,322,95,423,319,104,539,407,126,476,346,103
060816132004,1782,1363,419,1805,1379,426,2047,1659,338,1865,1472,288
060816134003,793,577,216,803,577,226,825,649,153,785,569,160
060816138001,321,240,81,321,233,88,436,318,107,220,155,53
060816134002,431,277,154,439,279,160,490,368,112,580,395,136
060816129002,401,314,87,406,313,93,477,407,64,438,353,63
060816128002,778,593,185,792,602,190,936,787,134,847,678,122
060816129003,415,340,75,421,340,81,528,457,65,435,367,50
060816129004,618,467,151,620,467,153,725,594,118,656,527,98
060816130001,804,583,221,811,586,225,985,804,162,922,699,175
060816132001,928,736,192,949,747,202,1053,896,126,966,793,118
060816132003,466,319,147,472,315,157,546,439,93,453,330,89
060816126002,506,423,83,508,427,81,579,500,70,595,497,67
060816126003,415,329,86,422,334,88,536,436,89,462,362,82
060816126004,543,443,100,552,450,102,654,563,74,602,504,65
060816127001,536,435,101,546,442,104,603,494,106,555,466,61
060816127002,778,552,226,803,568,235,915,748,157,790,597,140
060816126001,499,418,81,501,422,79,614,532,69,539,453,57
060816128001,1048,780,268,1068,791,277,1213,1005,187,1109,844,191
060816139004,401,327,74,403,329,74,505,421,74,460,382,53
060816139005,949,782,167,956,786,170,1180,1014,136,1137,972,101
060816026022,843,659,184,863,676,187,1412,1095,298,861,689,141
060816027003,570,453,117,576,462,114,877,675,181,683,541,99
060816027004,636,503,133,640,507,133,899,690,181,680,534,103
060816140004,588,439,149,594,436,158,847,642,190,647,484,133
060816027002,521,414,107,526,412,114,766,607,144,623,509,85
060816029002,794,636,158,801,645,156,967,770,178,869,661,159
060816027001,364,285,79,368,274,94,502,389,104,408,333,62
060816028002,812,635,177,813,617,196,1305,1016,269,1027,802,175
060816028003,374,283,91,374,277,97,532,415,107,420,320,84
060816015023,366,291,75,371,288,83,600,469,123,464,369,78
060816010003,837,687,150,859,696,163,1268,998,245,962,780,141
060816028001,420,343,77,424,334,90,577,457,109,459,363,75
060816029001,853,674,179,869,686,183,1158,893,239,985,764,168
060816030002,369,301,68,374,302,72,475,384,79,402,315,62
060816030004,592,492,100,598,493,105,766,626,127,624,489,92
060816030001,891,730,161,907,732,175,1157,931,196,948,740,145
060816030003,317,253,64,320,250,70,429,347,72,326,242,63
060816031002,693,550,143,699,544,155,869,668,182,742,562,137
060816140002,423,306,117,431,308,123,592,439,141,438,306,114
060816031001,1260,941,319,1270,945,325,1393,1060,308,1257,926,256
060816034001,1038,720,318,1058,717,341,1200,849,330,1046,707,275
060816034002,510,359,151,524,361,163,652,477,160,554,389,133
060816032004,394,308,86,397,306,91,498,383,104,514,388,105
060816033001,935,732,203,963,736,227,1207,930,248,1024,751,203
060816033003,1215,893,322,1232,875,357,1588,1183,376,1264,908,285
060816034003,670,485,185,682,484,198,873,632,222,736,520,171
060816034004,762,563,199,769,559,210,986,723,240,957,681,220
060816033002,1392,1042,350,1411,1034,377,1751,1311,402,1491,1075,331
060816032001,686,530,156,701,517,184,877,652,207,700,522,133
060816032002,388,305,83,392,302,90,477,362,102,371,281,75
060816032003,487,357,130,498,358,140,646,493,134,532,385,119
060816092021,891,700,191,903,699,204,1134,933,185,949,732,165
060816092023,475,387,88,482,386,96,661,540,107,518,406,83
060816092012,563,453,110,568,448,120,677,554,112,633,498,100
060816092013,743,579,164,759,585,174,897,731,159,776,621,121
060816092022,377,301,76,377,296,81,531,429,89,408,321,64
060816092011,607,469,138,626,480,146,711,571,125,672,532,104
060816091002,370,291,79,374,285,89,521,417,92,405,305,76
060816103022,548,443,105,553,453,100,859,722,109,463,363,81
060816093001,752,564,188,767,573,194,887,711,159,795,612,142
060816093002,1104,832,272,1133,850,283,1327,1062,239,1159,892,201
060816094001,903,688,215,930,692,238,1036,832,182,922,695,180
060816094002,942,722,220,980,753,227,1147,920,208,980,763,169
060816096032,962,673,289,972,670,302,1148,867,258,998,728,221
060816096033,877,598,279,890,610,280,1044,786,232,918,678,198
060816096021,945,704,241,965,709,256,1133,903,212,1025,748,229
060816096031,833,615,218,843,613,230,1019,795,209,920,677,199
060816096034,431,318,113,438,321,117,543,424,107,480,342,113
060816097001,1180,845,335,1209,851,358,1447,1107,314,1187,864,260
060816098002,925,663,262,933,670,263,1069,816,231,974,669,246
060816097002,1370,932,438,1392,941,451,1634,1223,375,1420,988,347
060816133001,955,562,393,971,586,385,1164,787,349,1001,635,302
060816111003,630,478,152,634,483,151,796,599,174,718,553,127
060816098004,734,548,186,739,551,188,960,761,183,894,625,207
060816113001,631,479,152,641,479,162,757,585,155,692,513,145
060816113002,823,584,239,841,592,249,1022,763,235,857,627,184
060816113003,401,284,117,406,281,125,481,360,107,439,328,94
060816134001,652,427,225,668,437,231,802,606,180,734,533,156
060816111001,1516,1106,410,1530,1104,426,1908,1468,396,1651,1220,340
060816132002,1072,763,309,1091,757,334,1249,1002,216,1119,841,198
060816118002,545,502,43,555,498,57,845,738,84,583,521,25
060816120011,400,364,36,399,358,41,680,596,78,543,500,27
060816120012,308,290,18,316,290,26,495,444,46,414,378,20
060816120021,288,266,22,289,260,29,442,380,53,337,307,19
060816120022,299,274,25,300,266,34,436,377,51,332,299,19
060816118001,453,424,29,448,412,36,774,686,72,540,506,22
060816119011,338,289,49,343,286,57,347,297,40,262,220,21
060816119021,478,436,42,478,433,45,753,643,93,632,567,36
060816119013,145,128,17,145,123,22,209,178,26,195,168,17
060816119024,464,395,69,466,391,75,667,569,86,527,431,59
060816119012,388,348,40,388,351,37,629,532,78,439,387,29
060816119022,318,297,21,315,293,22,465,406,51,380,354,14
060816119023,260,243,17,260,241,19,362,316,39,310,293,9
060816121021,288,263,25,291,264,27,356,309,38,313,268,22
060816121022,231,211,20,234,212,22,445,390,48,375,322,30
060816121011,444,371,73,452,378,74,517,455,54,489,420,39
060816121012,340,307,33,342,303,39,496,422,66,436,371,37
060816121013,69,62,7,69,61,8,111,93,15,86,74,8
060816116002,640,508,132,645,514,131,752,631,104,680,540,95
060816116001,589,485,104,597,483,114,680,576,84,576,482,63
060816117002,581,517,64,584,518,66,746,641,93,634,560,49
060816117003,425,389,36,425,373,52,614,521,71,455,407,29
060816117001,493,452,41,496,435,61,754,650,86,570,509,37
060816139001,344,296,48,350,294,56,389,342,40,365,314,32
060816139002,407,353,54,415,353,62,479,421,45,443,379,40
060816139003,583,508,75,587,508,79,690,628,53,605,517,53
060816125003,908,756,152,929,754,175,1059,924,117,979,829,111
060816125002,503,380,123,511,371,140,637,536,89,599,466,104
060816117004,132,118,14,133,117,16,212,174,33,30,22,7
060816105001,186,152,34,187,152,35,267,218,43,236,193,35
060816105002,260,210,50,261,211,50,424,348,70,321,259,47
060816105003,143,115,28,144,116,28,232,189,36,168,135,25
060816105004,404,331,73,405,332,73,510,425,81,452,363,68
060816106021,429,360,69,433,363,70,513,438,65,492,388,74
060816106023,570,495,75,575,491,84,723,629,88,666,558,67
060816103021,436,341,95,434,327,107,678,509,157,578,409,129
060816106011,247,224,23,248,217,31,416,354,52,294,262,20
060816106013,248,225,23,247,217,30,367,312,47,315,260,36
060816107002,357,297,60,357,292,65,480,400,73,444,349,67
060816107004,675,556,119,687,547,140,865,696,153,794,615,129
060816104001,576,485,91,587,483,104,848,703,124,724,596,90
060816104002,318,276,42,318,266,52,497,414,70,403,335,46
060816104003,476,405,71,477,396,81,635,537,89,565,473,63
060816102011,132,117,15,134,116,18,218,177,35,155,130,18
060816102013,162,141,21,165,144,21,239,204,29,186,157,23
060816102014,317,278,39,321,281,40,442,378,57,393,328,47
060816102021,506,444,62,510,442,68,552,474,64,477,392,53
060816102031,158,139,19,157,138,19,248,214,25,195,166,24
060816102022,828,722,106,835,710,125,1280,1087,163,727,599,82
060816101002,313,246,67,320,246,74,407,313,85,337,247,70
060816101001,560,470,90,568,461,107,721,607,105,636,509,94
060816099001,736,563,173,750,566,184,876,667,192,813,613,158
060816100003,608,489,119,613,474,139,728,592,123,641,498,105
060816100001,959,808,151,979,807,172,1253,1072,161,1000,808,130
060816100002,615,455,160,631,463,168,762,610,128,655,488,131
060816099002,988,765,223,1007,771,236,1270,1023,225,1137,857,225
060816098001,390,316,74,397,319,78,518,415,91,435,327,84
060816098003,370,276,94,377,281,96,452,363,85,420,306,96
060816110001,516,410,106,519,411,108,664,529,118,553,420,96
060816110002,525,411,114,537,413,124,675,529,131,574,437,103
060816110004,889,708,181,908,714,194,1129,889,220,1000,771,174
060816111002,1153,893,260,1173,892,281,1435,1113,294,1236,933,240
060816110003,506,396,110,519,400,119,658,515,127,563,439,94
060816102032,275,244,31,278,249,29,425,345,64,297,255,28
060816109012,281,238,43,285,246,39,380,339,32,335,290,33
060816109011,599,492,107,601,486,115,792,643,126,690,553,95
060816109022,569,460,109,575,457,118,681,561,112,589,471,82
060816107001,406,340,66,412,342,70,401,336,57,395,323,55
060816108003,202,172,30,201,167,34,284,241,39,233,191,30
060816108002,74,63,11,74,62,12,194,166,21,182,149,23
060816109021,550,484,66,549,470,79,780,663,101,743,617,91
060816108001,573,498,75,575,482,93,876,710,135,725,576,115
060816107003,333,270,63,335,262,73,433,336,87,407,310,75
060816112002,911,704,207,934,702,232,1101,896,182,959,721,184
060816112001,601,463,138,610,460,150,732,593,127,651,501,127
060816102012,384,340,44,386,329,57,577,478,79,470,398,56
060816103032,1190,856,334,1207,876,331,973,760,198,1242,919,253
060816103033,746,546,200,771,564,207,1511,1198,284,720,547,137
060816103035,261,206,55,266,210,56,266,211,49,311,241,51
060816103041,654,460,194,668,466,202,802,614,173,810,598,176
060816103043,377,265,112,385,269,116,476,363,102,443,322,97
060816103031,612,441,171,631,457,174,804,639,152,666,511,123
060816103034,456,345,111,464,352,112,771,612,144,543,418,96
060816001005,431,356,75,439,352,87,555,442,100,476,371,80
060816001004,434,352,82,446,350,96,552,444,94,442,350,74
060816001001,538,441,97,554,439,115,667,536,117,608,479,95
060816001002,476,378,98,483,371,112,649,508,128,442,346,75
060816012001,477,382,95,480,377,103,738,556,168,558,447,84
060816008002,310,254,56,313,250,63,475,377,92,449,376,57
060816012002,466,369,97,471,365,106,654,489,151,462,352,85
060816011003,361,285,76,368,288,80,535,413,122,407,334,64
060816012004,495,391,104,500,386,114,683,511,157,693,533,126
060816012003,472,371,101,473,357,116,692,520,158,494,393,83
060816014001,491,382,109,499,375,124,754,565,181,618,483,112
060816013021,610,516,94,614,510,104,719,564,147,435,377,49
060816013022,358,299,59,360,290,70,898,700,179,640,528,90
060816013013,254,207,47,254,199,55,377,296,76,261,221,33
060816016011,285,245,40,292,238,54,479,379,91,324,271,42
060816016012,464,355,109,461,350,111,641,501,136,502,392,91
060816037002,1204,906,298,1224,900,324,1664,1201,425,1358,1007,285
060816037001,1149,860,289,1166,857,309,1562,1165,373,1293,959,275
060816140001,735,531,204,745,533,212,1010,751,240,757,527,196
060816140003,433,324,109,438,321,117,516,390,116,648,484,134
060816025003,559,420,139,572,438,134,812,625,172,677,536,123
060816002001,466,392,74,474,386,88,780,598,167,523,431,70
060816002002,524,429,95,529,430,99,773,596,165,586,481,86
060816003002,671,542,129,677,544,133,1019,792,207,843,664,145
060816003001,654,534,120,660,531,129,911,724,166,616,485,103
060816004011,546,449,97,552,448,104,937,738,182,812,646,130
060816004012,355,296,59,355,293,62,618,470,133,442,355,63
060816004021,309,257,52,308,253,55,472,367,105,379,311,52
060816004022,470,392,78,465,388,77,839,640,185,604,493,85
060816004023,257,216,41,261,215,46,410,309,87,303,248,40
060816007011,395,323,72,398,322,76,693,525,164,520,421,79
060816005013,393,317,76,399,315,84,678,537,128,444,364,60
060816007012,251,215,36,258,217,41,429,322,101,309,263,36
060816006003,262,219,43,264,219,45,421,335,82,315,259,43
060816006001,690,561,129,695,556,139,1123,884,215,897,734,124
060816007013,258,220,38,264,222,42,439,332,99,321,268,39
060816007021,324,276,48,330,279,51,562,433,115,337,284,40
060816007022,299,255,44,305,258,47,579,434,132,437,366,52
060816005012,312,256,56,314,252,62,478,379,92,536,443,78
060816005021,723,578,145,740,588,152,1029,793,213,772,629,119
060816005011,203,166,37,202,163,39,295,236,57,245,203,37
060816006002,324,267,57,326,263,63,526,408,103,403,330,60
060816013011,317,261,56,317,256,61,491,392,99,387,324,50
060816005022,409,324,85,416,329,87,665,514,143,472,386,72
060816013012,420,342,78,421,332,89,650,514,129,476,398,61
060816008003,373,305,68,372,300,72,482,384,94,441,360,57
060816009001,754,526,228,763,530,233,1082,814,252,859,602,214
060750604002,313,259,54,318,260,58,446,350,86,105,84,14
060816009002,646,470,176,658,474,184,923,699,215,743,542,168
060816011002,223,178,45,229,181,48,351,268,82,259,214,38
060816011004,469,371,98,478,376,102,724,555,153,556,446,88
060816011005,475,376,99,488,383,105,697,530,158,527,424,86
060816008001,273,224,49,277,221,56,404,320,77,371,309,47
060816008004,164,134,30,164,131,33,241,193,46,220,179,28
060816011001,283,232,51,286,228,58,468,352,108,350,295,45
060816010001,595,479,116,612,482,130,886,690,179,663,541,98
060816010004,371,295,76,379,292,87,566,444,118,429,352,65
060816010002,493,400,93,508,402,106,741,586,149,570,462,84
060816014003,325,249,76,328,248,80,552,418,120,423,336,70
060816014002,650,509,141,655,501,154,1079,824,242,807,645,135
060816015011,580,458,122,585,452,133,963,759,195,719,577,116
060816014004,445,336,109,451,335,116,807,620,177,561,443,98
060816015013,430,335,95,431,327,104,667,504,161,533,421,92
060816015022,233,184,49,236,182,54,437,326,106,278,220,47
060816015021,312,236,76,317,236,81,535,399,129,386,306,66
060816016041,737,596,141,748,590,158,1157,880,263,908,737,142
060816015012,437,345,92,443,336,107,720,552,166,535,416,91
060816016054,582,450,132,591,446,145,892,674,206,677,529,125
060816016031,855,658,197,868,656,212,1424,1096,311,1018,800,188
060816017003,614,474,140,624,471,153,877,682,181,719,555,137
060816016033,220,170,50,226,174,52,434,337,94,364,279,74
060816016053,709,545,164,725,538,187,1113,861,244,873,691,158
060816016051,370,280,90,375,276,99,632,487,136,501,389,95
060816016052,302,227,75,310,227,83,417,318,93,327,254,65
060816016032,616,477,139,628,482,146,980,764,203,741,564,152
060816026021,405,318,87,414,325,89,622,487,128,436,351,71
060816026011,724,570,154,738,571,167,1248,977,251,862,690,141
060816026012,584,459,125,591,451,140,916,712,193,692,554,113
060816025001,620,467,153,627,462,165,958,740,205,719,561,138
060816025002,517,390,127,522,385,137,790,588,195,603,470,115
060952518021,265,225,40,267,225,42,380,311,63,272,232,32
060952518031,219,170,49,223,169,54,331,240,87,301,240,53
060952518022,423,336,87,432,337,95,624,492,119,519,406,93
060952518032,347,264,83,351,265,86,574,418,146,418,323,79
060952518033,317,245,72,321,246,75,502,366,126,420,324,75
060952518041,287,225,62,291,225,66,459,342,110,372,295,64
060952518042,343,270,73,347,270,77,507,375,123,424,336,73
060952518043,321,249,72,328,251,77,548,404,132,415,323,73
060952518034,313,254,59,318,251,67,484,356,117,396,320,63
060952519021,303,245,58,308,244,64,447,362,79,378,305,61
060952519022,446,362,84,451,359,92,660,535,110,600,481,95
060952519011,533,449,84,539,453,86,800,653,133,672,560,86
060952519023,232,188,44,237,188,49,367,297,62,300,242,47
060952519024,475,419,56,490,417,73,781,636,132,674,577,79
060952519031,399,334,65,402,336,66,600,495,91,475,409,53
060952519032,545,458,87,552,462,90,845,710,127,687,598,74
060952519033,603,507,96,610,511,99,937,782,141,752,646,81
060952519012,232,189,43,234,190,44,329,269,55,281,222,45
060952519013,559,474,85,567,478,89,794,646,132,660,551,82
060952514002,493,384,109,506,388,118,654,480,156,607,455,119
060952514003,556,424,132,566,424,142,763,556,180,633,468,128
060952517011,524,427,97,531,428,103,692,556,121,562,442,89
060952517012,672,558,114,676,556,120,953,766,160,743,593,103
060952514001,777,605,172,793,605,188,1116,838,250,955,696,197
060952517021,273,228,45,276,227,49,587,473,100,290,231,39
060952517022,213,178,35,216,178,38,103,83,17,232,185,31
060952517023,231,193,38,231,192,39,327,265,55,257,205,33
060952512001,368,314,54,373,312,61,522,416,84,425,339,56
060952512002,259,217,42,262,214,48,353,281,61,308,246,41
060952512003,206,179,27,211,179,32,303,256,40,226,186,29
060952515002,379,297,82,382,293,89,513,402,105,419,320,79
060952515003,362,305,57,366,305,61,478,387,82,394,322,55
060952510001,222,185,37,225,182,43,326,266,51,280,218,39
060952510002,311,257,54,315,257,58,447,365,71,376,289,54
060952513001,409,302,107,410,298,112,495,373,114,434,306,94
060952513002,499,371,128,505,367,138,629,470,144,527,371,117
060952513003,478,357,121,488,354,134,606,448,139,490,341,112
060952515001,205,150,55,205,150,55,281,213,65,247,181,54
060952501031,467,350,117,469,347,122,648,480,161,565,422,119
060952501032,618,460,158,624,454,170,857,616,232,711,533,146
060952501033,452,339,113,457,338,119,637,467,159,535,400,109
060952501041,403,295,108,414,300,114,489,366,116,466,346,100
060952501051,453,341,112,460,340,120,692,542,135,536,403,110
060952501053,868,656,212,882,650,232,1245,924,310,1046,807,204
060952501042,457,334,123,471,340,131,631,462,151,506,376,111
060952501052,1007,778,229,1030,780,250,1566,1178,367,1137,890,209
060952501061,481,328,153,487,332,155,669,462,196,593,408,163
060952501062,1002,774,228,1021,780,241,1476,1101,351,1147,908,200
060952521033,1036,784,252,1047,763,284,1442,1111,304,859,645,178
060952521031,127,93,34,130,92,38,194,148,45,505,378,104
060952509001,306,253,53,307,251,56,429,339,78,358,293,46
060952509002,174,145,29,176,145,31,355,274,71,188,152,27
060952509003,280,231,49,282,229,53,349,291,48,342,268,51
060952516001,314,262,52,317,260,57,371,315,50,350,289,49
060952516002,367,305,62,369,303,66,468,381,76,426,355,51
060952502002,371,285,86,376,279,97,420,319,93,415,309,81
060952502003,423,325,98,426,318,108,664,498,146,491,363,96
060952503002,391,307,84,401,305,96,566,424,133,471,365,84
060952503003,206,160,46,210,160,50,308,227,70,229,175,40
060952522061,847,576,271,860,588,272,1187,822,346,999,671,288
060952502001,408,309,99,411,302,109,576,429,133,479,350,103
060952503001,355,270,85,360,266,94,509,370,129,404,301,84
060952520001,732,497,235,742,492,250,896,613,257,788,527,205
060952520002,440,301,139,450,304,146,543,377,150,470,319,122
060952521021,1027,697,330,1042,691,351,1269,873,365,1099,732,285
060952520003,482,332,150,493,340,153,588,435,146,704,477,182
060952521081,782,544,238,795,549,246,922,675,219,601,412,155
060952521082,805,553,252,821,558,263,952,681,242,968,655,254
060952521022,795,530,265,815,520,295,1092,750,314,935,592,265
060952521071,1004,668,336,1024,657,367,1298,902,377,1164,758,323
060952506051,358,277,81,365,274,91,529,387,133,418,323,78
060952520004,673,469,204,689,483,206,799,595,180,759,519,192
060952521052,808,537,271,818,536,282,1098,730,348,870,573,242
060952521062,667,443,224,680,440,240,916,620,276,757,498,206
060952521063,564,376,188,573,374,199,663,469,173,591,389,160
060952521042,719,434,285,734,444,290,986,687,273,786,510,237
060952521051,850,560,290,868,555,313,1181,771,383,943,613,265
060952521061,749,483,266,764,482,282,950,655,279,903,591,262
060952521072,631,417,214,644,415,229,819,556,239,719,470,200
060952505022,693,487,206,707,482,225,977,726,230,788,557,193
060952521041,1317,885,432,1339,873,466,1881,1271,575,1432,937,405
060952521043,859,514,345,880,530,350,1264,855,378,970,621,295
060952522041,873,554,319,883,559,324,1386,900,451,1089,695,324
060952522042,785,403,382,793,411,382,1047,559,468,827,417,357
060952522062,922,567,355,940,558,382,1342,832,475,1037,690,283
060952522051,1243,844,399,1262,827,435,2043,1394,602,1306,860,362
060952522052,662,467,195,671,458,213,1122,794,310,565,370,162
060952522053,847,589,258,858,575,283,1365,937,398,1105,720,313
060952523051,500,348,152,510,350,160,775,534,221,586,392,163
060952524021,272,200,72,276,193,83,379,254,117,303,220,66
060952524023,228,167,61,235,164,71,344,254,83,262,189,57
060952524022,635,440,195,642,438,204,1017,695,297,739,508,188
060952508014,353,285,68,359,285,74,532,423,96,272,205,55
060952507011,311,257,54,314,261,53,520,427,83,424,350,55
060952507012,321,263,58,323,264,59,505,406,82,421,342,55
060952508012,215,178,37,217,181,36,364,292,62,331,270,42
060952508013,316,244,72,324,245,79,422,312,101,417,292,94
060952508011,330,262,68,337,265,72,466,356,94,511,378,99
060952510003,232,192,40,236,190,46,372,305,63,264,206,45
060952511002,350,289,61,356,285,71,576,447,114,415,314,69
060952511001,300,244,56,308,252,56,484,377,88,410,327,62
060952506011,498,379,119,504,381,123,672,524,133,624,470,126
060952506043,491,376,115,497,377,120,702,536,160,581,446,108
060952506013,230,177,53,235,174,61,382,307,65,298,230,55
060952506052,568,444,124,575,442,133,784,600,169,683,518,129
060952506012,569,436,133,575,433,142,792,615,162,688,532,126
060952506041,623,476,147,629,476,153,916,696,202,740,568,137
060952506053,819,637,182,829,636,193,1121,864,241,933,707,178
060952506042,419,333,86,426,331,95,608,465,132,490,369,95
060952521032,725,521,204,737,512,225,956,684,258,820,565,209
060952505011,294,205,89,298,199,99,432,290,134,334,227,88
060952505012,388,296,92,396,293,103,552,395,142,431,291,113
060952505021,606,424,182,620,425,195,827,610,199,705,502,165
060952504001,274,208,66,279,209,70,427,315,105,324,233,73
060952504002,475,359,116,481,361,120,728,530,178,539,386,122
060952504003,253,172,81,253,162,91,381,257,119,321,207,93
060952522031,478,214,264,483,216,267,462,238,215,498,205,257
060952522043,372,149,223,375,152,223,491,247,234,431,187,224
060952523062,1019,642,377,1030,634,396,1428,852,532,1104,664,367
060952523052,803,442,361,808,435,373,1128,663,437,706,385,283
060952523053,814,469,345,825,460,365,1040,604,410,934,532,345
060952523061,683,393,290,690,384,306,833,506,307,740,443,257
060952523111,694,397,297,703,392,311,1129,700,396,936,552,317
060952523113,442,272,170,445,268,177,605,384,210,555,332,195
060952523121,670,387,283,677,381,296,784,457,310,709,397,267
060952523122,314,186,128,318,182,136,367,258,97,335,228,87
060952523101,1041,545,496,1057,553,504,1370,807,538,1127,617,449
060952523102,610,295,315,615,295,320,665,365,287,603,301,264
060952523112,904,585,319,913,580,333,1411,934,449,969,618,304
060952524011,280,195,85,289,198,91,487,340,127,366,253,88
060952524013,282,195,87,287,198,89,412,268,134,333,203,119
060952524012,194,134,60,196,135,61,282,203,76,234,164,56
060952524014,199,137,62,203,139,64,280,200,74,234,166,57
060952525012,356,246,110,365,250,115,557,391,145,458,316,108
060952525021,162,114,48,165,113,52,266,195,70,196,140,52
060952526043,184,131,53,186,127,59,278,197,75,219,151,53
060952526052,194,137,57,199,134,65,305,209,90,262,177,69
060952526041,227,166,61,231,159,72,426,307,111,257,175,62
060952526042,320,232,88,326,223,103,556,397,143,404,275,98
060952526053,196,151,45,201,148,53,269,198,63,232,179,44
060952526051,387,293,94,398,287,111,550,401,133,519,365,127
060952522032,575,356,219,587,360,227,1113,734,358,950,605,284
060952522033,1003,563,440,1020,562,458,1397,864,504,631,344,246
060952525011,170,120,50,171,115,56,267,190,69,211,142,54
060952525022,178,124,54,177,120,57,225,161,61,215,145,57
060952526062,193,137,56,196,133,63,353,242,102,250,168,66
060952526063,317,223,94,320,216,104,452,309,131,416,279,108
060952526071,281,195,86,286,189,97,437,306,111,362,243,94
060952526072,277,193,84,284,187,97,449,315,117,361,240,93
060952526082,401,319,82,403,313,90,642,471,151,459,343,93
060952526061,439,325,114,443,319,124,650,452,182,588,401,149
060952526081,382,282,100,383,277,106,580,453,112,486,339,107
060952526112,201,150,51,203,146,57,330,241,77,222,174,37
060952526113,208,154,54,209,151,58,353,258,83,240,185,40
060952526102,436,303,133,442,300,142,655,480,160,541,367,140
060952526111,306,209,97,311,207,104,426,303,109,343,246,77
060952526101,519,335,184,526,321,205,803,543,238,623,410,168
060952527072,548,353,195,558,340,218,755,484,250,677,416,232
060952526054,179,137,42,181,134,47,391,293,89,177,133,35
060952528021,22,16,6,21,13,8,55,34,20,41,24,14
060952527021,342,216,126,345,213,132,463,298,150,368,219,119
060952527022,244,155,89,252,154,98,346,223,113,276,165,87
060952527023,283,180,103,288,178,110,396,251,126,324,191,101
060952527031,325,236,89,327,227,100,476,351,111,383,271,82
060952527032,470,342,128,470,328,142,665,488,160,550,399,117
060952527033,386,282,104,385,267,118,595,432,147,461,347,92
060952527071,561,402,159,567,392,175,879,637,216,696,493,158
060952527042,270,192,78,272,187,85,428,312,104,328,224,80
060952527041,186,132,54,187,128,59,320,231,78,232,160,57
060952527044,251,179,72,254,175,79,395,276,103,301,210,72
060952527045,331,235,96,333,230,103,521,371,136,401,272,97
060952527043,265,192,73,267,184,83,386,285,92,301,201,82
060952527073,285,114,171,288,117,171,378,167,200,334,133,173
060952527024,686,487,199,699,482,217,899,655,220,761,538,180
060952527025,417,296,121,423,292,131,533,388,133,462,328,108
060952527026,306,202,104,310,198,112,445,305,127,340,227,96
060952527051,327,236,91,332,226,106,513,365,130,397,280,91
060952527052,285,185,100,289,178,111,413,276,127,333,207,103
060952527061,549,396,153,553,377,176,892,664,217,601,432,137
060952534021,422,275,147,432,268,164,605,369,224,514,313,170
060952534042,395,204,191,402,205,197,531,293,223,426,216,183
060952534044,786,395,391,789,375,414,1031,497,513,917,430,428
060952534043,510,258,252,508,241,267,654,338,300,551,280,236
060952534041,389,201,188,397,204,193,560,291,248,524,274,220
060952534033,1024,496,528,1038,486,552,1321,653,637,1185,549,555
060952534022,304,147,157,314,150,164,412,204,187,338,172,149
060952534023,249,120,129,251,119,132,337,175,154,254,121,119
060952534024,716,354,362,728,349,379,1210,630,550,852,408,382
060952533001,576,219,357,586,212,374,686,263,403,440,173,239
060952534031,669,321,348,678,315,363,840,408,407,793,398,343
060952534032,471,227,244,477,221,256,620,291,310,521,222,271
060952534025,597,308,289,609,297,312,950,462,451,621,309,269
060952532011,742,329,413,755,320,435,906,414,469,737,317,361
060952532012,491,214,277,490,203,287,593,264,313,521,222,261
060952532013,565,259,306,581,256,325,742,350,375,653,298,308
060952532014,786,361,425,806,356,450,900,408,467,808,374,382
060952532031,501,247,254,514,239,275,723,351,349,660,298,309
060952532032,561,278,283,568,265,303,835,405,406,676,302,315
060952532071,1003,451,552,1020,447,573,1383,639,712,1213,550,590
060952531011,159,79,80,161,78,83,242,140,95,162,87,67
060952531012,265,130,135,269,126,143,390,191,189,300,144,135
060952531013,349,172,177,354,164,190,458,212,226,389,181,174
060952531014,281,139,142,284,133,151,349,177,163,312,141,143
060952531015,393,195,198,399,191,208,526,248,260,443,204,201
060952532033,301,148,153,305,143,162,363,189,161,326,152,144
060952531016,589,297,292,600,293,307,787,393,374,617,281,284
060952532053,205,100,105,209,97,112,299,189,97,216,116,87
060952532081,414,198,216,425,195,230,618,285,314,512,226,249
060952532082,458,219,239,465,212,253,667,309,339,533,249,248
060952532083,235,113,122,241,111,130,329,213,100,271,145,109
060952532084,177,85,92,180,82,98,226,154,71,186,102,75
060952532062,518,241,277,528,233,295,834,369,444,535,237,267
060952529033,995,382,613,1015,373,642,1414,509,864,834,316,472
060952529044,1264,713,551,1279,704,575,1703,992,689,1168,636,461
060952532061,717,335,382,727,322,405,926,429,480,799,348,398
060952532051,509,237,272,521,229,292,675,312,346,536,255,248
060952532052,261,123,138,267,117,150,372,173,192,271,149,110
060952529043,283,108,175,286,103,183,578,248,317,361,136,203
060952531081,611,325,286,620,313,307,900,453,421,733,381,295
060952531082,376,205,171,383,205,178,533,294,224,446,238,180
060952531083,349,187,162,352,185,167,505,273,213,412,216,170
060952531071,404,212,192,413,198,215,720,405,289,477,244,189
060952531072,568,313,255,579,299,280,679,383,279,640,344,250
060952531073,503,279,224,513,268,245,759,426,312,608,331,236
060952531074,252,139,113,255,133,122,340,223,112,278,151,107
060952531051,161,92,69,161,81,80,340,204,126,218,125,75
060952531052,193,111,82,193,97,96,371,220,139,249,142,87
060952531053,452,249,203,458,230,228,659,378,266,537,293,206
060952531054,275,174,101,277,166,111,394,232,152,319,185,112
060952531055,202,127,75,203,122,81,309,184,115,235,135,82
060952529083,338,178,160,345,173,172,515,270,234,370,191,159
060952529111,710,372,338,728,365,363,973,533,412,832,443,342
060952529123,508,266,242,519,260,259,650,340,295,593,304,253
060952533002,415,166,249,426,158,268,539,228,302,645,267,340
060952529032,593,217,376,600,210,390,787,264,501,691,242,403
060952529034,449,176,273,455,171,284,521,193,316,527,204,297
060952529041,751,284,467,766,276,490,1036,386,626,822,304,463
060952529031,444,195,249,452,188,264,637,266,349,514,248,236
060952523171,1107,652,455,1131,642,489,2193,1410,735,1877,1142,629
060952523172,1411,946,465,1422,902,520,2359,1584,723,937,579,288
060952523173,412,270,142,413,257,156,632,385,219,482,298,152
060952528011,104,70,34,105,67,38,261,163,87,185,115,57
060952528012,3,2,1,3,2,1,5,3,2,5,3,2
060952528013,28,19,9,29,19,10,37,23,13,47,30,14
060952528014,53,35,18,52,33,19,117,75,40,74,48,24
060952528015,15,10,5,16,10,6,26,16,10,20,13,7
060952523152,572,375,197,581,376,205,865,590,253,672,440,196
060952523153,596,389,207,603,391,212,840,556,265,748,490,217
060952523161,556,364,192,562,366,196,905,617,268,709,462,208
060952523131,306,202,104,309,197,112,244,167,71,241,155,71
060952523132,663,427,236,669,416,253,1007,667,309,766,490,232
060952523141,399,263,136,404,257,147,565,365,188,465,297,139
060952523142,411,270,141,416,266,150,603,391,199,629,405,188
060952523143,445,294,151,451,288,163,639,438,184,518,333,155
060952523133,650,361,289,659,357,302,775,462,296,674,386,257
060952523134,746,407,339,757,402,355,929,543,370,778,435,309
060952523151,476,293,183,485,287,198,638,411,211,555,348,176
060952523162,594,364,230,606,358,248,816,526,270,675,426,213
060952535013,206,101,105,211,97,114,239,112,124,232,109,114
060952535021,611,255,356,616,235,381,897,390,482,729,280,391
060952535022,497,209,288,509,196,313,712,310,388,581,225,312
060952535023,449,192,257,458,184,274,619,268,330,531,210,281
060952535012,1718,1047,671,1733,1041,692,2264,1466,773,1663,1012,587
060952535011,1740,1062,678,1751,1057,694,1865,1208,642,1452,887,516
060952527053,283,181,102,288,174,114,402,263,131,330,200,105
060952527054,636,406,230,644,389,255,957,625,313,732,448,236
060952527055,421,285,136,428,274,154,606,411,180,456,294,135
060952527062,682,436,246,691,416,275,1124,713,384,801,492,256
060952529042,327,152,175,334,145,189,1214,681,504,407,189,195
060952529112,686,353,333,695,351,344,812,434,369,740,380,335
060952529113,341,176,165,346,174,172,425,225,191,372,189,167
060952529114,731,376,355,740,371,369,906,481,410,754,384,338
060952529121,615,255,360,624,253,371,850,377,453,709,301,362
060952529125,486,201,285,494,199,295,641,286,343,593,250,302
060952529122,379,182,197,390,174,216,489,250,231,416,191,195
060952529124,590,284,306,609,272,337,785,398,368,694,318,329
060952531061,224,122,102,228,120,108,315,170,135,268,136,108
060952531063,481,252,229,487,242,245,703,375,300,592,298,241
060952531062,201,101,100,203,94,109,337,179,145,253,127,103
060952529131,520,234,286,526,225,301,726,380,326,567,280,237
060952529132,489,221,268,496,216,280,686,360,313,543,270,231
060952529142,438,255,183,444,234,210,714,375,315,530,260,220
060952529143,450,260,190,456,240,216,664,361,286,529,271,216
060952529081,395,210,185,399,198,201,582,292,272,436,215,187
060952529082,387,205,182,389,194,195,608,322,266,438,232,175
060952529101,425,225,200,428,214,214,621,313,297,473,235,203
060952529102,437,233,204,440,216,224,647,323,301,507,249,217
060952529103,830,432,398,838,405,433,1298,634,631,930,468,406
060952529133,363,201,162,372,201,171,493,257,227,410,201,177
060952529134,542,258,284,552,256,296,765,395,349,626,307,267
060952529141,975,529,446,991,503,488,1422,762,623,1149,605,470
060952529152,1313,727,586,1343,701,642,2286,1236,994,1173,625,471
060952529151,849,445,404,852,418,434,1078,567,483,848,435,361
060952529091,607,265,342,616,253,363,902,413,455,734,310,361
060952529092,754,339,415,768,324,444,887,411,452,742,317,366
060952529104,389,205,184,395,192,203,687,336,332,427,218,185
060570002002,855,370,485,839,343,496,1046,461,561,880,333,473
060570002001,557,270,287,551,259,292,756,335,398,646,265,323
060570009002,573,383,190,564,369,195,799,486,291,667,338,223
060570003001,497,227,270,497,217,280,642,310,318,528,195,291
060570004031,837,350,487,826,333,493,1045,428,587,859,313,484
060570003002,928,458,470,914,428,486,1077,533,525,951,404,455
060570004041,810,338,472,801,323,478,979,400,548,792,272,463
060570004042,724,322,402,712,304,408,869,435,411,728,283,395
060570004043,1119,521,598,1111,488,623,1252,598,622,1112,431,579
060570004011,522,250,272,514,236,278,643,317,307,533,226,266
060570005031,562,311,251,562,302,260,777,421,330,594,283,254
060570005023,808,450,358,797,426,371,933,506,400,770,353,345
060570005024,524,281,243,522,271,251,590,322,251,528,243,230
060570004013,991,447,544,979,426,553,1177,568,591,994,418,517
060570009003,423,232,191,422,229,193,491,259,215,435,210,185
060570004012,910,407,503,893,387,506,1036,508,510,890,374,465
060570004014,1134,507,627,1115,483,632,1253,623,607,1091,459,573
060570008025,348,227,121,346,224,122,393,254,127,348,196,117
060570009001,904,709,195,881,671,210,972,741,203,1035,673,188
060570001061,520,190,330,515,181,334,611,240,356,501,158,313
060570001074,489,178,311,481,167,314,597,236,346,511,185,297
060570001075,1151,413,738,1133,394,739,1385,574,776,1137,410,661
060570001062,539,194,345,533,187,346,663,268,379,547,187,331
060570001073,411,147,264,405,141,264,506,212,286,399,146,234
060570001053,601,233,368,589,217,372,739,298,421,566,196,321
060570001071,662,239,423,647,226,421,857,338,499,648,202,406
060570001072,802,350,452,789,330,459,892,384,485,764,293,424
060570001024,882,397,485,866,374,492,988,433,527,888,374,463
060570001043,573,259,314,566,242,324,668,292,360,603,225,326
060570001051,459,176,283,454,166,288,583,253,316,472,149,288
060570001052,318,118,200,314,109,205,425,176,242,346,108,213
060570001021,844,372,472,835,354,481,984,453,509,839,336,447
060570001022,931,447,484,931,427,504,1107,538,543,935,373,496
060570001023,1195,523,672,1183,493,690,1436,660,742,1264,499,673
060570007021,1178,572,606,1165,540,625,1347,661,643,1170,509,559
060570001042,770,361,409,765,335,430,949,440,489,778,317,406
060570001041,483,234,249,484,223,261,619,263,336,496,205,254
060570006022,380,228,152,375,217,158,508,297,196,382,191,153
060570006023,929,459,470,918,433,485,1099,560,506,970,423,453
060570006024,279,155,124,278,147,131,375,217,143,231,116,96
060570006021,558,322,236,559,310,249,713,422,271,561,287,222
060570007015,821,394,427,808,373,435,1055,523,505,852,375,401
060570007022,1129,532,597,1116,500,616,1344,679,640,1147,495,556
060570005041,504,294,210,502,282,220,693,402,269,508,255,201
060570005042,703,404,299,692,387,305,821,512,295,697,340,287
060570005022,514,294,220,511,282,229,610,352,244,536,257,222
060570006011,566,314,252,565,299,266,702,390,295,577,286,226
060570007013,777,447,330,778,435,343,882,537,327,782,401,310
060570008024,1029,612,417,1026,596,430,1189,753,419,1058,550,432
060570005021,378,240,138,380,235,145,500,297,189,463,254,161
060570005043,246,141,105,243,131,112,351,201,142,269,127,116
060570005044,493,296,197,491,284,207,643,382,244,508,256,196
060570005045,278,181,97,279,174,105,336,200,131,275,154,92
060570007014,548,272,276,551,265,286,657,329,312,565,236,277
060570007012,713,365,348,700,350,350,858,433,400,711,318,327
060570007011,674,354,320,670,343,327,703,368,319,701,303,328
060570008011,1063,702,361,1059,687,372,1208,812,370,1070,627,317
060570007016,1142,689,453,1131,668,463,1370,844,488,1205,614,475
060570008023,654,468,186,648,452,196,787,607,157,683,454,158
060570008022,1333,978,355,1321,954,367,1501,1109,351,1376,905,324
060570008021,500,361,139,492,348,144,599,372,214,515,273,204
060570008012,1156,709,447,1138,686,452,1314,858,425,1078,572,382
060570008013,1117,671,446,1099,647,452,1348,874,447,1153,621,419
060570009004,309,194,115,303,183,120,422,248,159,294,148,113
060570012051,1046,702,344,1044,693,351,1259,929,304,1074,679,311
060570012052,993,698,295,1009,700,309,1241,898,313,1016,645,282
060570012082,533,390,143,533,386,147,700,540,141,550,367,136
060570012111,271,198,73,276,198,78,409,303,94,292,194,74
060570012112,489,347,142,493,345,148,692,517,157,451,301,114
060570012053,327,240,87,332,237,95,371,279,84,304,204,76
060570012072,652,473,179,662,471,191,831,629,183,583,396,145
060570012092,450,336,114,458,334,124,621,476,129,498,333,122
060570012071,234,175,59,233,170,63,358,268,81,236,156,60
060570012091,339,251,88,345,250,95,480,359,111,357,246,88
060570012074,278,206,72,277,201,76,388,289,88,283,194,71
060570012102,302,219,83,302,219,83,315,236,69,319,216,79
060570012101,334,242,92,333,242,91,447,346,90,331,227,81
060570012103,338,244,94,338,244,94,470,360,97,287,192,71
060570012081,344,251,93,342,250,92,477,373,96,318,220,78
060570012073,761,567,194,756,552,204,1003,755,225,759,504,191
060230007002,715,423,292,720,419,301,936,534,377,876,455,345
060230007003,684,368,316,681,354,327,827,466,335,720,360,310
060230106001,763,459,304,760,445,315,928,562,339,701,385,245
060230107011,363,188,175,360,179,181,496,278,201,421,203,188
060230107022,807,418,389,800,399,401,1046,581,437,983,469,430
060230003004,699,452,247,709,445,264,983,634,309,817,451,289
060230004003,453,292,161,461,285,176,647,405,217,544,307,186
060230107021,202,118,84,200,115,85,292,163,122,211,106,88
060230003005,595,375,220,592,365,227,705,451,232,566,327,189
060230004001,509,269,240,515,262,253,660,385,248,595,295,257
060230004002,414,215,199,416,207,209,552,309,225,479,229,211
060230007004,407,261,146,404,250,154,499,321,166,438,251,149
060230002002,329,230,99,333,226,107,479,319,147,408,240,125
060230006003,310,201,109,309,198,111,384,260,122,321,191,108
060230006002,517,327,190,518,323,195,629,429,183,569,325,190
060230007001,511,310,201,505,309,196,688,455,214,603,345,204
060230008001,541,315,226,537,307,230,746,463,263,585,316,214
060230112001,382,207,175,390,200,190,517,271,232,525,263,222
060230112003,587,310,277,581,290,291,770,387,360,576,255,241
060230112002,465,201,264,470,189,281,635,261,352,538,215,280
060230108003,372,178,194,371,167,204,500,226,259,407,177,193
060230109011,369,175,194,371,171,200,479,217,244,564,257,256
060230108001,518,265,253,514,266,248,498,248,232,458,206,204
060230111003,352,139,213,348,134,214,584,242,325,421,154,227
060230108002,439,233,206,440,218,222,763,361,367,545,242,253
060230110003,334,127,207,330,124,206,450,203,225,273,100,145
060230109024,667,256,411,664,237,427,856,336,491,603,210,350
060230111004,262,126,136,263,122,141,377,183,177,289,97,167
060230115021,544,393,151,532,368,164,738,504,220,1044,621,244
060230107012,241,135,106,238,130,108,339,188,142,217,105,86
060230107014,810,461,349,808,451,357,1124,622,463,898,450,366
060230107013,253,149,104,253,149,104,355,198,147,297,148,119
060230116006,151,91,60,149,90,59,228,160,63,223,100,91
060230109021,256,151,105,261,142,119,303,155,139,257,105,110
060230109022,242,94,148,242,89,153,361,147,202,373,141,204
060230108004,298,148,150,294,136,158,452,208,234,368,163,176
060230109012,341,173,168,343,169,174,500,224,254,305,141,136
060230110002,492,210,282,494,208,286,652,299,335,569,233,288
060230109013,738,323,415,737,312,425,1051,476,537,831,346,435
060230109023,571,235,336,572,230,342,781,342,410,766,289,410
060230110001,695,282,413,706,272,434,980,443,499,816,302,458
060230111001,323,127,196,319,121,198,450,181,251,416,154,225
060230111002,347,148,199,346,137,209,520,216,297,393,154,192
060230115013,632,497,135,627,480,147,758,530,194,255,155,58
060230116005,126,66,60,122,64,58,128,93,33,108,53,42
060230116001,258,201,57,257,196,61,326,227,84,293,170,65
060230116004,207,152,55,205,149,56,273,189,70,246,157,56
060230116003,374,270,104,372,261,111,520,358,134,355,204,88
060230115012,162,124,38,158,116,42,182,128,49,191,112,44
060230116002,181,130,51,183,126,57,286,196,73,189,107,58
060230115011,480,383,97,473,363,110,564,388,141,594,359,125
060230010023,454,423,31,457,418,39,522,458,45,432,344,33
060230010021,362,329,33,360,320,40,723,625,67,408,316,40
060230010012,633,584,49,632,576,56,831,734,61,730,551,51
060230009001,1070,948,122,1063,925,138,978,844,100,1176,894,146
060230010011,628,562,66,626,547,79,1028,888,92,817,613,80
060230011031,896,771,125,889,743,146,1105,954,113,990,716,130
060230011023,847,745,102,848,736,112,1093,924,129,797,594,94
060230011022,410,350,60,415,352,63,547,456,70,539,387,71
060230012001,862,738,124,865,722,143,1030,856,135,930,660,123
060230010022,391,355,36,394,351,43,300,258,30,448,358,35
060230009002,658,528,130,652,517,135,822,672,129,651,482,108
060230009004,674,491,183,670,479,191,801,566,215,709,462,174
060230013001,620,461,159,611,456,155,1041,733,271,587,379,137
060230011021,801,622,179,800,608,192,1078,789,243,900,583,201
060230012002,595,413,182,596,411,185,756,532,203,667,412,182
060230012003,432,340,92,426,327,99,615,464,126,471,309,106
060230103003,289,208,81,290,206,84,373,267,96,367,229,99
060230103004,408,289,119,405,283,122,543,387,139,389,239,105
060230008003,768,490,278,767,477,290,1006,638,336,870,507,272
060230009003,294,214,80,291,211,80,348,251,86,486,309,124
060230106002,490,328,162,490,321,169,606,387,203,301,173,103
060230001001,371,284,87,370,278,92,534,395,123,458,304,99
060230001002,373,287,86,374,279,95,572,413,123,460,300,98
060230001004,258,197,61,263,196,67,362,268,83,265,178,55
060230002004,420,289,131,421,288,133,587,398,166,405,237,108
060230002005,191,138,53,186,133,53,255,182,59,175,106,44
060230002006,324,236,88,323,229,94,435,321,103,344,220,79
060230003001,221,136,85,222,133,89,369,246,112,268,150,91
060230003002,215,141,74,216,137,79,310,205,95,254,140,87
060230002003,207,139,68,208,139,69,288,192,90,250,153,72
060230003003,222,145,77,223,143,80,318,209,97,269,147,92
060230002001,421,295,126,416,283,133,519,354,151,451,279,131
060230006004,531,370,161,531,358,173,690,484,179,525,319,154
060230005001,296,229,67,296,223,73,445,329,107,363,231,83
060230005002,344,252,92,344,249,95,467,324,127,505,297,145
060230005003,245,187,58,248,184,64,334,249,78,319,208,73
060230006001,321,225,96,316,217,99,428,291,114,361,217,109
060230006005,543,359,184,542,348,194,680,477,189,533,317,167
060230001003,263,199,64,262,193,69,293,217,65,341,212,93
060230005004,287,221,66,285,216,69,396,292,89,306,207,69
060230008002,631,368,263,627,360,267,834,507,294,706,374,258
060230103001,474,322,152,480,323,157,478,362,104,529,343,148
060230103002,329,206,123,327,201,126,377,240,127,341,189,117
060230105021,794,482,312,790,474,316,1079,696,353,837,475,298
060230101021,310,169,141,305,164,141,609,351,241,1016,578,329
060230103005,191,122,69,191,120,71,222,142,74,214,120,75
060230102001,471,383,88,458,363,95,586,456,115,488,350,85
060230102002,623,511,112,616,501,115,578,436,128,451,335,67
060230102003,171,141,30,173,138,35,346,261,75,301,205,57
060230102004,160,110,50,159,104,55,247,190,53,327,189,101
060230104002,759,513,246,756,508,248,968,625,321,843,501,271
060230101023,78,52,26,76,54,22,119,90,25,58,39,12
060230101024,209,151,58,209,148,61,223,169,48,213,117,52
060239400001,338,265,73,331,256,75,737,574,145,8,7,1
060239400002,18,14,4,17,13,4,44,36,8,16,12,3
060230101022,350,181,169,347,176,171,273,147,115,239,105,108
060230105032,761,507,254,758,494,264,1053,710,307,673,380,218
060230105031,507,347,160,502,343,159,681,457,201,659,402,198
060230105042,547,384,163,534,372,162,717,479,212,622,390,165
060230105022,805,496,309,794,493,301,1059,669,362,758,436,256
060230105041,865,582,283,867,572,295,1144,770,334,1094,643,340
060230105023,806,531,275,799,510,289,1134,718,391,866,504,285
060230104001,911,600,311,911,591,320,1094,732,325,980,567,324
060470003011,475,366,109,485,354,131,313,225,74,627,491,98
060470003012,167,127,40,170,125,45,620,449,152,199,152,33
060470003062,84,67,17,84,64,20,147,106,36,111,91,16
060470003063,53,42,11,52,38,14,89,67,22,54,44,9
060470003053,202,153,49,204,148,56,916,643,249,233,187,37
060470003051,480,364,116,496,353,143,822,582,216,553,444,83
060470003061,311,246,65,314,240,74,487,350,121,400,321,53
060470003013,556,389,167,561,389,172,825,543,268,599,422,140
060470003031,741,384,357,751,366,385,329,138,185,760,398,330
060470003052,214,161,53,217,154,63,344,239,99,205,164,36
060470015011,549,365,184,558,353,205,889,559,298,720,463,204
060470015031,174,146,28,176,138,38,260,189,65,213,173,29
060470015032,168,142,26,171,134,37,268,193,65,233,186,33
060470016032,176,147,29,178,142,36,344,253,76,239,189,29
060470016033,146,119,27,146,113,33,152,108,44,114,92,16
060470015021,167,138,29,169,129,40,240,178,51,231,182,30
060470015022,179,148,31,175,137,38,230,176,50,242,202,27
060470015033,158,134,24,160,124,36,260,204,45,206,172,22
060470016042,316,257,59,320,249,71,654,464,163,405,310,70
060470016041,191,152,39,194,149,45,322,228,85,277,213,48
060470016031,131,106,25,135,101,34,321,239,66,248,186,37
060470016012,100,85,15,103,81,22,158,126,23,138,118,13
060470016013,72,56,16,71,52,19,122,92,24,86,72,13
060470016011,127,101,26,130,97,33,230,170,50,187,151,25
060470014011,460,236,224,462,236,226,657,353,286,552,292,224
060470017002,223,144,79,228,145,83,375,226,139,300,175,93
060470019011,303,146,157,303,143,160,481,242,233,387,199,171
060470019014,198,154,44,197,147,50,355,255,88,260,200,40
060470019012,118,82,36,118,81,37,188,126,61,155,114,37
060470019013,180,120,60,184,117,67,309,188,109,224,152,61
060470019022,270,64,206,270,62,208,342,92,248,309,84,217
060470026012,280,132,148,286,134,152,173,50,115,376,180,174
060470026021,117,41,76,119,43,76,186,71,107,155,67,76
060470017004,376,232,144,378,220,158,591,336,233,508,289,184
060470009012,184,46,138,183,47,136,239,69,169,233,71,152
060470012002,508,271,237,523,271,252,639,352,278,574,295,246
060470012003,362,191,171,365,189,176,467,248,208,407,203,179
060470012004,724,288,436,734,289,445,816,337,458,820,337,434
060470014023,557,287,270,571,291,280,781,416,342,617,304,273
060470026022,441,195,246,450,200,250,686,309,361,496,215,255
060470026023,646,332,314,660,341,319,1369,778,570,766,380,355
060470014012,378,210,168,381,202,179,578,323,233,465,249,181
060470014021,318,165,153,327,169,158,446,240,198,402,202,175
060470014022,234,108,126,235,103,132,346,168,167,287,138,133
060470013012,352,211,141,354,204,150,543,318,205,445,232,168
060470010042,340,181,159,345,178,167,469,257,206,401,196,177
060470013013,199,129,70,201,122,79,325,204,117,257,148,97
060470011012,473,260,213,480,261,219,642,355,271,552,293,221
060470011013,514,268,246,521,270,251,715,370,332,619,316,265
060470012001,354,187,167,359,188,171,463,255,198,429,217,179
060470014024,271,144,127,277,143,134,408,221,179,347,174,154
060470013011,132,76,56,134,77,57,219,130,85,164,98,56
060470013021,186,102,84,187,100,87,272,154,108,224,117,81
060470013022,212,143,69,213,141,72,329,214,107,277,169,87
060470013023,186,133,53,185,126,59,290,190,86,269,171,77
060470010043,443,233,210,449,235,214,575,314,238,506,256,222
060470017003,298,187,111,300,177,123,421,257,146,422,254,131
060470011011,536,268,268,542,263,279,704,353,336,614,291,288
060470010063,569,294,275,577,291,286,837,474,345,676,350,280
060470010062,439,217,222,450,222,228,630,328,291,523,259,235
060470010071,262,171,91,265,169,96,951,639,293,260,161,79
060470010072,677,458,219,681,456,225,975,644,308,602,389,167
060470010061,592,341,251,601,328,273,816,485,318,691,356,285
060470011014,537,238,299,553,244,309,728,357,357,605,273,304
060470018011,1671,932,739,1711,930,781,1802,906,853,2006,1084,790
060470010033,212,156,56,212,151,61,323,229,83,282,195,70
060470010041,247,199,48,252,196,56,398,290,97,348,244,78
060470010051,469,316,153,479,308,171,716,488,216,595,371,183
060470026011,156,84,72,156,82,74,676,418,243,180,113,55
060470017001,232,120,112,235,124,111,434,243,185,275,123,139
060470006011,303,143,160,308,135,173,443,210,217,367,167,175
060470006012,320,177,143,326,168,158,456,249,196,361,198,146
060470006013,176,104,72,177,96,81,265,147,110,217,122,84
060470007011,309,185,124,311,181,130,543,333,186,422,243,156
060470007012,202,120,82,206,122,84,338,219,111,287,168,104
060470008021,600,305,295,606,297,309,965,474,465,748,368,349
060470008022,614,302,312,625,296,329,1025,513,488,785,392,353
060470006021,507,243,264,509,232,277,749,380,352,652,307,304
060470006022,357,154,203,362,155,207,530,248,268,460,186,236
060470008012,458,226,232,459,223,236,716,352,350,437,222,193
060470005031,432,132,300,442,130,312,679,229,444,552,178,345
060470006033,306,161,145,308,161,147,438,224,199,372,186,167
060470006034,123,66,57,123,65,58,203,103,93,153,77,69
060470006035,80,42,38,81,42,39,146,75,66,106,54,48
060470006014,440,186,254,446,179,267,624,279,328,524,211,275
060470006031,544,208,336,549,212,337,774,326,432,608,216,365
060470006032,321,139,182,326,140,186,451,198,242,364,146,204
060470009041,591,279,312,600,277,323,1114,547,546,774,376,351
060470008011,506,248,258,510,250,260,710,356,343,563,272,269
060470008013,516,296,220,521,285,236,866,490,357,477,254,195
060470009032,451,201,250,454,205,249,798,376,403,568,250,292
060470009042,393,254,139,399,237,162,660,391,254,491,309,162
060470010081,367,241,126,368,228,140,619,371,229,451,274,148
060470025002,563,195,368,569,195,374,670,227,430,615,195,390
060470007021,615,149,466,619,146,473,726,194,523,691,184,466
060470007023,496,173,323,499,180,319,792,298,479,604,232,340
060470009031,416,281,135,419,275,144,543,346,179,484,311,143
060470007022,915,269,646,921,274,647,1267,420,826,1022,325,653
060470010082,742,436,306,753,435,318,1059,624,412,905,521,334
060470010032,359,257,102,358,251,107,523,370,141,455,313,116
060470010083,474,310,164,481,300,181,918,591,300,621,390,180
060470003032,176,76,100,175,69,106,255,112,134,218,92,114
060470005051,535,210,325,532,204,328,717,288,415,628,270,330
060470002011,493,189,304,499,187,312,636,230,393,517,184,307
060470025001,280,76,204,284,83,201,424,125,290,329,84,229
060470002012,379,193,186,390,191,199,571,260,289,440,210,202
060470002021,345,171,174,355,168,187,508,251,249,408,220,168
060470002051,212,148,64,215,143,72,526,332,181,364,241,99
060470002041,260,179,81,264,178,86,522,327,178,371,252,92
060470002042,156,111,45,156,108,48,288,187,95,225,160,52
060470002052,221,162,59,225,158,67,365,247,107,269,194,55
060470002053,221,163,58,223,157,66,387,263,114,273,200,57
060470002043,322,227,95,325,224,101,625,397,209,444,306,109
060470020021,440,193,247,443,176,267,690,298,381,516,207,285
060470020022,366,189,177,370,180,190,558,272,264,450,209,204
060470020023,149,67,82,153,66,87,227,108,116,194,86,97
060470020024,324,177,147,336,174,162,478,241,233,399,194,179
060470020025,274,126,148,278,122,156,456,200,243,336,153,162
060470020011,296,112,184,299,109,190,408,161,234,358,134,194
060470004031,411,106,305,417,105,312,675,170,493,450,122,309
060470004032,575,181,394,592,171,421,938,255,667,661,197,425
060470004042,829,203,626,843,180,663,1316,293,999,915,224,639
060470004041,422,98,324,437,98,339,600,132,463,480,108,361
060470004011,192,65,127,192,58,134,616,192,411,220,81,132
060470009011,311,72,239,319,74,245,386,88,291,364,101,246
060470005042,334,214,120,336,195,141,390,225,156,443,282,137
060470005052,138,85,53,142,76,66,215,118,91,173,111,54
060470005043,255,169,86,260,162,98,719,464,240,370,233,117
060470005053,285,187,98,283,177,106,570,363,194,375,233,123
060470005041,304,188,116,308,181,127,404,246,149,403,244,135
060470021001,429,139,290,440,129,311,592,200,383,505,174,312
060470021002,117,36,81,120,35,85,256,82,166,142,51,85
060470023031,527,291,236,534,282,252,778,418,345,670,339,285
060470024032,473,225,248,480,221,259,775,374,388,504,238,243
060470024041,329,189,140,326,177,149,494,275,209,391,217,157
060470024042,127,93,34,126,84,42,223,157,59,165,113,38
060470024043,463,212,251,475,207,268,662,307,345,566,257,275
060470022011,102,63,39,105,60,45,214,136,76,161,100,52
060470022012,209,132,77,215,123,92,248,140,102,256,156,86
060470022013,158,101,57,165,94,71,286,161,114,209,126,69
060470022015,325,202,123,330,188,142,476,274,193,403,245,137
060470023011,707,264,443,724,249,475,941,364,561,794,295,464
060470022014,329,201,128,329,190,139,367,213,144,304,181,104
060470023014,654,339,315,660,321,339,1024,547,458,791,402,355
060470023013,380,220,160,387,213,174,1051,611,418,466,252,185
060470023012,440,191,249,450,189,261,594,273,303,494,197,268
060470022042,369,246,123,369,223,146,543,360,173,418,272,125
060470022043,125,83,42,128,77,51,212,139,69,154,100,45
060470023051,316,194,122,318,185,133,602,373,214,372,220,134
060470023033,512,367,145,521,355,166,888,610,253,653,446,173
060470023052,513,371,142,524,355,169,873,607,257,504,341,138
060470023041,517,346,171,524,337,187,1063,696,340,594,383,174
060470023061,577,419,158,584,405,179,1022,706,295,639,452,156
060470022041,584,406,178,599,397,202,895,611,261,713,469,203
060470022031,254,185,69,256,170,86,480,336,132,307,195,85
060470022032,479,336,143,485,317,168,762,535,202,616,419,160
060470023032,114,78,36,113,77,36,270,172,93,136,83,41
060470022033,281,203,78,288,187,101,467,316,143,372,264,91
060470024031,191,132,59,192,121,71,281,180,96,230,154,63
060470021003,318,193,125,320,180,140,443,267,165,368,193,150
060470024011,414,112,302,417,109,308,553,167,377,492,136,330
060470009013,226,71,155,230,70,160,374,140,223,270,103,156
060470019021,313,182,131,311,171,140,486,287,185,378,217,134
060470010031,155,98,57,160,92,68,239,159,74,205,129,66
061110009021,364,203,161,371,204,167,453,263,177,401,210,157
061110011021,1020,591,429,1030,593,437,1351,801,526,1116,594,452
061110011022,715,385,330,723,375,348,994,563,413,829,400,362
061110012041,815,485,330,827,478,349,1167,684,442,927,507,332
061110095004,427,228,199,430,225,205,502,285,210,436,228,190
061110093002,1397,636,761,1410,617,793,1876,926,898,1648,725,831
061110005001,529,327,202,528,306,222,829,532,286,669,423,213
061110009031,494,366,128,501,368,133,601,457,140,582,407,135
061110009032,458,290,168,465,290,175,521,331,180,491,281,172
061110009033,626,446,180,641,445,196,842,594,223,732,489,198
061110009022,821,574,247,832,577,255,1068,746,299,868,566,241
061110097003,325,166,159,333,167,166,389,191,185,361,169,165
061110050062,416,325,91,418,319,99,658,484,156,546,420,95
061110050061,300,234,66,301,233,68,449,336,102,411,321,68
061110050052,431,335,96,431,326,105,677,500,164,574,440,105
061110050053,149,128,21,146,116,30,356,284,62,231,191,29
061110050051,194,152,42,194,144,50,269,189,72,227,176,41
061110050021,334,252,82,340,255,85,441,343,82,463,374,68
061110050041,2541,1807,734,2566,1758,808,4296,3087,1121,2871,1886,787
061110003022,901,516,385,909,505,404,1206,699,477,993,544,390
061110003042,356,223,133,361,217,144,569,370,183,446,284,138
061110003043,412,264,148,416,257,159,603,394,200,472,304,144
061110003024,434,288,146,440,279,161,598,388,190,500,322,147
061110003023,183,119,64,185,114,71,261,168,89,303,194,95
061110003021,871,467,404,890,464,426,1288,748,521,574,321,230
061110003031,455,296,159,463,287,176,674,436,226,552,354,169
061110003032,472,308,164,477,295,182,712,461,239,552,354,167
061110003033,506,291,215,515,281,234,881,524,346,822,486,297
061110053053,713,281,432,717,281,436,879,404,457,764,305,410
061110076073,1108,564,544,1126,561,565,3367,1857,1446,1269,614,585
061110076122,801,426,375,816,424,392,1098,587,491,955,476,419
061110093001,1378,653,725,1399,653,746,1415,690,699,606,299,275
061110076141,656,360,296,666,352,314,863,489,353,1430,753,600
061110075151,873,387,486,881,372,509,1236,566,648,962,418,481
061110077001,872,451,421,887,444,443,1259,657,579,1037,511,454
061110003041,313,137,176,318,133,185,423,201,212,356,156,171
061110023022,423,301,122,428,299,129,634,442,178,480,305,132
061110052022,1027,457,570,1038,456,582,1302,656,614,1082,492,519
061110052031,1219,611,608,1246,596,650,1590,850,704,1390,660,636
061110052033,506,244,262,519,245,274,649,351,289,548,259,255
061110052032,1200,542,658,1212,535,677,1409,705,674,1332,594,636
061110036171,494,262,232,500,266,234,673,379,285,584,304,250
061110036172,367,225,142,374,229,145,569,340,212,418,247,151
061110075112,231,134,97,237,132,105,331,186,137,275,147,105
061110075122,385,223,162,394,216,178,500,280,206,401,217,156
061110075123,719,401,318,734,397,337,1061,568,463,1282,564,621
061110083043,716,335,381,732,325,407,960,454,493,801,340,414
061110075111,996,542,454,1006,548,458,1298,758,513,1139,638,452
061110052041,1077,462,615,1091,466,625,1339,658,653,1134,473,598
061110052051,1582,653,929,1602,652,950,1935,907,1001,1666,656,922
061110052053,1627,846,781,1655,848,807,2335,1267,1028,1790,931,743
061110052021,326,153,173,328,148,180,463,215,236,384,163,200
061110095002,543,289,254,544,279,265,661,369,283,588,290,255
061110095001,336,171,165,335,161,174,424,245,172,359,186,141
061110011012,744,433,311,763,423,340,1004,614,373,826,433,319
060379201041,1170,462,708,1199,444,755,1663,718,912,1336,481,784
061110009011,1139,819,320,1152,812,340,1301,970,310,1215,826,310
061110009012,366,248,118,370,249,121,423,302,115,406,271,107
061110010021,913,567,346,919,559,360,1061,673,369,984,565,349
061110010023,967,611,356,982,601,381,1380,883,472,1024,581,361
061110010024,536,383,153,538,375,163,763,536,210,614,383,182
061110010022,772,441,331,781,441,340,841,497,323,814,429,321
061110012013,163,91,72,166,91,75,266,154,107,158,80,69
061110008004,480,284,196,485,275,210,866,511,344,753,441,276
061110012011,848,512,336,862,494,368,999,597,377,968,548,359
061110028001,664,445,219,676,446,230,887,581,277,974,590,318
061110014021,1021,550,471,1032,539,493,1459,857,565,1163,617,470
061110015062,549,322,227,561,316,245,698,419,268,785,417,310
061110076131,716,338,378,727,338,389,1900,1087,766,803,398,365
061110076144,548,313,235,556,304,252,1135,662,444,626,352,237
061110076113,362,270,92,368,268,100,0,0,0,432,304,98
061110076111,362,249,113,364,245,119,560,393,161,431,283,123
061110076112,386,281,105,388,278,110,510,374,126,478,333,116
061110076121,634,443,191,639,431,208,1392,979,376,743,484,209
061110076142,1176,609,567,1192,609,583,1271,709,538,1337,663,575
061110076143,545,282,263,553,283,270,760,424,322,613,303,263
061110076071,1355,665,690,1379,671,708,1076,581,475,1480,716,678
061110076101,1175,520,655,1195,519,676,1576,765,785,1372,611,673
061110076102,1388,604,784,1411,611,800,1774,856,884,1524,677,738
061110076091,1336,626,710,1362,617,745,811,456,342,1486,720,655
061110076072,546,276,270,554,277,277,404,228,171,608,303,276
061110076132,825,366,459,841,363,478,1103,534,545,918,404,454
061110096002,1581,879,702,1608,873,735,2036,1224,768,2334,1312,879
061110094002,361,212,149,372,214,158,599,377,204,470,253,185
061110018012,506,309,197,516,311,205,641,404,220,566,339,197
061110046001,65,29,36,66,28,38,163,67,84,143,38,83
061110004001,231,137,94,229,135,94,371,234,133,169,105,56
061110008002,1132,722,410,1150,700,450,1590,986,567,1486,950,457
061110074033,1180,716,464,1202,726,476,1556,974,557,1310,779,461
061110074051,833,502,331,850,506,344,1095,690,387,919,553,312
061110074054,990,611,379,1006,610,396,1402,911,459,1176,709,406
061110074052,467,286,181,475,287,188,643,412,215,530,319,180
061110074031,573,354,219,581,349,232,773,511,245,638,392,212
061110074032,888,549,339,905,543,362,1212,802,386,1002,614,337
061110074061,1111,687,424,1126,677,449,1448,956,461,1254,768,421
061110074053,415,258,157,422,257,165,568,370,183,419,253,146
061110011011,1204,693,511,1233,691,542,1672,950,676,1348,711,539
061110059062,441,225,216,444,224,220,551,300,237,499,257,222
061110047041,296,217,79,299,215,84,435,303,124,369,274,80
061110047151,545,393,152,550,395,155,862,616,235,686,501,160
061110056023,1078,657,421,1094,656,438,1402,864,500,1273,753,417
061110047152,553,407,146,554,413,141,825,594,211,693,512,152
061110047171,341,266,75,336,256,80,574,441,125,456,361,69
061110047161,399,313,86,398,309,89,610,455,146,584,464,94
061110009034,512,371,141,524,370,154,694,512,166,569,386,146
061110009035,605,419,186,612,417,195,798,564,220,651,420,186
061110092002,690,532,158,695,514,181,1178,855,303,813,586,184
061110030132,552,360,192,558,348,210,900,637,246,748,490,196
061110030131,783,540,243,790,534,256,1075,747,311,859,570,241
061110030111,716,545,171,721,505,216,1087,791,272,893,672,176
061110030101,796,579,217,806,573,233,1152,817,312,964,692,217
061110030112,459,357,102,459,337,122,685,520,144,569,443,96
061110092001,816,645,171,815,623,192,1248,907,315,1083,808,219
061110088002,433,334,99,438,332,106,692,520,156,569,440,101
061110088001,641,486,155,643,482,161,970,720,226,855,652,159
061110036143,479,325,154,486,317,169,713,488,210,532,338,157
061110036141,620,425,195,624,419,205,875,596,261,685,438,192
061110047103,339,250,89,338,249,89,509,355,147,421,308,94
061110047101,391,292,99,396,291,105,548,404,132,511,387,104
061110045072,113,89,24,116,87,29,166,125,34,161,129,22
061110045071,62,49,13,61,46,15,112,86,25,82,66,13
061110045081,83,65,18,83,63,20,147,114,30,119,97,17
061110045082,195,152,43,197,148,49,407,295,107,288,235,40
061110008003,658,446,212,665,425,240,917,592,307,785,533,228
061110007022,565,381,184,568,363,205,730,478,245,673,437,195
061110045051,416,341,75,416,331,85,640,488,142,492,381,83
061110045041,403,316,87,400,304,96,628,475,142,502,383,101
061110045043,323,217,106,330,213,117,493,328,151,446,304,119
061110045042,242,162,80,245,160,85,371,246,115,343,235,91
061110040002,366,304,62,369,294,75,473,358,97,511,405,74
061110041012,437,359,78,437,346,91,654,520,122,569,443,88
061110041013,361,295,66,361,286,75,576,459,107,494,390,76
061110089002,426,351,75,425,340,85,651,519,120,531,435,71
061110041011,414,342,72,412,328,84,732,571,139,524,424,69
061110042002,395,287,108,392,275,117,627,444,167,487,334,122
061110089001,313,261,52,313,243,70,489,355,108,400,325,51
061110029051,1133,767,366,1146,746,400,1582,1092,454,1273,845,355
061110040001,318,264,54,321,254,67,489,380,102,407,329,61
061110036162,812,354,458,818,352,466,1060,546,497,794,345,398
061110036163,436,210,226,441,212,229,522,274,240,486,246,208
061110047162,459,385,74,458,375,83,696,549,132,613,507,81
061110047172,354,282,72,350,275,75,561,418,128,494,392,77
061110045031,175,134,41,174,131,43,286,206,75,254,192,47
061110045032,249,192,57,251,188,63,432,306,112,347,265,64
061110045033,268,206,62,265,200,65,419,304,110,389,298,71
061110039011,568,485,83,569,470,99,871,703,148,734,620,82
061110039021,656,536,120,652,511,141,1021,796,210,843,697,111
061110037001,295,259,36,291,250,41,469,386,72,421,364,35
061110037004,372,328,44,367,316,51,570,475,87,517,457,43
061110037003,299,254,45,300,246,54,500,395,93,402,327,51
061110038012,218,192,26,217,187,30,336,279,51,304,266,26
061110038013,346,298,48,343,287,56,565,461,100,449,384,54
061110038021,314,271,43,317,259,58,433,349,81,420,349,52
061110091003,15,13,2,15,13,2,239,183,44,87,79,4
061110036082,557,397,160,558,379,179,882,636,228,699,497,149
061110036081,457,325,132,462,315,147,655,477,172,540,387,117
061110086012,182,142,40,184,140,44,281,208,68,274,191,65
061110086013,344,270,74,349,267,82,547,405,132,502,357,109
061110086023,197,154,43,196,151,45,288,209,69,285,208,56
061110086021,103,82,21,102,78,24,266,198,56,134,103,22
061110036132,756,524,232,760,517,243,1153,762,367,873,579,247
061110036131,486,338,148,490,334,156,702,468,221,581,383,165
061110031011,385,310,75,385,303,82,491,397,84,410,328,52
061110033021,380,285,95,381,285,96,544,405,121,499,358,115
061110033022,647,485,162,652,478,174,934,678,244,767,551,174
061110087002,741,554,187,749,553,196,1269,923,321,1118,810,240
061110037002,215,182,33,214,175,39,359,279,66,304,245,39
061110032011,186,167,19,184,162,22,289,252,36,276,237,26
061110032012,211,188,23,210,185,25,359,313,43,287,255,25
061110091001,343,300,43,345,290,55,611,495,92,493,421,43
061110091004,203,184,19,201,177,24,250,215,27,284,240,20
061110038011,212,176,36,211,169,42,353,287,61,335,271,48
061110088003,508,366,142,507,367,140,743,534,196,640,469,138
061110036142,627,421,206,632,402,230,900,619,261,763,487,231
061110033023,203,151,52,204,145,59,353,262,88,265,187,68
061110033011,506,378,128,509,367,142,788,568,200,625,442,142
061110087001,459,356,103,461,338,123,737,552,166,584,437,113
061110029013,849,521,328,851,498,353,1301,798,483,967,584,317
061110029012,732,469,263,736,449,287,1009,645,342,829,504,282
061110029011,689,443,246,697,426,271,881,569,302,754,460,257
061110033012,255,191,64,261,186,75,395,287,102,319,226,75
061110029052,885,600,285,888,581,307,1224,851,341,1022,678,286
061110038022,118,98,20,118,92,26,176,140,29,194,158,28
061110049021,422,368,54,420,350,70,663,556,93,563,490,49
061110049022,409,359,50,408,344,64,620,523,74,556,489,42
061110031022,679,503,176,682,489,193,1177,822,328,951,710,197
061110031013,476,346,130,479,336,143,800,549,239,581,422,126
061110031012,281,205,76,281,198,83,457,314,137,337,245,74
061110086022,350,281,69,353,270,83,329,249,70,272,215,42
061110086011,200,159,41,198,150,48,305,234,67,237,191,39
061110040003,303,238,65,302,231,71,476,354,113,383,299,65
061110040004,287,226,61,288,222,66,437,324,105,364,284,61
061110049013,486,367,119,490,357,133,757,536,203,608,445,128
061110049012,592,448,144,597,432,165,954,671,252,769,557,164
061110049011,624,471,153,633,459,174,996,705,261,761,552,161
061110031021,703,523,180,703,511,192,1030,740,277,845,639,166
061110036161,767,371,396,780,376,404,997,514,460,829,358,425
061110036183,601,352,249,616,349,267,852,495,341,691,353,288
061110036151,711,400,311,720,402,318,984,569,387,837,435,353
061110036152,628,352,276,640,356,284,841,495,337,685,362,291
061110091002,32,24,8,31,21,10,65,44,19,56,40,10
061110047102,270,199,71,274,195,79,442,339,86,347,250,80
061110047111,284,208,76,286,206,80,485,318,160,389,283,89
061110047112,437,320,117,441,318,123,767,505,255,604,433,137
060290033072,370,166,204,377,165,212,473,219,245,397,155,219
060290033073,219,93,126,224,93,131,292,132,155,233,85,136
061110057001,247,174,73,249,175,74,306,215,86,279,183,72
061110056021,1068,483,585,1088,493,595,1333,650,665,1172,553,570
061110058012,1082,534,548,1099,530,569,1278,713,537,1021,525,439
061110097001,244,181,63,244,175,69,424,310,107,340,247,70
061110097002,216,163,53,217,156,61,367,269,92,298,219,62
061110043051,60,35,25,60,37,23,187,76,96,101,34,57
061110044005,506,299,207,512,305,207,1072,670,371,722,410,263
061110042001,595,414,181,602,414,188,933,625,279,780,529,193
061110044001,398,277,121,404,278,126,621,427,179,486,329,121
061110044002,615,415,200,621,417,204,750,506,228,622,424,152
061110044003,296,206,90,297,206,91,470,315,141,379,257,93
061110042003,465,338,127,464,324,140,699,493,187,584,399,146
061110043041,1039,662,377,1048,652,396,1372,898,445,1178,743,373
061110043042,244,155,89,247,154,93,351,230,114,273,173,88
061110043043,425,276,149,427,267,160,639,417,210,538,342,159
061110043044,369,241,128,370,234,136,553,360,182,419,269,118
061110044004,277,164,113,279,165,114,242,156,78,323,185,116
061110004002,529,301,228,529,294,235,653,365,277,412,231,162
061110004003,658,416,242,654,401,253,955,642,300,958,612,307
061110006001,211,125,86,214,117,97,359,254,98,246,148,84
061110008001,319,194,125,319,182,137,462,307,145,283,175,95
061110007013,312,204,108,315,196,119,483,336,140,384,257,108
061110007014,289,204,85,290,198,92,319,241,73,272,189,69
061110007011,392,272,120,397,263,134,563,399,154,491,341,126
061110007012,314,227,87,317,223,94,463,314,143,395,279,93
061110004004,325,275,50,325,263,62,551,453,84,436,374,39
061110006002,214,153,61,212,147,65,412,302,103,252,188,50
061110007021,502,338,164,506,324,182,645,415,220,546,354,157
061110006005,106,86,20,107,83,24,171,130,35,164,129,26
061110006004,248,201,47,246,193,53,442,324,109,348,273,55
061110006003,166,130,36,168,128,40,299,237,60,228,178,42
061110053051,1306,496,810,1322,506,816,1642,730,882,1400,533,771
061110013021,732,431,301,738,413,325,1049,651,370,860,481,327
061110013031,592,368,224,593,352,241,730,475,240,598,355,207
061110055021,579,306,273,588,306,282,727,412,296,621,309,263
061110053052,2226,1047,1179,2251,1036,1215,1509,711,763,1636,753,782
061110053072,619,311,308,628,308,320,1146,641,481,672,339,287
061110053071,472,238,234,477,235,242,1001,542,436,556,279,238
061110059063,788,356,432,799,353,446,1058,532,510,733,345,343
061110073001,918,423,495,924,414,510,1167,591,550,1092,489,543
061110059101,1063,553,510,1078,543,535,1358,713,618,1127,560,492
061110054011,920,419,501,943,417,526,1070,528,512,1040,449,517
061110054012,974,443,531,998,438,560,1414,705,678,1069,460,532
061110036182,424,247,177,430,244,186,608,349,240,513,264,212
061110053081,2012,1039,973,2044,1032,1012,1967,1105,814,2092,1045,904
061110054031,773,478,295,787,471,316,1179,716,434,950,570,307
061110077002,518,262,256,528,262,266,995,546,425,583,294,249
061110077003,625,316,309,639,316,323,930,507,394,789,393,331
061110078002,327,179,148,332,173,159,598,343,244,353,182,151
061110078003,167,91,76,168,87,81,316,181,128,189,98,81
061110078001,466,255,211,469,245,224,743,428,304,546,282,235
061110080041,662,319,343,668,311,357,907,446,444,743,334,356
061110080043,264,133,131,266,127,139,452,232,214,313,142,149
061110080044,424,225,199,428,217,211,598,302,280,477,223,217
061110054041,937,491,446,952,476,476,1296,678,577,1092,535,472
061110075063,595,264,331,603,265,338,1228,599,601,623,272,314
061110075064,1597,706,891,1633,699,934,1691,771,888,1591,670,829
061110075062,1148,431,717,1169,425,744,1562,576,960,1233,440,730
061110080051,578,297,281,590,294,296,841,413,412,638,299,294
061110080052,360,189,171,365,188,177,520,260,248,392,187,175
061110075051,726,340,386,738,332,406,861,420,420,819,354,408
061110080042,437,231,206,441,217,224,668,338,308,534,247,249
061110079011,704,398,306,709,385,324,1092,599,457,870,450,358
061110079012,338,192,146,344,187,157,491,273,207,410,208,173
061110085022,719,375,344,729,371,358,1164,630,510,835,412,376
061110075124,346,152,194,348,152,196,435,199,226,383,168,192
061110075121,1048,460,588,1053,460,593,1426,653,739,1134,496,566
061110080011,593,287,306,607,288,319,857,428,404,667,310,317
061110080012,599,295,304,608,289,319,951,476,454,680,316,321
061110080022,913,421,492,928,414,514,1122,513,584,1076,469,544
061110052042,655,306,349,666,307,359,1007,519,458,732,350,333
061110079032,1146,545,601,1163,537,626,1611,756,809,1234,579,587
061110079031,983,426,557,999,405,594,1303,574,701,1081,438,574
061110085011,1393,617,776,1419,611,808,1550,760,752,1555,647,813
061110085012,1221,495,726,1241,492,749,1783,824,922,1373,524,766
061110079042,469,226,243,477,221,256,637,320,297,546,242,267
061110079044,830,397,433,846,390,456,1109,558,523,952,419,467
061110079043,312,150,162,320,146,174,452,229,216,368,163,181
061110081012,583,276,307,587,269,318,787,392,375,1577,711,763
061110081011,733,378,355,746,359,387,1004,513,474,0,0,0
061110082021,636,347,289,653,341,312,749,408,320,651,323,287
061110082022,489,267,222,501,261,240,797,429,352,550,277,240
061110082023,711,389,322,730,381,349,955,513,423,803,402,350
061110080021,615,281,334,626,276,350,899,401,478,697,296,356
061110080023,194,101,93,197,94,103,276,137,129,214,99,103
061110082011,664,343,321,670,322,348,970,483,465,785,362,377
061110082012,978,518,460,991,502,489,1457,752,668,1097,530,502
061110084021,1821,805,1016,1863,795,1068,1329,595,703,1008,427,525
061110084022,697,304,393,713,300,413,928,417,495,753,295,413
061110084023,415,181,234,424,179,245,580,261,310,470,185,257
061110085021,586,266,320,600,266,334,797,359,420,657,270,338
061110083021,811,417,394,824,411,413,1119,560,541,876,417,400
061110083023,1396,703,693,1420,690,730,1851,940,868,1154,571,511
061110083022,500,250,250,510,242,268,700,362,324,0,0,0
061110083031,24,12,12,25,12,13,494,248,233,32,15,15
061110083032,355,177,178,364,174,190,541,278,248,456,214,212
061110083041,445,212,233,456,210,246,610,300,298,1914,883,903
061110075072,487,165,322,489,160,329,601,239,351,533,176,328
061110075074,1430,643,787,1442,639,803,1821,923,871,1567,700,790
061110075131,873,322,551,891,319,572,1157,448,679,925,310,564
061110083042,890,415,475,906,404,502,1213,573,620,1025,435,525
061110083081,1247,537,710,1272,539,733,1812,894,883,1377,572,721
061110083082,941,406,535,961,409,552,1316,627,660,1035,434,541
061110084013,685,301,384,702,305,397,1011,492,500,780,331,403
061110084012,605,276,329,617,272,345,806,364,421,652,285,331
061110084024,403,184,219,413,181,232,526,238,276,411,179,208
061110083033,246,135,111,249,135,114,860,444,399,258,134,109
061110083071,286,157,129,291,157,134,448,253,185,321,166,136
061110083072,570,313,257,579,313,266,1026,536,462,684,355,291
061110075161,616,300,316,617,293,324,816,434,368,711,342,335
061110075152,641,308,333,648,298,350,902,439,446,724,322,350
061110075071,1343,605,738,1358,598,760,1637,829,778,1380,632,680
061110075162,758,380,378,770,378,392,1002,528,451,826,396,390
061110079041,712,343,369,725,339,386,963,488,448,756,337,368
061110075052,867,378,489,883,364,519,1139,529,579,917,375,484
061110055032,932,410,522,944,405,539,1121,571,525,893,387,445
061110055041,1059,515,544,1079,503,576,1288,659,599,1307,603,607
061110075061,519,236,283,524,236,288,768,395,356,554,249,271
061110075073,417,190,227,421,190,231,573,295,267,449,202,220
061110075102,1253,695,558,1275,694,581,1584,999,561,1369,772,532
061110084011,901,424,477,916,424,492,1222,616,589,938,417,466
061110079013,570,323,247,580,317,263,830,465,344,703,346,304
061110055042,905,446,459,927,438,489,1264,690,547,990,464,453
061110052052,490,231,259,498,232,266,706,396,300,578,291,250
061110055031,134,64,70,137,64,73,706,393,298,143,73,62
061110053061,1113,516,597,1130,517,613,1429,730,660,1243,565,594
061110053062,1255,573,682,1263,565,698,1583,815,738,1404,637,679
061110053041,743,387,356,755,386,369,958,521,414,803,409,347
061110053042,778,406,372,792,406,386,1011,573,424,837,425,363
061110053044,997,522,475,1013,523,490,1162,661,492,1049,562,450
061110053043,692,346,346,702,347,355,823,460,353,730,369,326
061110056022,355,197,158,361,195,166,515,297,204,408,223,157
061110056012,587,268,319,598,272,326,767,378,380,650,302,321
061110053073,1388,671,717,1414,677,737,1863,972,858,1538,740,693
061110056013,607,332,275,615,326,289,2156,1270,830,730,389,294
061110056011,450,247,203,457,242,215,693,410,270,517,274,209
061110068003,438,249,189,450,250,200,592,336,239,493,271,184
061110070001,489,326,163,498,317,181,795,522,253,569,359,169
061110070002,600,399,201,610,388,222,893,590,285,695,440,208
061110071003,268,162,106,274,162,112,424,257,156,309,179,114
061110071004,490,284,206,499,283,216,729,427,281,582,312,234
061110072021,1940,990,950,1966,993,973,1944,1104,808,2070,1072,889
061110071001,378,238,140,380,234,146,693,446,232,449,283,145
061110071002,572,313,259,580,311,269,908,578,308,687,376,273
061110064001,1132,531,601,1144,538,606,1490,763,692,1356,667,620
061110072022,899,433,466,912,445,467,1153,621,508,972,481,442
061110068002,626,324,302,639,324,315,827,440,373,721,360,317
061110059061,1560,857,703,1579,865,714,2040,1211,791,1698,943,674
061110059073,809,426,383,827,433,394,987,578,394,887,478,356
061110072012,947,457,490,968,462,506,1272,611,628,1077,519,500
061110072011,804,383,421,814,378,436,1096,560,521,995,469,471
061110059082,545,286,259,556,284,272,806,458,334,622,305,280
061110059091,791,425,366,803,425,378,1300,735,540,880,445,399
061110059092,925,467,458,943,470,473,874,494,364,1049,526,467
061110059112,385,211,174,391,209,182,603,342,247,439,232,181
061110058011,329,159,170,336,155,181,415,227,178,365,171,169
061110058013,1183,579,604,1207,568,639,1849,1027,776,1287,635,569
061110058031,1579,772,807,1616,771,845,2084,1116,932,1397,645,665
061110058043,428,222,206,439,226,213,603,346,246,483,256,202
061110058044,683,347,336,698,348,350,897,508,370,765,389,328
061110059012,1357,666,691,1380,655,725,1499,775,691,1487,704,682
061110059015,622,306,316,631,303,328,772,415,340,675,328,306
061110058041,385,201,184,394,203,191,532,306,216,484,259,198
061110058042,640,320,320,652,319,333,791,450,323,1168,622,482
061110063011,1337,753,584,1358,762,596,1875,1124,707,1476,834,567
061110063021,651,347,304,665,338,327,435,264,162,722,366,322
061110063022,701,357,344,718,355,363,902,514,366,773,397,339
061110065001,503,272,231,513,269,244,602,328,262,576,300,236
061110065002,748,401,347,763,399,364,1222,669,525,734,382,299
061110062001,1214,632,582,1240,630,610,1433,837,566,1280,678,522
061110063012,1281,665,616,1300,662,638,1614,938,649,1422,720,618
061110063013,774,420,354,784,425,359,982,580,383,825,460,322
061110067001,371,170,201,374,169,205,563,300,255,409,177,207
061110069002,947,525,422,961,527,434,1100,658,424,1065,571,436
061110066001,711,351,360,730,346,384,1239,614,598,797,382,372
061110064002,1200,628,572,1215,621,594,1470,835,604,1287,676,544
061110064004,411,217,194,420,216,204,523,297,217,440,232,182
061110064005,516,278,238,526,273,253,679,384,279,565,307,223
061110066002,1377,662,715,1410,657,753,1387,743,621,1530,727,713
061110067002,1023,574,449,1046,564,482,1494,867,603,1145,633,449
061110061012,780,453,327,791,444,347,1157,725,404,1987,1028,830
061110059113,833,411,422,845,413,432,977,554,410,891,446,393
061110059011,503,253,250,508,247,261,647,328,299,562,273,249
061110059013,784,381,403,798,376,422,1016,510,481,882,408,419
061110059014,372,181,191,380,176,204,493,257,227,403,189,186
061110059071,661,365,296,678,367,311,847,485,354,726,391,307
061110059072,530,291,239,543,291,252,696,392,300,592,315,257
061110075101,936,465,471,952,467,485,1475,821,624,1047,536,456
061110075081,651,332,319,664,333,331,802,466,322,701,366,296
061110075103,1051,583,468,1069,580,489,1395,823,550,1158,651,450
061110062002,635,294,341,647,296,351,781,407,356,653,308,301
061110061011,853,498,355,868,488,380,1189,746,415,1021,589,370
061110061022,206,115,91,211,114,97,361,227,126,235,132,86
061110061021,438,256,182,444,250,194,654,410,228,503,291,183
061110059064,410,215,195,420,218,202,512,299,202,452,242,181
061110069001,484,302,182,495,305,190,769,492,260,558,337,193
061110059081,640,335,305,651,330,321,995,526,445,737,359,331
061110060002,740,377,363,757,370,387,1034,541,467,230,107,110
061110060003,726,354,372,739,355,384,939,498,418,796,366,370
061110064003,461,237,224,464,235,229,547,316,224,494,254,219
061110075082,988,553,435,1005,543,462,1331,805,496,1089,601,415
061110075091,675,351,324,685,354,331,921,555,352,734,397,303
061110075092,1064,598,466,1084,590,494,1472,902,538,1207,675,461
061110055022,403,258,145,411,256,155,692,433,242,512,314,156
061110055023,346,221,125,353,220,133,831,519,290,472,288,143
061110059111,686,367,319,696,371,325,926,531,371,761,391,319
061110074021,1358,615,743,1379,626,753,1649,868,745,1518,725,714
061110074022,1310,662,648,1331,669,662,1202,667,513,1412,751,593
061110074023,674,323,351,683,324,359,1622,933,663,758,371,346
061110058032,595,281,314,604,273,331,801,415,371,674,303,323
061110060001,573,292,281,585,283,302,823,408,390,185,83,89
061110068001,531,271,260,540,265,275,712,375,326,617,298,286
061110018011,1109,639,470,1115,633,482,1332,838,463,1236,727,424
061110019012,631,396,235,642,398,244,1019,681,315,620,396,181
061110019011,1072,699,373,1097,711,386,1194,819,353,1076,695,309
061110023021,268,218,50,265,207,58,394,288,98,338,251,59
061110025001,573,373,200,585,374,211,715,489,214,627,380,197
061110025002,836,495,341,844,491,353,1097,659,412,771,434,271
061110025004,837,524,313,847,523,324,1053,669,357,930,532,335
061110022002,1034,739,295,1047,730,317,1555,1073,444,1091,696,298
061110028003,507,349,158,511,343,168,729,506,206,528,339,146
061110028004,698,479,219,706,469,237,897,627,246,753,488,203
061110028005,253,174,79,257,171,86,359,253,99,291,189,78
061110025003,405,225,180,409,225,184,536,309,213,458,237,192
061110026002,741,510,231,744,491,253,893,614,248,840,542,224
061110028002,607,421,186,620,419,201,774,528,227,641,403,193
061110024001,415,313,102,425,315,110,594,421,157,488,328,110
061110024002,614,453,161,628,447,181,880,641,200,642,424,153
061110027001,614,418,196,624,424,200,874,591,262,700,445,201
061110027002,1159,716,443,1183,722,461,1507,985,487,1301,798,415
061110015081,1900,1214,686,1922,1208,714,2726,1713,949,2183,1326,732
061110015101,871,514,357,884,513,371,1106,694,382,988,566,360
061110016021,876,542,334,893,536,357,1075,685,360,982,576,333
061110016022,423,261,162,432,259,173,538,343,180,456,266,154
061110015063,1048,597,451,1068,590,478,1513,880,595,939,498,369
061110015072,711,410,301,723,406,317,936,566,352,782,435,294
061110015073,558,325,233,567,330,237,737,448,271,650,375,226
061110013042,800,454,346,810,449,361,1089,653,409,950,499,373
061110014012,1078,579,499,1096,576,520,1379,770,579,1229,616,526
061110014022,857,469,388,877,468,409,1135,648,464,933,489,387
061110014023,708,399,309,725,399,326,938,555,364,744,405,291
061110012022,1274,645,629,1299,654,645,1621,896,692,1450,742,617
061110012023,1475,756,719,1500,770,730,1823,1016,770,1641,862,679
061110012021,935,458,477,952,455,497,1211,658,529,1046,507,474
061110018013,573,344,229,582,346,236,804,502,283,626,361,230
061110094001,535,312,223,549,311,238,598,371,212,510,268,210
061110013032,1289,744,545,1302,733,569,2025,1230,747,1472,858,520
061110015091,530,353,177,534,342,192,788,552,223,645,394,208
061110015092,746,480,266,757,476,281,971,668,287,834,514,265
061110015102,2,1,1,2,1,1,5,3,2,0,0,0
061110026001,356,260,96,362,256,106,490,339,131,383,265,85
061110026003,241,167,74,245,163,82,372,263,103,261,170,70
061110020002,516,346,170,524,352,172,644,448,180,421,263,126
061110020003,531,334,197,547,346,201,672,449,203,563,346,172
061110021022,466,315,151,470,313,157,624,418,189,562,375,138
061110021021,336,235,101,341,237,104,440,306,121,366,245,92
061110012012,990,534,456,1012,534,478,1519,886,595,1019,522,426
061110015061,722,415,307,742,409,333,1004,598,386,856,437,362
061110015111,503,296,207,516,288,228,677,418,242,709,396,259
061110015112,238,140,98,243,135,108,328,200,120,276,154,102
061110015071,283,165,118,290,160,130,410,227,170,322,164,123
061110095003,251,138,113,255,132,123,333,190,136,270,127,125
061110022003,403,313,90,406,304,102,576,422,135,492,345,104
061110023011,238,192,46,241,184,57,364,275,81,271,197,51
061110022004,256,203,53,258,199,59,387,294,84,344,242,75
061110022001,217,167,50,215,163,52,335,251,76,275,189,63
061110020001,444,298,146,449,302,147,564,389,153,490,310,145
061110023012,367,301,66,364,284,80,511,390,106,403,297,69
061110023023,261,215,46,260,203,57,450,341,96,295,219,52
061110013041,488,277,211,492,272,220,714,426,268,564,295,222
061110014011,781,407,374,794,415,379,1023,601,397,864,457,340
061110096001,323,167,156,326,163,163,440,252,178,443,231,184
061090022021,787,278,509,808,279,529,961,359,584,761,249,452
061090022014,312,112,200,320,110,210,749,263,473,284,90,177
061090022023,563,201,362,579,203,376,657,253,385,646,211,388
061090012001,394,172,222,406,179,227,561,247,293,328,142,170
061090012002,459,228,231,473,233,240,610,305,290,485,212,246
061090041021,575,288,287,591,294,297,627,317,293,618,270,309
061090011001,587,249,338,605,248,357,792,321,449,452,171,250
061090011002,331,144,187,345,144,201,476,196,266,541,214,293
061090051022,561,223,338,572,221,351,771,310,446,674,240,389
061090012003,453,255,198,476,258,218,622,343,259,536,248,243
061090012004,154,76,78,159,77,82,229,110,112,165,76,81
061090011003,464,200,264,480,200,280,641,276,341,590,227,321
061090011004,196,96,100,200,95,105,273,133,132,181,85,87
061090022012,741,293,448,769,297,472,873,320,531,790,277,455
061090022013,767,290,477,792,290,502,1043,392,627,894,303,545
061090032001,785,287,498,806,285,521,995,350,623,691,222,424
061090022011,339,137,202,351,138,213,415,165,242,362,128,219
061090021021,759,302,457,778,301,477,871,363,485,716,250,426
061090021022,286,143,143,293,147,146,367,165,193,263,117,132
061090022022,203,85,118,206,85,121,249,104,139,327,121,188
061090031011,618,250,368,638,253,385,717,288,406,745,296,410
061090031021,675,269,406,696,266,430,627,274,340,537,204,303
061090031023,271,101,170,281,102,179,360,129,216,215,71,129
061090031022,419,159,260,431,157,274,537,206,314,505,170,303
061090031032,293,121,172,296,117,179,371,156,207,367,134,210
061090032002,297,118,179,305,119,186,347,128,215,442,151,260
061090032003,389,158,231,399,158,241,540,191,333,453,155,262
061090032004,260,95,165,269,98,171,645,211,415,436,136,262
061090032005,344,124,220,353,126,227,506,170,325,331,108,199
061090032006,222,81,141,228,81,147,305,106,197,250,81,149
061090031012,277,116,161,279,113,166,426,192,227,257,104,136
061090031013,307,107,200,320,108,212,387,137,243,315,107,197
061090031031,259,107,152,266,106,160,347,157,184,305,125,164
061090051014,528,177,351,539,177,362,677,213,446,565,167,365
061090041022,509,191,318,525,190,335,580,213,357,567,206,331
061090042014,402,200,202,414,201,213,543,266,256,317,137,160
061090042011,335,162,173,339,162,177,404,212,185,335,155,162
061090042012,410,189,221,417,187,230,500,250,237,376,169,181
061090042022,277,132,145,286,134,152,344,174,168,284,125,143
061090042021,193,93,100,199,93,106,260,128,125,219,94,111
061090042023,305,139,166,312,138,174,411,189,216,518,215,272
061090041011,924,302,622,951,300,651,1001,310,674,1104,330,711
061090052012,530,169,361,539,153,386,721,200,514,532,140,372
061090051021,600,207,393,613,206,407,919,278,618,467,150,291
061090021011,273,130,143,278,128,150,341,150,181,315,129,164
061090021012,205,98,107,208,96,112,257,113,137,247,93,141
061090021013,539,240,299,547,239,308,703,297,385,606,232,333
061090021014,424,176,248,432,174,258,545,206,323,563,207,324
061090051011,836,322,514,856,325,531,1191,470,693,669,238,395
061090051012,696,234,462,713,236,477,720,283,420,926,340,524
061090051013,330,97,233,336,95,241,516,141,366,648,158,460
061090052011,113,30,83,115,28,87,278,60,216,117,31,85
061090041012,468,143,325,479,142,337,550,168,368,384,112,246
061099852021,6,2,4,6,2,4,15,4,11,1,0,1
060710091292,328,229,99,330,218,112,643,439,190,400,277,107
060710091333,426,284,142,426,270,156,734,495,223,549,366,158
060710091332,148,103,45,151,100,51,278,177,90,188,133,50
060710091331,317,157,160,319,149,170,560,255,283,400,223,161
060710091341,139,50,89,141,50,91,229,92,133,179,72,96
060710091312,111,81,30,112,76,36,231,166,58,181,128,42
060710091313,160,108,52,161,99,62,344,238,95,232,163,55
060710091322,58,44,14,59,41,18,146,98,45,77,59,16
060710091321,129,86,43,131,80,51,331,217,104,187,131,46
060710091302,433,291,142,440,283,157,829,519,289,600,407,168
060710091301,298,201,97,301,193,108,517,326,182,389,265,108
060710091293,324,225,99,327,217,110,672,461,192,444,304,119
060710091291,325,225,100,330,217,113,617,423,179,439,298,118
060710091251,679,442,237,691,422,269,1170,767,379,907,584,272
060710091252,360,233,127,359,221,138,603,393,196,458,292,139
060710091242,400,287,113,405,275,130,784,516,252,548,368,144
060710091241,287,208,79,292,197,95,530,348,170,380,256,99
060710091311,86,68,18,88,63,25,213,156,48,120,85,28
060710121011,389,96,293,395,94,301,516,127,381,439,97,319
060710121014,769,244,525,784,227,557,1105,379,693,943,286,606
060710097261,337,135,202,343,136,207,469,178,275,457,172,258
060710121013,793,272,521,814,253,561,1149,437,688,969,308,602
060710097262,671,220,451,679,204,475,950,334,596,745,241,470
060710097271,298,152,146,302,146,156,528,278,222,420,183,208
060710097272,337,171,166,344,165,179,566,303,244,476,208,238
060710097141,337,109,228,342,106,236,488,182,296,471,158,292
060710097142,389,126,263,397,124,273,648,239,396,447,147,275
060710097131,513,165,348,522,158,364,779,253,510,627,168,423
060710097132,430,137,293,441,134,307,664,216,435,521,137,352
060710097134,187,71,116,187,70,117,278,111,162,231,80,136
060710097135,518,195,323,521,193,328,817,323,476,640,221,381
060710097133,222,82,140,229,82,147,371,145,219,307,105,182
060710097171,681,184,497,694,170,524,988,299,663,759,204,511
060710097172,989,265,724,1010,252,758,1383,402,956,1179,310,816
060710097221,527,195,332,529,190,339,778,295,462,649,212,396
060710097222,528,163,365,534,159,375,763,261,488,703,202,466
060710097231,472,135,337,477,126,351,654,201,446,638,181,426
060710097232,861,253,608,869,236,633,1095,309,767,862,232,587
060710097233,894,272,622,902,256,646,1425,516,879,1029,285,693
060710097251,1012,315,697,1027,298,729,1491,516,944,1229,403,786
060710097241,1221,385,836,1244,393,851,1705,596,1078,1519,476,978
060710097253,594,217,377,602,206,396,835,331,482,707,240,430
060710097242,415,141,274,422,137,285,589,219,362,467,143,299
060710097252,465,164,301,471,157,314,666,261,389,548,178,337
060710097213,344,170,174,350,163,187,605,289,302,432,198,209
060710097211,428,210,218,435,204,231,749,356,373,543,249,261
060710097201,360,152,208,362,148,214,594,245,338,472,182,263
060710097212,328,141,187,335,136,199,572,233,325,435,165,243
060710097121,230,93,137,232,86,146,377,152,214,289,108,169
060710097123,292,117,175,296,112,184,499,202,286,370,135,220
060710097124,323,127,196,326,119,207,638,234,381,531,175,329
060710097122,479,176,303,494,174,320,808,305,476,644,212,402
060710097181,1696,574,1122,1716,561,1155,2091,841,1232,1648,565,1043
060710097182,933,315,618,946,309,637,1125,453,665,1038,354,657
060710100123,569,219,350,569,208,361,849,332,508,714,250,434
060710097191,619,193,426,621,183,438,978,343,606,818,256,520
060710097192,324,63,261,326,63,263,496,118,367,376,78,281
060710097091,339,118,221,340,106,234,547,187,344,414,143,247
060710097081,381,107,274,385,99,286,645,182,455,607,164,426
060710097083,634,138,496,642,134,508,945,211,718,772,123,610
060710097092,517,195,322,525,188,337,857,302,530,639,215,385
060710097094,366,164,202,373,154,219,635,257,370,467,181,268
060710097093,320,130,190,320,124,196,546,194,344,406,143,238
060710097143,425,146,279,423,139,284,585,221,360,464,151,288
060710095011,214,116,98,220,107,113,349,172,162,292,130,138
060710095021,310,159,151,312,154,158,504,266,223,422,183,201
060710095013,247,127,120,251,129,122,393,203,180,288,149,111
060710120013,366,165,201,376,151,225,573,253,307,429,188,214
060710120011,560,237,323,571,238,333,837,360,458,695,311,346
060710120012,295,156,139,299,150,149,449,213,221,367,163,182
060710094001,167,85,82,167,85,82,263,130,125,188,89,84
060710094003,173,107,66,176,107,69,323,201,117,273,137,113
060710094002,45,25,20,43,23,20,99,53,41,79,40,34
060710095022,308,148,160,307,141,166,444,210,225,365,171,169
060710119004,254,71,183,260,73,187,365,102,255,312,87,213
060710120022,267,128,139,269,127,142,461,231,216,315,141,149
060710120014,207,102,105,208,99,109,334,167,161,267,115,131
060710095012,222,109,113,223,113,110,362,168,185,273,134,114
060710120021,14,7,7,14,6,8,20,13,7,36,11,20
060710120025,174,85,89,176,86,90,275,140,126,234,102,109
060710120024,444,210,234,450,207,243,756,386,349,553,245,261
060710120023,165,71,94,168,69,99,298,130,160,230,101,113
060710118021,404,170,234,404,151,253,661,274,370,519,169,315
060710118011,296,131,165,301,121,180,439,184,242,406,140,235
060710118022,281,78,203,286,75,211,401,110,284,341,91,228
060710118012,789,252,537,805,234,571,1148,343,774,928,269,603
060710093001,306,98,208,306,82,224,479,136,334,368,112,229
060710112031,395,123,272,398,120,278,478,179,290,464,143,294
060710114053,294,96,198,297,98,199,399,150,231,312,102,192
060710112042,146,50,96,154,50,104,233,85,146,169,67,98
060710112043,236,80,156,241,81,160,271,92,172,285,89,180
060710112041,114,40,74,114,39,75,193,71,116,161,61,89
060710112051,323,121,202,328,122,206,524,214,300,425,133,271
060710113001,268,114,154,274,115,159,321,150,165,274,110,144
060710112062,247,93,154,251,94,157,361,150,206,281,97,171
060710112032,167,60,107,170,57,113,241,90,144,226,72,141
060710112061,163,63,100,170,65,105,217,90,125,176,60,106
060710115002,568,224,344,577,225,352,630,263,352,535,197,299
060710001031,435,225,210,443,219,224,633,331,287,496,248,223
060710001032,428,221,207,436,219,217,620,327,281,469,237,211
060710001033,580,341,239,594,340,254,961,556,391,587,328,229
060710001041,941,511,430,955,501,454,1295,728,550,1194,647,488
060710001181,901,413,488,918,404,514,1287,686,581,1048,528,473
060710001182,719,343,376,727,342,385,1048,572,463,805,410,366
060710001171,914,414,500,951,426,525,1736,890,819,805,403,365
060710001174,390,181,209,400,183,217,582,304,265,432,221,193
060710001093,810,300,510,821,303,518,1077,466,596,797,349,407
060710001112,850,370,480,857,362,495,978,466,493,948,408,484
060710001111,211,82,129,213,82,131,277,124,149,193,74,108
060710001042,517,291,226,527,289,238,751,432,310,661,359,260
060710001052,1686,824,862,1719,816,903,2184,1190,956,2090,1109,889
060710001172,996,468,528,1012,451,561,1356,700,636,1157,535,582
060710001173,321,151,170,325,145,180,473,246,222,338,174,145
060710001051,676,341,335,688,338,350,1029,548,466,740,440,271
060710001043,710,381,329,713,375,338,987,559,413,822,464,319
060710001071,1207,494,713,1222,470,752,1691,750,908,1327,541,700
060710001091,509,218,291,516,216,300,686,317,365,635,267,338
060710001092,411,192,219,416,189,227,561,268,279,405,162,215
060710001094,574,253,321,584,244,340,794,360,411,645,293,309
060710001095,597,260,337,603,259,344,788,368,407,692,287,367
060710001192,577,292,285,586,286,300,864,435,411,669,351,279
060710001082,502,242,260,511,238,273,819,420,383,642,282,331
060710001083,767,411,356,778,404,374,1032,571,439,935,449,438
060710001081,599,287,312,604,279,325,772,386,372,667,288,350
060710001203,826,414,412,847,413,434,1387,732,633,858,437,391
060710001191,502,291,211,511,288,223,1024,579,421,569,310,228
060710001202,448,249,199,456,245,211,700,389,299,528,276,227
060710001204,737,428,309,744,417,327,1160,649,495,877,448,379
060710001201,252,134,118,259,133,126,576,321,247,312,162,135
060710001211,442,206,236,450,203,247,695,365,320,557,285,247
060710001222,387,187,200,394,182,212,550,291,254,447,227,200
060710001152,716,401,315,729,398,331,1263,725,521,669,384,253
060710001153,688,367,321,706,362,344,1319,735,563,876,451,387
060710001154,1161,644,517,1179,633,546,2089,1274,779,1103,606,441
060710001151,841,413,428,854,410,444,1239,633,585,945,474,422
060710001213,903,441,462,921,433,488,1374,719,631,1109,565,501
060710001214,804,363,441,813,357,456,1060,525,520,924,444,441
060710019071,9,4,5,9,4,5,11,7,4,10,6,4
060710001212,506,262,244,514,261,253,673,353,312,565,295,242
060710001221,718,357,361,724,342,382,1061,556,488,807,397,360
060710004012,398,186,212,409,190,219,613,293,313,447,203,226
060710005014,479,257,222,484,242,242,702,378,319,538,288,231
060710004011,561,348,213,564,321,243,841,492,334,708,403,270
060710004032,534,279,255,541,260,281,837,435,388,644,316,294
060710005013,499,299,200,509,286,223,864,519,328,610,353,223
060710005011,512,302,210,516,288,228,782,461,307,616,350,234
060710005031,433,250,183,439,245,194,620,365,248,463,254,183
060710004031,361,201,160,366,196,170,519,285,222,430,237,169
060710004041,843,452,391,859,447,412,1327,704,597,967,532,400
060710004042,610,349,261,624,344,280,952,533,399,713,391,281
060710006031,250,138,112,254,138,116,379,205,164,273,151,107
060710006032,315,180,135,316,173,143,528,307,205,450,246,170
060710006043,431,247,184,438,240,198,713,415,281,558,309,213
060710006051,393,291,102,398,282,116,699,454,235,497,364,110
060710005041,290,179,111,293,172,121,468,265,191,353,202,134
060710006033,747,378,369,758,367,391,1092,554,519,856,424,392
060710006041,680,376,304,681,360,321,1030,559,452,842,477,327
060710017031,496,292,204,501,276,225,712,397,298,557,318,207
060710017043,458,289,169,474,286,188,813,504,293,546,339,169
060710017032,554,310,244,563,293,270,787,428,341,654,356,263
060710017033,630,316,314,641,305,336,904,472,422,739,373,331
060710017034,256,128,128,258,123,135,468,244,218,335,169,150
060710019011,819,401,418,833,395,438,1178,591,576,958,485,424
060710019111,686,338,348,697,338,359,1052,529,515,746,379,338
060710019013,768,376,392,780,363,417,1101,538,540,872,432,390
060710019112,406,198,208,409,191,218,644,327,307,423,216,188
060710019113,706,347,359,715,332,383,1114,529,558,823,388,398
060710005042,675,294,381,686,279,407,965,430,520,815,345,437
060710122011,673,353,320,680,345,335,1252,637,597,718,365,329
060710019091,487,268,219,494,261,233,858,466,373,620,330,257
060710122012,668,350,318,674,341,333,1298,662,618,665,340,306
060710122021,350,183,167,356,180,176,662,336,315,369,186,169
060710006042,311,185,126,311,177,134,529,300,218,392,244,133
060710006052,423,295,128,428,286,142,741,484,242,639,440,164
060710006061,561,346,215,574,342,232,918,540,357,689,416,245
060710006062,364,224,140,365,218,147,627,365,242,456,276,161
060710019012,545,267,278,549,257,292,826,420,392,671,341,300
060710005012,635,337,298,642,325,317,964,516,434,750,385,321
060710005032,493,259,234,500,251,249,817,435,367,591,300,259
060710005033,374,216,158,380,212,168,634,372,252,456,252,179
060710005043,915,423,492,934,407,527,1366,684,656,1039,511,485
060710004014,744,336,408,752,313,439,1235,568,640,962,428,487
060710019073,470,258,212,479,252,227,1925,1049,838,584,312,242
060710019072,329,179,150,331,174,157,537,333,197,409,217,169
060710066012,190,127,63,195,124,71,322,209,110,256,166,71
060710066032,651,480,171,657,465,192,1024,701,316,790,559,187
060710066041,453,355,98,458,345,113,780,568,193,593,441,119
060710044031,414,296,118,424,291,133,754,526,216,568,413,134
060710040041,646,347,299,660,337,323,950,520,406,786,424,316
060710036121,585,456,129,589,450,139,1066,751,297,732,561,131
060710036111,424,342,82,430,336,94,763,570,181,575,452,96
060710036112,349,281,68,352,271,81,667,501,150,509,396,86
060710066031,632,470,162,644,449,195,954,650,280,716,499,180
060710066042,255,210,45,257,201,56,471,350,113,391,303,76
060710049021,182,152,30,189,141,48,341,239,87,265,215,32
060710067002,207,143,64,208,139,69,383,253,120,293,200,71
060710067003,189,135,54,190,129,61,317,211,98,254,179,60
060710067004,161,120,41,161,111,50,237,166,71,207,151,44
060710067001,269,211,58,275,194,81,450,300,126,365,268,73
060710070021,282,224,58,285,203,82,463,320,136,364,271,75
060710070022,164,123,41,164,113,51,269,184,78,218,158,42
060710070012,228,182,46,226,168,58,367,259,103,308,239,51
060710070011,326,265,61,331,256,75,546,397,142,428,351,59
060710124001,190,123,67,193,119,74,303,195,104,232,157,65
060710070023,338,269,69,343,257,86,592,417,159,433,344,66
060710125004,201,152,49,202,140,62,330,225,96,259,195,51
060710066011,422,287,135,425,278,147,719,468,230,562,371,156
060710066013,277,198,79,277,188,89,427,286,133,353,242,93
060710125001,181,145,36,182,137,45,310,225,80,245,190,42
060710125002,200,169,31,201,156,45,370,264,94,285,224,46
060710125003,137,115,22,138,106,32,253,184,66,184,146,32
060710071081,337,236,101,340,232,108,603,414,169,504,333,134
060710071101,415,268,147,422,256,166,710,438,254,514,309,164
060710071102,464,299,165,471,285,186,717,439,257,522,317,165
060710071051,881,495,386,895,484,411,1421,780,602,1114,615,424
060710071121,75,56,19,75,55,20,195,144,44,101,75,21
060710071122,388,260,128,394,254,140,721,485,211,515,345,137
060710073082,471,239,232,475,232,243,723,364,345,562,265,263
060710073071,740,374,366,750,354,396,1183,618,534,872,426,388
060710071042,424,204,220,431,197,234,569,281,271,492,215,245
060710071072,194,107,87,196,104,92,326,170,142,247,128,100
060710071071,311,215,96,314,212,102,563,379,167,451,291,126
060710020392,987,562,425,1000,552,448,1572,861,675,1380,735,573
060710092021,504,204,300,513,204,309,721,284,414,565,221,309
060710020401,671,322,349,689,326,363,1079,518,552,643,317,298
060710020421,1087,475,612,1103,473,630,1535,742,769,1230,556,611
060710020402,998,519,479,1016,499,517,1618,834,755,1115,590,472
060710020391,866,539,327,882,529,353,1539,907,599,972,592,332
060710023151,628,373,255,639,362,277,1449,827,590,775,463,282
060710023142,971,569,402,981,550,431,1492,835,627,1237,677,508
060710023152,675,453,222,684,446,238,1226,811,397,828,556,244
060710020371,396,235,161,406,225,181,622,377,226,450,251,175
060710020374,777,488,289,786,474,312,1214,757,430,921,569,304
060710020372,760,481,279,773,471,302,1268,792,447,1001,628,321
060710020373,447,286,161,455,279,176,765,482,267,588,385,180
060710020381,827,564,263,832,542,290,1422,933,463,1069,720,302
060710020382,918,591,327,929,580,349,1407,892,489,1127,763,328
060710023141,802,451,351,815,439,376,1288,720,546,980,549,389
060710023101,605,392,213,614,376,238,994,606,370,840,555,256
060710023111,490,304,186,498,292,206,797,476,308,622,391,210
060710023102,947,664,283,962,638,324,1639,1054,551,1013,716,257
060710023112,468,304,164,473,294,179,811,497,298,645,393,212
060710023113,384,245,139,394,242,152,608,368,228,477,285,163
060710023081,689,497,192,698,480,218,1295,869,402,665,477,155
060710023121,948,653,295,955,614,341,2006,1285,675,1103,742,306
060710023131,407,281,126,409,263,146,757,496,240,524,363,141
060710023132,307,220,87,314,210,104,572,385,172,394,279,99
060710023122,781,536,245,790,508,282,1018,634,366,751,495,220
060710022042,228,175,53,230,169,61,420,293,119,332,249,67
060710022043,187,143,44,190,141,49,350,244,99,254,192,51
060710022044,318,243,75,319,235,84,629,434,177,447,335,91
060710024041,202,150,52,204,144,60,466,307,153,323,232,77
060710024042,204,170,34,204,166,38,444,318,113,302,243,43
060710027081,671,412,259,681,408,273,1181,710,451,945,575,321
060710027082,961,586,375,973,586,387,1689,1047,607,1018,618,344
060710023083,485,355,130,490,342,148,895,606,267,601,437,136
060710023084,423,311,112,428,304,124,724,501,209,538,388,121
060710028031,160,119,41,159,117,42,280,199,70,224,168,43
060710028032,157,113,44,158,113,45,263,185,70,216,163,44
060710028033,165,130,35,167,126,41,312,229,77,253,197,45
060710028041,216,173,43,217,166,51,427,311,107,305,237,53
060710028042,91,66,25,91,65,26,210,150,55,127,93,26
060710030002,225,170,55,229,169,60,398,290,105,325,249,59
060710024061,145,119,26,144,114,30,280,209,67,189,152,31
060710024062,143,120,23,142,115,27,287,212,70,208,171,30
060710028043,172,142,30,173,136,37,300,223,71,237,192,39
060710028011,401,308,93,409,305,104,789,555,216,564,429,104
060710028012,203,155,48,206,154,52,418,291,114,283,218,52
060710028013,153,117,36,156,117,39,301,212,83,225,170,42
060710023082,195,151,44,197,147,50,347,246,92,276,202,58
060710023133,512,395,117,515,383,132,895,634,236,722,532,149
060710024051,324,259,65,326,249,77,596,429,151,459,359,73
060710024053,226,181,45,227,173,54,447,326,110,327,253,57
060710031011,221,170,51,221,160,61,403,286,107,292,218,59
060710031012,360,271,89,361,256,105,620,435,171,472,348,98
060710031013,137,110,27,135,105,30,261,192,66,198,155,34
060710031021,232,189,43,235,183,52,479,346,120,319,250,51
060710031022,128,103,25,128,100,28,253,179,63,182,144,29
060710031023,140,113,27,140,109,31,250,181,63,193,151,31
060710025041,322,257,65,326,248,78,583,423,143,446,355,68
060710025031,361,276,85,366,261,105,661,489,158,521,401,97
060710027091,769,453,316,779,441,338,2209,1253,907,898,534,321
060710034031,221,154,67,218,146,72,380,255,119,292,197,72
060710033022,262,171,91,262,167,95,473,286,178,353,231,106
060710023091,486,352,134,484,335,149,922,625,273,516,378,118
060710023092,323,229,94,328,222,106,547,367,163,386,273,93
060710023062,645,468,177,648,452,196,1124,763,331,885,648,198
060710023072,315,239,76,317,228,89,606,429,164,445,332,89
060710023073,201,152,49,202,145,57,404,287,109,270,204,54
060710029021,245,183,62,246,180,66,441,314,123,333,246,71
060710034011,329,243,86,329,230,99,614,426,177,445,333,90
060710023071,480,344,136,484,327,157,800,535,250,633,459,138
060710034042,276,204,72,278,196,82,525,367,147,391,289,77
060710034012,280,218,62,281,205,76,526,368,138,409,311,70
060710034014,314,227,87,315,216,99,528,350,162,473,341,99
060710034043,96,75,21,96,70,26,174,122,46,167,127,28
060710034051,220,161,59,221,153,68,374,252,115,320,234,67
060710034052,146,117,29,146,112,34,309,222,76,169,130,27
060710029022,244,183,61,246,179,67,387,272,108,364,267,77
060710029023,318,222,96,319,218,101,529,355,163,398,279,98
060710029024,212,159,53,213,155,58,368,259,102,294,214,62
060710029025,135,101,34,136,98,38,235,166,65,166,121,35
060710029011,205,147,58,205,141,64,369,249,107,258,184,58
060710029012,276,198,78,279,192,87,485,333,143,332,238,75
060710029013,227,168,59,227,164,63,372,264,105,304,222,67
060710030001,276,204,72,283,201,82,482,340,136,374,275,83
060710032021,142,111,31,145,109,36,291,211,74,211,157,42
060710032022,369,263,106,373,258,115,658,446,196,486,345,117
060710032023,249,168,81,250,164,86,413,269,135,314,214,83
060710034013,405,274,131,411,265,146,664,411,237,586,402,152
060710034033,211,142,69,211,136,75,339,210,120,287,197,75
060710032011,381,262,119,383,253,130,660,422,225,528,355,146
060710032012,185,127,58,189,125,64,308,195,104,244,163,68
060710032013,246,170,76,250,165,85,451,290,155,340,227,96
060710033024,130,94,36,129,90,39,235,145,83,181,124,48
060710033021,171,128,43,174,124,50,357,242,104,262,186,58
060710026061,575,448,127,581,431,150,1020,718,284,739,559,141
060710026063,483,381,102,493,367,126,836,600,216,611,463,120
060710026102,415,321,94,417,308,109,714,503,195,535,404,107
060710026111,734,560,174,740,537,203,1283,891,364,981,743,205
060710026112,385,293,92,387,279,108,650,461,183,489,370,104
060710026101,329,252,77,334,243,91,621,431,177,419,320,85
060710022041,122,95,27,123,94,29,204,143,59,170,130,31
060710025013,228,182,46,230,179,51,374,270,95,311,250,44
060710025014,181,148,33,182,143,39,311,231,77,275,226,37
060710025042,317,244,73,319,244,75,555,380,155,436,340,72
060710025032,239,182,57,241,182,59,406,280,114,329,255,55
060710026091,486,312,174,486,299,187,751,480,250,654,425,193
060710033011,433,317,116,436,306,130,754,528,206,569,427,114
060710033012,225,165,60,227,160,67,382,266,103,309,233,62
060710033013,174,128,46,175,124,51,291,202,79,242,182,48
060710026092,279,196,83,277,184,93,454,311,137,440,318,103
060710026021,427,312,115,432,303,129,744,513,212,581,429,120
060710026024,274,199,75,277,192,85,478,333,135,355,264,74
060710026041,329,244,85,335,236,99,604,416,172,469,346,96
060710026043,189,144,45,188,138,50,335,240,92,236,176,48
060710026022,338,258,80,343,245,98,622,427,182,477,358,93
060710026023,469,357,112,474,344,130,879,611,252,627,471,123
060710026042,338,256,82,341,250,91,586,413,157,435,325,90
060710026044,334,254,80,333,244,89,581,411,155,417,312,86
060710026062,386,296,90,387,290,97,729,513,205,553,419,105
060710033023,359,252,107,360,245,115,646,431,198,464,332,102
060710026083,636,471,165,640,453,187,1062,714,331,781,572,177
060710026082,579,418,161,584,410,174,1030,667,338,729,528,168
060710071111,638,341,297,644,325,319,917,494,399,738,386,311
060710071112,421,224,197,424,214,210,619,334,269,511,268,213
060710071041,288,141,147,295,136,159,407,203,195,321,141,162
060710071043,645,317,328,654,306,348,879,444,424,723,324,358
060710071061,366,179,187,372,173,199,503,257,236,418,193,197
060710071062,206,108,98,208,107,101,385,209,166,256,128,113
060710071063,327,172,155,332,170,162,534,289,230,403,200,179
060710071064,374,191,183,379,187,192,564,301,250,457,223,205
060710071044,324,155,169,327,148,179,485,243,232,357,161,174
060710100102,285,146,139,285,144,141,488,232,253,355,162,173
060710100101,307,150,157,312,141,171,470,215,248,377,177,188
060710100161,457,221,236,462,212,250,729,350,369,588,269,283
060710100093,402,163,239,404,156,248,776,325,438,474,187,272
060710100163,422,208,214,433,201,232,784,424,341,576,278,253
060710100162,188,96,92,191,88,103,398,222,168,259,136,101
060710100421,551,286,265,558,271,287,963,468,471,728,347,339
060710100342,505,121,384,515,112,403,762,181,562,597,145,428
060710100422,520,266,254,523,250,273,983,498,466,673,315,328
060710100413,466,193,273,475,184,291,782,343,419,646,239,371
060710100412,522,282,240,524,271,253,1028,517,483,733,407,284
060710100411,366,158,208,365,147,218,608,265,329,420,195,204
060710100341,852,199,653,855,193,662,1125,306,806,970,215,709
060710100103,333,159,174,337,153,184,584,290,281,382,177,189
060710100104,469,214,255,476,212,264,764,352,384,584,264,285
060710100152,321,153,168,325,143,182,523,246,261,432,190,216
060710100153,339,160,179,347,151,196,545,261,284,436,185,225
060710100111,302,160,142,307,155,152,488,240,227,445,227,188
060710100112,305,160,145,307,154,153,499,257,241,390,202,173
060710100113,278,146,132,284,142,142,479,242,230,380,196,164
060710100151,525,256,269,534,249,285,832,421,388,666,321,298
060710100141,186,104,82,186,101,85,325,181,135,301,160,116
060710100142,258,145,113,257,139,118,445,252,188,319,173,125
060710100143,230,129,101,231,125,106,389,222,164,256,139,102
060710100281,410,170,240,416,162,254,664,279,373,539,208,298
060710100282,639,262,377,646,253,393,1031,427,569,732,286,395
060710100331,352,173,179,354,159,195,603,300,296,515,214,273
060710100212,599,217,382,600,210,390,890,344,526,655,272,347
060710100121,276,113,163,282,109,173,481,197,266,366,137,208
060710100122,445,176,269,453,173,280,716,289,416,577,206,342
060710100291,622,257,365,629,249,380,987,413,553,819,310,462
060710100292,361,156,205,361,148,213,585,255,322,490,195,267
060710100213,724,224,500,735,223,512,1170,401,756,917,263,619
060710100221,687,230,457,690,227,463,1085,393,669,859,270,554
060710100222,616,191,425,620,187,433,887,262,605,692,189,479
060710100243,817,224,593,830,232,598,1238,395,827,955,246,674
060710100301,732,292,440,741,282,459,1164,495,649,940,369,533
060710100192,453,195,258,461,201,260,749,331,407,616,232,359
060710100322,200,76,124,202,73,129,363,144,209,267,102,150
060710100323,347,175,172,353,166,187,633,336,285,576,230,316
060710100321,552,207,345,563,200,363,937,345,566,727,259,427
060710100241,288,90,198,289,87,202,487,166,315,358,134,205
060710100242,590,205,385,598,198,400,974,332,612,775,244,485
060710100311,559,311,248,566,302,264,973,507,445,730,351,343
060710100312,388,172,216,393,163,230,683,308,361,519,236,259
060710100191,377,123,254,380,114,266,691,254,421,500,189,290
060710100343,488,129,359,498,125,373,697,195,493,535,150,364
060710100231,797,270,527,807,256,551,1304,459,806,1032,348,631
060710100233,436,164,272,440,156,284,769,305,455,585,202,361
060710100193,334,108,226,337,99,238,502,159,334,414,137,259
060710100211,668,221,447,673,212,461,1011,335,665,797,227,530
060710100232,403,132,271,403,127,276,653,235,406,507,172,308
060710064023,172,123,49,175,121,54,337,220,98,254,185,50
060710064021,294,213,81,298,207,91,555,365,171,419,302,86
060710065021,167,126,41,168,122,46,304,206,93,210,155,44
060710063041,340,260,80,346,249,97,541,385,143,457,324,112
060710074081,227,171,56,230,167,63,385,274,103,294,217,63
060710074082,232,179,53,234,172,62,401,286,103,218,160,45
060710076051,79,65,14,80,62,18,147,108,33,111,90,15
060710076052,115,91,24,118,87,31,188,138,47,148,113,26
060710076062,205,167,38,205,155,50,321,234,78,258,205,40
060710074121,339,189,150,341,180,161,479,274,194,426,234,169
060710074072,151,108,43,153,106,47,260,162,90,207,148,50
060710074083,175,130,45,180,127,53,326,216,97,242,179,50
060710074092,360,247,113,365,233,132,596,370,207,494,324,144
060710074101,271,175,96,271,166,105,384,240,136,306,187,102
060710074103,102,58,44,103,59,44,188,104,76,134,80,41
060710076061,216,167,49,217,161,56,369,263,96,373,278,74
060710076053,151,116,35,151,111,40,272,195,70,199,148,40
060710076031,232,159,73,234,151,83,410,274,125,323,221,80
060710076033,335,238,97,342,230,112,605,408,184,469,325,117
060710074091,472,296,176,472,280,192,728,443,268,599,358,204
060710074093,639,349,290,646,341,305,902,488,396,783,410,327
060710076032,252,160,92,257,151,106,412,254,152,380,241,117
060710076041,207,133,74,207,125,82,353,223,121,290,190,85
060710076042,322,198,124,328,187,141,494,287,190,365,210,132
060710076043,578,344,234,586,328,258,884,504,358,675,380,263
060710079052,631,274,357,640,264,376,799,357,429,679,288,360
060710079053,779,311,468,792,316,476,962,432,513,867,362,469
060710079062,1266,564,702,1286,550,736,1803,863,909,1422,623,739
060710079032,619,307,312,631,297,334,818,436,367,643,292,310
060710079033,465,211,254,473,199,274,663,315,339,517,224,267
060710079031,772,350,422,788,339,449,1170,561,585,841,372,427
060710079044,1058,446,612,1077,415,662,1597,697,875,1235,506,671
060710074102,542,284,258,553,284,269,845,448,379,677,337,306
060710079051,305,148,157,307,145,162,410,201,205,350,152,180
060710079041,594,260,334,598,251,347,826,401,405,667,289,344
060710079061,533,252,281,543,252,291,751,384,354,633,299,303
060710079042,731,320,411,745,310,435,1027,461,547,831,348,440
060710079043,531,227,304,539,219,320,735,325,396,583,241,312
060710111014,361,118,243,366,113,253,494,178,307,395,125,250
060710073081,694,325,369,700,316,384,970,495,453,795,369,368
060710073032,336,206,130,340,198,142,555,330,206,397,226,139
060710073033,251,161,90,252,154,98,402,249,147,319,192,102
060710072011,332,220,112,336,215,121,578,361,202,414,265,124
060710072022,146,115,31,146,114,32,225,163,57,211,163,34
060710073053,358,221,137,359,213,146,613,381,212,434,254,142
060710073052,264,164,100,267,159,108,442,276,152,342,200,110
060710073051,221,145,76,223,138,85,462,283,157,284,172,85
060710073062,136,81,55,137,80,57,231,143,79,171,98,57
060710073061,405,242,163,406,234,172,674,421,231,507,293,172
060710078001,499,307,192,508,304,204,1102,704,360,655,384,215
060710073063,275,164,111,279,166,113,575,338,219,335,196,109
060710073064,658,391,267,665,396,269,953,560,365,771,453,252
060710078004,272,166,106,276,167,109,536,343,183,295,173,102
060710073072,597,317,280,609,304,305,928,517,390,719,368,297
060710073073,434,217,217,439,203,236,635,328,295,487,237,221
060710073083,739,326,413,743,314,429,1000,487,487,850,367,414
060710002011,352,266,86,353,257,96,712,491,201,226,155,55
060710002012,339,258,81,341,254,87,610,427,167,433,301,104
060710002013,315,238,77,315,229,86,528,366,149,380,265,92
060710002031,565,406,159,574,405,169,920,626,267,715,501,176
060710002033,339,249,90,343,252,91,517,361,147,440,316,100
060710002071,392,284,108,398,284,114,658,448,186,498,350,119
060710002032,221,156,65,222,152,70,347,236,102,285,201,73
060710002051,385,272,113,388,264,124,601,406,178,478,312,135
060710002081,772,576,196,784,567,217,1183,815,340,937,661,222
060710002052,711,445,266,728,451,277,1112,677,405,869,544,272
060710002053,264,186,78,268,180,88,434,277,137,316,215,82
060710002082,336,237,99,340,227,113,532,339,170,411,282,106
060710002073,284,219,65,285,211,74,486,337,138,361,275,67
060710003061,293,224,69,295,220,75,485,338,137,354,261,76
060710003053,151,116,35,150,112,38,284,195,81,180,137,33
060710003054,142,110,32,142,106,36,258,178,73,180,138,33
060710003071,209,165,44,207,157,50,373,268,95,286,216,53
060710003072,262,203,59,264,196,68,439,306,124,349,269,64
060710002072,320,245,75,323,236,87,525,365,146,391,291,74
060710003062,238,183,55,242,176,66,420,292,117,307,218,74
060710003051,100,77,23,102,74,28,182,125,50,131,97,24
060710003052,106,81,25,108,78,30,178,123,49,131,98,25
060710003082,366,260,106,367,248,119,591,399,181,455,325,110
060710003041,483,322,161,489,307,182,815,498,302,589,382,182
060710003042,611,416,195,620,403,217,999,618,362,763,501,218
060710107001,251,115,136,254,109,145,445,183,252,326,128,184
060710107002,325,131,194,332,127,205,474,176,288,397,138,236
060710251001,224,81,143,228,79,149,360,120,234,255,79,164
060710107003,220,102,118,220,94,126,379,157,210,299,117,163
060710251002,158,59,99,160,59,101,226,84,140,187,65,111
060710010011,440,298,142,444,291,153,732,460,250,531,343,160
060710010013,323,220,103,327,215,112,513,325,176,383,248,115
060710010012,391,265,126,398,261,137,612,398,201,479,307,137
060710010021,241,169,72,245,165,80,403,271,125,291,202,73
060710011041,738,384,354,752,387,365,1153,633,494,875,446,392
060710011011,200,133,67,199,130,69,330,212,110,242,154,70
060710011012,301,207,94,307,204,103,485,309,165,358,228,108
060710011013,135,92,43,136,90,46,249,159,86,159,100,48
060710011043,498,342,156,503,333,170,778,500,268,601,382,181
060710011033,331,207,124,334,205,129,519,326,174,422,263,125
060710014001,304,195,109,309,196,113,502,329,168,389,250,109
060710014002,274,194,80,273,185,88,523,357,164,379,248,104
060710011031,491,283,208,497,275,222,723,418,283,641,361,240
060710011032,517,262,255,522,266,256,843,441,382,555,260,260
060710012001,506,292,214,513,271,242,716,413,285,584,321,221
060710012002,324,214,110,329,208,121,558,348,190,352,216,110
060710013091,363,277,86,362,268,94,609,441,156,447,340,87
060710013101,352,247,105,354,238,116,552,366,165,433,287,123
060710013104,237,167,70,241,161,80,385,259,116,300,192,93
060710013052,227,165,62,225,156,69,449,304,128,298,220,60
060710013053,123,90,33,124,87,37,248,170,70,157,118,31
060710015011,306,229,77,311,228,83,510,372,131,407,319,67
060710015032,225,164,61,222,160,62,384,269,106,318,250,50
060710015041,320,246,74,323,236,87,563,391,160,405,308,74
060710015042,293,232,61,292,225,67,515,365,140,392,295,76
060710013092,277,215,62,277,206,71,462,335,113,345,263,64
060710013093,244,189,55,242,182,60,422,308,102,309,237,57
060710013082,295,197,98,295,191,104,521,341,171,365,260,93
060710013051,375,276,99,378,273,105,639,444,184,467,338,105
060710013081,461,325,136,463,319,144,785,517,250,716,510,169
060710013071,543,391,152,545,374,171,945,632,290,686,486,161
060710013072,355,249,106,359,239,120,573,378,184,446,304,116
060710013121,436,309,127,437,303,134,649,434,201,503,338,148
060710013122,347,249,98,346,234,112,543,367,167,440,309,110
060710013123,401,297,104,400,279,121,1012,705,286,508,362,117
060710010024,176,128,48,176,123,53,323,221,91,236,170,50
060710010023,138,100,38,138,96,42,241,166,68,169,122,36
060710010022,267,195,72,271,189,82,487,333,135,347,255,71
060710016003,170,128,42,172,119,53,294,207,77,229,183,35
060710017021,337,213,124,340,200,140,667,430,228,515,299,184
060710017023,683,326,357,698,323,375,1051,543,490,861,432,376
060710017041,379,247,132,382,236,146,599,354,234,431,268,149
060710017042,281,184,97,286,178,108,447,261,176,331,208,111
060710016004,149,120,29,150,116,34,242,188,51,213,181,31
060710016005,157,129,28,158,123,35,300,233,61,229,186,30
060710017061,302,244,58,303,236,67,541,401,130,394,306,62
060710017062,151,112,39,154,112,42,255,177,73,189,131,48
060710017064,396,294,102,400,289,111,697,478,196,549,382,140
060710017063,147,109,38,148,106,42,265,182,74,193,135,50
060710017072,349,228,121,355,224,131,619,384,216,434,292,118
060710017073,522,320,202,527,315,212,910,548,344,727,468,218
060710017071,463,344,119,467,329,138,751,517,224,573,427,117
060710016001,129,106,23,131,101,30,215,158,54,180,153,25
060710016002,18,13,5,17,12,5,25,16,9,23,18,5
060710018121,282,227,55,287,223,64,501,363,126,396,291,84
060710018122,235,189,46,237,185,52,450,322,111,317,248,51
060710018131,220,191,29,221,182,39,434,328,96,311,257,40
060710018133,120,102,18,117,97,20,225,173,50,162,135,20
060710018132,123,106,17,125,104,21,245,186,53,169,140,22
060710018032,86,61,25,86,61,25,146,99,44,109,78,25
060710018102,321,224,97,324,220,104,533,358,165,398,270,102
060710018103,330,236,94,333,234,99,542,363,162,441,310,100
060710018031,655,441,214,667,425,242,1055,699,334,804,515,248
060710018101,284,191,93,287,183,104,490,323,155,375,240,117
060710018041,767,504,263,780,491,289,1299,798,476,887,576,263
060710018062,430,283,147,432,269,163,700,436,253,570,353,188
060710018061,499,301,198,506,292,214,798,459,315,625,363,228
060710018081,404,276,128,414,268,146,720,469,230,541,354,151
060710019081,396,217,179,401,219,182,2139,1296,793,227,119,97
060710019101,332,169,163,337,165,172,699,385,301,276,166,99
060710019063,1236,739,497,1254,711,543,2516,1515,965,1050,626,381
060710019062,631,377,254,636,352,284,1593,964,602,782,464,280
060710022063,399,264,135,398,254,144,649,414,223,546,354,164
060710022064,628,388,240,633,383,250,974,605,355,704,427,245
060710127001,568,374,194,575,366,209,901,555,328,754,490,229
060710019061,434,269,165,442,270,172,681,426,238,579,353,187
060710019064,318,197,121,325,199,126,505,316,176,424,259,137
060710018093,268,157,111,271,150,121,419,248,162,338,207,110
060710022061,712,420,292,719,402,317,1162,692,444,903,552,297
060710022062,298,182,116,301,180,121,463,289,170,338,202,121
060710127002,661,419,242,667,404,263,1037,611,409,804,495,266
060710021092,585,420,165,588,408,180,1188,839,326,416,281,105
060710021093,472,339,133,477,331,146,845,595,231,1037,694,276
060710018042,516,298,218,521,288,233,851,483,355,633,359,246
060710018043,410,246,164,416,238,178,677,376,284,486,274,188
060710018063,567,335,232,573,324,249,867,473,379,676,375,270
060710018082,392,220,172,396,212,184,600,337,251,471,264,186
060710018083,415,233,182,416,223,193,580,327,243,462,258,184
060710018091,365,223,142,370,211,159,589,354,218,490,285,169
060710018092,321,196,125,326,185,141,516,309,190,400,233,138
060710015043,199,146,53,200,140,60,372,241,125,308,229,64
060710011042,302,181,121,309,177,132,458,283,170,349,207,127
060710013102,403,301,102,408,293,115,649,447,181,460,322,108
060710013103,292,219,73,294,211,83,471,331,133,346,239,86
060710015012,182,145,37,184,140,44,348,269,72,258,180,63
060710015031,121,102,19,120,98,22,256,198,48,197,155,31
060710017022,555,270,285,556,253,303,783,408,363,608,352,219
060710012003,399,227,172,401,223,178,543,307,228,456,272,154
060710012004,308,169,139,310,162,148,435,239,185,349,193,137
060710020131,589,267,322,597,263,334,905,443,440,735,327,367
060710020132,1228,467,761,1246,457,789,1592,642,931,1396,531,798
060710020173,991,358,633,1002,352,650,1367,541,797,1154,411,681
060710008121,630,277,353,648,264,384,903,397,486,757,302,412
060710020142,1369,486,883,1407,473,934,1855,711,1119,1554,542,942
060710020152,872,410,462,896,404,492,1320,627,655,1092,480,545
060710020151,916,406,510,933,402,531,1315,596,688,999,452,501
060710020232,264,123,141,268,120,148,384,179,201,307,144,149
060710020234,495,244,251,502,239,263,748,382,355,556,265,258
060710020251,1073,480,593,1079,471,608,1595,771,791,1351,596,694
060710020252,899,421,478,915,414,501,1374,656,690,1069,500,512
060710020231,401,215,186,409,213,196,651,345,296,487,248,211
060710008122,466,208,258,473,200,273,562,262,287,454,196,231
060710008123,530,228,302,539,223,316,725,336,374,685,277,372
060710020161,696,366,330,711,353,358,1067,556,488,835,421,363
060710020162,702,346,356,710,332,378,1003,502,484,820,385,384
060710008192,758,360,398,768,356,412,1266,642,601,926,440,436
060710020112,848,284,564,869,284,585,1193,422,738,987,321,613
060710020141,1205,389,816,1229,388,841,1585,574,974,1218,396,760
060710008041,1203,445,758,1209,431,778,1608,684,888,727,248,441
060710008042,368,134,234,371,130,241,473,197,265,1171,424,678
060710020111,1118,353,765,1138,360,778,1473,552,885,1280,435,778
060710020172,510,171,339,514,169,345,682,264,406,552,195,327
060710020171,1353,479,874,1376,483,893,1714,670,1016,1469,507,892
060710020181,1200,458,742,1216,447,769,1715,748,927,1495,643,756
060710020182,854,437,417,866,427,439,1381,721,634,1012,466,483
060710009011,487,284,203,492,277,215,810,481,309,514,281,199
060710021012,402,249,153,408,244,164,658,397,250,593,348,211
060710021051,729,473,256,740,466,274,1268,794,446,846,527,265
060710020271,716,389,327,718,380,338,1076,599,458,856,455,350
060710020272,619,328,291,628,321,307,936,486,426,746,359,341
060710021053,620,356,264,621,344,277,923,517,388,730,405,280
060710021072,522,321,201,523,305,218,922,548,354,646,351,249
060710020282,1037,483,554,1055,470,585,1508,706,764,1251,552,617
060710020281,841,481,360,856,471,385,1486,867,583,1023,546,418
060710021011,526,385,141,537,385,152,929,661,240,693,484,154
060710021122,324,224,100,326,221,105,636,429,187,436,284,130
060710021121,396,274,122,398,270,128,679,464,197,520,338,156
060710021052,239,167,72,239,155,84,408,239,155,307,201,90
060710021071,273,184,89,278,176,102,440,264,163,345,222,100
060710021073,407,247,160,412,240,172,743,431,300,516,334,151
060710021111,332,221,111,339,216,123,589,349,221,441,285,131
060710013112,598,383,215,607,383,224,1018,623,375,726,468,215
060710013111,488,305,183,498,304,194,774,472,290,569,371,169
060710022071,392,267,125,396,263,133,679,442,229,469,307,141
060710021113,138,93,45,141,87,54,309,175,129,185,111,63
060710021031,346,235,111,352,232,120,592,368,211,442,270,150
060710021033,448,305,143,458,302,156,790,490,281,589,357,189
060710020233,506,277,229,511,275,236,755,452,285,651,293,328
060710020273,609,313,296,612,290,322,925,464,430,769,374,344
060710021032,245,155,90,248,147,101,429,249,170,307,186,97
060710021112,253,188,65,256,178,78,560,388,149,382,251,106
060710020291,531,290,241,543,290,253,869,455,400,634,332,262
060710020292,551,279,272,564,283,281,865,438,411,673,340,295
060710020311,667,367,300,681,365,316,1023,548,455,815,441,327
060710020313,712,370,342,719,371,348,1036,528,489,861,440,371
060710020354,331,196,135,337,199,138,470,297,164,406,234,155
060710020503,484,291,193,491,291,200,769,484,271,628,369,234
060710020502,478,294,184,483,287,196,824,515,296,695,422,246
060710020501,473,291,182,477,282,195,727,453,263,376,230,132
060710020441,804,383,421,815,370,445,1273,619,631,900,440,408
060710020442,887,459,428,889,440,449,1401,762,615,1195,602,524
060710020482,481,280,201,484,275,209,806,471,329,602,339,236
060710020481,536,313,223,546,299,247,1036,579,433,606,331,239
060710020471,235,168,67,236,158,78,397,254,137,346,206,125
060710020452,706,337,369,716,324,392,994,466,507,793,391,368
060710020451,449,215,234,456,207,249,628,293,321,488,216,248
060710020312,917,460,457,925,453,472,1395,730,643,1081,530,489
060710020512,642,410,232,646,401,245,1062,664,377,764,464,265
060710020511,499,324,175,498,315,183,847,533,296,620,376,213
060710020353,554,332,222,558,327,231,804,482,305,578,343,202
060710020492,533,319,214,539,317,222,705,424,267,561,334,196
060710020352,938,497,441,955,477,478,1425,754,643,1089,544,476
060710020491,282,160,122,286,154,132,453,257,185,289,154,116
060710020472,307,176,131,312,168,144,537,301,221,407,220,165
060710020473,175,99,76,180,96,84,328,181,136,233,127,95
060710020351,658,361,297,665,357,308,990,578,391,716,399,265
060710020191,854,447,407,863,436,427,1291,669,595,982,508,408
060710020192,672,392,280,676,379,297,1040,635,385,829,470,315
060710020211,872,347,525,889,337,552,1191,524,646,1088,420,624
060710020293,506,233,273,517,222,295,725,348,370,604,277,294
060710020294,743,344,399,760,329,431,1035,496,523,882,385,451
060710020462,569,266,303,572,270,302,918,439,457,810,409,359
060710020463,696,463,233,694,462,232,1152,705,432,829,511,282
060710020464,345,216,129,349,203,146,463,251,206,312,190,108
060710020212,754,347,407,763,347,416,1092,520,547,711,316,359
060710020213,474,235,239,483,230,253,697,344,337,770,359,372
060710020412,1067,514,553,1090,505,585,1606,788,793,1092,501,547
060710020433,670,349,321,684,339,345,1045,553,474,1093,547,502
060710020431,735,378,357,739,363,376,1186,629,543,629,328,272
060710020432,573,292,281,575,281,294,885,467,408,695,362,300
060710020411,857,363,494,870,363,507,1287,552,715,710,295,386
060710020461,676,405,271,684,384,300,1214,676,518,721,373,309
060710078003,400,244,156,408,239,169,636,406,214,508,281,186
060710078002,319,195,124,329,193,136,556,353,188,387,215,142
060710080042,294,209,85,295,200,95,464,300,150,381,253,107
060710081002,400,250,150,407,244,163,612,403,190,467,272,160
060710081003,183,114,69,187,112,75,283,184,88,208,121,70
060710081001,359,224,135,362,221,141,499,299,181,392,211,139
060710082013,611,362,249,621,359,262,790,476,286,702,377,273
060710083011,342,193,149,346,192,154,463,271,179,398,201,169
060710083012,587,341,246,592,333,259,789,463,300,634,349,248
060710083013,445,233,212,449,231,218,649,368,264,491,239,216
060710083014,697,343,354,711,343,368,884,478,385,806,377,372
060710083015,623,299,324,634,296,338,813,433,364,659,321,296
060710082012,233,135,98,238,135,103,347,209,126,319,174,114
060710080012,457,277,180,460,267,193,743,443,281,471,279,167
060710080013,517,360,157,527,343,184,876,578,268,723,486,197
060710080041,326,240,86,326,224,102,528,350,162,400,268,96
060710080014,893,474,419,903,469,434,1514,806,670,1005,523,417
060710080031,185,130,55,185,125,60,287,187,92,244,130,101
060710080032,162,114,48,166,112,54,263,175,85,189,115,57
060710080033,168,117,51,170,115,55,218,141,70,256,160,77
060710080011,349,216,133,356,214,142,561,321,222,422,239,156
060710080034,259,181,78,262,177,85,492,319,152,300,188,90
060710084061,639,329,310,646,324,322,968,509,445,752,394,314
060710084062,824,429,395,829,427,402,1217,666,516,1000,499,450
060710084021,351,179,172,356,175,181,561,289,257,371,188,159
060710084022,1156,577,579,1174,562,612,1506,763,703,1298,626,584
060710084023,582,272,310,592,267,325,795,386,387,673,300,333
060710084024,657,291,366,665,280,385,874,407,447,723,303,374
060710084032,941,403,538,965,392,573,1191,556,606,1023,410,554
060710084033,776,312,464,794,318,476,1010,455,530,871,360,470
060710085011,1104,449,655,1125,447,678,1443,686,718,1225,519,636
060710085023,1069,419,650,1086,418,668,1336,609,703,1149,456,621
060710085021,616,255,361,626,252,374,720,344,365,651,269,340
060710086012,353,149,204,357,140,217,582,254,311,409,166,221
060710086013,521,250,271,526,234,292,756,356,375,623,269,306
060710086021,675,309,366,682,292,390,1067,486,546,768,337,381
060710086022,638,243,395,651,244,407,928,342,569,766,267,454
060710084051,633,319,314,636,307,329,904,471,416,678,347,296
060710084052,525,269,256,530,260,270,758,401,341,585,302,255
060710084053,580,341,239,589,337,252,781,462,311,636,370,236
060710084031,586,310,276,590,307,283,810,445,346,655,316,292
060710084041,240,144,96,246,143,103,424,249,156,287,164,101
060710084042,393,237,156,396,232,164,611,368,219,458,248,176
060710084034,467,221,246,472,219,253,626,314,297,542,231,271
060710082021,748,395,353,761,390,371,949,539,387,893,405,423
060710082022,389,206,183,391,201,190,518,289,211,430,213,188
060710083021,536,275,261,541,270,271,674,373,285,565,263,264
060710083022,459,220,239,469,218,251,594,313,265,490,216,243
060710083023,765,351,414,785,353,432,951,488,435,813,349,414
060710085012,1084,445,639,1103,447,656,1286,598,658,1104,459,586
060710085022,641,246,395,649,246,403,863,378,467,731,285,409
060710085024,324,111,213,325,106,219,428,169,251,377,132,224
060710082011,459,242,217,465,238,227,626,352,256,419,229,150
060710027062,555,396,159,564,383,181,850,592,244,690,487,174
060710023061,226,173,53,226,168,58,426,314,101,333,257,55
060710034041,212,163,49,212,158,54,406,299,96,300,230,50
060710027031,736,467,269,747,451,296,1135,699,411,895,541,305
060710027032,611,383,228,622,368,254,958,549,387,740,444,257
060710027033,487,321,166,493,313,180,866,531,318,658,402,209
060710027071,504,336,168,507,326,181,843,537,285,575,360,179
060710027072,456,306,150,461,297,164,695,459,226,539,340,165
060710027051,440,304,136,438,288,150,656,420,216,519,343,150
060710027052,512,357,155,518,341,177,790,520,256,630,422,182
060710027061,2286,1274,1012,2326,1251,1075,4388,2295,2010,1862,1054,725
060710027053,410,305,105,423,294,129,659,464,183,509,369,118
060710035031,388,298,90,394,286,108,712,533,169,516,404,91
060710027054,308,228,80,315,222,93,493,307,175,376,270,90
060710027063,676,455,221,673,443,230,1035,666,344,861,573,243
060710038013,446,344,102,449,331,118,744,531,188,606,454,114
060710038011,309,237,72,312,226,86,508,369,129,406,306,82
060710038012,391,301,90,400,292,108,668,486,168,507,383,99
060710038042,339,260,79,344,251,93,548,393,142,478,359,93
060710035052,208,161,47,211,157,54,407,290,105,265,200,48
060710035062,371,285,86,375,277,98,600,430,155,495,380,90
060710035061,184,143,41,186,135,51,342,253,77,256,200,46
060710035063,374,277,97,378,264,114,724,532,182,551,418,110
060710038041,358,269,89,358,257,101,546,386,146,440,332,86
060710038043,494,372,122,502,359,143,788,556,208,616,465,121
060710043023,403,334,69,409,321,88,671,507,149,583,474,88
060710035092,415,318,97,419,306,113,786,561,194,615,471,114
060710038032,540,408,132,548,398,150,880,614,244,662,497,135
060710039001,338,256,82,337,241,96,548,397,136,431,317,87
060710035051,338,262,76,336,251,85,639,482,146,436,343,73
060710038031,365,269,96,366,261,105,628,459,154,460,347,90
060710035053,360,284,76,361,273,88,665,506,150,471,377,77
060710035072,372,289,83,377,276,101,682,502,168,610,471,108
060710035033,346,269,77,346,256,90,590,433,148,426,327,80
060710035032,576,440,136,582,426,156,900,636,242,711,519,151
060710035071,629,488,141,634,460,174,1116,792,299,915,711,156
060710040032,317,206,111,319,201,118,502,319,169,401,273,109
060710040043,222,146,76,224,139,85,364,238,122,292,196,83
060710036091,169,136,33,171,127,44,306,221,76,266,202,50
060710036062,239,188,51,241,175,66,425,291,124,366,279,69
060710036052,453,342,111,459,325,134,766,536,219,519,388,115
060710034053,263,206,57,261,197,64,527,383,128,290,223,50
060710036032,439,317,122,446,306,140,756,499,243,627,452,142
060710034032,358,257,101,361,256,105,648,463,177,474,342,100
060710039002,320,242,78,318,227,91,545,394,134,398,297,80
060710035091,348,276,72,348,265,83,629,461,155,471,368,84
060710037001,242,194,48,245,188,57,408,302,100,333,263,57
060710037002,378,297,81,376,285,91,637,461,165,501,388,92
060710035102,158,126,32,161,125,36,261,200,55,186,149,26
060710035103,253,203,50,257,199,58,406,308,87,298,240,41
060710035101,310,250,60,315,243,72,519,396,112,362,291,51
060710036071,514,402,112,521,391,130,996,712,261,686,529,130
060710036072,519,396,123,521,376,145,840,593,231,655,482,138
060710036122,226,163,63,229,159,70,405,278,117,344,243,83
060710039003,276,210,66,276,199,77,469,331,129,356,262,76
060710036092,299,209,90,301,202,99,529,363,158,431,298,111
060710036093,363,255,108,366,245,121,595,408,177,507,350,129
060710036031,473,379,94,473,365,108,911,664,227,644,510,103
060710036051,420,311,109,422,294,128,741,509,214,583,437,123
060710057012,117,92,25,116,91,25,202,142,53,164,130,28
060710057011,176,142,34,177,137,40,278,200,73,230,184,36
060710058002,149,119,30,150,117,33,286,202,75,203,157,34
060710058003,131,105,26,133,105,28,226,159,59,166,130,26
060710043021,251,217,34,252,206,46,383,291,76,322,268,37
060710043022,148,128,20,149,125,24,228,182,46,180,155,21
060710048002,214,182,32,214,177,37,320,245,68,255,204,29
060710049012,238,196,42,237,187,50,336,253,78,284,234,39
060710047002,152,131,21,154,126,28,302,233,58,238,199,24
060710047004,113,96,17,114,92,22,208,163,41,157,136,13
060710047005,154,129,25,154,125,29,250,198,52,213,184,21
060710048001,181,156,25,183,149,34,395,309,76,276,237,25
060710049022,236,190,46,240,177,63,393,292,90,308,250,48
060710056012,141,110,31,140,105,35,251,184,62,223,172,37
060710056021,210,174,36,208,167,41,375,282,86,282,230,39
060710058001,136,106,30,137,102,35,254,185,61,216,167,35
060710063032,221,164,57,224,155,69,411,280,116,301,217,70
060710064012,223,182,41,224,178,46,452,339,100,268,207,38
060710064022,85,69,16,85,65,20,163,121,28,129,108,15
060710065011,127,100,27,126,95,31,265,184,75,200,154,36
060710065012,172,135,37,174,131,43,323,226,88,268,202,51
060710064011,40,34,6,40,34,6,42,33,9,108,90,12
060719801001,1,0,1,1,0,1,0,0,0,0,0,0
060710063031,215,159,56,215,147,68,372,256,106,291,212,68
060710056011,110,91,19,112,88,24,195,143,45,198,159,29
060710056013,139,111,28,138,109,29,246,185,57,195,162,30
060710056022,118,97,21,119,98,21,195,154,39,159,130,23
060710063013,334,252,82,334,245,89,518,382,127,412,303,87
060710063033,146,107,39,146,104,42,235,171,54,198,140,43
060710054004,282,232,50,280,223,57,404,288,101,333,257,58
060710063011,197,141,56,198,132,66,319,209,98,243,168,55
060710063012,182,130,52,186,124,62,294,195,91,240,167,55
060710063014,118,96,22,119,92,27,216,166,46,174,134,29
060710063043,257,180,77,256,166,90,465,303,149,349,233,96
060710046041,257,182,75,261,177,84,467,283,161,314,214,77
060710046042,273,191,82,278,185,93,524,322,193,373,259,93
060710046044,373,257,116,376,247,129,677,420,251,461,308,126
060710054001,243,189,54,248,184,64,401,275,107,364,266,72
060710054002,180,140,40,181,135,46,272,188,74,257,190,49
060710054003,308,257,51,312,250,62,467,339,119,387,296,69
060710055023,185,157,28,185,156,29,309,242,58,242,195,31
060710055024,108,93,15,110,93,17,204,162,38,152,124,19
060710055021,176,146,30,179,143,36,297,221,63,235,188,30
060710055022,141,117,24,142,115,27,262,198,52,203,165,28
060710055011,147,120,27,142,109,33,297,213,71,250,198,37
060710055012,74,60,14,74,57,17,134,93,29,100,79,15
060710053004,251,166,85,250,162,88,410,254,143,325,204,101
060710053005,186,116,70,187,113,74,288,186,97,243,164,63
060710071103,501,303,198,508,299,209,833,506,301,609,334,221
060710044032,185,148,37,187,141,46,335,244,82,279,216,50
060710044033,256,204,52,259,195,64,491,360,119,386,299,70
060710044041,205,161,44,207,155,52,444,321,112,291,227,54
060710044042,225,170,55,221,161,60,347,245,91,283,212,61
060710044043,282,221,61,282,212,70,497,358,124,377,291,71
060710044012,309,238,71,309,231,78,551,400,141,414,322,74
060710044013,279,219,60,278,214,64,518,380,130,383,299,65
060710049011,257,201,56,256,182,74,463,332,113,341,264,59
060710124002,154,118,36,155,116,39,284,208,70,224,163,47
060710124003,160,123,37,161,121,40,290,215,72,227,167,47
060710073031,233,180,53,238,183,55,402,287,105,347,259,66
060710072023,124,83,41,128,83,45,217,134,75,168,109,50
060710072021,161,108,53,163,106,57,266,167,94,212,138,62
060710072012,353,236,117,355,232,123,582,364,204,457,300,135
060710110021,413,195,218,417,186,231,491,240,243,464,212,233
060710074111,460,242,218,468,246,222,746,424,310,615,300,291
060710074123,568,335,233,571,323,248,844,506,316,680,391,251
060710074124,382,218,164,387,210,177,566,333,223,469,261,182
060710061023,463,232,231,467,219,248,671,347,307,662,305,322
060710061022,208,143,65,209,136,73,319,200,108,285,175,90
060710074041,306,157,149,311,151,160,443,232,200,385,188,178
060710123001,52,25,27,52,24,28,62,32,30,65,31,30
060710074042,402,196,206,405,186,219,589,299,282,528,251,243
060710074043,316,155,161,316,151,165,517,277,228,350,162,176
060710074044,403,179,224,406,173,233,482,240,232,449,191,242
060710074045,274,145,129,279,142,137,400,217,171,332,163,151
060710061012,463,274,189,462,262,200,732,444,273,583,320,229
060710061011,268,176,92,271,172,99,480,316,153,333,199,111
060710074104,426,243,183,433,243,190,681,423,244,518,297,194
060710061013,325,157,168,328,151,177,448,224,208,323,150,154
060710074122,245,164,81,247,158,89,413,286,122,305,201,84
060710045052,272,164,108,274,161,113,456,270,172,336,193,127
060710045071,267,183,84,269,180,89,415,245,150,347,222,101
060710045073,353,223,130,355,217,138,566,342,210,279,175,92
060710045091,471,271,200,477,263,214,711,409,285,807,438,323
060710045092,317,196,121,321,193,128,511,307,195,390,232,138
060710045093,495,279,216,502,273,229,777,460,297,643,350,258
060710045053,442,274,168,451,267,184,704,422,261,566,328,205
060710051021,303,191,112,304,182,122,497,289,188,380,212,145
060710051022,326,217,109,326,209,117,461,288,160,388,236,129
060710108051,543,222,321,557,218,339,784,339,426,665,264,371
060710045051,411,247,164,412,238,174,602,357,232,512,292,190
060710062031,372,274,98,374,268,106,692,481,192,481,330,116
060710045072,325,220,105,326,217,109,507,317,170,398,253,114
060710045031,922,451,471,928,434,494,1390,695,662,1058,534,456
060710045121,694,411,283,708,411,297,1164,701,444,894,486,357
060710045122,747,383,364,768,390,378,1109,570,525,902,437,411
060710045111,385,238,147,391,235,156,592,369,212,450,262,162
060710045112,695,434,261,706,424,282,1006,628,360,825,494,281
060710045101,348,201,147,350,199,151,486,278,193,525,336,150
060710045102,265,192,73,269,192,77,396,268,121,279,187,69
060710045103,377,273,104,383,274,109,632,424,190,466,310,115
060710046011,590,373,217,594,361,233,790,494,272,661,395,216
060710046012,321,208,113,323,200,123,469,301,157,388,235,125
060710046013,279,180,99,281,174,107,425,268,143,352,213,112
060710046014,280,190,90,284,186,98,480,319,149,404,256,118
060710046015,296,200,96,298,194,104,491,318,164,421,263,130
060710046033,438,279,159,443,272,171,699,437,246,550,327,185
060710046031,408,247,161,418,246,172,625,372,246,501,281,188
060710046032,218,133,85,220,128,92,348,201,133,284,160,107
060710046034,503,321,182,507,313,194,739,438,282,611,363,215
060710046043,324,215,109,324,209,115,527,315,197,428,261,142
060710043011,307,244,63,304,234,70,649,476,165,404,318,71
060710043012,147,122,25,148,120,28,268,204,61,184,152,26
060710043013,350,292,58,355,286,69,550,420,122,489,399,69
060710044011,140,109,31,138,104,34,259,185,66,195,151,36
060710042013,349,305,44,348,294,54,664,534,117,470,423,31
060710042011,333,292,41,338,285,53,553,464,78,457,395,45
060710042012,321,281,40,325,276,49,598,488,99,447,395,37
060710041033,190,158,32,189,151,38,366,283,80,291,241,33
060710042021,344,300,44,348,294,54,571,461,96,493,422,46
060710042022,228,195,33,228,189,39,412,321,85,333,279,36
060710047001,142,123,19,143,116,27,263,198,56,217,176,22
060710041013,260,192,68,258,183,75,471,337,117,357,270,66
060710041012,244,191,53,246,184,62,424,311,102,351,269,67
060710041031,290,247,43,292,234,58,548,420,115,428,346,60
060710041032,200,178,22,201,169,32,395,308,75,315,267,27
060710041041,274,204,70,276,194,82,474,337,127,417,325,70
060710042023,243,209,34,244,200,44,350,272,69,311,272,29
060710047003,141,121,20,143,118,25,222,170,44,184,159,17
060710051011,504,260,244,509,253,256,724,391,313,613,298,282
060710051012,253,142,111,255,139,116,389,217,160,315,163,135
060710052001,306,187,119,307,184,123,464,266,179,333,187,126
060710062011,204,115,89,205,116,89,306,193,108,250,139,95
060710062012,211,129,82,213,129,84,311,191,118,248,144,89
060710052002,270,177,93,272,172,100,447,288,150,362,232,111
060710062013,454,291,163,465,288,177,717,448,248,605,368,198
060710062042,281,193,88,284,200,84,447,312,120,381,284,70
060710062041,264,185,79,268,185,83,394,286,100,367,248,90
060710062032,281,222,59,286,219,67,485,342,129,356,260,75
060710074071,99,75,24,100,76,24,176,130,40,161,125,28
060710074073,129,98,31,130,98,32,264,194,62,183,143,32
060710051013,303,188,115,306,180,126,479,274,184,366,199,140
060710051014,279,174,105,280,166,114,431,254,169,340,189,130
060710051023,208,127,81,212,122,90,305,177,123,254,136,104
060710052004,265,167,98,267,161,106,395,236,150,323,183,117
060710052003,166,113,53,165,108,57,246,161,84,225,149,63
060710053001,271,190,81,269,178,91,436,286,131,381,260,90
060710053002,169,119,50,173,115,58,269,180,83,220,149,53
060710053003,177,117,60,178,114,64,265,164,97,236,148,76
060710104021,113,60,53,114,55,59,415,157,208,270,99,143
060710104152,350,159,191,354,155,199,518,243,252,348,128,196
060710104341,244,113,131,246,105,141,435,202,212,347,117,198
060710104321,646,303,343,655,296,359,895,406,453,700,260,382
060710104151,300,123,177,306,118,188,517,213,269,358,131,194
060710104153,317,134,183,320,129,191,522,228,258,357,138,196
060710104313,107,48,59,109,48,61,142,63,78,116,38,73
060710104154,316,131,185,322,126,196,514,242,257,428,158,233
060710104331,273,150,123,278,145,133,529,265,228,354,131,192
060710104222,328,133,195,330,130,200,501,232,254,280,104,151
060710104262,232,99,133,232,96,136,331,136,184,247,96,133
060710104332,90,38,52,91,36,55,216,95,107,149,57,80
060710104333,130,53,77,131,51,80,268,120,127,207,76,112
060710104261,334,122,212,338,123,215,520,235,257,408,145,231
060710104221,104,32,72,104,33,71,153,50,98,168,57,97
060710121052,339,80,259,348,78,270,601,146,448,492,109,359
060710121051,697,176,521,704,172,532,826,210,605,681,152,503
060710097082,446,84,362,450,79,371,570,127,434,472,83,370
060710097084,278,70,208,277,70,207,368,101,261,312,81,216
060710103001,107,42,65,107,32,75,163,46,112,156,48,98
060710119001,137,39,98,141,38,103,192,46,142,172,39,120
060710119002,93,29,64,94,27,67,126,37,87,97,22,68
060710119003,234,73,161,237,73,164,350,104,236,317,97,205
060710117001,271,89,182,276,86,190,459,154,297,344,105,219
060710116021,365,115,250,374,114,260,518,156,338,493,141,331
060710116022,44,11,33,46,12,34,61,28,31,41,12,28
060710111021,385,132,253,397,133,264,520,169,339,423,127,271
060710104252,116,58,58,115,54,61,145,68,75,130,48,78
060719401001,230,67,163,232,71,161,374,104,267,325,89,226
060710089012,233,58,175,235,61,174,327,84,231,304,75,208
060290054101,461,138,323,468,139,329,618,201,394,506,148,317
060710121062,110,35,75,108,33,75,186,62,120,150,44,94
060710103002,305,78,227,309,78,231,406,103,287,350,92,243
060710103004,176,41,135,178,39,139,267,71,192,219,57,152
060710103003,199,51,148,200,51,149,273,70,194,211,55,148
060710250001,147,85,62,147,82,65,539,276,223,369,166,156
060710089011,233,56,177,242,58,184,368,85,267,321,68,225
060710116013,649,187,462,657,182,475,957,307,621,766,188,536
060710116012,516,153,363,522,149,373,713,237,460,571,158,388
060710116011,437,124,313,444,124,320,684,216,447,563,133,396
060710116014,602,176,426,608,173,435,820,274,529,672,186,456
060710113002,409,135,274,417,134,283,589,202,378,497,148,325
060710121031,521,156,365,528,148,380,789,204,566,658,181,439
060710121061,279,96,183,281,91,190,417,133,279,347,100,229
060710104243,316,116,200,320,113,207,266,126,140,247,85,150
060710121032,525,151,374,531,149,382,815,218,592,715,197,483
060710104241,183,50,133,183,47,136,246,68,168,192,47,132
060710114043,179,55,124,185,56,129,325,99,222,248,54,179
060710104361,124,43,81,128,45,83,205,77,124,180,59,114
060710104362,100,37,63,100,36,64,138,56,82,136,41,85
060710104251,87,45,42,88,41,47,125,54,67,97,38,48
060710104102,456,174,282,465,175,290,650,240,390,539,178,334
060710104351,242,108,134,246,106,140,442,190,233,367,128,218
060710104311,117,69,48,116,67,49,165,88,73,125,59,55
060710104312,252,108,144,254,104,150,305,118,171,251,84,142
060710104202,560,286,274,565,288,277,549,249,287,444,185,234
060710104193,375,192,183,376,195,181,625,321,287,559,235,280
060710104191,477,253,224,479,253,226,496,272,210,607,262,292
060710104201,369,195,174,374,194,180,779,384,365,398,180,195
060710104203,249,140,109,254,139,115,404,209,178,262,121,121
060710104194,285,141,144,286,145,141,406,208,188,372,154,193
060710104192,390,194,196,391,197,194,522,278,228,454,190,236
060710104132,480,176,304,489,168,321,575,218,344,449,154,272
060710104173,264,123,141,265,125,140,365,166,192,275,104,158
060710104242,300,137,163,303,137,166,392,186,198,338,137,188
060710104352,300,139,161,303,141,162,425,199,217,312,120,180
060710104353,376,164,212,376,164,212,391,164,214,346,130,198
060710104281,448,167,281,451,161,290,571,242,317,450,162,261
060710104101,540,219,321,532,210,322,757,279,453,658,218,395
060710104171,695,313,382,697,313,384,970,430,515,803,278,467
060710104172,257,117,140,260,117,143,370,162,194,289,103,169
060710091352,145,51,94,150,55,95,259,89,167,231,61,155
060710091191,558,137,421,564,132,432,884,228,638,687,155,509
060710091193,516,155,361,522,152,370,914,351,544,623,184,410
060710091192,565,134,431,568,127,441,769,201,551,659,146,481
060710099102,717,369,348,728,341,387,1115,521,565,861,407,396
060710091282,391,252,139,398,235,163,636,384,244,483,294,166
060710100271,453,140,313,461,142,319,735,241,481,583,171,386
060710100272,487,147,340,493,148,345,765,249,503,619,189,403
060710100391,1015,328,687,1027,317,710,1490,528,942,1162,339,763
060710091221,521,176,345,524,164,360,768,251,488,697,197,460
060710091222,471,152,319,480,142,338,740,247,478,607,170,404
060710091231,342,93,249,351,93,258,497,157,321,442,119,289
060710091194,206,56,150,212,55,157,339,92,243,233,64,162
060710091093,376,90,286,385,89,296,528,142,376,390,93,279
060710091094,499,120,379,503,116,387,732,191,520,573,136,412
060710111023,187,76,111,190,78,112,258,123,129,181,77,93
060710111011,392,149,243,398,146,252,538,204,325,447,144,275
060710111012,446,166,280,452,167,285,593,220,365,487,164,296
060710111013,377,138,239,383,136,247,495,187,299,397,123,247
060710111022,308,140,168,313,140,173,451,212,227,359,123,203
060710109051,434,131,303,437,129,308,669,224,432,829,253,530
060710109062,166,71,95,167,66,101,234,103,122,206,77,116
060710109032,353,126,227,355,124,231,503,179,312,297,91,188
060710109033,447,158,289,454,160,294,498,201,286,449,138,286
060710110031,469,166,303,475,160,315,310,137,164,300,116,171
060710110041,306,128,178,313,123,190,452,192,251,292,101,166
060710109043,561,166,395,568,161,407,667,222,435,597,157,412
060710109042,307,99,208,314,98,216,398,144,249,351,88,248
060710109041,263,93,170,271,94,177,409,150,252,419,128,272
060710109031,568,193,375,572,189,383,785,288,482,600,172,392
060710109052,275,86,189,278,88,190,399,134,258,212,64,136
060710109053,315,99,216,321,100,221,385,141,237,337,102,215
060710110032,287,119,168,290,117,173,419,189,223,311,125,172
060710110022,379,153,226,387,151,236,501,212,276,391,151,221
060710109061,185,58,127,190,57,133,231,91,134,203,65,131
060710108063,276,104,172,280,103,177,388,149,234,307,107,184
060710108062,405,168,237,410,160,250,437,196,233,323,113,184
060710108052,337,135,202,340,131,209,544,218,316,442,159,249
060710108061,383,141,242,390,138,252,714,273,421,493,165,294
060710108041,483,172,311,487,167,320,770,306,448,560,188,340
060710108031,355,151,204,359,147,212,511,210,282,384,150,214
060710108033,378,162,216,385,158,227,518,227,270,438,166,248
060710108042,367,157,210,377,156,221,505,235,259,408,150,229
060710108032,332,140,192,337,136,201,407,179,216,383,140,226
060710108034,355,143,212,361,139,222,432,186,235,408,149,238
060710108043,260,96,164,264,98,166,324,132,183,289,98,175
060710115001,444,171,273,448,171,277,586,227,352,512,181,296
060710114042,564,175,389,577,173,404,667,213,436,583,155,391
060710114061,549,186,363,561,185,376,722,252,452,662,203,419
060710114062,310,106,204,310,104,206,520,186,320,335,106,215
060710114051,174,58,116,174,58,116,217,82,134,168,56,109
060710114052,160,56,104,163,55,108,220,81,139,212,68,133
060710114071,379,133,246,386,133,253,571,206,350,442,140,273
060710114081,270,116,154,272,106,166,409,181,226,298,104,174
060710114082,357,131,226,364,129,235,520,204,301,367,119,231
060710114044,322,93,229,325,93,232,444,142,295,361,90,248
060710114041,402,155,247,409,146,263,564,231,325,457,158,270
060710087112,785,217,568,794,216,578,1039,327,697,862,239,581
060710091201,568,153,415,572,141,431,770,219,529,604,128,439
060710091232,367,124,243,368,110,258,524,160,358,463,135,310
060710091212,789,219,570,808,207,601,1077,294,762,1028,236,738
060710091211,290,79,211,294,77,217,410,109,289,346,81,247
060710091091,577,125,452,582,125,457,853,232,600,728,163,524
060710091092,447,97,350,450,96,354,604,161,431,601,139,431
060710092011,913,315,598,922,310,612,1276,456,779,987,307,597
060710092012,608,205,403,623,206,417,828,299,501,646,198,399
060710092013,483,169,314,491,172,319,679,242,423,540,172,323
060710092022,251,72,179,254,70,184,346,102,235,300,83,200
060710045032,497,159,338,501,146,355,673,212,446,585,174,390
060710087153,651,213,438,655,214,441,868,318,525,675,230,418
060710087111,1153,252,901,1161,251,910,1572,375,1175,1300,286,959
060710041043,112,88,24,111,83,28,233,166,62,171,135,24
060710041014,102,72,30,103,69,34,188,133,51,147,109,26
060710041011,182,129,53,189,127,62,332,231,88,254,188,46
060710041042,183,125,58,182,119,63,362,244,108,271,200,53
060710061021,426,282,144,429,267,162,683,415,251,528,319,171
060710063042,191,131,60,194,125,69,271,177,89,257,168,74
060710065022,189,146,43,192,151,41,379,266,100,270,207,54
060710086011,310,150,160,312,141,171,514,249,250,341,148,167
060710086014,564,274,290,569,260,309,914,441,444,722,306,355
060710036061,148,111,37,149,101,48,271,185,82,227,166,48
060710036063,246,174,72,247,167,80,437,291,135,346,244,77
060710036064,172,119,53,171,116,55,308,205,96,232,162,53
060710026081,185,131,54,187,125,62,315,195,118,253,181,60
060710040011,492,345,147,497,333,164,793,501,270,643,457,151
060710040012,274,207,67,278,201,77,475,327,130,387,289,73
060710040033,356,270,86,357,256,101,630,428,190,474,362,89
060710040042,254,166,88,257,159,98,422,270,143,337,224,94
060710040031,223,177,46,224,166,58,381,283,93,305,238,51
060374028042,150,118,32,151,114,37,258,186,66,171,142,23
060710003081,249,194,55,250,187,63,397,288,102,302,229,60
060374028043,189,154,35,192,151,41,330,237,83,255,208,34
060710003043,274,186,88,279,192,87,441,282,151,341,230,106
060710004033,519,238,281,526,229,297,780,347,424,633,298,312
060710004013,385,171,214,392,168,224,611,270,327,471,217,234
060710024031,157,133,24,159,131,28,357,262,90,241,194,33
060710024052,223,177,46,224,168,56,420,303,108,306,241,48
060710024033,362,291,71,363,277,86,681,489,179,496,399,72
060710024032,199,160,39,199,153,46,343,246,91,285,232,39
060710025011,186,150,36,187,143,44,355,254,94,247,201,35
060710025012,320,262,58,323,254,69,584,425,142,452,371,61
060710114072,278,118,160,283,115,168,420,186,223,293,112,166
060710091361,113,77,36,113,73,40,208,136,72,134,87,44
060710099111,466,219,247,472,204,268,802,391,401,626,304,295
060710100273,370,132,238,371,122,249,613,198,408,462,139,296
060710091202,671,171,500,678,165,513,972,258,689,786,173,565
060710100401,645,196,449,651,191,460,949,300,636,748,201,504
060710008131,852,380,472,871,383,488,1141,586,535,948,455,447
060710008132,904,385,519,923,386,537,1206,591,596,1028,463,516
060710008142,688,272,416,701,270,431,934,427,490,799,326,433
060710008143,441,176,265,451,172,279,581,263,307,495,209,261
060710008151,760,373,387,773,373,400,1192,624,550,868,431,397
060710008152,893,455,438,908,446,462,1223,662,537,1006,510,446
060710008162,899,382,517,915,373,542,1208,572,609,972,416,506
060710008163,732,316,416,746,308,438,952,468,466,813,355,413
060710008171,564,289,275,576,282,294,769,418,336,601,302,270
060710008172,573,283,290,583,277,306,808,422,369,689,338,319
060710008181,742,339,403,754,335,419,989,487,481,836,360,430
060710008173,443,219,224,450,218,232,671,348,307,530,267,240
060710008183,569,308,261,578,295,283,832,460,356,719,345,339
060710008191,566,231,335,573,223,350,607,278,321,629,266,341
060710008141,448,151,297,458,149,309,583,233,339,484,168,289
060710008144,469,161,308,479,159,320,604,252,341,539,194,313
060710008201,901,325,576,919,315,604,1217,495,698,998,388,553
060710008081,650,321,329,657,318,339,1115,567,521,740,360,332
060710008193,856,376,480,870,365,505,1199,567,606,954,435,476
060710008202,586,242,344,596,237,359,715,341,364,605,247,335
060710008203,563,234,329,572,227,345,839,397,428,678,276,374
060710008161,508,209,299,513,205,308,644,289,346,547,226,299
060710008184,601,247,354,608,244,364,795,355,427,656,272,356
060710008084,516,256,260,528,255,273,794,408,367,621,297,286
060710008182,556,246,310,555,233,322,724,365,350,608,293,288
060710008242,427,241,186,430,240,190,657,375,262,514,292,186
060710008243,345,198,147,347,197,150,552,313,224,420,237,154
060374019011,314,273,41,318,276,42,432,322,98,344,306,13
060710008212,99,72,27,100,69,31,220,153,61,120,84,28
060710008211,620,441,179,628,429,199,1369,942,391,736,498,189
060710008231,494,281,213,502,277,225,725,431,274,565,319,212
060710008262,360,205,155,365,201,164,584,347,221,431,243,161
060710008263,447,257,190,457,253,204,683,402,265,515,282,202
060710008234,380,261,119,387,254,133,616,407,195,453,295,130
060710008233,280,186,94,284,181,103,440,278,151,355,221,113
060710008251,202,134,68,205,130,75,341,216,118,260,162,83
060710008252,411,274,137,416,265,151,696,442,241,702,448,208
060710008253,117,78,39,119,76,43,236,149,82,168,105,53
060710008232,357,255,102,360,247,113,664,462,184,462,318,115
060710008261,489,260,229,495,251,244,731,398,311,553,295,222
060710008083,295,177,118,301,173,128,518,295,210,415,225,163
060710008082,690,365,325,697,355,342,890,487,384,764,405,327
060710009033,261,175,86,261,171,90,440,286,138,344,224,99
060710009041,640,406,234,648,402,246,955,596,336,770,451,260
060710009012,518,299,219,523,292,231,781,463,298,636,351,245
060710009013,278,170,108,280,165,115,452,280,163,349,205,121
060710009031,253,172,81,254,168,86,427,284,132,338,222,96
060710009032,303,205,98,305,200,105,532,353,167,387,256,109
060710008241,210,134,76,212,128,84,370,227,133,266,142,107
060710008244,250,160,90,254,153,101,430,263,155,340,194,123
060710009042,231,148,83,235,145,90,354,231,117,265,159,89
060710091353,322,203,119,332,196,136,524,296,216,395,231,149
060710100092,214,93,121,214,88,126,373,171,194,314,131,167
060710100091,367,161,206,370,150,220,651,295,337,507,212,270
060710091363,453,303,150,456,290,166,810,508,283,574,358,189
060710091362,449,307,142,453,291,162,796,497,267,599,374,193
060710091351,688,401,287,699,389,310,1130,634,474,914,518,353
060719802001,0,0,0,0,0,0,0,0,0,0,0,0
060710091262,470,225,245,466,217,249,733,382,332,529,259,239
060710099152,256,166,90,258,159,99,610,372,222,339,205,110
060710099151,184,118,66,182,112,70,356,219,129,249,152,81
060710098002,76,42,34,75,38,37,139,76,63,99,55,41
060710121012,148,78,70,150,77,73,256,135,116,196,92,93
060710091263,249,167,82,254,162,92,480,303,164,192,95,85
060710091261,527,354,173,532,339,193,1016,642,345,691,451,200
060710099161,173,101,72,177,94,83,325,188,123,442,264,154
060710099163,312,179,133,315,172,143,609,356,233,336,197,122
060710099162,499,286,213,507,278,229,844,499,327,717,416,262
060710098001,93,62,31,90,56,34,192,124,67,147,98,42
060710098003,207,138,69,204,127,77,365,227,126,296,187,85
060710098004,171,114,57,171,107,64,324,196,110,263,169,76
060710091281,612,415,197,619,391,228,1164,781,352,783,536,203
060710091272,437,312,125,439,298,141,800,537,246,590,394,166
060710091273,316,225,91,317,215,102,609,410,186,447,298,127
060710091271,586,391,195,595,376,219,996,600,376,809,527,234
060710099182,386,254,132,389,247,142,700,444,228,573,352,181
060710099172,356,239,117,358,228,130,625,409,203,536,333,170
060710099171,239,137,102,251,139,112,388,215,157,331,175,137
060710099173,305,228,77,309,216,93,563,405,144,499,322,147
060710099181,157,96,61,156,92,64,248,150,93,190,110,68
060710099121,251,151,100,252,143,109,467,280,168,401,209,167
060710099133,216,119,97,217,114,103,345,190,139,225,129,83
060710099132,228,143,85,233,139,94,397,245,141,314,189,105
060710099131,269,169,100,271,161,110,464,282,164,420,199,191
060710099112,461,234,227,470,223,247,704,372,314,547,270,242
060710099141,220,128,92,221,120,101,387,234,142,298,183,101
060710099123,362,184,178,375,178,197,621,334,270,519,252,240
060710099134,362,161,201,365,153,212,501,234,258,383,181,176
060710091372,786,442,344,794,430,364,1303,710,559,1030,564,414
060710091393,282,162,120,288,158,130,498,274,209,370,202,150
060710091392,431,252,179,431,242,189,856,493,343,563,335,201
060710091381,469,277,192,470,273,197,985,618,346,645,393,223
060710091382,462,276,186,461,271,190,832,446,371,617,382,212
060710099061,421,229,192,427,227,200,739,436,280,559,314,226
060710099063,426,246,180,427,231,196,652,374,261,526,284,208
060710099062,349,201,148,353,192,161,566,323,226,466,252,185
060710099113,699,369,330,710,362,348,1044,574,446,876,426,389
060710099081,476,263,213,492,256,236,848,451,377,674,339,298
060710099082,622,354,268,630,331,299,978,552,407,763,414,304
060710099101,454,281,173,462,268,194,720,434,275,569,340,207
060710100362,466,268,198,467,261,206,786,451,319,573,322,227
060710100361,436,249,187,438,244,194,769,442,313,568,321,223
060710100373,259,129,130,259,120,139,426,220,196,351,155,172
060710100372,525,261,264,525,247,278,830,429,385,660,296,327
060710100371,617,306,311,624,290,334,1132,558,543,788,357,389
060710100351,338,176,162,340,164,176,584,315,260,444,228,196
060710100352,263,137,126,266,128,138,451,242,199,355,180,155
060710100382,385,215,170,389,205,184,652,368,276,545,298,214
060710100381,523,286,237,526,269,257,909,497,383,714,382,290
060710091371,315,173,142,319,167,152,458,246,206,395,211,165
060710099142,144,102,42,146,95,51,338,227,96,259,158,87
060710099122,329,156,173,334,145,189,492,250,237,375,184,178
060710091391,292,180,112,295,176,119,544,338,194,419,277,125
060710104131,403,171,232,405,164,241,676,289,360,533,180,322
060710087154,639,208,431,649,204,445,1213,424,765,741,239,462
060710087151,702,239,463,712,231,481,1065,364,681,804,249,514
060710087163,526,179,347,537,174,363,804,276,515,597,185,381
060710087051,291,124,167,298,121,177,458,166,280,410,151,224
060710087053,273,131,142,278,124,154,429,173,246,349,127,192
060650438022,307,99,208,313,96,217,324,108,212,245,82,151
060650438232,181,61,120,183,59,124,1057,376,657,178,55,113
060710087131,497,158,339,511,152,359,684,212,458,573,183,364
060710087141,904,310,594,912,299,613,1265,464,773,1080,379,640
060710087133,559,192,367,568,190,378,832,316,491,658,238,383
060710087142,271,111,160,275,103,172,491,197,283,347,123,192
060710087132,445,158,287,449,150,299,687,259,411,530,182,315
060710087052,302,107,195,309,103,206,459,173,277,380,131,226
060710087054,365,130,235,371,125,246,555,209,330,435,149,259
060710087152,719,281,438,731,277,454,946,350,578,879,319,511
060710087101,370,147,223,377,146,231,548,228,310,433,162,248
060710087103,332,132,200,337,131,206,534,223,304,410,153,235
060710087093,475,186,289,484,183,301,799,275,496,596,206,349
060710087081,431,148,283,435,143,292,613,215,385,497,160,297
060710088002,516,204,312,517,190,327,832,336,486,634,212,375
060710087102,327,129,198,331,130,201,552,242,302,452,168,261
060710087161,969,335,634,990,336,654,1360,495,834,1103,383,657
060710087162,835,295,540,853,293,560,1131,419,684,926,338,539
060710088003,641,245,396,652,241,411,989,379,587,747,270,428
060710087121,1129,310,819,1144,308,836,1494,444,1018,1276,348,869
060710088001,565,161,404,572,160,412,837,257,559,642,187,415
060710088004,335,95,240,341,95,246,468,146,316,367,108,238
060710087091,313,101,212,318,100,218,468,153,303,334,100,213
060710087083,586,183,403,595,184,411,855,280,558,700,200,467
060710087082,599,197,402,610,194,416,887,315,555,738,230,461
060710087092,369,123,246,378,122,256,626,221,392,456,140,287
060710087122,942,258,684,959,256,703,1230,384,822,1044,275,711
060710104271,431,187,244,431,191,240,626,272,335,531,189,312
060710104272,384,137,247,390,135,255,604,243,339,492,163,297
060710104133,516,226,290,523,225,298,877,373,477,622,230,362
060710104283,438,189,249,443,188,255,654,278,347,579,184,364
060710104282,490,180,310,493,176,317,634,232,383,508,153,329
060710104134,609,264,345,614,264,350,839,362,458,695,254,403
060710104293,325,116,209,326,115,211,474,172,291,383,115,244
060710104292,526,201,325,533,197,336,787,318,459,626,191,395
060710104291,422,143,279,427,140,287,592,219,365,498,149,327
060710104302,684,221,463,694,217,477,1045,357,662,804,232,539
060710104301,641,219,422,642,209,433,928,323,584,751,213,506
060790100173,741,223,518,751,212,539,992,335,638,792,214,537
060790100163,581,183,398,587,173,414,770,264,489,841,262,542
060790100162,639,215,424,647,206,441,1059,373,665,676,220,408
060790103032,589,194,395,600,187,413,855,259,587,670,210,416
060790100172,455,142,313,465,137,328,628,224,390,465,130,316
060790100171,497,147,350,505,140,365,667,235,413,552,146,379
060790102071,947,324,623,963,308,655,1414,573,818,919,352,515
060790103031,537,147,390,546,140,406,788,247,524,607,158,420
060790100161,931,343,588,944,336,608,1148,456,666,1031,361,605
060790101011,758,341,417,778,331,447,1033,471,530,929,370,479
060790101041,310,167,143,312,163,149,461,245,206,366,157,190
060790102072,1326,548,778,1355,543,812,1905,817,1037,1273,511,672
060790103021,1055,313,742,1069,309,760,1233,391,815,1142,344,738
060790102022,600,250,350,613,241,372,759,349,398,670,280,357
060790103022,714,251,463,731,246,485,997,385,590,715,239,438
060790102042,792,370,422,810,365,445,1092,513,553,883,395,431
060790102041,1213,513,700,1237,499,738,1655,787,820,1345,522,732
060790103011,666,209,457,675,208,467,812,234,558,682,208,437
060790103012,847,246,601,858,249,609,1084,355,706,920,251,607
060790103013,261,96,165,263,93,170,363,151,200,299,101,175
060790101042,165,93,72,171,90,81,290,154,126,205,89,104
060790101033,366,198,168,379,195,184,587,319,261,460,224,198
060790101031,349,181,168,357,176,181,456,243,211,427,203,190
060790102061,688,274,414,696,261,435,1044,497,523,743,266,431
060790102062,1163,436,727,1186,428,758,981,462,486,1215,456,679
060790101032,424,199,225,440,200,240,556,273,273,515,230,241
060790102051,465,222,243,477,216,261,813,378,419,561,245,281
060790102053,707,317,390,723,312,411,1013,464,525,796,344,400
060790102052,356,155,201,365,155,210,514,236,264,381,160,197
060790102021,788,327,461,809,309,500,1018,485,515,857,352,455
060790102023,766,354,412,782,339,443,1033,487,517,883,400,421
060790127071,705,304,401,725,301,424,948,436,486,770,323,400
060790126021,926,402,524,944,396,548,1196,564,603,1010,426,507
060790127061,768,315,453,783,317,466,951,428,498,819,323,439
060790127073,592,235,357,607,240,367,757,347,396,621,243,337
060790131005,632,264,368,644,265,379,856,400,432,665,283,347
060790127072,1012,427,585,1045,429,616,1270,589,657,1109,455,572
060790131002,705,225,480,720,216,504,920,337,557,769,246,473
060790131004,385,170,215,390,166,224,532,242,265,430,187,214
060790104032,715,448,267,720,444,276,820,567,247,698,430,239
060790104041,776,472,304,798,473,325,933,624,289,765,457,265
060790130001,625,332,293,638,333,305,813,427,362,652,324,290
060790104031,856,563,293,868,565,303,950,662,280,874,541,283
060790104033,733,501,232,739,494,245,885,613,259,733,487,196
060790104042,402,276,126,409,274,135,500,335,154,433,284,115
060790105061,789,467,322,810,461,349,1042,614,397,749,409,282
060790105041,407,217,190,415,215,200,497,291,197,456,243,183
060790105042,580,329,251,594,331,263,756,436,294,621,337,247
060790105043,567,322,245,577,319,258,626,370,249,609,328,246
060790105062,441,258,183,449,255,194,530,324,195,423,231,169
060790105052,883,540,343,896,523,373,1129,679,426,964,544,357
060790105051,853,521,332,869,511,358,1087,686,380,922,515,352
060790106031,667,396,271,684,400,284,883,565,296,700,398,253
060790106021,739,463,276,758,458,300,979,637,326,802,477,281
060790106023,731,443,288,748,444,304,880,568,292,773,449,268
060790106022,810,495,315,829,488,341,1023,663,340,864,506,306
060790107012,1100,792,308,1121,775,346,1339,952,339,1136,748,292
060790107031,782,544,238,800,548,252,1072,767,271,830,533,226
060790107032,836,585,251,851,575,276,1023,725,272,890,587,235
060790107011,770,571,199,785,560,225,890,646,226,794,543,193
060790107013,643,451,192,657,456,201,825,594,208,688,449,185
060790107071,520,365,155,530,363,167,609,446,148,530,353,145
060790107072,857,619,238,878,619,259,1020,755,253,897,609,226
060790107073,647,475,172,666,476,190,835,603,215,697,478,171
060790107074,711,506,205,724,501,223,820,599,202,702,471,186
060790107075,818,567,251,833,569,264,978,690,267,895,588,244
060790130002,531,255,276,540,250,290,658,324,319,570,247,272
060790112011,1000,723,277,1043,732,311,1134,862,240,1264,859,285
060790112012,899,591,308,935,597,338,1137,808,303,988,619,280
060790112021,1262,932,330,1302,945,357,1542,1182,307,1238,845,268
060790113002,865,614,251,890,611,279,1123,792,295,977,638,231
060790113003,673,444,229,691,447,244,800,554,216,712,458,191
060790113004,405,298,107,419,296,123,529,381,128,439,290,93
060790109033,1336,1102,234,1382,1107,275,667,525,112,1624,1197,257
060790109032,25,18,7,26,18,8,9,5,4,0,0,0
060790109042,26,19,7,27,19,8,9,4,5,1,1,0
060790113005,560,379,181,577,377,200,789,546,214,653,418,176
060790113001,652,455,197,673,448,225,883,613,239,708,460,187
060790111031,723,509,214,743,508,235,1063,767,269,693,457,178
060790115011,890,595,295,911,586,325,1135,761,345,955,594,280
060790111032,793,543,250,810,541,269,1035,744,272,855,552,228
060790115052,1187,815,372,1218,809,409,1425,1035,354,1194,785,308
060790116002,803,426,377,817,419,398,998,564,408,844,433,349
060790110011,820,560,260,838,563,275,1085,795,257,879,584,221
060790111053,765,591,174,789,588,201,964,744,189,759,542,154
060790111041,845,663,182,868,661,207,1147,905,215,846,621,148
060790115051,880,565,315,907,553,354,1215,839,335,920,552,280
060790110012,808,564,244,825,555,270,945,699,227,856,582,212
060790110013,996,726,270,1016,734,282,1203,915,257,1135,797,256
060790110021,1007,741,266,1033,755,278,1265,947,295,1053,737,239
060790111012,610,471,139,634,469,165,860,661,170,651,466,114
060790111052,514,423,91,529,427,102,655,515,116,567,408,98
060790111051,573,467,106,584,459,125,693,547,119,647,478,96
060790110022,495,384,111,504,376,128,601,461,123,576,397,124
060790111013,495,387,108,508,387,121,602,471,105,553,398,98
060790116001,978,432,546,1012,443,569,1193,634,524,1045,490,492
060790123024,402,171,231,411,175,236,476,236,229,412,184,206
060790116003,964,552,412,974,551,423,1194,732,440,1010,577,364
060790117062,843,434,409,856,430,426,1135,629,478,928,454,407
060790117041,726,396,330,739,393,346,887,489,374,836,436,341
060790117042,702,400,302,718,399,319,853,471,364,706,391,275
060790117043,507,262,245,518,258,260,660,373,286,564,284,252
060790117061,1030,467,563,1053,471,582,1186,596,574,1025,458,513
060790117051,823,378,445,841,380,461,1058,522,508,845,389,409
060790121021,565,305,260,578,298,280,746,404,327,677,325,295
060790121022,888,482,406,906,474,432,1138,619,503,994,483,435
060790120021,753,444,309,771,443,328,1030,548,444,844,438,346
060790120022,325,185,140,330,181,149,453,245,200,368,183,158
060790119031,833,452,381,854,453,401,1026,564,437,884,438,380
060790120023,712,386,326,723,374,349,995,534,424,776,402,295
060790121023,465,263,202,473,259,214,697,388,295,530,279,195
060790121024,284,162,122,292,156,136,418,231,181,303,163,112
060790120011,977,520,457,993,502,491,1347,747,569,1062,548,424
060790122012,550,340,210,566,325,241,835,488,329,653,365,234
060790119043,683,335,348,705,324,381,956,534,398,745,331,345
060790118005,1602,767,835,1641,752,889,1938,1013,872,1672,770,764
060790123021,1205,556,649,1233,545,688,1516,741,733,1207,546,581
060790123022,523,221,302,533,219,314,658,302,341,552,232,283
060790118002,1112,557,555,1125,537,588,1317,724,564,1114,552,493
060790118003,501,244,257,511,246,265,600,334,249,506,243,231
060790118001,904,438,466,927,439,488,1100,607,459,918,432,417
060790118004,446,223,223,454,215,239,619,337,264,477,223,217
060790119011,840,351,489,860,343,517,985,490,464,877,363,443
060790119041,667,373,294,674,352,322,917,515,383,724,375,299
060790119012,822,448,374,842,445,397,1129,588,509,873,420,375
060790119042,861,440,421,887,435,452,1067,576,460,932,450,409
060790119044,616,314,302,629,292,337,870,472,371,695,324,309
060790123023,803,300,503,818,292,526,1044,420,596,835,297,483
060790123061,2176,975,1201,2209,962,1247,2940,1496,1404,2025,937,998
060790123053,913,385,528,929,378,551,1124,515,589,974,393,526
060790123054,664,268,396,675,257,418,838,361,463,681,267,377
060790123051,1089,442,647,1115,427,688,1317,587,711,1116,442,614
060790123052,559,224,335,571,216,355,622,274,339,510,191,287
060790123062,411,178,233,419,169,250,576,254,313,447,188,230
060790124061,363,175,188,367,166,201,577,292,267,455,200,219
060790124063,434,213,221,444,202,242,611,320,277,456,210,212
060790124062,264,133,131,269,125,144,389,200,175,295,135,135
060790124041,630,289,341,646,280,366,934,420,491,679,311,332
060790124044,349,164,185,358,159,199,517,234,272,403,189,193
060790124042,512,256,256,516,247,269,751,371,363,541,254,249
060790124031,876,380,496,891,370,521,1213,537,645,960,408,486
060790124051,721,363,358,730,354,376,1038,519,495,771,361,356
060790124052,442,204,238,444,196,248,655,290,353,526,233,247
060790124032,784,310,474,799,307,492,914,429,472,847,340,461
060790124043,785,261,524,803,258,545,972,439,512,873,302,519
060790122021,798,446,352,816,446,370,1067,612,434,925,485,381
060790122011,310,188,122,319,182,137,462,265,179,377,209,134
060790122022,484,293,191,489,277,212,751,434,301,569,321,208
060790127062,956,420,536,982,420,562,1195,543,611,1040,437,533
060790125051,1084,435,649,1101,418,683,1463,656,779,1154,438,636
060790126012,623,323,300,638,311,327,851,419,407,676,315,314
060790126011,1101,486,615,1130,470,660,1328,640,661,1149,479,597
060790127051,461,208,253,469,205,264,589,279,303,520,225,264
060790127063,777,387,390,785,379,406,914,438,461,773,377,343
060790126013,588,305,283,602,291,311,787,389,377,658,304,305
060790126014,713,327,386,726,323,403,945,470,434,783,322,403
060790125022,406,215,191,420,216,204,648,332,297,472,228,202
060790125023,848,439,409,863,438,425,1290,670,578,1030,470,468
060790125052,509,212,297,516,203,313,670,300,355,565,214,303
060790125053,791,396,395,806,392,414,1001,507,469,825,375,376
060790125021,630,336,294,642,330,312,838,433,380,670,320,280
060790125031,684,296,388,703,288,415,897,441,432,762,289,418
060790125033,500,258,242,512,248,264,701,345,338,582,262,276
060790125034,664,372,292,673,367,306,1015,562,417,698,343,291
060790131003,264,98,166,270,97,173,388,156,218,275,97,157
060790125032,454,262,192,464,261,203,650,376,250,534,273,208
060790127054,1113,467,646,1123,453,670,1382,574,767,1170,469,611
060790127052,359,147,212,365,147,218,448,155,284,394,154,215
060790127053,855,422,433,870,415,455,1084,601,445,930,438,412
060790131001,266,74,192,269,74,195,330,105,219,292,76,200
060790127081,436,157,279,444,157,287,553,190,357,558,198,328
060790115053,431,168,263,434,165,269,608,265,322,374,146,206
060790111011,500,384,116,515,379,136,683,527,138,551,391,96
060790109023,438,346,92,455,353,102,617,489,108,501,365,88
060790112022,539,408,131,565,417,148,694,547,132,548,384,114
060790109031,238,193,45,253,196,57,384,297,74,338,248,60
060790109022,409,317,92,430,319,111,557,445,95,545,379,101
060790109021,314,240,74,326,237,89,485,393,80,354,245,70
060790109041,10,5,5,10,5,5,10,5,5,10,5,5
060750255011,554,471,83,561,467,94,713,584,113,625,519,75
060750255022,729,611,118,736,610,126,998,807,171,842,705,98
060750255012,577,489,88,580,485,95,776,633,126,645,537,73
060750255013,338,284,54,344,284,60,443,355,82,384,317,48
060750255023,524,468,56,532,471,61,678,586,84,568,497,48
060750256004,568,486,82,585,489,96,853,669,167,686,562,82
060750255021,378,319,59,381,313,68,524,403,103,446,357,64
060750313011,357,302,55,372,306,66,520,430,82,392,325,51
060750313012,625,521,104,643,524,119,874,722,134,678,553,87
060750312014,427,354,73,439,353,86,599,470,110,513,411,74
060750313013,564,501,63,596,512,84,744,625,106,658,561,66
060750312011,671,565,106,697,575,122,974,784,170,801,668,89
060750312021,484,407,77,495,409,86,683,544,126,531,440,64
060750312012,490,416,74,524,433,91,896,717,160,590,488,63
060750312022,583,502,81,599,503,96,802,657,139,639,553,64
060750261002,698,556,142,734,580,154,1160,864,274,898,715,142
060750261004,405,333,72,425,346,79,561,434,122,468,376,71
060750261001,448,369,79,466,373,93,684,521,148,556,462,72
060750313022,445,363,82,459,370,89,720,537,154,662,540,77
060750313023,902,741,161,933,757,176,1285,1024,241,1073,875,140
060750313021,505,430,75,531,453,78,710,569,128,571,479,60
060750314022,304,262,42,319,269,50,469,364,92,398,330,46
060750314023,376,320,56,398,335,63,536,433,96,460,382,56
060750314021,607,502,105,630,529,101,906,728,165,721,607,80
060750314011,466,393,73,483,408,75,687,523,148,582,495,55
060750261003,364,280,84,391,297,94,534,402,128,427,330,76
060750262021,522,421,101,544,427,117,792,595,178,654,523,103
060750314012,214,178,36,224,186,38,354,266,77,279,232,29
060750262012,422,348,74,436,363,73,679,518,153,510,425,65
060750262013,315,253,62,326,263,63,490,371,112,397,322,60
060750262011,346,295,51,358,310,48,536,410,119,422,360,47
060750263033,354,274,80,365,281,84,526,384,130,380,304,58
060750262022,406,319,87,425,335,90,619,475,134,488,386,82
060750263032,346,266,80,357,271,86,538,391,135,399,319,63
060750263012,625,499,126,654,499,155,1016,770,225,756,592,134
060750263013,263,208,55,276,209,67,432,329,100,330,265,59
060750263031,585,467,118,611,485,126,901,708,180,700,564,113
060750263021,327,268,59,347,284,63,524,406,100,418,339,59
060750263022,397,319,78,412,336,76,557,437,108,463,378,62
060750263023,712,574,138,744,607,137,1090,839,235,911,732,145
060750256001,554,474,80,572,480,92,818,629,171,646,543,74
060750260021,425,358,67,435,359,76,640,514,115,522,425,65
060750260022,683,582,101,692,585,107,915,747,145,814,680,84
060750260011,390,322,68,395,324,71,543,417,111,472,391,61
060750260012,424,350,74,429,352,77,614,471,125,522,432,67
060750260013,381,314,67,388,319,69,600,465,116,449,368,59
060750260031,710,601,109,731,607,124,1048,819,199,884,717,114
060750260014,384,322,62,399,331,68,564,455,91,480,394,59
060750260041,634,538,96,662,555,107,983,772,180,803,658,99
060750260032,801,650,151,835,664,171,1160,890,242,982,789,137
060750260042,530,430,100,545,437,108,776,604,155,654,533,86
060750263011,338,277,61,348,281,67,465,356,99,410,337,52
060750177001,279,256,23,280,256,24,345,315,24,261,235,14
060750228011,638,588,50,644,591,53,780,710,56,679,606,33
060750228012,805,754,51,805,753,52,928,853,58,918,832,37
060750228021,351,322,29,355,322,33,392,358,28,374,331,23
060750228022,507,477,30,505,471,34,654,589,44,599,543,24
060750227041,758,703,55,769,709,60,998,917,60,862,781,43
060750607021,891,791,100,914,796,118,1232,1032,169,739,644,56
060750227042,579,534,45,585,533,52,672,613,41,662,595,36
060750227021,680,644,36,682,644,38,755,708,31,732,673,28
060750227022,639,592,47,643,592,51,713,670,37,673,616,32
060750229032,447,420,27,440,408,32,471,416,36,514,464,20
060750614012,379,345,34,377,341,36,410,362,34,429,379,23
060750227043,630,580,50,635,584,51,693,636,38,675,625,27
060750614013,584,546,38,584,545,39,720,668,40,668,612,24
060750614021,655,596,59,662,597,65,760,695,49,633,569,37
060750614011,486,443,43,488,446,42,532,480,40,576,515,27
060759809001,232,213,19,237,216,21,341,303,29,319,283,14
060750614022,383,349,34,386,350,36,648,594,43,463,414,26
060750226002,2031,1851,180,2089,1899,190,1123,1035,69,1992,1819,77
060750226001,1045,979,66,1053,981,72,1289,1211,60,796,736,23
060750230011,473,394,79,506,423,83,811,630,161,593,497,66
060750612002,251,214,37,266,233,33,399,326,62,336,289,27
060750612003,329,293,36,343,308,35,529,458,62,437,384,28
060750231021,621,556,65,641,585,56,926,799,106,696,636,42
060750231031,444,403,41,469,434,35,688,592,78,478,427,34
060750612001,434,390,44,440,396,44,604,512,76,557,503,36
060750230012,353,294,59,374,310,64,556,430,112,441,363,56
060750230033,499,435,64,512,445,67,719,596,99,595,516,44
060750230031,356,301,55,373,317,56,532,439,82,390,342,34
060750231022,402,359,43,407,372,35,599,515,66,508,464,24
060750232003,396,365,31,404,373,31,563,506,45,505,465,26
060750231032,660,588,72,695,631,64,1185,1029,123,815,745,39
060750230013,483,388,95,513,426,87,749,563,166,580,463,93
060750230032,361,291,70,381,310,71,572,435,120,440,359,60
060750232001,443,397,46,461,414,47,661,551,91,525,458,45
060750233002,712,559,153,762,604,158,1169,830,310,782,613,138
060750232002,499,451,48,530,472,58,717,618,81,643,566,44
060750234001,355,308,47,373,320,53,789,633,135,492,425,46
060750234002,486,409,77,512,437,75,568,468,86,559,494,44
060759806001,166,148,18,170,152,18,242,208,30,191,169,17
060750264041,299,234,65,314,250,64,568,408,146,378,316,47
060750264042,276,219,57,288,235,53,461,337,117,332,284,40
060750605023,280,219,61,287,226,61,441,323,113,384,320,51
060750605021,131,109,22,145,125,20,253,199,44,244,222,16
060759805011,38,29,9,40,31,9,61,47,14,54,46,7
060750605022,101,85,16,114,101,13,161,133,24,166,153,8
060750264011,469,359,110,500,392,108,812,578,213,590,488,81
060750264012,428,323,105,461,358,103,712,498,183,556,430,92
060750264021,271,214,57,276,219,57,457,350,94,364,296,46
060750264023,444,352,92,469,375,94,722,549,155,558,456,75
060750259002,802,663,139,828,679,149,1168,930,220,966,794,123
060750258002,203,167,36,209,173,36,324,247,70,281,234,32
060750264022,431,354,77,456,373,83,707,550,138,538,445,68
060750233001,333,296,37,350,305,45,517,412,90,380,333,30
060750610002,395,345,50,414,355,59,643,524,107,471,413,41
060750264032,391,304,87,432,338,94,727,538,179,551,429,96
060750264031,456,338,118,511,391,120,764,552,199,577,439,111
060750610001,494,398,96,523,416,107,770,566,178,634,499,109
060750610003,403,333,70,415,342,73,590,475,101,467,391,57
060750165004,555,533,22,552,530,22,662,630,21,640,596,13
060750102011,799,667,132,811,674,137,908,805,86,905,789,70
060750102021,516,405,111,528,418,110,630,526,89,599,489,79
060750102022,521,434,87,532,448,84,615,539,66,671,581,58
060750101011,287,238,49,302,254,48,338,269,61,354,289,47
060750103001,730,616,114,750,637,113,888,762,110,834,719,74
060750102012,615,533,82,625,538,87,676,609,56,728,636,59
060750109022,646,551,95,664,568,96,725,648,61,732,640,62
060750109011,637,547,90,648,553,95,729,647,69,712,626,49
060750103002,564,482,82,585,495,90,656,570,72,649,555,59
060750103003,623,523,100,643,540,103,763,661,87,737,624,72
060750152021,600,514,86,616,525,91,680,603,65,681,588,60
060750152022,632,556,76,655,581,74,716,651,55,689,610,38
060750151002,566,492,74,585,513,72,717,621,79,493,417,49
060750151003,421,361,60,434,377,57,490,420,61,506,429,52
060750152011,556,485,71,566,496,70,693,609,74,655,586,44
060750151001,436,371,65,448,389,59,508,430,68,469,395,48
060750101012,526,432,94,543,448,95,637,529,96,621,510,73
060750101021,682,571,111,710,596,114,896,731,143,795,656,94
060750104021,337,274,63,345,281,64,431,364,58,386,320,45
060750105001,469,385,84,484,397,87,609,492,99,452,363,59
060750107021,353,305,48,374,317,57,437,375,52,437,375,40
060750104011,276,236,40,282,239,43,315,276,34,339,288,33
060750104012,797,667,130,813,676,137,955,829,99,930,786,88
060750104022,356,309,47,364,313,51,448,398,41,419,354,33
060750104023,387,328,59,392,331,61,463,401,56,450,376,45
060750109021,566,475,91,587,494,93,646,561,74,711,615,69
060750109012,624,551,73,644,563,81,690,597,78,734,647,54
060750108001,612,504,108,638,530,108,744,635,93,704,583,81
060750108002,582,498,84,614,520,94,696,582,100,712,587,83
060750107022,228,194,34,241,204,37,301,248,46,295,250,28
060750107012,325,278,47,353,299,54,514,414,90,432,369,41
060750107011,289,235,54,325,266,59,514,391,115,422,347,56
060750106001,476,409,67,484,413,71,605,510,81,566,472,51
060750106003,440,378,62,452,384,68,610,517,81,546,455,47
060750106002,411,336,75,425,347,78,482,397,77,481,387,62
060750110021,266,227,39,274,235,39,321,287,29,305,259,29
060750110022,323,274,49,336,292,44,413,355,51,381,328,34
060750110023,384,327,57,398,341,57,454,403,42,456,383,42
060750113001,332,276,56,360,303,57,510,399,102,453,378,51
060750611021,96,78,18,110,90,20,184,138,42,153,127,19
060750110012,528,446,82,560,481,79,665,573,81,572,499,49
060750111011,508,447,61,523,453,70,618,532,72,637,540,46
060750110011,791,685,106,825,719,106,857,745,96,870,766,67
060750108003,722,628,94,754,657,97,901,760,121,896,761,84
060750113002,380,297,83,421,341,80,517,389,112,493,393,75
060750611022,203,154,49,224,171,53,351,253,93,293,227,51
060750117002,129,103,26,137,108,29,151,121,29,132,106,20
060750118001,303,239,64,336,277,59,464,355,102,431,350,59
060750611012,194,154,40,215,176,39,323,242,74,289,239,38
060750611011,136,106,30,152,126,26,246,183,59,208,176,25
060750105002,410,313,97,417,316,101,549,440,102,571,447,97
060750117004,265,229,36,270,232,38,329,268,54,285,238,33
060750105003,290,220,70,293,220,73,377,301,70,338,267,60
060750111021,522,462,60,533,468,65,573,506,57,640,551,44
060750111012,444,383,61,458,392,66,459,402,49,513,444,43
060750112003,272,232,40,278,237,41,299,259,33,312,267,28
060750111013,441,392,49,451,401,50,467,406,55,517,453,36
060750112001,614,502,112,628,512,116,723,596,114,745,613,86
060750112002,371,308,63,376,312,64,419,349,58,447,376,45
060750112004,336,273,63,343,278,65,397,326,63,418,344,51
060750119012,136,112,24,142,116,26,188,156,27,166,137,21
060750119021,227,188,39,235,193,42,258,212,41,273,228,33
060750111022,437,384,53,444,391,53,525,457,51,450,384,36
060750120011,473,414,59,485,426,59,592,524,51,575,491,44
060750120022,214,193,21,215,193,22,285,246,30,234,203,17
060750122022,383,334,49,391,339,52,457,372,75,514,439,47
060750119013,277,245,32,279,242,37,306,266,31,299,255,27
060750119011,642,566,76,646,563,83,714,611,81,701,597,62
060750120012,279,255,24,284,263,21,298,267,24,302,270,16
060750121002,492,442,50,497,449,48,582,504,59,574,502,40
060750121003,472,426,46,476,425,51,527,459,52,550,478,40
060750119022,649,584,65,654,584,70,707,635,53,690,607,41
060750121001,320,282,38,326,288,38,376,320,45,351,302,31
060750120021,466,426,40,466,420,46,530,468,50,574,501,38
060750123021,277,255,22,281,255,26,332,296,24,329,294,19
060750123023,148,134,14,151,136,15,185,163,18,172,151,12
060750123024,200,175,25,207,184,23,267,211,46,254,220,20
060750117003,71,63,8,72,64,8,102,86,16,94,82,10
060750119023,236,203,33,239,205,34,287,230,47,279,236,32
060750123013,76,62,14,82,71,11,92,76,15,90,76,10
060750125032,128,104,24,142,123,19,228,184,37,178,148,19
060750125031,188,153,35,209,183,26,303,246,49,271,226,28
060750117001,253,217,36,258,218,40,284,229,46,310,264,34
060750152012,280,241,39,289,248,41,327,287,35,312,273,24
060750155004,430,364,66,445,382,63,451,376,68,471,400,49
060750155001,536,481,55,549,500,49,625,542,63,711,640,41
060750155003,299,251,48,309,264,45,346,289,51,389,324,46
060750159004,365,322,43,374,331,43,474,405,59,415,360,36
060750159003,332,293,39,341,302,39,466,397,58,392,341,33
060750159002,312,272,40,325,287,38,438,368,57,360,309,33
060750161022,520,450,70,552,492,60,870,712,140,664,577,60
060750159001,539,468,71,560,485,75,664,555,97,590,497,67
060750161021,329,295,34,341,307,34,461,408,45,407,368,27
060750160002,602,532,70,610,538,72,653,553,92,725,630,65
060750160001,570,508,62,578,512,66,664,560,91,637,557,56
060750161011,604,485,119,611,495,116,830,590,228,692,537,130
060750161012,412,353,59,430,377,53,534,431,94,473,403,48
060750163001,329,306,23,334,314,20,459,409,39,412,382,14
060750162001,561,513,48,567,520,47,638,568,56,586,533,32
060750162003,560,521,39,562,524,38,670,604,52,625,574,26
060750165003,844,800,44,844,797,47,899,854,29,960,891,23
060750165002,660,626,34,664,628,36,769,730,29,747,691,17
060750165001,789,743,46,798,750,48,877,818,51,969,884,37
060750163003,642,619,23,634,610,24,737,698,24,779,717,12
060750164002,552,523,29,550,520,30,615,588,19,616,565,12
060750164001,923,852,71,934,858,76,1022,919,88,1071,958,61
060750163004,530,509,21,533,511,22,604,561,27,664,606,15
060750163002,577,533,44,581,537,44,622,557,53,671,611,29
060750162002,624,581,43,626,581,45,665,611,44,698,639,27
060759803001,43,40,3,44,41,3,36,34,2,37,34,1
060750164003,677,655,22,679,654,25,673,653,12,764,705,16
060750166021,1395,1323,72,1394,1326,68,1495,1395,57,1523,1364,51
060750166012,894,854,40,896,857,39,985,933,29,954,872,27
060750166011,973,931,42,976,933,43,1090,1027,36,1091,1009,24
060750167003,597,570,27,597,569,28,657,631,21,650,612,14
060750167004,907,864,43,908,865,43,969,925,25,1036,967,20
060750167001,1046,1007,39,1053,1008,45,1177,1129,29,1169,1093,16
060750168011,802,769,33,792,760,32,893,858,22,920,861,19
060750168012,665,638,27,674,646,28,715,681,30,804,750,23
060750168022,709,675,34,705,674,31,798,752,31,866,806,20
060750168013,656,629,27,666,637,29,800,747,42,716,667,21
060750168021,634,591,43,637,594,43,701,656,32,723,663,24
060750168023,639,614,25,651,615,36,734,691,32,640,598,16
060750171023,1039,982,57,1039,979,60,1130,1064,39,1064,978,30
060750171013,732,690,42,732,701,31,811,761,29,784,722,24
060750301011,794,736,58,807,748,59,926,840,57,914,819,40
060750171021,809,767,42,815,772,43,886,832,32,892,825,27
060750171011,802,757,45,817,775,42,876,828,29,891,839,24
060750301023,797,702,95,819,717,102,961,862,87,883,765,69
060750301024,516,474,42,523,481,42,603,564,34,591,530,33
060750171022,420,400,20,426,404,22,487,463,18,483,445,13
060750171012,687,634,53,689,638,51,776,723,34,772,717,30
060750301022,594,549,45,597,557,40,668,635,22,639,598,23
060750122021,340,295,45,348,307,41,389,307,69,380,324,32
060750122032,301,275,26,306,279,27,329,280,40,367,323,22
060750122031,259,236,23,263,239,24,291,248,36,295,260,17
060750122043,308,282,26,312,285,27,318,270,34,357,312,17
060750122042,290,266,24,294,269,25,313,268,33,323,283,15
060750123011,297,261,36,302,269,33,375,309,53,333,282,29
060750123022,280,246,34,284,254,30,323,266,46,314,264,28
060750123012,183,154,29,192,169,23,340,250,78,258,219,23
060750124031,266,229,37,276,241,35,368,285,70,315,271,27
060750124061,237,206,31,243,210,33,291,232,51,292,250,27
060750122041,310,272,38,315,281,34,356,289,55,356,302,24
060750124042,278,244,34,281,251,30,326,266,50,334,284,22
060750125022,194,144,50,207,165,42,261,166,83,242,198,33
060750125021,179,141,38,200,169,31,258,190,62,266,218,29
060750125023,207,163,44,232,196,36,278,205,67,257,212,28
060750125033,294,229,65,323,272,51,446,333,98,378,306,50
060750176022,202,172,30,207,182,25,243,201,37,277,235,25
060750124053,321,294,27,325,299,26,292,260,20,326,287,18
060750124062,322,258,64,345,283,62,412,326,79,402,321,61
060750124032,173,148,25,180,158,22,225,172,46,221,191,18
060750124051,257,216,41,266,233,33,289,226,52,359,306,31
060750124041,252,215,37,255,227,28,276,225,43,324,279,24
060750124043,182,156,26,185,164,21,220,179,34,250,215,18
060750125024,157,125,32,177,150,27,221,160,51,301,235,44
060750124052,655,601,54,671,615,56,798,719,57,462,406,25
060750125041,161,122,39,169,142,27,229,176,46,240,199,29
060750201011,550,500,50,560,502,58,714,625,64,672,593,46
060750202021,642,602,40,638,600,38,640,601,27,682,638,18
060750176034,448,403,45,451,407,44,560,484,58,422,367,33
060750176033,333,291,42,340,302,38,420,352,56,385,336,30
060750177002,671,616,55,677,622,55,848,752,81,796,705,47
060750176043,307,261,46,319,276,43,408,344,52,347,296,35
060750176041,0,0,0,0,0,0,0,0,0,0,0,0
060750176042,633,561,72,648,571,77,803,705,76,496,429,42
060750176032,366,321,45,377,333,44,385,310,64,372,321,31
060750176021,482,412,70,500,438,62,636,517,98,536,459,51
060750176023,172,145,27,176,154,22,266,219,40,219,186,20
060750178042,375,329,46,386,342,44,467,410,44,456,404,29
060750178011,369,281,88,422,340,82,558,419,130,456,377,62
060750615013,267,230,37,277,244,33,314,264,43,345,296,34
060750615012,169,144,25,176,154,22,227,192,34,245,210,23
060750615031,265,234,31,272,242,30,736,644,77,226,195,19
060750615033,304,267,37,309,276,33,380,334,43,372,320,33
060750615071,288,237,51,297,245,52,474,403,62,300,254,29
060750615011,282,233,49,291,242,49,321,265,52,306,260,29
060750615062,309,253,56,320,263,57,443,380,49,392,333,36
060750178031,403,370,33,408,373,35,453,396,45,444,393,26
060750178032,364,334,30,372,340,32,406,368,30,214,189,12
060750178041,648,580,68,668,603,65,825,736,69,686,609,32
060750178043,245,220,25,252,225,27,286,246,32,277,247,17
060750178012,433,379,54,449,395,54,531,449,67,508,447,35
060750178044,246,215,31,258,225,33,339,282,47,258,228,18
060750180004,299,274,25,305,278,27,478,431,34,322,285,19
060750180003,265,242,23,270,246,24,330,298,24,105,93,7
060750180002,381,342,39,389,343,46,360,331,25,590,530,32
060750178013,416,343,73,439,373,66,518,400,105,503,423,51
060750615022,413,348,65,426,363,63,492,417,66,481,412,43
060750607033,755,675,80,770,688,82,875,765,88,778,695,52
060750180001,495,437,58,501,436,65,539,488,40,426,379,25
060750615041,374,324,50,377,324,53,458,405,45,431,370,33
060750615042,287,245,42,290,245,45,427,373,45,257,220,20
060750615051,419,347,72,431,356,75,564,501,57,489,408,60
060750615061,648,536,112,667,550,117,811,689,110,570,474,70
060750607031,645,567,78,662,580,82,809,729,67,736,649,51
060750607011,411,341,70,425,355,70,518,448,63,505,429,46
060750607013,301,260,41,313,272,41,1013,904,93,195,170,15
060750615083,255,207,48,266,218,48,329,277,47,281,239,27
060750615021,476,395,81,484,406,78,580,502,65,562,479,55
060750615081,187,162,25,199,179,20,135,114,17,238,200,27
060750615082,307,266,41,326,294,32,432,364,52,450,382,50
060750607032,515,456,59,524,465,59,618,541,66,601,534,41
060750607012,253,230,23,261,238,23,1644,1487,138,409,371,19
060750179031,461,410,51,478,435,43,716,607,89,518,439,35
060750176031,328,282,46,340,299,41,426,348,65,433,375,34
060750615063,324,286,38,333,296,37,462,405,46,282,239,26
060750615032,306,275,31,306,277,29,396,346,28,398,343,30
060750301021,717,616,101,742,629,113,885,772,101,786,649,90
060750305003,372,311,61,384,318,66,477,404,66,440,367,51
060750305001,504,419,85,516,419,97,618,530,82,525,424,68
060750305002,470,377,93,481,389,92,595,495,91,523,425,68
060750307001,1582,1354,228,1621,1386,235,1887,1663,193,1739,1475,190
060750217001,745,619,126,758,632,126,912,791,107,798,674,92
060750307002,946,838,108,964,850,114,1118,1006,91,1006,891,70
060750311005,938,831,107,942,832,110,1182,1047,113,1072,939,80
060750311001,592,540,52,593,539,54,669,604,54,650,587,35
060750170003,745,706,39,754,718,36,781,751,20,792,742,25
060750170002,549,508,41,549,506,43,612,573,28,617,572,26
060750170004,638,598,40,642,606,36,749,711,27,709,666,21
060750170001,676,634,42,677,638,39,708,675,27,771,720,28
060750167002,429,408,21,429,403,26,490,464,18,466,428,12
060750169001,796,758,38,808,775,33,882,836,31,871,815,14
060750169003,769,737,32,771,739,32,808,769,26,832,777,13
060750169002,501,481,20,504,485,19,561,535,18,493,468,8
060750203003,832,806,26,842,804,38,882,844,25,884,827,21
060750203001,865,833,32,870,825,45,966,905,45,968,903,27
060750202023,563,528,35,573,531,42,678,600,62,626,563,35
060750202022,726,682,44,736,689,47,859,779,61,801,725,33
060750202011,604,557,47,608,564,44,730,658,54,715,640,34
060750204011,817,767,50,822,777,45,933,885,36,890,823,28
060750204012,357,331,26,362,337,25,423,393,26,402,369,18
060750204013,858,808,50,862,816,46,939,897,27,945,879,27
060750205001,565,531,34,574,541,33,576,545,25,607,559,29
060750203002,412,394,18,413,392,21,436,419,13,442,416,12
060750202012,546,509,37,545,510,35,595,543,40,642,576,32
060750204023,708,650,58,718,663,55,753,694,41,747,682,33
060750205002,608,572,36,610,577,33,655,619,24,663,617,24
060750206022,628,592,36,631,597,34,686,653,25,681,636,18
060750206012,1029,976,53,1035,984,51,1150,1095,38,1114,1047,33
060750206011,768,728,40,772,735,37,834,792,28,835,783,23
060750207021,648,613,35,648,610,38,744,689,39,764,697,28
060750207022,725,694,31,727,695,32,800,753,32,787,725,23
060750204024,440,405,35,450,415,35,526,484,37,492,444,28
060750212003,525,485,40,527,490,37,604,572,26,580,539,22
060750205003,642,607,35,640,609,31,695,662,24,656,616,18
060750206021,800,754,46,808,761,47,889,837,39,880,816,28
060750207012,642,613,29,645,619,26,702,666,23,728,680,21
060750207013,553,525,28,553,529,24,614,583,20,631,588,19
060750204021,720,655,65,730,667,63,867,793,61,777,694,54
060750204022,630,573,57,638,583,55,715,654,50,670,598,47
060750213002,794,736,58,804,745,59,926,859,47,879,811,33
060750212002,689,630,59,698,638,60,810,747,50,755,694,37
060750212001,564,526,38,570,531,39,602,567,27,625,573,25
060750211001,747,703,44,752,707,45,830,784,35,821,770,26
060750211004,522,487,35,528,490,38,586,552,26,586,544,21
060750207011,531,503,28,533,501,32,586,546,27,587,542,20
060750210001,548,515,33,547,511,36,616,571,34,655,598,28
060750210002,536,505,31,532,498,34,593,552,31,635,580,27
060750210003,802,759,43,795,754,41,883,818,47,875,795,35
060750213001,639,586,53,652,597,55,746,686,42,716,649,35
060750211003,600,561,39,603,560,43,634,597,28,634,591,21
060750214003,756,704,52,769,711,58,841,792,36,849,782,32
060750211002,531,500,31,533,500,33,581,547,25,620,571,22
060750214001,461,434,27,463,432,31,508,478,22,485,447,17
060750216002,775,677,98,792,681,111,904,798,95,845,737,85
060750216003,467,425,42,477,432,45,573,518,45,550,504,30
060750216001,1109,1027,82,1127,1041,86,1270,1183,73,1254,1145,66
060750214002,865,813,52,876,822,54,956,908,37,970,899,36
060750215001,476,447,29,477,447,30,537,507,22,524,485,19
060750210004,417,393,24,414,392,22,478,447,27,466,424,18
060750217003,957,867,90,966,876,90,1173,1073,84,1072,962,62
060750215003,526,486,40,524,486,38,560,517,35,555,502,29
060750215004,616,566,50,618,570,48,700,643,36,664,605,29
060750215005,592,545,47,594,544,50,662,622,34,640,584,32
060750253004,900,855,45,899,841,58,1008,931,58,1010,923,35
060750215002,676,631,45,676,628,48,781,730,35,733,670,27
060750218001,696,649,47,696,647,49,806,746,48,771,708,38
060750217002,634,574,60,648,586,62,764,693,57,674,605,43
060750218002,670,630,40,667,624,43,776,721,42,703,655,24
060750218003,444,420,24,445,418,27,502,471,26,474,438,19
060750218004,588,555,33,602,563,39,665,629,29,654,597,32
060750253003,438,415,23,438,410,28,456,417,29,474,424,20
060750254011,577,536,41,578,540,38,687,623,53,660,592,28
060750254013,484,450,34,483,448,35,601,542,45,558,499,30
060750254031,845,755,90,860,757,103,1095,934,139,981,846,88
060750201012,684,642,42,683,634,49,839,749,72,821,749,27
060750201021,463,430,33,467,434,33,514,450,54,548,487,29
060750201022,298,276,22,301,280,21,338,297,32,409,363,21
060750201023,218,202,16,221,205,16,263,227,31,267,237,15
060750208021,449,414,35,449,415,34,533,476,46,524,457,29
060750208022,549,521,28,545,522,23,621,574,36,631,593,13
060750208011,453,429,24,453,428,25,513,477,26,538,497,17
060750228013,662,631,31,656,623,33,780,731,36,800,734,16
060750208012,524,481,43,538,483,55,656,559,84,707,617,55
060750208013,421,396,25,424,391,33,502,452,39,514,461,24
060750209001,682,648,34,680,637,43,768,693,62,790,704,36
060750209004,526,494,32,515,482,33,527,477,40,568,515,19
060750228031,812,759,53,798,746,52,918,839,53,953,864,35
060750228032,565,540,25,561,526,35,643,594,37,634,577,20
060750228033,513,490,23,508,475,33,585,540,35,577,527,19
060750229031,564,525,39,558,514,44,659,594,52,654,578,30
060750209003,341,321,20,336,313,23,361,326,29,379,344,12
060750229011,709,673,36,692,650,42,831,741,65,809,717,33
060750229021,492,474,18,482,458,24,585,531,38,554,499,17
060750209002,376,358,18,371,347,24,412,364,36,436,390,18
060750229013,294,274,20,288,265,23,341,303,31,334,291,18
060750229012,586,547,39,576,527,49,723,633,62,693,607,35
060750229022,508,481,27,508,474,34,583,521,45,540,485,21
060750229033,363,338,25,358,331,27,416,373,34,380,336,18
060750252001,608,575,33,595,560,35,702,648,41,676,607,25
060750252002,829,788,41,820,776,44,968,894,54,932,841,34
060750251001,844,797,47,837,790,47,958,904,40,932,850,34
060750251003,442,410,32,443,413,30,511,473,33,503,456,25
060750252004,695,660,35,686,646,40,785,742,34,729,674,21
060750253001,647,616,31,648,610,38,696,656,28,662,609,19
060750251002,513,489,24,514,485,29,615,574,32,582,534,21
060750252003,734,697,37,733,693,40,893,828,45,816,748,30
060750253002,481,456,25,474,444,30,514,485,21,507,465,16
060750254022,404,377,27,408,379,29,521,477,37,483,440,24
060750254023,483,444,39,490,451,39,581,522,48,559,504,35
060750254012,504,481,23,501,477,24,595,552,33,532,490,16
060750254021,516,491,25,521,488,33,648,596,43,633,575,25
060750254032,846,775,71,855,784,71,1113,984,105,931,823,61
060750256002,325,248,77,343,253,90,507,372,128,399,313,71
060750257011,388,324,64,411,329,82,586,452,124,464,383,65
060750257012,536,445,91,572,494,78,850,646,174,689,560,90
060750256003,361,307,54,373,307,66,521,414,99,430,341,62
060750259001,741,583,158,769,598,171,1030,810,195,869,699,127
060750257013,385,295,90,401,305,96,607,455,142,462,358,81
060750257023,447,349,98,470,363,107,644,485,144,525,411,85
060750257022,415,340,75,427,333,94,627,481,127,522,405,90
060750258001,281,226,55,293,234,59,470,360,105,372,301,52
060750257021,316,234,82,329,255,74,497,354,127,384,294,71
060750479023,538,449,89,559,461,98,677,563,100,565,455,76
060750479021,579,478,101,604,494,110,775,635,122,653,525,91
060750479022,527,428,99,548,442,106,699,566,118,595,481,85
060759802001,41,34,7,43,34,9,53,43,9,47,38,6
060750427003,751,614,137,778,633,145,996,800,177,861,679,125
060750478021,481,385,96,490,389,101,661,528,122,547,447,78
060750427002,701,582,119,722,594,128,962,766,175,838,669,113
060750427001,707,584,123,730,598,132,957,780,155,810,657,102
060750426012,1029,885,144,1057,899,158,1286,1092,164,1192,996,131
060750426022,539,465,74,553,471,82,679,574,92,591,505,59
060750426011,613,518,95,629,524,105,838,681,140,708,578,94
060750426023,545,477,68,565,493,72,694,597,84,635,536,66
060750426021,439,381,58,456,397,59,633,536,85,499,420,54
060750477012,627,531,96,650,544,106,857,703,137,763,623,84
060750402002,404,353,51,412,354,58,469,396,66,453,381,47
060750402003,528,462,66,547,473,74,691,586,89,595,507,58
060750402004,746,652,94,776,672,104,940,814,109,834,719,69
060750401004,448,398,50,458,413,45,517,469,43,497,434,35
060750402001,826,724,102,850,742,108,1005,870,113,885,763,73
060750401002,519,449,70,526,460,66,644,554,75,597,507,55
060750401003,647,566,81,659,581,78,777,672,89,728,619,67
060750451003,579,516,63,581,516,65,729,623,84,660,583,54
060750479033,482,402,80,497,407,90,667,537,114,549,443,77
060750478023,592,486,106,617,504,113,809,647,140,672,543,92
060750479031,445,363,82,455,372,83,616,495,105,492,394,66
060750479032,638,529,109,661,538,123,867,708,142,744,597,102
060750478012,459,377,82,472,387,85,671,534,121,569,455,79
060750478013,730,580,150,761,603,158,1001,788,193,833,652,133
060750477011,630,503,127,657,522,135,795,625,151,736,594,106
060750477013,532,440,92,549,448,101,740,592,131,602,485,81
060750476001,600,510,90,623,525,98,747,629,105,677,562,72
060750476002,605,502,103,633,522,111,795,662,115,673,561,75
060750476003,522,428,94,541,441,100,635,523,102,571,469,71
060750452011,499,428,71,507,425,82,648,552,82,564,470,64
060750452012,566,483,83,575,483,92,726,612,98,635,526,78
060750452013,578,488,90,589,491,98,656,538,104,630,516,92
060750452021,761,648,113,770,653,117,925,789,115,865,726,98
060750451001,959,856,103,975,861,114,1206,1034,143,1084,942,89
060750156003,504,447,57,512,450,62,613,523,78,557,478,51
060750156001,355,312,43,365,316,49,470,412,51,390,323,43
060750157011,974,853,121,995,863,132,1217,1048,150,1121,939,118
060750479041,666,535,131,689,542,147,919,691,200,755,586,130
060750479042,554,457,97,566,471,95,710,583,115,609,500,78
060750478011,546,427,119,566,442,124,760,613,131,629,474,114
060750478022,498,410,88,511,425,86,683,558,110,558,451,81
060750477021,487,416,71,503,426,77,625,512,105,553,451,74
060750477023,589,501,88,603,510,93,777,639,125,691,566,91
060750477022,582,483,99,594,488,106,742,613,115,631,509,91
060750476004,735,615,120,749,623,126,905,768,123,805,657,108
060750452022,786,698,88,798,701,97,927,816,103,894,761,82
060750451002,667,592,75,678,598,80,844,733,98,737,631,57
060750156002,644,577,67,655,583,72,758,682,60,713,616,57
060750157012,582,527,55,595,531,64,430,380,41,686,596,58
060750326011,857,736,121,878,743,135,1069,893,152,991,825,99
060750601001,582,519,63,582,517,65,730,659,62,632,542,37
060750601002,742,640,102,754,669,85,964,869,70,886,776,59
060750428002,375,290,85,390,302,88,457,374,76,395,315,61
060750126021,802,569,233,842,621,221,1005,811,175,883,683,153
060750127001,791,567,224,826,594,232,971,793,159,890,668,163
060750129011,860,722,138,889,746,143,799,696,88,792,664,80
060750129012,597,501,96,616,517,99,857,740,98,822,685,82
060750129022,567,471,96,590,491,99,691,586,90,667,562,62
060750127002,638,472,166,663,483,180,822,667,137,696,533,122
060750127003,393,316,77,407,325,82,505,426,70,449,361,59
060750126012,660,509,151,692,544,148,792,664,110,791,639,105
060750126011,543,415,128,571,442,129,645,535,97,627,499,90
060750128021,398,317,81,417,335,82,517,436,71,452,366,57
060750126022,540,409,131,564,434,130,784,643,124,579,478,75
060750128013,385,304,81,402,318,84,486,412,68,487,390,64
060750129023,458,367,91,486,390,96,569,479,83,611,508,69
060750128012,547,412,135,571,444,127,672,550,106,598,477,87
060750128011,480,358,122,494,373,121,567,473,83,539,433,72
060750128022,487,392,95,507,411,96,627,539,77,612,500,75
060750130021,516,397,119,541,426,115,634,522,98,624,501,87
060750130022,483,376,107,510,403,107,634,534,85,595,489,76
060750129021,718,569,149,743,609,134,865,729,118,794,665,88
060750130012,575,448,127,600,475,125,656,546,96,674,550,86
060750132002,767,601,166,791,634,157,922,797,112,881,738,104
060750132001,391,302,89,411,324,87,484,413,64,451,369,61
060750132004,458,358,100,476,377,99,580,489,81,539,439,74
060750132003,635,498,137,671,536,135,739,629,96,756,621,92
060750131022,720,577,143,750,604,146,819,701,107,863,713,102
060750130011,671,540,131,692,559,133,723,618,94,822,695,77
060750131013,405,326,79,424,342,82,463,394,59,460,380,50
060750428001,622,482,140,643,499,144,751,615,122,690,541,113
060750428003,436,351,85,452,373,79,533,466,58,539,447,55
060750401001,516,439,77,533,457,76,608,537,63,598,501,67
060750133005,393,323,70,405,337,68,475,420,48,448,378,48
060750133003,474,377,97,491,397,94,581,494,75,529,440,62
060750133004,430,335,95,450,361,89,551,488,56,498,428,48
060750133001,396,309,87,407,319,88,471,410,53,440,368,47
060750133002,614,481,133,630,496,134,684,590,77,687,571,74
060750134021,1227,1043,184,1273,1104,169,1382,1240,115,1393,1220,113
060750134011,390,332,58,407,356,51,447,403,37,423,371,32
060750131021,828,698,130,846,713,133,904,794,94,957,825,92
060750131014,524,441,83,540,459,81,605,523,69,590,505,45
060750131011,593,493,100,613,510,103,694,624,58,670,576,51
060750131012,660,570,90,673,581,92,703,630,59,762,665,63
060750134012,455,413,42,474,425,49,546,500,38,523,463,39
060750135001,706,605,101,728,620,108,849,763,71,790,694,52
060750135003,324,285,39,341,300,41,418,372,34,335,292,22
060750135002,417,354,63,426,362,64,477,424,48,474,412,39
060750154022,608,519,89,631,538,93,732,655,60,653,564,50
060750154012,607,517,90,626,535,91,674,604,55,676,583,52
060750154021,754,619,135,778,643,135,886,750,120,875,727,103
060750154011,1161,1013,148,1196,1040,156,1401,1232,147,1334,1149,109
060750153001,561,500,61,571,505,66,627,573,38,617,547,30
060750153002,639,576,63,653,584,69,794,738,40,694,620,35
060750155002,299,279,20,305,283,22,364,337,18,380,339,19
060750158012,802,740,62,818,762,56,977,892,76,957,864,41
060750157021,838,752,86,851,760,91,972,877,84,914,811,70
060750352012,483,403,80,506,422,84,512,409,90,527,417,71
060750352021,693,617,76,712,627,85,973,843,109,749,618,80
060750352022,626,557,69,643,567,76,846,720,107,733,609,75
060750351011,497,413,84,516,426,90,657,526,123,574,473,73
060750351012,526,441,85,547,455,92,691,556,122,624,501,88
060750327001,355,287,68,373,295,78,496,402,88,437,358,58
060750327002,485,390,95,508,402,106,692,547,124,604,493,80
060750327007,343,281,62,367,290,77,472,389,70,398,333,46
060750326012,616,528,88,630,535,95,750,626,112,724,604,74
060750326021,733,586,147,763,597,166,1026,798,204,856,679,129
060750326013,649,534,115,668,545,123,817,662,141,703,570,89
060750302011,852,754,98,860,764,96,1091,941,126,1000,857,84
060750302012,544,486,58,550,491,59,668,580,77,610,526,48
060750352014,511,440,71,527,445,82,704,585,104,611,493,71
060750352023,506,445,61,514,445,69,714,598,97,613,509,61
060750351013,476,393,83,497,404,93,656,523,121,528,414,85
060750327003,489,403,86,506,408,98,622,497,109,550,460,62
060750327006,352,264,88,368,280,88,469,357,105,392,300,70
060750352013,481,415,66,507,429,78,655,540,98,534,436,63
060750352015,388,322,66,412,339,73,536,431,96,426,342,57
060750351021,327,253,74,347,260,87,473,351,108,371,275,73
060750351022,365,283,82,388,291,97,504,378,117,410,307,81
060750351023,356,274,82,380,284,96,494,369,115,404,302,81
060750327004,377,273,104,400,296,104,518,383,122,400,294,80
060750327005,303,218,85,324,236,88,471,347,113,356,274,69
060750326022,515,394,121,543,410,133,697,535,148,583,441,101
060750326023,485,371,114,510,385,125,654,509,140,587,448,101
060750303011,638,530,108,663,547,116,805,684,111,697,563,102
060750352011,436,354,82,459,377,82,594,467,108,498,389,72
060750354001,529,433,96,565,464,101,719,589,118,599,474,88
060750351024,544,423,121,588,453,135,811,605,191,657,515,109
060750353001,396,300,96,414,316,98,594,451,131,443,340,81
060750353006,505,399,106,536,424,112,727,566,148,595,472,100
060750354002,589,471,118,630,505,125,863,684,162,679,539,108
060750329021,441,332,109,481,354,127,665,506,147,519,404,97
060750329022,468,368,100,505,388,117,647,510,130,547,419,99
060750328023,483,373,110,511,392,119,715,539,160,548,421,99
060750328021,513,402,111,540,415,125,712,546,144,582,444,105
060750328022,552,436,116,572,441,131,729,550,161,617,473,107
060750329011,449,346,103,462,350,112,636,483,141,531,406,99
060750329012,498,384,114,517,390,127,740,558,166,581,448,105
060750329023,489,383,106,514,398,116,683,529,145,553,423,102
060750328011,520,406,114,548,423,125,784,601,164,639,497,112
060750353002,540,405,135,571,424,147,818,617,180,622,470,115
060750329013,484,366,118,505,380,125,714,517,181,569,437,106
060750329014,498,377,121,518,391,127,733,535,184,570,433,106
060750328012,548,435,113,571,451,120,730,570,142,628,494,103
060750328013,442,339,103,462,358,104,665,504,152,516,405,89
060750354003,467,371,96,486,391,95,623,483,126,537,425,84
060750354004,708,568,140,733,593,140,994,769,197,812,639,125
060750354005,457,373,84,475,387,88,617,498,107,535,435,71
060750353005,477,381,96,494,391,103,653,517,124,548,427,82
060750353003,369,280,89,389,294,95,560,430,121,443,339,75
060750330012,561,439,122,585,457,128,747,571,158,623,482,103
060750330013,561,440,121,589,459,130,770,589,162,618,484,103
060750330021,538,427,111,561,451,110,774,606,148,625,510,89
060750330022,485,381,104,506,397,109,615,484,123,556,451,85
060750353004,377,294,83,396,311,85,557,430,112,407,317,62
060750330011,510,366,144,542,392,150,727,535,179,618,464,137
060750308004,934,734,200,960,740,220,1038,837,189,1025,801,175
060750330023,731,538,193,751,562,189,928,730,177,807,620,139
060750158011,215,196,19,221,206,15,292,260,27,246,224,11
060750158013,691,649,42,701,654,47,828,756,55,840,772,28
060750157022,902,847,55,898,836,62,985,932,38,1007,914,40
060750158021,862,832,30,866,831,35,940,887,28,932,857,22
060750158022,923,854,69,921,850,71,1029,952,60,1036,944,41
060750301012,692,649,43,701,653,48,790,733,40,781,707,24
060750302021,839,768,71,847,768,79,952,848,86,926,826,58
060750302022,796,729,67,804,729,75,934,832,85,883,787,58
060750302023,745,676,69,755,682,73,879,798,64,804,714,52
060750301013,498,463,35,510,474,36,534,494,34,550,501,22
060750301014,541,504,37,553,511,42,635,589,39,625,566,24
060750302013,620,530,90,622,536,86,742,668,63,684,584,66
060750303021,620,502,118,649,514,135,819,676,127,659,517,109
060750303012,994,891,103,1014,903,111,1218,1093,108,1132,982,96
060750303014,587,486,101,610,497,113,740,633,100,647,539,78
060750303013,851,733,118,866,738,128,1030,898,112,953,808,99
060750303023,592,487,105,611,488,123,775,633,129,650,522,91
060750303022,616,494,122,631,510,121,738,623,103,668,542,85
060750304001,643,502,141,668,528,140,791,659,124,710,579,106
060750304002,616,476,140,632,495,137,737,604,124,680,538,109
060750304003,649,506,143,678,523,155,863,684,156,751,588,123
060750304004,356,281,75,375,287,88,449,355,87,404,316,67
060750304005,396,321,75,403,320,83,503,405,85,452,355,68
060750308005,847,679,168,863,675,188,1094,874,200,918,723,137
060750308001,553,432,121,569,444,125,770,624,135,593,467,85
060750306002,437,355,82,442,356,86,536,447,81,667,538,98
060750306003,450,350,100,466,363,103,538,444,86,451,363,62
060750306001,426,329,97,442,348,94,534,435,94,457,378,64
060750308003,383,283,100,393,289,104,507,391,105,393,298,75
060750331003,347,241,106,359,245,114,488,372,107,377,263,96
060750331002,473,334,139,503,343,160,680,493,175,541,398,116
060750331004,648,429,219,680,455,225,878,636,231,719,524,163
060750331001,292,220,72,308,225,83,382,276,101,327,246,66
060750332011,774,694,80,788,691,97,469,358,100,1258,1066,131
060750309006,320,219,101,336,231,105,395,288,99,370,260,99
060750309005,417,301,116,428,311,117,535,415,114,442,321,103
060750309002,696,524,172,720,537,183,894,694,187,800,582,175
060750309001,536,395,141,547,412,135,683,544,123,648,494,126
060750308002,445,332,113,461,338,123,562,448,105,478,375,85
060750310001,434,360,74,443,365,78,542,460,81,491,397,66
060750307003,1337,1101,236,1358,1111,247,1629,1381,227,1434,1186,186
060750310002,790,645,145,803,651,152,825,680,129,919,735,137
060750604001,359,289,70,370,293,77,467,361,97,421,313,79
060750332043,453,393,60,453,386,67,469,384,78,567,463,65
060750332032,508,436,72,510,432,78,563,455,103,612,496,77
060750332041,335,289,46,340,293,47,377,298,70,397,308,56
060750309007,451,330,121,469,348,121,625,464,149,506,389,102
060750332031,666,579,87,676,587,89,824,656,148,804,640,100
060750332042,445,371,74,449,360,89,499,390,100,535,416,87
060750309003,626,507,119,641,517,124,855,677,164,721,574,123
060750309004,449,342,107,456,343,113,568,443,117,522,396,107
060750312013,322,273,49,333,278,55,418,330,75,365,298,50
060750310003,667,542,125,684,544,140,922,739,165,783,613,119
060750311004,583,494,89,590,496,94,778,656,104,713,600,83
060750311003,332,291,41,339,292,47,448,384,55,387,331,41
060750311002,665,583,82,676,585,91,850,728,107,862,719,90
061150403021,271,123,148,275,118,157,459,204,241,344,148,162
061150403041,635,279,356,640,272,368,1041,467,537,823,359,400
061150403043,364,161,203,365,154,211,575,261,305,417,190,196
061150404002,230,104,126,231,102,129,399,177,208,302,131,150
061150404003,330,134,196,331,123,208,545,209,317,457,171,259
061150403011,371,148,223,378,148,230,584,231,332,505,182,291
061150403012,293,131,162,300,128,172,452,199,233,348,145,164
061150403042,240,107,133,240,103,137,383,167,199,345,153,159
061150403051,553,241,312,558,234,324,1061,470,553,441,182,224
061150402022,405,156,249,407,149,258,633,237,366,506,179,292
061150402023,255,97,158,258,92,166,405,151,240,295,98,174
061150402012,226,89,137,227,83,144,404,155,237,271,100,156
061150402013,314,140,174,316,134,182,468,199,263,361,147,189
061150402024,151,56,95,155,56,99,200,77,118,187,66,104
061150402021,198,76,122,197,72,125,303,114,174,238,81,130
061150401001,222,83,139,228,81,147,302,110,180,263,87,161
061150401002,177,73,104,179,67,112,293,114,170,210,80,116
061150402011,436,167,269,436,153,283,743,270,450,531,180,310
061150401003,204,99,105,206,97,109,313,146,158,248,110,119
061150401004,165,78,87,167,78,89,239,112,127,210,89,105
061150401005,177,90,87,181,86,95,300,135,153,225,92,115
061150404001,241,106,135,243,94,149,423,181,226,365,164,176
061150409011,552,156,396,570,154,416,749,199,540,685,162,469
061150405001,224,98,126,224,94,130,366,141,216,286,112,155
061150405002,252,115,137,257,109,148,423,178,230,321,128,171
061150405003,172,75,97,174,73,101,283,112,169,220,96,111
061150406002,203,89,114,204,85,119,334,129,194,273,121,136
061150409012,306,100,206,307,102,205,483,153,321,371,109,233
061150406003,301,126,175,305,118,187,483,203,265,384,147,214
061150406004,190,80,110,192,74,118,277,115,149,238,90,131
061150406005,152,63,89,155,59,96,258,110,142,185,76,94
061150407022,502,213,289,507,200,307,895,368,492,679,261,359
061150407023,200,64,136,200,60,140,279,104,169,241,89,132
061150406001,321,148,173,325,138,187,529,231,277,373,151,196
061150407011,513,220,293,514,207,307,935,407,497,600,232,320
061150407014,647,263,384,655,252,403,1192,496,650,637,225,359
061150407013,466,185,281,471,178,293,804,334,442,542,182,315
061150407021,622,226,396,636,227,409,1095,438,623,661,241,377
061150407012,560,197,363,571,197,374,965,373,566,653,206,399
061150408001,602,178,424,606,176,430,1072,304,734,859,227,571
061150408002,161,47,114,162,46,116,273,79,191,229,65,153
061150408003,361,103,258,366,102,264,644,182,441,520,141,347
061150409021,2,1,1,2,1,1,9,5,4,8,3,4
061150409023,20,9,11,20,9,11,73,38,30,40,15,19
061150409024,6,3,3,6,3,3,19,10,7,16,6,6
061150410021,546,212,334,550,205,345,770,286,471,643,257,350
061150411011,519,271,248,527,266,261,617,290,306,559,223,276
061150411021,584,298,286,593,298,295,801,393,385,665,296,314
061150411013,412,177,235,418,174,244,545,223,309,468,149,279
061150411012,314,107,207,319,100,219,400,125,262,373,104,238
061150410012,512,103,409,520,99,421,643,136,495,579,114,436
061150410011,238,51,187,240,46,194,320,70,247,272,58,201
061150410023,622,163,459,632,153,479,808,207,589,668,174,454
061150410022,721,168,553,733,153,580,955,212,727,816,172,591
061150410013,711,134,577,722,123,599,913,168,728,757,131,592
061150409022,7,2,5,7,1,6,50,25,21,36,13,16
060050004012,337,161,176,348,161,187,462,200,249,393,161,207
060050005001,537,184,353,546,182,364,662,225,414,562,182,343
060050005002,543,209,334,551,202,349,729,271,439,555,194,330
060050005003,474,199,275,487,191,296,606,238,351,500,189,282
060050003041,812,313,499,828,310,518,1057,387,636,857,297,503
060050004014,516,222,294,529,216,313,610,247,345,543,207,306
060050004023,421,167,254,426,162,264,534,202,319,433,155,246
060050004021,840,324,516,855,303,552,1022,376,622,765,272,446
060050004024,549,199,350,564,191,373,696,254,419,607,190,373
060050003031,864,321,543,876,299,577,1182,428,724,887,295,539
060050003012,732,211,521,745,203,542,1052,300,724,713,199,466
060050003032,659,209,450,671,191,480,848,246,584,701,197,471
060050003033,910,281,629,922,268,654,1243,372,832,965,302,598
060050002011,463,167,296,470,163,307,684,255,409,534,174,326
060050003011,316,102,214,322,98,224,403,137,254,341,101,215
060050003042,853,241,612,867,233,634,1268,336,899,977,256,658
060050002012,878,374,504,902,360,542,1087,463,589,926,352,518
060050001015,357,148,209,363,143,220,409,172,229,355,145,191
060050001014,456,177,279,464,175,289,534,201,323,467,160,279
060050004022,370,138,232,379,133,246,489,179,298,394,123,246
060050001022,452,164,288,463,166,297,652,234,404,328,109,195
060050001012,604,220,384,609,220,389,775,298,459,309,113,173
060050001013,355,125,230,361,127,234,426,158,263,344,114,210
060050001011,511,188,323,517,188,329,613,246,358,444,164,258
060050001021,469,197,272,475,199,276,584,255,320,525,201,302
060050004013,839,346,493,851,332,519,1011,429,560,867,325,493
060050004011,728,259,469,737,247,490,905,325,562,784,252,495
060050002013,414,168,246,424,162,262,522,208,302,451,168,253
060050002022,463,196,267,473,186,287,557,233,311,480,190,254
060050002021,557,241,316,568,226,342,680,278,387,568,217,309
060070025001,191,87,104,193,85,108,276,116,150,204,83,105
060070025002,273,125,148,277,118,159,450,188,248,318,126,169
060070025003,111,51,60,111,49,62,180,75,97,135,56,69
060070025004,401,139,262,411,134,277,535,191,330,424,146,246
060070028002,169,77,92,171,73,98,284,126,144,223,94,114
060070028003,298,142,156,298,136,162,371,174,184,307,131,155
060070028004,133,65,68,135,65,70,187,89,94,162,68,79
060070028005,192,94,98,195,90,105,252,118,123,230,93,114
060070030021,117,55,62,120,55,65,217,88,121,184,61,109
060070027001,374,126,248,379,118,261,484,162,312,386,121,241
060070027002,259,90,169,264,89,175,406,141,252,294,92,180
060070027003,228,78,150,233,71,162,321,103,212,265,80,166
060070027004,289,103,186,292,94,198,386,131,242,312,98,191
060070027005,458,179,279,463,168,295,669,257,392,523,183,302
060070028001,170,71,99,173,70,103,257,109,138,202,80,107
060070030012,144,68,76,146,67,79,292,134,146,179,81,84
060070027006,336,114,222,342,106,236,451,146,292,346,102,221
060070026021,512,162,350,517,153,364,672,228,432,552,163,359
060070030011,208,79,129,211,75,136,274,118,147,244,97,122
060070031002,354,107,247,359,104,255,490,153,324,385,111,249
060070031003,308,104,204,313,101,212,442,144,284,346,101,221
060070030013,118,61,57,118,57,61,210,106,100,172,85,76
060070030014,99,53,46,100,48,52,169,89,80,141,68,62
060070030024,159,71,88,164,69,95,256,107,143,236,76,139
060070030023,219,78,141,225,77,148,284,109,167,280,85,174
060070026022,830,270,560,842,256,586,1113,391,705,881,260,576
060070026023,414,132,282,418,126,292,489,165,319,430,126,283
060070031001,574,166,408,585,149,436,745,216,513,642,173,427
060070026013,405,123,282,412,111,301,560,167,380,441,116,293
060070031004,421,140,281,426,126,300,609,187,408,465,143,291
060070030022,264,97,167,270,91,179,388,145,237,283,93,167
060070033001,729,219,510,738,194,544,992,291,685,818,225,545
060070026012,379,121,258,384,118,266,542,180,355,402,118,263
060070026011,280,74,206,284,65,219,396,111,275,333,77,236
060070032001,286,93,193,290,86,204,402,122,268,357,108,223
060070032002,462,143,319,465,127,338,643,192,440,531,156,339
060070032003,347,118,229,355,111,244,465,144,316,439,139,280
060070033003,567,164,403,571,149,422,828,239,572,677,196,439
060070024023,610,196,414,616,186,430,734,226,491,723,207,459
060070033002,319,101,218,318,94,224,437,127,301,393,117,247
060070024011,342,144,198,346,135,211,310,123,173,399,144,207
060070024012,433,182,251,432,174,258,458,187,258,498,174,272
060070024022,509,212,297,515,209,306,472,180,284,624,220,356
060070024021,248,83,165,253,81,172,296,86,204,313,97,194
060070022002,949,335,614,963,324,639,797,291,486,1024,353,599
060070004032,954,540,414,967,528,439,1215,704,485,1020,540,399
060070004031,582,325,257,595,320,275,718,415,286,599,315,240
060070006012,400,257,143,403,247,156,479,307,159,421,251,137
060070005011,446,212,234,449,205,244,620,296,301,438,186,215
060070005012,571,302,269,590,299,291,717,394,302,590,295,249
060070005013,487,269,218,497,261,236,598,340,240,455,231,187
060070005014,183,131,52,187,131,56,225,154,64,275,183,63
060070005015,243,181,62,249,183,66,292,207,76,390,267,84
060070005021,340,212,128,344,199,145,434,269,151,355,198,127
060070004041,1422,648,774,1455,649,806,1891,952,886,1520,648,745
060070004042,514,230,284,527,235,292,606,317,275,552,241,265
060070004012,1230,578,652,1259,558,701,2011,1017,938,1030,427,508
060070004011,292,137,155,304,138,166,394,202,185,302,127,153
060070006011,452,257,195,466,257,209,590,348,226,489,233,207
060070006013,699,419,280,718,410,308,869,553,276,719,375,269
060070010002,192,154,38,194,154,40,245,184,52,209,146,39
060070010004,166,138,28,171,138,33,241,179,51,196,131,41
060070010005,188,155,33,196,155,41,244,187,51,200,135,42
060070010006,491,396,95,501,401,100,619,467,132,538,370,99
060070006033,556,450,106,568,447,121,449,338,98,672,464,123
060070005022,208,174,34,214,175,39,288,226,51,167,123,26
060070005023,374,301,73,382,299,83,515,396,100,398,280,76
060070005024,316,265,51,323,265,58,446,351,76,379,279,60
060070011004,298,230,68,307,231,76,273,189,73,278,181,65
060070006032,243,201,42,249,201,48,319,252,55,259,187,39
060070006041,150,134,16,156,137,19,169,136,25,202,153,22
060070006043,141,125,16,145,128,17,249,198,38,184,140,20
060070006045,256,227,29,262,231,31,367,292,56,294,224,31
060070010001,306,239,67,309,237,72,387,278,88,290,195,53
060070010003,268,214,54,269,215,54,345,248,79,295,205,51
060070013001,374,283,91,379,278,101,557,401,128,394,248,94
060070013002,314,243,71,317,238,79,406,295,93,289,196,56
060070013004,249,193,56,253,190,63,362,258,83,242,162,46
060070006031,225,180,45,231,178,53,299,224,63,212,147,37
060070006044,299,217,82,303,210,93,359,252,89,291,181,73
060070006042,286,180,106,293,172,121,463,302,138,301,168,98
060070002012,295,150,145,302,145,157,433,200,222,343,161,151
060070003002,471,266,205,479,259,220,741,404,305,572,280,233
060070014001,1268,455,813,1298,434,864,1661,610,1007,1306,423,787
060070014003,427,150,277,430,137,293,572,206,355,457,150,278
060070014004,770,281,489,791,269,522,983,373,588,836,278,505
060070014002,601,262,339,617,258,359,809,393,392,661,267,346
060070016021,664,322,342,671,320,351,808,375,412,698,296,347
060070001021,593,332,261,604,323,281,747,447,276,635,333,246
060070001022,640,355,285,654,349,305,828,457,343,672,350,259
060070001023,591,315,276,607,310,297,818,452,342,620,314,252
060070001031,1082,587,495,1103,571,532,1887,1051,782,919,463,387
060070001032,1084,563,521,1119,556,563,1597,864,689,1106,548,475
060070001041,865,506,359,882,490,392,925,513,390,868,450,338
060070001043,423,236,187,426,227,199,510,311,183,438,223,180
060070001044,334,197,137,340,190,150,682,386,274,421,218,164
060070009041,1319,783,536,1344,779,565,1617,984,593,1385,792,493
060070009042,862,523,339,884,525,359,1091,686,377,910,538,304
060070016023,861,473,388,874,466,408,1106,653,432,902,485,360
060070008001,585,365,220,592,361,231,706,446,244,601,355,198
060070008002,460,288,172,465,283,182,565,380,167,475,281,157
060070008003,508,314,194,519,313,206,594,395,184,554,329,173
060070008005,439,272,167,445,269,176,545,354,173,457,269,145
060070008006,335,209,126,341,207,134,425,289,125,347,206,110
060070009043,357,219,138,364,221,143,464,296,155,385,232,124
060070007001,475,327,148,481,320,161,621,424,182,484,292,138
060070007002,581,418,163,590,415,175,739,531,188,580,380,141
060070007003,786,539,247,806,542,264,910,629,258,793,525,192
060070007004,402,296,106,416,299,117,520,386,126,419,283,96
060070008004,569,388,181,581,384,197,709,473,210,576,341,168
060070002011,345,188,157,351,182,169,541,290,232,361,158,164
060070002013,299,154,145,304,148,156,383,202,171,330,141,156
060070002014,630,327,303,642,317,325,875,462,388,668,291,315
060070002022,260,153,107,266,152,114,392,213,163,298,142,126
060070002023,314,170,144,322,168,154,421,225,185,328,151,152
060070002024,297,168,129,302,166,136,395,217,165,319,153,138
060070002021,421,252,169,428,249,179,622,348,251,516,255,209
060070003001,217,134,83,218,131,87,311,194,105,237,125,87
060070003003,214,132,82,215,129,86,280,176,94,239,124,88
060070003004,318,198,120,321,193,128,431,271,146,336,174,123
060070009044,568,287,281,575,278,297,736,410,311,547,270,244
060070001042,480,274,206,497,279,218,724,413,292,470,232,191
060070016011,599,287,312,612,286,326,760,364,379,658,302,313
060070016012,221,102,119,228,102,126,283,131,147,227,103,110
060070017041,255,84,171,254,80,174,307,97,206,372,127,228
060070016022,551,319,232,559,320,239,537,305,214,566,289,213
060070011001,152,125,27,158,128,30,289,223,54,213,147,37
060070011002,603,286,317,619,285,334,782,390,374,651,274,326
060070011003,251,187,64,257,188,69,383,277,91,268,174,64
060070011005,131,108,23,137,111,26,231,179,45,141,96,26
060070012001,422,345,77,434,343,91,584,443,119,448,298,88
060070012002,272,223,49,281,221,60,396,303,80,290,192,57
060070012003,251,164,87,258,163,95,377,239,126,365,186,143
060070012004,185,152,33,190,150,40,317,239,64,210,139,41
060070009031,358,217,141,369,210,159,524,310,195,400,210,142
060070009032,353,213,140,358,204,154,507,303,185,381,202,135
060070013003,363,196,167,369,191,178,527,288,220,305,156,121
060070009033,716,412,304,732,404,328,1053,625,394,814,440,300
060070009034,571,328,243,584,323,261,904,571,313,585,318,216
060070034001,465,132,333,469,119,350,712,234,465,495,136,329
060070035012,256,115,141,262,106,156,380,172,202,309,128,155
060070035013,219,107,112,224,103,121,328,157,167,244,117,116
060070035014,268,119,149,274,112,162,388,171,206,280,116,144
060070035022,280,129,151,284,123,161,421,195,218,333,153,161
060070035024,265,118,147,272,112,160,405,182,215,322,136,165
060070035011,421,147,274,421,132,289,576,192,366,432,144,266
060070035021,383,106,277,390,93,297,484,130,345,429,119,293
060070035023,277,140,137,275,130,145,465,226,225,327,164,143
060070036001,271,88,183,278,89,189,396,132,257,302,98,189
060070036002,322,109,213,330,111,219,481,168,302,380,131,231
060070036003,559,94,465,572,90,482,716,147,561,602,92,483
060070029001,412,156,256,418,149,269,644,225,404,542,187,319
060070029002,379,151,228,384,144,240,554,214,328,444,155,251
060070037001,413,165,248,418,153,265,616,234,361,457,166,261
060070037003,350,132,218,357,127,230,534,183,342,392,133,232
060070037004,265,100,165,270,96,174,392,136,245,304,104,177
060070034002,466,115,351,472,103,369,610,170,427,508,122,357
060070015001,473,167,306,483,157,326,769,272,474,521,180,304
060070015002,535,181,354,547,158,389,592,201,373,563,177,338
060070015003,954,355,599,973,343,630,1124,434,658,1025,359,595
060070015004,352,112,240,354,104,250,457,147,290,364,117,223
060070015005,245,79,166,249,75,174,306,100,198,265,85,164
060070037002,256,75,181,256,70,186,428,134,285,279,81,175
060070009011,1329,671,658,1340,668,672,1656,930,686,1397,690,601
060070018001,721,315,406,733,305,428,266,97,160,784,300,421
060070018002,328,146,182,335,144,191,93,36,56,357,134,193
060070018004,448,200,248,458,196,262,144,52,86,482,177,264
060070018005,381,150,231,391,145,246,120,46,71,414,141,243
060070021003,322,137,185,329,132,197,117,46,67,354,131,196
060070021002,298,132,166,307,131,176,58,19,38,325,125,172
060070021004,607,281,326,618,270,348,284,112,158,656,265,336
060070021005,391,189,202,397,181,216,192,82,105,420,175,212
060070022001,653,279,374,664,266,398,181,79,98,713,276,382
060070018003,519,218,301,533,215,318,144,50,91,548,206,303
060070019001,283,123,160,289,120,169,81,32,48,321,120,178
060070019002,512,213,299,529,209,320,159,57,100,569,212,315
060070019003,351,150,201,359,147,212,143,51,86,385,143,212
060070019004,417,178,239,428,175,253,141,52,86,443,165,244
060070021001,407,208,199,414,205,209,132,55,75,433,186,219
060070020005,503,212,291,507,201,306,184,62,116,576,216,315
060070020006,309,138,171,314,136,178,92,33,55,340,134,180
060070020004,386,167,219,393,161,232,110,39,69,429,165,228
060070023002,508,210,298,518,199,319,184,65,116,536,198,302
060070023003,343,151,192,351,145,206,117,43,69,388,151,204
060070023004,466,206,260,477,203,274,156,57,94,520,203,268
060070020001,543,217,326,551,204,347,158,53,104,561,203,317
060070020002,354,144,210,360,135,225,96,32,62,386,141,217
060070023001,722,269,453,731,253,478,233,78,147,780,262,470
060070022003,419,180,239,422,168,254,107,43,61,440,167,236
060070022004,580,240,340,590,227,363,270,101,161,645,237,356
060070020003,361,139,222,365,132,233,149,48,99,360,127,206
060070017024,418,171,247,425,163,262,541,211,318,463,154,275
060070017043,520,217,303,525,205,320,762,296,440,594,206,344
060070017022,755,335,420,763,317,446,197,78,113,831,325,454
060070017023,969,396,573,977,374,603,1178,465,673,1005,357,576
060070017031,511,221,290,515,207,308,207,89,114,515,197,283
060070017032,715,299,416,725,279,446,697,300,373,822,309,454
060070017042,394,156,238,400,147,253,514,180,314,439,145,264
060070017021,397,177,220,401,167,234,120,44,65,442,173,240
060070023005,472,164,308,470,162,308,541,169,354,508,165,304
060990021001,205,155,50,208,145,63,313,184,119,242,178,52
060990021002,198,146,52,201,142,59,301,179,115,250,155,73
060990023041,74,60,14,75,57,18,98,70,23,98,71,19
060990023042,257,223,34,257,208,49,361,284,73,284,223,43
060990023021,279,230,49,281,216,65,402,290,97,325,241,65
060990023022,263,215,48,264,203,61,357,261,88,312,233,62
060990027022,317,246,71,323,240,83,490,300,176,311,229,61
060990025032,219,144,75,226,138,88,300,186,109,261,162,86
060990026023,281,170,111,282,165,117,380,213,152,307,175,115
060990025061,191,162,29,191,152,39,287,210,71,244,181,46
060990023033,400,330,70,404,315,89,585,424,146,499,376,95
060990024021,284,222,62,283,208,75,409,292,108,328,245,64
060990024022,135,104,31,137,99,38,269,148,116,150,110,33
060990023031,208,173,35,208,164,44,307,221,80,255,197,46
060990024023,243,187,56,244,174,70,364,173,183,270,193,60
060990031001,220,69,151,223,64,159,227,109,114,238,80,147
060990031003,438,163,275,447,155,292,547,246,294,501,197,285
060990040003,537,119,418,554,112,442,651,203,438,569,162,385
060990031002,189,111,78,188,113,75,272,159,106,221,127,78
060990026041,299,191,108,303,185,118,472,273,188,350,171,160
060990026042,223,144,79,226,139,87,321,184,128,272,134,122
060990027021,166,118,48,167,117,50,250,145,101,202,138,55
060990027023,263,164,99,270,157,113,397,233,154,318,193,109
060990027024,341,214,127,342,205,137,505,294,199,389,241,131
060990027025,293,185,108,297,181,116,414,240,167,342,215,115
060990026051,502,283,219,507,277,230,770,463,293,588,311,246
060990026052,541,307,234,549,299,250,730,415,303,642,372,233
060990030032,542,326,216,546,315,231,732,438,280,645,363,243
060990030042,317,180,137,321,173,148,453,273,172,356,206,128
060990025031,308,196,112,313,188,125,480,269,195,365,205,134
060990025033,310,202,108,312,194,118,445,251,179,358,210,124
060990025041,646,431,215,649,412,237,942,536,375,787,477,259
060990026021,225,144,81,224,134,90,310,180,130,240,127,104
060990025042,486,334,152,486,320,166,664,386,262,567,359,175
060990026031,236,117,119,238,113,125,281,162,111,227,118,94
060990026043,296,204,92,300,197,103,426,247,169,316,164,131
060990030021,332,119,213,336,114,222,449,195,249,356,152,187
060990026022,585,353,232,591,342,249,810,456,332,671,373,249
060990027011,536,313,223,540,308,232,754,406,337,620,346,243
060990020023,182,96,86,183,90,93,257,124,124,224,111,96
060990030034,814,562,252,827,550,277,1142,654,473,853,570,242
060990026032,767,345,422,778,332,446,940,548,375,761,375,334
060990025062,3,2,1,3,2,1,4,3,1,0,0,0
060990025051,490,375,115,491,366,125,840,574,244,582,413,139
060990025052,523,402,121,525,392,133,837,571,244,621,438,149
060990027012,821,459,362,831,441,390,1047,559,450,861,455,362
060990030033,230,166,64,236,164,72,412,250,158,256,176,63
060990030031,550,396,154,558,385,173,779,467,294,564,349,180
060990036031,191,56,135,198,53,145,236,71,165,255,66,178
060990036032,145,45,100,145,38,107,216,63,153,114,29,84
060990036033,379,146,233,385,142,243,602,231,360,425,169,233
060990037003,278,189,89,286,183,103,445,263,168,357,238,100
060990037001,239,93,146,245,88,157,334,123,199,311,101,190
060990037002,324,115,209,332,107,225,476,133,334,346,103,224
060990001021,472,137,335,480,128,352,468,129,331,430,122,286
060990003011,338,196,142,341,188,153,594,303,285,392,197,176
060990004051,518,162,356,525,147,378,723,241,472,558,157,374
060990028024,479,145,334,486,135,351,629,193,424,508,147,344
060990020021,525,284,241,529,270,259,747,390,343,657,332,289
060990028032,670,303,367,681,298,383,860,405,435,722,293,383
060990030041,279,116,163,286,116,170,363,132,223,332,114,199
060990030022,382,215,167,386,206,180,561,281,260,456,178,253
060990030023,461,269,192,467,261,206,717,412,292,450,182,247
060990030024,454,267,187,461,257,204,728,419,285,542,216,294
060990004044,319,156,163,327,153,174,407,191,206,321,147,158
060990004043,934,452,482,947,442,505,1278,602,642,1029,462,512
060990005011,730,233,497,742,237,505,962,328,617,722,226,467
060990005012,506,189,317,515,191,324,667,250,405,515,188,307
060990005053,472,243,229,479,242,237,726,356,359,512,249,234
060990005063,377,179,198,381,177,204,492,238,241,418,189,205
060990005064,314,136,178,320,135,185,410,202,197,336,130,184
060990009081,575,300,275,587,295,292,730,372,336,622,294,287
060990009082,620,303,317,632,298,334,770,416,335,700,322,344
060990032013,274,165,109,277,161,116,357,206,141,291,161,114
060990032031,617,388,229,628,388,240,886,536,321,680,398,239
060990033002,550,235,315,557,225,332,858,406,432,558,282,255
060990034001,250,106,144,249,98,151,326,140,184,291,118,161
060990033003,225,108,117,228,103,125,325,151,170,264,100,154
060990033004,292,121,171,293,115,178,393,175,209,325,107,199
060990034002,141,58,83,144,56,88,211,72,135,160,55,100
060990035014,690,391,299,698,376,322,989,557,412,801,413,336
060990035012,324,193,131,329,185,144,496,277,208,389,219,143
060990035011,212,112,100,212,107,105,317,175,136,229,117,98
060990035023,368,219,149,374,212,162,561,306,249,448,260,163
060990035022,169,97,72,173,95,78,285,151,126,205,115,78
060990035021,484,291,193,497,285,212,722,405,302,578,328,208
060990036034,376,118,258,391,115,276,550,165,376,436,135,284
060990032011,373,254,119,382,246,136,528,335,184,364,245,98
060990032052,768,491,277,776,480,296,1053,647,376,881,529,283
060990033001,274,126,148,279,119,160,353,160,183,298,172,116
060990029011,390,113,277,399,109,290,484,130,350,420,102,296
060990029013,339,100,239,343,96,247,434,120,314,363,97,248
060990029014,257,75,182,261,72,189,396,104,279,270,100,159
060990036071,455,143,312,466,143,323,617,186,420,484,143,316
060990036082,294,91,203,300,91,209,420,126,288,329,97,217
060990036083,858,325,533,875,318,557,1141,421,701,971,305,616
060990036072,435,138,297,447,135,312,536,193,335,464,152,290
060990029012,364,107,257,366,101,265,408,103,299,378,120,237
060990029015,514,146,368,521,142,379,645,164,463,517,208,281
060990029041,933,341,592,953,335,618,1230,444,764,999,368,583
060990029031,899,355,544,909,340,569,1226,456,744,890,325,525
060990029033,254,79,175,259,76,183,336,92,240,265,105,146
060990036084,837,242,595,846,233,613,1144,342,777,901,256,596
060990036081,569,218,351,589,220,369,755,286,454,630,210,381
060990039071,911,332,579,927,319,608,1047,397,625,950,317,584
060990039044,360,146,214,368,141,227,515,220,284,358,147,183
060990039053,591,253,338,606,246,360,743,324,403,681,245,392
060990039054,266,114,152,271,110,161,340,153,171,260,110,128
060990020022,183,100,83,188,95,93,273,143,123,259,133,114
060990028023,538,166,372,541,157,384,730,224,494,571,161,383
060990040001,373,69,304,386,67,319,455,121,328,420,84,312
060770055031,271,90,181,270,84,186,343,123,214,317,113,188
060990005131,733,377,356,746,368,378,1034,525,485,795,374,366
060990006011,307,120,187,308,115,193,454,195,249,365,133,211
060990006012,696,379,317,705,368,337,938,471,445,773,369,364
060990006013,567,279,288,584,273,311,741,375,353,620,320,265
060990029034,394,193,201,401,175,226,593,220,361,453,163,267
060990029032,288,133,155,295,125,170,401,153,244,317,116,188
060990001011,787,216,571,805,211,594,1144,319,806,807,213,559
060990001012,500,131,369,508,131,377,661,181,476,541,132,387
060990001014,334,84,250,347,89,258,498,132,350,514,137,352
060990002024,1232,410,822,1253,391,862,1907,613,1263,1127,400,660
060990001022,1154,319,835,1172,305,867,1248,351,871,1090,284,753
060990001023,465,129,336,468,123,345,620,164,447,454,118,316
060990002012,617,224,393,623,215,408,821,277,525,645,220,389
060990002015,452,183,269,465,180,285,666,234,423,533,183,328
060990002023,667,236,431,677,225,452,902,307,572,645,223,381
060990002051,369,150,219,376,142,234,501,189,298,489,168,294
060990002052,885,361,524,901,348,553,1505,501,970,818,285,480
060990002043,823,294,529,838,286,552,1045,347,680,943,306,579
060990028013,355,87,268,363,85,278,487,115,363,385,86,278
060990020042,246,162,84,246,154,92,352,212,129,299,159,111
060990020043,453,299,154,453,280,173,659,398,243,555,300,207
060990009051,607,310,297,615,302,313,809,400,379,694,303,342
060990009052,870,445,425,883,437,446,1178,552,597,1009,440,508
060990009053,778,396,382,792,391,401,1059,519,518,901,406,439
060990009063,868,399,469,879,387,492,1119,530,558,926,417,448
060990020041,425,218,207,434,215,219,508,302,191,428,241,158
060990020044,413,212,201,421,209,212,472,289,168,404,229,149
060990023032,206,171,35,207,163,44,230,168,58,266,205,44
060990016012,305,229,76,311,224,87,397,259,127,369,266,82
060990016013,209,171,38,209,167,42,291,230,54,220,178,34
060990016041,198,163,35,197,157,40,274,211,51,221,175,30
060990016043,165,142,23,165,136,29,250,194,45,192,154,27
060990022004,212,168,44,210,156,54,294,213,76,248,190,43
060990022001,279,233,46,283,221,62,389,276,102,323,264,46
060990022002,322,262,60,320,244,76,447,319,112,397,309,63
060990016031,230,153,77,233,149,84,228,180,46,267,162,87
060990022003,83,67,16,85,64,21,119,85,31,99,76,17
060990015001,465,314,151,470,308,162,632,424,190,554,350,178
060990016011,220,181,39,222,178,44,320,237,74,263,198,50
060990017001,220,183,37,224,181,43,373,265,108,263,211,36
060990017002,100,84,16,102,83,19,174,124,49,137,105,18
060990015002,386,275,111,391,271,120,500,344,141,472,312,139
060990015003,412,293,119,419,289,130,560,382,157,501,329,147
060990014001,551,316,235,563,315,248,885,478,375,667,343,277
060990014002,349,201,148,353,198,155,466,276,177,343,201,118
060990014003,151,87,64,155,87,68,188,111,72,162,95,55
060990014004,547,316,231,555,315,240,828,455,359,666,347,282
060990014005,158,91,67,161,91,70,232,124,99,226,117,94
060990008051,515,284,231,516,273,243,704,370,314,579,281,254
060990008054,442,245,197,448,237,211,633,336,285,502,241,221
060990008031,289,170,119,294,168,126,407,248,151,313,176,111
060990008033,413,242,171,417,237,180,547,332,201,446,244,172
060990008052,459,268,191,466,264,202,685,363,309,526,279,218
060990008053,276,161,115,278,158,120,385,204,172,309,174,109
060990005052,573,300,273,585,301,284,813,383,412,647,325,282
060990008061,723,387,336,740,386,354,955,461,474,795,397,351
060990008062,660,353,307,675,353,322,856,451,380,720,360,319
060990019001,838,457,381,856,454,402,1059,545,468,889,443,384
060990019002,279,153,126,284,152,132,349,186,158,284,142,125
060990019003,396,215,181,401,215,186,503,268,222,443,220,197
060990019004,271,148,123,276,148,128,364,192,161,332,167,144
060990019005,310,170,140,314,169,145,417,221,188,358,179,155
060990010012,577,282,295,587,279,308,768,389,364,647,301,306
060990010023,259,138,121,265,138,127,359,184,165,268,139,108
060990018001,213,144,69,219,142,77,335,208,118,240,139,75
060990018002,257,170,87,258,166,92,378,235,137,307,183,104
060990018003,0,0,0,0,0,0,0,0,0,1,1,0
060990012001,321,184,137,327,185,142,381,198,181,307,159,128
060990012002,471,286,185,483,288,195,546,283,255,418,219,169
060990012003,663,406,257,681,410,271,874,527,325,778,414,295
060990013002,265,161,104,275,164,111,328,193,130,286,154,109
060990013004,646,372,274,657,371,286,834,462,354,712,370,286
060990013006,370,226,144,384,229,155,465,255,203,436,236,166
060990010011,568,282,286,580,280,300,748,376,340,628,286,300
060990010013,273,143,130,277,141,136,392,197,178,321,150,151
060990010021,344,180,164,351,179,172,478,245,220,366,185,154
060990010022,478,251,227,486,248,238,646,327,298,484,248,194
060990011001,344,181,163,348,177,171,439,221,200,382,192,161
060990006021,331,194,137,335,191,144,454,212,236,388,188,177
060990006022,585,329,256,594,321,273,755,385,353,597,319,251
060990011002,274,143,131,279,145,134,374,192,173,301,152,125
060990011003,321,172,149,328,172,156,419,213,192,333,167,141
060990011004,320,172,148,331,172,159,394,201,186,335,170,140
060990013001,373,200,173,380,199,181,531,287,228,436,194,214
060990013005,432,233,199,441,231,210,579,317,250,495,223,246
060990013003,456,247,209,462,247,215,581,317,252,495,253,201
060990008013,363,172,191,370,171,199,457,213,237,414,194,196
060990008014,596,289,307,607,288,319,766,378,367,669,312,312
060990008015,581,281,300,592,281,311,719,354,345,630,294,295
060990009073,446,232,214,459,227,232,612,291,312,493,220,235
060990009091,614,319,295,630,311,319,879,420,445,669,312,305
060990009092,577,300,277,590,290,300,828,393,422,660,295,316
060990009093,285,148,137,291,143,148,378,179,191,306,149,135
060990008011,587,277,310,597,271,326,725,338,369,586,247,303
060990008012,633,298,335,643,292,351,779,366,394,670,283,348
060990009071,585,252,333,595,248,347,708,336,359,597,259,306
060990009072,523,225,298,531,221,310,600,284,304,542,235,277
060990010014,462,217,245,469,215,254,598,304,279,518,236,258
060990010015,516,242,274,523,240,283,634,324,293,536,248,253
060990009101,464,255,209,474,249,225,734,368,348,553,257,258
060990009102,442,242,200,451,237,214,637,345,275,568,277,242
060990009103,261,142,119,261,138,123,349,189,150,283,139,122
060990009104,393,217,176,401,211,190,584,294,278,450,210,211
060990004032,834,378,456,846,387,459,1130,519,587,809,344,402
060990004033,657,304,353,667,311,356,873,388,464,671,297,336
060990004031,488,226,262,496,231,265,556,285,266,515,229,259
060990016032,257,215,42,260,207,53,357,270,64,291,217,52
060990016034,291,197,94,296,192,104,382,233,139,340,212,105
060990016042,173,151,22,175,145,30,222,172,41,198,160,28
060990008032,372,200,172,376,192,184,482,296,178,378,216,132
060990008071,355,193,162,359,184,175,356,177,175,454,217,208
060990008072,644,349,295,647,328,319,1031,507,502,757,363,346
060990009083,591,325,266,598,313,285,764,391,355,670,306,325
060990009141,647,350,297,658,342,316,933,490,428,721,357,330
060990009143,592,315,277,603,311,292,1085,568,497,589,311,253
060990024011,272,226,46,271,213,58,367,284,73,311,245,50
060990024012,365,303,62,366,287,79,532,409,103,413,323,67
060990009062,861,415,446,874,402,472,1214,561,613,1001,445,491
060990009061,632,305,327,643,297,346,780,355,396,700,308,343
060990028031,506,234,272,511,229,282,606,310,277,582,244,301
060990005031,461,255,206,469,255,214,800,415,362,495,257,212
060990005032,600,333,267,614,334,280,838,438,378,707,366,305
060990005033,365,202,163,371,202,169,519,270,236,401,209,172
060990009151,971,458,513,979,449,530,1414,660,726,1029,464,511
060990009133,868,417,451,881,402,479,1260,602,638,965,428,470
060990009134,787,375,412,797,362,435,1260,584,649,845,379,408
060990005113,749,343,406,760,337,423,1010,487,510,790,352,393
060990005111,810,384,426,827,377,450,1173,592,560,857,395,415
060990005121,740,340,400,757,333,424,903,447,436,772,360,374
060990005122,617,283,334,633,278,355,731,360,356,665,304,322
060990004041,394,194,200,399,190,209,547,259,278,432,196,207
060990004042,439,218,221,446,211,235,545,258,275,471,218,232
060990005061,403,191,212,411,191,220,526,256,258,435,185,222
060990005062,397,189,208,403,187,216,533,260,261,444,200,216
060990005112,554,295,259,562,294,268,812,411,385,648,297,312
060990005051,493,262,231,501,262,239,924,462,435,588,297,257
060990020051,487,301,186,496,294,202,726,396,308,596,330,225
060990020061,601,373,228,612,365,247,923,503,390,716,398,268
060990020062,602,368,234,607,358,249,946,518,404,723,396,274
060990020052,410,266,144,411,253,158,654,356,279,486,291,169
060990009111,634,317,317,645,316,329,829,416,394,689,304,345
060990009112,595,297,298,601,296,305,849,425,401,682,302,339
060990009131,428,214,214,434,214,220,568,297,262,434,189,221
060990004052,203,94,109,206,91,115,299,126,169,210,96,104
060990009152,677,317,360,688,314,374,1035,482,531,722,325,358
060990009113,393,207,186,401,206,195,616,320,281,458,201,232
060990009132,366,193,173,369,191,178,520,275,238,402,174,202
060990009142,613,323,290,621,321,300,956,499,437,732,400,302
060990035013,442,253,189,447,244,203,765,427,316,401,207,168
060990001013,488,125,363,495,126,369,747,201,538,534,124,385
060990002013,289,114,175,294,110,184,391,154,234,394,133,239
060990002014,216,82,134,217,77,140,328,109,208,236,81,141
060990002021,339,147,192,346,141,205,459,199,249,597,216,350
060990002022,175,75,100,178,73,105,256,110,136,143,50,83
060990002041,836,308,528,853,302,551,1161,392,745,840,285,501
060990002042,244,89,155,248,86,162,299,129,164,335,115,201
060990002011,699,232,467,709,220,489,964,322,615,758,257,453
060990015004,379,177,202,388,170,218,581,180,382,449,188,235
060990016033,159,105,54,162,102,60,267,115,142,193,118,65
060990032032,894,621,273,907,611,296,1393,935,430,966,635,279
060990032051,395,259,136,401,258,143,585,366,202,436,271,139
060990032012,333,226,107,338,219,119,509,320,173,379,253,102
060990032014,203,137,66,206,132,74,282,178,97,212,141,58
060990032041,323,214,109,331,207,124,439,277,158,350,227,105
060990032042,253,172,81,256,166,90,341,215,125,274,179,85
060990032062,697,487,210,703,469,234,1067,721,319,788,517,226
060990032061,582,426,156,588,413,175,899,636,244,613,423,161
060990003012,160,88,72,160,82,78,206,114,92,187,99,88
060990003021,130,63,67,132,59,73,217,117,94,137,68,62
060990003022,289,141,148,296,135,161,429,201,217,325,161,146
060990003023,342,166,176,343,155,188,477,252,215,367,182,164
060990003031,634,373,261,648,357,291,964,514,434,704,352,317
060990004062,935,499,436,955,482,473,1341,702,595,1001,496,449
060990003033,548,349,199,553,331,222,787,422,347,667,331,297
060990003042,373,229,144,380,222,158,583,296,275,408,221,164
060990003041,249,153,96,248,145,103,401,215,174,298,175,103
060990003043,422,261,161,422,247,175,696,375,303,459,274,160
060990003032,468,226,242,471,224,247,561,264,284,480,215,237
060990004061,956,478,478,969,474,495,1497,714,746,1088,492,534
060990004071,339,142,197,344,144,200,442,193,241,357,149,185
060990004072,784,343,441,796,346,450,1150,506,616,850,377,427
060990005013,688,372,316,702,354,348,1103,585,488,814,413,344
060990005014,824,447,377,836,421,415,1079,573,477,888,402,411
060990005141,644,367,277,658,360,298,893,495,370,705,371,288
060990005132,856,479,377,868,463,405,1229,650,545,959,497,396
060990005142,251,146,105,257,140,117,353,202,148,267,147,108
060990040002,473,177,296,482,173,309,616,244,365,522,185,304
060770051063,210,49,161,213,47,166,272,62,206,224,48,162
060990038021,190,114,76,192,114,78,266,163,99,219,127,75
060990038024,209,143,66,212,138,74,317,190,117,258,151,87
060990038032,289,186,103,296,182,114,381,219,157,363,182,159
060990038041,256,157,99,260,157,103,369,226,137,311,168,130
060990038042,229,138,91,235,141,94,344,206,126,281,149,115
060990038044,276,169,107,281,169,112,417,251,154,342,181,141
060990037004,242,164,78,245,159,86,366,203,154,290,181,92
060990038022,157,113,44,162,108,54,237,140,87,184,106,62
060990038023,356,245,111,360,235,125,522,296,214,412,240,141
060990038031,283,200,83,291,193,98,426,248,161,329,192,113
060990039041,438,188,250,450,183,267,544,251,278,407,225,151
060990039042,264,114,150,268,110,158,326,152,167,229,135,82
060990039043,415,179,236,424,173,251,565,248,307,369,212,123
060990039051,327,140,187,335,136,199,410,196,205,380,134,222
060990039052,610,261,349,626,256,370,733,351,375,683,256,383
060990039061,283,121,162,289,118,171,401,153,239,275,121,132
060990039062,567,253,314,581,245,336,749,349,379,566,260,262
060990039063,374,161,213,383,156,227,496,233,251,365,183,152
060990039073,568,244,324,577,236,341,717,273,429,605,234,332
060990039074,1002,430,572,1022,417,605,1323,518,769,1136,392,677
060990039081,289,146,143,293,142,151,395,195,190,313,149,139
060990036102,676,364,312,696,363,333,802,354,432,633,325,270
060990036101,752,391,361,774,387,387,1085,490,581,812,400,373
060990036123,607,315,292,626,313,313,943,475,458,678,346,297
060990036121,828,429,399,854,427,427,1233,619,592,911,463,397
060990039082,289,152,137,295,150,145,441,219,210,308,140,146
060990039091,596,312,284,609,308,301,863,424,409,666,301,310
060990039092,509,268,241,519,264,255,706,349,338,544,245,255
060990039093,643,339,304,656,332,324,905,450,436,627,288,297
060990036092,656,303,353,675,297,378,787,338,436,688,311,336
060990036091,691,321,370,712,314,398,939,403,519,756,343,370
060990036111,764,354,410,786,346,440,1174,504,647,794,361,386
060990036112,610,282,328,628,276,352,837,358,464,649,293,317
060990039072,827,355,472,850,349,501,1155,442,688,893,375,459
060990039094,334,154,180,344,151,193,533,201,316,361,164,169
060990038043,776,437,339,789,426,363,1055,540,491,739,390,303
060990038051,769,431,338,778,420,358,1068,534,512,833,444,324
060990036122,946,535,411,970,531,439,1464,734,705,1134,569,492
060990028011,870,306,564,879,293,586,1177,442,703,924,340,528
060990028012,464,207,257,467,197,270,704,268,425,550,202,320
060990028021,365,162,203,364,152,212,554,210,331,434,154,261
060990028022,603,263,340,613,251,362,874,326,529,684,244,408
060630003004,525,130,395,527,118,409,679,166,501,562,135,414
060630003003,464,171,293,481,171,310,687,257,415,533,181,319
060630002011,634,248,386,643,233,410,732,314,406,624,234,362
060630002021,314,137,177,319,135,184,440,222,201,311,133,158
060630002022,262,120,142,270,122,148,289,119,165,285,109,149
060630001005,387,173,214,394,166,228,546,259,276,479,194,247
060630001006,383,175,208,392,176,216,457,223,216,362,165,169
060630004002,358,162,196,372,160,212,474,214,247,379,155,191
060630004001,479,193,286,494,184,310,517,206,297,523,191,291
060630005022,263,77,186,268,76,192,313,98,212,269,74,186
060630003002,397,176,221,404,170,234,525,232,277,450,184,230
060630003001,353,121,232,364,118,246,466,174,278,396,125,250
060630002012,533,209,324,536,197,339,585,256,322,552,208,316
060630001001,492,261,231,497,251,246,430,228,191,468,234,185
060630001003,332,144,188,335,135,200,420,196,213,273,104,145
060630001004,615,242,373,631,236,395,774,323,434,681,256,362
060630001002,286,175,111,295,182,113,415,260,148,302,169,114
060630004003,386,163,223,390,148,242,509,199,293,392,147,203
060630005023,443,125,318,449,123,326,523,164,353,445,127,304
060630005011,285,76,209,292,81,211,372,104,254,319,87,213
060630005012,585,170,415,592,172,420,749,234,509,578,159,394
060630005021,293,86,207,295,79,216,354,113,237,322,88,218
061070015021,725,215,510,736,223,513,1072,331,721,849,244,559
061070015022,209,70,139,210,72,138,297,103,192,257,85,161
061070015023,368,118,250,367,119,248,516,178,338,388,119,259
061070015011,649,194,455,657,200,457,889,291,584,709,205,457
061070015013,481,160,321,484,168,316,668,211,437,521,150,334
061070015012,437,151,286,440,157,283,646,219,410,578,187,351
061070015024,291,89,202,292,89,203,422,140,276,298,95,182
061070026012,217,153,64,221,149,72,343,226,112,333,232,84
061070026011,329,219,110,334,213,121,524,334,183,403,273,109
061070026021,254,165,89,260,153,107,405,252,144,290,171,105
061070026022,206,144,62,210,139,71,323,214,102,235,161,53
061070025004,217,113,104,223,110,113,352,200,143,231,124,95
061070026023,220,150,70,225,146,79,332,216,108,340,232,91
061070026024,122,85,37,122,82,40,201,132,65,135,97,32
061070028001,241,158,83,244,153,91,374,235,132,257,167,75
061070028002,166,107,59,171,103,68,326,191,121,153,97,48
061070017051,452,175,277,458,181,277,655,265,374,516,174,312
061070017061,889,346,543,897,352,545,1558,631,893,887,320,518
061070017062,458,169,289,463,172,291,694,265,418,525,184,318
061070013061,468,212,256,479,211,268,772,370,385,511,226,254
061070013062,256,108,148,262,109,153,382,184,189,279,123,139
061070017034,695,263,432,704,266,438,1223,487,712,700,249,406
061070017033,615,244,371,621,247,374,886,360,506,738,260,434
061070017031,727,284,443,734,290,444,964,389,551,813,291,467
061070017032,764,275,489,775,280,495,896,364,515,854,288,514
061070017052,353,125,228,356,128,228,455,186,262,391,133,234
061070017013,377,151,226,378,153,225,539,221,313,394,145,221
061070017015,487,194,293,494,201,293,692,280,396,519,195,299
061070013051,90,50,40,93,49,44,128,79,46,99,58,34
061070013052,375,186,189,382,183,199,568,272,278,443,187,217
061070013063,591,278,313,596,270,326,836,380,441,660,288,332
061070013041,877,264,613,887,269,618,1106,371,712,909,259,607
061070013042,247,124,123,250,121,129,364,173,178,354,158,174
061070013033,496,264,232,502,255,247,882,420,429,534,234,268
061070013032,262,152,110,264,145,119,463,221,225,324,146,158
061070016011,231,161,70,234,159,75,346,216,122,280,182,79
061070016012,183,127,56,184,125,59,282,173,98,203,133,57
061070016013,119,82,37,121,81,40,178,110,63,137,89,39
061070016014,182,125,57,183,124,59,318,200,110,256,165,72
061070016022,357,247,110,360,248,112,504,322,173,343,225,96
061070016023,403,159,244,408,158,250,592,244,330,452,173,251
061070014006,252,175,77,254,176,78,431,265,148,292,189,92
061070001021,370,180,190,376,188,188,513,248,253,396,166,209
061070001011,787,280,507,794,291,503,810,258,537,733,249,449
061070001012,651,328,323,657,334,323,850,448,384,757,344,362
061070014001,265,75,190,266,75,191,321,109,208,313,118,190
061070014002,312,70,242,318,70,248,412,104,298,333,70,245
061070014003,316,76,240,319,76,243,403,110,284,378,83,278
061070014004,224,50,174,225,50,175,289,74,211,243,73,161
061070014005,163,44,119,165,44,121,235,70,159,198,49,137
061070016021,285,70,215,287,69,218,434,107,317,347,74,257
061070024023,534,139,395,543,137,406,651,193,437,537,129,385
061070020111,363,166,197,372,164,208,549,233,309,593,221,339
061070020112,593,209,384,595,213,382,873,330,527,605,207,370
061070025001,180,62,118,184,62,122,226,72,153,212,81,127
061070033022,211,41,170,216,38,178,215,65,148,190,60,124
061070024022,355,73,282,358,72,286,513,142,357,391,90,285
061070025002,332,123,209,334,118,216,423,168,244,371,148,213
061070032021,122,77,45,120,73,47,219,144,71,172,112,50
061070032022,65,46,19,67,43,24,116,84,31,80,56,19
061070025003,101,46,55,104,47,57,152,90,57,117,59,51
061070027021,550,131,419,556,136,420,741,196,529,584,136,422
061070033011,424,159,265,418,154,264,576,221,345,492,207,264
061070033012,103,64,39,103,59,44,182,94,85,143,67,71
061070033013,233,117,116,235,114,121,352,184,160,281,128,137
061070033023,423,107,316,422,97,325,508,179,321,441,162,263
061070033021,189,83,106,184,87,97,280,124,145,221,84,123
061070022024,234,152,82,238,141,97,453,266,174,232,128,90
061070022031,259,169,90,261,157,104,436,257,171,302,169,114
061070022032,286,183,103,289,169,120,400,236,159,284,157,114
061070022033,245,161,84,249,149,100,390,230,152,247,146,91
061070022034,28,18,10,27,17,10,76,47,29,33,21,12
061070030021,221,114,107,222,107,115,322,190,123,281,133,129
061070030011,135,83,52,139,82,57,207,141,61,173,102,68
061070030022,236,165,71,235,153,82,376,235,128,286,192,76
061070030012,141,97,44,140,91,49,256,167,84,171,106,60
061070030013,192,135,57,191,129,62,310,193,111,232,162,61
061070022021,168,107,61,171,99,72,275,168,106,205,112,91
061070022022,93,59,34,94,55,39,173,104,68,124,69,52
061070022023,179,113,66,188,112,76,320,190,125,249,131,112
061070022044,141,88,53,139,83,56,254,143,99,212,103,90
061070022041,318,203,115,321,196,125,538,302,209,417,232,153
061070022042,269,172,97,269,163,106,453,255,175,359,201,131
061070022043,122,80,42,118,72,46,199,116,78,134,80,50
061070024032,801,334,467,807,328,479,1490,537,920,735,260,433
061070029011,275,127,148,272,119,153,407,208,183,300,169,113
061070029012,276,144,132,278,134,144,394,254,138,277,172,98
061070029033,135,66,69,141,65,76,239,148,81,183,85,82
061070029034,370,179,191,374,169,205,526,230,289,470,181,269
061070029043,314,143,171,314,138,176,525,213,300,365,135,206
061070029041,364,182,182,372,177,195,551,225,314,429,172,229
061070029042,392,186,206,393,178,215,600,247,346,423,257,138
061070024021,361,140,221,366,139,227,587,216,363,409,135,249
061070023021,303,109,194,303,107,196,450,169,270,353,136,193
061070023022,678,234,444,686,232,454,952,350,587,761,267,451
061070023034,389,132,257,395,129,266,586,188,397,484,175,277
061070023035,223,87,136,225,84,141,316,124,188,295,106,173
061070023041,157,64,93,157,59,98,262,85,177,174,83,74
061070023042,230,89,141,234,86,148,328,128,192,294,102,176
061070029032,271,106,165,274,101,173,417,165,243,346,118,209
061070021002,356,119,237,356,115,241,510,192,310,432,153,255
061070023031,421,112,309,428,116,312,577,184,382,520,138,363
061070023032,887,235,652,896,239,657,1123,355,743,887,255,601
061070023033,376,115,261,386,116,270,488,156,325,423,158,238
061070024012,919,303,616,933,303,630,1415,509,879,967,301,625
061070024011,490,161,329,496,159,337,688,248,426,524,163,341
061070023023,344,115,229,347,116,231,680,244,423,377,121,234
061070029031,456,151,305,463,154,309,705,250,442,562,185,355
061070024031,831,340,491,839,335,504,1317,465,821,770,252,486
061070031002,259,109,150,259,106,153,460,149,304,355,124,208
061070031003,122,38,84,123,38,85,163,46,117,143,43,94
061070032011,275,152,123,279,158,121,387,218,162,359,227,112
061070044012,256,206,50,259,199,60,488,376,92,338,255,70
061070044011,118,96,22,122,93,29,256,198,48,148,124,17
061070044021,63,54,9,68,52,16,124,100,24,83,76,7
061070044022,66,54,12,65,50,15,133,103,26,87,75,9
061070044023,111,88,23,112,84,28,201,155,42,153,130,20
061070020103,501,187,314,510,189,321,818,298,500,584,185,371
061070021001,281,68,213,284,66,218,347,95,248,248,70,172
061070024013,168,46,122,167,44,123,332,114,214,183,61,111
061070031001,155,43,112,156,42,114,199,59,140,170,56,109
061070032012,123,27,96,128,26,102,170,37,130,146,38,106
061070032013,128,41,87,128,38,90,185,50,135,148,54,91
061070043011,92,43,49,89,42,47,118,68,50,96,52,43
061070042004,167,56,111,172,55,117,217,73,144,179,64,112
061070043021,134,66,68,138,70,68,216,121,85,177,89,82
061070042001,161,81,80,163,74,89,234,101,127,187,100,82
061070043022,63,33,30,64,30,34,87,46,41,57,36,21
061070034012,144,49,95,145,51,94,228,82,144,174,70,96
061070042002,108,46,62,110,44,66,147,84,62,120,51,63
061070042003,185,79,106,183,74,109,327,155,163,241,100,121
061070042005,137,61,76,137,57,80,181,104,73,152,64,76
061070019022,515,206,309,520,206,314,513,201,302,409,141,237
061070020102,288,132,156,293,131,162,430,184,234,342,130,195
061070020101,747,304,443,750,293,457,1125,466,638,876,336,494
061070018001,219,96,123,219,96,123,299,152,146,252,112,127
061070018002,540,233,307,543,235,308,747,356,366,634,243,343
061070018003,332,151,181,335,151,184,410,206,195,339,143,168
061070018004,362,167,195,366,167,199,518,249,252,371,148,195
061070019011,400,184,216,403,184,219,587,227,342,464,155,280
061070019024,332,131,201,335,133,202,451,178,267,362,123,217
061070020021,304,132,172,310,132,178,391,171,210,330,125,184
061070020022,378,163,215,384,165,219,529,222,297,391,148,219
061070020023,459,198,261,468,200,268,624,255,353,523,200,293
061070020024,401,171,230,406,172,234,545,249,287,426,159,238
061070020091,472,184,288,478,191,287,649,263,369,546,221,294
061070020092,507,213,294,509,216,293,774,315,442,563,218,307
061070020093,297,126,171,298,128,170,435,179,250,333,138,172
061070010051,1138,341,797,1154,344,810,1520,521,979,1205,390,749
061070020061,561,195,366,560,196,364,746,292,439,650,204,415
061070020081,401,148,253,403,151,252,586,237,332,416,180,215
061070020082,319,115,204,322,119,203,412,167,233,345,146,185
061070020062,674,233,441,680,233,447,830,338,467,726,244,434
061070020063,685,233,452,691,231,460,869,349,502,743,202,502
061070017011,155,63,92,156,64,92,246,123,115,172,72,87
061070017012,172,71,101,172,71,101,294,148,137,186,80,91
061070017014,237,97,140,238,98,140,364,172,182,291,106,163
061070019021,218,90,128,219,91,128,339,134,200,258,91,146
061070020031,369,143,226,371,147,224,519,222,288,401,155,222
061070020034,441,175,266,449,180,269,611,264,334,485,184,270
061070020035,386,154,232,393,158,235,535,230,294,411,157,228
061070019012,542,188,354,549,192,357,722,281,423,573,195,345
061070019013,284,99,185,286,100,186,350,136,206,305,102,182
061070019023,569,198,371,580,203,377,777,302,455,600,201,359
061070020032,359,136,223,365,143,222,534,221,305,441,157,248
061070020033,261,100,161,266,105,161,392,162,224,321,130,169
061070020041,299,129,170,300,132,168,409,169,231,342,137,188
061070020042,894,385,509,898,392,506,1244,509,705,997,351,586
061070020043,475,205,270,478,210,268,644,265,365,513,204,287
061070011012,105,77,28,105,74,31,146,98,48,127,89,29
061070011021,270,189,81,276,185,91,462,295,152,360,224,118
061070012001,332,128,204,340,137,203,480,212,256,393,170,199
061070010082,1278,423,855,1293,430,863,2042,751,1249,798,258,503
061070009011,166,83,83,169,82,87,251,122,126,197,76,108
061070010061,324,114,210,330,115,215,398,159,226,348,125,194
061070010062,369,130,239,373,133,240,468,186,265,398,142,224
061070010063,1015,358,657,1027,359,668,1371,540,795,1120,397,662
061070010064,428,151,277,433,152,281,517,205,302,443,155,265
061070010065,184,65,119,187,66,121,263,104,154,212,69,134
061070010081,822,264,558,837,269,568,1179,423,727,1065,316,704
061070010113,376,254,122,381,253,128,615,406,188,397,263,104
061070010102,258,185,73,258,177,81,419,308,102,277,190,60
061070011011,127,91,36,128,89,39,256,170,82,133,100,27
061070011022,218,162,56,217,152,65,372,242,107,255,179,52
061070010124,521,293,228,526,289,237,990,527,446,554,260,259
061070010101,217,147,70,220,142,78,341,234,97,241,161,65
061070010111,509,260,249,510,249,261,739,361,362,588,272,279
061070010112,884,448,436,899,437,462,1456,713,719,868,404,416
061070010071,729,255,474,736,257,479,931,361,553,764,252,474
061070010072,740,260,480,745,262,483,999,393,587,760,274,445
061070010123,658,295,363,662,284,378,993,481,486,741,263,440
061070005011,229,162,67,235,160,75,367,234,116,293,188,88
061070005013,292,229,63,295,222,73,546,364,169,304,205,85
061070005022,228,137,91,228,128,100,345,223,118,240,156,69
061070005021,299,171,128,295,163,132,471,285,179,327,178,122
061070005012,140,107,33,140,106,34,230,137,92,211,145,56
061070005014,166,127,39,170,126,44,284,171,113,248,173,68
061070004024,300,157,143,302,156,146,531,305,202,432,246,161
061070004023,319,175,144,317,175,142,454,264,187,312,196,111
061070004011,233,98,135,234,96,138,312,137,167,255,121,121
061070003033,323,111,212,327,107,220,542,230,304,359,149,194
061070004012,511,324,187,521,305,216,843,492,332,579,319,229
061070004013,377,240,137,383,226,157,580,339,230,491,334,131
061070004021,239,118,121,239,116,123,344,172,166,273,137,128
061070004022,520,279,241,529,272,257,735,365,357,586,284,267
061070010122,578,254,324,585,249,336,1077,469,573,572,241,296
061070010091,203,138,65,207,134,73,347,235,102,232,168,46
061070010092,328,223,105,330,211,119,516,347,154,351,260,69
061070013031,315,214,101,321,207,114,532,273,246,380,180,176
061070010121,479,201,278,484,197,287,732,312,401,606,258,311
061070001022,630,211,419,633,202,431,859,296,557,702,230,445
061070007011,225,164,61,229,158,71,336,222,107,247,159,74
061070007012,327,106,221,336,104,232,450,152,292,370,109,241
061070007021,272,179,93,273,168,105,392,267,116,311,211,80
061070007022,167,122,45,173,119,54,231,160,70,179,128,45
061070007023,269,204,65,275,198,77,428,275,141,325,220,84
061070007024,130,98,32,129,93,36,180,124,53,141,100,32
061070009013,99,64,35,101,64,37,150,99,50,125,84,35
061070009012,419,266,153,426,265,161,717,443,252,499,297,167
061070003032,465,111,354,469,112,357,597,179,407,524,136,363
061070008023,454,85,369,461,85,376,620,130,479,492,133,332
061070009021,431,174,257,438,164,274,668,264,387,482,165,292
061070006001,267,201,66,269,183,86,371,290,78,267,220,40
061070006002,92,79,13,94,74,20,144,117,27,140,116,16
061070006003,70,61,9,74,58,16,96,77,19,105,91,13
061070006004,190,108,82,193,105,88,314,143,171,232,121,105
061070002031,227,162,65,228,158,70,331,195,127,263,169,73
061070002032,198,133,65,200,130,70,289,181,97,323,229,83
061070002041,213,160,53,216,157,59,327,245,77,213,168,30
061070002042,233,179,54,238,176,62,353,267,82,227,184,31
061070002023,133,69,64,133,68,65,222,89,126,159,87,66
061070002033,132,89,43,132,84,48,196,126,67,164,95,63
061070008011,160,101,59,162,100,62,243,144,91,201,102,91
061070008012,164,116,48,169,113,56,258,174,80,198,115,78
061070008013,268,186,82,271,183,88,419,268,139,342,208,111
061070003042,178,50,128,177,48,129,225,74,149,178,60,109
061070003031,400,95,305,402,94,308,626,165,451,422,131,273
061070003041,201,91,110,202,90,112,305,116,181,219,75,135
061070003043,173,50,123,175,50,125,219,82,137,171,59,111
061070003021,133,30,103,134,30,104,165,62,101,151,44,104
061070003022,177,49,128,175,47,128,261,87,172,158,53,101
061070009023,209,40,169,209,36,173,258,82,169,238,49,177
061070009022,13,2,11,13,2,11,22,7,15,20,5,14
061070002022,153,50,103,152,48,104,183,76,107,156,88,62
061070003023,111,22,89,114,26,88,153,67,83,120,30,87
061070008021,140,69,71,141,69,72,186,104,81,167,49,115
061070008022,424,91,333,423,82,341,462,158,297,437,104,315
061070002021,117,43,74,119,42,77,137,62,74,112,63,49
061070036023,291,171,120,293,164,129,552,242,302,428,222,174
061070041031,164,106,58,165,101,64,299,187,99,244,163,65
061070041032,304,201,103,309,190,119,582,360,190,431,282,120
061070041041,92,60,32,94,60,34,167,107,57,129,87,37
061070041033,91,59,32,92,58,34,138,91,47,110,75,34
061070038023,253,148,105,258,144,114,393,213,172,304,159,135
061070039043,137,76,61,137,74,63,218,127,84,183,93,76
061070039032,153,76,77,158,75,83,250,146,95,189,97,84
061070041042,120,74,46,122,74,48,197,112,81,161,85,69
061070035011,391,139,252,395,146,249,537,224,308,456,173,265
061070036024,534,207,327,539,205,334,800,333,446,613,216,370
061070034021,336,131,205,344,137,207,650,247,386,483,211,246
061070039041,112,64,48,113,63,50,187,117,67,155,62,85
061070039042,127,68,59,130,69,61,226,111,112,166,86,73
061070041043,184,101,83,183,100,83,307,225,77,219,117,88
061070041021,299,164,135,301,164,137,557,248,297,372,204,153
061070035042,523,247,276,526,243,283,784,377,391,619,280,303
061070036021,301,147,154,302,149,153,529,258,258,429,225,183
061070037004,237,119,118,238,116,122,395,181,200,386,184,181
061070038012,300,145,155,301,148,153,491,228,247,379,186,166
061070038021,202,98,104,212,101,111,385,202,179,274,141,114
061070038022,114,58,56,116,56,60,229,116,105,133,73,55
061070039031,240,118,122,245,114,131,376,216,152,336,173,150
061070039021,490,170,320,497,171,326,702,266,422,563,193,343
061070040001,2,1,1,2,1,1,18,7,11,3,2,1
061070034013,277,93,184,284,96,188,293,122,170,323,140,164
061070035041,268,105,163,269,106,163,447,179,262,290,131,145
061070035033,360,164,196,364,165,199,593,255,321,427,178,228
061070035032,473,228,245,476,224,252,815,391,410,554,272,249
061070036013,303,147,156,307,142,165,526,220,295,378,169,191
061070036011,475,231,244,473,219,254,649,315,319,559,235,289
061070036014,279,134,145,280,130,150,504,240,253,325,141,166
061070036022,143,70,73,146,73,73,244,117,124,204,114,80
061070038011,229,109,120,228,110,118,383,176,197,275,135,126
061070035043,405,190,215,406,188,218,680,326,340,524,235,259
061070037001,296,142,154,298,136,162,501,234,257,379,183,171
061070037003,355,168,187,362,167,195,596,285,298,476,217,225
061070035012,459,138,321,462,142,320,642,255,380,506,170,317
061070036012,459,204,255,460,195,265,708,296,397,518,236,252
061070035031,382,187,195,386,184,202,671,324,336,492,185,283
061070037002,188,93,95,188,88,100,357,183,165,242,115,113
061070043012,257,222,35,263,222,41,307,259,41,311,267,26
061070027011,282,71,211,283,72,211,380,109,269,284,65,208
061070027022,283,72,211,285,74,211,355,93,259,323,85,222
061070027023,676,201,475,679,206,473,958,277,662,772,193,538
061070027024,300,127,173,301,132,169,434,166,254,345,90,237
061070034022,234,68,166,235,69,166,310,100,205,270,84,169
061070045005,316,112,204,320,113,207,481,208,261,401,155,224
061070045001,245,80,165,249,82,167,323,135,186,263,105,153
061070045004,282,100,182,283,101,182,385,111,270,340,134,193
061070045002,123,54,69,122,52,70,176,94,78,139,54,80
061070045003,101,43,58,101,43,58,143,78,65,104,43,60
061070039024,75,37,38,76,37,39,106,56,48,98,38,54
061070039022,145,82,63,148,82,66,285,161,121,226,92,123
061070039023,108,62,46,108,62,46,218,125,89,153,61,84
061070027012,263,59,204,268,61,207,361,98,255,263,70,184
061070034011,191,122,69,192,117,75,355,216,127,247,157,75
060330011021,520,314,206,526,306,220,712,407,286,492,250,198
060330013021,136,69,67,142,67,75,182,85,91,202,79,104
060330013023,322,172,150,332,163,169,443,215,214,382,163,180
060330013025,125,70,55,128,67,61,168,87,78,143,66,67
060330012004,382,199,183,385,192,193,526,265,248,468,219,208
060330013011,463,239,224,468,226,242,650,323,314,524,247,238
060330013012,789,424,365,803,399,404,1044,540,483,816,396,366
060330013022,472,230,242,487,223,264,594,294,285,451,210,207
060330013024,235,119,116,247,118,129,397,191,195,319,144,154
060330012002,309,151,158,317,149,168,456,203,240,287,118,145
060330012003,200,94,106,204,94,110,302,135,161,236,97,123
060330012001,306,153,153,308,153,155,481,222,245,403,178,194
060330008011,355,211,144,358,205,153,531,305,201,417,230,153
060330007023,3,0,3,3,0,3,3,0,3,3,0,2
060330008012,283,159,124,285,151,134,411,204,186,332,158,136
060330008022,204,119,85,210,116,94,327,176,140,270,137,104
060330006022,177,97,80,182,96,86,220,119,95,160,80,67
060330007032,358,198,160,364,194,170,495,255,218,469,232,195
060330007041,336,205,131,346,205,141,447,264,175,454,242,169
060330007042,147,88,59,151,86,65,208,121,80,201,104,77
060330007031,244,151,93,246,145,101,335,190,137,252,142,87
060330008024,117,62,55,118,60,58,171,87,81,139,66,65
060330008021,202,113,89,204,112,92,335,179,146,262,125,107
060330008023,215,123,92,217,121,96,346,183,153,296,151,116
060330007021,401,254,147,405,244,161,626,365,250,516,279,194
060330007022,410,250,160,412,243,169,600,331,254,498,289,177
060330006023,295,135,160,296,129,167,401,184,205,358,147,181
060330001001,606,294,312,619,284,335,871,379,470,721,289,355
060330001002,269,122,147,276,117,159,371,157,210,323,120,172
060330005022,230,124,106,236,123,113,309,164,139,287,136,119
060330001003,401,192,209,409,190,219,556,268,272,452,190,223
060330005021,468,236,232,476,238,238,683,364,306,562,264,239
060330005011,449,246,203,453,240,213,641,318,310,560,256,251
060330005012,505,288,217,512,294,218,653,356,280,566,274,240
060330006021,295,166,129,304,170,134,398,229,159,339,168,141
060330006012,341,184,157,348,179,169,465,247,209,384,181,176
060330006011,322,172,150,322,165,157,453,225,217,364,186,154
060330004011,549,291,258,565,280,285,722,373,327,659,288,297
060330004012,321,166,155,327,156,171,425,237,180,344,145,164
060330004013,305,160,145,313,159,154,422,229,182,354,152,172
060330004022,573,330,243,584,315,269,790,417,356,641,337,245
060330003001,610,258,352,615,242,373,751,324,409,700,271,367
060330004021,313,178,135,315,171,144,444,234,201,362,196,135
060330003002,541,280,261,554,282,272,731,386,327,623,273,297
060330003003,222,115,107,225,116,109,291,155,131,250,113,120
060330010004,314,143,171,314,136,178,395,176,210,348,143,179
060330010002,256,131,125,254,122,132,395,201,179,284,126,133
060330010003,183,95,88,186,89,97,236,110,122,219,97,106
060330009021,713,399,314,726,392,334,950,541,393,823,418,337
060330010001,289,157,132,293,146,147,372,183,177,324,151,144
060330010006,302,161,141,305,159,146,429,214,200,339,170,139
060330009022,487,267,220,494,262,232,618,346,257,532,267,225
060330011012,261,134,127,267,128,139,337,166,166,287,129,129
060330009023,443,222,221,451,216,235,618,326,271,543,248,245
060330010005,391,236,155,398,226,172,542,310,220,476,250,176
060330009011,555,333,222,561,313,248,781,426,335,599,305,236
060330009012,635,342,293,644,319,325,864,451,395,756,349,342
060330011011,334,199,135,335,190,145,469,260,191,410,211,162
060330011022,326,192,134,324,186,138,407,239,158,451,248,169
060250122013,242,217,25,243,202,41,413,310,95,412,362,41
060250122022,433,384,49,434,359,75,723,536,167,780,676,74
060250122021,190,167,23,191,160,31,325,239,78,324,294,21
060250121021,178,153,25,180,145,35,326,240,81,308,264,35
060250121011,299,258,41,306,242,64,523,383,126,495,423,51
060250121012,266,236,30,265,213,52,479,362,108,428,382,36
060250122012,302,264,38,302,248,54,576,390,172,550,472,54
060250122011,208,182,26,209,172,37,407,278,121,355,304,34
060250120042,682,575,107,683,541,142,1232,891,305,1102,942,113
060250119021,113,99,14,113,92,21,203,146,52,193,167,19
060250119022,770,688,82,773,639,134,1372,991,342,1207,1063,96
060250120011,530,469,61,533,436,97,959,712,228,959,853,70
060250120041,318,282,36,323,263,60,700,504,182,497,436,42
060250120012,132,116,16,133,109,24,240,173,56,238,208,18
060250121022,284,250,34,286,236,50,467,322,132,437,393,29
060250119012,272,232,40,274,222,52,536,372,151,462,388,51
060250120032,340,283,57,340,265,75,549,392,148,542,447,77
060250119032,455,372,83,457,354,103,840,566,257,742,602,100
060250120031,469,388,81,472,367,105,846,581,252,716,586,102
060250121023,212,187,25,212,176,36,341,242,92,307,275,23
060250119011,91,64,27,91,63,28,135,92,41,290,235,39
060259400003,68,48,20,69,47,22,127,86,40,100,64,31
060250124001,75,32,43,77,31,46,135,54,75,108,43,60
060259400002,36,28,8,37,28,9,87,64,21,59,38,18
060250116001,398,247,151,394,231,163,640,386,242,501,306,174
060250118011,567,352,215,567,330,237,787,472,295,801,488,262
060250118022,493,303,190,489,284,205,764,455,289,645,391,220
060250118012,831,409,422,845,386,459,1260,630,622,993,474,463
060250118021,242,151,91,244,143,101,440,264,162,336,212,102
060250116002,307,232,75,312,218,94,588,393,176,602,452,117
060250116003,156,112,44,156,105,51,233,154,79,218,164,47
060250116004,351,259,92,354,237,117,559,386,167,447,338,85
060250114002,89,66,23,85,58,27,168,115,49,187,143,35
060250117001,458,334,124,456,307,149,737,496,218,673,508,134
060250117003,441,307,134,442,285,157,656,432,210,598,428,138
060250118032,333,194,139,335,186,149,589,340,232,474,284,162
060250117002,319,188,131,322,184,138,513,293,212,420,245,149
060250118023,535,295,240,536,278,258,774,428,334,647,382,228
060250118033,561,335,226,573,333,240,959,535,409,761,467,258
060250123012,177,66,111,178,60,118,275,124,145,250,108,130
060250111001,167,54,113,172,48,124,286,101,177,249,97,143
060250113031,490,367,123,488,355,133,961,637,310,864,702,125
060250113011,436,359,77,440,342,98,824,567,240,691,576,76
060250113012,213,185,28,214,170,44,420,302,103,213,180,22
060250111002,293,97,196,295,96,199,395,140,248,354,140,206
060250118031,513,289,224,515,279,236,919,505,405,632,372,239
060250112011,299,218,81,302,200,102,535,346,179,779,600,145
060250115004,248,184,64,252,167,85,443,287,140,236,178,46
060250112021,285,233,52,287,221,66,530,396,122,489,417,57
060250112022,137,112,25,138,106,32,261,194,61,248,208,28
060250112013,519,294,225,523,280,243,883,480,386,672,388,256
060250112023,142,105,37,142,98,44,284,194,81,265,202,48
060250112024,162,120,42,159,110,49,358,243,102,244,187,44
060250115001,153,121,32,153,113,40,347,248,91,63,50,11
060250115002,157,116,41,155,106,49,295,202,85,245,185,45
060250115003,179,145,34,181,135,46,333,244,85,335,277,45
060250110026,470,200,270,476,184,292,682,296,378,534,224,286
060250110013,380,215,165,387,198,189,676,366,296,517,279,212
060250110012,430,247,183,435,232,203,742,407,314,528,294,205
060250110022,157,92,65,160,88,72,255,143,106,337,191,128
060250110021,192,113,79,195,106,89,338,189,140,211,121,82
060250110023,382,213,169,386,201,185,679,357,306,553,299,219
060250110024,230,135,95,232,126,106,412,219,184,288,160,111
060250110025,780,396,384,789,383,406,1681,823,822,1075,554,453
060250110011,307,153,154,311,153,158,603,292,303,406,211,172
060250112014,407,250,157,409,239,170,947,549,378,452,281,147
060250112012,539,300,239,540,287,253,859,470,374,690,392,268
060250103001,347,134,213,348,126,222,470,208,254,473,224,221
060250111003,220,158,62,221,146,75,441,275,146,434,301,92
060250105002,294,123,171,299,112,187,402,180,215,353,144,189
060250105003,277,163,114,280,151,129,474,267,188,394,234,135
060250104011,88,60,28,89,57,32,146,94,52,155,107,41
060250105001,138,92,46,141,87,54,246,154,88,187,126,50
060250106001,258,176,82,264,169,95,438,282,153,375,248,107
060250106002,231,154,77,233,142,91,465,265,195,276,182,82
060250104012,248,176,72,250,164,86,448,284,151,340,244,75
060250105005,416,295,121,422,277,145,716,460,239,544,391,121
060250105004,142,101,41,143,94,49,258,165,88,197,142,43
060250106003,639,168,471,647,163,484,824,229,581,718,186,496
060250106004,354,182,172,357,174,183,623,303,308,370,193,156
060250106005,505,228,277,513,224,289,750,355,381,601,268,299
060250107003,233,184,49,236,170,66,424,292,118,321,257,50
060250104022,218,177,41,219,162,57,252,178,71,270,217,43
060250107001,241,183,58,243,170,73,390,266,111,393,283,89
060250101022,178,127,51,178,106,72,296,180,108,246,168,68
060250101023,200,144,56,205,120,85,337,208,123,267,176,75
060250101024,175,125,50,174,100,74,266,161,97,240,156,65
060250102001,252,133,119,261,118,143,331,186,140,305,187,108
060250102002,244,157,87,241,136,105,325,203,113,300,208,81
060250101021,218,108,110,219,103,116,324,171,151,321,171,135
060250101011,150,67,83,151,66,85,207,110,93,170,71,90
060250124002,44,24,20,44,20,24,71,39,31,56,27,26
060250124003,36,13,23,36,13,23,48,22,26,36,13,22
060250123011,179,92,87,182,89,93,330,182,138,342,175,152
060250123022,183,98,85,184,97,87,352,198,145,190,85,94
060250123023,179,80,99,179,74,105,313,160,147,251,122,123
060250123021,115,61,54,116,58,58,201,125,70,158,96,57
060250104021,254,216,38,259,195,64,427,309,111,368,301,53
060250104023,252,217,35,253,195,58,671,491,165,369,299,53
060250107002,229,182,47,231,170,61,349,254,91,328,260,50
060250119031,481,413,68,482,389,93,975,670,288,834,704,93
060250114001,221,181,40,222,174,48,415,310,100,498,411,63
060250114003,362,298,64,371,293,78,667,486,166,439,372,44
060250113021,220,147,73,221,139,82,360,201,152,363,246,100
060250113032,234,122,112,236,118,118,254,144,106,403,224,157
060250109001,417,207,210,424,193,231,590,296,282,486,253,208
060250109002,287,169,118,290,158,132,445,251,183,372,220,126
060250109003,265,162,103,265,149,116,379,223,153,344,214,110
060250109004,227,145,82,229,133,96,336,214,119,325,222,90
060250109005,157,102,55,158,91,67,227,144,80,204,140,54
060250109006,113,72,41,112,66,46,168,108,60,140,99,37
060250108001,159,50,109,159,41,118,301,107,191,148,54,90
060250108002,256,88,168,261,82,179,384,140,232,322,116,184
060259400001,80,42,38,78,38,40,133,80,52,114,56,50
060510001021,181,71,110,181,71,110,277,109,157,241,75,152
060510001022,295,108,187,294,107,187,397,156,226,330,106,203
060510001023,214,70,144,215,67,148,242,94,141,232,79,146
060510001011,607,248,359,611,241,370,877,364,479,473,124,312
060510001012,306,159,147,305,158,147,388,223,153,309,153,134
060510001024,196,124,72,199,129,70,268,179,76,218,126,72
060510001013,297,206,91,301,207,94,343,238,98,464,290,148
060510001014,390,228,162,392,222,170,506,300,195,415,229,157
060510002011,587,385,202,600,384,216,869,601,235,670,422,200
060510002025,213,137,76,214,130,84,302,200,96,243,141,82
060510002021,426,271,155,431,262,169,640,410,210,472,268,162
060510002024,297,196,101,302,192,110,463,321,123,326,210,90
060510002012,174,116,58,175,115,60,254,183,70,191,123,54
060510002022,178,122,56,178,120,58,288,200,80,201,123,60
060510002023,209,144,65,211,143,68,289,203,83,223,136,67
060510002013,242,163,79,244,158,86,334,232,91,263,168,72
060770022011,157,142,15,159,142,17,287,223,57,240,215,20
060770023002,183,154,29,183,152,31,299,232,59,227,183,25
060770021003,240,200,40,242,187,55,308,220,68,290,231,43
060770021004,218,184,34,219,172,47,304,224,69,301,252,42
060770022012,237,214,23,240,212,28,454,361,89,351,322,22
060770022021,197,160,37,200,159,41,342,257,74,289,245,35
060770023001,191,164,27,192,159,33,347,270,73,286,238,35
060770023003,174,152,22,179,150,29,337,272,65,248,217,27
060770025031,169,138,31,172,134,38,307,243,60,212,174,28
060770025032,164,133,31,166,132,34,354,273,70,277,237,34
060770025041,328,256,72,333,261,72,573,435,109,449,378,55
060770024013,278,226,52,279,211,68,481,375,95,410,340,44
060770024021,202,159,43,205,148,57,312,235,70,274,232,32
060770024022,134,113,21,134,108,26,226,175,47,178,154,19
060770024011,233,203,30,234,205,29,438,340,86,300,264,26
060770024012,163,134,29,165,127,38,258,205,53,292,256,29
060770003002,99,78,21,100,77,23,194,139,43,121,96,19
060770007003,110,86,24,109,84,25,166,129,37,166,130,27
060770007004,184,143,41,185,141,44,358,269,81,282,222,45
060770019002,216,187,29,213,181,32,294,225,69,285,267,12
060770020001,183,160,23,186,157,29,300,214,69,279,238,26
060770020002,156,137,19,160,136,24,243,178,59,246,216,22
060770038042,340,261,79,342,248,94,579,439,133,438,356,70
060770038052,418,321,97,419,307,112,705,524,174,539,431,88
060770001023,96,75,21,95,69,26,183,135,41,137,106,25
060770001011,46,38,8,49,38,11,109,80,25,78,58,13
060770006001,72,59,13,75,56,19,137,104,33,98,84,12
060770006002,86,70,16,85,67,18,158,121,37,133,115,14
060770001021,109,81,28,112,79,33,276,208,61,201,143,46
060770001012,94,69,25,91,64,27,198,147,46,114,88,19
060770003001,267,185,82,268,178,90,367,275,81,280,192,68
060770004012,148,103,45,150,99,51,201,147,46,171,114,41
060770004014,190,132,58,197,130,67,251,194,57,187,136,47
060770009002,274,191,83,278,185,93,437,289,137,365,250,95
060770008033,247,201,46,247,194,53,387,298,79,318,260,46
060770008032,280,229,51,280,221,59,456,356,94,349,288,50
060770004021,153,119,34,155,120,35,279,207,62,214,163,39
060770004022,143,109,34,145,110,35,240,178,53,188,138,35
060770004023,134,104,30,136,106,30,232,172,53,202,156,39
060770004024,310,227,83,314,225,89,431,307,113,399,285,92
060770038061,404,314,90,410,308,102,670,482,174,511,398,93
060770038062,380,298,82,384,290,94,648,484,149,494,401,77
060770038051,259,197,62,263,194,69,476,352,114,372,305,56
060770038032,338,255,83,348,255,93,558,397,147,470,317,126
060770001022,85,61,24,86,64,22,211,155,49,101,78,16
060770005001,172,121,51,174,121,53,301,229,72,242,175,60
060770005002,80,59,21,82,60,22,163,124,39,140,102,33
060770017003,134,96,38,134,95,39,211,149,60,178,146,27
060770018001,221,149,72,220,142,78,375,263,94,306,193,88
060770018002,274,184,90,278,174,104,446,333,108,372,258,95
060770019001,187,152,35,187,148,39,320,241,75,274,221,39
060770019003,159,128,31,163,125,38,233,177,56,211,174,35
060770019004,104,80,24,104,81,23,173,131,41,159,129,23
060770020003,221,171,50,225,170,55,353,264,81,318,239,61
060770016002,104,75,29,104,73,31,208,152,50,152,107,38
060770004011,221,159,62,224,157,67,276,188,78,251,170,65
060770004013,431,307,124,434,302,132,586,403,173,471,325,122
060770028001,272,212,60,274,209,65,459,357,89,374,292,68
060770028003,269,207,62,268,206,62,469,366,90,384,297,71
060770028004,234,187,47,236,186,50,443,339,88,339,278,49
060770038033,314,151,163,319,156,163,461,232,215,396,197,174
060770010002,328,179,149,330,175,155,582,330,242,441,241,180
060770010004,341,162,179,341,160,181,431,239,180,405,180,203
060770011023,201,113,88,202,110,92,339,212,116,245,159,76
060770011025,190,113,77,192,107,85,269,164,98,218,140,67
060770038043,365,271,94,367,265,102,566,427,128,449,326,108
060770038071,265,197,68,269,194,75,444,334,101,345,266,66
060770038072,220,163,57,222,160,62,393,293,89,284,220,53
060770038031,183,113,70,184,112,72,274,156,113,213,142,57
060770021001,223,194,29,226,194,32,373,277,80,317,280,23
060770021002,185,154,31,186,154,32,276,206,61,256,221,24
060770007001,105,84,21,108,82,26,192,152,40,143,112,22
060770007002,135,108,27,136,106,30,256,202,54,184,142,27
060770038081,377,298,79,382,292,90,638,468,153,504,380,98
060770038083,269,212,57,272,209,63,419,317,96,348,278,56
060770038082,328,261,67,332,254,78,585,439,132,436,344,72
060770025042,369,286,83,376,293,83,573,436,111,453,373,67
060770011011,556,328,228,562,316,246,746,473,247,621,354,220
060770011012,444,254,190,450,243,207,622,374,230,574,326,220
060770011021,316,192,124,322,185,137,480,290,177,375,218,131
060770009004,217,151,66,218,149,69,363,231,120,280,201,63
060770009005,179,124,55,181,123,58,333,210,111,245,177,52
060770009001,284,194,90,290,180,110,346,223,115,319,195,105
060770009003,299,204,95,305,190,115,393,248,129,353,212,116
060770022022,231,175,56,232,173,59,420,309,96,336,265,54
060770022023,191,167,24,194,167,27,413,328,81,256,225,21
060770028002,286,247,39,284,243,41,550,432,108,443,394,35
060770008031,388,293,95,394,280,114,610,470,123,510,412,76
060770038041,521,398,123,529,390,139,938,689,226,767,595,140
060770031081,548,315,233,556,309,247,691,421,251,594,337,224
060770031082,424,255,169,431,248,183,631,387,231,497,289,177
060770031083,430,270,160,434,259,175,636,390,232,502,296,169
060770031063,773,351,422,789,359,430,939,516,405,829,387,410
060770031061,524,278,246,532,278,254,660,372,276,551,276,251
060770031062,362,166,196,366,168,198,471,264,200,353,191,149
060770031092,706,339,367,719,335,384,905,506,370,778,393,334
060770032032,873,421,452,885,426,459,978,569,380,971,482,427
060770033072,275,188,87,279,183,96,456,278,161,361,235,102
060770033073,253,177,76,260,174,86,470,283,178,323,216,92
060770031094,587,308,279,599,309,290,859,456,376,673,361,275
060770031121,613,328,285,629,323,306,804,467,315,682,386,266
060770031122,535,276,259,548,269,279,618,396,209,611,309,279
060770033063,258,175,83,264,176,88,405,269,127,347,244,83
060770033062,188,125,63,190,122,68,342,227,109,257,182,62
060770033071,366,251,115,373,251,122,612,362,229,448,298,127
060770031102,247,157,90,246,149,97,354,252,92,274,183,75
060770033053,386,250,136,388,238,150,554,359,189,519,321,163
060770032161,430,266,164,433,253,180,645,400,227,537,356,151
060770032162,323,197,126,325,187,138,449,280,163,383,245,109
060770032171,275,172,103,279,166,113,448,273,160,352,223,100
060770032172,317,207,110,320,199,121,539,312,210,396,245,120
060770031093,354,193,161,358,189,169,495,309,168,391,212,152
060770031103,324,206,118,323,202,121,483,347,126,426,286,117
060770031111,515,314,201,522,309,213,763,467,274,613,399,180
060770033122,110,85,25,113,83,30,315,204,97,177,121,44
060770033132,119,96,23,122,98,24,357,225,119,216,155,46
060770034072,219,155,64,221,148,73,450,287,152,280,192,71
060770034071,225,157,68,227,147,80,389,255,123,293,201,74
060770034101,320,242,78,323,230,93,592,415,166,460,357,86
060770034103,267,194,73,270,185,85,492,351,134,407,314,79
060770034102,227,171,56,230,162,68,404,289,110,259,196,54
060770034104,156,119,37,156,111,45,279,197,75,209,161,38
060770012001,471,292,179,479,289,190,588,378,186,520,314,171
060770012002,414,258,156,419,251,168,537,350,174,436,269,141
060770012003,498,309,189,507,303,204,621,414,203,520,319,171
060770012004,430,266,164,431,259,172,540,361,174,443,264,154
060770041084,358,227,131,360,220,140,806,494,296,403,285,105
060770041081,397,271,126,398,264,134,743,473,254,517,378,124
060770041082,372,251,121,376,249,127,681,436,234,466,335,115
060770033051,281,169,112,285,173,112,452,290,152,348,216,117
060770033052,375,251,124,378,239,139,591,377,199,427,259,140
060770033131,228,142,86,235,140,95,355,238,114,227,168,48
060770031112,605,408,197,604,398,206,851,527,299,714,479,191
060770013001,322,206,116,325,207,118,462,306,153,381,234,114
060770013002,598,385,213,606,388,218,879,586,280,700,441,211
060770013004,119,77,42,120,78,42,198,124,68,141,87,44
060770013003,317,205,112,325,207,118,498,313,175,419,267,136
060770032031,676,352,324,681,337,344,880,504,359,807,363,397
060770032051,353,165,188,352,154,198,471,232,229,389,171,188
060770032052,670,348,322,676,332,344,922,528,369,736,369,319
060770014004,430,281,149,436,276,160,613,409,192,566,354,180
060770033081,360,236,124,364,230,134,512,338,160,318,217,88
060770014002,243,156,87,244,146,98,411,270,126,290,181,95
060770014001,236,148,88,237,139,98,368,240,112,302,184,101
060770014003,222,141,81,226,134,92,358,239,113,272,175,92
060770015011,358,228,130,359,218,141,592,362,219,286,172,91
060770035042,325,244,81,329,238,91,651,459,180,465,360,91
060770035043,473,330,143,480,322,158,759,519,229,814,608,180
060770035041,702,504,198,702,496,206,1192,805,363,681,520,142
060770031162,126,93,33,126,90,36,220,162,52,151,107,36
060770031161,150,103,47,154,103,51,241,172,64,184,129,45
060770031151,182,132,50,188,136,52,344,248,86,250,178,58
060770031152,317,232,85,320,225,95,478,349,112,416,293,97
060770031153,147,108,39,149,105,44,273,199,65,217,155,51
060770033121,145,103,42,147,97,50,211,136,71,116,84,25
060770033123,76,60,16,78,57,21,212,142,64,131,88,37
060770033061,355,222,133,361,216,145,513,350,159,454,302,124
060770031091,263,167,96,266,159,107,398,242,145,301,179,99
060770035034,675,475,200,678,457,221,1201,781,397,806,583,199
060770035032,444,314,130,444,297,147,790,524,251,581,428,131
060770035033,366,262,104,370,256,114,753,516,225,486,357,115
060770035031,192,137,55,193,129,64,343,236,103,241,176,55
060770034091,297,211,86,298,206,92,446,303,136,372,277,82
060770034092,329,234,95,336,231,105,540,363,164,453,338,95
060770034093,260,184,76,263,182,81,426,301,113,326,244,68
060770032152,350,227,123,354,210,144,478,291,173,411,225,158
060770015013,279,200,79,278,193,85,634,410,207,376,288,78
060770015021,145,95,50,146,93,53,295,198,89,407,258,108
060770016001,137,97,40,139,90,49,254,189,63,182,133,39
060770041083,610,307,303,615,297,318,1299,693,586,461,210,223
060770034031,254,180,74,257,183,74,424,295,122,333,245,75
060770034032,337,220,117,341,221,120,520,360,154,404,296,94
060770034033,385,220,165,386,215,171,525,343,169,418,287,112
060770034051,192,137,55,193,136,57,359,227,128,259,192,55
060770034052,161,115,46,163,115,48,312,197,109,211,155,44
060770034053,173,124,49,175,124,51,306,193,107,243,178,53
060770015012,264,201,63,269,197,72,373,244,114,299,243,46
060770034044,325,184,141,326,178,148,463,292,163,377,221,137
060770034041,157,115,42,158,115,43,280,174,97,194,142,39
060770034042,159,116,43,162,117,45,313,197,110,196,145,39
060770034043,252,186,66,256,186,70,484,304,170,407,240,149
060770033101,337,225,112,339,219,120,499,321,172,395,256,117
060770033102,355,238,117,359,231,128,520,332,178,448,316,115
060770033103,245,164,81,244,158,86,387,244,131,317,224,81
060770040032,750,447,303,762,440,322,1126,676,432,890,518,332
060770040042,320,186,134,325,181,144,557,341,208,365,225,119
060770040031,508,304,204,517,299,218,753,464,276,608,353,228
060770040044,518,301,217,526,293,233,771,473,286,646,393,220
060770040041,412,241,171,415,231,184,595,364,224,449,271,158
060770031181,427,234,193,433,228,205,607,361,235,495,290,178
060770031192,478,263,215,486,258,228,700,418,271,584,319,233
060770031193,581,323,258,589,320,269,778,466,299,628,348,250
060770031191,272,152,120,276,151,125,384,228,148,316,173,128
060770031182,553,304,249,563,300,263,771,459,300,638,361,243
060770031171,835,348,487,851,343,508,1166,557,587,900,392,458
060770031172,913,391,522,930,386,544,1102,528,557,1004,446,499
060770032131,297,169,128,298,161,137,445,261,176,378,241,116
060770032132,310,197,113,311,189,122,506,303,191,368,220,129
060770032133,239,152,87,242,147,95,346,212,124,252,168,71
060770032134,407,246,161,417,249,168,589,362,211,454,289,142
060770040043,582,342,240,591,326,265,1003,616,374,687,421,230
060770032192,476,272,204,480,260,220,791,470,303,594,387,177
060770032195,1029,552,477,1040,531,509,1449,886,530,1369,760,538
060770032191,590,345,245,596,330,266,936,544,377,729,392,288
060770033111,329,204,125,330,196,134,583,372,198,424,279,119
060770033112,273,169,104,279,165,114,461,296,160,362,237,103
060770032053,300,153,147,304,149,155,412,250,152,352,171,151
060770032091,418,227,191,418,220,198,602,370,217,536,266,235
060770032092,302,161,141,308,160,148,407,257,148,377,189,166
060770032093,511,270,241,517,263,254,677,423,248,631,320,272
060770040033,423,277,146,432,266,166,709,433,259,525,322,175
060770034061,346,237,109,348,233,115,547,343,200,438,317,102
060770034062,232,158,74,235,158,77,480,294,171,292,213,68
060770032181,475,248,227,479,241,238,719,425,283,546,301,209
060770032182,380,208,172,383,201,182,555,343,201,437,259,151
060770032193,413,241,172,413,236,177,615,358,248,485,286,170
060770032194,518,305,213,525,300,225,773,475,283,570,299,233
060770032151,466,271,195,468,266,202,604,371,221,512,307,186
060770032141,389,213,176,396,207,189,610,354,247,525,278,215
060770032142,735,400,335,745,401,344,1037,598,417,847,460,342
060770032101,590,343,247,606,352,254,745,460,268,706,416,255
060770032102,325,177,148,335,179,156,446,256,177,440,237,178
060770032153,118,88,30,122,87,35,215,137,73,153,111,32
060770032154,176,131,45,183,130,53,322,204,110,225,163,46
060770052081,560,334,226,569,326,243,761,455,294,574,316,227
060770052082,454,270,184,461,263,198,655,388,253,508,280,198
060770054052,390,251,139,401,251,150,559,345,200,417,257,126
060770054061,562,352,210,566,349,217,761,472,272,643,435,173
060770054031,468,274,194,478,268,210,598,380,202,486,289,158
060770054032,442,253,189,452,250,202,606,378,209,470,258,178
060770054033,593,362,231,612,352,260,795,517,258,684,395,244
060770054034,582,362,220,595,360,235,793,497,278,648,394,217
060770053033,136,81,55,139,80,59,207,123,78,157,92,51
060770053034,236,134,102,244,137,107,338,203,130,242,144,80
060770053035,200,120,80,207,119,88,288,169,107,201,116,66
060770053081,281,158,123,284,158,126,365,218,141,311,167,130
060770053082,220,127,93,227,123,104,315,188,122,249,131,100
060770053072,405,247,158,418,236,182,619,383,222,510,289,184
060770053083,253,155,98,257,148,109,376,224,143,313,198,96
060770053084,462,285,177,472,276,196,698,413,265,560,360,169
060770053031,180,117,63,185,111,74,268,163,104,217,126,71
060770053032,231,151,80,235,143,92,342,209,132,262,155,86
060770052142,585,334,251,605,341,264,1057,605,430,740,406,299
060770053091,491,300,191,501,282,219,655,414,229,538,302,199
060770053092,401,243,158,409,231,178,546,344,194,436,248,163
060770052141,1076,584,492,1089,554,535,2732,1622,1065,911,439,403
060770053101,298,197,101,307,195,112,445,282,154,277,168,88
060770053102,331,217,114,340,217,123,462,295,158,358,224,112
060770053103,309,203,106,318,202,116,409,260,139,343,220,105
060770053112,356,233,123,364,235,129,515,325,177,398,255,123
060770053111,203,132,71,207,133,74,323,205,111,257,163,79
060770053121,318,200,118,324,202,122,449,284,153,364,223,124
060770053122,446,269,177,455,271,184,623,389,219,520,310,184
060770053071,354,225,129,364,219,145,489,290,185,410,216,161
060770054053,270,187,83,273,183,90,439,266,154,343,211,103
060770054051,214,149,65,220,146,74,318,199,113,251,161,70
060770054062,245,150,95,250,148,102,337,215,119,228,145,73
060770052083,594,362,232,603,364,239,823,497,311,645,398,209
060770052163,825,495,330,839,497,342,1337,791,514,815,481,290
060770052162,367,225,142,374,224,150,487,283,192,380,227,132
060770052201,742,460,282,760,451,309,1035,626,381,753,434,266
060770052191,893,516,377,913,518,395,1351,849,482,855,488,322
060770052192,886,496,390,906,502,404,1217,719,478,958,520,379
060770052171,777,458,319,790,451,339,1150,745,382,830,486,287
060770052172,531,351,180,541,344,197,682,438,231,537,343,164
060770052084,449,261,188,455,258,197,635,397,223,501,282,185
060770053123,278,171,107,281,168,113,379,240,128,283,171,100
060770052121,986,610,376,1014,609,405,1145,723,403,1161,721,389
060770052123,731,460,271,742,450,292,1158,748,382,796,512,251
060770052252,414,191,223,422,183,239,751,376,355,386,150,216
060770052242,942,588,354,970,587,383,1176,749,402,890,548,302
060770052241,612,382,230,633,387,246,1092,702,366,739,423,273
060770052182,430,294,136,435,288,147,613,395,202,446,306,119
060770052181,606,415,191,612,405,207,891,577,295,632,422,174
060770052161,489,305,184,497,305,192,653,412,229,519,319,167
060770052132,690,376,314,702,373,329,1291,781,491,571,305,248
060770052112,618,423,195,637,417,220,873,549,295,748,507,209
060770052111,357,263,94,369,260,109,591,391,185,264,188,65
060770052113,457,336,121,469,331,138,794,528,250,553,397,134
060770052152,421,243,178,435,252,183,785,467,303,566,330,209
060770052153,661,375,286,681,389,292,609,355,244,468,261,185
060770052131,277,164,113,286,165,121,476,299,166,291,172,106
060770052122,616,415,201,625,415,210,871,573,281,531,349,158
060770042032,187,107,80,191,101,90,319,131,181,235,115,100
060770042033,274,141,133,281,134,147,443,183,257,304,144,136
060770042031,468,201,267,471,193,278,718,294,408,553,207,309
060770045011,436,146,290,438,146,292,539,212,315,491,197,267
060770045023,151,96,55,155,91,64,122,81,41,77,53,23
060770045012,287,164,123,296,153,143,534,218,301,410,202,178
060770041042,599,205,394,600,196,404,798,299,478,703,233,428
060770041043,512,178,334,519,173,346,633,238,381,552,184,336
060770041052,506,178,328,516,172,344,587,222,353,552,173,350
060770042021,946,289,657,954,282,672,1142,454,658,1037,307,679
060770041051,775,263,512,786,249,537,871,320,535,869,312,502
060770041071,601,199,402,613,199,414,1089,433,641,566,173,367
060770044021,411,194,217,414,182,232,706,345,345,504,245,232
060770044023,641,281,360,654,274,380,875,429,427,768,349,379
060770043072,376,190,186,380,178,202,606,297,295,545,208,297
060770043073,229,98,131,232,93,139,369,169,191,286,109,156
060770043081,438,223,215,444,209,235,481,236,236,331,190,122
060770043082,224,114,110,226,106,120,329,194,119,240,137,88
060770043083,3,2,1,3,1,2,133,63,67,220,126,81
060770044022,340,163,177,346,154,192,525,243,274,427,213,192
060770044041,127,82,45,126,75,51,298,155,137,207,136,54
060770043102,608,216,392,616,213,403,690,293,382,575,172,370
060770043092,551,204,347,558,199,359,700,301,386,614,214,359
060770043053,138,49,89,140,49,91,393,166,214,159,60,89
060770043052,723,260,463,732,254,478,991,424,541,992,381,544
060770043022,539,198,341,549,184,365,763,309,428,605,239,338
060770043023,531,175,356,538,170,368,737,311,409,602,194,369
060770042041,324,133,191,327,132,195,479,196,277,332,146,161
060770042042,501,204,297,510,202,308,719,299,409,614,214,358
060770042043,342,142,200,347,142,205,440,182,255,408,141,236
060770043021,415,171,244,420,171,249,515,208,291,440,189,217
060770043091,526,192,334,540,182,358,703,289,396,638,220,374
060770042051,430,136,294,434,132,302,584,220,353,494,164,298
060770042052,441,147,294,445,142,303,653,248,393,534,177,320
060770042061,568,226,342,580,206,374,852,319,509,647,232,370
060770042053,331,125,206,335,119,216,500,188,299,374,125,230
060770041041,927,313,614,936,302,634,1153,446,680,762,254,460
060770042062,607,211,396,614,202,412,823,330,473,666,213,408
060770043101,652,212,440,668,207,461,860,348,492,723,210,472
060770043054,534,200,334,541,193,348,682,291,372,641,242,355
060770043024,313,138,175,317,134,183,483,217,263,384,167,188
060770044033,287,189,98,291,175,116,185,125,60,166,114,40
060770044032,85,56,29,86,52,34,188,124,59,113,78,27
060770044031,213,139,74,216,132,84,387,256,123,315,196,91
060770044042,2,1,1,2,1,1,237,159,76,166,116,39
060770044043,92,60,32,95,57,38,267,174,83,201,126,54
060770045022,97,63,34,97,59,38,212,137,67,147,101,41
060770045021,131,86,45,127,76,51,396,257,123,259,182,69
060770043071,524,224,300,531,218,313,960,420,516,628,231,358
060770046004,495,150,345,505,147,358,380,118,256,527,153,347
060770043051,707,231,476,718,222,496,969,392,558,671,247,386
060770051341,517,275,242,525,270,255,730,366,350,591,288,272
060770051351,632,327,305,642,317,325,916,467,435,667,317,310
060770051251,334,161,173,338,156,182,466,245,206,407,175,201
060770051252,302,146,156,304,140,164,408,215,182,349,151,173
060770051344,449,217,232,456,202,254,646,322,309,487,214,235
060770051343,351,168,183,355,163,192,499,249,238,392,175,188
060770051342,301,145,156,305,141,164,415,219,185,345,148,170
060770051352,670,325,345,676,301,375,988,521,443,615,274,301
060770051261,284,164,120,290,158,132,426,217,194,331,186,124
060770051262,399,242,157,407,233,174,566,299,252,472,228,210
060770051263,326,194,132,333,186,147,497,258,228,377,203,154
060770051192,113,61,52,113,59,54,155,93,61,147,80,59
060770051233,622,348,274,635,339,296,927,500,405,707,377,289
060770051232,294,165,129,299,160,139,433,231,188,337,179,141
060770051231,302,169,133,308,164,144,451,242,196,316,181,116
060770051081,525,295,230,527,288,239,663,341,304,516,277,210
060770051083,401,248,153,403,238,165,588,311,267,445,238,184
060770051242,362,206,156,368,201,167,478,256,209,361,187,154
060770051243,337,190,147,337,184,153,499,267,217,408,213,175
060770051082,147,93,54,150,91,59,235,122,109,181,98,72
060770051241,223,142,81,228,139,89,405,219,178,309,172,119
060770051353,1120,490,630,1137,490,647,1244,580,643,930,427,453
060770051354,1683,782,901,1710,785,925,1978,991,958,1655,748,859
060770051091,368,184,184,376,183,193,505,256,229,434,194,198
060770051092,357,186,171,363,174,189,481,254,223,365,176,156
060770051401,490,247,243,500,240,260,710,364,328,595,251,300
060770051412,639,312,327,655,319,336,842,430,383,741,324,359
060770051093,179,94,85,182,88,94,258,128,124,192,89,93
060770051403,275,145,130,285,139,146,423,210,203,315,144,152
060770051374,290,157,133,296,157,139,428,239,179,325,174,128
060770051402,213,103,110,216,101,115,263,130,130,203,112,84
060770051391,496,228,268,503,219,284,674,324,338,586,249,300
060770051392,749,352,397,760,347,413,1082,553,514,887,403,443
060770051411,367,176,191,373,163,210,443,217,217,428,188,215
060770051313,470,161,309,479,155,324,702,275,408,530,216,283
060770051321,218,112,106,219,108,111,296,149,143,228,122,92
060770051322,250,137,113,253,129,124,415,224,181,313,167,127
060770051323,242,133,109,247,128,119,379,205,166,308,162,125
060770051333,174,95,79,178,92,86,259,126,123,198,105,76
060770051334,186,102,84,191,100,91,269,135,131,209,112,83
060770051372,577,316,261,590,318,272,986,491,473,691,345,317
060770051373,461,249,212,466,247,219,705,396,298,518,278,206
060770051061,985,455,530,999,447,552,1731,803,885,787,322,421
060770051362,522,275,247,532,271,261,778,421,343,615,317,272
060770051361,554,314,240,561,311,250,702,380,309,617,314,278
060770051371,650,359,291,661,352,309,1196,644,527,753,463,249
060770051062,760,415,345,777,410,367,1063,595,451,877,466,370
060770051064,1194,636,558,1208,618,590,2678,1414,1208,910,453,396
060770051223,541,289,252,550,285,265,877,455,397,423,209,190
060770051221,722,418,304,730,411,319,1118,645,452,871,489,335
060770051382,414,193,221,422,187,235,691,367,305,474,226,225
060770051381,403,195,208,406,188,218,557,312,235,492,244,223
060770051331,339,171,168,345,165,180,496,260,221,418,174,221
060770051332,495,250,245,499,238,261,664,336,306,595,258,304
060770051224,370,170,200,376,163,213,491,267,215,413,196,193
060770051222,264,122,142,273,118,155,357,194,156,293,140,135
060770049032,629,219,410,647,214,433,833,279,542,677,215,424
060770049031,443,146,297,454,145,309,543,179,351,486,158,295
060770049041,416,140,276,424,137,287,603,198,394,472,154,292
060770049051,478,149,329,487,146,341,704,195,495,528,155,345
060770049063,324,77,247,332,59,273,414,85,322,355,88,246
060770049042,494,172,322,506,164,342,644,215,417,544,165,349
060770049043,415,144,271,415,135,280,668,216,436,442,141,273
060770049044,421,161,260,427,155,272,569,187,371,442,176,243
060770050013,469,141,328,479,130,349,622,199,411,531,127,377
060770050014,690,207,483,704,200,504,882,293,570,654,168,442
060770050011,522,151,371,528,149,379,596,186,402,426,115,282
060770050012,910,263,647,930,268,662,1095,317,760,965,222,690
060770050033,794,218,576,800,206,594,1018,299,697,881,218,610
060770050041,676,191,485,688,185,503,937,291,628,747,198,505
060770050042,671,218,453,679,211,468,965,297,648,682,220,414
060770050043,420,136,284,428,132,296,577,192,373,483,126,327
060770050044,619,164,455,629,166,463,829,243,564,645,175,432
060770050034,563,165,398,571,160,411,949,307,623,537,166,352
060770050032,781,238,543,788,229,559,1057,352,681,836,241,550
060770051272,381,249,132,389,245,144,627,398,216,545,368,152
060770051273,487,316,171,493,309,184,806,508,277,645,420,179
060770051271,502,328,174,505,318,187,855,539,297,562,372,161
060770051291,336,218,118,343,209,134,524,331,179,397,260,118
060770051292,569,369,200,576,351,225,901,570,306,722,447,229
060770051301,205,133,72,208,126,82,304,193,103,249,152,79
060770051302,433,281,152,441,267,174,664,417,224,549,325,188
060770051191,643,461,182,656,452,204,1188,800,366,822,576,209
060770051193,895,596,299,909,585,324,1545,997,518,1047,683,316
060770051194,370,270,100,378,262,116,675,455,209,610,442,144
060770015023,192,125,67,189,120,69,351,210,139,265,173,76
060770015022,105,67,38,106,67,39,225,134,87,141,95,42
060770017001,133,85,48,133,84,49,242,146,93,192,129,54
060770008021,165,143,22,163,133,30,306,231,73,210,171,35
060770017002,183,133,50,185,131,54,294,214,77,249,177,59
060770027011,121,87,34,124,87,37,203,132,69,174,107,55
060770037003,91,62,29,92,62,30,238,138,91,152,85,59
060770037002,224,125,99,226,121,105,387,218,163,291,153,127
060770048004,667,187,480,676,175,501,863,274,578,798,238,525
060770049062,383,96,287,385,84,301,504,138,356,397,102,279
060770051311,216,94,122,221,85,136,362,169,178,275,151,113
060770011013,427,249,178,435,239,196,657,393,249,529,314,191
060770011022,302,186,116,308,179,129,442,259,164,360,209,127
060770011024,226,140,86,230,135,95,348,211,134,274,166,91
060770027012,153,103,50,155,99,56,239,154,81,195,125,61
060770027013,265,178,87,268,173,95,448,283,150,350,224,108
060770027014,357,233,124,360,223,137,565,368,192,512,344,154
060770037001,209,135,74,215,133,82,375,223,148,297,171,114
060770010001,313,179,134,316,168,148,490,274,208,419,235,155
060770010003,580,306,274,583,294,289,825,460,345,713,363,303
060770031101,386,195,191,386,187,199,526,301,199,462,229,201
060770035021,412,169,243,417,163,254,579,227,339,486,166,302
060770036011,285,91,194,291,86,205,483,150,322,339,123,196
060770036012,354,129,225,361,121,240,478,192,282,419,155,251
060770036013,217,83,134,220,80,140,300,113,183,264,95,157
060770036014,301,106,195,303,98,205,407,132,265,364,145,199
060770036021,356,106,250,365,100,265,507,157,339,421,107,299
060770036022,224,71,153,227,67,160,374,116,248,276,80,182
060770047044,464,137,327,472,123,349,594,175,411,508,172,310
060770027021,184,129,55,189,125,64,301,196,102,256,188,54
060770027022,193,135,58,194,128,66,319,200,105,278,203,63
060770027023,191,134,57,196,129,67,346,219,115,265,187,69
060770035023,322,135,187,325,130,195,369,169,195,340,171,146
060770035022,357,146,211,364,141,223,483,193,283,436,182,234
060770048001,381,106,275,386,99,287,459,145,310,380,112,250
060770048002,672,186,486,682,166,516,857,267,571,787,203,541
060770048003,334,86,248,336,81,255,463,145,311,358,106,234
060770047041,428,113,315,439,106,333,551,161,380,451,139,285
060770035011,619,243,376,628,245,383,884,352,521,691,305,353
060770035012,553,218,335,562,219,343,774,307,452,585,232,329
060770036023,318,120,198,322,114,208,434,133,289,358,129,205
060770041072,425,140,285,423,135,288,515,193,316,512,172,315
060770046001,439,141,298,444,132,312,911,319,582,523,162,339
060770046005,293,90,203,295,88,207,413,134,270,345,100,225
060770047011,371,114,257,381,112,269,568,165,386,458,136,301
060770047012,545,170,375,560,167,393,762,219,524,638,192,419
060770047043,522,154,368,524,136,388,683,197,472,615,154,432
060770047031,556,142,414,568,136,432,562,162,395,606,146,429
060770047042,544,135,409,551,130,421,719,210,498,622,151,444
060770046003,552,163,389,561,149,412,596,166,423,637,190,413
060670095011,463,164,299,471,157,314,663,248,395,515,193,288
060770041061,344,94,250,346,94,252,613,230,374,377,118,244
060770041062,342,83,259,347,84,263,446,145,292,388,99,273
060770040011,357,153,204,362,141,221,492,182,297,428,179,229
060770040012,275,135,140,278,125,153,335,167,164,318,155,147
060770046002,423,103,320,430,103,327,596,214,374,458,118,322
060770047032,513,131,382,525,122,403,738,210,514,539,138,370
060770047033,440,113,327,450,108,342,655,185,464,519,133,359
060770041054,538,185,353,548,176,372,777,284,476,582,208,331
060770041053,366,127,239,370,118,252,499,183,306,399,142,238
060670094061,501,146,355,506,140,366,621,185,424,490,143,318
060770052151,501,215,286,507,212,295,718,322,381,604,262,305
060770055021,374,159,215,383,160,223,822,432,376,412,180,211
060770055022,335,133,202,341,126,215,457,193,258,371,153,200
060770055032,174,66,108,179,65,114,358,129,223,195,70,115
060770055033,177,69,108,180,66,114,81,31,50,184,66,110
060770052251,238,113,125,241,104,137,320,162,154,304,149,133
060770052233,271,107,164,280,105,175,422,186,221,309,118,176
060770052211,1401,956,445,1419,952,467,2522,1704,762,918,621,249
060770052212,522,361,161,528,357,171,885,602,267,572,383,154
060770052221,524,363,161,535,355,180,845,572,252,1464,994,388
060770052222,563,389,174,565,384,181,983,661,304,535,352,148
060770052231,689,473,216,696,459,237,1652,1113,500,719,504,176
060770052232,156,107,49,152,103,49,661,446,207,128,95,31
060770051312,510,171,339,512,160,352,652,231,410,561,166,367
060770049061,272,68,204,275,57,218,336,81,250,293,82,197
060770050031,402,95,307,410,84,326,554,140,400,456,108,331
060770049053,308,62,246,314,62,252,422,106,310,369,70,272
060770049052,354,91,263,362,88,274,523,135,377,351,95,232
060770039001,156,72,84,155,70,85,196,82,108,164,74,80
060770039002,161,50,111,168,47,121,230,99,127,199,73,118
060670094062,542,165,377,552,157,395,728,214,497,610,182,393
060779800001,2,1,1,2,1,1,3,1,2,2,1,1
060930002001,335,89,246,335,91,244,425,121,298,419,106,287
060930003001,705,187,518,712,180,532,1059,278,754,853,206,601
060930001001,323,65,258,325,61,264,424,118,299,411,87,297
060930002002,143,34,109,142,34,108,140,35,105,164,35,119
060930003002,448,119,329,455,113,342,604,157,430,550,130,382
060930003003,504,179,325,512,169,343,815,262,536,625,233,357
060930007011,595,156,439,601,150,451,602,173,419,723,159,520
060930012002,387,151,236,387,136,251,437,181,248,399,139,228
060930012001,295,120,175,299,111,188,353,149,197,283,101,159
060930011001,271,155,116,276,147,129,268,143,117,289,154,112
060930011003,350,213,137,353,203,150,447,265,165,358,182,139
060930009012,791,432,359,793,417,376,917,495,404,827,402,357
060930010032,480,297,183,493,293,200,653,393,236,460,252,149
060930010033,671,427,244,687,423,264,853,535,295,695,399,226
060930010034,345,200,145,349,198,151,378,228,142,341,176,124
060930010021,875,489,386,886,477,409,1135,591,518,904,405,416
060930010011,589,302,287,594,292,302,823,402,404,596,268,277
060930009023,236,91,145,236,87,149,196,78,117,251,82,151
060930009014,237,132,105,237,126,111,337,162,161,266,123,119
060930007013,564,138,426,573,128,445,719,174,525,560,119,409
060930007014,295,78,217,297,74,223,189,44,144,145,32,109
060930009021,158,59,99,155,54,101,187,74,113,231,103,118
060930009022,1042,466,576,1053,441,612,1469,686,750,1164,463,624
060930009011,237,136,101,237,129,108,308,158,142,254,123,112
060930007023,429,161,268,431,152,279,567,216,332,485,152,291
060930013004,330,118,212,332,114,218,388,132,251,424,128,265
060930013001,376,163,213,385,160,225,489,192,287,461,159,260
060930013003,209,73,136,212,71,141,292,101,183,267,87,160
060930006002,435,128,307,440,125,315,552,171,367,484,115,340
060930007012,433,142,291,435,133,302,624,208,405,528,144,354
060930007021,564,226,338,577,215,362,669,241,413,654,212,391
060930007033,515,174,341,521,167,354,734,251,466,608,175,388
060930008003,268,84,184,274,83,191,544,175,357,462,127,300
060930008002,286,107,179,287,107,180,345,125,213,295,96,180
060930011002,233,141,92,236,136,100,296,181,109,284,145,109
060930010031,523,334,189,540,329,211,682,424,244,543,303,178
060930009013,136,78,58,137,75,62,209,103,98,163,78,73
060930009015,157,91,66,160,87,73,339,147,183,169,81,76
060930007022,328,105,223,329,101,228,474,154,307,397,108,262
060930007032,436,165,271,442,159,283,570,215,330,484,169,283
060930007031,255,96,159,254,92,162,337,129,200,306,102,182
060930008004,587,177,410,592,173,419,769,239,510,634,161,431
060930013002,141,58,83,142,54,88,194,71,118,175,50,106
060930008001,220,79,141,223,79,144,277,92,177,260,84,159
060930006001,226,76,150,228,72,156,361,124,221,262,79,161
060830015001,807,488,319,823,499,324,1003,668,311,763,473,253
060830017061,758,472,286,772,472,300,1045,710,306,852,528,273
060830017063,264,167,97,270,164,106,354,240,106,306,186,104
060830015002,430,237,193,442,247,195,509,338,160,457,272,159
060830017064,364,246,118,371,244,127,457,320,127,411,274,114
060830007003,608,397,211,623,402,221,709,514,181,553,356,154
060830005011,929,682,247,951,696,255,925,710,200,998,715,228
060830005012,788,577,211,813,585,228,867,678,171,804,572,182
060830007002,791,543,248,809,547,262,923,677,225,788,534,198
060830001021,883,631,252,906,644,262,1159,858,279,948,665,214
060830018001,474,160,314,484,157,327,465,154,297,540,175,326
060830016011,542,337,205,553,332,221,687,483,189,494,310,149
060830016012,949,618,331,966,602,364,1297,934,336,1071,708,286
060830016013,961,618,343,987,624,363,1618,1163,419,1029,646,316
060830017041,579,395,184,589,395,194,741,524,197,1048,737,251
060830017062,546,341,205,560,336,224,670,468,186,581,363,181
060830016042,305,221,84,311,219,92,402,290,105,358,253,84
060830017065,374,253,121,381,249,132,469,327,132,448,303,124
060830014031,950,527,423,976,546,430,1005,667,320,1037,649,327
060830014041,530,298,232,540,304,236,659,436,209,773,472,259
060830015003,479,280,199,492,291,201,570,375,179,531,324,179
060830007004,905,638,267,920,628,292,1204,949,234,1030,734,237
060830014042,410,243,167,420,254,166,481,326,147,433,273,133
060830005021,672,520,152,684,523,161,700,551,133,710,546,130
060830005013,507,392,115,517,397,120,620,499,107,542,418,99
060830005022,451,350,101,453,345,108,741,568,155,483,367,90
060830016044,1107,787,320,1127,779,348,958,694,248,879,595,231
060830017042,200,140,60,204,138,66,258,186,67,214,158,45
060830016041,431,315,116,436,308,128,610,439,156,454,323,105
060830016043,336,245,91,341,242,99,514,373,136,441,306,107
060830009001,665,527,138,679,525,154,878,711,154,826,636,129
060830009003,202,158,44,206,157,49,282,231,49,245,191,38
060830006003,562,405,157,578,405,173,673,490,164,600,425,143
060830007001,568,375,193,580,371,209,834,645,176,760,524,194
060830008051,394,274,120,401,275,126,547,425,117,448,298,112
060830012061,464,358,106,475,365,110,602,464,120,512,378,102
060830012063,328,274,54,333,263,70,506,417,72,412,337,49
060830008061,278,237,41,283,232,51,416,353,52,310,261,35
060830010022,320,274,46,325,271,54,441,366,68,366,292,51
060830011021,499,423,76,509,418,91,652,558,84,562,456,72
060830011022,338,296,42,340,287,53,536,457,68,424,345,46
060830011023,191,168,23,193,163,30,306,262,40,241,196,25
060830012062,286,253,33,288,244,44,446,383,57,364,298,37
060830011011,465,384,81,476,379,97,619,495,111,507,406,76
060830011012,307,262,45,314,259,55,455,390,57,374,308,45
060830011013,361,309,52,361,301,60,472,407,60,434,359,54
060830003011,286,236,50,291,233,58,377,320,53,323,263,41
060830003012,431,356,75,442,354,88,569,478,77,517,418,67
060830003013,362,306,56,370,303,67,450,378,63,400,322,52
060830004001,688,523,165,705,534,171,805,647,143,748,554,161
060830004004,577,461,116,591,472,119,704,578,110,626,491,94
060830004005,616,503,113,629,509,120,838,691,126,449,352,71
060830009002,492,413,79,503,413,90,658,548,95,750,600,103
060830010021,365,313,52,371,310,61,465,391,64,432,344,59
060830010023,534,446,88,548,445,103,678,556,104,593,460,82
060830010011,468,406,62,476,409,67,608,512,82,501,400,65
060830001032,915,607,308,938,611,327,1371,990,355,1168,746,333
060830006004,386,324,62,397,324,73,509,429,72,423,337,58
060830006006,290,224,66,296,221,75,362,279,75,298,224,58
060830010012,554,462,92,561,456,105,743,615,112,616,477,87
060830008011,262,204,58,272,204,68,367,293,70,279,214,47
060830008063,354,300,54,355,288,67,479,410,64,407,338,51
060830004002,418,323,95,429,329,100,476,383,87,449,341,81
060830004003,449,367,82,457,368,89,556,455,86,477,377,65
060830006001,363,270,93,374,274,100,420,330,85,386,285,82
060830006002,514,377,137,527,377,150,640,480,146,561,409,123
060830006005,549,434,115,558,425,133,798,632,152,613,473,109
060830008012,528,457,71,534,443,91,697,596,85,592,491,68
060830008013,444,386,58,452,372,80,589,509,75,487,408,55
060830008062,406,355,51,410,339,71,580,495,72,502,421,53
060830008064,318,272,46,325,264,61,458,392,57,354,296,40
060830005023,324,251,73,332,251,81,421,321,93,353,266,64
060830005024,611,433,178,629,433,196,731,558,165,626,431,152
060830005025,488,313,175,501,312,189,571,430,132,536,353,147
060830005026,877,645,232,895,652,243,1148,889,233,897,653,192
060830001031,713,425,288,729,431,298,687,430,237,661,384,234
060830019071,406,213,193,412,210,202,543,326,209,499,266,206
060830029071,1034,621,413,1062,624,438,1311,865,410,1102,652,379
060830001011,767,498,269,779,493,286,969,699,251,851,543,265
060830030051,460,324,136,470,318,152,723,534,170,532,361,136
060830002022,532,400,132,541,398,143,780,571,196,585,413,127
060830013061,906,629,277,935,638,297,1005,746,241,988,674,259
060830013063,426,257,169,428,248,180,537,385,141,445,262,154
060830001013,673,458,215,682,449,233,768,571,182,729,471,217
060830029073,441,257,184,455,256,199,546,353,180,460,265,164
060830029131,1164,756,408,1185,748,437,1200,845,327,1178,758,341
060830029132,902,589,313,915,585,330,1487,1051,405,970,632,276
060830029322,909,573,336,926,579,347,1246,835,380,1024,636,323
060830030012,610,437,173,618,430,188,750,577,157,651,462,156
060830030041,709,476,233,719,464,255,889,631,242,751,516,186
060830030072,664,427,237,682,432,250,805,576,212,708,458,210
060830030071,625,359,266,639,361,278,798,526,253,691,413,236
060830001022,233,168,65,237,169,68,307,222,75,258,180,60
060830001024,695,519,176,709,516,193,902,698,188,783,568,169
060830001014,746,528,218,763,522,241,920,687,213,824,564,218
060830001023,538,399,139,545,395,150,764,580,166,551,396,118
060830030052,805,537,268,834,549,285,1059,766,272,848,567,230
060830030073,823,457,366,845,472,373,1118,713,375,906,528,333
060830030042,864,584,280,878,570,308,1136,815,301,989,643,279
060830030053,767,544,223,782,535,247,1112,828,261,932,622,239
060830030043,721,497,224,738,489,249,901,662,215,771,548,177
060830001012,612,421,191,619,419,200,757,557,182,681,461,172
060830001033,473,267,206,482,271,211,570,357,194,506,294,183
060830029143,857,532,325,874,533,341,1051,720,308,935,580,297
060830029072,727,437,290,749,442,307,905,606,283,775,470,258
060830002011,459,348,111,466,342,124,578,440,127,502,378,94
060830002012,825,524,301,848,523,325,963,718,226,834,535,258
060830013071,254,211,43,258,206,52,368,298,60,325,255,50
060830012081,391,285,106,399,286,113,476,357,105,429,293,103
060830012082,453,332,121,466,334,132,563,423,125,482,337,108
060830012085,416,305,111,425,305,120,554,423,123,432,297,105
060830012083,341,251,90,351,253,98,446,340,98,414,293,86
060830012084,366,275,91,379,277,102,508,388,108,419,303,82
060830013081,400,310,90,413,310,103,522,406,106,456,341,82
060830013082,361,279,82,373,280,93,462,363,95,377,286,67
060830013062,571,398,173,589,405,184,699,525,160,636,450,156
060830013074,695,503,192,708,504,204,865,672,176,730,522,167
060830013083,429,315,114,436,318,118,545,419,115,434,311,98
060830013084,412,308,104,421,314,107,480,377,98,423,318,82
060830013085,457,361,96,466,361,105,650,506,130,537,412,97
060830012032,1117,827,290,1138,824,314,1361,1031,304,1202,848,281
060830012031,338,266,72,343,261,82,380,295,75,349,258,66
060830011014,423,347,76,432,343,89,519,414,98,471,369,79
060830013073,526,394,132,537,392,145,627,488,127,568,415,123
060830013072,274,197,77,280,197,83,338,263,68,301,212,72
060830002021,419,311,108,426,310,116,537,396,127,450,339,83
060830003023,491,421,70,502,422,80,667,559,97,515,410,65
060830003024,196,168,28,201,170,31,288,241,40,217,175,28
060830003025,242,208,34,247,208,39,366,303,54,280,225,36
060830003021,345,283,62,350,285,65,437,362,67,353,275,58
060830003022,296,242,54,302,246,56,369,306,55,319,247,53
060830030013,304,218,86,306,213,93,399,307,83,332,235,80
060830030011,186,152,34,192,149,43,469,361,100,218,174,35
060830030014,356,290,66,359,282,77,586,451,122,427,336,68
060830030015,130,107,23,135,105,30,219,171,46,159,123,25
060839800001,220,174,46,223,170,53,426,323,92,4,3,1
060830029061,575,351,224,586,340,246,481,323,150,591,359,199
060830029331,147,115,32,151,114,37,190,144,40,251,181,48
060830029141,361,230,131,369,232,137,435,289,133,396,259,113
060830029142,541,345,196,557,350,207,645,446,185,532,348,154
060830029062,902,530,372,925,525,400,1151,769,350,995,635,306
060830029063,708,431,277,725,423,302,1137,736,373,827,497,285
060830029091,905,623,282,925,617,308,1247,888,338,1022,679,271
060830029092,731,461,270,750,455,295,978,689,263,825,514,252
060830029093,889,580,309,904,573,331,1180,833,313,1022,669,288
060830019111,720,304,416,734,299,435,656,336,312,811,344,412
060830019121,951,477,474,965,448,517,1126,621,475,1064,512,468
060830019123,689,341,348,703,337,366,815,451,344,707,329,339
060830019091,838,381,457,863,393,470,1001,516,458,724,318,365
060830019092,947,438,509,972,453,519,1119,592,504,1082,514,516
060830019051,564,247,317,579,248,331,883,429,442,635,298,310
060830019053,476,198,278,487,200,287,526,253,261,505,213,265
060830019083,548,232,316,558,230,328,721,351,351,577,243,300
060830019084,571,296,275,585,290,295,763,440,311,578,285,253
060830029321,190,117,73,188,113,75,141,87,51,132,70,53
060830031021,278,125,153,283,126,157,445,212,223,350,127,201
060830029361,1106,998,108,1141,1009,132,1215,1071,102,1371,1123,122
060830029371,139,114,25,141,113,28,155,141,11,165,127,26
060839802001,166,54,112,169,54,115,238,125,92,223,93,96
060839805001,6,2,4,6,2,4,128,62,53,10,4,4
060830028093,338,151,187,344,145,199,487,216,260,388,171,188
060830028094,962,346,616,980,352,628,1133,493,603,1041,388,583
060830025031,179,101,78,181,93,88,286,173,112,243,151,85
060830020061,681,200,481,691,192,499,932,311,605,740,206,492
060830028081,555,221,334,564,213,351,786,363,402,617,246,327
060830020132,813,250,563,827,234,593,1028,392,610,876,254,585
060839803001,1993,1822,171,2045,1832,213,281,256,16,2848,2382,246
060830029333,356,262,94,366,261,105,431,330,91,409,296,88
060830029334,526,493,33,537,496,41,348,318,18,673,563,40
060830029332,691,649,42,704,642,62,26,25,1,1002,837,108
060830029351,695,541,154,707,533,174,1289,980,273,791,597,118
060830029372,1077,855,222,1098,855,243,1156,933,189,1172,887,168
060830029241,681,628,53,701,632,69,703,622,60,982,820,93
060830029242,689,630,59,708,637,71,689,613,58,1023,852,91
060830029243,337,305,32,344,309,35,353,313,30,526,432,52
060830029244,436,391,45,448,394,54,403,360,35,733,594,77
060830029262,727,680,47,755,695,60,855,756,73,1181,976,113
060830029261,521,477,44,540,481,59,657,582,56,839,681,76
060830029263,424,364,60,438,372,66,496,440,41,635,498,66
060830029362,303,273,30,308,272,36,389,342,33,437,351,42
060830019101,439,212,227,451,219,232,554,299,242,478,227,225
060830019081,879,397,482,904,391,513,1126,540,562,1005,426,488
060830019082,639,225,414,642,224,418,802,386,399,682,246,412
060830019052,359,165,194,366,164,202,529,256,262,391,180,190
060830028084,938,422,516,957,396,561,1332,616,677,1062,470,511
060830028082,537,200,337,546,193,353,635,293,324,566,215,307
060830028083,459,169,290,468,165,303,586,273,299,481,180,261
060830028085,823,314,509,836,311,525,989,457,504,844,325,470
060830028092,415,187,228,422,177,245,618,280,323,479,211,233
060830019112,514,255,259,522,244,278,714,372,325,613,279,296
060830028091,377,130,247,384,134,250,479,200,265,436,157,253
060830020113,338,222,116,348,204,144,547,339,192,451,284,133
060830029341,515,382,133,522,374,148,529,401,112,655,452,165
060830029352,536,409,127,548,403,145,762,578,161,633,430,163
060830029342,893,646,247,909,635,274,1008,768,214,961,694,193
060830019102,471,214,257,480,212,268,601,328,260,524,238,253
060830019103,425,195,230,435,193,242,656,339,301,435,197,210
060830019122,524,260,264,532,252,280,1194,652,512,607,286,280
060839804001,40,16,24,41,17,24,55,13,40,54,13,37
060830025041,287,210,77,291,193,98,469,313,141,382,285,72
060830025043,555,405,150,561,379,182,885,601,265,651,472,144
060830025042,344,252,92,345,238,107,696,471,212,445,313,106
060830028062,316,163,153,322,161,161,417,252,163,361,199,145
060830031022,402,197,205,411,191,220,611,336,242,501,224,227
060830031023,528,274,254,538,265,273,753,409,306,639,305,290
060830020112,385,158,227,393,149,244,491,249,235,440,229,185
060830024093,772,434,338,785,399,386,791,470,310,698,388,269
060830020062,468,157,311,479,167,312,626,219,399,535,188,329
060830020111,890,279,611,906,282,624,1278,539,711,984,336,591
060830020052,599,202,397,611,198,413,801,305,483,791,248,496
060830020053,792,267,525,800,259,541,1114,422,667,849,288,509
060830020051,492,154,338,502,150,352,761,270,475,397,110,262
060830020054,602,192,410,616,192,424,810,307,487,677,199,431
060830020122,467,175,292,480,176,304,823,317,485,530,181,311
060830020123,375,152,223,383,149,234,485,188,295,417,155,241
060830020131,657,223,434,667,210,457,844,319,500,725,227,458
060830020121,624,196,428,641,198,443,745,286,438,665,208,424
060830020091,676,231,445,691,224,467,948,376,542,772,248,476
060830020092,534,169,365,546,167,379,662,264,381,579,180,361
060830020093,464,165,299,475,159,316,601,238,346,529,155,333
060830020102,427,143,284,431,139,292,545,206,330,502,164,311
060830020103,364,122,242,367,118,249,464,176,276,470,153,290
060830020101,940,334,606,967,315,652,1195,451,715,1070,355,646
060830020104,304,107,197,311,101,210,388,147,233,341,110,212
060830020082,599,216,383,611,211,400,871,348,492,718,236,433
060830020083,453,170,283,463,162,301,624,254,354,520,175,306
060830020081,782,285,497,794,275,519,1047,429,594,904,313,533
060830020084,695,245,450,708,240,468,980,396,548,791,263,478
060830020152,364,136,228,372,131,241,469,193,265,389,147,216
060830020153,472,176,296,482,172,310,645,266,368,567,215,320
060830020154,518,193,325,530,193,337,648,279,355,542,223,291
060830027031,577,309,268,590,296,294,855,489,345,677,376,255
060830027032,643,325,318,658,312,346,783,444,320,598,319,228
060830027061,407,208,199,415,197,218,550,312,235,524,281,207
060830027062,256,139,117,268,134,134,394,223,162,356,199,135
060830028021,547,260,287,555,247,308,765,418,333,643,331,274
060830027081,215,105,110,222,105,117,278,157,113,276,131,121
060830027082,387,198,189,397,187,210,509,291,208,455,218,201
060830027083,342,174,168,349,166,183,401,229,166,401,171,197
060830027101,156,94,62,158,85,73,242,145,93,229,131,78
060830027071,197,104,93,202,99,103,265,152,111,248,132,99
060830027103,311,182,129,318,174,144,530,307,208,296,186,86
060830027091,335,185,150,338,176,162,538,303,209,510,292,178
060830027072,222,125,97,222,121,101,311,175,132,277,144,111
060830027073,344,178,166,351,174,177,475,260,191,393,195,167
060830027102,153,100,53,153,92,61,280,177,97,160,100,47
060830027051,344,194,150,350,186,164,509,320,176,451,225,199
060830027052,271,181,90,277,166,111,490,302,169,408,246,132
060830027053,255,150,105,260,143,117,405,255,140,341,192,127
060830027063,221,138,83,228,130,98,382,216,153,284,169,89
060830027065,70,47,23,73,43,30,111,69,39,97,60,30
060830027064,179,112,67,183,103,80,287,164,116,268,161,89
060830028022,581,294,287,590,279,311,836,445,364,673,336,291
060830027092,195,106,89,202,105,97,312,197,110,258,150,86
060830028023,521,280,241,529,267,262,812,436,351,555,294,223
060830028024,751,362,389,759,348,411,1015,543,443,885,411,412
060830028061,603,272,331,606,264,342,786,423,345,688,311,329
060830020142,932,420,512,944,409,535,1053,515,518,801,364,393
060830020151,419,156,263,436,155,281,552,245,293,440,162,259
060830020143,567,228,339,579,220,359,804,359,431,683,273,377
060830020141,420,192,228,430,190,240,977,474,488,792,356,390
060830024101,434,297,137,438,280,158,638,405,217,399,262,119
060830024092,465,267,198,474,246,228,1277,768,478,687,380,265
060830024091,379,254,125,388,244,144,578,376,182,553,333,188
060830024062,83,63,20,83,56,27,230,148,75,111,85,20
060830024051,154,114,40,154,103,51,281,183,91,205,149,42
060830024052,129,98,31,131,88,43,226,152,74,163,124,29
060830024071,155,106,49,157,101,56,249,168,81,206,140,61
060830024072,68,54,14,67,48,19,161,136,23,159,119,29
060830023071,340,227,113,345,209,136,517,329,179,437,270,143
060830022112,658,266,392,667,249,418,893,425,445,726,309,378
060830022114,329,139,190,334,135,199,445,234,194,351,150,182
060830021032,364,225,139,373,217,156,632,354,259,471,262,185
060830021033,359,176,183,367,177,190,566,293,259,448,250,175
060830021021,342,210,132,348,205,143,488,269,210,439,264,140
060830021031,163,103,60,167,98,69,272,152,111,196,109,76
060830024103,240,165,75,244,155,89,486,303,165,325,211,101
060830024102,58,42,16,61,40,21,128,83,41,74,50,22
060830021011,555,319,236,567,313,254,782,418,351,573,327,213
060830021012,324,163,161,331,160,171,502,247,253,414,206,189
060830021022,191,111,80,194,108,86,275,145,127,287,155,117
060830024081,155,105,50,158,104,54,308,216,90,218,149,63
060830024061,64,44,20,66,44,22,126,83,40,105,65,31
060830022111,564,244,320,573,244,329,781,378,393,592,265,297
060830022113,642,298,344,649,284,365,921,488,398,800,365,389
060830022101,677,363,314,678,338,340,1025,549,452,875,464,361
060830022102,459,214,245,467,213,254,673,360,294,555,261,257
060830022103,414,210,204,419,197,222,633,340,279,533,278,219
060830022061,404,225,179,411,217,194,680,378,286,521,275,216
060830022062,236,132,104,239,126,113,424,233,186,316,179,111
060830022051,271,156,115,277,142,135,367,228,126,361,169,170
060830022052,301,171,130,308,167,141,446,278,154,381,198,155
060830022053,100,58,42,102,55,47,270,170,92,239,144,77
060830022091,315,193,122,322,183,139,531,330,187,484,287,165
060830022092,259,148,111,267,137,130,409,256,139,316,186,109
060830022063,165,94,71,174,94,80,265,168,93,229,139,79
060830023035,126,88,38,129,81,48,270,177,78,178,131,35
060830023033,142,103,39,144,95,49,271,178,89,196,144,39
060830023034,114,83,31,117,77,40,249,166,79,153,116,31
060830023042,106,75,31,109,70,39,181,121,54,167,121,36
060830023043,172,121,51,172,109,63,314,208,100,251,188,50
060830023044,119,83,36,119,76,43,241,163,73,158,122,31
060830023031,175,131,44,176,126,50,348,223,121,256,160,75
060830023032,168,126,42,169,120,49,343,218,119,266,198,56
060830023041,62,49,13,64,44,20,124,87,37,76,49,26
060830023101,232,155,77,230,146,84,378,235,133,315,240,58
060830023102,226,154,72,230,147,83,362,227,126,298,225,58
060830023081,643,405,238,652,381,271,893,572,306,694,425,229
060830023091,214,158,56,218,147,71,463,294,152,338,253,63
060830023092,230,170,60,235,156,79,469,303,158,343,266,62
060830023082,303,163,140,305,156,149,398,253,132,388,229,141
060830023072,423,226,197,429,217,212,738,477,247,669,407,236
060830023073,222,150,72,224,138,86,379,247,128,307,192,99
060650301011,245,173,72,247,170,77,331,237,88,328,225,84
060650422092,185,133,52,187,133,54,326,241,76,270,187,66
060650422091,258,179,79,257,173,84,425,311,105,378,255,96
060650422101,265,202,63,267,197,70,382,284,86,338,251,62
060650422102,370,287,83,370,279,91,580,423,142,503,378,89
060650422103,286,229,57,286,222,64,396,292,90,362,283,50
060650305021,127,107,20,132,106,26,313,237,73,189,153,26
060650465022,38,35,3,37,34,3,3,2,1,71,60,8
060650465021,61,53,8,61,51,10,62,45,14,98,77,12
060650465024,285,249,36,285,239,46,426,317,96,364,290,46
060650465025,158,138,20,159,133,26,196,144,44,252,202,31
060650304001,106,87,19,106,85,21,238,186,50,155,123,22
060650304002,226,185,41,227,177,50,495,378,101,391,308,55
060650304003,230,191,39,232,180,52,213,167,46,200,161,30
060650304004,190,154,36,190,148,42,333,252,74,250,201,35
060650304005,257,211,46,254,199,55,405,314,83,327,264,44
060650305011,189,160,29,188,152,36,388,298,80,270,222,28
060650305012,237,191,46,247,192,55,346,269,71,308,253,47
060650305022,132,112,20,134,108,26,241,190,49,197,167,21
060650305031,85,73,12,87,70,17,170,132,36,133,114,13
060650305032,188,160,28,188,151,37,364,282,75,269,220,27
060650305033,102,86,16,102,82,20,201,154,41,159,129,16
060650305013,535,421,114,546,424,122,764,576,156,722,572,116
060650422093,296,260,36,299,256,43,443,302,128,404,343,36
060650465011,321,296,25,328,296,32,30,21,9,583,504,44
060650465023,102,90,12,105,90,15,60,41,18,78,69,7
060650422131,618,439,179,627,432,195,760,520,224,727,474,194
060650422141,900,571,329,909,556,353,2066,1285,732,1000,602,333
060650422132,437,296,141,443,292,151,583,393,170,542,365,140
060650422133,538,364,174,544,356,188,766,525,224,852,535,256
060650422062,498,301,197,506,297,209,687,452,215,641,383,217
060650422064,399,242,157,405,239,166,792,494,277,676,406,230
060650422072,594,310,284,598,310,288,753,449,285,660,341,281
060650422061,598,401,197,602,391,211,997,679,291,734,450,230
060650422063,273,183,90,274,178,96,378,255,110,337,205,106
060650422171,748,469,279,755,462,293,827,493,314,640,368,229
060650425051,153,110,43,154,102,52,432,317,106,258,193,49
060650509012,363,222,141,364,217,147,726,433,275,413,246,139
060650509011,181,111,70,182,108,74,294,176,112,208,125,69
060650509023,280,152,128,280,150,130,418,229,176,347,183,131
060650509021,188,113,75,189,110,79,302,178,118,227,133,79
060650509022,310,189,121,310,184,126,474,286,180,362,217,120
060650422071,933,414,519,946,413,533,1134,599,508,995,442,497
060650422081,691,332,359,698,336,362,769,461,294,718,341,342
060650422082,703,338,365,709,341,368,868,519,332,738,350,350
060650306031,822,371,451,832,369,463,995,516,462,862,401,405
060650306032,462,209,253,465,207,258,640,333,294,517,238,244
060650306033,375,171,204,381,171,210,454,237,213,396,182,191
060650306021,656,307,349,663,306,357,778,404,361,684,304,340
060650312001,346,161,185,347,161,186,473,243,221,398,177,196
060650312005,630,326,304,633,320,313,915,485,411,726,365,318
060650306023,343,159,184,351,155,196,417,202,209,397,186,190
060650312002,309,167,142,315,162,153,443,228,207,373,194,157
060650312003,454,244,210,459,238,221,678,351,314,535,281,224
060650312004,546,351,195,552,342,210,850,516,312,690,433,215
060650306042,1009,380,629,1022,370,652,1200,521,651,1048,404,583
060650306051,1300,571,729,1311,563,748,1843,918,890,1409,612,728
060650306022,733,272,461,746,268,478,863,371,475,794,305,451
060650313001,243,176,67,241,172,69,403,284,109,313,223,68
060650313002,278,203,75,278,197,81,427,304,117,262,187,59
060650317011,257,187,70,257,182,75,394,275,107,454,327,101
060650317043,313,184,129,315,178,137,518,257,243,384,221,137
060650306041,458,176,282,466,170,296,614,266,335,563,216,309
060650317012,569,257,312,577,250,327,760,378,372,631,286,316
060650420051,1069,403,666,1077,386,691,1426,629,770,1159,445,650
060650420124,584,270,314,595,262,333,843,415,412,648,298,315
060650422172,685,293,392,690,287,403,709,358,337,776,337,397
060650422174,438,187,251,444,185,259,714,360,340,510,223,261
060650422173,625,285,340,638,277,361,904,453,429,736,311,388
060650420123,440,208,232,445,201,244,633,302,323,542,239,264
060650420122,277,144,133,282,140,142,445,223,211,307,150,138
060650420121,607,316,291,620,307,313,1031,518,491,741,362,333
060650420053,425,153,272,427,146,281,599,239,354,531,180,319
060650420182,696,313,383,706,303,403,998,484,498,787,355,383
060650420183,683,309,374,688,297,391,1050,499,527,787,356,386
060650420181,690,343,347,698,330,368,1151,543,577,844,380,422
060650420153,813,372,441,822,368,454,1063,505,537,848,380,428
060650420151,331,158,173,336,157,179,626,297,317,498,224,248
060650420161,981,475,506,988,464,524,1457,693,737,1178,503,612
060650420152,1006,433,573,1015,421,594,1487,703,747,1195,510,616
060650420033,922,391,531,935,379,556,1116,479,613,843,332,469
060650420041,685,255,430,687,243,444,1112,469,623,786,301,448
060650420052,449,206,243,454,199,255,732,359,358,515,230,261
060650420171,648,299,349,661,291,370,988,484,484,796,359,395
060650420091,648,271,377,658,270,388,1021,458,540,769,345,385
060650420093,397,184,213,402,175,227,597,288,296,489,234,224
060650420172,656,316,340,664,298,366,1049,513,512,821,396,373
060650315012,205,130,75,207,126,81,335,198,130,246,143,88
060650316023,459,271,188,463,266,197,711,416,278,544,309,198
060650316022,460,273,187,464,267,197,675,395,262,526,297,191
060650314023,479,298,181,485,288,197,761,454,280,442,255,152
060650315031,677,381,296,682,371,311,964,553,387,837,445,332
060650315032,350,197,153,355,192,163,426,250,166,371,197,147
060650315033,296,166,130,297,161,136,382,223,147,328,175,130
060650315011,352,221,131,349,212,137,456,268,178,383,224,135
060650315016,78,49,29,78,47,31,106,61,41,95,53,35
060650315013,285,180,105,286,175,111,436,254,167,321,184,114
060650315014,241,138,103,242,135,107,335,184,139,262,131,106
060650316011,357,236,121,361,231,130,514,298,199,387,236,128
060650315015,67,31,36,69,32,37,76,37,36,123,45,60
060650316012,184,129,55,183,124,59,284,163,108,200,131,58
060650316013,453,293,160,454,282,172,606,357,234,411,267,117
060650316021,174,121,53,175,119,56,294,172,114,208,138,59
060650414031,877,479,398,882,461,421,1459,850,584,901,461,388
060650414032,459,230,229,459,224,235,652,310,332,472,240,206
060650414131,1074,458,616,1085,442,643,1273,599,658,1011,454,513
060650317021,350,176,174,354,166,188,517,267,238,538,280,226
060650317022,601,280,321,607,267,340,698,363,319,654,299,318
060650317031,286,139,147,292,135,157,442,228,205,339,161,161
060650317032,764,371,393,775,359,416,1174,607,540,920,404,460
060650317041,431,222,209,433,214,219,644,352,284,529,263,234
060650317042,378,196,182,382,190,192,625,341,272,439,222,189
060650317044,421,217,204,425,209,216,615,337,270,472,239,205
060650315041,516,308,208,525,303,222,784,522,246,621,359,216
060650315042,366,219,147,372,214,158,503,336,155,459,262,161
060650410012,401,296,105,409,293,116,315,195,113,387,279,83
060650411011,125,95,30,126,90,36,423,259,150,235,161,60
060650411012,303,231,72,305,225,80,417,281,127,383,283,78
060650411013,173,132,41,175,128,47,270,182,82,182,135,39
060650412022,365,278,87,368,270,98,588,397,183,415,306,85
060650412023,225,170,55,222,165,57,370,250,115,276,204,57
060650412032,293,213,80,298,211,87,496,331,152,405,290,90
060650412011,512,355,157,515,350,165,785,521,239,665,462,156
060650412021,174,122,52,175,119,56,325,200,115,240,162,63
060650412031,291,201,90,293,199,94,545,363,167,379,264,90
060650412012,401,285,116,401,280,121,605,407,185,475,326,118
060650413021,540,385,155,545,382,163,853,567,260,641,440,158
060650413022,253,175,78,253,171,82,386,242,134,313,211,83
060650409012,438,302,136,443,296,147,655,397,242,472,307,133
060650414071,490,337,153,490,327,163,758,461,280,579,350,194
060650414072,352,242,110,355,237,118,602,365,223,392,255,111
060650414073,357,246,111,359,240,119,538,327,201,433,267,140
060650414051,425,258,167,429,249,180,673,406,251,546,299,217
060650414061,520,324,196,520,312,208,789,480,292,677,399,236
060650414081,304,189,115,305,184,121,653,397,241,401,253,121
060650414082,492,320,172,495,310,185,729,452,259,529,330,156
060650414122,605,314,291,610,305,305,922,451,453,641,355,254
060650414141,606,280,326,611,275,336,830,406,409,743,333,375
060650414142,935,457,478,943,448,495,1529,775,721,1136,527,555
060650414041,618,341,277,623,330,293,800,459,331,709,360,316
060650414042,453,270,183,454,258,196,625,378,231,510,280,200
060650414052,637,380,257,641,363,278,777,472,288,746,396,310
060650410031,701,354,347,706,347,359,913,560,327,820,390,365
060650411021,302,203,99,305,197,108,509,295,201,409,263,120
060650411022,485,314,171,488,308,180,953,549,375,548,354,164
060650413011,326,217,109,325,208,117,556,322,219,374,245,108
060650413012,292,193,99,298,191,107,503,292,198,376,245,109
060650408133,625,194,431,636,190,446,1273,527,714,742,236,471
060650409021,523,279,244,530,267,263,702,407,279,630,329,260
060650409042,648,338,310,656,325,331,846,490,334,758,391,314
060650409011,586,360,226,593,353,240,946,561,361,675,387,244
060650409022,777,457,320,783,441,342,888,522,347,613,336,245
060650409031,361,203,158,366,196,170,494,287,196,403,218,163
060650409032,364,214,150,369,210,159,489,289,192,390,217,149
060650409041,284,159,125,286,153,133,391,229,155,319,172,128
060650409013,360,229,131,364,223,141,518,310,198,416,240,147
060650409014,196,102,94,198,99,99,374,223,142,230,124,97
060650409023,602,312,290,614,307,307,776,463,295,725,391,304
060650414063,460,291,169,466,284,182,767,459,292,599,364,198
060650414062,423,268,155,428,261,167,739,440,281,479,292,158
060650422143,667,392,275,673,375,298,991,604,368,825,470,296
060650414133,941,439,502,944,421,523,2676,1249,1386,1023,486,489
060650414152,731,356,375,741,356,385,1190,604,565,825,396,385
060650414153,143,74,69,143,70,73,261,142,112,182,89,82
060650420081,272,98,174,279,96,183,385,159,216,312,107,190
060650420084,779,300,479,789,294,495,1148,499,625,934,327,556
060650420032,546,215,331,551,206,345,839,333,486,695,269,392
060650420031,805,307,498,811,299,512,1173,493,656,910,320,540
060650420042,726,265,461,731,254,477,1097,443,628,867,295,522
060650414132,672,313,359,679,305,374,1013,487,513,784,374,375
060650420072,895,306,589,894,283,611,1718,624,1077,904,263,592
060650420083,785,230,555,795,217,578,1289,455,805,899,274,591
060650420082,630,312,318,635,302,333,904,475,413,740,409,291
060650429033,259,110,149,261,107,154,409,179,221,326,145,159
060650420071,941,302,639,947,297,650,1180,366,808,1041,324,667
060650420094,288,179,109,291,170,121,446,289,139,375,234,126
060650420092,280,174,106,280,165,115,469,314,146,418,261,141
060650420101,223,150,73,224,139,85,379,248,123,330,226,82
060650420103,233,157,76,238,149,89,405,266,133,299,211,71
060650420104,207,144,63,212,136,76,437,273,139,303,219,62
060650420102,110,78,32,108,69,39,222,144,73,162,117,36
060650429063,179,139,40,181,132,49,348,226,108,248,197,38
060650429061,300,232,68,299,220,79,520,356,164,440,340,73
060650429062,282,211,71,285,205,80,565,379,170,416,314,84
060650429052,270,168,102,270,158,112,428,273,144,370,225,125
060650429032,164,99,65,168,97,71,307,189,113,233,145,79
060650467004,253,90,163,261,90,171,246,119,126,283,91,179
060650430103,421,199,222,420,184,236,652,317,321,539,247,268
060650430101,745,343,402,752,325,427,1185,556,606,920,418,474
060650430031,361,171,190,367,161,206,713,338,361,479,252,193
060650430033,237,120,117,239,111,128,512,244,256,319,167,128
060650430013,910,486,424,917,461,456,2523,1363,1095,559,259,271
060650430081,1037,430,607,1048,400,648,1592,643,914,1213,469,684
060650464012,418,220,198,422,211,211,711,333,367,534,237,263
060650430083,461,172,289,464,169,295,681,278,388,551,227,300
060650464034,632,276,356,637,265,372,1035,474,538,763,306,422
060650430073,760,327,433,768,312,456,1116,518,579,913,387,471
060650430091,799,348,451,810,320,490,1340,598,719,966,386,525
060650430052,397,196,201,399,181,218,413,213,195,402,189,194
060650430092,528,264,264,535,250,285,1272,674,567,713,324,349
060650427493,685,376,309,693,364,329,1248,675,550,816,444,321
060650427502,654,357,297,660,343,317,1517,799,695,813,421,342
060650427491,227,127,100,227,122,105,248,134,109,260,144,101
060650427501,459,208,251,464,201,263,739,349,373,582,242,315
060650430011,211,130,81,212,124,88,409,224,173,276,151,109
060650430053,316,136,180,316,127,189,513,221,280,387,166,206
060650430063,262,135,127,261,125,136,442,234,204,308,161,135
060650430062,182,118,64,184,111,73,332,187,140,250,135,102
060650427492,209,114,95,209,108,101,379,204,167,237,132,93
060650429023,346,146,200,352,143,209,503,223,266,437,196,223
060650427481,673,311,362,684,302,382,524,254,263,747,327,385
060650427482,470,203,267,473,196,277,977,444,512,468,185,265
060650464043,471,203,268,475,191,284,734,328,395,650,271,341
060650427483,816,233,583,830,228,602,892,209,673,667,143,502
060650427332,622,248,374,631,239,392,3419,1468,1882,983,370,564
060650432741,277,127,150,279,119,160,432,210,216,325,130,175
060650464042,635,291,344,646,274,372,1045,499,519,704,280,379
060650427331,537,241,296,536,229,307,859,413,430,412,173,219
060650432742,286,111,175,288,108,180,604,242,344,368,143,202
060650427333,2095,866,1229,2129,838,1291,2621,1198,1381,1836,756,992
060650430032,365,185,180,371,175,196,614,309,296,410,199,180
060650430051,485,244,241,496,234,262,1035,525,486,653,300,306
060650430102,369,187,182,370,174,196,572,289,280,488,224,240
060650430012,160,90,70,160,84,76,271,152,115,194,106,77
060650430061,320,202,118,321,193,128,569,313,249,440,233,175
060650464041,459,254,205,463,243,220,457,239,213,842,443,340
060650464033,252,116,136,255,111,144,477,233,234,350,139,195
060650419103,702,317,385,713,314,399,1315,597,694,976,413,525
060650419102,523,234,289,526,228,298,868,440,416,647,301,314
060650419152,477,226,251,483,228,255,1096,563,516,589,263,299
060650419153,749,333,416,764,332,432,1332,662,647,950,444,458
060650419104,688,256,432,693,250,443,996,491,492,731,282,432
060650419101,739,276,463,745,270,475,799,395,398,786,302,464
060650419151,997,397,600,1013,391,622,1404,642,745,1169,446,678
060650419154,722,351,371,728,339,389,696,345,343,697,317,352
060650481002,949,395,554,959,389,570,1857,825,998,905,357,514
060650419141,776,424,352,784,413,371,1486,747,718,903,453,407
060650419142,484,268,216,490,259,231,1430,707,703,527,265,234
060650430072,729,335,394,735,319,416,1247,584,639,880,378,455
060650430071,741,326,415,752,313,439,1182,552,605,868,371,449
060650464011,538,172,366,546,170,376,842,304,523,672,203,430
060650464021,469,218,251,479,210,269,804,374,423,554,247,272
060650414151,328,202,126,332,198,134,534,312,207,367,219,130
060650427141,1002,227,775,1020,227,793,2082,641,1412,1223,276,898
060650427142,557,121,436,562,118,444,772,182,583,632,123,484
060650429072,262,139,123,271,134,137,475,236,227,358,189,154
060650427161,691,160,531,697,155,542,994,236,748,768,153,586
060650427162,699,197,502,709,191,518,1016,280,721,840,229,575
060650427163,734,206,528,744,201,543,1054,245,795,851,203,617
060650427172,366,132,234,371,126,245,653,227,417,440,150,269
060650427173,576,213,363,590,205,385,1057,371,660,697,241,419
060650464052,596,220,376,609,214,395,813,324,461,737,268,425
060650464031,384,163,221,388,153,235,635,268,349,518,197,285
060650464032,523,194,329,528,177,351,841,314,514,682,216,420
060650432792,455,166,289,463,158,305,687,254,421,524,180,308
060650432761,913,355,558,922,352,570,1443,576,839,684,247,394
060650432791,943,324,619,949,303,646,1503,553,918,1107,356,673
060650464051,568,206,362,573,198,375,913,337,559,686,228,413
060650432701,1193,451,742,1206,422,784,1714,636,1048,1494,545,876
060650432702,815,277,538,828,265,563,1239,457,756,886,283,549
060650432762,297,114,183,299,113,186,1461,572,862,537,197,309
060650432711,809,276,533,818,258,560,933,360,561,786,258,484
060650432712,546,198,348,552,183,369,752,272,461,689,242,399
060650432721,845,239,606,859,230,629,1433,505,901,944,262,644
060650432723,759,222,537,766,213,553,1205,383,795,917,266,595
060650432272,731,279,452,744,268,476,1075,459,586,1064,387,618
060650432274,566,223,343,574,221,353,160,64,92,618,226,355
060650432781,360,136,224,369,131,238,534,229,293,383,139,223
060650497011,809,246,563,822,237,585,1182,389,766,947,282,624
060650506002,374,143,231,378,136,242,569,218,341,481,151,305
060650430082,238,128,110,237,120,117,366,196,158,320,127,172
060650464022,477,206,271,479,199,280,893,415,462,594,243,317
060650429024,168,126,42,165,122,43,420,300,114,222,161,49
060650429021,106,79,27,105,74,31,170,122,47,154,111,35
060650429051,224,170,54,223,160,63,368,253,108,314,233,64
060650429071,348,264,84,353,252,101,568,414,140,505,376,102
060650429081,251,188,63,253,181,72,463,314,135,344,255,73
060650429034,165,127,38,165,123,42,300,208,80,240,181,45
060650429031,144,112,32,150,110,40,279,199,75,217,159,50
060650428021,304,241,63,301,220,81,591,425,142,558,411,109
060650429022,121,60,61,122,52,70,202,93,106,168,76,82
060650432722,775,176,599,786,172,614,1113,292,807,820,176,614
060650497023,491,136,355,494,129,365,714,228,476,522,138,359
060650512003,606,213,393,614,213,401,919,369,528,708,258,411
060650512001,419,116,303,421,111,310,601,183,402,462,133,303
060650432541,367,146,221,370,140,230,679,291,370,452,170,252
060650406031,453,279,174,456,266,190,1014,601,386,560,320,208
060650406061,291,181,110,293,174,119,639,374,248,410,256,129
060650406062,228,140,88,227,136,91,308,174,125,270,172,85
060650404031,420,243,177,421,229,192,857,487,351,462,260,181
060650404032,188,98,90,191,97,94,286,163,118,236,134,91
060650404033,397,235,162,399,221,178,622,349,251,501,284,190
060650405012,479,284,195,487,270,217,759,432,316,574,324,213
060650405022,299,180,119,304,177,127,398,261,130,355,206,132
060650405021,300,209,91,305,205,100,512,324,177,383,250,112
060650404021,412,218,194,419,212,207,381,218,157,480,258,194
060650410043,245,110,135,247,105,142,654,368,271,288,125,143
060650404022,617,325,292,620,313,307,788,448,324,775,426,304
060650402022,356,174,182,362,171,191,543,317,215,436,218,195
060650404041,421,237,184,422,236,186,692,393,284,566,317,217
060650404042,288,163,125,287,161,126,493,282,205,377,210,149
060650404051,700,336,364,708,321,387,702,370,318,783,358,390
060650405032,754,477,277,764,468,296,1159,602,536,868,529,301
060650405031,430,277,153,437,275,162,675,349,310,561,350,188
060650406042,578,304,274,589,298,291,739,386,343,681,338,299
060650406043,652,308,344,661,303,358,971,505,448,766,350,374
060650406183,1310,731,579,1326,713,613,2797,1501,1231,1022,545,416
060650405023,400,267,133,406,263,143,654,363,279,481,308,152
060650406041,528,233,295,532,229,303,742,387,345,639,276,331
060650406221,222,146,76,223,144,79,382,232,136,294,188,91
060650406162,673,402,271,682,395,287,1430,798,610,581,329,226
060650406051,273,185,88,275,179,96,365,231,127,323,205,102
060650406052,180,122,58,178,116,62,322,205,111,232,146,73
060650405011,548,353,195,552,335,217,885,492,373,668,392,233
060650405013,473,310,163,477,300,177,833,482,336,597,363,201
060650401021,657,416,241,659,401,258,639,387,242,667,400,230
060650401022,441,274,167,440,262,178,1392,862,505,561,330,199
060650403032,624,363,261,629,347,282,997,529,449,486,278,186
060650403031,283,179,104,281,172,109,461,241,213,324,181,127
060650403021,860,385,475,867,365,502,1183,608,555,916,435,432
060650404053,742,330,412,745,311,434,1318,684,610,904,402,461
060650401012,570,416,154,575,409,166,1044,694,323,776,553,188
060650401011,192,159,33,192,155,37,327,252,66,244,213,20
060650402041,164,138,26,167,135,32,247,191,49,111,89,17
060650403043,159,131,28,159,128,31,284,215,57,188,148,29
060650403041,260,209,51,260,203,57,332,252,67,251,196,40
060650403051,363,231,132,366,222,144,581,352,215,696,416,233
060650302001,674,481,193,674,473,201,621,412,199,775,530,188
060650402012,82,58,24,83,57,26,131,81,49,93,61,27
060650402042,181,154,27,180,149,31,279,213,57,207,165,32
060650403042,157,117,40,158,113,45,244,180,58,206,124,68
060650403052,415,254,161,420,241,179,610,392,207,524,305,181
060650402031,216,163,53,214,153,61,352,239,109,355,263,70
060650402032,241,204,37,239,188,51,743,555,171,366,265,79
060650403024,483,247,236,489,241,248,750,394,339,634,329,265
060650403023,431,260,171,437,246,191,898,527,354,574,313,219
060650403022,392,180,212,393,179,214,639,343,279,475,224,230
060650404052,344,155,189,345,155,190,491,234,246,395,171,205
060650402011,499,261,238,512,253,259,694,403,275,597,292,264
060650402021,345,214,131,349,207,142,613,349,245,395,229,137
060650402014,588,377,211,590,364,226,1044,605,408,600,419,143
060650402013,224,144,80,225,138,87,313,183,124,246,170,62
060650308002,298,169,129,298,166,132,410,248,147,335,169,135
060650308003,493,256,237,497,240,257,720,436,256,584,270,271
060650308004,453,238,215,457,225,232,658,401,236,549,258,250
060650307001,587,358,229,596,356,240,764,468,278,681,394,241
060650307002,450,275,175,458,274,184,587,355,210,493,285,171
060650307003,414,244,170,420,242,178,496,307,182,440,238,173
060650307004,359,211,148,363,208,155,437,268,156,361,194,141
060650307005,432,264,168,438,262,176,575,348,205,483,278,169
060650302004,608,356,252,609,351,258,731,451,264,643,344,248
060650302002,385,241,144,392,240,152,529,328,194,420,248,140
060650308001,267,153,114,270,153,117,400,244,143,303,156,122
060650301031,193,129,64,193,125,68,314,209,96,239,146,68
060650301032,260,176,84,263,172,91,399,271,122,305,193,87
060650303001,280,186,94,285,185,100,460,295,157,329,203,94
060650303004,175,118,57,175,114,61,294,184,106,213,133,63
060650303002,207,140,67,207,133,74,410,254,148,242,151,69
060650303003,195,131,64,194,126,68,328,206,117,222,138,63
060650302003,290,197,93,295,194,101,435,269,160,325,212,91
060650301041,547,380,167,551,380,171,1079,721,335,716,492,175
060650301043,165,114,51,166,112,54,256,173,80,209,141,53
060650301042,344,238,106,346,239,107,552,368,170,456,316,110
060650301044,377,252,125,381,239,142,659,437,204,461,286,133
060650423001,587,381,206,593,361,232,919,592,300,696,424,220
060650309001,332,220,112,332,213,119,491,309,177,395,235,131
060650309002,503,330,173,504,320,184,787,484,279,582,346,192
060650310022,310,201,109,312,194,118,482,290,181,365,220,117
060650310023,260,164,96,261,158,103,440,258,170,324,199,103
060650308005,212,129,83,218,127,91,382,214,153,273,170,85
060650310021,342,208,134,346,203,143,648,365,263,439,277,133
060650308006,597,335,262,602,317,285,863,493,354,655,349,266
060650310011,600,330,270,610,320,290,918,523,374,715,375,293
060650311003,427,236,191,435,228,207,603,342,248,506,262,207
060650311001,496,259,237,503,256,247,743,420,301,562,274,241
060650311002,593,310,283,606,308,298,835,474,342,706,345,304
060650310014,361,189,172,370,189,181,536,304,218,398,204,166
060650310013,332,174,158,340,173,167,476,269,194,381,195,159
060650310012,539,283,256,552,281,271,794,451,324,633,324,266
060650314011,265,152,113,271,149,122,425,257,158,340,179,139
060650314012,488,289,199,499,281,218,776,468,288,615,342,223
060650314024,236,140,96,243,136,107,400,242,150,295,166,107
060650314025,298,176,122,303,171,132,503,303,187,362,202,131
060650314014,372,212,160,377,204,173,531,318,198,440,225,188
060650314013,472,262,210,477,261,216,717,417,280,569,312,220
060650314021,342,190,152,344,189,155,482,279,189,425,234,164
060650314022,319,177,142,323,177,146,492,287,193,374,205,144
060650410022,426,266,160,432,254,178,601,369,214,496,284,178
060650410041,355,229,126,362,222,140,541,336,194,437,263,144
060650410011,217,160,57,221,158,63,445,278,160,326,234,72
060650410021,204,151,53,206,146,60,419,259,151,312,223,69
060650410042,278,205,73,283,202,81,523,322,187,374,269,82
060650423003,1007,596,411,1019,572,447,1608,959,611,698,395,262
060650423002,374,222,152,376,214,162,611,368,230,457,263,171
060650406171,768,427,341,777,418,359,2109,1184,895,1157,650,459
060650406172,1007,553,454,1021,543,478,770,431,327,738,410,294
060650406181,371,238,133,373,231,142,845,499,333,419,244,142
060650406182,204,133,71,206,130,76,328,189,129,242,135,90
060650406223,652,399,253,654,388,266,1104,650,438,753,449,266
060650406093,1003,503,500,1018,494,524,1651,859,763,1168,605,507
060650406094,718,359,359,730,357,373,1187,621,551,812,420,356
060650415001,99,68,31,100,66,34,99,60,37,119,85,27
060650406092,1237,620,617,1247,611,636,2262,1179,1054,1391,688,639
060650406164,662,373,289,672,371,301,1395,728,643,817,472,310
060650406163,446,253,193,451,251,200,964,504,446,537,313,203
060650406161,645,368,277,652,363,289,992,516,460,632,370,237
060650406222,407,233,174,410,227,183,665,370,288,497,283,194
060650406211,487,270,217,494,264,230,953,535,398,651,378,244
060650406212,593,333,260,599,327,272,940,528,392,653,383,243
060650406193,366,202,164,372,199,173,691,377,300,452,259,170
060650406192,350,190,160,350,188,162,536,304,225,388,222,147
060650406113,595,328,267,604,320,284,968,533,417,684,378,276
060650406114,410,227,183,414,226,188,710,391,306,501,266,210
060650406112,813,435,378,826,426,400,1519,813,682,960,526,391
060650406203,616,343,273,620,339,281,1027,569,440,827,441,345
060650406201,608,335,273,620,329,291,982,543,425,640,353,261
060650406204,655,369,286,661,360,301,1525,806,693,802,454,314
060650406111,420,233,187,424,231,193,731,402,312,481,254,202
060650406202,311,173,138,314,172,142,513,284,222,369,195,156
060650406091,1018,529,489,1032,522,510,2132,1110,993,1160,628,474
060650406191,732,412,320,740,404,336,1294,672,600,860,490,336
060650414102,185,136,49,187,132,55,289,214,68,237,173,51
060650414111,350,266,84,352,254,98,547,372,166,423,315,88
060650414112,319,252,67,322,245,77,502,334,159,356,275,62
060650414121,754,471,283,758,459,299,1135,670,439,863,516,306
060650414101,211,145,66,214,138,76,310,205,89,254,170,69
060650419091,432,194,238,442,190,252,600,284,304,494,226,247
060650419092,383,170,213,385,165,220,552,255,280,442,195,224
060650419093,415,185,230,419,180,239,756,350,389,405,186,202
060650419094,415,186,229,421,182,239,655,289,355,538,209,304
060650481003,608,242,366,614,237,377,708,324,367,710,286,393
060650407011,1036,269,767,1049,261,788,1132,339,774,1142,311,789
060650407031,424,114,310,438,109,329,580,173,400,492,126,344
060650407021,476,147,329,482,138,344,897,266,614,563,161,371
060650407022,500,145,355,510,136,374,649,193,447,584,157,396
060650408131,905,281,624,927,283,644,1464,475,956,1173,375,737
060650408122,716,235,481,731,237,494,1025,307,697,774,253,479
060650466011,238,71,167,241,68,173,302,98,203,246,72,168
060650466021,518,169,349,527,162,365,721,238,472,561,172,362
060650408082,346,220,126,350,219,131,658,329,313,441,265,147
060650466022,969,298,671,984,284,700,1396,443,924,1076,310,714
060650408121,481,165,316,486,157,329,757,223,517,628,194,389
060650408132,773,232,541,787,229,558,905,273,613,765,233,496
060650407032,641,188,453,653,184,469,1110,329,760,696,202,464
060650408062,523,184,339,533,178,355,785,319,449,615,195,385
060650408061,614,233,381,626,225,401,987,451,506,652,231,383
060650408161,763,418,345,774,414,360,1202,670,504,898,490,359
060650419042,646,291,355,653,285,368,820,392,411,717,304,373
060650419043,363,170,193,367,165,202,545,301,227,417,204,184
060650419052,338,191,147,346,190,156,436,249,178,325,167,134
060650419132,661,322,339,671,313,358,1080,513,543,779,339,377
060650419133,633,293,340,645,294,351,1003,479,508,740,328,369
060650479022,708,295,413,723,295,428,1098,503,576,677,282,361
060650418031,910,388,522,933,391,542,1234,572,639,1009,438,514
060650418042,899,376,523,914,365,549,1385,666,694,1003,418,536
060650408143,309,180,129,314,178,136,499,283,204,387,220,147
060650408141,434,257,177,441,253,188,659,388,256,850,501,298
060650408213,314,180,134,319,175,144,556,311,231,373,210,141
060650408212,477,289,188,482,285,197,900,505,373,582,337,209
060650408091,565,302,263,571,290,281,762,429,316,620,347,238
060650482001,775,414,361,783,398,385,1139,639,475,879,488,342
060650482002,518,298,220,522,290,232,865,487,361,634,361,233
060650408211,169,105,64,171,103,68,290,163,120,185,108,67
060650408214,416,256,160,420,253,167,774,433,321,519,305,185
060650408142,358,225,133,365,222,143,635,377,243,490,298,164
060650408151,527,309,218,531,301,230,832,495,319,629,378,221
060650408152,449,269,180,459,266,193,774,460,296,551,333,188
060650418091,324,169,155,330,164,166,520,265,240,401,194,186
060650418092,460,239,221,466,228,238,739,378,342,530,281,219
060650418094,246,128,118,250,123,127,387,199,179,332,162,154
060650418093,464,241,223,471,233,238,727,371,335,546,281,236
060650418103,776,338,438,791,328,463,1156,532,606,923,408,471
060650408072,719,283,436,733,272,461,1010,505,484,901,340,516
060650408071,419,189,230,423,183,240,633,316,302,479,216,234
060650408081,413,210,203,418,206,212,741,369,354,499,251,219
060650408084,273,124,149,278,121,157,403,202,194,324,147,157
060650408083,356,227,129,360,227,133,674,338,325,444,267,148
060650408092,353,243,110,356,236,120,614,370,222,524,291,202
060650415002,392,260,132,395,254,141,866,543,289,395,281,91
060650417032,490,297,193,492,289,203,798,482,294,646,416,186
060650418051,430,257,173,438,245,193,655,396,242,529,277,220
060650418052,554,334,220,560,324,236,1177,711,433,735,368,318
060650419061,255,157,98,255,152,103,397,239,147,303,170,114
060650419062,420,258,162,422,252,170,862,520,318,503,280,187
060650419063,310,191,119,313,186,127,476,287,174,407,222,156
060650418053,561,340,221,569,324,245,781,470,290,687,360,279
060650417031,198,119,79,198,115,83,323,196,120,230,159,56
060650417033,224,135,89,226,132,94,360,217,132,230,166,52
060650417021,274,193,81,277,187,90,394,234,145,320,223,78
060650417022,597,355,242,609,348,261,907,538,334,782,381,349
060650417023,388,199,189,395,195,200,533,318,196,468,233,203
060650417041,295,208,87,296,201,95,452,270,169,344,242,83
060650417042,303,215,88,308,208,100,483,286,179,316,222,74
060650416011,184,129,55,191,126,65,318,195,120,227,157,51
060650416021,297,210,87,299,202,97,504,302,188,350,235,91
060650416022,113,78,35,113,74,39,201,123,77,132,93,31
060650416012,253,177,76,253,170,83,405,247,154,290,200,67
060650418121,625,302,323,632,290,342,865,456,385,719,319,351
060650418131,502,279,223,507,270,237,750,395,339,582,303,252
060650418132,714,393,321,725,379,346,1101,578,502,833,457,331
060650418133,391,236,155,393,227,166,601,318,268,408,265,122
060650418122,573,259,314,573,248,325,826,433,381,651,278,328
060650418071,344,172,172,349,166,183,473,283,176,424,201,194
060650418072,434,217,217,441,209,232,583,346,214,510,242,233
060650419041,515,221,294,524,220,304,782,374,395,610,251,317
060650419122,584,254,330,593,250,343,876,415,440,692,287,358
060650419121,1026,470,556,1044,459,585,1648,785,830,1123,512,553
060650419123,554,254,300,565,248,317,813,386,410,640,283,319
060650419051,447,219,228,454,212,242,634,305,317,546,239,265
060650419064,375,183,192,382,179,203,515,292,211,372,203,142
060650419131,385,189,196,391,183,208,572,275,286,446,194,216
060650418041,742,309,433,757,303,454,1056,506,526,846,345,450
060650418061,708,330,378,719,330,389,1049,503,526,797,396,367
060650418062,866,404,462,877,403,474,1240,595,619,1029,457,522
060650418082,897,410,487,915,408,507,1302,624,652,1022,479,504
060650418081,853,383,470,868,376,492,1198,556,622,1045,431,566
060650418083,550,251,299,562,250,312,898,430,454,661,293,342
060650418101,772,325,447,786,323,463,1229,561,652,845,361,443
060650418102,686,287,399,698,287,411,1012,465,538,779,311,434
060650479013,751,300,451,761,295,466,1146,522,606,842,330,478
060650479021,843,333,510,850,323,527,1226,563,648,1107,432,633
060650479023,771,315,456,786,311,475,1244,563,658,928,377,513
060650479011,395,168,227,402,165,237,587,267,309,445,191,231
060650479012,755,300,455,762,290,472,1168,528,616,861,367,442
060650418032,322,144,178,327,137,190,630,290,329,372,172,185
060650418033,858,381,477,872,366,506,1359,628,709,1038,457,529
060650481001,854,341,513,865,338,527,1450,659,759,982,399,543
060650427442,457,209,248,465,203,262,982,476,489,569,246,292
060650427451,1132,441,691,1143,429,714,1322,547,760,1263,479,740
060650435173,708,396,312,717,376,341,698,394,291,784,417,313
060650435171,560,325,235,566,308,258,1051,579,441,658,361,266
060650513021,699,335,364,702,333,369,987,521,439,852,393,416
060650513012,412,227,185,418,226,192,1614,877,690,579,317,237
060650435091,495,266,229,503,235,268,814,359,438,621,276,298
060650435093,171,87,84,172,83,89,241,136,101,196,107,75
060650435092,472,269,203,471,242,229,797,422,356,614,307,259
060650436022,308,199,109,309,196,113,619,327,277,392,235,132
060650436011,308,173,135,310,162,148,509,287,217,360,209,132
060650513022,404,210,194,408,191,217,680,293,378,592,260,294
060650435172,491,291,200,496,272,224,892,498,369,580,323,228
060650435182,487,228,259,491,214,277,902,409,486,658,296,334
060650435062,547,281,266,550,280,270,1137,623,490,714,362,322
060650435222,105,62,43,106,60,46,284,157,121,126,68,52
060650436021,233,152,81,232,149,83,459,257,194,292,179,96
060650513011,567,331,236,580,317,263,1058,558,471,773,424,307
060650435231,283,175,108,289,170,119,561,298,252,393,214,157
060650435123,360,205,155,363,202,161,580,319,242,469,256,184
060650435131,647,319,328,648,309,339,1019,535,455,808,383,382
060650436012,303,201,102,304,195,109,647,358,272,405,237,141
060650435243,612,260,352,615,254,361,808,417,369,762,305,411
060650435122,380,184,196,384,181,203,704,386,295,492,241,225
060650435124,394,200,194,398,199,199,636,352,268,518,258,233
060650435241,427,174,253,429,167,262,503,247,247,505,200,280
060650435242,213,114,99,215,111,104,338,188,145,278,140,124
060650435121,418,222,196,423,220,203,702,383,291,518,258,227
060650435232,381,167,214,387,164,223,625,297,315,435,185,231
060650435221,248,158,90,248,154,94,402,237,154,331,192,117
060650435211,333,189,144,333,185,148,712,400,290,415,224,166
060650432931,1101,292,809,1110,290,820,1326,365,939,1213,290,865
060650432923,467,136,331,469,131,338,646,222,415,508,136,347
060650432932,292,72,220,292,68,224,364,101,257,340,80,241
060650432921,746,192,554,753,186,567,936,260,654,779,189,550
060650432971,867,318,549,878,307,571,1396,587,782,1322,484,751
060650432671,1188,408,780,1204,398,806,1821,746,1040,1401,477,858
060650432922,467,116,351,475,115,360,795,216,565,595,138,429
060650432461,404,86,318,409,85,324,557,144,399,444,86,332
060650432463,496,162,334,502,160,342,698,270,411,580,178,372
060650432653,341,130,211,345,128,217,566,238,312,424,148,248
060650432021,552,218,334,558,213,345,849,361,468,889,331,514
060650432031,1407,565,842,1421,549,872,2042,890,1112,1198,470,662
060650432022,424,160,264,426,153,273,688,286,390,486,181,279
060650432023,658,273,385,664,268,396,1021,450,550,745,298,410
060650432032,175,51,124,178,52,126,238,76,159,204,51,147
060650432962,799,302,497,802,288,514,1453,637,785,869,326,493
060650432983,856,385,471,864,366,498,1191,559,615,1066,424,593
060650432011,653,304,349,661,297,364,1033,477,530,1009,377,569
060650432981,723,324,399,727,305,422,1037,494,528,765,307,413
060650432982,366,163,203,370,155,215,505,241,258,419,168,230
060650434011,328,167,161,334,166,168,567,307,253,466,233,206
060650434012,344,179,165,349,179,170,512,285,221,418,199,192
060650434013,289,159,130,292,159,133,457,236,215,354,185,154
060650434051,281,148,133,284,148,136,356,189,154,306,149,139
060650434052,278,156,122,281,155,126,487,246,235,392,207,164
060650434053,334,182,152,337,182,155,608,308,282,428,220,187
060650435212,143,80,63,143,79,64,372,186,177,215,115,91
060650435213,136,77,59,139,76,63,235,117,112,179,95,76
060650433091,206,104,102,207,102,105,410,206,192,273,131,126
060650433092,261,131,130,266,130,136,483,243,230,347,165,158
060650433102,353,173,180,358,168,190,587,269,300,445,206,213
060650433101,295,130,165,300,129,171,509,238,258,387,162,206
060650433111,286,109,177,289,105,184,412,207,195,342,121,201
060650437021,903,333,570,917,321,596,1181,520,637,1040,369,611
060650427452,819,330,489,829,321,508,966,431,517,904,348,523
060650427453,297,97,200,299,95,204,537,170,355,340,103,221
060650435202,449,181,268,452,173,279,606,277,327,480,184,280
060650435201,316,131,185,319,125,194,516,238,271,361,142,203
060650435051,616,255,361,626,252,374,873,401,450,718,284,405
060650435061,661,273,388,676,271,405,864,400,454,760,304,431
060650435064,277,114,163,281,113,168,350,161,181,307,121,174
060650435063,284,118,166,290,117,173,416,191,215,344,135,193
060650435181,483,227,256,485,206,279,824,414,401,645,287,315
060650435031,252,121,131,259,122,137,381,191,179,294,128,154
060650435034,288,133,155,295,133,162,492,244,236,371,158,198
060650435032,358,181,177,365,182,183,509,274,223,432,197,218
060650435033,297,150,147,301,150,151,438,238,193,347,160,175
060650435052,588,298,290,600,298,302,832,452,368,698,318,353
060650433061,725,318,407,734,312,422,1127,525,578,857,341,476
060650433062,641,281,360,652,276,376,974,453,492,771,303,424
060650435191,161,70,91,165,70,95,231,108,118,205,83,113
060650435192,276,121,155,282,119,163,401,187,204,351,142,194
060650433071,532,237,295,541,230,311,794,390,394,646,261,351
060650434041,445,221,224,450,218,232,678,359,307,551,254,271
060650434042,389,190,199,394,186,208,588,296,279,477,212,240
060650433192,491,261,230,498,247,251,891,423,453,622,288,301
060650427233,222,91,131,219,87,132,344,151,186,267,106,148
060650433182,997,415,582,1008,419,589,1313,627,668,1187,473,667
060650433181,474,198,276,482,200,282,670,318,340,538,213,302
060650433162,571,217,354,576,213,363,685,327,348,637,237,372
060650433163,617,280,337,624,270,354,942,449,478,697,305,354
060650433191,542,295,247,546,279,267,992,472,502,678,317,321
060650433074,541,201,340,549,200,349,718,344,365,632,227,377
060650433072,328,131,197,332,128,204,479,237,235,379,146,217
060650433161,402,148,254,407,147,260,487,232,248,461,166,277
060650433082,250,127,123,252,123,129,441,230,200,303,159,119
060650434031,277,158,119,281,156,125,464,248,202,379,193,164
060650434032,269,157,112,271,152,119,455,250,192,347,176,150
060650433073,214,98,116,217,95,122,347,173,165,263,116,135
060650433121,341,184,157,352,185,167,609,307,288,511,258,227
060650433122,379,180,199,391,182,209,666,323,330,503,231,242
060650433045,526,205,321,538,204,334,552,229,309,611,223,354
060650433043,334,138,196,342,137,205,507,238,255,435,174,235
060650438131,211,83,128,212,80,132,319,129,183,252,94,138
060650432271,495,186,309,500,175,325,694,304,370,583,210,341
060650432782,515,189,326,521,186,335,1065,407,637,840,289,511
060650432783,616,215,401,620,204,416,600,227,360,507,161,326
060650432784,658,230,428,664,222,442,1152,443,690,741,263,443
060650432292,693,253,440,703,250,453,985,430,527,862,313,513
060650504022,386,152,234,391,147,244,651,286,347,477,174,275
060650504012,323,119,204,325,116,209,469,206,251,369,136,215
060650504011,440,161,279,443,157,286,644,282,343,509,192,289
060650504014,461,177,284,467,172,295,751,330,402,520,210,287
060650504013,328,138,190,333,130,203,514,227,274,384,154,201
060650504021,408,169,239,412,162,250,747,328,400,504,204,257
060650504023,643,275,368,651,261,390,1024,448,545,791,294,435
060650507021,491,222,269,496,217,279,1718,810,874,593,243,319
060650507012,414,186,228,418,185,233,729,343,371,468,189,258
060650507022,632,237,395,642,235,407,1003,445,541,767,257,477
060650507011,1187,516,671,1213,507,706,1172,536,621,1126,468,602
060650432101,619,229,390,629,228,401,871,360,497,725,278,403
060650503023,542,226,316,547,212,335,966,448,502,645,249,360
060650503021,545,227,318,548,212,336,857,379,461,654,245,373
060650503022,453,208,245,461,206,255,1205,550,632,553,237,285
060650432102,872,293,579,886,281,605,1127,424,690,1018,401,564
060650503011,505,205,300,512,203,309,589,276,298,555,216,307
060650432951,316,127,189,320,124,196,400,167,225,365,136,210
060650503012,705,309,396,716,307,409,1210,570,615,853,368,435
060650503013,429,201,228,435,197,238,736,348,376,521,226,262
060650497022,1094,335,759,1103,327,776,1564,527,1010,1336,375,901
060650497012,766,234,532,775,232,543,1074,360,694,872,245,584
060650432273,684,278,406,689,264,425,1260,458,769,793,306,436
060650506001,365,147,218,368,142,226,573,190,375,485,151,311
060650506003,403,130,273,406,123,283,531,212,307,437,126,290
060650432282,850,322,528,863,311,552,2334,1060,1230,948,352,540
060650497021,838,212,626,848,205,643,1054,340,690,811,212,556
060650506004,738,186,552,751,182,569,1309,422,863,832,261,539
060650498001,627,217,410,631,210,421,1023,400,609,926,312,560
060650498002,471,159,312,479,159,320,347,122,224,266,77,174
060650432281,399,156,243,403,151,252,246,111,130,161,59,93
060650432293,1011,388,623,1022,380,642,1273,573,680,1037,387,597
060650432291,905,332,573,916,332,584,1014,443,553,1080,396,644
060650432061,511,221,290,515,212,303,1242,544,672,1147,434,656
060650432062,314,133,181,319,126,193,409,177,221,377,154,206
060650432063,799,347,452,806,334,472,1327,580,722,960,374,525
060650432065,463,205,258,462,198,264,813,355,443,491,198,260
060650506005,647,244,403,655,245,410,642,289,344,802,235,536
060650432064,167,74,93,169,72,97,312,135,169,306,124,160
060650432112,442,185,257,450,183,267,708,332,361,485,176,283
060650432113,520,214,306,530,210,320,834,360,457,646,231,378
060650432114,436,177,259,446,173,273,710,287,408,575,203,340
060650432111,389,162,227,393,160,233,476,223,241,495,193,271
060650432103,261,109,152,267,108,159,404,191,206,355,145,186
060650505022,589,264,325,600,258,342,1015,481,511,710,302,371
060650505032,564,263,301,574,256,318,1150,542,586,568,254,284
060650496002,952,448,504,971,438,533,1283,628,630,910,385,470
060650505031,260,123,137,268,121,147,476,228,240,328,148,164
060650505033,511,247,264,516,238,278,741,357,373,599,262,300
060650505021,456,215,241,463,209,254,840,403,422,545,246,271
060650432091,387,157,230,393,153,240,366,172,185,493,184,285
060650432092,817,331,486,826,321,505,1693,793,865,1113,411,648
060650505011,321,129,192,323,126,197,545,255,277,271,109,147
060650505012,356,175,181,358,168,190,575,276,291,426,187,212
060650505013,605,295,310,610,282,328,999,489,491,694,301,351
060650432542,361,146,215,369,144,225,567,253,294,466,172,254
060650432543,858,357,501,873,345,528,1355,607,704,985,380,527
060650432082,654,300,354,661,292,369,1080,510,546,776,318,414
060650432083,510,233,277,517,225,292,778,364,391,621,247,339
060650432072,194,74,120,197,72,125,402,205,190,219,100,107
060650432073,756,344,412,767,333,434,1173,555,595,842,364,437
060650432081,359,165,194,363,163,200,615,290,310,420,177,219
060650432521,635,290,345,642,284,358,1332,629,674,817,343,426
060650432524,657,276,381,665,270,395,812,383,410,732,299,399
060650432523,408,189,219,413,185,228,489,230,247,316,133,164
060650432522,1054,401,653,1074,399,675,2085,950,1090,1020,405,575
060650432482,866,313,553,885,313,572,1234,573,634,983,356,572
060650432561,306,129,177,312,128,184,429,193,229,357,132,197
060650432201,527,248,279,537,237,300,1003,436,539,792,307,430
060650432202,586,287,299,594,271,323,1033,449,556,690,297,346
060650432662,203,104,99,206,99,107,411,208,185,249,108,118
060650432663,370,190,180,375,181,194,620,316,282,439,189,207
060650432664,191,97,94,191,93,98,342,175,156,233,100,110
060650432221,820,360,460,836,361,475,1464,719,698,889,281,552
060650432222,863,335,528,874,325,549,1193,530,637,1014,322,626
060650432071,247,93,154,252,91,161,355,185,166,271,125,133
060650432462,665,241,424,675,235,440,1028,437,563,800,277,477
060650432643,664,257,407,672,253,419,616,262,337,789,281,454
060650432654,342,133,209,343,129,214,991,425,540,423,150,243
060650432481,738,314,424,748,309,439,1156,518,614,903,334,506
060650432563,338,144,194,342,142,200,528,237,281,405,159,221
060650432562,449,192,257,455,189,266,701,315,374,534,216,287
060650432623,633,243,390,643,234,409,826,353,452,716,254,420
060650432622,554,212,342,565,207,358,775,330,425,664,235,391
060650432621,1050,424,626,1061,410,651,1334,570,732,1152,421,677
060650432641,675,309,366,686,295,391,1027,439,564,754,300,403
060650432642,727,334,393,743,321,422,1074,457,590,828,332,441
060650432644,843,317,526,854,312,542,1236,526,682,956,369,531
060650432652,888,347,541,903,347,556,1351,575,745,1028,346,620
060650432655,438,173,265,445,176,269,661,281,364,483,172,275
060650432651,406,161,245,411,162,249,594,253,326,485,163,291
060650432464,534,193,341,541,188,353,812,344,446,648,224,387
060650432182,833,297,536,843,293,550,1081,449,608,982,343,585
060650432012,681,280,401,687,278,409,1225,581,613,264,91,161
060650432172,529,249,280,537,245,292,882,390,478,862,361,455
060650432171,601,234,367,610,226,384,961,397,541,698,268,385
060650432181,706,273,433,720,266,454,999,417,563,809,310,444
060650496001,525,254,271,531,243,288,793,404,359,417,176,220
060650432183,702,239,463,710,225,485,959,375,564,779,271,461
060650432162,751,299,452,756,296,460,1099,497,584,864,349,440
060650432163,790,343,447,803,345,458,1159,537,594,914,354,491
060650432672,882,321,561,895,315,580,1188,485,680,977,348,584
060650432673,916,337,579,924,328,596,1289,526,740,994,354,599
060650432161,344,161,183,350,162,188,675,346,307,477,195,241
060650512002,202,95,107,207,97,110,319,165,146,217,105,98
060650496004,583,274,309,587,264,323,937,459,460,829,346,434
060650496003,349,164,185,356,161,195,539,264,264,399,168,208
060650432661,243,125,118,247,119,128,360,183,164,279,120,132
060650427371,760,282,478,773,280,493,1639,681,931,864,338,482
060650432351,1004,393,611,1014,378,636,1906,849,1021,978,373,565
060650507013,537,240,297,552,238,314,949,435,488,680,281,358
060650432352,1615,670,945,1633,657,976,3826,1758,1994,1529,615,825
060659415001,655,293,362,664,285,379,1135,491,606,789,323,414
060650427232,549,261,288,555,255,300,1547,738,768,500,226,252
060650427201,459,179,280,460,166,294,412,172,229,488,189,278
060650427203,415,180,235,423,174,249,813,376,422,466,195,251
060650427231,565,274,291,571,268,303,824,418,391,699,309,352
060650427261,308,111,197,314,109,205,477,196,275,373,144,223
060650427202,191,81,110,187,73,114,299,143,150,246,105,122
060650432961,44,17,27,44,16,28,0,0,0,54,19,31
060650432972,1545,634,911,1567,613,954,2789,1231,1500,1486,554,850
060650432942,585,237,348,593,223,370,1231,517,694,730,270,423
060650432953,650,274,376,657,253,404,1011,422,568,789,300,447
060650432952,350,148,202,351,134,217,491,206,279,466,175,261
060650432042,782,337,445,786,332,454,1148,506,624,716,270,396
060650432043,717,292,425,723,285,438,1851,813,1006,755,281,429
060650432052,661,270,391,666,262,404,1119,503,591,770,295,428
060650432041,415,174,241,418,170,248,552,243,297,376,144,212
060650432051,716,274,442,726,269,457,1166,493,653,848,298,490
060650432941,691,263,428,700,256,444,1124,470,635,808,283,485
060650433112,329,152,177,335,150,185,500,226,257,403,174,207
060650433081,229,120,109,229,114,115,396,181,201,300,143,129
060650433131,266,131,135,269,126,143,512,232,265,378,177,172
060650433132,390,156,234,399,157,242,606,273,311,490,193,265
060650433141,496,193,303,497,188,309,743,316,403,643,236,364
060650433041,648,233,415,657,233,424,879,373,487,800,264,491
060650433142,484,175,309,490,173,317,789,334,429,611,211,359
060650433151,730,263,467,739,258,481,1119,461,629,879,296,525
060650433044,711,259,452,721,245,476,1010,357,628,863,278,542
060650437022,485,177,308,489,166,323,735,274,451,563,184,353
060650437012,500,208,292,504,198,306,721,305,398,574,229,310
060650437031,424,181,243,430,168,262,649,275,359,533,208,285
060650437032,250,105,145,253,101,152,419,179,234,335,134,182
060659415002,479,195,284,485,186,299,679,286,377,586,217,333
060650437011,601,230,371,603,218,385,783,325,435,696,257,403
060650444042,503,280,223,510,279,231,430,250,172,406,191,187
060650444053,317,173,144,320,175,145,585,328,242,372,183,162
060650444071,480,152,328,486,152,334,702,233,452,542,164,344
060650444052,258,145,113,259,145,114,668,396,257,270,136,116
060650444073,392,183,209,394,187,207,564,282,265,420,188,208
060650444034,215,96,119,217,94,123,284,105,173,279,111,157
060650444041,437,259,178,442,255,187,340,203,130,622,332,243
060650444051,500,296,204,506,293,213,510,304,196,515,281,201
060650433042,399,98,301,402,94,308,826,283,524,417,108,287
060650444062,406,119,287,412,116,296,596,176,411,443,129,288
060650444061,491,161,330,494,149,345,632,181,440,544,139,372
060650444031,480,160,320,487,158,329,727,239,471,575,165,369
060650444032,219,69,150,218,66,152,275,93,178,250,71,163
060650444072,408,128,280,411,127,284,506,167,328,497,147,319
060650444033,256,82,174,256,81,175,350,119,228,302,86,197
060650451242,211,78,133,213,81,132,265,117,144,242,95,141
060650445072,475,303,172,481,299,182,507,354,143,588,358,200
060650445092,364,230,134,366,227,139,557,338,204,473,271,167
060650445172,511,283,228,514,281,233,772,431,326,532,274,236
060650445181,501,308,193,507,305,202,838,509,300,572,328,210
060650445171,547,252,295,552,255,297,783,384,389,607,255,331
060650445183,456,279,177,458,269,189,961,577,357,538,306,207
060650445242,243,149,94,243,146,97,419,255,156,286,172,104
060650445091,353,233,120,359,229,130,595,363,218,454,266,159
060650445182,429,281,148,425,271,154,728,448,269,571,336,197
060650445102,259,163,96,259,160,99,402,253,145,346,203,123
060650445103,278,187,91,278,182,96,475,319,151,370,233,116
060650445161,548,350,198,556,344,212,999,615,355,688,403,243
060650445164,292,171,121,293,169,124,466,283,174,331,195,118
060650445074,219,156,63,218,151,67,387,272,111,293,203,76
060650445071,271,194,77,276,189,87,501,353,138,368,252,96
060650445104,241,170,71,242,167,75,426,293,128,324,226,87
060650445101,148,105,43,147,101,46,264,181,71,225,153,59
060650445152,161,117,44,162,114,48,298,209,80,211,148,54
060650445151,431,329,102,432,317,115,769,562,183,622,456,130
060650445163,229,178,51,226,168,58,420,312,97,318,239,59
060650445162,165,122,43,166,118,48,313,223,84,227,157,53
060650445073,148,86,62,145,77,68,295,170,117,208,116,73
060650445202,319,172,147,318,166,152,439,236,196,354,178,163
060650445241,184,119,65,182,112,70,299,179,117,239,141,81
060650445231,189,94,95,192,95,97,313,170,137,193,96,92
060650445211,294,183,111,296,173,123,485,277,198,346,188,147
060650446043,446,344,102,448,344,104,637,488,138,517,383,120
060650446053,363,287,76,365,287,78,556,437,114,409,310,87
060650446052,439,348,91,439,348,91,593,460,122,481,363,103
060650446054,526,417,109,529,419,110,747,584,154,554,419,118
060650446042,363,262,101,365,263,102,445,336,109,413,296,109
060650446041,540,394,146,546,395,151,977,741,236,504,354,138
060659412001,276,203,73,279,204,75,730,616,109,317,257,53
060659412002,971,723,248,979,728,251,649,486,154,1061,697,321
060650446051,309,231,78,316,237,79,464,346,112,336,240,90
060650446064,450,331,119,455,334,121,544,399,142,491,340,139
060659413001,431,324,107,433,326,107,554,414,132,453,320,117
060659413002,394,295,99,399,300,99,524,391,125,407,289,106
060659413004,453,341,112,456,344,112,591,441,140,529,375,136
060659413003,287,216,71,291,219,72,357,264,85,295,210,76
060650446021,268,205,63,269,206,63,355,281,69,294,208,69
060650446022,479,364,115,486,369,117,517,413,104,522,384,131
060650446023,493,375,118,496,376,120,604,472,121,507,367,124
060650446063,307,236,71,313,239,74,397,314,81,325,236,82
060650446062,353,284,69,358,291,67,542,434,103,498,370,113
060659405001,654,499,155,662,507,155,760,607,147,639,460,160
060650447012,345,272,73,348,275,73,478,380,94,407,311,87
060650447013,299,241,58,301,245,56,380,302,74,326,253,67
060650447011,480,376,104,482,376,106,780,595,175,529,396,117
060650448062,424,342,82,429,350,79,422,343,76,474,362,98
060650448061,488,389,99,492,395,97,804,647,147,510,375,113
060659414001,324,263,61,325,269,56,413,330,79,335,257,68
060659414002,482,389,93,488,399,89,673,533,130,474,361,97
060650448041,445,347,98,448,347,101,621,465,146,484,361,111
060650448042,332,249,83,332,250,82,434,328,101,356,252,94
060659407001,485,375,110,489,376,113,704,538,164,522,380,124
060659414003,379,295,84,382,295,87,548,433,106,411,301,91
060650448051,476,364,112,484,369,115,509,411,94,456,333,114
060650448052,585,446,139,588,449,139,608,490,111,436,316,108
060650448071,251,192,59,253,193,60,340,254,80,265,188,67
060650448072,604,455,149,611,462,149,520,390,125,608,442,152
060659407002,429,326,103,433,329,104,499,380,117,429,306,108
060659407003,339,259,80,344,262,82,442,333,103,374,270,92
060659408001,349,263,86,353,268,85,481,376,101,327,235,82
060659408004,364,274,90,369,280,89,551,433,117,363,265,93
060659410011,507,360,147,508,365,143,705,537,160,478,315,152
060659410023,317,225,92,318,226,92,399,308,90,295,195,92
060659410012,323,229,94,324,232,92,338,246,85,373,245,118
060659410021,357,254,103,359,257,102,492,374,114,405,269,127
060659410022,422,299,123,424,303,121,579,438,134,341,225,108
060650450002,606,455,151,610,457,153,821,619,187,714,497,177
060659405003,246,186,60,248,188,60,320,251,67,263,188,68
060659405002,315,221,94,319,223,96,355,274,79,327,217,102
060659408002,408,306,102,410,309,101,470,371,98,390,287,99
060659408003,297,224,73,301,228,73,711,556,151,307,223,79
060659411001,263,187,76,262,181,81,421,321,96,292,185,99
060650449071,231,186,45,231,180,51,413,322,84,264,206,42
060650449072,167,134,33,165,129,36,280,221,56,185,147,27
060650449073,216,175,41,216,167,49,360,286,73,251,193,38
060650449262,376,289,87,378,282,96,638,471,159,406,307,80
060650449261,242,188,54,241,183,58,390,292,90,307,234,59
060650450001,283,215,68,287,216,71,320,243,74,301,214,75
060650450003,278,210,68,282,213,69,451,341,104,306,219,78
060650449332,158,117,41,159,116,43,242,185,51,165,131,26
060650449333,161,120,41,162,119,43,224,173,47,147,114,24
060650449331,91,68,23,92,67,25,131,98,27,98,77,15
060650449342,200,149,51,198,145,53,297,227,62,184,148,28
060650449341,221,165,56,225,164,61,302,234,63,236,190,37
060650449161,486,369,117,492,368,124,642,477,157,512,334,165
060650449162,385,278,107,385,274,111,549,401,142,510,295,195
060659411002,221,165,56,225,164,61,369,257,110,290,180,103
060659411003,312,232,80,312,228,84,560,389,166,452,280,159
060659409001,722,521,201,734,535,199,931,695,230,757,495,247
060659409002,338,203,135,341,210,131,469,293,170,329,204,117
060650449043,483,333,150,492,338,154,856,573,271,577,363,193
060650449042,515,360,155,520,358,162,766,526,237,622,384,215
060650449041,412,285,127,416,287,129,652,441,208,511,314,175
060650449311,881,588,293,889,585,304,1067,689,361,795,517,246
060659406001,305,208,97,308,208,100,470,301,158,331,192,126
060650449322,548,347,201,551,342,209,858,556,294,574,332,221
060650449321,170,107,63,172,106,66,575,374,195,382,261,107
060659406004,303,175,128,306,176,130,448,293,151,326,200,119
060659412003,364,208,156,368,205,163,575,362,205,323,198,111
060650447021,457,366,91,457,359,98,748,584,154,586,425,133
060650449251,218,162,56,220,158,62,341,241,93,273,197,62
060650449252,600,446,154,604,439,165,987,703,268,679,495,156
060650449263,431,319,112,430,311,119,665,473,180,574,434,112
060650449231,490,320,170,493,312,181,843,556,277,597,375,195
060650449232,457,299,158,455,287,168,706,468,233,554,349,182
060650449241,528,345,183,532,336,196,851,557,276,648,404,220
060650449242,480,314,166,480,302,178,788,510,254,589,367,200
060650445053,547,344,203,554,333,221,775,438,326,717,439,243
060650445052,435,291,144,435,277,158,779,448,328,538,358,160
060650445051,347,175,172,347,173,174,681,384,283,424,194,215
060650445054,448,227,221,450,225,225,522,298,221,419,193,214
060650445201,208,106,102,212,106,106,275,150,120,222,104,114
060650452333,265,112,153,267,108,159,320,136,179,331,132,181
060650452332,658,280,378,666,280,386,894,381,500,827,345,438
060650452331,358,155,203,364,162,202,874,372,488,473,213,229
060650452142,527,214,313,531,213,318,706,328,368,584,236,321
060650452143,710,244,466,722,245,477,991,421,553,795,246,519
060650452141,642,236,406,645,234,411,807,344,448,736,251,457
060650514013,711,341,370,720,345,375,774,409,363,739,345,380
060650514021,790,386,404,800,392,408,884,469,413,817,380,419
060650514011,1113,531,582,1123,538,585,1193,631,559,1139,527,588
060650514012,792,383,409,804,391,413,1181,622,551,841,394,434
060650514023,669,328,341,675,332,343,699,368,323,586,273,300
060650514022,555,274,281,561,276,285,837,441,392,632,296,325
060650451241,466,206,260,471,208,263,628,327,293,452,189,246
060659406003,408,233,175,414,237,177,990,618,364,392,210,175
060650449163,336,182,154,341,186,155,676,404,265,368,197,164
060650449164,356,194,162,359,195,164,252,152,99,375,199,167
060650449171,1022,591,431,1027,595,432,1088,650,429,1051,574,448
060650449183,454,209,245,457,211,246,390,188,198,459,190,259
060650449212,535,285,250,536,284,252,936,495,426,551,250,286
060650449211,676,380,296,681,382,299,883,528,345,719,388,312
060659406002,402,219,183,406,220,186,681,407,267,381,203,170
060650449174,413,239,174,417,242,175,354,213,140,424,234,181
060650451031,255,134,121,259,136,123,612,367,239,264,133,127
060650449172,416,225,191,421,228,193,561,337,219,441,225,204
060650449173,509,275,234,513,278,235,652,389,256,527,272,241
060650449181,521,281,240,526,284,242,677,404,266,663,336,310
060650451035,189,103,86,191,104,87,260,156,101,197,101,90
060650451034,174,94,80,177,94,83,76,47,29,95,49,45
060650451032,374,200,174,377,203,174,446,265,178,406,207,191
060650451033,389,189,200,396,194,202,539,289,243,575,277,277
060650449182,633,271,362,642,277,365,821,398,413,680,272,390
060650451182,399,204,195,403,204,199,627,300,321,464,223,220
060650449191,751,370,381,763,371,392,962,507,444,823,380,418
060650449192,657,284,373,665,284,381,892,472,409,667,256,393
060650449194,444,208,236,452,209,243,563,298,258,454,198,244
060650449193,609,286,323,620,287,333,775,413,357,611,268,328
060650449223,229,118,111,232,119,113,872,480,379,242,112,121
060650449221,631,301,330,644,306,338,512,257,249,367,159,195
060650449224,648,334,314,653,332,321,933,512,407,906,419,446
060650449292,413,223,190,417,221,196,561,296,256,428,213,196
060650449293,546,315,231,552,311,241,814,430,373,598,317,255
060650449294,221,127,94,223,126,97,427,226,196,235,126,100
060650449301,196,113,83,200,113,87,122,65,57,213,114,91
060650449302,176,101,75,178,100,78,311,164,142,206,110,88
060650449303,640,339,301,646,337,309,1022,571,434,675,331,319
060650449283,227,89,138,228,88,140,368,152,213,229,89,133
060650449281,285,120,165,288,120,168,394,209,180,325,119,197
060650449284,700,293,407,707,292,415,883,469,407,774,286,465
060650451232,576,217,359,581,218,363,830,395,423,541,243,266
060650449222,584,256,328,592,261,331,805,392,400,618,264,333
060650449272,582,255,327,590,260,330,842,411,424,637,276,347
060650449273,391,172,219,400,177,223,580,283,289,416,179,224
060650449271,428,186,242,438,193,245,540,264,271,453,193,244
060650449111,663,337,326,663,327,336,922,462,441,690,333,328
060650449114,516,262,254,517,255,262,715,367,333,581,279,274
060650449112,421,215,206,422,207,215,630,331,287,478,231,227
060650449113,323,149,174,325,146,179,451,222,220,350,156,180
060650449282,273,139,134,276,137,139,408,196,205,340,164,161
060650451261,501,291,210,501,285,216,660,399,243,457,255,180
060650451181,306,178,128,309,176,133,551,326,214,395,219,157
060650451271,867,440,427,873,439,434,1063,544,500,973,449,481
060650451262,214,124,90,215,123,92,327,196,119,265,141,108
060650451272,214,125,89,216,124,92,336,204,123,239,129,96
060650451174,415,216,199,424,222,202,715,365,338,445,218,210
060650451191,628,325,303,633,323,310,1014,565,432,683,328,329
060650451192,273,158,115,275,157,118,409,235,163,308,165,127
060650449291,473,233,240,479,232,247,610,321,279,491,222,248
060650451162,224,121,103,226,122,104,325,169,149,258,131,114
060650451161,321,160,161,326,162,164,430,227,199,352,172,169
060650451173,288,155,133,293,159,134,386,202,179,394,202,172
060650451172,400,210,190,405,211,194,563,298,258,434,216,199
060650451171,389,211,178,392,213,179,546,289,252,449,230,201
060650451141,546,248,298,550,249,301,562,294,258,601,262,315
060650451151,360,166,194,365,168,197,467,247,214,394,180,199
060650451152,580,266,314,588,267,321,770,404,353,624,277,320
060650451142,448,198,250,452,202,250,644,340,296,449,189,241
060650451253,137,45,92,140,45,95,251,104,143,147,51,90
060650451252,284,85,199,286,85,201,474,184,282,313,95,206
060650451222,423,131,292,426,132,294,335,134,198,410,125,273
060650451221,317,99,218,318,99,219,420,166,248,352,107,234
060650451231,499,153,346,505,156,349,534,211,318,547,169,360
060650452281,606,314,292,609,311,298,469,242,219,495,251,214
060650469003,194,64,130,196,64,132,188,74,112,251,86,155
060659404001,82,75,7,83,72,11,116,93,22,100,90,6
060650452144,603,282,321,606,274,332,825,405,404,642,257,358
060650452133,780,511,269,792,491,301,1187,766,388,894,570,274
060650452131,317,133,184,319,133,186,400,205,193,311,141,158
060650452341,1053,440,613,1066,435,631,1542,729,793,1273,531,683
060650452351,940,417,523,950,419,531,1074,518,536,870,399,436
060650452352,409,183,226,415,186,229,883,416,452,654,301,325
060650452342,348,163,185,351,166,185,467,220,239,387,164,203
060650452343,474,222,252,478,226,252,713,337,366,557,236,294
060650451292,665,276,389,674,283,391,844,432,394,726,336,362
060650451291,282,112,170,285,115,170,371,190,173,310,142,156
060650451282,565,225,340,572,232,340,633,328,298,561,201,345
060650451281,259,102,157,263,106,157,345,177,161,356,125,218
060650451293,247,97,150,251,101,150,309,158,144,274,97,168
060650451294,322,127,195,327,132,195,431,221,202,389,138,237
060650451295,280,111,169,284,115,169,391,200,183,328,116,201
060650451201,248,132,116,250,131,119,398,204,188,300,142,145
060650451202,711,380,331,719,378,341,1043,543,497,846,464,335
060650451204,304,162,142,306,161,145,491,252,231,344,162,166
060650451203,143,77,66,145,77,68,215,113,102,178,84,87
060650451251,424,225,199,425,222,203,657,337,310,499,249,231
060650451254,201,107,94,202,105,97,452,243,198,247,128,107
060650451091,577,325,252,582,319,263,834,488,330,669,374,263
060650451092,785,443,342,788,432,356,1099,643,441,876,506,333
060650451103,541,309,232,542,304,238,863,501,340,649,365,253
060650451102,535,307,228,541,303,238,814,467,318,635,348,250
060650451101,508,292,216,513,288,225,790,463,315,613,341,246
060650456132,165,81,84,169,82,87,261,143,109,190,90,94
060650456172,310,126,184,313,126,187,169,119,46,313,129,173
060650456064,390,120,270,393,120,273,302,127,173,426,130,285
060650456063,343,181,162,342,176,166,723,380,338,384,201,168
060650456062,104,32,72,104,32,72,171,73,98,110,33,74
060650456133,185,56,129,186,56,130,252,106,146,208,62,137
060650456131,222,66,156,223,66,157,293,123,167,240,71,163
060650456141,295,89,206,297,89,208,788,332,451,295,90,197
060650456171,1046,417,629,1054,413,641,1171,492,666,1023,405,600
060650456142,169,66,103,170,66,104,196,83,112,150,59,89
060650456192,190,164,26,189,155,34,375,295,66,343,296,26
060650456183,1,1,0,2,2,0,4,3,1,2,2,0
060650456182,23,20,3,22,19,3,186,154,30,30,25,3
060650456193,82,64,18,80,61,19,39,31,8,119,94,18
060650456061,147,76,71,147,75,72,928,508,414,163,86,72
060650456151,382,291,91,381,285,96,556,387,162,458,328,98
060650456101,375,344,31,376,334,42,196,161,31,216,193,12
060650456191,19,17,2,18,16,2,33,28,5,24,21,2
060650456161,174,145,29,176,141,35,407,312,86,241,197,29
060650456162,25,20,5,23,18,5,270,190,74,36,30,6
060650456152,128,97,31,128,89,39,173,120,50,199,153,36
060650456121,157,127,30,157,121,36,328,258,55,279,215,38
060650456122,64,59,5,63,57,6,46,38,7,29,25,4
060650456103,98,91,7,97,88,9,178,151,24,145,135,3
060650456102,82,76,6,82,75,7,69,60,9,210,192,6
060650456112,75,69,6,73,66,7,530,443,75,243,223,5
060650456111,1,1,0,1,1,0,200,168,29,95,87,3
060650456123,126,107,19,124,97,27,262,209,45,197,160,28
060650452282,759,368,391,767,367,400,1089,558,523,778,344,396
060650494001,726,376,350,732,373,359,1274,653,605,1083,505,555
060650494002,364,178,186,367,175,192,544,280,260,420,196,216
060650494003,546,263,283,550,261,289,778,399,372,635,296,326
060650452162,598,317,281,601,315,286,494,253,238,695,326,359
060650452161,502,267,235,509,267,242,997,512,476,573,268,295
060650452173,663,356,307,667,354,313,731,487,229,588,405,142
060650452171,617,373,244,620,363,257,968,554,397,673,377,262
060650452121,596,251,345,598,248,350,729,374,347,534,242,271
060650452122,428,180,248,427,178,249,604,317,280,427,193,217
060650453061,548,301,247,557,292,265,844,485,344,651,325,295
060650453051,692,379,313,696,366,330,1072,576,481,743,375,336
060650453052,422,232,190,424,222,202,799,430,353,485,244,221
060650453053,222,122,100,224,118,106,363,195,161,255,129,115
060650453062,208,137,71,207,129,78,649,375,265,264,146,106
060650453063,124,80,44,122,76,46,400,231,163,155,87,63
060650453064,276,181,95,283,177,106,601,346,245,347,193,137
060650453021,388,317,71,389,298,91,661,475,171,510,403,84
060650453022,178,146,32,178,138,40,243,177,66,245,195,41
060650453023,182,149,33,182,141,41,296,214,79,233,182,37
060650453031,488,357,131,492,342,150,350,263,75,575,387,157
060650453032,141,117,24,145,111,34,221,172,48,193,155,32
060650452222,78,47,31,79,46,33,359,191,163,91,50,36
060650455011,180,146,34,181,142,39,342,250,82,227,178,38
060650455013,175,142,33,174,136,38,334,247,81,212,171,34
060650455012,473,384,89,473,370,103,902,646,236,623,498,95
060650495022,237,195,42,232,185,47,485,372,108,327,261,53
060650495021,230,191,39,230,186,44,394,290,93,320,257,48
060650495011,287,237,50,285,230,55,312,230,74,374,301,57
060650495012,315,262,53,311,250,61,565,414,136,417,334,64
060650452221,666,348,318,676,346,330,411,224,185,538,304,212
060650452223,221,113,108,221,112,109,957,509,437,238,133,96
060650452132,678,467,211,677,447,230,1073,721,334,848,555,250
060650452244,433,301,132,433,298,135,710,471,221,552,377,149
060650452241,22,16,6,23,16,7,58,39,18,30,20,8
060650452092,487,347,140,488,329,159,867,582,269,633,475,128
060650452172,315,236,79,318,223,95,595,397,182,412,283,110
060650455022,281,209,72,280,197,83,497,338,155,330,251,66
060650452091,406,300,106,410,283,127,751,505,230,586,400,147
060650455021,227,167,60,228,159,69,452,309,143,326,231,76
060650452071,333,221,112,334,212,122,552,369,172,427,291,113
060650452072,467,310,157,469,298,171,795,531,250,620,423,164
060650452242,486,242,244,492,240,252,414,224,185,543,273,255
060650452243,879,437,442,886,432,454,978,530,440,835,421,389
060650491011,434,216,218,439,214,225,700,380,313,508,255,237
060650491012,73,36,37,74,36,38,123,65,54,85,42,39
060650491023,417,202,215,417,204,213,672,352,313,443,208,224
060650491022,274,133,141,277,136,141,387,205,181,327,151,166
060650491021,387,188,199,392,193,199,451,237,210,433,202,218
060650452261,363,316,47,363,301,62,711,559,139,506,411,65
060650452263,321,278,43,322,267,55,815,628,168,462,377,58
060650452262,283,245,38,286,236,50,545,426,107,399,325,53
060650457091,150,134,16,149,128,21,284,221,55,159,137,14
060650457062,130,118,12,130,112,18,246,193,49,184,162,15
060650457071,196,174,22,195,164,31,332,265,67,262,227,28
060650457074,277,244,33,277,233,44,456,353,91,362,305,35
060650457073,220,193,27,216,182,34,435,338,85,311,261,31
060659404003,456,402,54,453,380,73,655,507,128,591,500,58
060659404004,65,58,7,67,56,11,114,88,22,83,71,9
060650457041,202,182,20,203,174,29,377,297,73,367,318,30
060650457042,169,153,16,171,146,25,304,239,62,240,212,20
060650457081,247,220,27,245,211,34,212,167,40,274,237,24
060650457082,130,115,15,131,112,19,761,598,145,275,238,25
060650457063,187,168,19,187,161,26,353,275,71,250,217,20
060650457061,128,115,13,127,108,19,214,168,42,169,147,15
060650457092,322,283,39,320,272,48,727,566,142,446,381,45
060650457072,241,211,30,243,206,37,483,379,97,352,302,35
060659404002,301,266,35,299,256,43,724,564,143,498,421,51
060650457033,238,214,24,239,203,36,245,197,48,300,269,23
060650457032,327,295,32,331,280,51,487,380,91,474,416,32
060650457031,239,216,23,245,208,37,333,260,62,343,307,23
060650445232,410,181,229,410,187,223,595,290,301,397,192,195
060650472012,187,105,82,188,106,82,320,178,135,219,107,105
060650472011,119,67,52,121,68,53,151,89,61,130,64,63
060650472013,149,84,65,151,85,66,218,124,90,158,77,76
060650472023,125,62,63,127,61,66,183,89,90,147,66,75
060650472022,192,92,100,193,90,103,278,134,140,229,103,117
060650472021,191,93,98,192,91,101,293,141,144,207,92,106
060650459001,322,134,188,325,125,200,427,178,238,402,143,237
060650461011,213,98,115,219,97,122,250,113,136,367,183,167
060650461012,406,205,201,409,202,207,416,183,225,422,205,188
060650461021,341,153,188,342,148,194,429,189,227,427,173,231
060650461031,345,159,186,351,157,194,517,224,278,440,183,236
060650461032,287,143,144,291,143,148,557,244,295,353,172,160
060650462001,240,117,123,240,113,127,377,172,205,319,160,152
060650462002,255,128,127,251,124,127,505,222,265,340,166,158
060650469001,13,6,7,13,6,7,16,7,9,18,7,10
060650470001,174,86,88,176,87,89,63,27,32,215,104,98
060650470002,80,41,39,81,40,41,526,233,280,92,45,45
060659401001,16,3,13,16,3,13,12,2,10,17,3,14
060650470003,129,33,96,130,30,100,172,46,125,167,40,116
060650469002,115,52,63,116,47,69,287,103,177,159,86,65
060650459002,70,50,20,69,44,25,114,70,39,111,67,30
060650425223,332,253,79,331,243,88,589,433,148,430,324,81
060650425221,242,186,56,243,177,66,406,297,101,305,230,56
060650425233,207,158,49,207,151,56,381,283,88,304,217,65
060650425232,379,289,90,379,277,102,607,453,141,520,373,112
060650424052,238,187,51,240,187,53,486,361,113,391,322,46
060650424053,164,129,35,166,129,37,388,288,90,244,201,28
060650424041,412,302,110,416,297,119,724,508,206,616,443,137
060650424051,270,197,73,274,196,78,468,321,131,394,284,88
060650425132,429,298,131,429,284,145,723,508,205,592,407,152
060650425131,251,175,76,254,168,86,414,287,119,370,254,96
060650425141,293,204,89,299,198,101,473,327,136,408,281,105
060650425142,234,163,71,236,156,80,392,274,112,320,221,82
060650425151,204,153,51,208,147,61,406,281,116,297,222,57
060650425152,171,129,42,172,123,49,358,246,100,250,189,45
060650425191,254,184,70,254,177,77,506,348,152,372,276,78
060650425201,359,262,97,363,253,110,691,471,201,532,398,110
060650425112,269,203,66,272,195,77,494,360,122,368,279,69
060650425121,236,181,55,234,171,63,403,294,100,296,226,53
060650425122,203,156,47,205,150,55,464,340,115,342,254,70
060650425162,236,182,54,238,174,64,453,335,113,320,244,58
060650425211,544,403,141,546,389,157,926,649,261,745,560,145
060650425052,195,144,51,196,132,64,412,305,103,333,250,62
060650425111,250,179,71,250,173,77,473,343,118,362,267,75
060650425161,387,295,92,389,282,107,691,502,171,491,366,103
060650425222,173,134,39,177,132,45,316,233,79,264,201,48
060650425231,310,241,69,309,231,78,527,384,131,446,342,81
060650467001,232,180,52,230,172,58,440,322,109,349,266,63
060650467002,144,112,32,145,109,36,266,194,65,243,185,44
060650422142,639,379,260,643,362,281,907,558,328,786,451,276
060650424101,967,623,344,980,607,373,1730,1066,629,1160,715,385
060650424102,655,420,235,665,409,256,989,608,359,818,498,274
060650424123,818,448,370,829,442,387,1178,692,462,941,519,378
060650424111,331,197,134,335,190,145,486,276,200,428,237,166
060650424112,548,327,221,555,316,239,788,447,324,698,385,269
060650424122,541,318,223,548,305,243,953,540,402,677,380,263
060650422122,553,361,192,558,350,208,855,549,293,703,425,235
060650422123,347,226,121,350,220,130,695,442,241,412,250,138
060650422121,516,313,203,521,306,215,835,534,286,636,379,217
060650422124,308,187,121,312,183,129,504,323,173,417,249,143
060650424061,465,278,187,470,278,192,733,465,248,612,365,208
060650424062,578,364,214,585,363,222,872,557,299,737,462,233
060650424091,408,249,159,410,247,163,659,422,225,504,304,167
060650424071,383,203,180,383,195,188,644,363,265,492,270,200
060650424072,326,173,153,329,167,162,618,348,255,438,239,177
060650424092,355,256,99,361,256,105,592,381,204,491,342,116
060650424081,436,260,176,439,254,185,674,381,278,546,299,212
060650424082,401,239,162,403,233,170,731,414,302,437,239,169
060650424031,714,423,291,724,403,321,1102,629,457,864,492,320
060650424032,511,302,209,515,286,229,849,479,348,664,378,245
060650424023,314,198,116,320,195,125,547,324,214,420,269,125
060650424022,487,305,182,494,302,192,788,467,309,667,431,197
060650424021,569,271,298,578,267,311,826,480,330,683,329,319
060650424011,819,353,466,832,345,487,1065,621,433,961,402,516
060650424121,497,197,300,503,192,311,674,342,319,563,223,319
060650425101,322,247,75,323,239,84,611,445,153,474,365,87
060650425102,242,187,55,243,179,64,433,314,108,357,272,66
060650425103,235,181,54,236,175,61,427,311,105,359,274,66
060650426213,481,348,133,488,333,155,858,579,258,596,433,137
060650426214,474,343,131,475,324,151,831,562,253,546,399,125
060650426211,370,267,103,370,253,117,643,435,194,512,371,115
060650426221,563,366,197,572,359,213,1022,694,309,605,398,186
060650426222,565,380,185,571,363,208,944,657,271,720,454,231
060650426242,430,256,174,433,250,183,651,445,202,553,333,194
060650425212,355,261,94,359,253,106,636,436,180,405,300,83
060650425202,353,250,103,355,241,114,717,484,216,541,397,120
060650468002,558,397,161,558,380,178,1053,712,317,807,575,191
060650468003,355,255,100,356,241,115,659,448,202,513,364,122
060650426212,333,238,95,335,228,107,563,378,169,428,295,104
060650468001,370,264,106,373,253,120,625,435,180,553,381,134
060650425091,280,206,74,280,196,84,501,356,132,389,290,76
060650425181,280,197,83,280,187,93,496,345,141,419,297,99
060650425182,359,264,95,360,252,108,684,476,196,538,377,127
060650426241,613,343,270,622,334,288,990,543,423,783,438,308
060650487003,382,274,108,387,261,126,694,479,203,505,370,113
060650487001,202,136,66,207,132,75,337,234,97,241,153,79
060650425171,272,185,87,274,178,96,457,318,132,377,262,96
060650425172,373,256,117,382,248,134,617,429,177,526,369,133
060650489011,369,256,113,370,245,125,623,435,172,503,347,130
060650425092,334,231,103,335,220,115,564,391,161,454,319,106
060650489023,375,267,108,378,254,124,672,473,185,543,399,117
060650425072,440,325,115,437,311,126,804,577,213,574,420,127
060650425071,252,189,63,254,178,76,495,353,130,368,282,66
060650425081,207,155,52,207,145,62,363,261,93,316,241,56
060650425082,185,138,47,186,131,55,362,258,91,290,220,52
060650425083,325,239,86,323,231,92,555,394,144,481,350,108
060650489022,333,249,84,336,236,100,664,480,175,511,392,90
060650489021,407,300,107,410,292,118,682,484,179,534,398,109
060650425073,322,250,72,326,245,81,547,396,144,458,338,94
060650488001,519,403,116,527,396,131,897,639,235,708,523,148
060650483003,595,451,144,600,442,158,1067,780,274,795,618,139
060650488002,361,279,82,367,275,92,616,440,161,483,357,100
060650487002,698,483,215,705,463,242,930,632,284,921,640,239
060650489012,421,307,114,422,291,131,646,463,172,564,374,154
060650511004,310,232,78,314,226,88,542,398,132,400,299,86
060650511001,310,229,81,313,223,90,565,419,139,411,309,86
060650483001,391,297,94,390,290,100,643,477,158,515,388,99
060650483004,261,199,62,264,194,70,464,339,112,344,264,64
060650511003,385,294,91,386,286,100,616,455,151,554,418,111
060650511002,247,188,59,247,183,64,435,322,107,342,256,68
060650426251,494,364,130,493,348,145,544,375,159,617,431,151
060650483002,270,205,65,272,200,72,565,408,141,351,270,62
060650490011,463,342,121,469,334,135,799,579,206,595,419,146
060650490012,487,370,117,487,360,127,899,662,222,809,554,219
060650490013,360,271,89,362,266,96,815,588,211,809,492,281
060650490022,538,361,177,541,351,190,699,473,212,646,429,173
060650426232,753,479,274,764,464,300,1725,1155,542,924,562,312
060650426231,440,280,160,441,268,173,671,458,203,538,329,184
060650490021,170,108,62,171,103,68,249,171,76,198,121,67
060650438243,663,183,480,663,176,487,1003,325,664,723,187,503
060650438244,516,151,365,528,152,376,542,188,345,572,169,368
060650438241,376,127,249,379,123,256,567,184,369,406,133,248
060650438073,495,144,351,497,142,355,701,231,455,542,146,365
060650438072,600,252,348,607,245,362,951,409,512,763,317,402
060650438091,385,116,269,389,111,278,501,166,326,403,110,272
060650438093,1291,551,740,1305,535,770,2825,1301,1460,1082,389,646
060650438092,356,104,252,361,104,257,454,152,297,385,106,261
060650441041,802,379,423,818,373,445,1203,567,602,960,450,454
060650438102,743,307,436,750,300,450,974,434,523,818,326,460
060650438221,1009,420,589,1024,400,624,1336,629,677,1174,452,644
060650438124,2148,881,1267,2168,878,1290,2134,948,1157,1991,802,1139
060650438202,1082,527,555,1092,521,571,2273,1128,1097,1090,529,519
060650467003,125,59,66,123,57,66,206,114,91,117,51,60
060650426321,281,211,70,279,202,77,485,336,142,396,283,86
060650426252,418,320,98,422,308,114,828,600,211,615,472,108
060650426292,302,233,69,304,223,81,561,409,141,438,341,74
060650426293,303,234,69,305,225,80,486,353,123,398,309,67
060650426301,513,390,123,516,375,141,1080,786,272,796,604,148
060650426303,322,242,80,323,234,89,671,489,170,511,394,89
060650426313,233,183,50,237,179,58,419,286,123,322,257,50
060650426311,249,196,53,253,192,61,456,312,134,361,287,57
060650426312,341,268,73,342,260,82,602,444,151,527,419,85
060650426322,217,170,47,219,166,53,373,259,111,304,217,68
060650426262,206,163,43,210,159,51,395,289,100,292,225,51
060650426272,241,189,52,241,185,56,386,284,93,334,264,49
060650426273,374,286,88,375,277,98,640,464,157,562,439,84
060650426271,342,262,80,347,257,90,598,438,148,514,406,80
060650426261,721,564,157,722,550,172,1486,1067,395,768,609,111
060650428022,276,209,67,272,194,78,386,284,96,300,223,57
060650429082,321,241,80,318,226,92,666,446,206,502,368,105
060650426281,194,151,43,193,148,45,329,249,77,276,222,41
060650426283,217,171,46,219,164,55,425,301,114,313,246,45
060650427472,157,123,34,158,119,39,148,112,32,266,214,40
060650427462,270,214,56,272,206,66,681,517,148,424,338,61
060650428013,135,107,28,137,104,33,281,189,90,200,144,49
060650428012,188,148,40,188,142,46,285,200,76,299,211,73
060650427461,351,291,60,352,282,70,589,444,126,493,393,75
060650427473,252,209,43,253,203,50,479,360,103,349,276,53
060650427193,246,123,123,246,118,128,329,180,143,327,170,142
060650428023,151,120,31,152,109,43,275,203,69,251,186,48
060650428011,136,109,27,135,100,35,352,241,102,236,173,45
060650427311,1115,555,560,1124,519,605,1807,923,860,1228,604,566
060650427312,410,247,163,416,240,176,705,409,283,499,297,170
060650427313,403,241,162,410,234,176,645,369,264,595,351,205
060650426291,344,260,84,343,246,97,600,437,150,500,368,106
060650426302,527,395,132,529,378,151,687,500,173,694,506,151
060650426263,414,276,138,413,261,152,901,606,279,516,345,146
060650426282,98,77,21,98,74,24,189,140,45,143,113,20
060650426284,229,181,48,230,177,53,396,293,95,324,255,48
060650427471,217,171,46,218,168,50,360,268,87,288,230,43
060650441031,776,352,424,788,349,439,1131,528,577,879,369,471
060650438132,307,177,130,308,175,133,452,244,189,450,228,178
060650438134,194,125,69,192,127,65,361,218,138,233,138,77
060650438133,212,116,96,216,114,102,331,176,152,310,151,144
060650443003,192,105,87,193,101,92,270,146,119,228,117,92
060650427092,379,147,232,384,142,242,513,220,281,435,165,253
060650427093,563,219,344,571,213,358,760,326,416,633,234,374
060650427401,794,307,487,804,297,507,1053,442,593,811,308,472
060650427402,512,197,315,517,191,326,672,285,382,558,213,326
060650427412,777,301,476,787,291,496,1061,448,601,858,329,503
060650427091,1107,433,674,1127,421,706,1553,673,861,1152,389,719
060650427112,772,316,456,782,312,470,822,345,467,822,331,463
060650427113,818,321,497,830,313,517,1216,512,688,991,398,559
060650427323,1242,502,740,1263,478,785,1195,522,654,1183,457,659
060650427411,422,165,257,427,161,266,600,251,338,488,195,275
060650427083,473,184,289,479,173,306,1027,443,567,620,227,354
060650427111,988,404,584,1000,401,599,1739,741,986,1029,394,590
060650427321,696,251,445,703,239,464,1089,471,599,859,293,518
060650427322,760,320,440,776,303,473,574,236,326,659,246,376
060650427081,578,224,354,580,216,364,724,314,404,747,283,429
060650427171,285,126,159,295,122,173,474,210,261,341,146,178
060650427082,358,137,221,366,132,234,629,270,345,439,161,251
060650427421,645,267,378,652,251,401,1219,525,668,743,293,413
060650427431,575,198,377,586,186,400,2014,784,1188,1148,351,738
060650427422,766,257,509,775,244,531,1645,646,956,808,237,525
060650432793,283,93,190,287,90,197,484,181,295,365,109,241
060650427242,876,372,504,891,361,530,1514,719,760,877,336,493
060650427241,524,213,311,529,208,321,1287,589,670,612,254,322
060650427521,637,261,376,641,256,385,607,279,319,737,312,384
060650427383,697,260,437,709,255,454,1157,480,658,828,286,486
060650427382,546,203,343,554,198,356,1137,470,644,636,219,372
060650427381,1131,456,675,1138,429,709,1866,773,1057,1185,435,678
060650427394,728,292,436,735,286,449,1210,500,683,336,133,187
060650427391,547,217,330,552,215,337,1076,447,614,680,267,376
060650427392,700,275,425,705,260,445,1565,650,892,869,366,461
060650427393,364,120,244,370,110,260,558,225,327,400,133,254
060650427301,317,173,144,320,164,156,536,281,252,428,217,198
060650427304,343,204,139,346,188,158,596,321,263,449,259,168
060650427302,219,102,117,224,97,127,363,196,162,259,137,107
060650427281,573,268,305,583,258,325,1032,480,538,678,296,343
060650427262,551,243,308,559,237,322,949,461,470,654,268,349
060650427263,1868,854,1014,1900,839,1061,3124,1517,1546,1895,786,990
060650427511,523,243,280,529,232,297,810,359,441,596,262,311
060650427512,684,304,380,695,292,403,867,383,469,833,352,441
060650427522,647,250,397,660,242,418,1170,541,609,703,286,384
060650427513,548,202,346,555,195,360,782,346,422,601,224,352
060650427523,1008,368,640,1017,353,664,1170,516,631,1134,415,676
060650438021,911,296,615,936,291,645,1524,499,992,1183,350,766
060650438023,985,322,663,1006,319,687,1600,560,1013,1066,335,674
060650438242,537,219,318,544,206,338,719,268,432,563,206,329
060650438233,787,350,437,798,340,458,1383,627,722,884,373,468
060650438231,684,304,380,688,292,396,1424,646,750,578,246,306
060650438234,984,455,529,1000,440,560,2411,1127,1238,1189,517,614
060650438101,608,250,358,619,246,373,775,330,433,699,278,401
060650438103,1041,429,612,1059,426,633,1478,675,779,1167,467,651
060650438071,513,223,290,521,218,303,920,405,484,647,280,333
060650438211,1020,516,504,1034,498,536,1995,1038,915,1194,578,553
060650439002,290,134,156,291,128,163,522,256,265,359,157,183
060650440001,325,169,156,331,163,168,583,295,285,400,199,179
060650439001,587,244,343,597,237,360,899,402,476,718,285,383
060650439003,581,260,321,590,249,341,942,437,486,716,301,364
060650438181,583,279,304,596,271,325,993,525,447,699,316,344
060650438182,554,272,282,566,265,301,962,508,438,667,308,323
060650438201,1043,512,531,1052,507,545,1050,524,504,1112,545,525
060650441011,329,195,134,330,186,144,554,324,220,400,228,147
060650441012,124,72,52,126,70,56,247,144,96,151,89,55
060650441021,214,126,88,218,124,94,385,223,151,272,147,108
060650441022,554,289,265,557,281,276,519,298,200,674,344,290
060650442001,169,99,70,170,96,74,305,175,121,211,120,75
060650443002,164,90,74,165,86,79,257,137,113,194,102,78
060650443001,495,283,212,495,272,223,780,445,317,602,327,233
060650441033,602,279,323,602,279,323,880,436,420,661,301,331
060650438121,1046,358,688,1059,363,696,1167,484,671,1132,403,712
060650438123,412,157,255,417,161,256,582,251,325,475,179,279
060650438122,963,368,595,980,380,600,1182,495,681,1081,409,641
060650441032,188,85,103,190,82,108,613,291,304,221,100,113
060650442003,328,215,113,332,213,119,538,335,197,408,259,118
060650442002,256,168,88,261,168,93,469,286,166,300,192,91
060650442004,215,142,73,217,140,77,368,230,131,272,174,80
060650427303,205,91,114,206,88,118,325,152,169,245,105,129
060650427191,547,233,314,552,223,329,842,386,438,696,288,366
060650427441,530,202,328,532,193,339,811,339,459,664,250,372
060650427192,456,201,255,465,192,273,696,316,360,576,234,308
060650446061,188,118,70,189,118,71,294,181,105,207,114,87
060030100001,612,399,213,615,386,229,741,476,244,600,334,217
060210101012,533,269,264,538,252,286,863,440,396,624,281,296
060210101021,178,67,111,182,64,118,258,104,149,210,80,116
060210101011,242,95,147,244,92,152,303,127,158,282,113,156
060210101013,502,197,305,514,184,330,803,333,450,615,238,339
060210102003,244,66,178,240,55,185,391,116,269,264,70,180
060210101023,577,198,379,591,182,409,755,320,422,684,228,406
060210101022,288,105,183,291,98,193,427,161,256,346,125,199
060210102001,331,98,233,332,88,244,417,127,279,390,115,251
060210102002,572,155,417,581,136,445,816,239,565,656,172,446
060210102004,341,93,248,342,83,259,465,136,324,413,111,281
060210105011,332,243,89,340,220,120,430,318,106,393,287,89
060210105012,246,58,188,255,51,204,319,67,247,278,61,208
060210105013,226,110,116,227,97,130,303,136,158,303,126,159
060210103001,256,41,215,258,37,221,289,48,236,391,75,297
060210103003,321,67,254,326,59,267,381,84,289,183,40,140
060210103002,299,50,249,301,45,256,362,75,279,419,77,320
060210104011,235,52,183,239,49,190,324,86,238,264,65,184
060210104024,147,63,84,147,55,92,219,111,104,166,76,83
060210105021,323,59,264,330,58,272,371,80,280,329,65,250
060210105022,268,46,222,274,37,237,329,53,272,209,33,168
060210104012,267,55,212,267,51,216,341,100,236,284,64,205
060210104022,382,116,266,387,108,279,503,177,316,437,156,255
060210104021,213,66,147,210,52,158,312,106,200,223,70,140
060210104025,300,87,213,313,83,230,446,143,298,330,103,211
060210104023,164,49,115,169,49,120,245,88,148,197,71,112
060210104026,226,75,151,229,73,156,341,111,224,263,89,160
060210104027,204,71,133,205,66,139,279,109,164,226,74,137
060150001011,450,229,221,450,224,226,663,310,333,519,212,252
060150001021,719,292,427,721,279,442,1057,402,622,833,293,478
060150001022,556,239,317,557,225,332,799,322,451,656,255,332
060150001072,514,242,272,521,238,283,735,325,397,575,234,292
060150001041,854,345,509,866,347,519,1221,476,708,1012,374,546
060150001063,178,64,114,181,62,119,255,88,159,203,63,122
060150001012,473,248,225,480,245,235,665,337,299,556,262,235
060150001071,346,157,189,348,156,192,472,202,256,386,145,208
060150001061,214,90,124,214,87,127,323,131,188,252,90,144
060159900000,444,199,245,448,195,253,610,271,324,528,204,284
060150002021,169,78,91,170,74,96,222,104,116,198,84,101
060150002013,994,354,640,990,348,642,1326,452,836,1072,333,676
060150002022,157,55,102,159,50,109,238,76,158,197,63,122
060150002024,363,185,178,367,186,181,465,229,228,382,170,191
060150002012,394,136,258,400,130,270,518,180,329,422,131,269
060150002023,392,201,191,399,198,201,490,245,228,409,184,194
060150001062,501,181,320,508,174,334,674,234,421,550,171,337
060150002011,285,87,198,288,88,200,391,112,267,354,93,237
060150002031,258,141,117,261,135,126,328,181,141,257,124,114
060591101062,506,242,264,517,234,283,686,361,312,450,226,195
060591101172,514,254,260,529,248,281,657,353,289,558,289,245
060591101174,528,260,268,542,255,287,771,410,344,836,442,351
060591101023,517,282,235,527,277,250,983,552,408,551,304,219
060591101043,308,165,143,314,166,148,397,221,168,257,143,102
060591101101,294,173,121,298,165,133,533,307,217,406,214,161
060591101102,657,345,312,670,347,323,1108,594,495,851,447,340
060591101103,488,268,220,492,268,224,755,409,330,637,325,266
060591101041,961,481,480,983,485,498,1478,751,705,1109,569,466
060591101042,918,451,467,935,443,492,1479,804,648,1008,439,500
060591101061,266,137,129,274,135,139,411,236,168,305,157,127
060591101181,547,281,266,563,276,287,782,450,320,663,383,245
060591101182,502,258,244,515,254,261,725,416,297,452,245,179
060591100011,1304,560,744,1324,549,775,1709,811,857,1411,637,683
060591100101,1010,441,569,1024,432,592,1428,692,700,1154,508,571
060591101063,697,321,376,712,311,401,964,485,450,786,379,357
060591101141,606,287,319,613,278,335,888,459,408,724,338,337
060591101143,703,328,375,715,322,393,1016,521,473,831,379,395
060591100112,669,272,397,679,273,406,869,416,436,696,299,355
060591101112,903,455,448,923,454,469,1276,701,559,1000,507,445
060591101111,466,250,216,475,251,224,724,404,308,701,336,333
060591101113,577,311,266,591,313,278,917,508,387,697,401,257
060375551073,690,462,228,717,457,260,1134,714,398,835,536,252
060375552122,377,289,88,383,283,100,637,446,172,452,342,80
060591101091,339,178,161,343,174,169,463,257,196,432,201,213
060591101092,338,177,161,344,174,170,580,323,247,431,200,208
060591101093,453,237,216,459,233,226,673,373,286,583,316,227
060591101094,517,261,256,527,258,269,814,412,385,589,295,261
060591101171,701,424,277,716,424,292,1095,670,404,840,475,313
060591101173,198,120,78,202,120,82,381,233,140,230,146,70
060591101132,358,166,192,367,165,202,854,426,415,421,206,189
060591100102,620,270,350,630,263,367,876,422,426,626,271,319
060591100103,337,136,201,345,138,207,488,212,256,390,164,203
060591100111,679,296,383,687,287,400,940,460,455,850,415,388
060591102024,578,281,297,592,278,314,950,497,439,729,395,296
060591101131,525,257,268,530,249,281,789,394,376,640,317,283
060591101142,607,277,330,616,269,347,858,423,409,679,317,316
060591101022,923,472,451,941,467,474,1344,759,561,1085,553,464
060591101161,566,288,278,581,287,294,831,467,352,676,369,263
060591101021,628,313,315,637,309,328,876,489,375,719,361,307
060591101162,617,296,321,624,295,329,872,467,393,660,328,292
060591103041,764,382,382,775,373,402,1114,580,509,906,473,389
060591101151,327,176,151,331,174,157,507,282,214,393,225,149
060591101153,627,300,327,634,299,335,873,467,395,681,330,323
060591101163,386,228,158,393,222,171,556,314,231,413,253,149
060591103012,483,255,228,486,250,236,749,390,343,533,287,221
060591101152,381,216,165,389,214,175,628,362,256,466,266,175
060591103011,964,487,477,983,486,497,1519,797,702,1139,599,479
060590116011,225,171,54,224,168,56,359,263,94,243,184,45
060590116021,223,163,60,222,159,63,487,336,136,307,219,66
060590114033,394,252,142,398,240,158,593,350,225,435,256,155
060590115022,428,276,152,435,272,163,597,371,209,492,290,164
060590113001,710,457,253,717,436,281,1038,646,355,726,470,193
060590112001,393,222,171,407,225,182,547,314,220,416,243,134
060590112004,569,341,228,584,347,237,805,472,314,623,340,234
060590110004,652,373,279,668,372,296,945,533,391,731,334,343
060590113003,252,157,95,258,156,102,377,239,129,250,166,65
060590017053,493,217,276,498,203,295,658,328,313,539,251,251
060590017052,317,167,150,324,166,158,444,245,194,347,173,150
060590017061,484,205,279,491,199,292,668,331,322,553,247,274
060590017064,441,190,251,446,179,267,626,309,300,492,225,236
060590019021,438,265,173,444,250,194,608,357,240,509,294,184
060590110003,217,132,85,218,126,92,308,183,117,264,151,100
060590111023,525,377,148,533,379,154,933,646,262,596,427,140
060590116013,146,106,40,148,106,42,241,170,65,180,114,56
060590116014,345,251,94,348,250,98,368,259,100,311,222,72
060590116015,177,129,48,179,129,50,233,164,63,221,157,51
060590116024,111,81,30,113,81,32,156,109,42,122,78,38
060590019011,442,267,175,450,261,189,684,394,280,557,304,210
060590019012,413,251,162,420,245,175,620,373,235,500,283,180
060590110001,175,105,70,177,102,75,284,159,115,218,105,96
060590111011,755,449,306,763,443,320,1098,636,429,795,473,278
060590111021,402,249,153,412,240,172,558,338,207,542,317,189
060590111022,413,253,160,422,248,174,586,356,215,446,261,158
060590112003,335,177,158,342,172,170,420,236,170,341,174,144
060590112002,446,234,212,454,228,226,551,315,227,439,225,180
060590015053,953,415,538,971,410,561,1395,688,674,993,479,463
060590016021,468,208,260,479,207,272,615,310,288,415,199,199
060590016022,610,241,369,622,229,393,766,359,386,667,249,374
060590016023,868,455,413,891,447,444,592,279,298,570,213,325
060590016025,286,114,172,293,108,185,403,190,203,290,139,124
060590115031,421,202,219,435,196,239,559,296,249,482,214,238
060590115032,254,173,81,260,172,88,376,245,120,300,190,89
060590115042,84,58,26,86,57,29,267,173,85,112,72,33
060590115045,344,236,108,353,233,120,438,284,140,400,252,117
060590114035,477,354,123,482,337,145,667,432,212,476,320,112
060590114032,316,215,101,317,209,108,449,281,155,346,219,103
060590115021,252,154,98,254,151,103,320,175,133,282,164,101
060590117071,642,292,350,653,281,372,838,417,402,701,290,364
060590117082,399,274,125,408,275,133,581,398,167,354,226,96
060590117083,551,245,306,565,241,324,692,336,343,641,277,325
060590115023,582,363,219,588,364,224,838,519,294,1005,599,331
060590015051,436,229,207,443,229,214,1014,594,396,825,410,352
060590015052,1296,612,684,1317,603,714,1419,690,692,1170,504,582
060590015054,548,246,302,557,243,314,715,355,342,586,265,280
060590117073,697,278,419,712,280,432,923,414,488,765,336,381
060590117072,269,141,128,274,141,133,420,246,162,297,167,106
060590016041,400,159,241,403,154,249,662,311,334,418,186,208
060590016042,521,231,290,528,225,303,727,371,343,563,248,287
060590015034,558,220,338,566,207,359,705,318,367,645,238,349
060590016043,465,188,277,468,186,282,608,300,298,532,219,284
060590016044,467,188,279,474,187,287,616,305,303,524,215,282
060590015031,368,170,198,374,167,207,513,253,253,411,197,188
060590015033,528,218,310,539,212,327,547,249,290,470,171,273
060590016032,584,246,338,593,247,346,750,379,355,672,292,346
060591106052,553,278,275,564,275,289,768,427,326,513,290,201
060591106053,306,158,148,314,156,158,643,352,276,354,199,139
060591106041,688,354,334,700,351,349,831,451,370,752,407,326
060591106054,342,162,180,349,161,188,540,286,247,365,198,155
060591106055,433,214,219,447,212,235,637,337,286,625,338,262
060590017042,791,389,402,812,386,426,1157,614,520,880,470,374
060590017102,424,213,211,434,210,224,654,350,291,483,291,172
060591106051,268,138,130,273,136,137,421,232,179,307,168,126
060590110006,628,300,328,645,292,353,891,439,422,726,350,322
060590017043,674,378,296,689,372,317,1192,708,468,739,438,264
060590017044,252,141,111,256,137,119,467,278,184,291,171,104
060590110002,385,185,200,393,183,210,521,288,221,428,190,211
060590110005,334,160,174,341,159,182,472,260,198,377,166,185
060590113002,1045,517,528,1072,507,565,1295,714,546,1262,623,564
060590114011,239,138,101,240,133,107,327,206,112,285,164,98
060590016031,1397,624,773,1431,629,802,1744,908,808,1252,583,591
060590017062,420,170,250,430,170,260,527,253,263,449,189,227
060590017063,410,158,252,415,159,256,551,250,288,472,204,234
060590114012,760,386,374,776,381,395,952,512,417,788,401,334
060590114021,497,279,218,504,271,233,637,380,239,534,267,227
060590114022,752,395,357,763,388,375,943,522,392,820,398,367
060590114031,328,185,143,331,177,154,432,257,162,343,170,145
060590016024,547,270,277,559,273,286,704,372,315,646,302,306
060590018012,260,164,96,262,157,105,457,291,157,296,172,108
060590018013,237,124,113,237,123,114,339,185,147,306,160,130
060590018022,494,317,177,500,306,194,730,466,247,561,340,183
060590018023,376,228,148,381,223,158,572,356,201,438,258,148
060590019031,595,352,243,602,345,257,742,425,305,657,341,271
060590019032,345,234,111,345,226,119,768,485,264,397,247,125
060590111012,506,299,207,511,292,219,723,417,299,684,411,233
060590018011,447,311,136,450,295,155,661,440,201,492,297,170
060590017101,498,281,217,513,268,245,749,443,290,554,334,193
060590018014,121,95,26,122,90,32,188,140,44,160,114,32
060590018021,351,246,105,357,239,118,467,312,141,361,231,108
060590019022,515,308,207,521,291,230,733,427,289,595,345,213
060590116012,345,257,88,347,257,90,400,290,102,399,301,77
060590116016,339,254,85,340,251,89,523,376,134,374,282,69
060590117112,471,304,167,478,304,174,691,445,223,546,326,173
060590117113,251,183,68,256,183,73,329,233,86,279,191,67
060590117114,290,211,79,297,211,86,474,336,126,319,215,76
060590117115,215,153,62,218,151,67,374,260,105,258,174,63
060590117122,494,331,163,501,324,177,771,476,280,624,368,213
060590115041,233,166,67,237,163,74,414,284,117,313,192,85
060590115043,166,118,48,169,116,53,263,181,75,194,120,53
060590115044,299,213,86,304,208,96,531,366,149,411,263,100
060590117081,419,267,152,431,272,159,677,436,216,561,332,171
060590117074,647,257,390,656,244,412,905,448,437,701,314,341
060590117092,704,285,419,715,280,435,942,425,501,783,321,424
060590114034,197,147,50,199,142,57,294,208,79,219,152,46
060590116022,687,498,189,695,481,214,959,671,266,845,594,196
060590116023,253,189,64,254,181,73,384,272,102,271,214,34
060590018024,191,141,50,193,136,57,220,152,62,234,161,59
060590018025,197,145,52,198,140,58,312,215,88,246,169,62
060590867012,494,345,149,496,329,167,771,508,248,600,429,132
060591104011,587,350,237,595,350,245,1082,633,425,645,377,232
060590017041,434,200,234,445,200,245,604,309,280,474,236,218
060590017103,589,270,319,605,271,334,835,429,389,620,343,251
060590017083,578,267,311,594,268,326,825,423,384,676,301,340
060590885011,841,478,363,854,470,384,1357,733,595,994,571,347
060590886021,546,309,237,555,305,250,875,468,391,642,399,212
060590880021,401,240,161,407,247,160,646,334,302,512,321,162
060590880022,272,144,128,277,143,134,418,202,207,343,178,149
060590882012,486,266,220,488,250,238,733,348,374,570,314,232
060590880023,518,273,245,520,272,248,791,365,414,592,338,228
060590882011,284,149,135,290,148,142,443,213,222,324,187,124
060590882013,276,146,130,281,144,137,465,223,233,321,179,126
060590882021,416,214,202,425,213,212,676,320,343,482,272,186
060590883011,412,218,194,420,221,199,685,348,326,464,264,175
060590883012,799,419,380,811,421,390,1308,652,636,1074,591,436
060590883013,386,205,181,390,206,184,644,326,305,485,276,182
060590882022,566,281,285,573,278,295,898,414,468,678,354,281
060590882031,729,405,324,744,394,350,1150,554,578,852,486,317
060590887021,730,408,322,744,402,342,1299,624,657,859,547,264
060590888012,136,80,56,137,78,59,236,122,108,171,113,48
060590888013,367,202,165,373,200,173,606,283,313,434,272,136
060590883021,716,395,321,725,385,340,1076,559,500,816,477,289
060590883022,584,308,276,597,308,289,909,446,448,732,385,307
060590883023,576,319,257,586,313,273,903,453,431,693,411,249
060590886012,467,257,210,477,255,222,782,398,369,467,285,156
060590886011,309,174,135,312,167,145,529,255,263,373,222,129
060590887011,160,92,68,164,95,69,286,145,136,182,115,58
060590887012,348,198,150,355,196,159,698,323,359,383,217,148
060590887013,488,280,208,502,291,211,873,444,415,640,400,205
060590998011,385,229,156,387,216,171,600,317,273,436,276,135
060590889021,365,221,144,371,212,159,669,298,365,424,284,121
060590889022,545,331,214,559,320,239,894,398,486,612,403,175
060590889023,349,212,137,355,203,152,535,239,291,346,226,101
060590888014,386,214,172,395,219,176,714,355,348,453,321,117
060590888015,309,172,137,314,173,141,558,278,273,366,258,97
060590888022,344,191,153,350,193,157,630,313,313,425,243,153
060590888024,150,83,67,153,84,69,273,135,133,179,103,65
060590888021,313,181,132,320,174,146,576,263,302,355,219,117
060590888023,361,210,151,368,200,168,640,297,341,465,297,148
060590879021,476,277,199,483,267,216,773,407,350,589,376,176
060590880012,308,159,149,315,159,156,575,265,301,426,244,161
060590880013,437,227,210,442,226,216,727,334,374,529,297,203
060590881062,580,335,245,589,326,263,1033,521,494,685,437,205
060590881072,776,450,326,790,437,353,1351,663,669,950,626,276
060591100051,830,315,515,841,312,529,1124,471,632,935,336,522
060591100052,825,329,496,846,326,520,1079,471,589,831,333,444
060591100012,627,272,355,638,266,372,926,413,485,764,320,399
060591100032,912,399,513,926,394,532,1169,514,632,938,399,485
060590881011,571,336,235,575,314,261,937,563,354,715,458,211
060591100031,559,191,368,575,202,373,763,282,467,637,232,367
060591100041,560,231,329,574,231,343,705,303,387,591,222,338
060591100043,513,215,298,523,216,307,708,343,356,608,252,318
060591100042,450,170,280,465,173,292,586,259,315,470,179,262
060591100044,831,313,518,864,321,543,1067,473,573,905,358,496
060590875035,485,261,224,487,256,231,787,437,337,813,471,291
060590884011,456,274,182,461,266,195,715,397,301,571,351,193
060590884013,331,199,132,334,191,143,526,292,222,410,249,138
060590884012,787,478,309,790,473,317,1182,639,529,902,557,304
060590884031,878,599,279,880,571,309,1483,964,474,1113,767,265
060590884032,695,435,260,707,426,281,1044,606,413,832,579,204
060590885021,804,503,301,821,493,328,1227,716,484,920,621,260
060590761033,653,426,227,663,412,251,1148,704,422,807,541,222
060590891071,903,569,334,911,547,364,1378,816,549,987,654,283
060590889012,552,315,237,563,313,250,872,406,451,577,379,169
060590889014,431,250,181,439,237,202,736,311,416,501,333,150
060590889041,362,196,166,372,201,171,629,239,387,374,238,121
060590889042,537,296,241,553,301,252,894,356,530,601,387,190
060590881041,676,386,290,685,377,308,1173,608,545,779,450,285
060590881051,647,374,273,655,362,293,1103,567,525,794,503,258
060590889033,704,427,277,716,428,288,1221,603,605,872,593,247
060590889032,741,392,349,765,393,372,1206,507,687,782,454,282
060590992031,782,419,363,801,411,390,1305,559,730,885,531,318
060590992032,1008,506,502,1036,502,534,1565,671,873,1076,602,427
060590881042,466,258,208,473,245,228,755,394,348,544,298,212
060590878062,273,191,82,272,179,93,451,268,173,323,227,82
060590876022,567,325,242,573,312,261,861,470,370,662,377,249
060590885012,202,145,57,208,146,62,396,254,139,275,206,57
060590885013,350,250,100,362,251,111,634,394,225,499,370,105
060590888011,349,186,163,354,194,160,594,305,283,413,273,125
060590881052,505,251,254,519,259,260,799,383,407,599,335,226
060590881071,604,300,304,618,309,309,943,452,482,710,412,272
060590889031,555,295,260,562,293,269,1003,419,573,683,413,247
060590882032,482,275,207,494,270,224,811,406,384,621,362,225
060590887014,281,160,121,284,157,127,455,214,234,323,184,125
060590891061,389,247,142,393,241,152,706,418,267,549,390,145
060590891072,505,320,185,512,313,199,942,537,391,713,485,193
060590886013,589,342,247,597,334,263,1077,540,515,698,465,195
060590886014,166,96,70,171,96,75,295,152,136,218,144,61
060590887022,451,261,190,460,259,201,846,395,445,536,369,146
060590890011,359,236,123,362,229,133,657,355,292,430,303,108
060590890032,429,265,164,439,261,178,748,430,307,526,357,144
060590891021,631,429,202,632,415,217,1063,643,404,749,543,170
060590891023,438,300,138,440,290,150,725,454,258,506,384,95
060590891042,425,290,135,424,280,144,728,428,295,382,281,85
060590891062,177,121,56,177,117,60,292,184,104,214,163,41
060590761031,318,211,107,319,204,115,579,369,199,455,301,122
060590761032,316,211,105,316,199,117,564,334,213,411,280,106
060590761034,230,154,76,230,145,85,407,225,169,303,206,78
060590884021,598,376,222,599,361,238,1036,625,386,786,473,264
060590884022,418,258,160,416,245,171,697,378,305,494,343,127
060590885022,302,187,115,306,180,126,473,255,212,452,290,140
060590885023,105,65,40,106,62,44,190,101,84,118,84,29
060590886022,572,322,250,584,314,270,1031,472,543,728,445,250
060590890031,253,142,111,258,138,120,430,232,191,304,186,104
060590889011,332,178,154,342,179,163,589,251,327,362,240,109
060590889013,535,288,247,545,288,257,845,359,474,564,372,171
060590879011,362,212,150,364,205,159,492,250,234,435,271,146
060590880011,379,202,177,385,201,184,596,280,302,418,226,167
060590879022,325,196,129,328,189,139,527,277,239,395,257,119
060590878052,339,234,105,337,224,113,706,411,276,477,330,111
060590017051,725,381,344,736,378,358,969,532,419,795,393,342
060590012021,398,274,124,399,264,135,688,453,220,435,285,121
060590012022,250,173,77,253,168,85,371,244,119,301,201,83
060590012023,149,102,47,153,100,53,243,160,79,173,115,50
060590014012,358,166,192,363,161,202,461,227,225,382,169,192
060590014014,224,154,70,226,150,76,346,227,111,276,191,67
060590014042,173,119,54,174,115,59,275,182,88,196,138,47
060590014043,275,190,85,274,182,92,409,267,130,317,219,75
060590011033,394,235,159,396,226,170,609,362,229,443,266,151
060590012011,356,232,124,361,223,138,564,357,192,409,257,128
060590012012,311,210,101,309,198,111,537,347,174,363,233,107
060590012013,293,193,100,296,185,111,522,330,176,347,219,107
060590014013,379,182,197,381,176,205,531,272,248,428,228,178
060590011021,327,174,153,330,171,159,467,235,215,344,157,165
060590011022,355,188,167,361,185,176,499,255,233,453,207,217
060590011031,340,181,159,344,177,167,535,297,225,367,207,139
060590014022,425,230,195,431,224,207,624,347,266,472,271,176
060590014041,446,240,206,449,233,216,651,358,275,535,303,197
060590015011,968,451,517,982,440,542,1257,613,620,1078,511,505
060590017081,452,222,230,466,211,255,568,298,258,509,250,228
060590017082,544,266,278,556,252,304,737,386,335,593,277,279
060590017091,974,478,496,991,452,539,1443,726,694,1087,542,494
060590013011,448,264,184,453,255,198,659,381,267,552,294,226
060590013014,307,175,132,316,171,145,466,298,161,345,185,137
060590013015,530,337,193,536,327,209,885,540,321,614,361,213
060590013031,536,347,189,541,338,203,800,484,295,603,357,211
060590013033,453,300,153,458,292,166,761,489,256,568,357,177
060590013012,715,344,371,727,331,396,1134,572,545,690,343,306
060590011023,406,223,183,411,217,194,592,303,284,484,235,212
060590011032,443,264,179,452,255,197,672,394,256,438,245,167
060590013013,410,228,182,418,219,199,627,318,299,505,243,227
060590014011,563,252,311,570,245,325,828,396,411,638,267,326
060590013041,151,115,36,150,108,42,382,277,95,258,168,69
060590014023,514,270,244,525,264,261,752,409,330,550,308,210
060590014021,722,378,344,735,368,367,953,519,419,838,363,429
060590014031,728,314,414,750,316,434,860,384,455,693,263,387
060590014032,854,381,473,873,377,496,1117,518,582,975,399,521
060590011012,392,169,223,395,162,233,512,249,251,406,174,213
060590011014,408,187,221,412,174,238,529,266,254,499,214,259
060590011013,425,212,213,437,201,236,598,315,269,438,195,219
060590011011,537,280,257,546,273,273,812,441,355,651,323,290
060590013032,511,324,187,515,313,202,819,507,293,645,407,190
060590013042,602,381,221,606,366,240,992,611,354,645,397,217
060590865011,356,275,81,356,266,90,527,391,125,419,320,77
060590865021,207,132,75,208,128,80,359,237,112,251,170,64
060590117201,120,103,17,121,99,22,239,186,46,180,141,29
060590867021,240,175,65,241,167,74,384,265,115,285,198,71
060590867026,278,203,75,277,192,85,460,312,136,353,245,87
060590867022,153,111,42,151,104,47,268,179,78,188,135,38
060590867023,194,142,52,194,134,60,325,221,96,243,177,48
060590867025,133,97,36,133,92,41,228,154,67,205,150,40
060590867024,221,161,60,223,154,69,377,256,110,267,197,52
060590869011,158,113,45,159,108,51,264,164,96,223,164,51
060590869015,247,175,72,247,167,80,433,268,153,342,240,84
060590869017,170,118,52,173,115,58,271,173,94,218,142,61
060590869025,226,156,70,226,150,76,378,243,128,288,181,87
060590869021,337,207,130,334,197,137,518,314,189,404,254,125
060590869022,162,97,65,160,92,68,254,153,95,197,125,61
060591102023,217,149,68,216,141,75,405,258,136,273,183,69
060590219051,982,408,574,999,403,596,1344,600,727,859,357,470
060590219054,552,240,312,568,240,328,646,310,330,511,231,261
060590219053,538,202,336,544,193,351,703,308,381,567,200,332
060591104022,310,220,90,314,218,96,474,307,160,389,267,97
060591104023,421,302,119,424,298,126,710,460,233,563,391,135
060590868013,256,150,106,259,142,117,408,238,155,384,222,135
060590218121,472,126,346,476,122,354,595,205,377,486,134,326
060590218124,365,162,203,369,167,202,496,222,261,383,172,185
060590218122,535,253,282,539,247,292,731,360,357,647,291,313
060590218123,504,240,264,506,233,273,723,363,339,570,256,276
060590219232,477,192,285,486,188,298,673,310,352,540,243,275
060590219234,559,246,313,578,249,329,803,386,409,630,287,320
060590219235,629,276,353,649,278,371,905,433,457,716,324,362
060590870015,336,200,136,337,188,149,565,302,245,399,240,141
060590870014,359,213,146,361,198,163,576,326,241,457,278,157
060590870013,239,142,97,237,130,107,352,198,148,304,184,105
060590219241,457,212,245,465,213,252,652,328,309,516,261,227
060590219244,702,335,367,721,344,377,996,512,464,751,381,330
060590219242,380,175,205,383,172,211,549,272,261,351,152,174
060590219243,203,94,109,208,94,114,388,187,193,280,125,135
060590869024,308,156,152,314,156,158,487,250,225,423,232,173
060590869023,338,169,169,343,169,174,513,260,238,463,251,192
060590869031,222,124,98,225,123,102,374,209,153,274,148,106
060590869033,482,269,213,488,265,223,755,426,314,574,310,224
060590863036,311,171,140,310,167,143,412,230,175,397,216,163
060590219211,861,245,616,876,230,646,1080,395,673,661,183,447
060590219052,676,257,419,692,253,439,813,323,479,814,294,486
060590218071,674,352,322,679,339,340,984,530,429,350,157,170
060590218163,909,346,563,931,337,594,1235,531,677,992,376,574
060590218131,6,3,3,6,3,3,218,107,105,547,257,256
060590219122,1198,395,803,1223,376,847,1158,404,729,1016,353,596
060590219233,553,224,329,562,213,349,717,321,385,582,227,314
060590219201,481,202,279,491,197,294,594,284,300,511,217,271
060590219202,565,234,331,573,222,351,732,342,380,584,252,303
060590219205,429,181,248,438,177,261,643,308,326,462,202,237
060590219191,834,379,455,847,377,470,1047,490,540,1008,437,521
060590219192,542,247,295,550,245,305,1011,475,520,725,317,372
060590218072,541,220,321,555,222,333,788,333,445,618,240,349
060590218073,409,160,249,419,159,260,726,303,412,476,178,277
060590219162,312,124,188,315,122,193,399,171,223,326,129,184
060590219163,507,203,304,514,200,314,659,283,364,601,230,341
060590867015,291,173,118,290,165,125,455,264,184,340,198,123
060590867011,397,236,161,401,228,173,618,362,252,470,273,171
060590867013,279,166,113,281,160,121,443,256,179,342,206,120
060590867016,286,170,116,289,165,124,467,270,189,340,204,120
060590874012,365,256,109,362,245,117,510,341,154,413,274,98
060590874013,350,245,105,344,234,110,523,348,156,399,263,94
060590868035,220,140,80,224,139,85,410,254,146,342,214,108
060590219121,925,330,595,938,325,613,1160,500,642,861,330,493
060590219204,755,338,417,770,336,434,1093,564,506,1120,491,572
060590219206,554,251,303,562,248,314,733,354,364,621,291,297
060590219203,344,156,188,347,153,194,438,211,217,421,196,205
060590219212,839,339,500,855,333,522,1125,514,594,951,392,515
060590219221,785,340,445,807,340,467,1105,555,535,1125,498,570
060590219213,486,195,291,496,192,304,743,340,390,530,235,274
060590219223,341,151,190,350,150,200,498,238,247,369,176,175
060590219224,569,262,307,582,257,325,833,409,407,645,292,323
060590117221,440,242,198,447,238,209,605,327,273,499,261,210
060590117223,306,168,138,312,166,146,406,219,184,348,182,148
060590878053,254,174,80,258,167,91,471,326,136,334,210,104
060590878032,139,103,36,143,106,37,285,218,51,199,151,39
060590864044,331,242,89,328,233,95,543,381,149,426,299,105
060590864043,275,201,74,275,193,82,428,300,119,328,244,65
060590864041,332,244,88,333,235,98,976,687,268,414,308,81
060590864042,318,233,85,317,224,93,521,362,143,486,346,115
060590871063,293,190,103,295,182,113,498,312,173,357,226,108
060590871062,100,65,35,102,62,40,150,96,54,119,76,37
060590876011,226,147,79,229,142,87,389,244,136,304,192,92
060590876013,121,79,42,122,75,47,198,124,69,164,104,49
060590876014,260,170,90,262,162,100,421,265,147,345,219,103
060590877033,318,204,114,323,199,124,515,299,203,381,256,107
060590877032,330,206,124,333,201,132,532,311,214,434,294,119
060590878061,323,226,97,328,215,113,562,343,210,373,261,94
060590871011,418,249,169,416,227,189,637,372,255,487,285,178
060590877015,357,212,145,370,211,159,581,314,250,422,255,144
060590877012,235,137,98,235,134,101,358,198,154,237,146,81
060590877035,335,218,117,337,207,130,499,294,191,410,275,110
060590877034,247,161,86,250,154,96,483,284,184,326,219,87
060590877031,201,131,70,204,125,79,345,202,132,239,161,64
060590863011,620,432,188,626,419,207,1088,745,320,728,502,180
060590873023,303,219,84,309,215,94,503,348,143,404,283,95
060590873021,271,196,75,273,191,82,468,328,131,341,241,77
060590873026,138,102,36,139,99,40,222,157,57,164,119,32
060590873025,179,130,49,184,129,55,270,189,77,205,151,38
060590874011,233,171,62,235,168,67,400,287,103,292,214,56
060590874014,326,239,87,327,234,93,528,378,138,385,283,73
060590877011,529,282,247,524,265,259,778,411,359,573,328,213
060590877013,214,114,100,215,109,106,336,176,153,260,149,96
060590871036,274,151,123,276,146,130,386,208,170,355,200,130
060590871032,363,200,163,367,197,170,572,311,252,412,248,144
060590871035,247,137,110,249,131,118,452,247,199,301,183,105
060590871034,417,231,186,422,224,198,646,353,286,469,281,164
060590871051,420,269,151,422,265,157,676,424,243,516,331,159
060590876012,379,219,160,382,216,166,577,325,239,439,257,157
060590877044,277,160,117,279,157,122,425,239,176,341,201,122
060590877045,180,104,76,181,102,79,280,158,116,217,127,78
060590877041,214,123,91,215,121,94,323,184,135,252,148,90
060590876024,176,105,71,180,103,77,271,154,113,160,104,45
060590876026,146,87,59,149,86,63,230,128,97,140,93,40
060590876027,111,66,45,113,65,48,213,121,88,145,83,53
060590876025,322,192,130,325,187,138,516,291,215,400,230,146
060590877042,292,174,118,294,169,125,480,272,201,368,227,124
060590877043,352,209,143,356,205,151,566,319,237,420,272,129
060590871061,302,192,110,304,189,115,451,284,153,329,207,101
060590875051,711,451,260,721,449,272,1088,693,372,550,346,170
060590875052,126,80,46,129,80,49,205,129,70,147,93,45
060590875053,183,116,67,188,117,71,286,184,98,210,131,65
060590875034,209,112,97,210,114,96,304,172,127,334,198,117
060590864051,466,352,114,470,337,133,339,239,91,341,261,58
060590864052,238,180,58,239,173,66,356,253,97,286,220,48
060590864053,196,148,48,198,142,56,330,232,89,284,210,59
060590864054,188,142,46,189,136,53,318,226,86,401,296,83
060590864055,207,157,50,208,150,58,342,244,92,301,222,61
060590865012,329,257,72,329,249,80,493,369,113,442,321,97
060590865013,218,171,47,219,167,52,328,246,76,308,213,79
060590865022,200,158,42,202,153,49,352,264,81,223,181,27
060590865024,164,129,35,164,124,40,247,182,57,171,139,21
060590865023,220,173,47,221,167,54,335,249,78,236,192,28
060590873011,171,122,49,175,120,55,299,203,88,173,119,43
060590873024,227,162,65,232,160,72,362,246,106,298,215,60
060590873012,294,211,83,300,207,93,431,295,126,359,246,90
060590873013,215,155,60,221,151,70,426,294,126,230,168,47
060590873022,52,37,15,52,36,16,111,75,32,62,46,11
060590866021,408,255,153,406,243,163,627,393,216,452,304,120
060590866023,251,157,94,252,151,101,368,230,128,300,200,80
060590872001,317,197,120,320,191,129,444,277,155,413,243,157
060590872002,327,224,103,329,215,114,476,318,149,318,208,101
060590863014,292,223,69,292,212,80,477,339,130,331,248,64
060590863015,412,316,96,414,299,115,623,443,170,498,370,96
060590863013,381,249,132,384,239,145,570,372,194,451,301,127
060590863012,408,261,147,412,255,157,608,389,210,509,349,133
060590874041,344,269,75,342,257,85,579,419,144,439,338,79
060590874042,197,153,44,195,147,48,332,241,82,249,191,45
060590874051,195,152,43,194,146,48,319,233,79,246,190,44
060590874052,156,122,34,155,117,38,259,186,63,179,137,32
060590874053,165,129,36,162,122,40,266,194,66,207,156,37
060590874054,217,169,48,216,162,54,356,260,88,287,219,52
060591106043,650,342,308,661,337,324,1041,557,458,1073,580,434
060590872006,262,166,96,265,161,104,388,246,129,340,227,92
060590872005,480,250,230,486,246,240,668,391,262,593,328,225
060590872007,279,197,82,279,187,92,423,284,125,338,215,98
060590872004,222,157,65,220,147,73,335,226,101,326,206,94
060590872003,181,128,53,182,122,60,271,182,80,230,168,47
060590866022,245,163,82,244,161,83,431,284,138,326,219,83
060590761042,106,78,28,108,78,30,201,148,49,138,92,36
060590761043,292,215,77,296,212,84,1161,851,283,96,64,25
060590761044,132,97,35,134,96,38,333,243,81,142,95,37
060590761041,769,573,196,776,560,216,1453,1041,376,960,637,260
060590863034,231,170,61,235,169,66,495,364,120,282,190,72
060590863035,300,221,79,305,219,86,628,457,157,327,219,85
060590874032,133,110,23,134,105,29,200,151,46,167,128,30
060590874031,233,190,43,230,179,51,354,263,79,290,221,52
060590874033,69,57,12,71,55,16,98,73,22,70,53,12
060590863061,327,188,139,331,185,146,470,279,184,385,221,138
060590863062,267,153,114,271,152,119,389,231,152,335,192,120
060590863063,492,265,227,498,261,237,722,412,295,579,309,233
060590863043,344,201,143,345,192,153,492,287,195,376,214,141
060590863044,220,130,90,221,124,97,366,214,140,278,161,102
060590863051,692,404,288,693,388,305,953,553,372,764,429,291
060590219031,599,242,357,608,235,373,844,378,447,673,257,377
060590219154,386,141,245,391,142,249,489,206,277,407,153,237
060590219151,398,147,251,407,148,259,564,236,318,440,169,248
060590219153,575,220,355,584,219,365,795,340,440,643,269,344
060590219152,552,218,334,559,213,346,736,321,402,607,241,334
060590219032,738,366,372,752,360,392,974,478,475,841,404,386
060590219033,375,186,189,383,183,200,631,314,302,478,230,218
060590758131,1082,388,694,1101,385,716,1439,598,809,1075,373,649
060590758133,957,348,609,975,348,627,1252,523,705,1051,407,588
060590218213,628,303,325,642,297,345,986,528,439,586,317,239
060590218125,672,298,374,681,308,373,902,407,475,692,311,337
060590877014,121,73,48,122,74,48,185,104,77,138,92,39
060590870023,515,309,206,518,306,212,846,467,366,685,413,237
060590870024,479,290,189,483,285,198,738,408,313,652,389,226
060590117151,757,278,479,774,280,494,1015,430,570,741,277,415
060590218212,757,466,291,762,453,309,1243,751,471,850,453,332
060590117102,967,420,547,983,399,584,1312,605,680,1087,423,586
060590117181,741,259,482,759,252,507,963,382,556,869,332,478
060590117172,399,148,251,411,151,260,541,227,295,439,165,242
060590117123,573,325,248,588,318,270,812,513,280,639,401,201
060590117161,457,240,217,467,233,234,925,517,395,659,339,286
060590117162,1485,713,772,1515,694,821,1870,951,887,1382,682,634
060590117213,477,273,204,490,269,221,770,467,287,520,348,130
060590117101,772,327,445,787,323,464,1008,491,495,828,355,420
060590117111,443,203,240,453,206,247,580,282,287,503,214,254
060590117093,1037,423,614,1056,412,644,1333,611,698,1061,401,586
060590218202,1466,666,800,1490,649,841,1929,963,922,1433,636,714
060590218211,682,344,338,692,338,354,987,533,434,953,472,417
060590117152,1658,715,943,1679,696,983,2107,988,1086,2051,841,1099
060590869013,302,177,125,306,174,132,511,299,203,357,210,125
060590869014,204,115,89,204,114,90,376,213,156,229,132,83
060591102022,373,215,158,379,208,171,594,340,244,453,259,165
060591102021,312,199,113,316,193,123,529,322,194,391,244,118
060590117222,268,160,108,276,159,117,385,200,180,338,124,201
060590117121,408,276,132,411,265,146,627,407,210,474,309,145
060590117211,199,155,44,199,152,47,295,224,65,150,100,39
060590117212,288,209,79,288,204,84,432,330,93,322,216,81
060590218102,742,293,449,757,281,476,1003,424,551,810,342,420
060590117141,155,104,51,156,101,55,619,386,218,225,144,70
060590117202,350,283,67,349,268,81,543,401,132,437,333,78
060590218101,540,175,365,556,167,389,676,242,425,612,219,356
060590117171,938,357,581,957,350,607,1350,579,734,962,344,559
060590868011,401,233,168,410,234,176,708,400,292,476,279,173
060590117091,576,230,346,584,220,364,734,332,388,629,237,347
060590117203,196,145,51,196,139,57,340,236,95,242,184,44
060590218312,148,46,102,149,46,103,199,79,117,173,57,106
060590218311,1199,484,715,1220,471,749,1652,738,889,1427,554,806
060590117182,928,371,557,940,351,589,1252,543,680,933,330,543
060590878063,178,114,64,180,109,71,302,170,123,220,127,78
060590878064,227,157,70,231,148,83,375,221,146,247,161,72
060590864071,632,376,256,639,365,274,972,603,348,747,441,262
060590864073,332,180,152,332,176,156,475,281,187,519,309,181
060590868034,586,378,208,593,356,237,1103,684,396,535,320,187
060590868033,131,83,48,132,81,51,195,120,71,116,70,38
060590868036,255,163,92,256,158,98,389,241,142,307,182,102
060590870011,155,99,56,156,97,59,219,128,87,195,119,64
060590870012,119,76,43,120,70,50,202,124,73,137,82,48
060590868021,405,268,137,407,261,146,584,380,199,514,341,144
060590868023,456,302,154,460,294,166,665,430,227,569,381,159
060590868024,154,98,56,156,96,60,419,272,139,194,127,56
060590869012,263,141,122,263,141,122,466,257,201,336,188,128
060590878054,474,280,194,473,274,199,788,458,315,600,389,184
060590871064,312,205,107,316,206,110,481,304,165,394,265,101
060590117153,824,360,464,834,350,484,1059,516,525,883,371,458
060590866024,335,244,91,334,241,93,549,376,163,437,293,111
060590875032,224,147,77,228,147,81,352,217,124,248,148,85
060599800001,15,11,4,15,11,4,35,26,9,121,96,18
060590864024,436,291,145,437,281,156,663,422,227,541,344,165
060590864023,159,106,53,159,102,57,138,88,47,95,60,29
060590864061,157,105,52,156,100,56,230,146,79,194,122,59
060590864021,342,204,138,343,195,148,537,327,195,431,270,146
060590864022,417,248,169,424,240,184,607,371,222,503,309,174
060590864062,248,148,100,250,142,108,477,291,174,294,179,102
060590864063,307,158,149,309,155,154,393,225,165,319,190,108
060590864064,241,121,120,244,119,125,364,206,150,326,193,110
060590864072,305,186,119,309,180,129,546,341,190,337,200,117
060590864074,224,136,88,226,131,95,395,247,137,313,184,109
060590863041,266,158,108,266,149,117,413,251,154,316,184,115
060590863053,332,196,136,335,189,146,509,310,190,426,236,169
060590863031,276,153,123,279,152,127,424,238,177,338,185,138
060590762021,396,217,179,401,209,192,525,290,218,405,233,146
060590761021,332,232,100,332,223,109,627,422,191,331,229,82
060590875042,268,196,72,266,186,80,448,308,129,323,230,74
060590875041,87,70,17,88,65,23,157,114,38,106,85,14
060590875044,320,228,92,320,219,101,542,366,165,368,255,96
060590875031,207,165,42,207,154,53,377,278,89,148,112,26
060590875033,184,146,38,183,136,47,351,257,82,238,178,42
060590875043,199,157,42,198,147,51,334,246,79,247,196,31
060590863032,242,154,88,243,151,92,369,232,126,289,180,89
060590863037,376,239,137,379,235,144,555,350,191,434,271,135
060590863033,149,95,54,150,93,57,243,154,84,172,108,53
060590871033,368,220,148,369,213,156,580,336,234,440,276,146
060590871037,326,193,133,332,191,141,496,286,199,404,252,134
060590871031,120,72,48,123,70,53,178,101,70,147,91,48
060590876021,312,184,128,315,186,129,487,281,198,390,243,119
060590876023,371,219,152,374,221,153,590,341,238,455,285,139
060590870021,309,177,132,313,169,144,508,288,211,393,224,147
060590870022,417,239,178,424,229,195,731,416,303,531,300,198
060590871012,241,154,87,244,148,96,390,238,145,295,190,88
060590871021,197,143,54,199,140,59,332,220,102,238,175,49
060590871025,191,139,52,194,136,58,366,243,113,254,171,61
060590871022,337,244,93,339,238,101,556,369,171,444,301,106
060590871024,188,136,52,188,132,56,304,202,94,234,172,48
060590871023,140,102,38,140,99,41,192,127,59,159,117,33
060590869016,243,173,70,242,165,77,393,241,144,347,255,77
060591102011,743,439,304,746,408,338,1145,643,469,894,525,315
060590868031,422,287,135,429,278,151,706,449,242,681,474,167
060590871013,62,42,20,63,41,22,90,57,31,86,60,21
060590871014,214,145,69,216,140,76,410,262,141,280,195,69
060590626524,444,220,224,448,220,228,1650,1031,592,534,242,268
060590626532,10,5,5,9,5,4,14,9,5,9,5,4
060590626491,845,424,421,850,420,430,981,527,445,753,381,351
060590626481,303,150,153,309,150,159,874,474,393,332,165,159
060590626482,927,478,449,931,468,463,807,441,360,632,328,284
060590626483,866,474,392,878,473,405,985,562,412,1361,736,581
060590626493,454,256,198,456,253,203,552,296,251,950,443,464
060590626461,593,320,273,601,316,285,397,221,173,332,175,147
060590626462,260,140,120,264,139,125,394,219,173,350,184,155
060590626463,862,462,400,874,466,408,1125,633,481,1524,795,681
060590626464,412,221,191,416,218,198,621,345,272,530,279,235
060590626472,358,192,166,362,191,171,524,292,227,453,237,201
060590626474,327,175,152,331,177,154,419,236,180,368,192,165
060590626251,669,358,311,676,364,312,595,337,251,516,267,232
060590626252,595,318,277,601,323,278,705,399,298,586,302,263
060590626473,511,277,234,522,283,239,705,394,298,550,269,256
060590626411,728,453,275,732,445,287,1731,1062,645,597,368,202
060590626413,858,472,386,877,460,417,385,208,172,385,219,153
060590626221,964,472,492,980,473,507,1203,632,562,238,115,114
060590626222,247,121,126,251,121,130,324,170,151,280,136,134
060590626223,614,301,313,625,302,323,767,403,359,611,297,294
060590626225,456,223,233,464,224,240,608,319,283,1638,791,779
060590871053,413,232,181,417,224,193,649,354,282,537,306,206
060590871052,462,259,203,467,251,216,674,403,259,526,340,155
060590878011,692,375,317,697,361,336,1070,581,460,845,494,311
060590878023,455,265,190,457,254,203,733,405,320,492,268,196
060590219164,396,142,254,404,143,261,543,239,297,445,156,265
060590219161,524,188,336,533,189,344,714,311,390,566,197,340
060590758143,542,219,323,556,214,342,766,349,401,775,321,419
060590219222,269,116,153,276,117,159,402,191,202,267,130,121
060590219231,604,262,342,621,262,359,855,408,433,670,297,338
060590866011,166,129,37,167,125,42,280,191,80,189,145,32
060590866014,258,201,57,259,194,65,395,270,114,294,225,50
060590866015,159,124,35,160,120,40,267,184,77,188,145,33
060590866016,147,116,31,148,111,37,206,140,60,178,137,30
060590866012,263,206,57,265,199,66,448,318,117,353,276,56
060590866013,373,291,82,375,282,93,619,437,161,486,378,77
060590867014,356,247,109,360,240,120,561,365,183,459,326,101
060590868022,254,177,77,255,170,85,434,280,151,329,224,86
060591102031,443,221,222,448,210,238,619,297,308,503,218,255
060591102033,267,142,125,268,140,128,397,233,155,345,194,137
060591102034,208,112,96,209,110,99,314,153,154,241,107,117
060590869034,144,92,52,145,90,55,188,111,74,170,103,55
060590869035,206,131,75,208,129,79,352,211,133,262,159,86
060590869032,301,192,109,304,188,116,498,293,199,379,233,123
060590863045,275,134,141,277,133,144,442,239,195,305,142,146
060590863042,255,125,130,259,124,135,385,209,168,288,134,138
060590863052,420,207,213,426,205,221,611,332,271,491,230,236
060590762041,369,183,186,373,175,198,536,287,237,431,216,185
060590879012,555,361,194,556,344,212,927,530,382,707,504,172
060590881061,532,293,239,536,285,251,888,478,394,685,381,268
060590878012,559,319,240,567,321,246,831,437,379,627,366,223
060590878031,315,215,100,316,201,115,541,298,236,412,295,101
060590878024,113,70,43,114,67,47,182,109,71,136,80,49
060590878022,618,393,225,625,378,247,1029,619,387,746,438,266
060590878033,347,226,121,348,217,131,587,314,266,413,285,112
060590879023,512,356,156,521,354,167,841,481,346,641,412,187
060590878013,312,183,129,319,182,137,475,255,212,338,198,121
060590878021,493,334,159,499,322,177,890,553,316,708,479,200
060590878051,116,90,26,116,81,35,185,126,49,122,91,24
060590218171,1226,485,741,1248,474,774,1641,721,883,1364,499,762
060590218161,489,142,347,499,141,358,645,225,407,568,163,381
060590218162,985,329,656,1005,324,681,1358,512,815,1092,365,674
060590218313,539,220,319,551,220,331,848,392,441,652,279,341
060590218224,954,377,577,972,367,605,1519,724,769,855,331,473
060590218231,1780,587,1193,1796,572,1224,2418,945,1425,1908,699,1113
060590218241,561,168,393,570,167,403,742,272,457,631,188,415
060590218242,817,252,565,824,247,577,1032,386,624,980,288,648
060590218221,572,201,371,584,199,385,981,402,561,479,171,280
060590218225,830,313,517,849,308,541,1097,493,585,1387,499,814
060590218222,399,130,269,407,126,281,533,199,327,437,172,245
060590218251,859,258,601,879,260,619,1062,392,648,905,287,570
060590218271,658,254,404,679,266,413,933,428,491,767,288,448
060590218252,645,204,441,657,206,451,914,362,536,723,247,438
060590218301,754,228,526,769,229,540,899,325,558,805,263,498
060590218304,771,236,535,786,235,551,1014,370,630,832,271,516
060590218291,1135,355,780,1152,347,805,1378,512,844,1318,408,839
060590218103,473,178,295,479,163,316,632,256,366,492,176,292
060590218092,530,186,344,538,181,357,683,271,400,599,211,359
060590218021,700,230,470,712,221,491,1103,418,658,821,273,505
060590218022,695,248,447,710,237,473,764,299,447,641,229,378
060590218024,654,243,411,665,234,431,861,366,478,657,244,382
060590218026,348,135,213,356,130,226,614,277,326,362,131,215
060590218023,643,195,448,655,194,461,700,258,426,574,185,360
060590218272,718,276,442,733,275,458,1001,439,544,903,363,490
060590218261,599,230,369,606,218,388,888,373,493,632,235,355
060590218262,446,172,274,455,165,290,631,269,351,511,192,287
060590218282,555,202,353,565,198,367,774,322,439,643,230,383
060590218281,589,191,398,593,185,408,785,317,460,669,229,408
060590218283,834,291,543,843,287,556,1103,454,633,944,353,547
060590218091,860,282,578,871,271,600,1168,448,697,941,325,563
060590218201,697,204,493,708,194,514,922,329,578,806,244,523
060590218302,743,223,520,756,221,535,911,319,575,778,231,511
060590218303,806,320,486,816,315,501,1128,518,594,992,427,524
060590218025,344,110,234,351,108,243,616,226,380,389,127,243
060590218223,938,301,637,954,292,662,1257,460,775,1042,343,650
060590218172,420,166,254,426,163,263,549,233,305,460,171,259
060590218292,866,270,596,878,263,615,1132,422,689,912,318,549
060590218293,768,311,457,776,305,471,1005,467,521,813,327,453
060590992311,946,386,560,966,380,586,1227,538,651,1016,402,552
060590992314,428,175,253,437,171,266,543,240,290,456,180,247
060590992142,304,133,171,312,136,176,391,186,196,401,171,202
060590992313,990,416,574,1014,417,597,1274,571,669,1052,467,530
060590992293,273,152,121,279,153,126,399,211,182,288,173,104
060590992294,502,279,223,514,282,232,701,372,321,596,358,215
060590992291,875,432,443,890,432,458,1161,587,547,964,487,418
060590992292,1040,505,535,1064,502,562,1313,671,617,1110,548,492
060590992332,699,321,378,705,326,379,955,439,492,732,326,365
060590992341,670,308,362,680,314,366,894,412,463,712,316,354
060590992261,710,354,356,723,360,363,1075,517,543,792,428,327
060590992262,798,366,432,819,372,447,1099,488,595,874,435,401
060590992021,770,500,270,770,483,287,1214,673,518,826,543,250
060590992023,528,355,173,527,342,185,816,471,329,767,527,206
060590992271,313,177,136,317,170,147,488,243,239,351,196,143
060590992241,786,349,437,800,337,463,1108,514,578,863,410,402
060590992242,694,294,400,709,291,418,946,423,508,736,339,352
060590992252,777,331,446,791,325,466,1047,468,559,856,370,434
060590992331,827,359,468,848,368,480,1063,486,551,857,374,428
060590992342,447,195,252,460,198,262,558,254,292,525,222,272
060590992343,541,230,311,558,235,323,728,310,408,578,247,298
060590992321,842,386,456,870,394,476,1274,619,633,956,410,488
060590992323,648,280,368,661,276,385,756,346,392,693,289,364
060590992324,512,222,290,524,220,304,711,327,371,555,236,285
060590992233,524,245,279,532,250,282,820,339,465,600,328,246
060590992301,883,379,504,910,382,528,1174,530,620,939,408,469
060590992302,1152,530,622,1182,537,645,1552,748,771,1238,597,560
060590992043,732,356,376,753,347,406,1161,506,645,830,447,348
060590992251,658,286,372,668,288,380,965,414,540,714,334,341
060590992272,345,220,125,349,217,132,595,358,223,441,291,118
060590992273,697,337,360,715,338,377,946,435,498,759,379,345
060590992274,594,326,268,605,327,278,878,449,414,645,373,231
060590992312,437,192,245,449,198,251,655,307,337,450,200,227
060590992322,514,225,289,534,235,299,717,337,371,557,238,286
060590992502,454,194,260,466,195,271,651,276,365,490,200,267
060590992511,547,325,222,560,322,238,819,443,355,595,342,214
060590992512,507,261,246,518,263,255,710,369,326,577,291,247
060590992501,735,331,404,761,336,425,1020,498,507,854,401,405
060590992513,561,285,276,574,286,288,731,385,333,606,292,273
060590994161,527,289,238,541,292,249,781,412,349,626,285,297
060590994162,352,192,160,362,195,167,519,275,230,396,180,189
060590994163,874,475,399,901,483,418,1280,674,570,998,502,436
060590995131,723,259,464,733,257,476,866,347,498,758,273,446
060590995061,683,268,415,706,280,426,749,321,415,874,342,476
060590995132,419,143,276,422,143,279,677,252,413,353,124,213
060590995141,510,155,355,521,155,366,594,208,374,531,186,323
060590995144,383,128,255,390,126,264,453,171,273,405,139,247
060590995145,539,180,359,553,180,373,630,238,380,582,200,355
060590993052,571,277,294,586,275,311,839,403,408,651,294,313
060590993054,381,190,191,393,191,202,707,338,353,458,214,211
060590993053,298,145,153,307,145,162,489,237,239,347,153,172
060590993092,856,408,448,875,400,475,1106,522,564,968,382,516
060590994181,647,329,318,659,327,332,970,487,466,730,350,346
060590994182,327,162,165,335,161,174,463,233,222,354,159,175
060590994193,501,171,330,506,174,332,692,263,417,613,223,368
060590994151,560,220,340,572,222,350,682,299,360,662,278,345
060590992412,690,394,296,702,391,311,1136,555,558,866,510,304
060590993055,477,244,233,489,243,246,699,353,332,533,251,247
060590993094,470,231,239,482,231,251,500,252,242,467,223,215
060590993093,330,163,167,336,161,175,445,223,215,350,169,160
060590994191,480,232,248,491,232,259,665,330,320,571,254,282
060590992442,1215,557,658,1243,561,682,1487,720,751,1233,552,645
060590994154,720,272,448,742,280,462,892,412,456,722,273,395
060590992461,592,244,348,611,248,363,749,325,415,613,244,336
060590992462,926,382,544,953,387,566,1194,515,656,978,393,522
060590992463,332,137,195,343,139,204,462,200,256,366,145,199
060590995142,1051,388,663,1084,398,686,1290,554,711,1024,415,549
060590995143,745,227,518,761,226,535,936,334,583,774,298,433
060590993061,641,340,301,665,346,319,992,490,479,767,356,359
060590993062,461,236,225,476,239,237,712,332,361,486,230,224
060590993063,397,208,189,409,211,198,637,317,308,433,203,200
060590993065,422,206,216,430,201,229,981,474,481,758,340,369
060590992421,626,299,327,634,304,330,881,419,440,660,335,278
060590992422,717,344,373,728,349,379,983,467,492,773,318,407
060590994101,344,216,128,346,213,133,531,308,209,443,237,180
060590994103,541,340,201,546,336,210,851,494,332,558,351,177
060590997022,850,427,423,865,423,442,1221,550,647,929,449,413
060590997031,417,234,183,425,233,192,720,378,325,513,269,214
060590994061,860,376,484,881,377,504,1123,490,609,914,374,485
060590994062,1106,519,587,1129,524,605,1561,743,781,1331,587,662
060590996042,924,420,504,947,432,515,1162,524,602,989,437,493
060590996052,1175,596,579,1195,605,590,1721,885,796,1183,584,531
060590996034,617,276,341,640,279,361,825,383,424,672,300,333
060590996041,839,350,489,855,353,502,1169,506,641,864,360,438
060590996051,861,378,483,874,377,497,1094,501,564,986,445,476
060590994072,1076,493,583,1091,493,598,1345,634,680,1151,496,577
060590994071,359,157,202,365,157,208,472,221,237,414,186,200
060590994081,387,166,221,395,166,229,573,269,292,390,156,210
060590994083,432,205,227,440,207,233,571,269,284,467,209,225
060590994052,594,268,326,606,264,342,787,348,422,686,298,347
060590994053,660,311,349,680,310,370,1003,474,506,709,343,320
060590993101,771,370,401,785,372,413,1080,500,558,864,401,411
060590993102,745,357,388,760,360,400,1109,522,556,819,389,364
060590993103,385,182,203,394,185,209,669,319,332,513,227,239
060590992401,434,185,249,443,185,258,572,257,297,479,195,255
060590992403,387,165,222,394,165,229,519,233,268,272,129,125
060590992404,627,268,359,637,267,370,902,405,466,612,290,280
060590992431,1297,560,737,1327,555,772,1659,784,837,1327,586,659
060590992451,738,324,414,747,315,432,920,458,449,822,347,422
060590992141,534,234,300,541,236,305,775,369,388,439,174,238
060590992152,885,388,497,903,394,509,1131,537,569,1011,401,535
060590993081,1099,401,698,1118,403,715,1353,570,762,1050,368,626
060590993082,1001,379,622,1019,374,645,1297,496,777,1033,358,621
060590993083,1213,435,778,1234,443,791,1426,617,788,1241,486,706
060590994041,1103,479,624,1125,486,639,1466,693,739,1143,472,604
060590992143,409,179,230,420,179,241,534,237,291,440,175,239
060590992144,519,226,293,531,226,305,655,289,354,571,226,311
060590992163,394,168,226,404,173,231,574,263,300,441,181,237
060590992441,1091,488,603,1113,483,630,1383,634,712,1196,469,634
060590992371,890,417,473,901,412,489,1153,550,577,925,424,446
060590992372,908,433,475,922,431,491,1219,592,603,988,436,490
060590992171,627,258,369,637,253,384,810,374,427,661,278,353
060590992172,660,282,378,675,277,398,892,413,455,699,301,367
060590992382,1179,484,695,1204,463,741,1488,637,825,1270,489,698
060590992353,778,393,385,793,395,398,1171,573,574,834,368,411
060590992354,676,348,328,690,351,339,904,441,443,508,223,249
060590992452,784,366,418,798,368,430,1137,539,577,887,376,458
060590995084,603,233,370,613,234,379,654,258,385,682,241,411
060590994082,1125,519,606,1145,529,616,1405,695,671,1218,560,571
060590994172,1160,526,634,1184,526,658,1615,791,786,1126,511,539
060590994171,743,365,378,757,369,388,1002,499,475,785,358,375
060590994173,381,174,207,388,174,214,514,252,252,411,188,196
060590995081,685,294,391,703,298,405,919,405,485,767,295,415
060590992402,983,450,533,1003,461,542,1269,593,652,1086,465,553
060590992151,954,533,421,976,531,445,1378,727,605,1014,562,390
060590992153,481,268,213,491,268,223,637,333,280,562,227,300
060590994042,1210,512,698,1245,520,725,1543,693,821,1291,549,665
060590994122,562,276,286,577,271,306,721,357,356,638,294,309
060590994123,909,385,524,933,389,544,1146,516,612,1000,410,522
060590994153,815,333,482,832,340,492,985,447,519,878,348,481
060590994152,606,249,357,622,253,369,754,340,393,616,279,295
060590994155,346,141,205,351,142,209,431,195,225,369,143,203
060590994023,336,169,167,342,165,177,443,223,214,372,175,178
060590994121,589,296,293,601,289,312,900,453,434,648,325,285
060590994051,605,293,312,625,293,332,753,370,370,659,275,344
060590996021,599,302,297,616,303,313,940,480,439,648,313,292
060590996022,661,289,372,682,291,391,894,411,466,736,308,373
060590992203,770,347,423,789,343,446,1035,447,569,813,337,426
060590992204,422,188,234,432,185,247,509,232,263,462,190,244
060590992393,528,206,322,544,205,339,684,295,374,595,215,349
060590992161,405,172,233,415,177,238,577,264,302,448,186,239
060590992162,740,321,419,758,326,432,933,443,471,776,331,401
060590992164,327,154,173,335,156,179,452,215,225,365,161,179
060590992351,415,190,225,425,193,232,591,275,303,480,196,257
060590994183,389,207,182,396,208,188,531,260,261,701,350,307
060590993064,690,326,364,704,322,382,750,347,383,576,256,271
060590993071,693,330,363,705,328,377,1360,624,703,791,325,394
060590992391,454,205,249,463,193,270,562,240,306,668,277,341
060590992394,523,221,302,535,212,323,667,286,365,561,218,309
060590992381,991,407,584,1009,402,607,1310,597,680,1089,405,591
060590995021,85,44,41,86,44,42,84,45,36,92,47,40
060590996031,1005,484,521,1035,483,552,1538,741,769,1159,523,564
060590992122,382,239,143,387,238,149,563,321,224,470,214,219
060590992124,329,206,123,336,206,130,487,282,197,417,190,197
060590994021,267,167,100,274,167,107,459,264,183,258,184,59
060590994022,518,308,210,525,306,219,811,447,342,574,338,199
060590994024,274,172,102,279,172,107,457,263,183,269,193,61
060590993111,584,274,310,594,274,320,627,297,316,582,250,296
060590993112,647,305,342,658,305,353,923,443,460,759,327,380
060590993113,328,154,174,337,155,182,463,223,228,399,171,194
060590992201,752,364,388,767,364,403,982,475,480,677,330,301
060590992202,641,312,329,652,314,338,1013,492,494,845,367,420
060590992432,822,383,439,843,380,463,1070,504,541,892,369,466
060590993072,519,242,277,530,239,291,356,171,173,224,99,110
060590993051,485,269,216,490,263,227,783,393,370,523,242,244
060590993056,275,153,122,278,149,129,479,241,233,303,139,142
060590992121,378,216,162,382,213,169,597,320,261,457,229,193
060590992123,333,190,143,337,188,149,526,281,230,367,183,155
060590992392,561,230,331,574,230,344,752,353,389,640,263,344
060590995083,397,190,207,404,191,213,649,295,336,430,166,241
060590995082,349,163,186,354,168,186,534,281,241,490,208,252
060590994113,436,291,145,442,293,149,675,409,241,581,328,206
060590994114,165,110,55,167,111,56,269,164,97,216,122,77
060590993091,694,264,430,710,262,448,855,403,427,789,359,405
060590992352,382,176,206,388,175,213,527,246,269,421,171,225
060590994192,747,341,406,760,344,416,1066,514,529,819,375,389
060590994102,449,230,219,460,234,226,866,474,367,515,205,287
060590994111,362,186,176,368,186,182,468,242,217,355,183,148
060590994112,568,291,277,580,294,286,810,417,374,557,286,234
060591100152,1012,478,534,1038,464,574,1286,607,652,1109,487,541
060591100061,780,363,417,798,356,442,1038,516,501,829,397,394
060591101081,237,113,124,243,116,127,311,185,118,245,120,103
060591101082,594,283,311,607,290,317,800,390,379,694,290,362
060375739021,1133,603,530,1154,600,554,1491,877,585,1219,637,521
060591101083,291,132,159,299,134,165,377,194,173,295,143,129
060591100141,282,166,116,285,165,120,433,252,176,336,187,124
060591100142,359,197,162,368,194,174,668,340,309,405,211,167
060591100144,335,183,152,344,182,162,512,278,222,385,191,166
060591100151,632,293,339,650,291,359,809,400,389,752,308,398
060591100124,1019,463,556,1045,466,579,1198,599,576,1071,523,501
060591100153,114,63,51,118,61,57,152,84,63,123,75,44
060591100143,433,261,172,438,261,177,631,363,246,507,298,174
060590997023,658,368,290,680,363,317,1073,498,556,782,500,243
060590997033,606,282,324,621,276,345,881,392,472,715,334,331
060590997011,794,396,398,808,387,421,1411,605,781,936,537,350
060590997012,351,186,165,359,182,177,654,277,375,408,240,149
060590997013,316,163,153,324,163,161,601,248,343,400,227,152
060591100062,853,374,479,872,368,504,1062,536,505,933,410,466
060591100071,548,230,318,563,233,330,713,364,334,559,245,282
060591100073,967,410,557,990,419,571,1222,602,587,1115,511,547
060591100074,607,253,354,622,255,367,733,355,359,652,288,332
060591100081,1075,538,537,1103,541,562,1396,744,626,1174,556,556
060591100082,635,282,353,647,279,368,785,367,401,671,284,358
060591100083,583,259,324,594,255,339,717,347,354,639,310,301
060590995091,769,357,412,780,361,419,807,396,403,738,336,369
060590995092,525,250,275,534,251,283,751,369,378,523,244,262
060590995094,280,129,151,283,129,154,468,225,242,426,186,225
060590995095,369,169,200,373,171,202,470,218,248,396,182,200
060590995101,1333,615,718,1347,613,734,1630,755,855,1255,585,626
060590995102,649,300,349,653,297,356,823,400,411,803,403,375
060590995103,733,338,395,741,336,405,942,447,491,751,352,373
060379800071,0,0,0,0,0,0,0,0,0,1,1,0
060590995093,414,205,209,420,202,218,496,251,241,418,196,204
060591100072,512,222,290,520,213,307,617,305,303,527,223,279
060590995111,487,233,254,493,234,259,587,301,272,531,248,250
060590995112,447,228,219,455,233,222,578,286,280,501,263,214
060590995113,379,183,196,382,183,199,477,239,224,414,195,196
060590995114,396,203,193,407,208,199,531,284,239,424,218,180
060590995123,351,181,170,357,182,175,420,245,168,375,196,159
060590995121,688,353,335,702,357,345,844,451,383,752,374,338
060591100121,724,327,397,741,329,412,945,483,450,779,386,362
060591100122,625,287,338,639,291,348,770,376,382,655,294,337
060591100123,495,227,268,507,231,276,586,286,291,561,257,279
060375745002,1072,637,435,1070,627,443,1402,871,503,1186,677,429
060590995041,1586,799,787,1629,807,822,1978,1016,915,1657,824,736
060590995122,396,223,173,399,226,173,647,390,245,467,247,198
060375776041,703,381,322,710,376,334,895,526,353,746,382,318
060590423072,601,307,294,611,300,311,881,449,419,673,334,305
060590423074,287,149,138,291,147,144,383,199,176,325,160,148
060590423075,345,171,174,351,172,179,481,259,214,408,202,185
060590423274,606,282,324,615,277,338,556,290,260,447,171,258
060590423071,942,422,520,961,412,549,1210,625,564,1011,425,517
060590423073,607,272,335,619,267,352,849,435,395,614,283,303
060590626224,276,142,134,276,133,143,384,204,176,2,1,1
060590626522,778,422,356,795,421,374,1062,590,447,846,437,349
060590626521,627,341,286,641,332,309,891,511,350,696,359,279
060590626523,394,214,180,402,208,194,542,312,214,469,242,199
060590423331,1081,439,642,1101,437,664,1698,779,893,1193,516,621
060590423332,1135,464,671,1158,463,695,1462,733,707,1286,569,661
060590423201,909,518,391,922,507,415,1341,816,496,1129,639,429
060590423203,524,314,210,535,310,225,841,520,307,504,271,202
060590423281,689,270,419,701,267,434,953,427,512,908,356,501
060590423282,473,169,304,481,165,316,737,322,403,639,244,363
060590423271,436,178,258,445,174,271,637,309,313,515,206,276
060590626253,549,308,241,557,313,244,748,414,324,591,284,275
060590626254,226,127,99,230,129,101,292,205,83,155,121,24
060590423272,432,192,240,438,188,250,537,285,241,449,191,226
060590423273,1126,501,625,1144,491,653,1444,689,730,1219,532,602
060590626471,517,276,241,524,270,254,706,407,279,519,283,200
060590997021,740,363,377,765,356,409,1266,518,735,870,491,336
060590999021,439,213,226,444,201,243,622,291,321,508,245,231
060590999022,593,288,305,597,271,326,860,404,440,662,320,302
060590999033,629,316,313,644,309,335,1004,467,511,779,401,339
060590996012,659,361,298,670,367,303,1109,557,540,832,475,331
060590999031,393,237,156,404,225,179,634,314,307,480,284,169
060590999032,343,207,136,352,196,156,583,299,274,405,252,132
060590996014,449,212,237,461,217,244,667,310,345,482,272,191
060590999061,977,443,534,997,437,560,1233,560,641,1039,459,526
060590999062,580,280,300,592,275,317,783,361,409,632,297,302
060590999063,770,339,431,783,334,449,990,448,518,848,352,452
060590998022,740,438,302,769,439,330,1278,532,717,886,564,273
060590998013,398,215,183,403,208,195,656,297,348,470,301,144
060590998021,541,290,251,549,282,267,840,378,448,643,361,255
060590996011,407,249,158,418,239,179,723,370,338,473,322,123
060590996013,231,141,90,234,134,100,389,200,181,268,181,71
060590999042,367,223,144,372,213,159,645,321,312,450,284,142
060590999044,196,119,77,200,115,85,286,148,136,235,151,75
060590999045,252,153,99,254,146,108,424,216,197,309,196,97
060590889051,247,124,123,254,128,126,484,194,283,301,186,100
060590889052,628,319,309,648,329,319,1225,498,718,752,472,252
060590889053,363,184,179,372,188,184,608,247,361,421,264,142
060590998032,403,223,180,420,228,192,698,290,398,484,303,151
060590998033,571,307,264,591,314,277,1003,404,587,650,396,220
060590992411,797,376,421,817,382,435,1147,500,631,862,424,381
060590997032,871,401,470,893,401,492,1347,588,741,1022,483,481
060590998031,416,215,201,430,223,207,676,256,411,457,286,154
060590998012,643,306,337,660,316,344,1103,506,591,810,509,271
060590999051,415,212,203,422,211,211,701,367,320,470,239,202
060590999052,508,260,248,516,258,258,748,397,336,606,307,261
060590992231,492,231,261,503,230,273,778,311,454,565,343,199
060590992232,372,174,198,381,174,207,626,251,366,457,244,191
060590999023,408,207,201,417,204,213,723,338,369,519,315,176
060590999041,256,129,127,262,129,133,435,203,221,334,192,125
060590999043,280,142,138,286,140,146,474,221,243,367,190,156
060590992221,324,160,164,337,163,174,556,263,287,456,285,156
060590992222,439,216,223,451,219,232,710,284,413,483,256,201
060590992223,432,213,219,447,216,231,728,293,428,484,256,203
060590992224,322,159,163,332,160,172,522,210,304,370,197,155
060590996032,509,202,307,512,202,310,652,283,360,569,231,306
060590996033,681,271,410,688,271,417,821,356,456,713,291,383
060590889043,345,175,170,354,179,175,579,256,319,394,237,141
060590889044,408,206,202,421,212,209,679,300,373,465,278,166
060590992041,305,156,149,315,148,167,514,224,284,377,213,149
060590992042,310,159,151,317,149,168,539,234,296,338,192,134
060590423052,763,252,511,785,252,533,945,404,528,736,309,387
060590423233,528,209,319,535,208,327,712,311,391,619,236,355
060590423381,1460,656,804,1491,642,849,1919,938,944,1558,687,763
060590423382,812,347,465,830,345,485,1107,526,569,971,429,489
060590423393,465,209,256,471,208,263,494,249,236,493,211,253
060590423131,408,200,208,411,196,215,640,321,301,438,183,229
060590423132,399,189,210,405,186,219,527,254,268,468,203,239
060590423133,582,284,298,586,276,310,791,398,368,577,269,266
060590423231,524,227,297,535,226,309,516,236,274,634,275,335
060590423112,592,249,343,605,250,355,692,315,364,645,244,370
060590423134,606,273,333,617,273,344,844,403,418,673,310,315
060590423392,617,260,357,631,260,371,813,371,429,707,329,346
060590422014,499,228,271,507,227,280,692,317,362,547,221,291
060590422015,637,269,368,648,262,386,903,399,493,799,327,430
060590422061,744,339,405,757,335,422,981,453,511,804,322,434
060590422062,975,438,537,993,436,557,1247,585,643,914,367,492
060590422012,327,141,186,330,140,190,414,178,233,397,167,207
060590422013,675,302,373,688,309,379,906,412,471,750,355,348
060590422011,461,229,232,465,224,241,1673,870,764,754,312,404
060590421062,716,313,403,728,306,422,1094,493,576,392,182,191
060590422052,600,222,378,616,223,393,755,307,433,626,235,358
060590422053,1184,488,696,1206,482,724,1459,649,783,1270,520,670
060590422054,646,297,349,650,299,351,842,389,437,629,287,299
060590423114,1157,536,621,1184,544,640,1652,824,789,1267,551,626
060590423391,497,204,293,505,198,307,675,319,345,520,217,273
060590423135,506,251,255,517,248,269,726,378,328,551,260,263
060590423234,929,346,583,950,360,590,1157,501,634,972,371,553
060590423415,468,183,285,468,182,286,563,277,269,509,222,261
060590423411,448,232,216,455,225,230,475,245,223,308,135,158
060590423241,496,210,286,509,210,299,668,310,349,527,222,278
060590423242,285,149,136,287,146,141,434,233,192,349,147,186
060590423232,672,279,393,684,277,407,926,428,485,641,270,343
060590423053,559,279,280,574,281,293,662,370,281,592,289,272
060590626562,909,359,550,932,352,580,1202,560,615,422,197,204
060590423051,827,504,323,844,512,332,1074,675,382,683,414,239
060590626202,843,512,331,866,515,351,1037,666,361,858,493,321
060590626203,526,315,211,533,315,218,641,402,225,549,336,183
060590626204,834,527,307,853,531,322,977,636,326,900,566,291
060590626324,829,491,338,844,497,347,1076,671,387,986,587,363
060590626191,707,443,264,727,447,280,841,545,279,726,461,230
060590626321,445,310,135,453,307,146,448,306,134,393,238,133
060590626323,698,419,279,710,417,293,924,599,309,755,457,251
060590626051,354,239,115,362,240,122,463,310,143,229,154,63
060590626052,368,218,150,377,222,155,456,277,172,450,270,144
060590626054,553,346,207,559,345,214,759,479,267,598,366,186
060590626194,489,322,167,501,324,177,585,393,183,533,346,159
060590626192,476,301,175,489,305,184,708,463,231,495,317,157
060590626201,781,510,271,803,513,290,820,539,265,840,533,263
060590626053,359,250,109,368,251,117,432,297,124,370,250,99
060590626193,556,385,171,570,385,185,714,485,207,633,421,172
060590626561,481,280,201,492,285,207,505,301,192,429,251,151
060590626563,699,409,290,715,413,302,848,510,327,795,456,297
060590626492,533,383,150,543,380,163,755,522,217,661,429,197
060590626322,450,282,168,464,286,178,591,380,197,468,297,151
060590626331,1376,650,726,1399,647,752,2171,1080,1047,1473,692,696
060590626391,497,273,224,510,268,242,738,396,327,665,339,288
060590626392,793,424,369,813,417,396,1100,582,497,919,456,410
060590626393,875,464,411,893,455,438,1238,656,554,863,453,365
060590626344,352,195,157,358,195,163,478,283,182,403,213,160
060590626343,942,501,441,960,491,469,1306,729,542,598,310,240
060590626361,274,159,115,278,162,116,400,251,141,312,168,123
060590626362,469,271,198,477,278,199,635,398,223,554,314,192
060590626363,966,561,405,994,561,433,1554,883,637,468,258,177
060590626371,658,405,253,671,404,267,927,560,348,650,359,252
060590626382,781,435,346,800,427,373,1110,628,458,861,460,342
060590626383,598,360,238,613,360,253,1017,603,392,1268,667,526
060590626341,387,211,176,396,214,182,513,290,214,423,226,176
060590626353,574,313,261,588,318,270,764,430,317,605,323,241
060590626372,534,310,224,543,312,231,799,462,318,621,346,237
060590626373,483,280,203,491,282,209,749,432,298,497,273,195
060590626412,419,222,197,428,218,210,643,357,268,1199,638,506
060590626401,942,529,413,965,526,439,1377,759,586,908,489,365
060590626402,623,351,272,639,346,293,917,500,400,709,372,287
060590626342,1107,563,544,1136,563,573,1546,879,637,1177,565,529
060590626394,589,330,259,604,330,274,814,452,343,688,344,299
060590626381,444,243,201,455,237,218,536,302,221,437,240,158
060590626352,854,449,405,869,442,427,1103,609,466,889,451,379
060590626351,470,252,218,478,250,228,662,371,279,508,256,217
060590423204,656,362,294,678,368,310,971,554,397,814,416,328
060590626332,1403,733,670,1417,717,700,1781,1007,733,1412,707,619
060590320151,884,413,471,889,410,479,1105,584,495,906,417,438
060590320152,595,284,311,606,274,332,832,404,409,644,289,310
060590320154,645,300,345,662,295,367,874,422,426,732,308,387
060590320153,551,254,297,567,250,317,751,385,350,571,254,280
060590320491,422,147,275,434,144,290,577,236,331,448,144,274
060590320495,734,355,379,748,353,395,895,468,410,765,355,365
060590320494,1088,481,607,1112,483,629,1699,833,828,1055,474,528
060590320482,1130,409,721,1148,396,752,1529,725,794,1136,437,679
060590320483,495,241,254,504,241,263,690,356,314,540,261,250
060590320382,353,190,163,359,185,174,556,317,232,1219,580,566
060590320531,1370,566,804,1399,569,830,1882,865,974,1565,639,841
060590320534,639,290,349,652,291,361,987,492,474,787,397,348
060590320383,1270,646,624,1299,644,655,1738,946,761,1396,714,605
060590320381,1413,675,738,1455,675,780,1885,971,880,1546,733,727
060590320341,896,384,512,920,391,529,1224,631,575,992,419,518
060590320342,1468,607,861,1506,597,909,1832,870,915,1598,659,850
060590320474,606,309,297,614,303,311,622,314,289,641,343,257
060590320481,573,292,281,582,288,294,787,400,369,649,276,341
060590320351,839,316,523,848,309,539,1061,460,583,877,326,517
060590320352,461,175,286,467,170,297,598,259,328,520,192,305
060590320201,1170,499,671,1195,494,701,1509,718,763,564,221,308
060590320202,1447,612,835,1479,604,875,1811,872,905,1618,667,861
060590320401,908,401,507,921,386,535,1165,587,561,974,420,496
060590320402,558,246,312,565,237,328,711,358,342,585,253,297
060590320332,458,219,239,468,217,251,640,342,281,513,241,246
060590320333,327,141,186,339,148,191,437,234,192,352,150,184
060590320203,516,229,287,528,228,300,576,290,277,340,140,178
060590320311,651,327,324,667,322,345,921,483,417,734,338,346
060590320312,1082,472,610,1099,453,646,1382,656,702,1121,480,570
060590320331,508,259,249,520,253,267,798,428,352,591,296,265
060590320362,1223,519,704,1253,517,736,1599,734,839,1338,539,722
060590320321,677,288,389,690,277,413,860,403,442,749,311,398
060590320322,855,378,477,869,368,501,1088,531,535,898,385,460
060590320292,770,349,421,790,350,440,982,484,474,441,205,209
060590320293,863,408,455,883,406,477,873,463,383,1177,530,571
060590320302,1074,497,577,1097,488,609,1363,671,655,1198,525,588
060590320272,502,307,195,511,303,208,1000,566,406,529,306,180
060590320273,366,188,178,374,183,191,521,272,241,271,138,116
060590320282,649,379,270,663,375,288,974,552,396,901,479,351
060590320371,1417,538,879,1438,542,896,1686,766,902,1587,625,904
060590320373,985,362,623,998,366,632,1116,494,608,1004,393,578
060590320022,1060,467,593,1080,460,620,1194,580,594,1004,417,517
060590320281,560,244,316,572,239,333,734,415,297,599,243,310
060590320361,590,259,331,609,267,342,758,381,366,581,241,305
060590320133,429,178,251,437,177,260,530,245,276,470,199,247
060590320134,385,237,148,395,239,156,703,435,250,453,274,151
060590320131,710,288,422,719,287,432,919,419,485,628,245,350
060590320132,700,348,352,708,354,354,947,496,428,780,395,342
060590320031,839,377,462,852,368,484,1098,551,513,923,397,466
060590320032,818,333,485,834,329,505,993,482,490,873,337,477
060590320033,803,343,460,815,334,481,1039,500,511,868,359,457
060590320121,747,320,427,760,312,448,924,424,479,898,368,478
060590320023,949,430,519,963,423,540,1288,624,640,959,413,490
060590320024,670,294,376,679,292,387,843,410,418,734,312,390
060590320372,549,236,313,560,231,329,705,350,343,565,239,297
060590320021,441,176,265,450,174,276,518,250,255,466,176,257
060590320301,665,327,338,674,320,354,931,520,383,751,391,311
060590320291,541,259,282,557,260,297,707,357,334,581,271,271
060590320471,275,173,102,276,160,116,512,301,198,399,212,150
060590320472,368,181,187,373,177,196,501,255,236,423,183,210
060590320473,282,138,144,287,137,150,428,220,201,309,132,155
060590320223,404,206,198,405,201,204,473,240,227,397,193,180
060590320224,223,123,100,224,119,105,399,213,181,136,67,62
060590320221,955,507,448,969,487,482,1328,736,562,1061,529,471
060590320222,446,258,188,454,251,203,593,349,230,627,337,257
060590320393,305,159,146,306,153,153,426,228,186,317,157,141
060590320394,767,398,369,774,387,387,1028,554,447,807,400,357
060590320391,644,280,364,662,287,375,878,439,422,700,315,350
060590320392,1177,512,665,1209,525,684,1524,761,734,1241,530,643
060590320122,772,327,445,788,323,465,1027,468,527,845,379,408
060590320123,264,112,152,269,110,159,373,172,195,176,79,86
060590421162,638,295,343,655,297,358,875,411,444,596,261,292
060590421164,881,384,497,903,384,519,1149,520,608,1112,465,576
060590421151,551,229,322,561,229,332,729,304,413,701,261,392
060590421141,690,291,399,702,287,415,1014,431,565,735,288,402
060590421161,771,378,393,796,383,413,1204,618,562,806,362,378
060590421163,646,270,376,663,273,390,824,368,442,730,274,415
060590421082,241,107,134,245,107,138,324,151,167,245,110,110
060590421083,392,186,206,400,186,214,555,264,280,445,206,196
060590421071,341,173,168,347,172,175,501,240,253,375,174,181
060590421072,687,367,320,699,367,332,1035,526,477,760,385,330
060590421081,333,180,153,339,181,158,479,249,220,582,291,257
060590421084,658,350,308,666,350,316,1015,515,473,772,389,337
060590421061,421,161,260,421,155,266,534,230,299,447,180,241
060590421121,1541,527,1014,1566,520,1046,2056,834,1178,1727,574,1062
060590421094,567,231,336,573,222,351,719,330,371,608,241,330
060590421131,703,281,422,722,288,434,911,387,513,850,332,472
060590421132,692,277,415,707,278,429,911,391,507,661,254,371
060590421133,555,222,333,566,223,343,733,315,407,603,231,340
060590421143,590,249,341,607,249,358,772,342,415,690,288,368
060590421085,268,156,112,274,156,118,429,224,193,314,162,123
060590421091,578,235,343,584,228,356,757,350,384,585,235,313
060590421111,598,215,383,612,215,397,749,305,431,644,228,381
060590421122,815,287,528,832,287,545,1027,417,588,795,275,470
060590421112,802,305,497,816,297,519,1023,414,588,846,311,488
060590421123,953,348,605,963,343,620,1269,512,731,1008,373,576
060590320622,1083,394,689,1110,395,715,1723,739,950,1214,455,695
060590320632,721,267,454,731,265,466,1078,461,592,902,336,514
060590320633,940,350,590,953,341,612,1201,524,646,984,374,560
060590320643,50,18,32,51,18,33,53,22,30,19,7,11
060590320631,1245,468,777,1265,464,801,1597,682,872,1331,497,753
060590421092,819,333,486,829,321,508,1040,470,556,889,339,502
060590421093,276,112,164,281,109,172,353,158,189,307,117,173
060590421113,450,173,277,458,169,289,535,217,308,482,180,277
060590421114,1035,384,651,1046,377,669,1209,490,696,1047,394,595
060590320621,807,292,515,819,292,527,943,396,531,795,293,448
060590421115,733,274,459,745,270,475,1049,429,597,684,261,385
060590421142,471,205,266,480,199,281,619,278,327,507,218,262
060590421134,491,201,290,506,202,304,627,269,351,545,216,293
060590422051,807,302,505,827,299,528,1013,416,575,830,318,467
060590422036,663,248,415,663,244,419,820,342,466,702,277,398
060590320613,856,281,575,872,278,594,1009,379,612,902,294,574
060590320614,376,109,267,380,106,274,435,150,283,360,117,224
060590423122,692,330,362,703,324,379,911,444,457,816,342,432
060590320642,615,216,399,627,218,409,757,309,432,472,176,274
060590422035,945,333,612,964,335,629,1169,478,666,1375,517,794
060590320641,811,315,496,828,318,510,1024,447,563,830,330,460
060590422032,594,223,371,598,217,381,656,281,369,1247,513,668
060590422031,710,251,459,720,262,458,909,381,520,746,261,443
060590422034,625,282,343,637,283,354,1014,477,511,592,253,302
060590423414,851,441,410,861,433,428,408,226,173,280,126,135
060590423401,655,337,318,660,317,343,887,487,382,692,327,322
060590423111,628,278,350,635,268,367,783,382,389,676,274,365
060590423121,842,600,242,839,580,259,1161,774,368,897,604,240
060590423123,228,163,65,227,156,71,380,254,120,310,210,84
060590423124,217,156,61,218,146,72,352,257,92,266,195,59
060590423113,599,246,353,604,242,362,760,349,399,619,288,296
060590423412,474,202,272,480,195,285,615,251,355,512,204,282
060590423413,609,260,349,618,252,366,817,335,469,684,270,376
060590422033,619,231,388,627,228,399,763,329,421,671,247,397
060590320583,829,412,417,849,416,433,4054,1868,2113,2658,1083,1436
060590320611,523,186,337,533,184,349,656,274,365,583,189,364
060590320463,1213,332,881,1235,339,896,1633,603,1003,1357,400,902
060590320666,288,130,158,291,130,161,557,266,283,193,82,99
060590320464,700,180,520,712,183,529,910,322,571,793,236,520
060590320462,849,269,580,858,269,589,1073,427,629,925,290,604
060590320442,794,256,538,807,255,552,788,306,465,675,214,425
060590320443,565,158,407,571,152,419,949,367,562,636,205,401
060590320553,287,137,150,291,135,156,415,204,204,329,147,162
060590320452,797,285,512,810,283,527,1094,458,615,904,307,536
060590320444,799,255,544,809,249,560,1018,401,600,866,275,551
060590320461,337,89,248,344,86,258,438,146,285,367,111,241
060590320411,583,201,382,590,198,392,641,228,404,627,213,368
060590320432,789,271,518,801,276,525,1025,440,562,877,303,518
060590320112,362,186,176,372,189,183,438,234,193,408,190,185
060590320431,1167,423,744,1201,432,769,1624,694,895,1276,450,731
060590320423,658,258,400,676,253,423,1177,525,623,855,321,488
060590320441,926,297,629,949,295,654,1439,571,828,1168,411,691
060590524282,334,172,162,343,168,175,581,288,279,340,148,166
060590626105,810,555,255,826,555,271,2291,1472,760,1464,879,492
060590631021,914,510,404,940,504,436,1142,620,491,923,451,400
060590631024,714,384,330,729,381,348,980,522,437,855,407,375
060590637011,325,230,95,331,224,107,569,366,191,382,213,141
060590637013,310,220,90,314,213,101,353,252,91,304,169,113
060590637024,355,258,97,361,256,105,517,369,134,383,252,100
060590639031,655,359,296,665,356,309,867,480,369,750,365,318
060590639084,330,220,110,332,217,115,483,316,154,382,248,95
060590633011,383,213,170,394,217,177,618,338,262,506,273,190
060590633012,473,261,212,487,265,222,698,380,300,564,302,213
060590633021,494,219,275,508,224,284,650,320,316,420,165,218
060590633022,392,173,219,406,180,226,573,279,277,517,239,239
060590632021,298,153,145,305,153,152,402,202,187,350,164,158
060590632022,442,226,216,449,226,223,590,299,275,516,241,236
060590632024,322,165,157,329,165,164,455,229,212,361,170,165
060590639022,592,409,183,599,401,198,511,340,154,678,407,205
060590639024,198,137,61,200,134,66,360,203,146,233,124,93
060590638051,535,260,275,543,254,289,717,370,326,638,287,305
060590638052,653,319,334,662,311,351,891,460,407,769,349,369
060590638061,406,198,208,410,193,217,606,314,278,408,191,177
060590638062,649,294,355,658,296,362,803,362,426,677,295,331
060590636041,577,373,204,581,372,209,491,324,157,505,293,178
060590636051,168,136,32,168,132,36,271,212,54,218,127,77
060590636053,155,123,32,154,119,35,268,206,56,183,111,61
060590639052,385,215,170,390,209,181,395,248,137,292,146,116
060590639053,705,394,311,716,384,332,965,490,455,816,408,353
060590639051,671,329,342,687,340,347,1052,606,421,890,442,381
060590639023,214,159,55,215,155,60,411,273,124,250,149,81
060590632012,511,282,229,520,284,236,716,370,324,603,288,266
060590631011,673,403,270,678,402,276,946,492,429,797,346,396
060590636052,549,320,229,561,318,243,992,584,376,534,322,181
060590631022,691,392,299,708,388,320,1024,572,426,723,384,290
060590631023,630,358,272,643,353,290,876,495,362,673,320,301
060590637021,460,315,145,468,312,156,629,401,213,489,303,151
060590637023,338,220,118,341,222,119,515,302,197,406,223,153
060590639061,407,271,136,415,271,144,617,405,194,451,283,131
060590639062,337,226,111,343,225,118,506,333,158,333,208,97
060590632011,503,280,223,520,282,238,737,400,313,587,289,241
060590636011,870,486,384,892,484,408,1179,658,494,790,438,294
060590636012,514,285,229,532,286,246,712,404,290,509,283,189
060590638032,456,260,196,465,257,208,592,339,238,533,297,197
060590638034,506,284,222,521,283,238,670,376,280,518,288,193
060590631031,872,401,471,890,409,481,939,457,462,759,317,396
060590631032,494,232,262,504,234,270,846,420,398,648,301,298
060590632023,511,248,263,524,248,276,653,346,288,531,243,258
060590639041,661,357,304,675,356,319,975,517,428,834,415,345
060590639042,592,319,273,609,320,289,729,391,323,552,282,228
060590639043,205,110,95,211,111,100,304,163,133,233,123,89
060590639082,794,476,318,797,470,327,692,404,260,545,259,242
060590639081,516,297,219,528,292,236,1229,720,472,615,292,288
060590639083,345,198,147,350,195,155,480,280,192,511,296,159
060590638021,766,402,364,780,403,377,1022,494,503,710,321,346
060590638073,873,430,443,891,426,465,1408,762,608,977,531,374
060590638071,327,176,151,332,175,157,431,248,175,371,187,161
060590638063,804,303,501,816,300,516,995,443,533,819,410,356
060590638031,512,241,271,523,238,285,630,303,312,518,288,191
060590638072,339,159,180,346,157,189,421,204,209,358,181,155
060590638083,241,200,41,243,194,49,361,286,61,516,283,198
060590639063,875,491,384,899,479,420,1238,671,527,1056,511,463
060590639101,1229,634,595,1251,637,614,1685,903,753,1316,676,577
060590639102,890,468,422,904,468,436,1251,667,561,1146,583,503
060590639032,775,403,372,790,399,391,1014,538,456,836,425,349
060590633013,315,153,162,326,157,169,486,237,237,321,154,143
060590633023,582,283,299,598,288,310,720,354,351,658,297,319
060590633024,419,204,215,431,208,223,573,280,276,502,228,236
060590636034,397,214,183,409,217,192,978,523,434,466,246,187
060590636042,646,376,270,657,382,275,925,483,426,757,434,269
060590638033,399,227,172,405,225,180,547,314,218,474,264,175
060590637014,250,179,71,253,178,75,374,268,96,260,144,96
060590638082,269,197,72,271,197,74,419,308,102,406,224,155
060590638081,497,353,144,501,352,149,780,514,244,605,337,223
060590637012,267,213,54,268,210,58,286,218,65,244,137,92
060590632013,580,287,293,590,288,302,840,421,390,631,305,276
060590639092,795,559,236,815,555,260,1387,918,440,1060,645,348
060590637022,139,105,34,140,105,35,203,122,77,182,104,64
060590637025,239,180,59,242,181,61,374,270,96,235,165,52
060590638022,760,279,481,773,279,494,794,350,426,880,314,529
060590639021,992,514,478,1012,529,483,1748,991,712,1051,510,468
060590218143,548,210,338,559,215,344,677,302,361,595,232,335
060590218322,743,380,363,759,375,384,1087,615,462,876,460,384
060590015035,424,234,190,432,225,207,352,202,147,505,248,222
060590015071,486,254,232,493,241,252,932,531,385,562,281,250
060590015072,255,132,123,258,126,132,377,190,181,288,131,137
060590626421,455,175,280,463,175,288,602,273,322,516,208,282
060590626422,651,243,408,668,245,423,626,284,333,521,208,288
060590626423,780,287,493,800,288,512,1016,425,573,855,329,482
060590627022,413,156,257,421,161,260,499,213,276,440,173,249
060590627023,716,328,388,732,351,381,904,441,450,789,342,400
060590627024,383,153,230,392,156,236,503,246,251,418,182,220
060590626583,906,341,565,931,347,584,1184,510,644,995,377,570
060590626581,1022,384,638,1049,392,657,1372,603,737,1136,429,647
060590630041,1132,453,679,1159,459,700,1442,672,748,1185,494,624
060590630074,694,281,413,708,284,424,880,412,458,739,312,387
060590630091,429,168,261,440,165,275,500,208,285,435,187,216
060590636031,686,348,338,694,342,352,969,493,448,789,380,349
060590627011,807,287,520,819,288,531,1047,434,593,831,309,486
060590630043,581,235,346,590,230,360,737,303,421,689,255,406
060590630051,349,121,228,355,118,237,438,162,271,456,119,323
060590630052,371,128,243,380,126,254,481,178,297,381,138,227
060590015012,1244,524,720,1272,500,772,1818,859,927,890,380,465
060590015061,926,422,504,934,408,526,1481,703,741,1305,545,670
060590634001,504,223,281,513,218,295,637,275,349,490,208,249
060590628002,448,185,263,456,187,269,524,224,294,469,183,253
060590635001,473,191,282,485,192,293,775,323,433,553,192,331
060590635002,259,112,147,265,112,153,417,174,230,427,165,234
060590635003,343,142,201,353,143,210,437,186,244,347,142,190
060590635004,279,112,167,290,114,176,365,148,209,314,119,175
060590635005,223,94,129,227,95,132,304,129,169,220,92,114
060590627012,740,309,431,754,314,440,980,451,514,811,342,417
060590629001,644,184,460,655,186,469,782,256,512,717,211,472
060590629002,467,136,331,475,137,338,590,193,389,509,150,341
060590015041,370,186,184,378,180,198,521,301,209,368,185,159
060590015043,377,189,188,385,184,201,522,301,211,389,198,168
060590015073,783,382,401,802,374,428,1056,541,499,1062,480,523
060590630102,480,307,173,489,304,185,822,472,317,710,303,361
060590630103,1419,478,941,1448,476,972,1619,615,975,1431,521,831
060590634003,375,126,249,378,127,251,579,218,346,376,160,190
060590636032,723,333,390,747,345,402,955,473,467,781,338,393
060590630061,741,240,501,759,250,509,895,333,541,838,280,516
060590630062,774,250,524,796,260,536,963,364,591,881,288,556
060590630101,508,183,325,522,183,339,536,213,312,548,229,284
060590630104,748,277,471,771,277,494,977,415,551,770,294,432
060590627021,518,200,318,529,207,322,634,267,359,583,228,328
060590627025,441,181,260,449,183,266,587,259,321,521,206,284
060590634005,719,222,497,735,234,501,926,329,581,855,317,487
060590626433,471,180,291,483,190,293,586,246,335,487,193,279
060590628003,553,230,323,566,233,333,705,298,394,682,269,365
060590628004,337,146,191,347,151,196,446,199,241,395,164,204
060590628001,588,202,386,602,211,391,758,275,467,589,222,333
060590635006,585,269,316,603,269,334,703,314,377,598,230,344
060590015032,389,191,198,396,188,208,590,301,270,338,163,152
060590626432,576,255,321,590,266,324,737,361,367,1118,483,587
060590626454,332,148,184,341,151,190,470,224,240,334,148,170
060590626436,438,201,237,443,198,245,662,333,317,648,311,306
060590626434,461,214,247,468,210,258,958,464,475,382,179,183
060590626453,403,196,207,410,189,221,561,265,287,400,175,203
060590626431,731,293,438,747,305,442,998,444,541,310,130,170
060590626437,219,98,121,223,98,125,284,147,132,236,110,112
060590626435,447,199,248,453,198,255,558,289,259,496,226,239
060590626451,720,313,407,731,315,416,734,342,376,734,321,375
060590626452,370,161,209,375,162,213,526,244,271,384,169,196
060590626455,913,374,539,917,362,555,1124,536,573,998,425,523
060590634004,418,172,246,430,179,251,538,240,289,604,218,351
060590630071,1179,339,840,1195,351,844,1609,533,1050,958,364,547
060590630082,345,99,246,349,102,247,406,133,267,365,138,208
060590630081,147,42,105,149,44,105,228,75,149,138,52,79
060590634002,622,235,387,637,239,398,751,314,423,629,258,331
060590630073,845,432,413,861,432,429,1337,696,610,1098,513,519
060590015042,476,254,222,481,251,230,723,393,309,554,279,231
060590626571,397,195,202,406,197,209,591,299,283,423,198,200
060590630072,1027,377,650,1038,376,662,1228,499,706,1064,403,608
060590630092,563,206,357,579,208,371,706,296,393,574,205,334
060374087031,625,311,314,646,303,343,1023,585,427,675,341,304
060590015013,1000,405,595,1028,385,643,1265,582,659,1145,439,630
060590218321,295,137,158,297,125,172,390,187,193,661,330,299
060590218323,1264,633,631,1287,606,681,2544,1381,1129,798,399,356
060590626582,835,338,497,850,342,508,1017,459,542,804,304,458
060590630042,703,376,327,715,373,342,905,447,433,799,302,457
060590626572,557,274,283,568,275,293,934,469,445,518,243,246
060590636013,291,153,138,296,147,149,384,195,175,330,156,146
060590630044,712,307,405,722,315,407,835,392,432,738,323,374
060590015062,981,424,557,1002,416,586,1250,629,598,1207,533,618
060590631012,444,167,277,457,164,293,574,229,329,453,194,226
060590636033,624,336,288,644,341,303,952,515,415,622,265,315
060590015044,429,260,169,441,258,183,581,338,235,473,257,182
060590218144,888,414,474,901,395,506,1130,595,509,927,416,426
060590320511,305,151,154,308,144,164,453,229,215,353,173,156
060590320513,558,277,281,565,264,301,815,413,382,611,300,271
060590320501,268,127,141,274,122,152,397,190,202,318,138,163
060590320502,604,275,329,612,260,352,839,392,432,649,295,311
060590320512,489,233,256,491,219,272,703,342,341,595,273,281
060590320542,207,99,108,209,97,112,307,151,149,228,102,112
060590320543,210,102,108,209,98,111,244,115,125,200,90,99
060590320544,516,267,249,522,260,262,308,145,159,610,284,286
060590320514,230,114,116,230,108,122,323,164,149,250,118,115
060590320532,839,347,492,856,352,504,1106,526,554,878,393,444
060590320533,708,299,409,719,299,420,767,354,396,593,274,284
060590320652,333,155,178,339,153,186,467,239,216,387,180,181
060590320651,463,196,267,474,196,278,669,312,342,513,206,281
060590320493,1110,515,595,1132,511,621,1553,793,735,1235,566,594
060590320484,761,372,389,774,366,408,1070,552,491,806,390,369
060590320492,569,281,288,581,277,304,829,430,382,885,400,429
060590320421,1680,660,1020,1710,642,1068,2154,944,1167,1771,656,999
060590320422,498,192,306,509,187,322,497,219,267,396,142,227
060590320343,581,215,366,590,220,370,739,331,394,656,253,373
060590320551,251,120,131,258,120,138,372,186,171,177,92,71
060590320552,226,108,118,232,108,124,337,171,158,359,187,145
060590320554,506,242,264,519,241,278,700,356,327,532,241,248
060590320541,919,448,471,937,430,507,1843,935,858,1087,514,504
060590320503,1110,541,569,1129,526,603,1627,835,772,1335,619,651
060590524225,1390,827,563,1420,815,605,3303,1906,1332,1499,827,591
060590524253,471,263,208,480,257,223,694,383,295,534,282,216
060590524231,608,283,325,621,283,338,1098,558,519,997,426,512
060590524233,559,243,316,567,243,324,665,326,325,556,231,291
060590524242,622,310,312,636,306,330,1101,588,486,556,261,258
060590524243,506,249,257,519,250,269,658,346,298,486,236,219
060590524254,685,348,337,698,351,347,961,522,417,764,390,327
060590524251,502,252,250,510,248,262,695,374,304,542,254,248
060590524221,828,367,461,841,363,478,1107,569,510,956,418,476
060590524252,323,161,162,328,157,171,436,229,195,380,172,178
060590524232,752,420,332,769,424,345,614,370,231,489,277,179
060590524241,590,373,217,595,355,240,847,527,302,748,363,337
060590524152,1031,423,608,1056,424,632,1297,605,652,1108,451,575
060590320271,1123,551,572,1143,528,615,1566,810,729,1448,680,672
060590524081,547,217,330,559,218,341,711,331,366,596,248,318
060590524084,640,254,386,657,256,401,814,360,443,674,280,359
060590524161,284,152,132,290,152,138,395,229,161,307,150,138
060590524162,743,395,348,755,395,360,1045,584,446,853,396,398
060590320141,948,528,420,960,521,439,1328,730,573,1055,602,376
060590524082,990,443,547,1010,432,578,1280,635,616,1045,513,473
060590524083,974,435,539,993,425,568,1232,611,590,1044,422,547
060590320143,520,268,252,531,260,271,709,364,335,567,277,252
060590320142,308,162,146,315,156,159,428,233,182,347,171,155
060590524111,640,309,331,645,300,345,858,457,380,701,336,323
060590524112,550,292,258,556,292,264,736,447,272,577,303,236
060590524223,613,224,389,625,227,398,767,346,408,648,230,378
060590524224,440,234,206,448,230,218,906,488,394,501,251,215
060590524309,742,385,357,757,379,378,1070,600,448,830,423,352
060590524303,942,394,548,963,389,574,1087,536,529,860,370,436
060590524271,1057,509,548,1087,514,573,1534,807,696,1175,511,588
060590524272,1013,484,529,1043,490,553,1486,778,678,1150,495,577
060590524301,611,247,364,620,239,381,860,423,418,668,290,336
060590524281,729,335,394,747,331,416,1466,760,671,661,288,331
060590524283,363,157,206,373,157,216,508,242,257,426,185,209
060590524284,1046,465,581,1074,466,608,1329,669,629,1135,492,565
060590524285,376,168,208,385,167,218,522,271,238,401,174,202
060590524113,495,238,257,501,231,270,663,349,296,538,259,250
060590524163,578,264,314,589,252,337,720,357,348,595,251,306
060590524101,335,185,150,341,177,164,474,257,205,343,185,131
060590524102,558,224,334,567,229,338,689,313,367,586,189,383
060590524103,620,342,278,627,326,301,875,473,376,821,404,361
060590524151,1086,540,546,1105,547,558,1331,747,556,1148,580,517
060590524104,638,255,383,648,261,387,796,365,422,638,306,290
060590757013,369,212,157,375,213,162,561,344,204,982,584,335
060590218141,992,453,539,1015,458,557,1467,745,690,1126,506,561
060590218142,738,337,401,754,340,414,940,473,450,601,305,246
060590423171,494,205,289,502,205,297,672,325,336,498,218,248
060590423172,476,196,280,486,198,288,575,278,284,492,182,277
060590423311,1259,546,713,1282,544,738,1566,782,756,1338,617,659
060590423292,721,350,371,734,349,385,921,478,426,772,357,387
060590423293,817,396,421,829,395,434,1126,585,521,862,407,415
060590423301,883,415,468,905,422,483,1230,631,570,897,420,434
060590423262,1427,759,668,1445,745,700,1923,1059,833,1596,825,690
060590423243,802,364,438,813,363,450,919,457,447,842,382,426
060590423251,952,466,486,966,455,511,1220,653,545,1010,467,493
060590423303,613,290,323,623,286,337,905,483,410,614,288,292
060590423304,403,191,212,410,188,222,596,319,270,377,177,179
060590423313,666,346,320,677,340,337,940,518,410,718,361,317
060590423244,828,416,412,843,428,415,1014,562,428,866,409,423
060590423252,759,384,375,775,385,390,1102,596,485,862,417,404
060590423302,201,95,106,206,96,110,289,148,133,413,197,193
060590423372,780,261,519,789,262,527,991,401,570,807,284,485
060590423191,1293,558,735,1316,569,747,1725,869,832,1468,618,758
060590423261,614,308,306,626,301,325,844,449,377,619,320,271
060590423155,494,246,248,503,247,256,595,299,273,471,243,204
060590423153,517,256,261,524,249,275,772,391,366,521,268,225
060590423371,487,241,246,495,236,259,599,303,285,492,210,252
060590423312,274,154,120,280,152,128,357,204,148,530,284,216
060590423151,507,250,257,513,244,269,726,379,336,528,236,260
060590423154,767,380,387,778,377,401,1009,527,464,827,366,410
060590423152,534,259,275,540,250,290,702,363,326,640,271,327
060590423321,745,316,429,757,314,443,958,465,476,799,362,393
060590423322,1060,443,617,1076,439,637,1298,605,672,1266,517,679
060590423323,1055,445,610,1072,445,627,1335,658,649,1091,490,541
060590423173,975,423,552,995,421,574,1282,641,621,925,382,494
060590423373,428,178,250,436,177,259,559,251,300,498,217,250
060590423341,570,305,265,575,302,273,802,425,362,658,334,287
060590423342,349,186,163,352,186,166,480,254,216,382,213,147
060590423352,929,471,458,944,466,478,1313,681,608,1025,493,487
060590423353,959,492,467,974,486,488,1391,724,643,1089,542,495
060590423361,1425,687,738,1460,686,774,1886,970,877,1491,710,697
060590423351,584,314,270,593,307,286,798,421,361,590,283,278
060590423362,639,344,295,648,337,311,864,455,390,761,364,350
060590423291,592,283,309,606,282,324,772,396,361,590,272,278
060590423343,700,360,340,713,357,356,895,484,392,777,368,363
060590423344,583,301,282,595,298,297,730,394,319,657,356,278
060590423192,501,235,266,504,237,267,477,247,222,378,171,184
060590525051,290,168,122,296,168,128,437,259,167,370,214,134
060590525262,1086,607,479,1102,600,502,1455,856,571,1155,622,452
060590626101,309,181,128,312,184,128,827,480,326,0,0,0
060590755166,232,169,63,237,170,67,1032,713,289,242,160,64
060590626111,127,86,41,131,87,44,284,196,83,142,93,41
060590626112,368,249,119,376,250,126,446,308,130,311,204,89
060590626113,564,382,182,578,386,192,840,580,244,685,452,191
060590626271,404,273,131,413,274,139,492,340,143,415,301,91
060590626501,808,531,277,825,534,291,1127,749,350,883,564,265
060590626502,603,373,230,616,373,243,768,493,260,623,375,210
060590626503,772,504,268,785,504,281,925,605,306,868,546,277
060590525221,471,295,176,476,297,179,700,453,232,513,330,157
060590525223,438,265,173,443,266,177,679,428,234,486,326,140
060590525232,360,218,142,368,220,148,521,327,181,409,252,137
060590525233,611,369,242,622,372,250,835,524,288,698,428,233
060590626554,1126,564,562,1142,551,591,1679,908,738,1260,673,519
060590626291,892,506,386,913,499,414,1091,683,384,950,554,336
060590626292,355,207,148,364,209,155,456,286,160,396,232,140
060590626313,530,301,229,542,296,246,644,402,227,704,390,276
060590626311,350,204,146,354,203,151,414,263,145,372,199,158
060590626312,392,225,167,400,224,176,488,305,171,433,255,153
060590626148,1060,981,79,1077,980,97,329,298,22,1622,1408,115
060590525282,467,279,188,485,279,206,644,417,210,364,216,128
060590525284,280,167,113,289,167,122,375,245,122,458,271,157
060590525281,306,183,123,317,183,134,393,255,130,332,196,113
060590525283,248,149,99,257,149,108,344,222,112,282,166,98
060590525321,1042,666,376,1066,666,400,1557,1036,489,1388,849,438
060590525324,347,221,126,355,221,134,520,347,163,381,238,114
060590525322,84,54,30,86,54,32,122,81,39,92,54,31
060590525061,761,349,412,773,351,422,929,476,434,786,363,378
060590525062,468,215,253,477,216,261,576,295,270,487,229,236
060590525275,624,365,259,643,371,272,930,563,351,682,397,247
060590525276,766,436,330,793,444,349,1077,653,399,815,470,303
060590525271,590,336,254,607,340,267,799,485,296,609,349,226
060590626512,242,156,86,245,156,89,358,231,120,173,107,57
060590626513,366,237,129,369,235,134,433,281,146,375,233,123
060590525111,563,311,252,578,317,261,705,420,271,598,336,223
060590525112,388,196,192,395,199,196,500,280,210,408,204,180
060590525115,378,211,167,386,212,174,463,277,178,403,229,149
060590525116,301,172,129,311,176,135,386,233,143,324,192,113
060590525114,286,164,122,292,166,126,396,243,146,317,189,110
060590525113,611,314,297,624,320,304,761,433,316,628,323,269
060590626301,475,245,230,486,246,240,541,324,207,456,235,204
060590626302,403,207,196,413,210,203,424,253,162,349,179,156
060590525131,417,248,169,426,250,176,584,366,203,438,261,150
060590525136,405,241,164,414,244,170,494,311,173,462,281,152
060590525134,516,304,212,531,310,221,634,399,220,575,340,200
060590525135,342,195,147,347,198,149,420,269,143,365,210,137
060590524174,311,197,114,312,188,124,450,281,164,334,190,126
060590524361,398,234,164,407,230,177,599,396,192,430,251,166
060590524364,334,195,139,341,192,149,499,329,160,363,215,132
060590524211,844,485,359,862,486,376,1040,643,376,931,546,320
060590524212,537,306,231,549,307,242,676,415,245,602,339,223
060590525132,330,216,114,337,216,121,407,263,138,373,232,116
060590525133,343,224,119,347,223,124,432,278,146,349,223,99
060590525331,388,218,170,401,223,178,516,316,192,423,242,153
060590525336,528,296,232,543,303,240,701,431,263,491,276,190
060590525332,377,213,164,388,216,172,486,298,181,403,225,153
060590626281,314,202,112,322,200,122,285,188,92,246,146,83
060590626282,958,572,386,983,575,408,1349,859,457,1003,583,367
060590524176,385,169,216,393,169,224,549,285,255,421,218,184
060590524171,577,254,323,590,253,337,668,347,311,607,238,341
060590524172,391,173,218,399,170,229,516,269,241,467,184,263
060590524173,449,197,252,457,196,261,574,298,268,466,241,206
060590524214,358,198,160,363,197,166,470,286,174,405,224,156
060590524215,473,261,212,484,261,223,648,396,240,533,296,208
060590525144,712,377,335,729,378,351,911,535,354,706,401,264
060590525143,457,242,215,469,243,226,601,354,234,519,300,190
060590525193,832,505,327,849,503,346,981,615,342,778,443,283
060590525192,402,245,157,410,242,168,545,346,183,544,334,187
060590525204,269,162,107,277,161,116,357,221,128,284,173,98
060590525202,415,244,171,426,241,185,512,317,186,450,267,159
060590525201,235,135,100,240,136,104,321,201,114,250,138,95
060590626262,303,250,53,310,256,54,302,229,63,487,353,105
060590626272,323,266,57,331,273,58,258,196,53,297,214,64
060590626273,270,223,47,276,228,48,361,274,74,342,247,74
060590626144,562,519,43,573,524,49,372,337,26,523,454,32
060590626147,1124,1021,103,1140,1022,118,1145,1022,97,1090,946,77
060590626145,445,398,47,452,397,55,466,410,46,420,369,34
060590626553,182,102,80,185,99,86,265,150,111,234,120,100
060590626141,579,514,65,585,512,73,652,572,66,572,503,46
060590626143,353,314,39,355,311,44,391,348,40,338,299,28
060590524333,285,202,83,290,199,91,561,366,187,575,367,177
060590524332,310,220,90,314,215,99,485,321,156,195,126,57
060590524331,328,233,95,332,228,104,555,365,178,388,259,107
060590525333,441,259,182,450,257,193,630,376,240,437,252,158
060590525334,375,221,154,382,218,164,537,323,207,532,297,206
060590525335,815,480,335,833,475,358,1105,663,419,910,527,331
060590626261,440,338,102,449,336,113,463,330,121,455,357,75
060590525141,472,286,186,479,287,192,381,243,128,428,245,159
060590525323,238,133,105,243,138,105,503,308,189,256,160,78
060590525142,511,334,177,522,330,192,979,624,328,629,386,211
060590524175,837,465,372,856,466,390,1106,691,404,872,512,312
060590626314,137,80,57,140,80,60,175,110,61,142,81,54
060590524362,263,153,110,268,151,117,873,554,302,218,133,76
060590524363,527,308,219,541,305,236,727,483,233,237,143,82
060590524365,497,290,207,508,286,222,755,463,280,718,430,257
060590525291,558,355,203,570,352,218,953,633,299,645,416,195
060590525301,582,366,216,594,364,230,1041,682,334,607,380,191
060590525302,491,308,183,502,308,194,723,473,232,523,328,164
060590525311,656,390,266,669,394,275,963,595,348,657,394,220
060590525312,610,364,246,626,369,257,892,549,322,597,361,199
060590525292,453,291,162,465,288,177,661,436,207,493,325,150
060590525272,314,202,112,322,200,122,446,297,140,354,228,103
060590525273,205,132,73,209,130,79,441,286,144,249,161,73
060590755164,316,236,80,325,236,89,383,269,101,219,144,58
060590525222,445,287,158,450,289,161,637,421,206,468,297,147
060590525231,217,140,77,221,142,79,336,221,108,280,177,87
060590525234,162,105,57,164,105,59,255,168,81,183,116,58
060590525213,246,180,66,249,180,69,398,270,119,353,223,104
060590525214,199,147,52,203,147,56,341,232,103,179,117,48
060590755165,336,247,89,340,246,94,719,487,215,279,183,73
060590525303,351,246,105,354,246,108,399,262,129,317,202,94
060590525211,481,341,140,485,341,144,826,556,250,579,375,161
060590525212,271,192,79,272,191,81,445,299,135,292,193,75
060590755163,930,574,356,946,564,382,1354,940,383,1107,686,361
060590525191,558,329,229,575,325,250,723,445,261,621,351,230
060590525203,498,292,206,511,289,222,644,397,233,552,318,203
060590755161,303,233,70,308,228,80,189,146,41,1,1,0
060590626511,519,292,227,533,289,244,698,429,261,568,323,217
060590525053,482,267,215,492,266,226,659,373,272,528,287,215
060590525056,371,206,165,378,204,174,485,276,201,411,212,179
060590525052,258,143,115,263,142,121,367,209,152,257,169,72
060590525055,386,214,172,393,213,180,546,311,225,389,217,153
060590525054,104,58,46,107,58,49,123,71,51,112,57,50
060590525274,684,400,284,703,406,297,888,538,335,707,414,256
060590525261,679,373,306,688,368,320,924,534,368,736,411,271
060590626541,569,378,191,582,379,203,888,576,290,889,539,299
060590626543,758,504,254,777,505,272,1247,810,408,608,413,175
060590626542,573,374,199,589,376,213,884,571,296,649,407,209
060590524373,501,307,194,511,308,203,1126,693,413,176,106,62
060590524374,111,70,41,111,71,40,192,115,73,264,156,97
060590524375,517,295,222,536,294,242,1290,784,486,533,320,189
060590525181,963,721,242,975,717,258,1776,1204,539,2331,1473,726
060590525183,508,380,128,514,378,136,956,647,290,595,385,171
060590524351,393,243,150,403,244,159,487,311,163,325,196,112
060590524352,569,340,229,582,340,242,757,475,262,511,303,178
060590524353,661,396,265,680,397,283,856,542,298,564,337,197
060590524354,327,195,132,335,194,141,439,276,153,305,180,107
060590524355,430,245,185,441,248,193,640,393,233,465,273,177
060590626142,1008,936,72,1025,942,83,935,848,42,929,800,42
060590626146,455,423,32,463,426,37,463,421,21,458,382,25
060590626551,224,125,99,226,121,105,306,173,129,255,131,110
060590626552,417,232,185,423,226,197,587,331,248,460,237,199
060590524341,327,186,141,339,190,149,465,286,168,648,396,222
060590524343,410,237,173,422,239,183,636,393,229,422,264,141
060590524342,1096,650,446,1121,651,470,1690,1062,590,1266,780,419
060590524344,394,240,154,400,237,163,702,448,238,527,322,175
060590525341,583,384,199,588,372,216,340,216,115,665,443,183
060590524321,2777,1862,915,2839,1848,991,5625,3728,1775,678,448,189
060590524323,361,242,119,371,243,128,600,392,192,424,280,118
060590524311,467,312,155,482,314,168,761,496,250,527,353,150
060590524312,2297,1522,775,2360,1549,811,4057,2699,1281,451,300,126
060590524396,27,10,17,28,11,17,422,256,161,1,1,0
060590524307,360,220,140,369,218,151,2,1,1,2,1,1
060590524308,1429,874,555,1467,868,599,6,4,2,5,3,2
060590524302,0,0,0,0,0,0,0,0,0,0,0,0
060590524306,4,2,2,4,2,2,4,2,2,3,2,1
060590524383,354,239,115,363,244,119,1181,787,372,0,0,0
060590626102,240,156,84,245,156,89,407,257,141,270,160,94
060590626103,908,587,321,928,591,337,1064,669,369,732,436,244
060590626104,175,113,62,179,114,65,272,171,94,201,118,70
060590524322,280,188,92,290,190,100,424,285,131,323,216,88
060590524291,1144,723,421,1172,716,456,2215,1472,712,37,24,11
060590524292,909,574,335,935,572,363,1713,1137,552,119,78,36
060590524293,641,404,237,651,401,250,1230,821,395,22,15,6
060590524294,96,61,35,99,61,38,187,124,60,22,14,7
060590755183,55,34,21,56,33,23,51,33,18,23,14,8
060590626533,1212,764,448,1222,758,464,1396,909,463,0,0,0
060590524381,16,11,5,16,11,5,55,37,17,0,0,0
060590524382,251,167,84,258,172,86,842,563,265,0,0,0
060590525351,916,525,391,935,529,406,1390,847,514,1323,824,450
060590524324,40,27,13,40,26,14,3205,2032,1101,5904,3801,1802
060590525353,29,20,9,29,19,10,54,36,17,40,28,10
060590525354,65,44,21,67,44,23,272,179,85,85,58,21
060590525352,114,78,36,115,75,40,678,447,210,135,92,34
060590762022,488,220,268,500,213,287,672,311,345,500,215,257
060590758072,1054,480,574,1084,465,619,1308,618,652,1061,480,497
060590761051,499,290,209,500,276,224,744,448,278,598,350,208
060590761053,275,161,114,278,152,126,428,257,159,329,189,113
060590761052,522,311,211,521,292,229,803,493,296,671,393,231
060590758052,659,302,357,670,289,381,832,419,392,723,313,362
060590759011,378,210,168,384,207,177,426,248,164,445,232,177
060590759012,327,205,122,334,200,134,400,237,154,410,229,147
060590759013,680,436,244,688,421,267,956,665,271,767,456,243
060590762081,643,318,325,647,310,337,911,469,421,735,339,344
060590762082,392,195,197,392,188,204,501,260,232,432,200,204
060590762083,676,308,368,680,303,377,896,431,446,854,401,402
060590762084,270,134,136,271,129,142,401,207,185,285,132,134
060590758101,828,292,536,840,289,551,1049,425,599,866,320,505
060590758121,300,159,141,302,153,149,488,302,169,331,185,122
060590762052,600,316,284,604,307,297,882,450,409,738,387,301
060590762061,380,200,180,377,192,185,629,318,290,484,252,196
060590762014,694,324,370,706,317,389,982,508,453,753,344,366
060590762013,411,191,220,419,185,234,552,284,258,528,233,268
060590758051,432,233,199,436,225,211,597,336,241,362,201,133
060590758151,958,427,531,973,414,559,1266,577,651,1093,501,520
060590758153,444,197,247,452,192,260,610,281,316,446,219,195
060590761023,524,317,207,547,328,219,796,443,343,587,415,148
060590762042,236,156,80,237,145,92,381,247,123,300,199,78
060590762043,214,140,74,212,131,81,385,251,122,267,179,69
060590762062,327,149,178,331,145,186,420,214,200,363,163,178
060590762063,427,182,245,438,178,260,526,264,250,457,189,245
060590762051,293,153,140,298,153,145,433,254,167,332,175,134
060590762054,273,142,131,278,142,136,342,199,129,302,157,122
060590758053,334,191,143,336,184,152,455,277,167,393,221,146
060590219182,1097,562,535,1121,571,550,1515,805,676,1196,590,532
060590760014,426,267,159,427,257,170,618,404,203,506,305,161
060590760021,313,222,91,317,229,88,687,492,180,327,217,86
060590760012,548,344,204,550,331,219,796,515,263,657,397,209
060590760013,366,232,134,366,227,139,454,295,151,424,267,131
060590760015,531,342,189,533,342,191,841,506,315,656,418,190
060590758061,523,267,256,531,261,270,819,397,402,638,287,317
060590758062,431,220,211,438,214,224,626,305,309,491,214,252
060590758063,208,106,102,211,103,108,297,212,78,253,167,67
060590758064,376,198,178,377,191,186,568,328,228,513,275,206
060590756045,550,227,323,559,224,335,682,320,348,596,307,250
060590756046,656,250,406,664,240,424,783,350,415,848,344,458
060590758065,344,205,139,348,198,150,483,277,194,391,220,140
060590759022,659,385,274,673,372,301,940,560,353,759,431,271
060590759023,464,274,190,469,268,201,662,396,240,461,285,144
060590759024,425,257,168,436,249,187,558,335,210,469,267,164
060590759025,298,174,124,299,170,129,404,246,151,334,177,134
060590219134,506,382,124,503,363,140,789,546,218,566,382,153
060590219141,1174,565,609,1183,571,612,1460,772,647,1026,509,456
060590762024,487,196,291,495,194,301,663,298,356,570,232,302
060590219132,702,377,325,698,361,337,938,541,380,867,433,379
060590219133,668,366,302,675,354,321,990,540,434,753,390,322
060590758132,316,141,175,320,140,180,359,212,140,262,133,114
060590762023,686,306,380,691,303,388,1069,503,542,847,352,448
060590219123,724,254,470,733,249,484,800,328,454,718,245,434
060590219173,513,167,346,525,170,355,643,239,393,571,167,371
060590219142,680,317,363,684,311,373,871,439,408,742,338,355
060590219183,534,202,332,545,196,349,697,278,406,548,221,297
060590219181,481,252,229,488,244,244,664,351,301,663,330,288
060590219171,810,277,533,819,265,554,1028,397,609,893,302,545
060590219172,598,241,357,607,241,366,753,342,397,580,240,304
060590756044,756,309,447,770,304,466,1118,517,579,724,308,371
060590756052,769,334,435,792,340,452,1014,496,495,830,346,432
060590756055,606,273,333,623,279,344,816,413,386,660,277,342
060590756054,285,129,156,294,131,163,392,198,184,512,213,266
060590758152,306,181,125,309,175,134,450,282,147,414,209,175
060590758071,445,240,205,448,235,213,605,338,251,464,221,207
060590758073,234,126,108,236,124,112,349,196,144,240,115,107
060590758081,757,368,389,768,367,401,960,488,443,1407,637,685
060590758082,974,422,552,996,412,584,1265,604,635,1081,451,556
060590759021,468,279,189,471,270,201,598,365,218,567,281,246
060590760011,375,237,138,377,227,150,551,351,182,423,263,128
060590761022,152,101,51,151,97,54,298,199,93,82,58,21
060590761024,163,108,55,163,104,59,303,202,94,244,159,67
060590758142,437,177,260,449,173,276,661,300,348,534,222,286
060590758092,662,193,469,675,186,489,813,283,515,686,214,433
060590758141,407,138,269,421,141,280,547,212,326,440,140,280
060590758093,562,180,382,579,183,396,714,283,413,581,179,368
060590762011,484,237,247,489,233,256,967,529,417,559,286,238
060590762012,337,165,172,341,162,179,466,258,203,432,182,220
060590762015,755,371,384,765,364,401,948,519,408,880,481,348
060590219131,453,172,281,462,167,295,567,254,296,480,193,261
060590758161,579,340,239,583,328,255,865,556,287,638,315,281
060590758162,493,290,203,499,281,218,753,396,341,594,302,252
060590758102,866,271,595,876,273,603,1077,425,636,901,295,566
060590758111,852,340,512,867,336,531,1102,505,569,901,355,494
060590758122,554,224,330,565,221,344,723,328,381,622,234,348
060590758112,144,75,69,144,72,72,175,117,46,134,94,32
060590762053,531,279,252,536,267,269,799,418,359,681,313,316
060590762064,505,266,239,510,254,256,736,385,330,637,292,297
060590758123,566,226,340,576,223,353,769,339,415,634,257,338
060590758124,463,185,278,468,182,286,643,301,330,530,209,286
060590320571,167,76,91,170,75,95,1386,673,680,1402,625,691
060590320573,1832,826,1006,1875,799,1076,94,46,47,72,31,36
060590320662,3788,1720,2068,3840,1712,2128,7558,3637,3800,2556,1076,1323
060590320572,1482,647,835,1500,637,863,2049,970,1046,1620,673,867
060590320592,763,322,441,781,310,471,1110,525,560,821,357,429
060590320582,434,216,218,445,219,226,650,321,315,485,220,235
060590320594,98,45,53,101,47,54,158,75,78,117,48,59
060590320591,150,67,83,153,65,88,213,105,105,150,61,83
060590320595,360,165,195,367,157,210,488,238,240,1166,522,582
060590320593,441,206,235,460,215,245,717,353,345,118,52,61
060590320581,1286,445,841,1317,447,870,540,219,314,414,152,241
060590320612,2,1,1,2,1,1,2,1,1,0,0,0
060590752011,585,469,116,584,444,140,940,689,230,734,588,103
060590890041,380,222,158,394,226,168,633,297,328,414,287,108
060590890043,417,245,172,428,246,182,668,314,346,454,317,120
060590744053,110,97,13,111,95,16,177,138,31,141,117,14
060590750041,247,186,61,251,183,68,394,288,96,267,199,52
060590750042,234,207,27,235,198,37,365,285,65,283,238,26
060590753011,405,292,113,406,283,123,613,426,180,430,304,94
060590753012,545,329,216,555,324,231,748,470,262,699,425,236
060590753013,621,389,232,621,377,244,868,564,290,681,426,216
060590753021,523,350,173,524,336,188,772,507,255,545,365,149
060590891022,343,230,113,346,223,123,598,378,211,417,287,110
060590891043,169,112,57,170,109,61,280,142,137,188,130,49
060590992471,364,227,137,366,227,139,547,275,264,391,273,103
060590992472,403,251,152,407,252,155,643,324,310,423,295,111
060590890012,468,297,171,470,295,175,833,411,411,528,369,139
060590890013,281,179,102,283,176,107,545,268,266,366,255,96
060590752012,437,356,81,438,335,103,673,505,153,568,462,75
060590752021,489,406,83,490,385,105,762,577,172,615,506,76
060590741061,499,347,152,505,336,169,820,567,233,381,265,85
060590741062,566,345,221,575,347,228,848,550,281,893,558,276
060590741063,323,197,126,328,199,129,449,286,157,363,220,122
060590741102,432,264,168,439,265,174,651,424,217,498,300,167
060590750031,158,118,40,158,114,44,273,208,61,194,145,40
060590751003,500,356,144,501,342,159,724,499,208,635,450,149
060590753031,189,123,66,193,123,70,290,195,87,213,133,66
060590753032,690,451,239,697,444,253,1011,676,323,946,576,311
060590741071,148,97,51,149,98,51,225,143,79,190,121,56
060590741072,619,371,248,629,365,264,923,552,349,710,395,268
060590741073,657,391,266,666,385,281,960,576,360,785,431,301
060590751002,503,357,146,502,341,161,679,482,182,559,382,136
060590751004,394,290,104,391,276,115,551,392,146,473,346,96
060590752022,537,451,86,537,433,104,833,625,185,671,563,74
060590749012,261,221,40,260,212,48,407,307,89,345,296,35
060590751001,208,176,32,205,166,39,292,221,66,247,213,26
060590750021,285,228,57,283,221,62,480,348,121,381,317,47
060590750033,137,109,28,136,105,31,247,175,66,171,141,22
060590748031,758,557,201,762,540,222,1258,852,383,937,702,186
060590749011,312,277,35,305,265,40,502,399,83,391,339,35
060590749013,182,162,20,181,156,25,314,253,53,233,205,21
060590749015,179,159,20,175,152,23,279,223,46,226,198,20
060590746011,178,150,28,178,146,32,314,249,62,236,201,26
060590746012,209,177,32,207,173,34,287,222,55,293,249,29
060590746013,154,130,24,154,129,25,248,193,47,218,183,22
060590749014,165,140,25,164,138,26,279,220,56,227,191,28
060590749022,185,159,26,181,154,27,306,244,58,264,226,26
060590750024,214,181,33,216,175,41,381,302,69,328,271,40
060590750032,169,144,25,173,139,34,310,250,55,250,209,29
060590746021,130,112,18,129,108,21,195,151,37,140,116,13
060590746022,182,157,25,184,153,31,274,212,54,181,151,17
060590746023,326,281,45,326,275,51,486,376,97,420,356,44
060590746024,399,345,54,401,333,68,643,505,126,502,423,52
060590748013,308,264,44,305,253,52,560,451,101,419,366,32
060590748022,301,264,37,297,248,49,513,405,91,383,331,27
060590748051,233,198,35,232,189,43,431,343,77,312,273,21
060590748052,176,151,25,177,145,32,327,260,59,244,220,15
060590748061,199,169,30,200,162,38,365,294,67,262,228,18
060590747013,523,456,67,525,431,94,869,699,159,686,602,55
060590747023,224,194,30,221,183,38,434,334,95,294,258,23
060590748062,409,357,52,408,337,71,658,525,119,536,473,43
060590748011,242,206,36,240,200,40,349,287,54,313,271,30
060590748012,289,250,39,289,242,47,519,419,92,358,308,31
060590747021,405,344,61,402,329,73,605,468,121,464,394,53
060590747022,364,310,54,360,295,65,553,434,109,501,418,57
060590747011,337,285,52,342,284,58,530,405,116,472,386,61
060590747012,367,309,58,370,306,64,589,453,129,507,418,65
060590746014,444,337,107,454,334,120,700,487,197,556,421,98
060590746015,350,267,83,351,259,92,552,388,155,441,332,80
060590740032,423,360,63,427,356,71,571,452,105,474,373,79
060590741031,486,403,83,483,390,93,752,577,152,651,536,77
060590742003,638,549,89,636,527,109,1012,789,196,812,668,95
060590742004,463,397,66,460,380,80,677,533,133,581,481,69
060590741032,312,258,54,311,250,61,497,385,100,367,307,43
060590741033,328,271,57,325,262,63,485,380,100,431,354,50
060590741023,389,315,74,388,303,85,690,532,142,573,468,81
060590741021,483,379,104,485,368,117,466,358,101,409,337,53
060590741022,438,344,94,440,334,106,861,618,227,790,648,102
060590741081,537,424,113,534,406,128,1112,801,289,754,602,116
060590741091,413,316,97,410,313,97,481,350,125,384,319,49
060590741092,212,162,50,211,162,49,341,249,87,260,215,34
060590740044,782,507,275,785,490,295,1129,744,365,911,634,230
060590744062,269,197,72,270,192,78,423,316,97,289,211,60
060590744063,136,103,33,137,100,37,216,165,47,167,127,35
060590744064,79,59,20,80,58,22,118,90,27,103,76,22
060590754032,273,199,74,272,195,77,396,290,94,331,242,68
060590754034,526,386,140,527,377,150,765,572,173,592,431,122
060590754031,639,424,215,645,411,234,925,612,291,542,323,181
060590754033,591,387,204,592,374,218,891,591,277,685,412,227
060590755041,1306,658,648,1334,651,683,1662,914,712,1399,682,644
060590746025,253,219,34,251,210,41,407,315,81,303,252,33
060590745011,164,142,22,162,135,27,309,241,62,241,205,23
060590745012,261,223,38,263,215,48,426,339,84,344,294,34
060590743002,411,355,56,412,348,64,584,456,107,472,367,78
060590744031,289,251,38,286,241,45,582,436,131,424,365,38
060590748032,631,483,148,634,460,174,1039,646,370,771,598,138
060590748033,328,250,78,329,239,90,494,375,108,411,318,75
060590891052,286,231,55,284,220,64,517,383,122,340,282,45
060590891053,223,168,55,224,160,64,431,288,135,288,225,49
060590741082,252,201,51,250,191,59,441,318,113,378,300,60
060590890014,469,308,161,476,299,177,734,398,327,524,366,131
060590890042,538,353,185,548,346,202,998,536,444,641,449,161
060590891041,168,118,50,168,108,60,347,223,115,229,158,61
060590891051,167,117,50,168,109,59,316,205,105,403,283,99
060590992481,457,326,131,466,323,143,494,305,178,311,233,64
060590992482,434,309,125,444,307,137,1026,636,369,458,342,94
060590992491,323,230,93,330,229,101,527,328,191,351,260,72
060590992492,197,141,56,201,139,62,336,209,121,205,153,43
060590992022,793,537,256,796,520,276,1219,689,506,844,588,224
060590741101,866,573,293,865,557,308,1271,771,480,995,673,276
060590753022,762,512,250,766,490,276,1051,689,336,875,581,247
060590753033,529,356,173,531,339,192,669,446,215,630,418,178
060590744051,192,161,31,193,158,35,328,260,60,260,190,53
060590744052,402,336,66,404,329,75,619,491,114,529,387,111
060590744061,107,90,17,108,88,20,161,130,28,143,104,30
060590750022,311,261,50,314,256,58,497,393,94,422,310,89
060590750023,218,183,35,222,179,43,316,253,60,302,221,63
060590748021,218,192,26,214,180,34,360,289,65,292,253,22
060590748023,270,238,32,267,224,43,433,342,75,343,298,25
060590749021,237,214,23,235,206,29,385,313,64,322,278,27
060590749023,210,189,21,206,181,25,361,278,69,287,247,25
060590744071,256,219,37,251,208,43,448,360,78,336,295,26
060590744032,192,167,25,189,159,30,454,350,95,274,235,25
060590745013,118,103,15,118,99,19,236,183,49,169,145,16
060590757012,363,242,121,367,236,131,580,381,186,429,277,125
060590754011,991,561,430,999,547,452,1186,713,451,968,572,330
060590754012,767,438,329,770,426,344,1023,636,356,810,538,219
060590754043,485,295,190,490,284,206,707,440,249,491,360,102
060590754044,335,206,129,339,199,140,525,328,185,404,246,130
060590754041,482,287,195,488,277,211,716,434,266,579,341,204
060590754042,521,287,234,526,276,250,686,389,287,559,307,220
060590754051,599,350,249,606,350,256,882,538,330,720,431,242
060590754052,385,225,160,391,226,165,565,343,209,191,114,64
060590745021,704,574,130,701,555,146,955,733,198,891,739,109
060590742001,272,242,30,271,231,40,475,386,85,334,301,29
060590742002,215,189,26,212,180,32,345,283,62,269,238,25
060590743001,303,268,35,302,257,45,536,427,92,405,347,36
060590745022,313,277,36,310,264,46,534,423,92,409,350,36
060590740041,570,396,174,575,388,187,919,612,286,706,477,180
060590740042,127,88,39,129,87,42,241,161,75,190,129,48
060590740043,543,378,165,551,371,180,790,529,246,705,478,180
060590740062,433,323,110,436,321,115,629,459,150,530,374,123
060590740063,530,396,134,533,393,140,798,581,190,677,479,155
060590741111,367,232,135,373,228,145,567,343,216,399,241,133
060590740031,283,192,91,282,188,94,588,371,204,366,286,61
060590740053,232,163,69,235,160,75,395,277,109,397,271,98
060590740054,504,351,153,507,345,162,737,517,202,601,405,153
060590740061,261,182,79,262,178,84,398,280,110,182,122,47
060590741113,850,616,234,851,600,251,1349,864,457,1030,760,210
060590740051,322,237,85,322,231,91,534,373,148,390,299,68
060590740052,350,257,93,349,250,99,557,396,156,407,317,75
060590741112,300,221,79,298,213,85,510,340,162,383,280,81
060590320451,658,236,422,671,236,435,871,367,485,702,238,415
060590320654,559,257,302,576,247,329,821,418,385,642,282,312
060590320653,905,412,493,924,412,512,1330,662,638,989,424,501
060590320111,536,261,275,550,263,287,701,353,324,569,248,274
060591106062,357,232,125,357,226,131,955,632,303,426,292,111
060591105002,639,444,195,644,430,214,910,571,318,794,545,201
060591105004,207,139,68,212,136,76,360,236,120,270,188,72
060591106073,246,171,75,259,165,94,448,295,146,281,182,77
060591105001,473,348,125,475,336,139,462,327,126,603,422,146
060591105003,299,218,81,300,209,91,465,307,150,364,258,87
060591106032,241,177,64,243,170,73,420,281,131,293,213,62
060591106033,323,204,119,322,210,112,565,339,214,395,260,112
060591106035,334,254,80,336,247,89,555,383,158,405,294,88
060591103021,402,226,176,403,211,192,662,366,286,513,293,193
060591104013,265,138,127,266,136,130,438,233,197,322,180,124
060591104014,281,143,138,286,138,148,472,242,221,321,175,127
060591106031,513,333,180,528,331,197,837,525,298,577,382,154
060591106072,340,221,119,350,219,131,745,457,279,379,253,100
060591103023,722,446,276,732,429,303,1059,628,407,845,491,294
060591106061,391,261,130,397,253,144,679,415,246,442,293,125
060591106071,276,156,120,278,155,123,413,238,164,341,203,118
060591106034,242,175,67,241,167,74,406,269,135,297,223,59
060590755121,334,234,100,337,232,105,549,357,178,446,300,118
060590755122,430,301,129,432,298,134,647,423,209,547,325,184
060590755173,458,321,137,460,317,143,713,464,230,537,384,118
060590755141,507,360,147,510,351,159,727,471,246,574,398,130
060591104012,465,235,230,467,234,233,705,368,325,532,279,219
060590755042,700,355,345,715,351,364,1091,604,458,684,298,328
060590755071,627,372,255,636,373,263,907,579,307,681,386,245
060590755072,202,148,54,207,151,56,313,234,70,200,134,50
060590525023,827,479,348,840,473,367,1117,643,447,927,543,313
060590755131,839,584,255,850,574,276,1230,800,407,563,387,144
060590755132,372,259,113,378,255,123,533,348,177,762,470,230
060590868012,410,238,172,414,230,184,566,321,236,492,286,185
060590755051,534,305,229,537,297,240,747,446,278,595,318,230
060590755053,321,182,139,324,179,145,455,274,170,400,210,156
060590755052,326,185,141,329,182,147,458,276,172,359,205,133
060590757022,792,387,405,807,380,427,1035,544,466,884,372,437
060590525021,650,316,334,662,313,349,878,471,388,683,339,313
060590525022,724,352,372,736,347,389,914,491,403,755,367,346
060590524192,726,362,364,737,357,380,976,542,413,736,358,330
060590756051,532,212,320,544,211,333,608,280,308,528,204,293
060590525245,732,437,295,742,420,322,1058,658,366,746,427,275
060590868032,441,237,204,443,228,215,642,350,275,510,288,201
060591104021,469,261,208,469,249,220,686,377,291,519,286,202
060590756071,357,184,173,366,179,187,466,279,175,411,215,169
060590756072,814,421,393,830,408,422,1204,721,454,898,465,375
060590756073,424,221,203,432,209,223,613,340,263,460,234,202
060590756074,382,218,164,387,216,171,553,330,211,469,257,188
060590756065,408,173,235,417,172,245,850,423,408,609,260,315
060590756064,569,299,270,576,294,282,834,464,354,614,333,244
060590756061,1023,366,657,1037,347,690,1226,529,671,1121,413,629
060590756062,334,160,174,340,153,187,497,259,228,366,171,175
060590524191,808,401,407,819,395,424,899,497,383,712,380,282
060590756075,446,259,187,453,257,196,684,410,262,537,299,210
060590525241,532,293,239,542,293,249,864,518,332,571,280,258
060590525242,573,339,234,581,329,252,777,484,279,645,397,213
060590525243,274,162,112,276,157,119,419,262,151,284,164,103
060590525244,483,286,197,492,278,214,775,480,279,576,353,188
060590744072,490,342,148,492,336,156,742,516,208,528,353,140
060590744081,277,193,84,276,190,86,467,328,130,326,234,76
060590744082,246,184,62,246,182,64,372,262,99,302,229,58
060590744083,149,113,36,149,112,37,238,170,63,285,217,53
060590755061,806,368,438,820,356,464,1051,533,492,884,392,423
060590755171,482,333,149,488,322,166,696,478,205,556,399,123
060590755142,171,135,36,171,135,36,293,215,72,238,167,52
060590755172,167,133,34,167,133,34,344,251,84,235,168,52
060590757011,779,319,460,789,316,473,982,453,510,323,136,173
060590757014,946,429,517,960,417,543,1192,603,555,1003,433,502
060590755184,709,423,286,722,432,290,889,566,298,934,594,283
060590755182,230,137,93,235,141,94,357,227,119,288,181,88
060590525024,524,300,224,537,299,238,731,417,294,605,286,284
060591103042,849,432,417,862,411,451,1311,672,611,1052,543,446
060590755185,815,504,311,829,494,335,2074,1271,764,915,553,320
060591103013,443,218,225,449,216,233,647,320,316,499,244,223
060591103014,535,295,240,540,282,258,754,409,328,625,325,262
060591102025,212,117,95,214,112,102,315,174,136,241,134,94
060591102032,736,373,363,748,368,380,1184,605,562,883,435,377
060591103022,623,369,254,629,351,278,967,539,403,749,448,260
060591103031,703,417,286,707,394,313,1120,625,467,862,444,362
060591102012,810,448,362,820,430,390,1270,697,550,916,471,384
060591102013,639,355,284,645,338,307,1022,560,442,842,490,308
060590755062,325,185,140,331,181,150,481,295,175,400,214,161
060590755063,329,188,141,337,186,151,448,272,163,380,197,159
060590755073,625,356,269,640,352,288,902,554,327,652,365,241
060590756033,548,284,264,564,282,282,699,371,314,589,249,293
060591103032,889,450,439,898,438,460,1298,680,594,1030,508,472
060591106042,886,463,423,913,457,456,1277,686,565,588,297,266
060591106044,505,265,240,520,264,256,733,376,351,568,306,241
060590756031,831,346,485,847,334,513,1031,479,526,628,256,318
060590756063,864,312,552,876,301,575,1085,479,582,969,360,547
060590756042,1051,403,648,1071,401,670,1265,547,678,1187,519,599
060590756041,746,282,464,752,278,474,1016,476,522,968,380,526
060590756043,528,199,329,532,197,335,461,214,239,427,163,238
060590757031,1160,468,692,1181,464,717,1458,662,756,1171,462,629
060590757023,387,188,199,395,186,209,499,260,225,606,255,302
060590757021,564,219,345,573,211,362,701,303,376,587,246,288
060590756032,701,281,420,710,274,436,856,395,439,750,296,404
060590757032,441,179,262,449,178,271,537,247,276,453,192,229
060590757033,574,233,341,586,233,353,708,326,367,601,234,330
060590756053,739,287,452,757,285,472,899,416,462,708,255,400
060590758091,583,175,408,592,169,423,698,247,436,583,176,375
060170307091,782,314,468,793,314,479,1191,553,614,759,289,416
060170307093,515,161,354,524,152,372,685,249,422,671,237,393
060170307092,1196,490,706,1219,487,732,1563,711,802,1325,526,706
060170307011,1298,560,738,1318,552,766,1692,815,847,1372,583,693
060170307013,548,238,310,560,235,325,723,344,367,622,257,327
060170307012,1391,579,812,1419,565,854,1768,823,905,1496,603,795
060170307111,645,236,409,660,225,435,876,363,490,1142,477,595
060170307112,1302,601,701,1319,592,727,2246,1127,1093,613,302,284
060170307064,794,352,442,798,343,455,1093,531,532,855,349,443
060170317001,1493,620,873,1516,602,914,2109,989,1070,1478,614,763
060170307063,867,386,481,880,382,498,1099,535,537,979,406,508
060170307062,580,259,321,585,254,331,736,356,362,559,240,281
060170307102,824,292,532,839,287,552,1851,804,1014,501,184,293
060170307103,843,307,536,854,300,554,671,291,372,884,325,511
060170307061,978,434,544,991,433,558,1426,676,707,980,418,493
060170318001,376,166,210,386,167,219,515,266,239,395,190,181
060170318002,1004,450,554,1028,451,577,1386,694,664,1258,558,633
060170318004,478,211,267,487,211,276,698,337,347,408,179,206
060170308084,1039,365,674,1063,347,716,1320,554,733,1110,364,670
060170318003,998,463,535,1023,462,561,1470,694,746,1147,524,548
060170307101,1291,512,779,1310,512,798,1674,734,907,1393,559,737
060170308072,977,377,600,1001,371,630,1280,529,723,1077,411,573
060170308082,822,299,523,834,281,553,1040,407,614,855,297,498
060170308101,254,115,139,259,110,149,401,176,212,273,98,152
060170308103,577,237,340,587,228,359,818,343,446,712,254,391
060170308102,544,182,362,549,178,371,719,287,416,569,205,337
060170308081,497,197,300,503,185,318,711,290,400,480,175,260
060170308083,943,379,564,955,360,595,1275,542,713,1093,418,589
060170314071,623,242,381,630,230,400,946,343,583,771,261,452
060170314082,801,313,488,816,304,512,933,367,543,781,277,444
060170314092,511,147,364,515,137,378,582,180,388,609,179,388
060170314093,415,163,252,430,160,270,451,182,258,419,158,243
060170307113,919,424,495,939,430,509,1005,471,508,999,412,507
060170307122,390,181,209,397,182,215,1206,601,590,198,86,105
060170307121,650,173,477,664,173,491,700,203,478,779,209,516
060170307123,1065,468,597,1082,467,615,1208,529,661,504,190,285
060170315032,1035,336,699,1052,325,727,1279,416,837,1170,365,722
060170308071,861,362,499,878,349,529,1185,507,648,952,388,492
060170308121,1170,454,716,1201,458,743,1526,655,835,1282,489,703
060170308091,426,158,268,424,152,272,568,218,336,454,153,262
060170308092,743,291,452,749,279,470,969,392,548,760,278,422
060170314081,317,120,197,326,119,207,352,136,207,306,96,189
060170314091,235,65,170,235,62,173,337,102,222,205,58,134
060170315043,719,260,459,727,250,477,879,299,555,751,230,467
060170308041,854,245,609,870,241,629,1044,332,687,872,246,577
060170308044,681,226,455,698,216,482,784,256,504,632,201,393
060170314061,385,132,253,389,127,262,482,176,296,509,160,311
060170314062,577,226,351,589,222,367,795,307,462,444,159,251
060170314065,548,196,352,559,191,368,687,260,415,783,265,462
060170314063,442,155,287,444,147,297,666,248,400,475,150,288
060170314064,586,221,365,595,213,382,775,298,456,634,215,364
060170314041,852,287,565,862,275,587,1019,316,687,816,258,503
060170314042,453,144,309,454,137,317,551,197,342,492,140,315
060170308042,659,224,435,678,219,459,816,285,512,688,219,417
060170308043,1300,441,859,1331,437,894,1740,625,1074,1457,489,864
060170310001,294,148,146,297,146,151,386,202,176,305,143,135
060170310003,976,475,501,997,459,538,1189,575,585,996,434,472
060170310004,729,319,410,743,304,439,964,445,491,797,333,412
060170312001,996,421,575,1011,414,597,1188,539,628,1039,395,578
060170311001,637,327,310,648,310,338,857,435,398,720,331,327
060170311004,438,217,221,445,208,237,557,263,278,507,225,243
060170311002,463,232,231,473,232,241,606,312,274,511,234,229
060170311003,956,386,570,969,368,601,1212,485,699,980,385,532
060170312004,327,164,163,333,164,169,407,213,181,326,143,156
060170312003,265,133,132,269,130,139,376,192,174,269,116,129
060170312002,766,369,397,776,368,408,992,472,495,829,352,416
060170314052,409,144,265,412,137,275,507,184,311,404,130,247
060170315061,760,264,496,768,248,520,876,301,559,797,258,482
060170315051,717,261,456,731,250,481,1028,353,652,789,265,469
060170315052,392,134,258,398,134,264,281,97,178,228,70,140
060170315053,448,149,299,458,150,308,480,153,316,507,169,302
060170315062,516,190,326,527,177,350,650,242,398,461,166,266
060170315042,313,110,203,318,106,212,409,142,259,409,132,256
060170315044,789,280,509,805,269,536,1116,415,682,825,274,488
060170315031,503,163,340,508,156,352,618,202,408,429,131,267
060170315041,725,264,461,739,258,481,1224,474,721,1045,327,632
060170310002,746,305,441,763,301,462,913,386,509,830,308,471
060170313013,671,262,409,686,254,432,804,316,472,698,261,392
060170309022,724,249,475,738,245,493,930,341,569,802,265,489
060170313011,595,244,351,610,228,382,686,267,402,604,219,342
060170313012,479,189,290,491,183,308,688,277,398,627,220,366
060170313022,663,255,408,679,253,426,849,322,504,690,255,390
060170314051,855,332,523,865,308,557,1168,453,685,1024,343,595
060170313024,471,191,280,474,182,292,623,247,356,512,180,292
060170313023,324,130,194,325,125,200,452,173,267,337,122,192
060170306033,705,241,464,722,236,486,839,305,517,702,205,443
060170308123,658,220,438,667,208,459,850,297,528,716,240,437
060170308111,762,278,484,783,272,511,1060,441,589,764,254,449
060170308122,1176,337,839,1190,324,866,1416,469,910,1174,355,753
060170308011,1426,477,949,1453,461,992,1834,623,1157,1562,490,956
060170308012,777,249,528,788,242,546,1024,367,633,787,244,487
060170309021,1096,337,759,1120,330,790,1401,489,882,1196,398,726
060170306014,825,328,497,836,320,516,997,408,568,843,321,467
060170306013,693,277,416,701,270,431,830,331,487,642,249,349
060170306011,616,209,407,630,203,427,795,268,508,756,231,474
060170306012,622,232,390,638,232,406,800,290,492,644,209,393
060170306063,732,292,440,745,281,464,931,373,539,654,236,376
060170306041,441,130,311,441,123,318,452,140,305,371,98,238
060170306062,711,236,475,726,217,509,909,301,589,752,231,464
060170306051,478,167,311,488,158,330,510,172,328,463,145,281
060170306031,321,100,221,328,93,235,534,163,356,464,135,290
060170306032,480,196,284,491,198,293,198,93,103,477,175,266
060170306061,609,240,369,619,235,384,1544,601,902,749,275,418
060170306052,435,164,271,442,160,282,317,129,182,442,157,253
060170309011,964,378,586,985,368,617,1217,513,683,1120,414,634
060170309012,646,248,398,659,243,416,834,332,487,668,236,387
060170309023,828,294,534,845,287,558,952,367,566,863,291,505
060170304022,266,176,90,269,176,93,379,255,114,342,193,122
060170305041,589,369,220,600,369,231,756,483,242,636,362,223
060170305042,366,229,137,371,229,142,459,292,153,494,284,169
060170303013,217,151,66,227,155,72,306,212,92,247,148,75
060170305043,401,255,146,410,258,152,544,360,172,422,237,150
060170305071,258,164,94,261,167,94,392,260,126,421,244,133
060170302022,161,103,58,164,106,58,239,168,63,139,87,45
060170302021,251,161,90,256,166,90,343,231,101,304,183,98
060170302011,232,159,73,241,164,77,358,236,118,115,79,29
060170302012,242,163,79,244,162,82,379,251,117,433,272,128
060170302023,182,119,63,187,123,64,211,135,70,162,101,51
060170303012,309,210,99,313,214,99,522,352,152,367,223,111
060170316021,219,152,67,222,152,70,341,233,104,220,134,63
060170316022,144,96,48,148,99,49,238,167,62,144,91,45
060170305061,486,308,178,491,312,179,736,482,240,357,209,115
060170305072,289,182,107,296,188,108,373,251,116,306,164,106
060170305073,198,126,72,203,128,75,285,191,86,212,124,67
060170304042,398,230,168,410,234,176,408,252,148,236,120,98
060170304041,259,152,107,268,156,112,388,252,126,364,210,122
060170304021,314,207,107,319,207,112,461,307,145,329,188,109
060170304023,194,127,67,199,129,70,310,207,95,207,130,62
060170304024,356,233,123,368,238,130,489,321,155,371,222,117
060170304025,204,134,70,208,135,73,428,287,128,223,133,72
060170305024,268,179,89,272,180,92,334,236,89,266,166,81
060170303011,289,203,86,301,208,93,342,234,105,259,162,81
060170303021,285,198,87,289,199,90,386,260,113,297,184,87
060170304032,205,117,88,211,119,92,276,160,107,204,98,90
060170304033,237,136,101,244,137,107,303,176,118,192,94,84
060170304031,323,183,140,332,185,147,401,252,141,378,212,135
060170304043,207,123,84,211,123,88,279,186,81,212,127,65
060170320022,59,39,20,59,39,20,93,62,29,54,36,15
060170303022,301,207,94,308,213,95,402,276,113,310,192,95
060170303023,258,178,80,271,189,82,347,241,96,291,181,84
060170303024,201,141,60,204,143,61,282,198,79,191,120,57
060170302013,122,86,36,123,86,37,180,128,48,135,87,34
060170316013,127,91,36,129,89,40,188,126,58,42,26,11
060170316012,82,56,26,80,56,24,207,151,51,124,81,32
060170316011,196,138,58,199,137,62,248,181,61,158,106,38
060170305021,442,295,147,454,300,154,458,323,125,399,243,123
060170305022,286,192,94,291,193,98,382,276,103,288,180,88
060170305023,432,284,148,440,292,148,570,389,163,536,325,171
060170320021,85,59,26,85,60,25,98,70,28,87,54,25
060170313021,426,176,250,426,166,260,567,231,318,483,173,271
060170306034,81,37,44,83,39,44,113,56,56,110,48,51
060170319001,46,20,26,49,22,27,61,30,31,14,7,7
060170320011,345,234,111,351,237,114,475,323,138,357,215,107
060910100004,377,135,242,383,128,255,442,161,266,399,125,233
060910100003,381,170,211,378,146,232,436,192,221,445,147,246
060910100005,263,85,178,267,80,187,365,134,224,260,80,163
060910100001,355,134,221,366,138,228,459,165,284,338,134,184
060910100002,267,109,158,273,107,166,228,78,147,362,115,222
060530007014,70,62,8,71,61,10,137,117,18,111,103,6
060530007022,69,60,9,68,59,9,126,107,17,91,84,6
060530106072,271,235,36,270,226,44,446,369,70,363,320,30
060530106071,120,107,13,121,104,17,233,197,30,174,157,11
060530106081,64,57,7,64,55,9,131,110,18,98,89,6
060530106082,166,138,28,167,135,32,299,236,63,218,180,32
060530007013,119,100,19,119,96,23,196,153,39,139,119,15
060530007012,136,122,14,137,117,20,225,192,31,159,141,13
060530106041,545,448,97,548,440,108,894,666,211,706,587,87
060530106043,277,232,45,277,225,52,446,350,87,338,289,35
060530007011,171,157,14,171,153,18,288,244,39,213,192,11
060530106052,356,300,56,359,295,64,580,472,98,442,375,50
060530106051,384,331,53,385,321,64,641,526,102,492,419,51
060530009001,224,198,26,225,188,37,362,297,56,310,266,25
060530009002,88,78,10,87,74,13,156,129,26,118,103,9
060530006002,131,111,20,127,105,22,214,178,33,165,144,19
060530006003,207,183,24,209,178,31,361,300,57,252,221,23
060530008002,251,207,44,256,202,54,405,325,70,331,275,42
060530006004,150,138,12,151,137,14,279,234,42,179,165,11
060530007021,116,108,8,118,106,12,213,177,32,147,134,7
060530007023,202,187,15,203,183,20,369,303,54,267,243,13
060530012001,771,457,314,768,443,325,975,622,334,834,498,276
060530012002,472,289,183,473,285,188,618,409,200,500,312,154
060530013002,248,174,74,249,169,80,322,229,83,300,212,68
060530013001,176,133,43,178,130,48,277,201,70,222,166,43
060530145001,300,186,114,303,183,120,328,205,116,324,202,101
060530018022,204,164,40,204,160,44,384,284,89,274,209,49
060530018021,356,285,71,357,279,78,503,369,117,476,360,84
060530002001,326,236,90,328,228,100,503,339,148,414,300,94
060530002002,376,272,104,380,264,116,583,400,173,487,348,111
060530002003,359,258,101,357,256,101,565,409,148,450,330,95
060530002004,320,231,89,321,224,97,484,389,87,406,293,91
060530004001,172,139,33,171,136,35,277,212,60,225,177,36
060530004004,255,207,48,259,205,54,411,316,89,333,260,55
060530004003,95,72,23,94,70,24,150,112,34,101,77,19
060530005022,355,298,57,357,285,72,592,475,102,437,359,54
060530005021,375,322,53,376,305,71,621,507,101,482,397,57
060530006001,244,211,33,245,201,44,416,344,67,298,247,35
060530005013,146,117,29,146,111,35,242,194,48,190,160,27
060530005012,74,59,15,77,58,19,119,94,24,85,70,12
060530005011,177,141,36,178,136,42,284,217,57,225,185,30
060530001032,319,224,95,324,218,106,524,377,143,429,311,104
060530001033,223,140,83,223,135,88,326,222,99,274,183,79
060530001031,407,287,120,406,275,131,701,464,219,540,385,130
060530004002,430,316,114,433,303,130,663,486,161,465,330,98
060530004005,196,143,53,196,139,57,315,230,76,258,186,55
060530018023,394,313,81,396,314,82,698,534,145,488,379,83
060530001062,449,329,120,455,322,133,727,521,196,553,408,116
060530001061,432,324,108,434,312,122,659,481,161,524,387,98
060530001063,453,334,119,453,320,133,769,553,207,602,444,125
060530001052,379,283,96,381,274,107,631,463,151,475,356,88
060530003001,545,382,163,551,371,180,833,587,222,679,448,185
060530003002,522,364,158,524,353,171,795,539,238,717,482,190
060530101012,97,85,12,97,86,11,170,145,24,138,117,12
060530101011,255,205,50,255,203,52,419,330,83,334,264,48
060530101021,501,343,158,506,334,172,737,488,230,587,405,148
060530146011,487,341,146,491,329,162,730,574,146,551,385,131
060530146012,473,334,139,477,327,150,644,467,162,563,396,131
060530146013,300,212,88,302,207,95,418,318,90,330,234,76
060530101013,157,107,50,158,104,54,317,224,82,204,142,47
060530102021,361,249,112,360,241,119,541,376,151,295,207,72
060530101022,731,425,306,738,414,324,1005,618,359,832,476,294
060530102022,458,280,178,461,278,183,693,432,244,858,511,287
060530102023,585,336,249,595,333,262,778,474,285,695,394,250
060530147001,329,216,113,330,211,119,432,298,124,342,216,101
060530147002,808,500,308,812,496,316,1056,688,340,892,543,299
060530147003,440,270,170,444,263,181,615,392,215,507,298,177
060530147004,588,377,211,592,371,221,867,591,256,689,433,211
060530103051,652,388,264,659,387,272,921,559,339,574,328,207
060530103052,820,462,358,831,462,369,1114,669,416,991,559,359
060530104001,273,230,43,270,221,49,512,409,85,377,321,40
060530104002,268,230,38,269,221,48,476,388,82,668,580,68
060530104003,203,172,31,209,170,39,393,311,78,0,0,0
060530104004,196,167,29,199,164,35,352,288,61,275,239,28
060530103061,393,210,183,401,206,195,583,335,238,506,264,208
060530105011,445,258,187,450,243,207,699,404,285,518,272,204
060530105013,1751,861,890,1754,849,905,2348,1231,1071,1972,962,881
060530105012,395,188,207,398,186,212,563,303,243,459,228,201
060530103053,297,163,134,300,163,137,398,240,151,359,203,131
060530001013,314,190,124,316,184,132,445,283,157,342,219,105
060530001012,288,174,114,296,173,123,475,299,167,315,199,97
060530106061,703,398,305,710,405,305,1052,620,412,895,527,329
060530018011,321,239,82,322,236,86,516,389,115,392,293,76
060530105043,232,166,66,235,164,71,340,244,88,285,216,54
060530105044,16,13,3,16,13,3,292,225,61,18,16,2
060530106042,424,345,79,428,341,87,714,546,154,539,443,73
060530018012,783,533,250,789,536,253,1126,817,283,936,634,253
060530105052,269,199,70,271,192,79,454,348,96,323,236,66
060530105053,260,192,68,261,184,77,432,332,91,342,250,69
060530105063,104,77,27,104,73,31,147,112,31,136,100,28
060530105062,159,118,41,160,113,47,252,194,53,200,147,41
060530105051,447,327,120,450,316,134,687,476,196,578,412,124
060530105061,268,197,71,268,188,80,427,295,123,340,244,71
060530105042,378,288,90,380,277,103,379,290,80,508,379,93
060530105041,351,268,83,353,259,94,589,454,123,481,360,88
060530001051,625,446,179,628,427,201,975,700,259,759,573,158
060530001042,648,459,189,650,443,207,797,567,223,751,512,193
060530001041,576,409,167,581,397,184,888,625,244,697,479,174
060530106033,770,554,216,775,549,226,1177,866,287,918,663,207
060530106031,299,218,81,299,215,84,479,357,112,372,270,82
060530106032,806,600,206,805,585,220,1212,877,309,939,682,201
060530106034,402,276,126,400,276,124,658,460,186,484,325,130
060530008001,277,233,44,277,224,53,434,352,75,367,308,40
060530008003,190,160,30,189,154,35,308,249,51,248,208,26
060530009003,277,219,58,280,211,69,485,380,93,362,299,45
060539800001,0,0,0,0,0,0,1,1,0,0,0,0
060530106063,477,408,69,477,394,83,1079,853,212,492,418,54
060530106062,367,314,53,365,301,64,586,476,98,577,488,60
060530108042,157,64,93,157,62,95,192,92,98,211,104,94
060530148001,222,132,90,224,127,97,319,197,118,286,180,99
060530148002,222,145,77,225,143,82,341,225,112,279,186,85
060530108044,280,218,62,279,211,68,433,330,91,296,240,42
060530108041,200,154,46,202,151,51,321,242,78,245,199,42
060530148003,385,300,85,388,294,94,596,451,125,469,375,66
060530148004,442,339,103,443,331,112,695,512,168,548,427,94
060530108043,315,240,75,313,233,80,484,352,125,388,306,69
060530111031,185,159,26,185,154,31,310,240,58,229,194,21
060530111061,346,267,79,345,258,87,555,410,135,410,311,75
060530111032,514,431,83,522,417,105,1034,790,222,384,325,35
060530111052,532,417,115,532,393,139,891,650,209,713,554,108
060530111042,372,292,80,373,281,92,634,487,138,436,347,72
060530111051,627,504,123,633,489,144,992,747,227,737,591,108
060530111041,557,441,116,564,427,137,939,719,198,564,441,96
060530109001,30,17,13,32,16,16,42,26,16,34,18,14
060530112024,261,204,57,258,196,62,422,309,100,300,224,65
060530112021,492,380,112,497,372,125,664,511,137,537,404,99
060530112031,265,217,48,265,202,63,403,325,74,330,275,43
060530112032,307,251,56,310,238,72,501,398,90,376,308,48
060530112033,400,326,74,400,310,90,611,484,108,498,405,63
060530112042,379,307,72,381,289,92,575,453,105,475,384,65
060530112022,279,230,49,278,216,62,398,322,69,312,257,41
060530112023,144,118,26,142,111,31,205,165,35,202,166,27
060530112043,38,31,7,38,29,9,78,62,14,41,34,5
060530113033,347,147,200,349,137,212,453,204,234,411,180,198
060530113032,517,219,298,520,206,314,710,324,362,614,268,298
060530114001,704,161,543,711,165,546,969,266,689,773,199,536
060530114002,499,222,277,500,215,285,679,303,354,555,227,272
060530113021,198,136,62,200,131,69,347,231,111,612,425,152
060530113022,148,97,51,148,94,54,238,152,83,21,15,5
060530113052,0,0,0,0,0,0,0,0,0,0,0,0
060530113053,3,2,1,3,2,1,4,3,1,4,3,1
060530113051,151,101,50,153,100,53,184,110,70,183,105,66
060530113054,375,264,111,372,255,117,731,490,217,393,282,96
060530113023,328,186,142,331,181,150,460,288,158,439,302,111
060530113061,185,143,42,186,139,47,341,257,76,306,210,77
060530113062,138,103,35,138,98,40,231,160,64,108,74,26
060530113031,131,66,65,130,62,68,176,105,66,168,115,40
060530134001,824,547,277,838,551,287,1077,716,336,901,581,253
060530133001,647,465,182,655,452,203,951,673,248,708,488,163
060530141041,65,59,6,66,60,6,7,6,1,98,83,6
060530141081,1036,697,339,1048,688,360,1663,1134,461,966,601,272
060530141092,329,219,110,333,215,118,489,338,141,270,168,74
060530141091,226,150,76,228,148,80,324,224,92,256,158,71
060530135001,326,244,82,335,246,89,436,325,100,488,350,106
060530135002,535,359,176,543,359,184,741,505,212,494,322,139
060530135003,748,553,195,768,556,212,1096,810,260,839,616,172
060530137003,185,137,48,187,137,50,289,216,66,277,200,60
060530138002,724,584,140,730,580,150,1030,821,185,774,614,118
060530139001,545,408,137,553,407,146,781,587,178,606,447,119
060530139002,332,247,85,337,247,90,470,352,108,370,270,77
060530138001,492,369,123,497,364,133,687,512,153,579,441,105
060530136002,313,224,89,314,221,93,499,362,122,388,282,83
060530137001,245,188,57,248,188,60,401,307,83,306,240,49
060530137002,265,203,62,267,203,64,457,355,95,315,246,51
060530140001,403,277,126,411,283,128,644,446,186,534,368,128
060530138003,411,348,63,411,343,68,621,514,91,407,345,42
060530140002,253,187,66,256,184,72,403,281,104,289,212,59
060530136003,153,104,49,155,103,52,235,164,65,171,116,46
060530136001,508,347,161,512,341,171,729,507,207,576,390,155
060530141021,2,1,1,2,1,1,2,1,1,3,2,1
060530143012,574,381,193,585,381,204,1041,698,313,664,432,197
060530143022,536,354,182,548,354,194,747,486,239,603,392,177
060530143021,912,629,283,921,604,317,1309,933,347,1040,685,292
060530143011,707,498,209,712,493,219,1090,793,260,860,565,225
060530142013,593,423,170,600,413,187,980,715,244,714,503,150
060530142021,280,200,80,286,197,89,492,342,138,355,252,74
060530142011,499,340,159,507,337,170,689,494,180,548,358,155
060530142012,573,397,176,582,390,192,805,551,230,638,416,180
060530142022,931,639,292,942,627,315,1344,929,380,1020,665,286
060530141022,873,658,215,881,651,230,1313,919,349,789,575,148
060530141023,19,14,5,18,13,5,33,25,8,20,15,5
060530141053,835,734,101,840,714,126,1065,914,116,940,762,105
060530141051,148,130,18,149,127,22,124,107,14,174,141,20
060530014001,503,330,173,506,323,183,750,511,219,626,415,162
060530017001,537,360,177,540,358,182,735,502,213,629,419,165
060530017002,519,351,168,525,348,177,761,520,223,605,403,159
060530014002,414,272,142,420,269,151,604,374,216,496,329,128
060530016001,639,374,265,649,371,278,908,554,323,770,430,287
060530016002,446,261,185,453,258,195,626,388,225,515,288,194
060530015002,641,335,306,653,349,304,832,489,331,697,374,275
060530015003,859,477,382,869,484,385,1166,719,413,965,543,353
060530015001,755,454,301,770,456,314,1158,780,354,979,590,313
060530145002,728,412,316,734,396,338,1005,595,388,838,477,304
060530145003,646,349,297,650,341,309,845,509,325,716,399,282
060530125031,573,424,149,580,429,151,718,548,163,602,433,129
060530125032,372,274,98,377,279,98,463,352,108,397,286,83
060530121002,605,437,168,615,437,178,766,571,175,648,453,155
060530125033,244,179,65,245,181,64,345,253,79,272,194,58
060530126011,64,42,22,67,43,24,137,89,42,60,35,17
060530125042,423,323,100,427,315,112,644,491,132,485,347,109
060530125041,577,439,138,582,428,154,808,619,167,657,466,146
060530127001,291,223,68,297,222,75,391,302,79,349,257,71
060530127002,409,292,117,414,294,120,608,453,147,356,256,86
060530127003,453,347,106,456,342,114,583,459,122,464,341,97
060530127004,499,383,116,507,378,129,679,524,137,568,415,117
060530128002,795,544,251,802,545,257,917,664,233,865,585,231
060530130001,281,196,85,283,195,88,386,291,87,340,238,83
060530133002,436,310,126,437,303,134,659,453,181,544,370,137
060530133003,555,398,157,561,388,173,802,562,212,624,424,148
060530133004,313,223,90,315,220,95,443,314,125,380,257,94
060530132001,1325,643,682,1335,632,703,1661,946,683,1345,685,580
060530132002,1199,733,466,1215,732,483,1455,963,471,1332,826,432
060530128003,635,435,200,647,438,209,683,494,174,661,449,180
060530128005,403,277,126,407,278,129,472,345,117,467,318,121
060530128001,635,439,196,649,441,208,782,573,197,663,449,176
060530128004,375,264,111,379,265,114,466,345,108,403,279,99
060530130004,614,429,185,625,433,192,844,566,262,742,509,183
060530130003,0,0,0,0,0,0,3,2,1,1,1,0
060530130002,347,242,105,355,245,110,497,371,107,390,268,96
060530124023,603,426,177,616,431,185,713,538,161,617,439,142
060530124021,344,237,107,348,237,111,390,289,97,349,244,83
060530124022,705,494,211,718,497,221,857,635,199,747,517,178
060530121001,529,379,150,540,389,151,707,531,152,546,383,127
060530122002,483,352,131,495,360,135,560,438,121,462,342,107
060530123021,570,423,147,589,433,156,684,542,133,603,442,120
060530123022,421,310,111,431,315,116,538,413,114,432,310,93
060530124011,547,404,143,556,411,145,734,564,151,580,420,120
060530124012,334,245,89,337,247,90,412,321,87,347,253,73
060530122001,916,684,232,931,697,234,1105,869,220,983,729,195
060530120002,683,488,195,689,481,208,954,699,232,700,481,178
060530120001,912,677,235,937,678,259,1104,865,221,1002,732,218
060530119011,376,192,184,383,199,184,463,287,166,411,231,156
060530119022,502,257,245,509,264,245,594,364,214,531,297,200
060530119012,322,159,163,322,155,167,369,213,151,362,188,153
060530119021,594,304,290,609,319,290,682,428,246,667,386,248
060530119013,656,322,334,661,320,341,862,485,358,719,368,313
060530118012,1057,685,372,1093,724,369,1284,886,376,1120,724,327
060530117002,834,530,304,852,541,311,1077,748,305,1837,1173,562
060530118011,3,2,1,3,2,1,2,1,1,3,2,1
060530117003,1425,881,544,1460,903,557,1441,987,429,619,411,186
060530118021,125,75,50,130,79,51,380,261,114,133,84,42
060530116051,966,626,340,981,631,350,986,675,294,1079,708,321
060530117001,665,429,236,672,432,240,772,548,214,745,490,219
060530118022,0,0,0,0,0,0,0,0,0,0,0,0
060530116052,739,447,292,748,449,299,730,479,240,769,476,252
060530116041,1140,683,457,1157,691,466,1316,899,396,822,526,258
060530116062,594,346,248,602,347,255,1134,741,378,1057,618,363
060530110021,1266,890,376,1287,892,395,1470,1088,344,982,626,295
060530116061,568,338,230,570,332,238,655,423,224,534,319,185
060530110011,916,631,285,933,638,295,1190,859,304,803,546,204
060530110012,735,486,249,752,492,260,918,649,250,783,525,210
060530110013,404,288,116,409,289,120,516,385,120,704,487,169
060530115021,214,175,39,216,174,42,374,302,58,378,273,69
060530110022,473,322,151,479,320,159,589,377,200,804,537,188
060530111011,284,111,173,286,106,180,345,149,187,535,314,192
060530141101,1113,496,617,1123,500,623,1229,601,598,1172,536,554
060530107021,1193,539,654,1199,544,655,1539,810,695,1209,576,548
060530107022,1038,501,537,1056,513,543,1284,699,561,1209,619,514
060530141102,1491,722,769,1505,719,786,2015,1083,887,1687,876,702
060530141103,784,362,422,795,362,433,982,494,463,759,353,367
060530141104,386,178,208,392,178,214,459,231,216,367,173,176
060530001011,0,0,0,0,0,0,1,0,1,21,12,8
060530018013,13,8,5,14,8,6,20,13,7,21,14,6
060530112041,115,55,60,116,53,63,169,82,84,157,80,72
060530141052,648,429,219,659,428,231,1274,881,358,325,203,91
060530131002,50,32,18,50,31,19,165,104,52,47,23,16
060530131001,21,13,8,21,13,8,43,27,15,35,18,11
060530116042,420,269,151,422,272,150,488,339,141,430,291,122
060411081001,1768,1440,328,1810,1442,368,2093,1714,336,1868,1468,294
060411150002,1043,802,241,1079,822,257,1207,1007,180,1131,884,196
060411081004,704,597,107,713,592,121,788,656,118,773,645,98
060411081002,696,563,133,713,565,148,849,704,126,765,614,118
060411082021,833,645,188,857,654,203,1059,881,155,972,748,170
060411082023,676,515,161,696,518,178,821,669,133,733,548,151
060411081003,741,568,173,759,572,187,866,704,146,803,613,146
060411060012,1082,864,218,1112,883,229,1485,1222,231,1342,1046,214
060411060022,954,784,170,975,798,177,1186,978,187,1023,801,149
060411060023,630,511,119,652,529,123,797,658,125,698,557,105
060411082011,291,236,55,297,239,58,325,272,48,335,269,53
060411082012,652,526,126,665,536,129,859,702,147,718,585,95
060411082022,477,353,124,487,360,127,663,538,112,498,364,97
060411090021,906,777,129,927,784,143,1026,869,133,981,806,120
060411150001,1156,989,167,1184,1012,172,1384,1204,158,1264,1062,146
060411060011,624,488,136,645,503,142,686,543,129,642,507,109
060411090022,1029,881,148,1055,893,162,1242,1054,162,1110,920,129
060411170001,722,626,96,739,642,97,857,747,94,779,663,87
060411090023,371,309,62,377,312,65,450,382,58,413,328,59
060411110023,982,853,129,1008,872,136,1175,1036,120,1094,915,120
060411170002,420,362,58,433,373,60,497,433,57,453,386,51
060411181001,458,326,132,478,349,129,571,451,106,513,372,105
060411090012,651,518,133,660,526,134,766,649,98,719,563,117
060411090011,488,418,70,502,426,76,633,547,72,560,464,64
060411090013,556,476,80,566,481,85,697,588,95,632,516,71
060411110011,458,398,60,465,402,63,627,539,81,478,392,55
060411101001,967,742,225,998,768,230,1124,897,200,1030,784,200
060411102002,648,460,188,667,472,195,765,591,170,660,467,157
060411102003,1264,902,362,1295,920,375,1489,1141,325,1310,939,306
060411102001,1557,1105,452,1598,1148,450,1822,1406,393,1640,1193,364
060411110022,371,326,45,379,331,48,465,404,59,402,327,47
060411101002,1028,796,232,1053,809,244,1236,985,223,1109,832,222
060411101003,686,562,124,700,577,123,802,676,109,745,622,90
060411101004,242,199,43,244,202,42,307,260,42,287,225,46
060411070002,512,411,101,527,423,104,582,487,89,580,462,91
060411070003,522,420,102,536,426,110,595,499,90,534,449,64
060411070004,820,660,160,847,677,170,934,780,144,987,789,152
060411070001,848,667,181,870,680,190,1042,863,165,931,692,180
060411070005,869,691,178,894,703,191,1073,870,183,959,724,176
060411060021,1025,852,173,1053,860,193,1331,1108,199,1136,912,161
060411141001,1250,1147,103,1271,1162,109,1452,1340,82,1302,1124,88
060411141002,1054,955,99,1071,966,105,1228,1093,109,1084,923,86
060411141003,980,878,102,993,888,105,1117,998,102,1019,874,81
060411142002,641,566,75,654,582,72,786,698,71,717,596,64
060411160001,989,866,123,1006,883,123,1192,1048,118,1057,913,90
060411142001,1182,1049,133,1194,1055,139,1386,1231,129,1258,1062,115
060411191005,656,480,176,687,518,169,689,558,119,613,476,105
060411200011,657,544,113,680,563,117,922,789,118,703,573,95
060411200023,996,820,176,1024,843,181,1227,1042,164,1064,863,143
060411200021,763,625,138,777,635,142,695,593,92,824,667,108
060411200022,651,535,116,671,554,117,757,642,102,697,564,94
060411192012,965,785,180,997,812,185,1206,1015,176,1081,864,162
060411192011,843,694,149,872,725,147,1004,841,146,918,748,133
060411200024,650,514,136,670,522,148,785,648,124,733,575,114
060411192021,980,747,233,1017,785,232,1202,996,187,1089,841,189
060411121004,552,469,83,557,472,85,660,574,79,603,479,85
060411192022,1012,774,238,1054,819,235,1264,1033,201,1097,856,182
060411181002,809,566,243,845,610,235,1006,799,191,913,667,176
060411191002,605,495,110,623,511,112,720,584,123,622,507,85
060411191004,639,457,182,672,497,175,768,622,133,675,523,117
060411150004,1013,878,135,1040,905,135,1215,1069,124,1091,947,98
060411150003,1139,971,168,1172,999,173,1347,1181,142,1249,1033,141
060411160002,867,754,113,884,766,118,1022,898,107,932,813,78
060411170003,831,714,117,847,726,121,1020,887,116,917,776,93
060411170004,683,598,85,695,605,90,836,727,94,735,609,77
060411191001,332,259,73,344,272,72,444,364,72,373,288,64
060411110021,787,684,103,808,701,107,907,784,104,876,737,85
060411121001,166,142,24,168,143,25,214,178,33,185,152,23
060411121002,656,560,96,659,562,97,778,665,103,717,575,98
060411121003,607,515,92,615,522,93,723,633,80,618,528,54
060411311001,604,536,68,611,539,72,741,668,65,660,569,55
060411191003,463,359,104,480,377,103,787,650,120,577,450,96
060411230001,472,311,161,492,327,165,556,417,127,501,355,118
060411230002,771,510,261,805,537,268,941,709,213,820,585,189
060411261004,524,461,63,542,478,64,626,571,49,589,518,47
060411261005,553,481,72,567,498,69,656,593,51,587,518,42
060411270005,685,599,86,707,623,84,825,744,65,743,654,52
060411270002,357,313,44,368,317,51,424,386,33,382,333,33
060411270003,507,446,61,516,458,58,581,527,45,531,463,34
060411270004,566,501,65,584,519,65,689,624,53,610,536,41
060411282001,353,296,57,362,306,56,436,388,38,363,313,29
060411270001,690,594,96,705,604,101,854,775,69,739,642,67
060411261001,902,780,122,924,796,128,1114,1005,90,987,865,87
060411261003,629,548,81,641,558,83,747,678,61,694,607,52
060411261002,791,689,102,811,706,105,967,863,92,841,740,67
060411262001,1113,950,163,1132,963,169,1309,1181,111,1184,1038,98
060411262002,1057,906,151,1079,926,153,1207,1068,123,1144,974,124
060411262003,351,294,57,356,297,59,459,408,46,379,321,47
060411282003,1113,959,154,1148,975,173,1368,1218,123,1229,1046,119
060411302031,982,816,166,1013,832,181,1206,1033,153,1018,824,144
060411302043,573,482,91,592,493,99,704,601,91,661,545,80
060411302011,620,508,112,630,517,113,781,670,97,718,585,97
060411302012,703,559,144,713,564,149,828,697,117,754,588,121
060411302013,678,550,128,692,559,133,843,719,110,692,556,101
060411302041,469,411,58,478,418,60,866,750,97,582,497,62
060411302042,500,424,76,520,437,83,646,549,88,564,479,54
060411241002,697,482,215,723,499,224,845,644,186,679,486,156
060411241001,383,301,82,396,310,86,516,429,76,409,321,66
060411241003,404,296,108,419,309,110,507,402,92,434,325,82
060411241005,1148,872,276,1202,923,279,1512,1228,247,1253,972,200
060411242002,505,372,133,524,387,137,609,471,125,549,398,114
060411242003,732,529,203,755,545,210,822,648,161,795,579,172
060411242004,996,764,232,1030,793,237,1175,927,225,893,662,171
060411242001,932,680,252,963,704,259,1147,886,240,1006,729,210
060411281002,1155,995,160,1188,1027,161,1288,1144,120,1134,977,104
060411282002,1319,1165,154,1343,1188,155,1544,1379,134,1414,1244,101
060411281001,1199,1032,167,1236,1051,185,1440,1276,135,1321,1107,133
060411281003,1539,1355,184,1571,1368,203,1875,1659,185,1648,1417,151
060411290001,440,398,42,447,403,44,615,534,65,473,417,36
060411290002,458,414,44,465,419,46,647,564,71,507,449,37
060411250001,588,453,135,599,461,138,706,564,129,913,725,140
060411250003,741,605,136,761,613,148,1014,846,148,831,656,130
060411250002,636,480,156,653,495,158,747,588,146,680,510,129
060411211002,422,355,67,433,363,70,553,482,67,448,378,53
060411211003,635,533,102,657,549,108,787,674,99,647,545,73
060411211004,602,506,96,617,520,97,741,636,92,645,547,66
060411211005,466,400,66,481,413,68,542,466,67,466,396,33
060411211001,809,674,135,839,696,143,1019,876,127,784,654,97
060411212003,958,762,196,993,793,200,1190,1019,148,1020,814,161
060411212004,432,347,85,451,364,87,537,458,65,459,370,64
060411212001,600,462,138,623,479,144,734,583,129,643,509,102
060411212002,758,611,147,772,615,157,865,707,140,723,566,120
060411212005,201,164,37,204,165,39,259,202,51,211,166,34
060411031002,968,641,327,987,642,345,1220,866,336,1083,717,301
060411031001,1099,752,347,1141,769,372,1360,982,352,1194,830,299
060411031003,1176,796,380,1209,808,401,1469,1044,393,1320,890,350
060411031004,852,575,277,881,584,297,1034,745,265,885,586,244
060411022023,997,691,306,1027,702,325,1233,889,318,1069,709,298
060411022024,385,280,105,397,282,115,495,357,128,435,315,94
060411122041,148,125,23,150,126,24,258,208,45,172,145,19
060411122042,110,93,17,110,93,17,205,164,36,144,121,16
060411122032,82,70,12,85,71,14,163,131,29,97,82,10
060411122031,55,47,8,57,48,9,106,85,19,69,59,7
060411122022,127,108,19,131,110,21,263,216,45,136,118,15
060411122021,722,593,129,728,582,146,910,732,160,793,649,107
060411122023,147,121,26,150,119,31,189,152,35,162,132,22
060411130003,1135,1040,95,1151,1048,103,1266,1106,134,1203,1011,91
060411322002,392,361,31,394,362,32,474,409,54,423,330,58
060411322003,121,99,22,124,98,26,245,192,45,132,97,29
060411330001,512,391,121,530,390,140,569,432,119,552,427,82
060411330004,354,327,27,359,328,31,456,394,51,366,284,54
060411330002,305,216,89,307,212,95,360,317,37,322,249,49
060411330003,280,201,79,293,199,94,401,350,44,314,245,49
060411130001,521,464,57,530,469,61,646,564,68,578,471,54
060411321002,900,838,62,915,843,72,958,878,58,858,731,44
060411321001,295,270,25,302,271,31,422,386,26,421,374,26
060411130002,734,633,101,750,638,112,837,725,89,786,624,94
060411322001,430,396,34,434,403,31,490,423,56,461,404,23
060411021001,1334,927,407,1371,939,432,1671,1207,428,1431,1013,326
060411022021,847,582,265,872,588,284,1030,743,264,917,636,236
060411011001,1606,1094,512,1645,1122,523,1950,1403,507,1728,1145,493
060411022033,733,527,206,754,541,213,896,675,205,800,571,180
060411022022,713,517,196,732,526,206,848,631,201,814,583,182
060411032001,431,332,99,442,327,115,592,444,135,468,346,93
060411032003,1311,891,420,1340,899,441,1628,1183,412,1425,932,414
060411022031,524,409,115,533,407,126,644,506,124,606,455,108
060411022032,609,479,130,619,486,133,762,593,157,681,512,134
060411032004,324,236,88,335,240,95,438,346,80,360,266,68
060411032002,730,539,191,753,545,208,882,691,169,817,598,166
060411041031,854,645,209,873,641,232,1017,761,240,918,683,185
060411012001,1369,943,426,1396,940,456,1749,1287,427,1486,1005,399
060411041022,432,331,101,441,328,113,519,406,107,475,354,92
060411041043,1147,829,318,1175,822,353,1341,999,308,1246,880,291
060411041021,917,698,219,943,702,241,1274,950,302,1062,778,221
060411041023,514,395,119,525,393,132,649,482,152,550,413,106
060411041032,746,559,187,764,560,204,964,704,239,821,587,180
060411041042,596,436,160,612,438,174,721,552,157,676,500,145
060411042001,851,614,237,875,633,242,1116,842,240,962,674,223
060411042003,1057,649,408,1085,654,431,1265,944,298,1115,711,353
060411041041,436,322,114,449,325,124,511,391,112,479,358,102
060411043001,1060,731,329,1093,751,342,1361,954,386,1163,786,315
060411050021,339,262,77,350,272,78,640,500,126,362,271,74
060411050022,1062,819,243,1084,830,254,1137,899,219,1208,908,243
060411042002,872,682,190,892,696,196,1072,861,192,1010,766,201
060411050012,249,191,58,253,189,64,329,264,59,281,211,55
060411050011,264,205,59,268,204,64,367,291,66,289,218,56
060411050014,294,229,65,296,228,68,434,349,78,322,245,63
060411050013,335,267,68,339,266,73,424,339,76,352,271,67
060411241004,250,203,47,257,209,48,332,270,53,285,217,43
060411220001,17,13,4,17,13,4,64,46,15,123,83,30
061010507011,658,303,355,678,296,382,999,451,534,771,349,376
061010507012,477,240,237,482,227,255,757,363,374,569,280,247
061010507024,258,138,120,260,132,128,470,243,222,316,169,130
061010507023,333,181,152,339,170,169,510,261,239,354,188,143
061010507021,680,313,367,697,299,398,1138,522,589,761,344,372
061010506031,286,110,176,291,110,181,381,119,251,305,100,188
061010506042,1243,455,788,1281,452,829,1623,536,1047,1361,513,773
061010501015,593,221,372,617,222,395,833,340,475,624,212,380
061010501014,530,203,327,541,193,348,824,299,504,637,229,357
061010501011,276,104,172,285,103,182,469,167,286,307,107,174
061010501013,268,101,167,276,98,178,458,177,272,307,114,165
061010505034,311,152,159,326,155,171,457,232,213,368,179,170
061010505035,462,222,240,478,220,258,715,332,377,534,244,255
061010505043,304,148,156,316,147,169,466,240,217,354,164,173
061010501022,324,156,168,327,146,181,534,233,281,403,165,205
061010501023,250,121,129,255,111,144,446,195,237,334,154,160
061010502023,88,46,42,91,42,49,165,72,88,108,54,46
061010503023,100,59,41,101,54,47,210,93,112,131,81,42
061010503022,210,120,90,211,111,100,412,180,219,291,171,102
061010502022,197,86,111,200,80,120,318,140,173,234,100,116
061010503012,553,201,352,560,190,370,711,294,391,634,225,349
061010503024,385,158,227,393,143,250,540,233,287,467,181,241
061010503011,361,114,247,361,108,253,444,166,258,408,135,232
061010506011,513,149,364,529,143,386,652,238,400,471,151,295
061010508001,991,194,797,1017,185,832,1292,259,1013,1003,198,750
061010508002,497,99,398,505,89,416,660,201,453,290,57,220
061010510002,519,135,384,532,126,406,696,213,470,1050,248,749
061010506012,796,244,552,818,229,589,1001,392,590,852,267,539
061010505011,388,131,257,401,134,267,526,163,349,424,153,252
061010506013,573,248,325,593,238,355,837,404,421,679,292,354
061010509001,235,39,196,241,39,202,303,99,204,274,53,206
061010506014,542,210,332,557,199,358,766,348,406,638,255,355
061010501012,146,51,95,151,47,104,216,78,131,193,67,112
061010501021,423,158,265,430,151,279,611,221,372,491,187,272
061010506041,376,143,233,384,135,249,555,202,341,455,157,267
061010506032,503,157,346,509,144,365,605,242,348,473,152,297
061010506034,677,239,438,694,230,464,921,350,556,746,257,453
061010506033,743,273,470,765,260,505,1062,413,636,767,274,441
061010505013,439,220,219,462,231,231,751,375,365,489,276,189
061010505014,161,84,77,170,87,83,237,116,119,188,106,71
061010505015,419,239,180,454,254,200,720,348,360,492,311,156
061010505031,356,115,241,365,111,254,505,176,314,404,124,259
061010505032,495,247,248,516,252,264,763,404,346,582,276,274
061010505033,703,351,352,742,366,376,1091,545,519,731,377,319
061010505041,728,353,375,762,364,398,1084,517,546,820,393,386
061010505045,499,240,259,520,245,275,840,426,400,603,309,264
061010505044,540,277,263,573,290,283,852,418,419,649,350,275
061010505012,238,108,130,247,108,139,336,120,212,266,128,123
061010504022,297,89,208,306,80,226,373,119,244,291,96,181
061010504023,658,300,358,670,282,388,998,443,534,758,337,371
061010505042,354,114,240,366,104,262,516,160,340,405,149,235
061010510001,249,74,175,254,70,184,364,120,242,319,109,196
061010504011,454,165,289,467,161,306,659,259,387,525,186,304
061010504021,517,135,382,528,128,400,676,229,428,577,155,386
061010504032,419,189,230,434,186,248,649,319,316,476,220,229
061010504012,342,136,206,352,132,220,498,210,278,382,137,218
061010504013,351,158,193,358,149,209,528,245,274,422,161,232
061010504014,406,183,223,414,178,236,609,282,316,476,220,226
061010504031,662,300,362,675,287,388,1025,487,523,764,316,394
061010511002,240,51,189,250,52,198,275,69,204,249,60,180
061010511003,390,68,322,396,67,329,517,118,387,422,86,306
061010511001,391,90,301,404,87,317,501,112,375,422,100,298
061010507022,397,101,296,395,96,299,484,130,348,410,111,278
061010509002,185,59,126,190,58,132,254,55,196,200,57,132
061010502011,269,117,152,273,109,164,417,182,226,341,142,172
061010502021,175,78,97,178,75,103,257,113,139,200,100,86
061010503021,323,139,184,331,131,200,515,224,272,400,162,193
061010502012,313,142,171,315,132,183,437,193,235,374,180,171
061010502024,211,95,116,216,92,124,326,142,175,248,116,114
060730170592,1528,682,846,1556,695,861,1726,939,765,1500,704,751
060730170601,856,380,476,878,382,496,1037,564,457,911,410,471
060730170602,806,344,462,822,346,476,970,523,422,848,384,425
060730170591,850,402,448,871,404,467,1108,602,487,890,436,408
060730170513,1060,501,559,1092,510,582,1420,808,584,1140,589,500
060730170523,479,252,227,493,258,235,705,401,291,536,294,218
060730170524,495,258,237,512,266,246,693,395,284,574,307,237
060730170062,383,208,175,394,206,188,488,279,203,420,206,193
060730170511,576,326,250,589,321,268,809,459,332,672,363,277
060730170512,491,264,227,502,261,241,652,371,269,565,273,271
060730170521,689,371,318,707,375,332,1049,597,431,791,430,323
060730170522,343,187,156,353,189,164,507,288,208,397,212,165
060730170141,738,333,405,760,345,415,862,491,355,769,374,365
060730170142,913,441,472,934,447,487,1065,611,437,949,462,461
060730170572,439,215,224,452,213,239,606,318,277,492,232,230
060730170573,972,501,471,997,501,496,1267,727,515,1053,525,468
060730170571,429,174,255,444,174,270,519,297,211,479,195,253
060730170581,512,287,225,522,288,234,735,423,300,594,317,239
060730170582,470,260,210,479,261,218,643,369,261,507,269,209
060730170583,682,361,321,699,354,345,889,521,345,750,389,323
060730170711,822,475,347,853,475,378,1246,763,445,1001,544,382
060730170333,1382,788,594,1420,790,630,1966,1242,682,1452,838,534
060730170341,915,507,408,946,515,431,1265,775,450,1028,554,409
060730170662,1477,814,663,1519,826,693,2055,1240,767,1537,852,594
060730170633,973,553,420,1008,559,449,1292,782,474,1088,603,416
060730170311,564,296,268,585,301,284,808,489,295,654,337,262
060730170312,325,181,144,339,184,155,458,277,168,372,200,145
060730170313,633,352,281,658,357,301,935,566,341,735,395,285
060730170631,631,333,298,656,339,317,796,482,291,678,350,290
060730170632,570,293,277,591,297,294,681,405,268,598,308,261
060730170691,1083,593,490,1121,592,529,1471,882,559,1142,601,456
060730170611,767,363,404,795,359,436,879,483,379,702,333,338
060730083361,445,241,204,454,242,212,581,353,214,484,259,199
060730083362,795,428,367,819,433,386,930,574,337,831,451,330
060730170363,549,306,243,562,308,254,690,432,242,579,318,228
060730170361,373,232,141,386,237,149,589,366,204,435,267,141
060730170362,314,195,119,323,198,125,427,267,149,390,241,128
060730170181,474,274,200,487,269,218,864,534,313,698,388,261
060730170351,354,205,149,361,204,157,534,329,195,440,247,167
060730170352,87,50,37,89,50,39,137,85,51,107,58,45
060730170353,505,291,214,514,291,223,873,538,317,620,364,213
060730170342,471,243,228,484,250,234,565,347,201,503,256,217
060730170343,638,353,285,659,359,300,830,511,295,685,355,290
060730170391,325,171,154,333,176,157,423,262,155,359,183,161
060730170392,454,240,214,466,246,220,623,385,225,453,248,180
060730170551,598,325,273,619,335,284,869,538,314,689,423,234
060730170552,642,388,254,663,393,270,1021,632,370,717,424,251
060730170561,776,456,320,796,460,336,1274,786,461,986,562,368
060730170562,546,305,241,555,306,249,779,482,282,756,413,296
060730083681,527,270,257,545,276,269,642,392,236,596,287,263
060730083683,904,479,425,941,500,441,1232,746,460,964,517,390
060730170182,675,443,232,698,447,251,1015,634,354,760,453,261
060730170371,820,472,348,847,472,375,1163,727,405,943,523,363
060730170373,756,426,330,791,435,356,1030,628,382,892,503,336
060730170331,542,332,210,559,332,227,723,445,263,606,363,189
060730170332,356,218,138,365,217,148,454,281,165,402,232,145
060730170553,764,428,336,794,445,349,1064,658,387,898,507,345
060730083661,1187,648,539,1236,663,573,1700,1043,628,1306,739,505
060730083663,636,391,245,657,397,260,977,590,368,709,440,231
060730083662,1185,628,557,1221,639,582,1570,929,608,1321,728,525
060730083651,770,424,346,791,426,365,1010,626,368,850,493,318
060730083652,688,379,309,715,386,329,889,548,325,763,430,289
060730170372,439,243,196,454,243,211,529,331,184,495,274,191
060730170374,479,265,214,502,273,229,649,389,248,539,308,202
060730083684,904,499,405,928,508,420,1282,779,478,986,547,387
060730083682,437,238,199,447,236,211,616,374,230,493,271,186
060730083371,829,450,379,854,458,396,1107,676,405,918,505,354
060730083372,438,229,209,452,234,218,572,358,199,487,259,199
060730083373,704,376,328,727,382,345,960,592,347,789,429,312
060730083671,313,187,126,320,188,132,517,316,193,417,246,150
060730083672,804,446,358,826,455,371,1256,761,468,1351,809,463
060730170621,1036,441,595,1063,433,630,1380,723,626,1122,531,537
060730170622,718,359,359,743,361,382,1282,700,558,935,500,387
060730170651,1015,571,444,1042,577,465,1613,1039,540,1837,1133,604
060730170652,1744,1037,707,1795,1044,751,2857,1841,961,765,470,242
060730170661,1215,527,688,1244,529,715,1831,1012,781,1357,625,670
060730083281,1712,985,727,1761,986,775,834,540,278,1583,966,547
060730215021,975,622,353,1007,628,379,3562,2358,1137,818,516,267
060730215022,392,213,179,405,216,189,609,394,201,394,225,146
060730083722,1397,829,568,1446,850,596,2158,1374,728,1236,784,376
060730083731,843,512,331,869,517,352,1189,797,366,810,486,285
060730083732,678,404,274,694,406,288,965,649,296,796,470,289
060730083741,581,343,238,597,349,248,802,538,252,612,373,210
060730215023,735,378,357,753,382,371,1029,651,351,964,532,372
060730083742,650,389,261,673,399,274,871,551,298,672,426,207
060730083721,308,202,106,315,203,112,831,551,264,367,241,105
060730083712,471,292,179,481,290,191,718,483,219,526,314,183
060730083711,1055,671,384,1085,692,393,998,669,307,1128,727,348
060730215011,753,446,307,779,452,327,1028,683,321,805,502,265
060730215012,512,303,209,528,305,223,687,457,215,469,299,151
060730083282,1686,874,812,1735,892,843,2792,1794,943,1840,1030,726
060730083701,840,556,284,863,555,308,1086,734,323,963,610,288
060730083302,541,360,181,559,365,194,779,510,252,604,411,164
060730083303,760,502,258,788,508,280,977,641,317,877,585,247
060730083301,1057,613,444,1091,613,478,1332,873,432,1126,702,368
060730083311,1278,766,512,1322,792,530,1624,1099,483,1330,845,418
060730083271,964,580,384,992,584,408,1252,823,406,1048,640,344
060730083273,571,343,228,584,348,236,739,487,240,608,374,208
060730083272,1149,713,436,1176,728,448,1635,1072,531,1241,772,422
060730173061,1074,567,507,1105,576,529,1301,786,492,1147,609,490
060730173062,677,396,281,689,389,300,858,563,281,708,419,248
060730083241,1352,899,453,1395,896,499,1668,1185,449,1406,933,399
060730083691,415,268,147,430,270,160,589,392,186,506,318,156
060730083692,356,237,119,371,245,126,745,511,219,445,285,137
060730083702,808,524,284,830,526,304,1220,828,356,918,584,289
060730215013,514,302,212,532,302,230,681,453,213,616,387,206
060730083244,509,345,164,523,348,175,588,418,157,532,353,150
060730083245,1047,716,331,1075,724,351,1265,900,338,1142,768,310
060730083242,372,253,119,380,258,122,446,320,120,406,277,102
060730083243,736,512,224,753,518,235,936,663,248,775,522,215
060730083051,2662,2408,254,2733,2429,304,1311,1174,90,2867,2461,206
060730083052,618,548,70,629,552,77,981,875,67,481,385,45
060730083391,549,441,108,565,442,123,830,622,189,646,479,125
060730083782,37,30,7,38,30,8,64,51,12,57,43,10
060730083781,187,150,37,191,150,41,311,243,60,238,178,45
060730083431,663,547,116,681,539,142,1019,801,195,778,600,118
060730083432,391,322,69,400,316,84,592,464,114,492,377,76
060730083433,192,152,40,198,150,48,307,240,59,220,165,37
060730083611,682,515,167,692,507,185,920,634,265,831,595,184
060730083612,224,169,55,228,167,61,334,230,96,267,190,59
060730083621,503,374,129,512,371,141,695,479,201,591,417,138
060730083771,277,219,58,284,221,63,383,299,74,339,262,59
060730083772,456,361,95,471,367,104,633,495,122,543,417,94
060730083631,119,101,18,122,101,21,162,128,31,152,122,19
060730083632,223,188,35,229,189,40,317,247,61,275,221,35
060730083643,394,309,85,405,312,93,559,438,108,472,335,99
060730083644,275,205,70,282,207,75,382,299,74,291,205,64
060730083642,451,357,94,466,362,104,701,549,135,528,365,125
060730083641,592,423,169,610,432,178,687,537,133,642,433,170
060730083131,579,394,185,597,395,202,756,520,219,641,433,178
060730083622,275,203,72,280,202,78,403,278,117,326,220,85
060730083623,497,367,130,508,367,141,718,494,207,602,423,144
060730083752,573,433,140,586,431,155,741,557,165,677,483,147
060730083762,235,177,58,237,175,62,416,315,92,274,176,86
060730083633,292,253,39,303,255,48,374,292,72,303,243,39
060730083634,391,338,53,406,341,65,497,389,96,402,323,51
060730083751,375,276,99,381,272,109,583,440,130,455,341,83
060730083753,224,165,59,227,163,64,363,272,81,290,218,53
060730083763,82,60,22,85,62,23,1064,801,237,84,60,16
060730083761,758,556,202,781,568,213,209,157,47,765,545,168
060730083463,1361,891,470,1396,884,512,1579,999,548,1348,834,440
060730083462,229,145,84,236,144,92,276,179,91,222,127,61
060730083764,309,228,81,316,226,90,493,371,110,356,228,113
060730083793,502,365,137,516,369,147,683,534,131,615,432,150
060730083792,136,99,37,139,99,40,173,136,33,157,111,38
060730083791,276,201,75,284,203,81,374,292,72,356,249,87
060730083121,338,229,109,351,239,112,402,297,98,370,256,96
060730083124,599,370,229,614,380,234,702,493,204,665,419,207
060730083123,401,258,143,414,264,150,529,376,138,448,283,133
060730081012,414,297,117,426,302,124,501,344,144,424,300,103
060730083031,789,471,318,806,481,325,991,666,301,832,511,280
060730083032,863,465,398,886,481,405,1075,742,312,986,579,364
060730082011,488,302,186,501,307,194,633,435,182,471,290,151
060730082021,448,280,168,463,285,178,528,362,153,504,310,162
060730082022,335,204,131,346,211,135,460,315,132,360,221,118
060730082012,503,320,183,512,322,190,627,436,183,529,335,168
060730081011,328,234,94,336,238,98,406,280,117,348,243,87
060730081013,400,275,125,408,278,130,509,353,150,422,266,137
060730081014,415,285,130,426,291,135,562,387,162,480,308,146
060730081015,458,315,143,477,330,147,601,416,174,510,334,142
060730081022,595,382,213,622,398,224,784,528,242,682,441,202
060730081023,753,465,288,778,476,302,965,646,298,803,511,245
060730081021,508,286,222,528,297,231,642,443,188,522,298,195
060730080061,410,257,153,423,263,160,509,350,146,452,285,141
060730080062,377,259,118,386,261,125,529,355,159,423,285,107
060730080063,325,231,94,335,231,104,458,313,134,385,271,85
060730083112,667,364,303,687,373,314,837,516,304,692,397,258
060730083111,979,535,444,1012,553,459,1213,751,441,1044,601,398
060730080064,329,230,99,337,231,106,458,309,133,366,249,90
060730080065,451,316,135,464,319,145,606,411,176,526,357,131
060730083103,1407,755,652,1446,768,678,1757,1102,620,1540,840,634
060730083033,371,204,167,382,212,170,478,295,172,411,249,144
060730083101,630,348,282,647,357,290,836,516,302,689,412,253
060730083102,991,528,463,1017,541,476,1190,751,412,1071,593,431
060730083011,793,472,321,823,484,339,945,646,266,814,469,299
060730083012,577,326,251,595,329,266,700,461,218,635,357,247
060730083013,448,259,189,462,268,194,562,348,205,476,298,157
060730083132,607,398,209,625,399,226,780,538,225,692,451,205
060730083122,562,340,222,574,340,234,742,512,213,583,348,190
060730083475,655,434,221,675,432,243,1137,691,420,861,536,265
060730083461,648,366,282,669,364,305,952,579,351,765,456,266
060730083471,631,358,273,650,358,292,889,540,327,715,408,265
060730083472,448,257,191,461,256,205,644,391,238,568,339,200
060730083473,338,194,144,348,193,155,490,298,182,392,231,140
060730083601,526,359,167,536,354,182,740,450,269,603,401,165
060730083602,496,320,176,511,319,192,770,469,280,597,370,194
060730083811,483,293,190,498,294,204,753,481,256,580,360,188
060730083812,272,166,106,281,168,113,424,270,145,341,212,109
060730083552,738,427,311,752,428,324,1204,767,411,927,551,318
060730083532,1071,633,438,1100,628,472,1561,969,559,1201,687,444
060730083561,491,312,179,512,308,204,738,439,281,599,373,192
060730083573,488,310,178,507,304,203,795,473,304,613,386,195
060730083491,504,306,198,514,303,211,738,447,272,577,323,219
060730083562,605,367,238,617,357,260,911,540,349,707,410,248
060730083522,406,246,160,418,238,180,638,379,244,482,267,179
060730083523,269,164,105,276,157,119,418,248,160,300,167,113
060730083531,463,271,192,477,268,209,645,384,248,522,286,202
060730083571,414,230,184,424,233,191,697,419,261,488,277,184
060730083572,312,172,140,318,176,142,501,299,193,338,192,129
060730083551,329,185,144,334,186,148,500,300,189,354,209,124
060730083802,651,413,238,669,415,254,1010,641,343,790,521,231
060730083521,364,192,172,375,192,183,525,313,202,423,224,173
060730083533,320,169,151,329,171,158,492,291,187,446,236,184
060730083481,824,482,342,848,487,361,1196,715,450,946,565,328
060730083482,368,213,155,376,214,162,511,309,193,437,258,156
060730083474,329,203,126,340,199,141,473,287,175,369,210,139
060730083492,692,415,277,710,417,293,1028,622,383,758,430,283
060730083503,363,221,142,369,218,151,556,332,210,399,236,140
060730083501,714,391,323,731,386,345,1088,647,413,814,467,295
060730083513,277,166,111,285,164,121,441,265,167,345,201,123
060730083514,480,276,204,492,274,218,766,457,290,548,322,197
060730083581,635,390,245,660,390,270,1036,631,377,756,444,271
060730083603,703,421,282,725,419,306,1134,691,411,878,544,281
060730083511,266,157,109,273,156,117,423,253,160,319,189,113
060730083512,292,172,120,297,170,127,449,268,170,331,197,115
060730083502,376,230,146,383,229,154,576,345,218,409,244,143
060730083801,353,218,135,362,222,140,1481,939,506,387,253,111
060730083803,78,48,30,80,49,31,478,303,163,83,55,24
060730083591,1097,800,297,1121,790,331,594,360,214,461,292,132
060730083483,623,373,250,643,379,264,926,554,351,673,419,219
060730083504,469,296,173,478,296,182,746,445,281,545,325,190
060730083583,670,397,273,688,395,293,1003,611,367,786,473,265
060730083584,546,324,222,565,325,240,830,506,300,630,378,212
060730083582,267,171,96,274,170,104,365,223,133,329,201,110
060730083592,388,266,122,397,266,131,644,392,234,472,299,136
060730170432,379,237,142,389,229,160,542,341,190,408,250,130
060730170433,999,585,414,1027,572,455,1413,886,495,1102,636,401
060730170461,1393,776,617,1441,787,654,1784,1112,634,1541,862,593
060730170221,427,243,184,435,241,194,514,317,186,440,250,166
060730170222,465,271,194,481,274,207,571,352,207,518,302,187
060730170223,428,251,177,439,249,190,508,313,184,470,274,169
060730170226,551,326,225,568,331,237,726,447,263,680,403,228
060730170473,682,360,322,706,365,341,809,499,294,735,380,309
060730095043,1352,666,686,1396,686,710,1942,1197,705,1304,746,490
060730170224,509,317,192,519,320,199,692,427,251,605,374,187
060730170225,364,226,138,370,228,142,528,327,194,443,267,144
060730170671,457,259,198,472,259,213,585,360,214,469,267,171
060730170672,850,459,391,877,459,418,1280,762,487,1017,552,405
060730170682,922,528,394,942,533,409,1291,792,468,1020,594,371
060730170431,884,496,388,909,491,418,1274,802,448,1006,571,387
060730170441,604,349,255,621,349,272,851,535,298,683,406,235
060730170395,750,420,330,770,415,355,1054,636,392,914,490,370
060730170502,617,265,352,631,261,370,896,473,403,700,307,352
060730170442,475,265,210,491,270,221,603,373,216,535,301,205
060730170444,445,256,189,457,258,199,601,373,214,521,299,194
060730170681,574,367,207,579,359,220,934,571,341,684,382,251
060730095042,609,311,298,627,322,305,724,445,263,778,393,342
060730170472,658,339,319,683,343,340,821,509,296,677,341,292
060730095041,757,392,365,781,397,384,1037,589,431,874,465,369
060730170443,533,285,248,550,288,262,752,467,267,602,339,234
060730170451,1221,651,570,1269,666,603,1708,1042,628,1402,789,543
060730170471,805,425,380,832,434,398,1018,635,365,874,490,343
060730170462,566,299,267,586,312,274,703,436,252,672,377,268
060730095044,514,270,244,530,272,258,1203,671,503,515,253,241
060730170394,497,276,221,518,279,239,815,475,320,571,321,217
060730170393,738,384,354,766,390,376,978,570,385,827,437,333
060730083441,915,589,326,938,582,356,1151,815,311,1008,637,322
060730083442,886,584,302,911,586,325,1135,772,339,935,592,297
060730083451,574,345,229,589,345,244,764,512,233,636,372,216
060730083452,706,429,277,723,429,294,854,580,256,729,439,242
060730083453,670,438,232,691,443,248,825,562,247,739,472,223
060730083071,497,307,190,513,310,203,621,422,186,516,319,165
060730083073,484,286,198,507,302,205,631,427,189,513,315,172
060730083072,1160,755,405,1195,764,431,1465,995,437,1261,787,401
060730083061,367,230,137,384,237,147,481,327,145,392,245,130
060730083062,600,377,223,616,376,240,708,480,212,662,416,213
060730083063,836,525,311,865,530,335,1025,698,307,926,582,301
060730085011,703,428,275,725,426,299,868,553,294,784,461,273
060730085012,950,564,386,987,568,419,1178,751,400,1074,583,411
060730085013,537,315,222,559,320,239,732,465,247,630,349,233
060730085014,429,258,171,445,258,187,569,363,195,491,280,176
060730085031,927,553,374,961,578,383,1166,743,396,1042,599,372
060730085034,675,405,270,703,421,282,819,521,276,724,413,266
060730085033,1012,620,392,1047,640,407,1386,883,472,1174,667,421
060730085021,750,461,289,774,462,312,960,610,325,839,502,284
060730085023,466,288,178,482,288,194,573,364,194,524,312,177
060730085024,672,417,255,692,417,275,844,536,286,737,436,249
060730085025,512,321,191,524,326,198,768,490,261,615,372,205
060730085032,518,321,197,532,325,207,771,494,260,548,306,202
060730085043,570,374,196,590,390,200,833,529,282,708,431,236
060730085041,326,207,119,336,210,126,430,274,145,352,210,124
060730085042,331,214,117,338,217,121,406,256,138,376,228,132
060730085022,378,234,144,386,234,152,505,323,171,416,246,146
060730085054,514,316,198,532,319,213,728,465,246,655,388,226
060730085055,419,257,162,430,259,171,591,375,199,487,289,168
060730085045,1175,682,493,1206,684,522,1376,874,472,1282,692,508
060730085044,444,259,185,453,262,191,533,338,184,484,270,177
060730085072,275,195,80,282,192,90,418,263,143,335,218,92
060730085073,471,303,168,483,302,181,693,438,238,546,330,178
060730085074,360,263,97,368,259,109,634,401,218,425,285,109
060730085121,387,228,159,398,231,167,512,320,178,455,263,172
060730085123,1166,661,505,1203,667,536,1450,910,506,1269,672,529
060730085122,732,404,328,755,408,347,892,559,311,793,404,341
060730085131,909,523,386,926,526,400,1093,685,381,1038,579,401
060730085132,587,333,254,602,336,266,705,442,246,635,344,253
060730085101,413,280,133,422,282,140,669,440,211,456,281,142
060730085104,473,310,163,486,313,173,769,507,242,543,358,144
060730085092,507,310,197,522,309,213,650,413,220,563,318,206
060730085096,740,479,261,767,491,276,1071,673,372,857,535,264
060730085093,342,219,123,350,218,132,475,311,150,373,227,123
060730085095,418,276,142,432,282,150,631,396,220,488,310,144
060730085091,526,346,180,540,331,209,697,439,244,567,317,212
060730085094,286,192,94,298,201,97,449,281,158,349,229,94
060730085071,710,405,305,737,407,330,941,596,325,766,421,292
060730085075,514,288,226,529,293,236,653,414,224,591,317,232
060730085061,453,277,176,470,278,192,610,386,208,521,305,181
060730085062,516,303,213,536,302,234,735,466,251,613,351,223
060730085063,614,375,239,634,376,258,876,553,298,738,431,258
060730085051,591,353,238,609,353,256,810,512,278,672,387,244
060730085052,440,261,179,459,266,193,585,369,199,462,270,162
060730085053,334,197,137,342,196,146,464,295,161,380,218,141
060730085076,339,203,136,351,205,146,546,348,188,424,236,159
060730085102,910,546,364,938,550,388,1225,796,400,1041,580,389
060730085103,703,458,245,730,448,282,984,644,315,807,501,248
060730085111,958,663,295,990,658,332,1341,961,339,945,588,298
060730085112,192,114,78,199,110,89,276,176,96,213,110,92
060730085113,356,261,95,366,260,106,955,688,239,431,288,113
060730095111,74,47,27,74,43,31,210,109,95,136,63,57
060730095091,608,308,300,614,316,298,857,517,314,816,419,338
060730095112,84,53,31,84,50,34,253,132,110,179,83,76
060730095101,89,49,40,89,49,40,156,97,55,125,52,58
060730095102,180,99,81,182,99,83,313,195,110,236,97,111
060730095103,95,52,43,96,52,44,156,97,54,104,43,50
060730095071,1004,555,449,1033,545,488,1348,845,472,1209,662,459
060730095072,221,126,95,230,125,105,315,197,111,256,143,94
060730095073,405,226,179,421,235,186,534,348,176,466,267,171
060730095093,538,397,141,553,402,151,1053,743,278,648,414,187
060730095092,260,195,65,267,197,70,565,398,149,366,234,104
060730095022,815,501,314,842,495,347,1110,688,384,920,514,342
060730095053,987,600,387,1024,619,405,1301,814,455,1127,666,390
060730095062,884,570,314,911,575,336,1147,710,395,984,604,311
060730095061,1318,752,566,1353,750,603,1618,1015,567,1400,767,531
060730095021,975,529,446,1000,539,461,1156,718,398,1051,566,410
060730095052,743,433,310,768,431,337,1004,627,351,935,555,319
060730095054,720,439,281,735,431,304,985,614,343,710,421,241
060730095051,1113,611,502,1149,626,523,985,600,363,832,490,287
060730098053,641,366,275,658,369,289,805,480,307,721,401,279
060730098054,879,498,381,902,502,400,1113,676,414,899,489,352
060730097045,772,450,322,790,460,330,930,568,341,787,435,313
060730098052,398,228,170,406,227,179,514,309,196,436,230,173
060730098014,505,290,215,520,293,227,681,408,260,540,307,204
060730098013,694,391,303,715,388,327,929,560,354,755,397,318
060730098011,509,274,235,527,273,254,637,386,236,569,281,253
060730098021,632,337,295,650,340,310,750,461,278,721,360,318
060730098025,273,154,119,284,150,134,393,237,150,307,159,131
060730098041,919,530,389,947,530,417,1206,719,457,996,526,417
060730098043,426,239,187,436,242,194,537,323,205,456,249,182
060730098044,772,438,334,796,443,353,938,558,354,805,420,347
060730097042,394,233,161,401,231,170,593,386,198,398,221,145
060730097043,832,485,347,858,495,363,1016,665,332,887,515,317
060730097044,458,263,195,472,267,205,578,356,210,503,282,194
060730098022,397,261,136,409,265,144,710,434,261,486,294,152
060730098023,436,279,157,449,283,166,690,420,253,512,300,173
060730161003,600,302,298,627,294,333,928,469,435,741,354,330
060730098024,846,486,360,878,489,389,1103,677,406,972,500,426
060730098042,450,255,195,471,263,208,570,342,216,488,267,195
060730098051,673,381,292,701,390,311,867,517,327,770,422,300
060730098012,853,465,388,881,482,399,1022,600,406,939,500,395
060730097061,721,384,337,737,381,356,883,539,326,788,424,327
060730148053,644,410,234,658,398,260,956,601,330,767,441,267
060730097062,586,324,262,602,326,276,766,472,279,626,368,222
060730097067,495,264,231,507,261,246,631,388,231,526,273,229
060730097064,395,213,182,406,210,196,476,288,183,432,233,174
060730097065,613,323,290,634,328,306,762,457,290,625,342,256
060730097063,830,457,373,860,455,405,1051,632,402,905,495,359
060730097031,597,347,250,610,345,265,786,485,284,639,332,277
060730097041,662,380,282,684,389,295,870,537,315,760,443,271
060730096021,693,402,291,717,406,311,902,556,327,757,432,280
060730097032,433,252,181,450,258,192,595,372,216,477,260,197
060730097033,780,463,317,810,476,334,989,613,357,866,490,334
060730097066,490,259,231,505,264,241,634,384,237,539,294,226
060730097052,868,508,360,887,519,368,1077,671,384,915,496,363
060730097053,567,351,216,578,352,226,789,501,273,602,357,203
060730096042,419,261,158,432,263,169,543,352,180,490,283,165
060730096044,393,252,141,403,253,150,524,337,174,438,256,147
060730097051,470,254,216,481,266,215,583,360,212,518,262,226
060730096023,509,295,214,530,301,229,611,386,214,537,308,198
060730096024,343,194,149,351,196,155,423,260,154,360,205,132
060730096041,366,213,153,374,213,161,428,274,141,385,218,147
060730096022,412,252,160,416,242,174,599,372,217,475,274,171
060730096043,420,257,163,425,247,178,558,362,188,495,286,179
060730096031,467,344,123,479,340,139,707,499,187,568,388,149
060730096033,417,307,110,426,303,123,603,425,159,489,335,128
060730096032,384,268,116,392,263,129,539,380,143,466,284,151
060730096034,498,347,151,509,341,168,1015,717,269,490,300,157
060730092032,1381,898,483,1416,899,517,1385,945,409,1392,867,444
060730093061,769,466,303,794,469,325,1066,696,344,848,497,292
060730093064,766,497,269,791,484,307,1054,689,339,882,534,301
060730093062,318,179,139,327,179,148,415,274,134,363,205,134
060730093063,426,276,150,445,289,156,587,385,190,513,311,160
060730093014,331,208,123,347,216,131,481,314,155,356,233,92
060730093055,370,230,140,383,231,152,518,337,167,451,260,159
060730093051,395,248,147,411,257,154,579,379,188,510,272,205
060730093011,327,203,124,338,203,135,478,315,154,393,219,147
060730093013,408,253,155,422,253,169,574,375,185,457,293,126
060730093052,317,191,126,324,187,137,398,260,130,351,201,128
060730093012,631,374,257,640,374,266,812,553,239,693,386,257
060730092041,531,298,233,539,291,248,737,503,217,605,332,234
060730092042,929,570,359,958,573,385,1120,750,341,953,560,335
060730092011,479,325,154,490,330,160,976,645,306,651,407,191
060730092012,89,61,28,92,62,30,175,122,51,126,79,37
060730092013,564,337,227,576,331,245,760,519,223,644,346,245
060730092014,102,69,33,107,70,37,214,148,65,143,91,43
060730087022,863,530,333,881,512,369,1016,693,299,926,537,340
060730093074,209,152,57,218,149,69,322,219,94,245,163,67
060730093071,371,268,103,385,264,121,725,495,211,439,291,121
060730093083,650,471,179,671,465,206,974,664,286,793,528,215
060730093082,324,234,90,334,232,102,485,329,142,387,257,105
060730089021,417,284,133,420,282,138,580,406,159,489,314,134
060730089022,539,366,173,549,366,183,719,506,197,618,388,177
060730093072,401,292,109,414,294,120,657,488,151,459,309,111
060730093073,393,287,106,406,287,119,644,477,149,473,321,114
060730093081,381,277,104,395,277,118,657,446,193,452,301,119
060730093053,448,297,151,463,299,164,750,491,242,565,379,155
060730093054,229,151,78,236,153,83,401,261,129,291,196,72
060730087021,391,275,116,406,271,135,711,485,209,540,358,141
060730087023,294,208,86,305,205,100,491,333,144,411,277,102
060730088001,454,302,152,462,303,159,781,496,263,542,386,129
060730088002,245,157,88,248,156,92,401,266,126,248,160,74
060730088003,494,324,170,502,322,180,788,519,250,622,420,169
060730088004,338,219,119,343,218,125,591,389,187,356,238,100
060730089013,1416,959,457,1460,977,483,1754,1160,552,1624,1045,472
060730087011,318,208,110,330,208,122,524,328,182,386,221,138
060730087012,244,168,76,251,165,86,383,251,122,313,198,94
060730086001,905,601,304,924,607,317,1351,895,425,1103,693,320
060730086002,241,175,66,243,171,72,394,260,124,288,210,60
060730086003,154,112,42,156,110,46,302,199,95,184,135,39
060730086004,174,126,48,179,126,53,318,210,100,197,144,42
060730089011,322,200,122,329,199,130,479,317,150,411,256,128
060730089012,186,116,70,191,116,75,259,170,81,239,149,74
060730090001,838,579,259,853,570,283,1091,722,344,898,607,239
060730090002,281,199,82,282,194,88,409,267,127,318,215,85
060730091081,549,323,226,562,323,239,693,458,216,556,311,209
060730091091,202,141,61,207,140,67,107,69,34,293,198,72
060730091073,458,330,128,476,335,141,751,492,233,534,363,132
060730091072,326,240,86,333,247,86,486,324,152,440,304,105
060730091082,437,254,183,448,253,195,596,396,189,560,321,204
060730091071,388,273,115,404,275,129,543,358,170,439,294,107
060730091074,470,327,143,486,326,160,553,366,173,435,293,107
060730091042,928,542,386,971,545,426,1081,713,337,985,557,358
060730091033,682,417,265,705,421,284,865,554,292,795,469,283
060730091034,545,335,210,563,335,228,746,484,252,581,334,203
060730091041,635,349,286,653,345,308,814,535,254,731,404,276
060730091032,413,255,158,429,258,171,509,326,172,472,276,171
060730091031,411,258,153,424,258,166,485,310,163,447,263,161
060730091012,1066,657,409,1096,659,437,1437,917,483,1224,709,438
060730091013,471,277,194,484,281,203,596,379,200,508,297,179
060730091021,481,319,162,495,320,175,760,484,255,545,341,159
060730091023,317,209,108,327,210,117,466,296,156,359,233,95
060730091011,532,313,219,547,318,229,614,391,206,579,323,223
060730091014,768,438,330,788,450,338,998,637,335,869,464,342
060730091022,340,241,99,350,241,109,567,362,192,418,263,122
060730078001,441,320,121,447,313,134,752,520,208,523,342,135
060730078002,362,228,134,371,231,140,483,335,134,398,241,136
060730078003,352,262,90,365,267,98,697,479,193,454,291,120
060730078004,223,163,60,228,159,69,372,258,103,281,186,71
060730078005,174,116,58,180,119,61,241,167,68,192,119,59
060730076014,201,122,79,207,121,86,267,186,77,254,143,87
060730077011,568,363,205,584,367,217,774,523,225,669,408,212
060730077013,277,192,85,288,193,95,408,276,118,351,225,97
060730080023,390,261,129,404,266,138,500,342,143,426,262,133
060730080022,555,338,217,571,343,228,693,475,201,605,348,222
060730079082,410,305,105,427,314,113,671,457,189,482,310,123
060730079083,405,301,104,422,310,112,664,452,187,515,335,131
060730077022,421,308,113,437,305,132,614,424,169,516,325,143
060730077023,473,333,140,492,333,159,690,475,191,567,366,151
060730079111,409,301,108,422,304,118,626,429,172,458,287,121
060730079112,430,316,114,446,317,129,617,425,170,514,331,131
060730079081,237,174,63,243,174,69,385,268,107,295,193,74
060730079121,396,276,120,413,278,135,569,386,166,458,283,138
060730080021,444,254,190,454,258,196,543,372,158,490,280,177
060730079113,158,118,40,164,118,46,250,171,71,201,135,47
060730079122,377,278,99,393,280,113,588,402,165,483,321,115
060730079072,512,381,131,531,392,139,830,562,240,624,413,151
060730077024,276,202,74,284,200,84,428,294,118,294,184,83
060730077012,434,269,165,452,273,179,625,425,180,504,296,170
060730077021,495,282,213,510,289,221,607,418,170,520,281,197
060730077014,226,160,66,235,161,74,390,264,113,266,172,71
060730079071,683,503,180,707,499,208,1025,691,295,840,563,206
060730079051,443,302,141,458,305,153,728,490,212,574,356,157
060730079052,575,393,182,593,394,199,874,596,256,668,419,182
060730079101,636,459,177,656,464,192,907,616,261,759,478,217
060730079102,520,375,145,540,382,158,771,521,223,584,377,153
060730076012,375,229,146,381,224,157,490,338,144,429,248,142
060730076013,226,138,88,229,135,94,276,191,82,277,158,95
060730080031,547,383,164,567,385,182,747,508,218,639,433,155
060730080032,639,450,189,660,449,211,847,576,246,701,449,197
060730080033,418,294,124,437,296,141,584,399,169,496,335,120
060730076021,235,145,90,240,143,97,282,194,82,237,147,69
060730076022,264,162,102,270,162,108,347,238,101,317,172,117
060730076023,302,187,115,305,181,124,413,284,122,369,200,135
060730068011,561,396,165,574,403,171,829,578,227,680,444,177
060730068012,400,282,118,411,288,123,633,441,173,480,313,124
060730075014,413,322,91,424,321,103,562,426,118,469,318,99
060730075015,277,215,62,281,213,68,321,242,67,330,226,70
060730075022,401,323,78,413,322,91,613,459,128,478,333,98
060730075023,462,375,87,478,369,109,704,527,147,561,391,113
060730073041,808,614,194,831,610,221,1059,794,222,908,615,210
060730073042,793,615,178,818,614,204,1026,771,215,852,596,187
060730073031,538,413,125,548,412,136,661,504,139,594,412,130
060730073032,413,317,96,425,317,108,507,386,107,448,309,99
060730075021,543,414,129,560,413,147,723,548,152,621,438,135
060730072002,1189,723,466,1219,733,486,1476,893,544,1279,791,417
060730075013,390,311,79,405,307,98,550,419,115,454,323,89
060730075011,402,322,80,421,326,95,530,403,112,450,321,96
060730075012,289,231,58,300,233,67,429,326,91,317,224,68
060730074021,657,463,194,678,465,213,912,596,284,717,478,190
060730074022,595,423,172,614,425,189,879,581,272,644,434,165
060730074023,460,318,142,472,320,152,568,374,178,514,335,151
060730073021,432,286,146,441,299,142,549,361,172,479,314,133
060730073022,429,266,163,445,272,173,537,353,168,455,274,150
060730073023,386,236,150,397,238,159,475,315,148,408,240,139
060730074011,321,239,82,331,234,97,459,318,125,373,235,97
060730074012,414,308,106,427,302,125,562,392,154,486,306,127
060730068022,520,377,143,528,374,154,840,566,246,691,422,207
060730068023,603,441,162,621,441,180,977,680,266,696,436,192
060730069001,1267,784,483,1313,798,515,1562,1070,447,1436,840,483
060730063001,190,109,81,200,116,84,24,16,8,12,8,4
060730066002,55,35,20,55,35,20,92,59,30,70,41,23
060730066001,125,82,43,128,82,46,231,150,76,174,103,57
060730068021,437,285,152,444,283,161,803,519,263,553,323,183
060730065001,486,313,173,503,319,184,648,421,209,531,314,189
060730001002,1126,768,358,1150,772,378,1327,981,322,1149,766,311
060730065002,363,246,117,370,249,121,493,348,134,405,248,134
060730002021,677,518,159,698,534,164,884,660,204,786,563,175
060730065003,278,216,62,283,210,73,482,359,109,411,272,112
060730001001,761,554,207,781,562,219,860,648,199,830,606,180
060730002022,439,303,136,449,305,144,560,419,127,486,356,98
060730002011,570,436,134,582,437,145,618,466,144,561,420,107
060730002023,703,567,136,721,574,147,889,665,206,779,606,130
060730002024,494,395,99,506,402,104,624,467,144,557,417,115
060730003011,324,268,56,329,265,64,420,349,61,376,300,52
060730003013,554,479,75,567,484,83,725,601,105,626,504,82
060730002012,661,511,150,677,510,167,819,613,189,689,529,126
060730004002,505,446,59,512,452,60,648,542,94,590,491,67
060730004004,463,404,59,469,404,65,600,500,87,510,418,57
060730004003,417,366,51,423,368,55,504,420,73,478,394,51
060730004001,484,424,60,495,428,67,652,545,96,518,431,54
060730003021,1045,905,140,1060,907,153,1376,1148,200,1173,978,142
060730003022,530,465,65,543,469,74,651,539,95,594,482,75
060730003012,305,273,32,311,274,37,392,326,57,347,277,49
060730006002,615,530,85,630,538,92,735,634,86,654,537,78
060730005002,747,647,100,757,652,105,885,760,104,814,652,105
060730005001,529,432,97,532,433,99,623,529,83,571,451,81
060730005003,501,433,68,506,435,71,598,515,72,532,426,69
060730010001,706,592,114,716,594,122,859,726,112,860,668,132
060730006003,820,703,117,832,717,115,987,849,118,861,712,105
060730007001,780,678,102,793,684,109,931,801,110,806,680,81
060730007002,968,849,119,982,855,127,1187,1021,142,1013,857,98
060730007003,630,533,97,639,540,99,767,663,91,641,521,82
060730006001,370,325,45,379,328,51,547,468,65,462,378,54
060730009011,576,495,81,593,502,91,852,733,100,576,462,77
060730009023,335,294,41,342,295,47,475,411,55,421,334,56
060730010002,590,518,72,601,519,82,749,634,96,652,545,62
060730010003,596,528,68,609,534,75,756,646,92,656,551,62
060730010004,466,413,53,477,419,58,728,624,89,514,429,51
060730009012,406,360,46,417,363,54,590,506,70,488,399,53
060730009013,373,331,42,385,334,51,525,449,62,433,355,47
060730009021,462,396,66,470,394,76,558,479,67,507,404,75
060730009022,360,309,51,366,307,59,463,396,55,346,276,50
060730008003,679,602,77,683,606,77,794,677,100,718,590,75
060730008004,555,483,72,562,483,79,727,622,88,611,500,67
060730008005,469,408,61,477,408,69,607,521,74,514,423,57
060730008002,347,296,51,353,298,55,436,360,63,361,306,34
060730008001,276,238,38,282,238,44,386,335,45,297,244,34
060730014003,957,815,142,971,812,159,1204,1027,152,1142,923,151
060730012012,463,413,50,473,409,64,665,559,84,540,446,55
060730012021,660,567,93,674,562,112,851,716,108,720,579,89
060730012022,781,672,109,795,663,132,1026,865,130,898,720,112
060730011002,610,533,77,618,530,88,815,685,105,645,520,81
060730011003,425,370,55,432,370,62,516,436,67,437,356,54
060730011001,581,496,85,591,497,94,700,591,93,682,563,84
060730013021,511,455,56,524,459,65,682,585,79,574,480,56
060730013022,549,492,57,561,495,66,674,581,79,596,499,56
060730013023,456,403,53,468,409,59,662,566,77,554,461,54
060730013012,710,624,86,727,632,95,983,848,116,845,695,91
060730014001,348,297,51,354,293,61,436,377,56,390,312,56
060730014002,403,340,63,410,336,74,510,428,75,442,356,63
060730012011,493,440,53,507,438,69,666,561,85,574,474,58
060730013011,469,416,53,479,419,60,651,551,84,501,407,56
060730016004,526,461,65,534,464,70,711,587,100,519,415,61
060730015001,518,455,63,530,458,72,718,608,94,575,464,70
060730015004,463,406,57,473,408,65,596,508,76,514,417,61
060730015002,519,438,81,530,440,90,593,491,85,527,420,69
060730015003,517,436,81,530,442,88,572,477,83,557,446,72
060730042002,1099,917,182,1112,919,193,1197,991,172,1138,895,179
060730018012,477,407,70,484,405,79,646,544,85,526,427,65
060730018021,235,207,28,236,200,36,334,283,44,259,204,30
060730018022,316,279,37,320,270,50,468,390,60,331,259,41
060730023021,396,299,97,406,297,109,684,492,178,535,415,85
060730027071,167,122,45,169,122,47,307,222,81,220,171,36
060730027072,127,93,34,129,93,36,250,181,67,169,132,29
060730017001,530,461,69,539,460,79,739,617,100,635,516,70
060730017002,503,436,67,514,439,75,675,568,93,578,469,66
060730017003,560,485,75,573,486,87,741,619,99,628,511,69
060730017004,261,226,35,268,226,42,316,264,44,288,231,34
060730016002,415,366,49,421,366,55,625,532,75,485,401,52
060730016003,273,241,32,275,241,34,395,338,45,315,261,35
060730016001,356,306,50,361,301,60,561,458,89,460,368,49
060730022012,263,227,36,270,225,45,460,372,74,368,294,39
060730022011,314,255,59,318,252,66,583,437,130,393,320,46
060730022021,263,204,59,265,204,61,438,334,100,378,305,51
060730022022,331,262,69,338,260,78,540,404,122,447,357,60
060730022023,205,159,46,206,158,48,314,235,71,280,224,38
060730021003,294,235,59,301,239,62,399,309,82,327,256,50
060730021004,376,328,48,384,331,53,589,498,82,470,385,54
060730021005,471,410,61,479,411,68,685,576,95,597,486,72
060730018011,292,250,42,301,253,48,413,348,54,346,280,43
060730020013,538,420,118,548,420,128,623,480,130,610,462,114
060730020022,766,582,184,780,578,202,967,734,211,799,598,147
060730021002,336,269,67,343,272,71,453,343,102,360,277,57
060730023012,278,226,52,281,229,52,421,308,100,327,251,53
060730023013,147,119,28,149,121,28,244,179,57,189,144,32
060730020012,1030,746,284,1053,756,297,1152,889,242,1057,767,248
060730021001,578,481,97,582,482,100,666,520,144,596,460,96
060730020011,720,521,199,736,530,206,762,594,161,704,511,166
060730023022,215,172,43,216,168,48,375,280,92,266,213,39
060730023023,220,175,45,222,172,50,399,297,98,284,231,41
060730026011,299,245,54,302,237,65,504,361,120,430,345,61
060730026014,246,195,51,249,197,52,404,292,98,306,250,42
060730026013,74,60,14,75,59,16,133,99,34,100,81,15
060730026012,279,222,57,286,225,61,464,341,111,374,301,52
060730027073,107,85,22,109,85,24,205,149,49,136,109,20
060730027074,143,113,30,147,113,34,264,188,62,177,140,25
060730027091,315,262,53,320,262,58,480,351,115,383,302,48
060730020021,664,493,171,677,481,196,743,574,156,694,515,138
060730023011,290,236,54,298,229,69,509,385,105,379,278,72
060730028031,493,376,117,504,366,138,764,585,159,575,424,121
060730028032,464,348,116,474,340,134,751,578,156,553,413,114
060730028033,352,257,95,358,254,104,501,384,104,369,264,84
060730028034,716,550,166,733,557,176,1149,886,241,882,624,205
060730019001,549,451,98,561,449,112,648,550,87,584,461,84
060730019002,816,673,143,834,685,149,949,804,124,901,706,143
060730019003,451,373,78,463,372,91,522,445,70,497,392,75
060730018023,354,295,59,356,292,64,464,393,60,436,338,59
060730018024,333,279,54,339,279,60,451,382,59,396,307,55
060730028042,740,556,184,757,552,205,923,689,212,880,609,196
060730028043,469,350,119,480,346,134,501,374,116,528,369,118
060730028011,849,618,231,867,610,257,916,677,221,825,566,220
060730028041,532,410,122,554,419,135,779,580,179,703,473,172
060730028012,463,384,79,485,386,99,523,391,120,613,428,128
060730029044,227,173,54,233,177,56,324,242,75,275,189,65
060730029045,740,574,166,761,579,182,994,738,229,801,555,186
060730029041,667,546,121,689,543,146,457,338,104,913,639,198
060730029042,353,261,92,361,259,102,574,429,132,434,290,105
060730029043,233,173,60,236,169,67,428,319,97,284,190,68
060730029053,651,497,154,669,493,176,908,675,209,754,527,172
060730029051,403,304,99,409,300,109,574,435,134,458,313,113
060730027081,221,177,44,228,173,55,432,306,114,318,256,45
060730027083,203,163,40,209,159,50,392,278,103,302,244,42
060730027084,183,148,35,190,150,40,357,260,90,251,202,37
060730027082,56,45,11,58,46,12,95,69,23,67,54,9
060730027101,264,213,51,266,215,51,469,351,114,338,270,50
060730027102,208,167,41,213,171,42,370,268,88,260,206,39
060730027103,207,164,43,210,162,48,307,223,76,229,181,36
060730027092,363,303,60,370,304,66,547,400,132,465,368,59
060730027052,627,425,202,644,415,229,986,635,333,766,524,202
060730034011,374,292,82,384,290,94,843,639,178,457,342,86
060730034012,369,283,86,376,280,96,196,149,42,406,300,79
060730027111,237,168,69,244,168,76,430,301,120,306,204,83
060730027051,690,491,199,704,488,216,1058,707,330,803,594,169
060730027112,414,284,130,420,281,139,620,398,210,485,317,135
060730027121,470,357,113,487,366,121,719,506,193,572,429,114
060730027122,391,303,88,404,309,95,613,416,188,457,353,85
060730027123,394,329,65,397,322,75,668,482,169,543,443,66
060730027021,412,345,67,419,340,79,605,464,127,521,390,91
060730027022,426,336,90,435,343,92,602,461,128,523,379,117
060730027023,634,522,112,646,520,126,999,767,211,759,563,144
060730027033,326,250,76,331,244,87,574,418,143,399,306,73
060730027031,541,403,138,552,397,155,828,599,206,654,484,132
060730027032,381,282,99,390,278,112,568,408,142,487,353,103
060730027034,636,447,189,647,446,201,1022,678,321,794,530,216
060730029021,1205,896,309,1235,897,338,1469,1092,344,1334,925,310
060730029022,523,396,127,538,397,141,835,614,194,677,463,163
060730029023,581,416,165,587,403,184,779,580,181,668,432,187
060730029031,550,404,146,561,400,161,764,542,204,621,434,151
060730029032,424,299,125,434,299,135,592,415,157,502,326,137
060730029033,495,334,161,508,331,177,587,419,158,585,370,167
060730147022,1080,661,419,1108,656,452,1444,932,474,1194,712,411
060730029052,318,225,93,323,217,106,529,395,123,399,273,98
060730026021,195,154,41,196,147,49,353,260,86,272,207,45
060730026022,219,172,47,222,167,55,385,283,93,294,224,50
060730026023,203,160,43,205,154,51,415,301,99,285,218,47
060730025011,497,395,102,502,383,119,751,567,174,648,500,107
060730025023,141,117,24,143,118,25,240,183,51,174,136,25
060730025024,446,359,87,455,361,94,680,519,143,526,409,77
060730025022,326,258,68,334,259,75,465,357,101,388,300,56
060730025012,323,260,63,326,254,72,519,391,121,425,349,59
060730025013,303,244,59,308,238,70,529,397,122,395,317,56
060730024023,216,172,44,222,163,59,335,254,76,235,187,31
060730024022,207,164,43,212,155,57,334,249,75,235,190,31
060730024021,380,303,77,384,289,95,611,457,137,489,393,58
060730024011,226,188,38,229,185,44,292,219,66,225,182,28
060730024012,391,328,63,397,321,76,549,412,124,485,375,76
060730024013,439,374,65,445,369,76,638,477,143,545,422,84
060730025021,881,662,219,897,659,238,1286,927,325,1101,798,245
060730042001,1080,877,203,1098,880,218,1445,1196,211,1202,908,219
060730042004,431,353,78,437,353,84,568,471,83,471,358,80
060730043001,450,396,54,460,393,67,540,451,80,485,393,54
060730043002,960,828,132,987,833,154,1263,1049,179,1046,849,132
060730043003,578,486,92,593,487,106,739,617,104,649,519,91
060730044002,648,554,94,667,564,103,786,657,108,730,597,89
060730044003,437,376,61,449,381,68,530,453,73,492,396,61
060730042003,454,381,73,464,381,83,578,486,85,491,388,74
060730044001,534,439,95,546,443,103,655,548,91,548,424,83
060730044004,411,336,75,420,342,78,492,420,68,422,336,66
060730041012,470,403,67,480,401,79,678,559,96,570,446,72
060730041013,632,548,84,649,535,114,844,695,124,746,597,96
060730040001,215,184,31,217,172,45,367,291,67,305,254,33
060730040002,127,109,18,128,103,25,204,161,39,170,145,18
060730040003,191,166,25,192,160,32,277,218,51,245,209,23
060730041011,297,255,42,303,254,49,414,342,58,345,269,43
060730060001,641,534,107,657,534,123,784,658,115,682,548,97
060730060002,622,474,148,637,484,153,782,654,112,583,436,117
060730060003,1092,800,292,1117,803,314,1324,1106,192,1166,832,271
060730059002,402,314,88,412,316,96,532,407,107,465,344,94
060730059003,327,256,71,336,258,78,444,342,92,421,309,85
060730061001,855,593,262,877,588,289,1153,866,264,931,623,236
060730059001,619,486,133,628,483,145,752,576,153,679,510,123
060730057001,209,165,44,217,164,53,363,281,76,261,190,51
060730057002,298,236,62,300,229,71,438,333,90,367,266,71
060730056011,445,325,120,456,326,130,690,491,181,571,385,149
060730056012,592,434,158,607,434,173,872,623,229,630,424,164
060730058022,408,295,113,421,295,126,642,457,169,482,331,116
060730058021,522,380,142,541,379,162,776,553,204,632,437,151
060730058012,297,229,68,303,223,80,517,373,137,297,208,59
060730058011,312,238,74,316,231,85,492,353,130,360,252,69
060730061002,284,209,75,290,207,83,371,282,85,314,212,79
060730036012,201,178,23,204,172,32,311,249,55,301,258,27
060730036031,241,200,41,241,192,49,413,325,75,363,297,45
060730036032,245,206,39,252,196,56,407,323,77,367,290,48
060730038001,57,48,9,57,45,12,193,149,36,54,36,11
060730039023,197,171,26,200,163,37,347,277,64,242,204,26
060730214013,223,126,97,235,134,101,570,359,194,506,249,214
060730214012,831,494,337,867,514,353,1081,760,296,896,534,305
060730214011,111,63,48,117,67,50,167,108,55,155,77,66
060730069002,533,337,196,561,347,214,681,465,199,595,347,203
060730069003,910,558,352,943,570,373,1085,708,358,1065,624,372
060730214021,637,396,241,653,396,257,849,567,270,713,427,242
060730071001,1134,565,569,1167,580,587,1367,811,518,1278,626,578
060730071002,1514,791,723,1559,805,754,1764,1062,662,1563,813,652
060730071003,381,192,189,393,197,196,473,282,177,391,208,164
060730099021,144,77,67,146,75,71,325,185,129,281,137,127
060730214022,547,333,214,559,323,236,787,519,255,619,362,220
060730074013,609,402,207,625,398,227,758,528,207,678,418,206
060730070021,902,516,386,928,520,408,1087,712,339,924,518,343
060730070022,880,448,432,903,453,450,1080,715,339,935,480,390
060730072001,804,433,371,819,431,388,923,554,344,818,453,300
060730072003,537,296,241,548,298,250,655,400,246,667,374,246
060730053012,193,137,56,197,137,60,311,228,75,240,161,61
060730053013,257,184,73,265,184,81,399,295,98,332,226,85
060730053021,253,162,91,257,163,94,374,252,113,314,196,105
060730053022,551,352,199,561,355,206,818,550,249,676,419,228
060730054012,254,169,85,261,172,89,305,209,89,294,188,83
060730054011,421,293,128,430,294,136,566,397,154,472,308,131
060730053011,608,425,183,627,428,199,870,639,211,535,360,144
060730054021,725,462,263,745,472,273,866,595,252,801,520,233
060730054022,526,341,185,544,348,196,936,667,245,617,403,183
060730054032,801,513,288,821,523,298,975,657,295,975,621,307
060730054031,412,265,147,420,270,150,631,425,193,369,236,109
060730054023,548,347,201,567,355,212,769,516,234,550,357,158
060730051012,281,217,64,291,210,81,577,407,151,560,395,123
060730051032,72,53,19,75,51,24,314,220,84,229,153,58
060730051021,425,302,123,436,305,131,430,303,113,477,314,128
060730051022,461,328,133,473,330,143,945,668,249,523,345,141
060730056022,496,391,105,509,391,118,583,437,133,566,414,107
060730056021,479,378,101,493,378,115,580,432,134,495,361,95
060730052011,431,340,91,440,340,100,1007,752,229,508,353,110
060730052023,633,484,149,644,481,163,996,741,227,832,570,187
060730052021,176,135,41,180,135,45,272,201,63,223,152,50
060730051011,247,198,49,254,199,55,694,490,184,188,136,37
060730052012,238,192,46,246,194,52,510,379,116,329,232,67
060730052022,343,257,86,354,258,96,593,440,136,504,351,103
060730051023,335,238,97,346,238,108,591,417,155,254,168,67
060730050001,393,338,55,398,322,76,659,534,114,564,454,72
060730051031,140,119,21,144,115,29,243,196,41,221,183,23
060730047001,177,151,26,179,149,30,221,177,40,215,167,29
060730047002,272,233,39,277,231,46,358,291,62,311,243,40
060730046001,627,531,96,645,534,111,830,689,118,691,547,86
060730046002,205,177,28,208,176,32,267,221,42,225,178,29
060730041021,560,485,75,574,481,93,840,689,124,697,548,92
060730048001,204,184,20,208,178,30,283,222,48,255,209,30
060730048002,320,285,35,324,276,48,448,351,76,388,319,42
060730045013,222,190,32,230,190,40,301,251,43,278,215,38
060730045011,531,471,60,537,474,63,695,574,97,600,471,68
060730045012,253,224,29,255,226,29,330,271,47,267,211,30
060730048003,216,183,33,222,178,44,320,258,54,271,234,23
060730036022,253,227,26,253,220,33,434,348,77,390,336,37
060730036011,261,221,40,263,216,47,440,351,80,384,330,32
060730035011,318,270,48,320,263,57,543,438,98,455,385,47
060730035022,317,276,41,320,267,53,532,430,95,500,434,43
060730035023,281,242,39,288,236,52,467,376,84,412,364,30
060730035021,153,131,22,158,129,29,245,194,43,223,197,17
060730035012,138,117,21,139,112,27,246,198,44,222,186,23
060730035013,133,112,21,132,108,24,234,187,44,181,157,17
060730039011,201,178,23,200,171,29,307,242,57,273,235,25
060730033011,321,277,44,325,268,57,521,426,91,458,395,39
060730033012,336,290,46,341,282,59,569,463,93,500,428,43
060730036021,233,201,32,234,194,40,396,315,70,358,309,36
060730036033,193,162,31,198,152,46,301,241,57,295,233,40
060730049002,317,276,41,317,265,52,460,363,79,407,347,38
060730049003,484,420,64,486,403,83,804,629,138,679,564,68
060730049001,183,160,23,186,152,34,359,280,60,301,258,27
060730039012,200,177,23,204,170,34,327,261,60,266,225,24
060730039013,227,201,26,228,191,37,387,306,73,326,277,29
060730039021,154,138,16,157,133,24,239,194,44,223,192,18
060730039024,146,130,16,147,124,23,232,188,43,219,189,17
060730040004,206,179,27,208,175,33,301,237,55,259,219,24
060730039022,219,193,26,223,191,32,354,277,64,245,194,33
060730031032,768,649,119,779,631,148,1170,810,348,899,741,116
060730031141,352,223,129,359,219,140,616,418,183,448,305,130
060730031142,550,347,203,558,345,213,895,616,267,707,477,205
060730031091,301,153,148,304,149,155,468,273,187,371,202,155
060730031092,294,149,145,298,145,153,447,263,180,330,180,137
060730031093,324,164,160,332,162,170,494,288,198,400,219,169
060730031131,834,591,243,841,570,271,1321,951,348,972,691,244
060730031152,364,237,127,368,229,139,563,332,227,503,326,158
060730031153,404,251,153,411,243,168,677,395,270,491,312,158
060730031154,557,328,229,573,326,247,923,540,369,709,413,263
060730031151,369,232,137,371,221,150,662,388,267,466,309,140
060730031031,608,508,100,618,501,117,1096,758,327,811,666,112
060730031033,443,373,70,447,363,84,677,465,201,473,390,64
060730141021,877,662,215,899,649,250,1321,976,317,1115,842,230
060730141022,318,244,74,330,235,95,474,344,120,396,283,94
060730031051,712,552,160,726,529,197,1140,821,289,973,735,182
060730031052,467,337,130,476,317,159,700,507,179,606,433,138
060730031071,857,555,302,873,530,343,1313,877,408,1013,651,308
060730031072,557,425,132,567,420,147,878,632,224,658,479,138
060730031073,325,226,99,332,220,112,506,341,158,420,279,118
060730031012,445,398,47,450,389,61,617,476,129,533,465,52
060730031013,447,395,52,450,385,65,713,548,150,563,467,75
060730031113,564,371,193,572,366,206,883,679,185,738,577,131
060730031132,667,430,237,679,420,259,1041,665,360,827,567,225
060730031011,349,314,35,356,309,47,452,349,95,401,357,30
060730030013,539,467,72,550,466,84,708,544,153,629,534,64
060730030041,504,435,69,511,416,95,914,695,193,665,549,76
060730031111,268,234,34,273,224,49,521,402,110,302,267,23
060730031112,414,358,56,423,344,79,690,534,146,464,409,38
060730030012,535,453,82,548,452,96,758,582,162,644,549,63
060730030011,397,349,48,405,351,54,488,375,104,435,373,45
060730031122,344,255,89,346,245,101,636,491,134,491,365,99
060730031123,296,255,41,301,244,57,546,420,114,463,352,93
060730119021,483,298,185,494,289,205,725,440,272,642,395,210
060730031121,352,264,88,356,256,100,634,496,134,499,372,99
060730030033,357,265,92,363,261,102,499,378,107,429,305,91
060730030034,333,266,67,341,262,79,455,333,111,389,303,63
060730030031,601,449,152,608,438,170,882,670,188,744,535,159
060730030032,425,316,109,427,307,120,651,497,141,515,369,115
060730142003,671,439,232,680,424,256,930,615,290,801,514,242
060730030042,437,363,74,448,352,96,709,540,148,617,494,89
060730034031,232,196,36,235,188,47,393,311,73,329,279,35
060730034032,321,271,50,329,263,66,560,439,109,452,380,49
060730034014,822,672,150,835,669,166,1210,953,235,989,823,131
060730034041,331,291,40,333,273,60,525,436,82,468,397,47
060730034042,206,182,24,208,173,35,319,264,49,295,249,27
060730034043,284,254,30,291,244,47,439,357,69,378,325,32
060730034033,210,179,31,209,169,40,322,253,61,254,214,27
060730033032,376,322,54,379,312,67,700,545,142,559,479,45
060730033031,143,122,21,143,118,25,275,213,56,210,181,17
060730034013,244,203,41,246,198,48,417,325,81,329,266,47
060730033041,202,162,40,203,163,40,347,283,57,274,214,43
060730033042,290,232,58,291,234,57,516,420,85,377,295,59
060730033051,278,245,33,282,232,50,383,313,63,313,280,26
060730033052,403,363,40,409,352,57,687,564,113,687,614,56
060730033053,572,501,71,582,480,102,806,660,134,748,648,72
060730032141,693,493,200,703,478,225,1051,711,326,870,597,232
060730032143,321,234,87,325,228,97,511,362,144,384,282,86
060730032081,303,196,107,306,191,115,493,313,172,369,256,99
060730032082,199,129,70,201,125,76,347,221,121,261,181,70
060730032085,654,429,225,667,426,241,984,623,343,803,531,235
060730032112,274,177,97,277,172,105,453,288,158,359,250,96
060730032012,434,279,155,442,277,165,706,459,235,561,361,165
060730032111,648,410,238,657,408,249,1069,689,362,825,502,272
060730032121,405,259,146,415,262,153,676,431,234,506,336,153
060730032122,921,600,321,940,597,343,1362,869,467,1128,724,350
060730032131,595,344,251,606,326,280,956,594,344,734,416,275
060730032132,680,383,297,697,365,332,1057,662,382,831,482,305
060730032091,524,361,163,531,364,167,914,570,329,647,470,149
060730032092,449,332,117,455,312,143,713,444,254,532,384,125
060730032083,346,245,101,351,226,125,567,358,197,439,313,98
060730032084,316,223,93,321,206,115,479,304,167,413,294,94
060730032093,330,250,80,334,234,100,552,341,198,380,275,84
060730032022,836,598,238,852,585,267,1229,797,408,1019,744,231
060730032011,252,152,100,258,152,106,474,300,166,330,200,106
060730032013,79,48,31,83,49,34,160,103,57,117,72,38
060730032014,83,50,33,84,51,33,175,112,61,111,69,36
060730032021,438,302,136,447,297,150,783,512,250,654,453,165
060730101031,421,319,102,428,305,123,822,518,290,602,437,132
060730105021,319,211,108,322,211,111,555,334,196,431,284,117
060730101032,498,346,152,509,321,188,861,530,306,532,386,120
060730101033,511,360,151,519,339,180,825,513,293,663,479,149
060730104011,574,394,180,584,384,200,906,531,338,740,484,203
060730101042,735,426,309,747,407,340,963,594,343,852,481,310
060730104021,450,291,159,459,281,178,760,460,279,647,437,172
060730104023,327,216,111,326,200,126,675,401,246,541,355,143
060730101101,420,320,100,428,305,123,724,446,256,616,442,138
060730101103,385,238,147,385,219,166,617,379,217,509,355,131
060730101104,336,201,135,338,186,152,535,358,164,413,262,125
060730101102,516,335,181,522,338,184,751,538,199,664,461,176
060730101122,123,99,24,126,95,31,281,203,74,248,170,68
060730101123,216,174,42,219,165,54,474,343,123,417,334,60
060730101121,467,383,84,471,364,107,816,566,227,700,571,91
060730101092,716,529,187,720,510,210,1167,797,343,1001,758,200
060730101041,416,242,174,423,227,196,627,391,218,511,288,188
060730102011,478,270,208,482,263,219,736,405,307,616,361,207
060730101105,295,191,104,302,182,120,475,316,146,393,251,118
060730101091,557,383,174,570,370,200,880,589,271,708,492,182
060730100091,388,330,58,391,314,77,686,496,172,583,501,61
060730100094,295,255,40,296,240,56,541,391,136,548,478,51
060730100134,236,202,34,237,193,44,487,361,114,408,361,29
060730101071,669,501,168,672,483,189,1048,728,295,884,674,160
060730101072,245,173,72,249,165,84,436,310,117,391,280,90
060730101062,369,320,49,373,306,67,610,439,159,558,475,60
060730101073,452,351,101,458,335,123,687,488,184,588,462,99
060730101074,322,215,107,330,208,122,516,365,144,428,298,111
060730100012,795,520,275,803,500,303,1246,827,396,1061,717,292
060730101061,538,421,117,545,407,138,926,662,248,842,675,128
060730101063,317,260,57,319,243,76,566,396,158,529,436,66
060730101112,358,304,54,361,286,75,742,518,209,614,516,75
060730101111,457,392,65,456,360,96,551,387,156,466,390,59
060730100011,393,276,117,396,266,130,629,416,203,555,378,150
060730100112,513,371,142,522,365,157,840,562,260,761,537,181
060730100102,609,429,180,613,422,191,920,642,257,756,563,159
060730100042,747,572,175,752,551,201,1141,780,339,1072,816,202
060730100101,432,310,122,443,310,133,684,480,194,571,415,129
060730100103,470,339,131,480,335,145,738,506,220,644,475,136
060730100111,476,359,117,485,349,136,782,519,246,656,472,148
060730100033,436,335,101,446,328,118,661,439,206,551,383,131
060730100034,485,336,149,494,319,175,687,451,212,596,410,151
060730100032,471,325,146,473,309,164,707,471,220,622,431,161
060730100031,509,353,156,515,338,177,837,556,259,684,476,180
060730100041,627,477,150,636,455,181,1031,684,329,924,689,188
060730100051,691,570,121,694,541,153,975,723,230,969,794,131
060730100052,349,295,54,353,278,75,498,368,117,555,456,73
060730100053,587,505,82,591,488,103,926,689,218,844,720,80
060730100054,199,171,28,200,166,34,363,268,86,290,246,27
060730100151,521,394,127,523,368,155,885,591,277,832,628,163
060730100171,845,581,264,860,561,299,1579,1058,491,969,672,260
060730100172,536,386,150,542,375,167,992,662,310,591,429,138
060730100181,546,381,165,549,362,187,982,631,331,673,490,154
060730100182,345,243,102,343,229,114,681,450,220,428,310,101
060730100183,736,528,208,747,502,245,1442,955,461,984,704,229
060730100192,666,451,215,676,430,246,1190,756,412,829,581,212
060730100152,242,207,35,241,195,46,471,345,120,418,334,62
060730100093,39,35,4,39,33,6,74,53,18,75,66,7
060730100132,147,125,22,147,118,29,224,169,54,212,189,15
060730100121,363,308,55,369,293,76,639,473,153,556,473,52
060730100123,341,292,49,347,283,64,600,442,142,554,471,55
060730100122,153,134,19,155,132,23,283,210,67,278,239,29
060730100131,281,242,39,286,230,56,587,441,139,445,395,31
060730100191,226,161,65,226,152,74,425,271,146,275,202,62
060730100161,27,18,9,27,17,10,33,21,12,10,8,2
060730100133,259,213,46,258,194,64,477,353,113,406,351,41
060730100092,601,479,122,605,463,142,952,689,241,832,672,123
060730185211,578,305,273,585,301,284,707,398,294,579,279,269
060730185212,1049,590,459,1065,575,490,1870,1061,753,1239,584,575
060730185121,797,440,357,809,437,372,993,567,404,844,446,357
060730185233,501,240,261,512,235,277,713,412,281,522,259,233
060730186081,1067,536,531,1086,522,564,1302,753,516,1146,534,536
060730186171,1004,526,478,1018,521,497,1278,743,494,1104,498,542
060730186172,331,209,122,337,209,128,488,287,189,374,230,123
060730186193,738,341,397,766,346,420,1059,509,523,806,356,400
060730186092,379,255,124,384,247,137,518,304,198,472,306,135
060730186202,385,237,148,393,230,163,626,373,225,431,251,149
060730186121,1103,525,578,1122,517,605,1448,723,686,1150,516,553
060730186122,459,256,203,468,252,216,605,352,233,485,260,188
060730185042,844,454,390,857,455,402,1064,593,436,904,469,385
060730185043,1132,555,577,1166,565,601,1385,773,570,1162,570,531
060730185112,275,166,109,282,164,118,401,241,148,327,166,137
060730186183,237,168,69,240,167,73,397,232,151,276,180,78
060730186181,173,123,50,176,123,53,311,182,119,209,135,61
060730186182,227,161,66,229,160,69,394,231,150,288,185,87
060730186082,236,132,104,242,127,115,349,197,143,259,125,112
060730186091,734,392,342,755,398,357,1080,625,420,952,454,445
060730186093,526,322,204,539,320,219,974,574,374,595,384,173
060730186192,582,249,333,602,253,349,762,350,388,643,265,334
060730186194,603,267,336,612,268,344,804,382,398,621,250,322
060730186201,305,185,120,309,179,130,490,292,182,352,204,123
060730185201,536,331,205,544,315,229,817,458,335,612,340,223
060730193012,1230,587,643,1256,583,673,1539,799,696,1396,635,676
060730193013,1260,576,684,1296,574,722,1698,857,803,1389,616,675
060730193032,1178,514,664,1217,498,719,1668,763,862,1355,561,719
060730193031,1005,450,555,1038,432,606,1279,586,662,1042,429,550
060730193011,644,308,336,662,308,354,849,423,406,696,307,351
060730185251,1158,513,645,1189,525,664,1512,711,775,1244,536,634
060730185203,571,365,206,576,361,215,917,530,361,526,289,210
060730185241,794,445,349,816,454,362,769,446,303,640,327,270
060730185242,474,287,187,484,288,196,845,490,333,770,409,316
060730185231,777,430,347,790,428,362,1098,633,432,945,478,396
060730185232,386,204,182,394,203,191,581,334,229,432,207,197
060730185222,637,342,295,646,332,314,896,518,355,746,364,352
060730185252,950,418,532,973,427,546,1254,592,644,990,441,501
060730185221,766,442,324,778,436,342,1310,750,524,803,433,312
060730185202,542,300,242,554,294,260,830,464,340,614,325,224
060730185223,249,149,100,249,141,108,628,379,230,242,132,96
060730185122,588,344,244,600,344,256,725,417,296,615,330,263
060730186131,396,214,182,409,215,194,549,311,223,429,227,174
060730186211,619,364,255,628,359,269,910,514,370,667,372,255
060730186222,793,431,362,812,432,380,1132,642,460,883,466,370
060730186223,518,297,221,529,294,235,690,391,279,589,326,227
060730186133,206,118,88,211,119,92,317,181,130,238,131,91
060730186221,175,100,75,179,99,80,264,151,107,207,114,80
060730186132,502,299,203,509,304,205,761,430,307,541,292,193
060730186013,601,249,352,613,245,368,1246,669,521,974,429,467
060730186012,782,366,416,805,363,442,895,515,352,754,350,363
060730193051,693,363,330,707,364,343,973,498,449,773,381,344
060730193052,837,435,402,854,436,418,1052,548,481,973,455,459
060730184002,530,335,195,541,323,218,455,276,168,598,350,203
060730186152,167,117,50,169,113,56,314,182,124,214,138,60
060730186161,344,231,113,351,227,124,703,410,270,301,167,114
060730186163,234,163,71,239,158,81,419,241,166,306,198,87
060730186151,131,95,36,135,91,44,213,124,85,149,99,38
060730186162,337,242,95,343,232,111,528,304,208,398,263,98
060730186153,223,160,63,228,155,73,531,308,209,270,179,66
060730186011,461,230,231,471,222,249,641,372,253,595,264,281
060730187001,739,377,362,753,365,388,1799,805,871,1160,405,624
060730183012,241,118,123,246,121,125,339,204,123,256,132,105
060730183022,233,121,112,233,120,113,362,215,132,266,139,109
060730184001,406,241,165,419,236,183,792,473,293,432,220,178
060730184003,393,247,146,405,245,160,624,372,228,378,231,115
060730182011,621,401,220,634,397,237,948,573,347,617,341,235
060730182021,194,132,62,201,130,71,302,182,110,221,131,71
060730182023,433,272,161,439,273,166,600,365,222,500,256,200
060730182022,183,125,58,187,122,65,274,164,99,195,116,61
060730183011,174,110,64,177,109,68,269,164,101,213,115,82
060730183021,224,143,81,229,141,88,314,189,116,244,130,95
060730182012,241,164,77,249,161,88,378,226,138,267,164,82
060730181011,678,405,273,696,400,296,988,567,392,731,393,289
060730181023,284,178,106,296,179,117,414,234,171,315,174,119
060730193042,1002,510,492,1026,504,522,1403,731,636,1092,530,496
060730193041,397,224,173,407,220,187,551,288,251,431,223,185
060730185091,252,156,96,258,155,103,441,265,163,297,165,114
060730185092,349,215,134,355,214,141,530,320,197,406,221,157
060730185093,278,170,108,284,171,113,422,255,156,305,167,117
060730185094,203,125,78,208,126,82,298,180,110,238,125,94
060730185111,336,207,129,344,208,136,496,299,183,385,203,153
060730185101,549,320,229,559,322,237,730,442,270,557,272,236
060730185102,438,264,174,447,260,187,614,371,227,451,254,160
060730185113,282,171,111,289,171,118,392,235,144,330,191,117
060730185114,526,318,208,537,318,219,739,446,273,606,353,212
060730185123,543,298,245,555,303,252,689,401,281,598,319,266
060730185191,559,361,198,574,351,223,811,499,285,665,404,217
060730185194,245,177,68,251,173,78,448,296,138,259,168,72
060730185192,374,240,134,387,236,151,512,318,180,419,255,137
060730185161,1043,562,481,1066,561,505,1388,796,554,1186,608,498
060730185162,340,199,141,346,195,151,499,286,200,387,202,153
060730185171,438,251,187,446,249,197,679,371,291,489,254,199
060730194031,1720,980,740,1762,974,788,2351,1403,888,2008,1083,773
060730194032,231,121,110,237,120,117,333,174,148,260,124,117
060730194051,435,250,185,447,252,195,679,393,265,373,192,151
060730193033,889,500,389,906,494,412,1330,745,555,855,443,354
060730185181,377,242,135,387,243,144,564,348,198,428,253,146
060730185182,448,289,159,459,289,170,673,416,238,507,302,173
060730185193,183,128,55,190,127,63,315,202,104,218,139,65
060730198051,1022,618,404,1048,615,433,1480,908,529,1152,640,427
060730198052,352,198,154,361,195,166,398,235,158,397,212,159
060730198102,810,421,389,843,417,426,1104,603,485,881,468,350
060730198091,829,417,412,849,409,440,1058,566,468,881,405,421
060730198093,652,319,333,667,315,352,810,440,359,708,339,332
060730198081,710,363,347,723,366,357,804,440,347,740,377,333
060730198083,1502,743,759,1530,769,761,1590,872,691,1509,770,692
060730198101,2027,1062,965,2091,1041,1050,2678,1531,1090,2250,1121,964
060730198092,815,351,464,831,350,481,1044,569,453,863,365,439
060730199041,1012,482,530,1035,477,558,1384,707,642,1058,471,522
060730198082,757,402,355,768,390,378,1063,582,459,833,416,366
060730185152,877,434,443,897,435,462,1159,635,496,1005,478,467
060730185153,905,463,442,922,462,460,1208,660,516,1056,520,472
060730185172,486,265,221,500,268,232,680,373,292,530,263,234
060730185173,661,364,297,681,369,312,820,449,351,676,333,297
060730185151,410,184,226,420,181,239,531,290,227,444,185,231
060730198031,878,544,334,896,541,355,1577,963,576,784,427,286
060730185044,359,215,144,371,217,154,524,292,216,399,214,155
060730185045,344,207,137,356,209,147,495,276,202,379,202,148
060730185041,567,287,280,593,290,303,766,427,316,722,356,324
060730181013,457,259,198,470,262,208,602,335,248,495,247,219
060730181012,415,240,175,425,241,184,512,290,216,427,234,164
060730181021,477,276,201,492,277,215,609,341,253,527,289,203
060730181022,281,179,102,294,180,114,476,265,199,316,176,119
060730180001,379,219,160,388,217,171,446,278,162,422,223,170
060730179011,804,509,295,827,514,313,1022,632,368,853,484,302
060730200351,807,455,352,827,451,376,1049,631,395,870,467,355
060730200354,853,458,395,878,471,407,1074,665,383,892,489,360
060730200352,598,333,265,615,334,281,767,468,279,633,352,252
060730200353,548,303,245,564,305,259,640,391,234,584,317,241
060730171091,1232,609,623,1276,628,648,1564,915,616,1290,665,547
060730171112,1191,585,606,1230,605,625,1484,859,596,1252,644,537
060730221023,840,438,402,862,436,426,1088,676,394,896,463,370
060730221024,495,280,215,504,281,223,635,393,230,693,371,278
060730200302,1156,595,561,1184,606,578,1575,931,625,980,498,420
060730200303,1184,603,581,1210,608,602,1532,877,633,1233,625,552
060730221021,947,503,444,972,497,475,1236,716,491,921,481,387
060730221022,677,377,300,698,381,317,908,527,360,649,364,243
060730200332,961,514,447,988,522,466,1298,739,535,998,515,413
060730200322,795,416,379,823,425,398,1056,600,435,855,444,360
060730200311,1008,540,468,1031,540,491,1392,813,547,1101,601,435
060730200313,932,476,456,949,468,481,1200,663,515,963,497,418
060730200312,1210,671,539,1231,663,568,1616,943,634,1331,738,516
060730178111,639,395,244,650,404,246,769,442,306,650,373,238
060730178114,569,300,269,582,308,274,826,476,329,685,362,286
060730198033,504,277,227,525,284,241,711,412,281,569,278,247
060730198032,685,343,342,710,352,358,953,529,398,746,353,334
060730198043,1068,570,498,1095,581,514,1334,768,532,1136,574,491
060730200321,957,501,456,992,503,489,1103,622,466,1070,562,448
060730200152,603,344,259,614,339,275,734,432,286,595,330,234
060730200153,597,359,238,613,348,265,810,507,290,669,377,258
060730171094,1087,600,487,1112,601,511,1302,775,500,1158,616,457
060730171132,952,486,466,979,495,484,1132,654,453,990,515,407
060730178011,884,477,407,906,476,430,1054,593,435,922,468,393
060730178012,738,409,329,759,404,355,996,593,376,694,360,284
060730200151,1405,721,684,1443,714,729,1805,1081,693,1513,730,685
060730180003,565,320,245,587,318,269,727,447,261,651,361,241
060730180002,301,173,128,306,170,136,414,256,150,316,168,129
060730176011,620,434,186,640,439,201,825,551,256,643,426,170
060730178131,1026,478,548,1063,486,577,1289,683,582,1074,553,483
060730178133,596,302,294,613,310,303,837,472,343,702,335,341
060730178132,647,303,344,659,306,353,879,463,392,726,318,367
060730200301,793,457,336,812,475,337,1135,658,455,1068,593,410
060730179012,392,252,140,404,253,151,565,351,205,393,234,132
060730171093,442,242,200,458,243,215,1019,605,391,468,242,187
060730221011,1018,527,491,1049,528,521,1414,769,609,1124,551,514
060730179013,328,221,107,341,220,121,471,291,170,375,232,115
060730179021,608,410,198,629,406,223,932,573,335,699,407,241
060730179022,535,324,211,548,320,228,646,390,242,524,298,192
060730178115,830,406,424,855,417,438,1070,611,439,881,439,400
060730178112,948,507,441,977,502,475,1255,713,516,917,487,372
060730180004,264,148,116,275,147,128,348,214,125,303,170,108
060730178082,1088,534,554,1122,557,565,1289,729,532,1217,638,503
060730176013,687,301,386,709,311,398,712,374,329,724,323,371
060730176014,868,495,373,898,512,386,1060,707,330,895,530,301
060730178113,394,215,179,406,210,196,547,311,225,424,202,203
060730178084,901,500,401,921,496,425,1106,639,451,958,497,397
060730178081,806,374,432,821,376,445,999,546,442,794,386,370
060730221012,246,141,105,248,141,107,312,157,152,228,108,106
060730178101,1164,590,574,1186,584,602,1474,803,643,1231,597,542
060730178102,686,364,322,703,361,342,853,464,371,755,355,348
060730178091,1357,667,690,1395,678,717,1661,891,734,1380,644,631
060730178103,977,496,481,1009,506,503,1186,653,506,1021,518,431
060730178083,788,370,418,805,367,438,952,517,421,770,358,373
060730200421,684,386,298,697,390,307,996,605,367,877,474,344
060730198042,591,266,325,601,256,345,691,342,341,570,274,253
060730198041,1212,583,629,1262,601,661,1120,608,485,926,397,466
060730178013,1135,562,573,1169,574,595,1400,741,623,1225,613,541
060730178014,562,357,205,574,348,226,831,495,313,615,350,218
060730198113,710,405,305,730,413,317,1184,674,493,687,352,294
060730198114,795,455,340,819,466,353,1653,936,689,649,337,283
060730171092,582,301,281,607,312,295,726,431,279,650,359,245
060730198111,798,436,362,825,435,390,1150,602,520,1110,566,479
060730200333,434,248,186,448,250,198,534,311,213,423,255,139
060730200331,463,289,174,478,290,188,648,416,221,525,315,175
060730200341,1549,901,648,1586,906,680,1893,1184,678,1604,902,593
060730200355,962,498,464,988,507,481,1218,722,466,997,556,369
060730171071,1003,615,388,1030,623,407,1221,807,380,1063,647,346
060730198112,539,219,320,547,226,321,564,308,252,529,273,231
060730177014,467,308,159,474,302,172,430,290,131,338,202,109
060730177015,446,293,153,449,288,161,618,417,188,515,320,154
060730176031,615,448,167,633,450,183,783,541,221,640,435,158
060730177013,672,492,180,691,499,192,1134,764,345,878,577,230
060730177021,616,434,182,633,440,193,735,507,208,598,400,159
060730177022,429,299,130,439,303,136,520,361,148,440,284,126
060730177011,682,466,216,706,469,237,821,553,250,736,473,216
060730177012,354,237,117,367,238,129,450,302,137,395,252,118
060730171041,1432,864,568,1481,881,600,1700,1115,544,1499,900,507
060730171072,695,422,273,709,424,285,870,563,288,744,462,234
060730176052,875,502,373,895,508,387,943,577,345,765,457,261
060730176061,953,581,372,975,580,395,1277,797,458,1167,641,462
060730176062,790,553,237,809,559,250,1045,730,293,933,616,255
060730176012,923,559,364,949,563,386,1126,758,345,945,555,338
060730176032,682,500,182,702,504,198,866,619,225,737,482,204
060730176051,797,518,279,812,527,285,1004,670,313,786,482,252
060730171042,745,497,248,769,499,270,947,651,271,814,509,248
060730171083,655,448,207,676,453,223,820,565,233,720,468,200
060730174031,749,445,304,771,459,312,906,573,313,787,454,291
060730174032,811,455,356,835,461,374,965,609,333,828,469,307
060730171061,823,320,503,849,328,521,950,458,478,799,349,418
060730171111,1146,458,688,1163,454,709,1458,666,767,1157,466,635
060730171121,1240,633,607,1268,648,620,1574,905,632,1295,680,535
060730171084,481,305,176,494,301,193,627,400,217,540,342,156
060730174034,825,489,336,850,495,355,988,628,343,899,519,331
060730174033,647,413,234,675,421,254,788,514,258,648,399,201
060730174061,587,366,221,603,370,233,706,487,203,638,399,196
060730174062,535,327,208,552,332,220,683,445,222,543,323,193
060730174052,582,427,155,596,433,163,731,504,208,597,397,154
060730174053,762,531,231,782,540,242,952,658,272,815,538,214
060730177023,447,306,141,454,308,146,587,408,166,595,396,166
060730175021,437,307,130,447,305,142,602,430,157,438,300,107
060730175022,559,392,167,574,392,182,709,504,183,566,378,146
060730175011,387,278,109,400,281,119,491,351,128,406,273,100
060730175012,559,382,177,583,391,192,729,526,193,534,338,152
060730171082,904,597,307,925,614,311,1028,697,312,913,570,278
060730171081,516,312,204,532,319,213,634,419,207,544,338,180
060730174051,467,343,124,480,349,131,601,418,172,463,309,120
060730175023,458,363,95,467,369,98,680,484,176,510,359,117
060730174063,515,313,202,534,316,218,599,415,171,492,304,155
060730175013,771,591,180,794,585,209,827,596,215,777,563,164
060730174071,1060,726,334,1092,726,366,1336,927,383,1101,735,296
060730174072,655,444,211,672,444,228,852,595,243,724,471,206
060730174082,674,470,204,688,467,221,855,596,244,713,460,200
060730174081,669,463,206,682,461,221,870,603,248,713,464,199
060730173032,744,517,227,767,527,240,903,645,234,745,513,201
060730173051,716,391,325,732,391,341,869,530,324,777,436,301
060730173053,670,360,310,688,366,322,811,507,284,726,399,292
060730173052,461,234,227,471,245,226,548,320,217,476,261,181
060730173081,504,335,169,518,326,192,732,490,224,362,212,122
060730173072,723,467,256,740,469,271,912,617,274,1027,646,320
060730173082,803,525,278,825,519,306,1060,683,350,774,464,264
060730173031,613,410,203,636,416,220,798,560,217,650,415,199
060730173033,380,248,132,391,248,143,448,318,122,419,264,124
060730173071,504,295,209,513,301,212,668,440,212,502,309,165
060730172011,753,450,303,787,470,317,904,572,309,793,488,262
060730172021,649,364,285,669,374,295,739,471,252,646,383,217
060730172012,419,238,181,433,246,187,535,340,182,443,260,158
060730172022,767,487,280,794,490,304,886,562,306,761,502,219
060730189031,815,321,494,831,322,509,860,359,485,823,291,484
060730189033,533,287,246,545,277,268,803,386,398,353,195,132
060730189034,234,141,93,238,134,104,354,199,145,293,160,111
060730189042,273,145,128,277,140,137,371,208,154,285,139,129
060730189032,194,73,121,198,74,124,277,111,160,217,75,131
060730190012,805,310,495,821,303,518,1163,465,680,871,309,516
060730188012,903,308,595,922,300,622,1204,477,706,971,327,594
060730188042,1132,345,787,1172,350,822,1424,549,848,1174,341,778
060730188051,845,286,559,867,283,584,1232,496,711,954,298,607
060730188052,894,342,552,911,337,574,1029,412,599,931,320,577
060730190014,578,208,370,582,205,377,710,282,418,607,201,381
060730190021,828,357,471,844,343,501,1834,829,948,671,265,365
060730189043,289,145,144,293,141,152,577,276,285,304,147,137
060730189044,754,338,416,766,333,433,1080,545,507,840,369,425
060730189053,614,275,339,618,263,355,696,351,326,703,302,360
060730190013,1108,401,707,1127,401,726,1390,558,804,1341,440,835
060730189063,1047,357,690,1068,357,711,1388,534,828,1158,433,678
060730188011,1033,352,681,1044,344,700,1245,517,701,1111,363,690
060730188043,1140,374,766,1172,379,793,1415,543,844,1211,393,762
060730189041,152,99,53,155,95,60,298,168,123,189,114,56
060730189051,257,166,91,261,161,100,517,289,213,323,194,95
060730189052,131,83,48,132,82,50,260,132,120,156,93,46
060730189061,338,191,147,345,186,159,640,358,263,436,225,177
060730189062,247,122,125,255,120,135,374,209,152,262,122,125
060730189054,566,260,306,573,249,324,781,393,367,667,267,366
060730188041,905,284,621,925,281,644,1179,475,682,930,281,613
060730188031,348,111,237,360,106,254,245,86,156,135,41,89
060730186191,780,254,526,801,260,541,1030,392,614,779,263,478
060730188034,862,298,564,882,292,590,1187,459,702,1004,329,623
060730188032,569,200,369,581,198,383,661,249,404,524,179,318
060730188033,536,249,287,549,248,301,776,330,428,590,244,303
060730192051,328,206,122,336,201,135,476,295,169,357,189,139
060730192061,299,203,96,304,196,108,447,303,129,296,180,93
060730192062,390,254,136,399,246,153,583,379,190,465,260,177
060730192052,686,372,314,701,365,336,985,568,394,750,402,300
060730192053,394,214,180,405,215,190,568,330,224,459,244,189
060730192032,790,412,378,813,414,399,1093,565,498,904,446,405
060730194052,186,117,69,193,118,75,361,216,134,259,140,100
060730194053,332,240,92,338,235,103,516,308,192,377,240,107
060730194063,522,307,215,535,306,229,706,426,260,574,301,226
060730195022,346,240,106,353,235,118,533,336,180,255,178,57
060730195032,259,142,117,264,142,122,384,206,170,350,174,159
060730196013,770,409,361,792,404,388,990,506,452,854,430,366
060730196021,605,303,302,621,310,311,764,391,348,629,287,308
060730192092,985,341,644,1006,333,673,1321,550,743,1095,385,651
060730192091,698,294,404,715,303,412,848,393,436,717,306,363
060730192101,987,469,518,1012,470,542,1267,654,581,934,434,435
060730196011,713,346,367,739,342,397,1197,619,539,871,400,410
060730192082,1005,409,596,1026,416,610,1214,594,594,1072,410,588
060730196022,1082,504,578,1105,513,592,1357,675,647,1108,475,578
060730199044,569,286,283,581,283,298,755,407,332,632,283,308
060730199051,730,374,356,748,373,375,889,506,365,1042,510,467
060730199052,458,230,228,469,227,242,585,332,239,485,236,219
060730199053,619,337,282,631,331,300,818,466,337,861,423,374
060730196023,284,150,134,291,150,141,455,265,175,275,131,123
060730197023,494,268,226,509,266,243,715,422,264,584,286,252
060730199021,996,518,478,1017,508,509,1361,738,595,1050,501,491
060730192103,156,103,53,159,104,55,247,144,98,242,129,96
060730196012,357,194,163,367,189,178,525,269,241,472,239,198
060730196014,385,210,175,396,204,192,562,290,257,486,217,232
060730192063,229,149,80,237,144,93,387,241,136,297,171,109
060730195023,206,134,72,214,129,85,316,197,108,321,195,98
060730192054,271,150,121,275,144,131,367,213,144,321,170,133
060730194041,368,252,116,373,244,129,540,369,154,426,269,130
060730194042,361,280,81,369,273,96,587,404,167,463,332,98
060730195011,242,188,54,248,183,65,418,284,119,273,197,58
060730195012,210,150,60,214,147,67,325,224,93,253,173,64
060730195021,194,169,25,198,166,32,375,257,108,215,174,27
060730192102,210,136,74,213,137,76,373,231,133,294,158,115
060730195031,397,292,105,410,287,123,658,393,247,447,279,142
060730195033,435,266,169,449,263,186,649,393,238,483,293,162
060730194061,529,312,217,544,315,229,576,348,212,502,253,213
060730194062,529,313,216,544,317,227,910,551,334,747,415,270
060730197011,1626,859,767,1661,846,815,2297,1231,1005,1563,766,688
060730197012,506,267,239,521,264,257,722,376,330,684,334,304
060730197021,458,211,247,465,201,264,605,312,275,493,197,259
060730197024,850,395,455,875,393,482,1056,554,476,887,360,465
060730197022,351,186,165,367,185,182,510,290,202,414,200,181
060730199031,1080,494,586,1103,499,604,1238,592,618,1209,533,610
060730199043,564,320,244,577,315,262,933,494,418,421,213,182
060730199042,428,246,182,435,242,193,581,337,229,522,251,229
060730200171,470,239,231,478,241,237,572,333,230,520,254,235
060730200172,313,185,128,319,184,135,438,262,167,361,182,156
060730192031,423,188,235,433,185,248,534,264,256,454,199,233
060730192081,678,277,401,688,279,409,878,400,458,722,277,395
060730199022,288,146,142,291,138,153,417,224,183,336,162,151
060730199032,917,440,477,937,442,495,1296,622,650,747,355,349
060730200173,107,74,33,107,71,36,219,121,95,149,68,73
060730200261,405,186,219,415,191,224,547,268,274,428,190,221
060730200263,861,388,473,882,388,494,1039,535,489,858,352,464
060730200444,1364,674,690,1399,668,731,2186,1195,954,1774,841,836
060730200443,1357,719,638,1395,722,673,1851,1026,789,1329,648,596
060730200422,1259,573,686,1288,585,703,1473,729,723,1283,568,680
060730200193,1240,666,574,1269,661,608,1629,891,705,1309,642,587
060730200361,223,141,82,229,139,90,331,211,110,262,184,64
060730200381,749,410,339,765,403,362,1412,804,574,1111,572,468
060730200391,833,459,374,856,452,404,1170,666,476,917,499,360
060730200213,411,245,166,417,238,179,860,520,316,549,308,206
060730200212,400,218,182,404,211,193,590,335,239,483,254,197
060730200214,430,290,140,434,281,153,629,434,182,476,315,129
060730200211,205,140,65,207,136,71,302,210,86,232,158,61
060730200412,469,246,223,482,244,238,670,404,248,520,274,208
060730200231,914,554,360,934,540,394,1347,774,538,869,449,360
060730200382,1111,569,542,1134,546,588,1422,746,638,1007,484,462
060730200401,1300,611,689,1337,606,731,1841,923,868,1518,674,742
060730203044,1736,771,965,1771,750,1021,2261,1143,1075,747,317,389
060730200411,372,205,167,385,205,180,506,334,162,397,218,156
060730200402,713,311,402,731,308,423,931,468,440,755,332,368
060730200294,253,148,105,260,145,115,406,223,175,298,153,126
060730200293,400,234,166,411,230,181,567,368,183,456,272,156
060730200262,934,478,456,957,470,487,1240,684,533,1034,514,453
060730200441,339,186,153,347,182,165,538,303,222,402,208,171
060730200232,858,431,427,870,435,435,1143,578,539,1090,481,546
060730200241,902,457,445,919,452,467,1179,595,558,983,457,469
060730200242,331,181,150,336,177,159,475,267,191,347,156,155
060730200251,521,289,232,532,284,248,913,513,369,619,320,258
060730200252,532,313,219,549,306,243,589,332,239,594,311,241
060730200291,394,261,133,401,254,147,761,525,218,319,185,112
060730200292,200,133,67,203,129,74,427,294,123,204,153,36
060730203111,890,386,504,909,375,534,1257,634,594,977,416,514
060730203103,677,320,357,695,312,383,832,426,388,739,341,357
060730200253,669,352,317,685,349,336,925,475,432,781,375,356
060730203091,735,350,385,749,347,402,1107,585,486,801,331,416
060730200243,448,219,229,460,213,247,631,354,255,492,222,228
060730200362,296,201,95,303,197,106,523,329,178,340,240,84
060730200371,164,111,53,167,109,58,290,182,98,211,109,87
060730200372,929,576,353,957,563,394,1322,816,468,1082,620,397
060730200192,647,370,277,651,360,291,883,512,356,743,402,309
060730200191,1150,561,589,1174,563,611,1471,821,623,1216,564,610
060730203102,347,212,135,357,211,146,626,382,226,408,237,140
060730203101,1236,806,430,1270,799,471,1800,1073,682,1511,860,541
060730171131,842,459,383,865,445,420,1234,725,484,925,475,385
060730200442,302,153,149,310,150,160,413,227,180,323,163,139
060730200431,1358,686,672,1407,694,713,1886,1102,742,931,471,399
060730200432,883,493,390,912,500,412,1249,733,489,909,486,366
060730200283,134,106,28,136,101,35,260,179,74,158,118,28
060730200282,64,51,13,67,50,17,123,84,36,75,56,13
060730200281,170,134,36,173,129,44,326,224,94,201,150,36
060730203112,462,243,219,478,241,237,141,76,63,181,79,96
060730203121,909,406,503,932,405,527,1867,917,904,994,406,512
060730203131,469,229,240,482,229,253,1807,965,794,556,223,288
060730170641,552,326,226,564,324,240,836,526,297,612,362,221
060730170642,682,409,273,698,413,285,1047,658,370,826,514,271
060730170643,725,427,298,744,430,314,1087,674,393,798,481,277
060730170703,293,180,113,301,184,117,446,284,153,377,218,134
060730170701,905,498,407,928,504,424,1243,758,463,967,552,368
060730170702,863,474,389,886,475,411,1259,774,458,921,531,350
060730170712,895,487,408,911,489,422,1263,772,467,964,529,377
060730171062,649,253,396,666,244,422,851,398,431,716,296,383
060730170612,1445,528,917,1485,533,952,1730,832,868,1433,572,794
060730170623,509,178,331,527,177,350,609,279,318,512,208,279
060730171064,644,236,408,657,231,426,791,342,438,736,294,412
060730171063,729,257,472,745,251,494,916,415,488,761,295,425
060730111002,607,278,329,621,287,334,735,388,331,630,294,293
060730111003,345,155,190,352,161,191,426,229,192,372,176,177
060730218002,497,217,280,519,233,286,622,327,276,600,268,287
060730109001,415,189,226,425,189,236,540,284,240,461,212,217
060730110001,632,292,340,644,304,340,807,426,361,670,335,296
060730111001,896,443,453,910,439,471,1123,590,499,1003,478,452
060730110002,654,295,359,670,295,375,843,451,380,724,343,337
060730216001,194,80,114,200,83,117,419,217,189,238,103,120
060730216002,346,143,203,358,153,205,530,279,237,417,179,208
060730218001,470,204,266,487,217,270,633,338,286,563,266,272
060730108001,558,259,299,570,264,306,705,371,317,637,298,306
060730108002,571,265,306,591,275,316,711,379,325,664,296,320
060730109002,460,213,247,476,223,253,612,326,276,530,246,252
060730106012,596,257,339,609,262,347,742,376,356,665,286,351
060730106011,524,191,333,539,203,336,592,299,284,580,246,311
060730102021,333,190,143,340,187,153,512,281,209,366,180,156
060730102022,385,210,175,385,202,183,528,292,221,451,243,172
060730102013,245,140,105,247,135,112,349,191,148,246,124,105
060730105011,452,265,187,460,258,202,679,381,272,620,316,251
060730105023,330,210,120,342,209,133,537,331,193,396,259,119
060730105024,303,182,121,308,179,129,557,338,198,363,222,115
060730105022,227,139,88,231,137,94,380,219,148,288,191,79
060730103003,307,190,117,308,184,124,516,295,211,428,233,161
060730103004,280,165,115,287,161,126,375,217,152,371,206,141
060730102023,392,227,165,398,219,179,529,299,213,472,248,187
060730102012,376,195,181,387,194,193,504,281,221,456,200,226
060730103001,284,162,122,286,155,131,471,254,199,397,186,184
060730103002,496,275,221,502,264,238,772,404,345,590,345,214
060730104022,290,143,147,295,138,157,367,217,135,343,177,147
060730191091,961,364,597,995,358,637,1659,691,919,1229,416,743
060730191081,471,232,239,481,227,254,1053,556,473,786,388,337
060730191092,457,241,216,463,239,224,678,378,282,467,230,191
060730191093,443,170,273,453,165,288,606,248,344,488,157,300
060730191082,211,93,118,214,92,122,311,133,172,236,76,146
060730191103,667,257,410,684,250,434,618,262,345,511,161,322
060730191101,748,222,526,766,221,545,919,387,514,765,212,516
060730191102,717,218,499,734,217,517,976,371,589,767,223,500
060730191031,582,209,373,595,214,381,662,257,393,672,215,420
060730191034,492,190,302,504,189,315,651,261,378,532,180,317
060730191032,939,322,617,964,313,651,1387,524,835,974,300,612
060730191033,843,323,520,867,329,538,1209,483,704,903,332,521
060730191052,929,314,615,949,307,642,1196,452,723,978,311,602
060730201103,730,280,450,746,272,474,1120,461,634,901,342,502
060730191111,640,251,389,654,243,411,967,374,571,731,252,438
060730191112,540,206,334,550,200,350,790,314,456,561,195,338
060730191071,926,282,644,955,288,667,1194,446,728,984,299,642
060730191113,473,145,328,482,143,339,613,232,370,567,168,361
060730191051,720,239,481,732,234,498,852,349,489,793,266,490
060730191053,1094,400,694,1114,400,714,1371,559,783,1107,404,626
060730201112,484,179,305,501,176,325,619,248,353,529,180,326
060730191054,833,310,523,851,309,542,1102,450,635,922,337,539
060730201111,893,356,537,917,357,560,1228,541,658,986,369,558
060730201051,520,226,294,532,209,323,734,346,364,606,247,312
060730201101,1356,609,747,1393,613,780,2079,1008,1029,1378,590,696
060730201113,443,176,267,457,171,286,624,250,355,527,181,320
060730203051,1621,762,859,1662,759,903,2236,1094,1092,1832,769,949
060730203053,543,268,275,559,269,290,790,379,391,643,269,331
060730203092,405,259,146,413,252,161,621,366,241,474,276,166
060730207053,998,452,546,1021,439,582,1395,651,713,1094,420,611
060730207063,355,155,200,367,158,209,580,288,276,372,148,189
060730207061,630,253,377,651,259,392,772,343,411,688,274,367
060730206024,694,352,342,707,335,372,992,516,450,763,366,348
060730207064,1084,439,645,1102,435,667,1399,670,693,1138,467,611
060730207071,373,201,172,380,201,179,666,400,248,430,226,175
060730207081,1019,473,546,1041,471,570,1474,743,684,1125,485,554
060730207082,548,255,293,561,257,304,722,375,324,607,275,286
060730207062,1266,483,783,1295,482,813,1414,620,763,1348,505,765
060730204011,628,229,399,644,229,415,736,339,383,667,253,384
060730204012,852,380,472,870,383,487,1018,525,476,887,405,439
060730204032,815,355,460,837,355,482,1104,513,565,891,399,427
060730204042,552,294,258,564,290,274,766,388,358,547,254,245
060730204043,1241,518,723,1268,514,754,1617,746,840,1401,555,765
060730204051,764,286,478,776,285,491,915,425,477,799,294,472
060730204052,1115,428,687,1137,420,717,1373,630,717,1175,449,675
060730201052,286,133,153,294,127,167,400,202,187,349,151,171
060730201053,573,289,284,587,276,311,865,437,412,677,314,314
060730203052,262,132,130,268,133,135,331,191,131,318,154,140
060730207111,1120,462,658,1147,458,689,1848,871,943,1208,485,646
060730207122,706,302,404,719,299,420,997,466,512,731,295,392
060730203041,754,309,445,775,313,462,1041,496,526,1887,802,956
060730203043,471,195,276,486,202,284,650,314,324,516,206,280
060730203081,348,193,155,356,194,162,511,308,187,419,234,153
060730203083,956,524,432,974,525,449,1397,822,542,1186,580,528
060730203082,260,161,99,265,157,108,408,241,159,290,169,101
060730201061,857,398,459,874,388,486,1229,614,580,878,363,464
060730201062,472,252,220,480,242,238,703,374,316,509,249,230
060730201071,864,391,473,882,384,498,1257,584,648,944,405,475
060730201072,565,254,311,574,246,328,737,372,344,637,278,325
060730201091,344,201,143,348,190,158,457,281,165,395,205,164
060730201094,448,256,192,455,251,204,612,410,193,527,302,191
060730202061,362,216,146,369,205,164,504,295,198,414,212,175
060730202111,315,181,134,324,176,148,440,293,135,379,205,147
060730201102,1080,547,533,1106,532,574,1283,672,587,939,445,444
060730201092,408,254,154,418,241,177,557,324,220,485,260,183
060730202081,718,414,304,735,401,334,1055,611,416,770,369,347
060730207112,483,214,269,494,213,281,688,315,362,496,197,264
060730202101,744,418,326,759,404,355,1095,596,475,840,432,361
060730202024,158,118,40,159,111,48,278,192,77,187,126,44
060730202023,115,85,30,115,80,35,222,151,61,137,92,32
060730202131,131,97,34,131,91,40,249,173,69,158,108,38
060730202142,86,65,21,87,61,26,186,130,51,108,74,25
060730202021,329,243,86,335,236,99,599,397,189,370,267,78
060730202022,196,142,54,198,137,61,343,228,109,269,188,67
060730202133,108,80,28,109,77,32,178,115,55,145,104,30
060730202141,302,184,118,308,180,128,495,303,176,354,211,117
060730202144,111,82,29,113,79,34,203,133,62,138,99,29
060730202143,108,74,34,109,72,37,175,115,59,135,89,39
060730201081,256,170,86,261,164,97,386,266,108,324,186,114
060730201083,252,169,83,255,162,93,400,275,112,304,184,99
060730201084,257,172,85,261,165,96,370,254,103,301,182,98
060730201093,266,152,114,269,152,117,375,247,118,309,183,107
060730201082,167,108,59,173,106,67,215,148,60,243,139,86
060730202062,354,260,94,360,250,110,554,368,176,400,270,110
060730202063,190,133,57,194,127,67,316,209,100,223,142,67
060730202112,470,317,153,480,309,171,684,456,217,538,352,155
060730205002,353,237,116,358,229,129,592,362,211,413,270,115
060730205003,414,235,179,422,227,195,557,352,191,510,307,164
060730206012,299,195,104,306,190,116,470,293,161,321,198,101
060730206013,315,224,91,315,212,103,514,319,175,354,234,90
060730202132,156,111,45,158,106,52,241,157,72,164,104,47
060730206021,169,121,48,172,115,57,255,166,77,220,137,62
060730203132,536,270,266,549,265,284,736,411,300,572,296,240
060730202113,370,236,134,376,227,149,599,382,201,453,272,145
060730202114,173,110,63,175,106,69,294,188,99,257,154,83
060730202071,299,220,79,306,213,93,509,358,131,361,251,83
060730202072,318,234,84,323,225,98,641,414,215,392,281,83
060730202091,532,300,232,541,289,252,660,426,219,581,298,257
060730207123,688,297,391,702,292,410,839,448,372,813,331,434
060730202102,541,349,192,554,344,210,882,470,389,624,366,215
060730202092,462,315,147,470,310,160,725,469,242,544,342,164
060730202093,153,104,49,155,103,52,220,144,74,189,119,56
060730207121,653,289,364,664,282,382,869,463,382,705,290,371
060730207051,457,224,233,474,225,249,641,336,287,558,261,252
060730207052,573,307,266,592,302,290,684,360,315,563,233,292
060730206011,415,234,181,428,234,194,555,349,183,424,238,154
060730206022,406,245,161,418,239,179,614,372,215,496,273,183
060730206023,444,263,181,466,269,197,615,376,221,470,260,175
060730204031,684,343,341,700,333,367,1046,580,436,855,415,387
060730205001,341,188,153,347,181,166,445,268,155,374,197,153
060730203122,957,441,516,985,450,535,698,389,287,1026,459,494
060730204041,356,198,158,363,194,169,546,303,225,400,199,174
060730207073,576,338,238,590,323,267,767,473,272,593,287,264
060730207072,173,102,71,177,97,80,270,180,81,270,145,105
060730207101,998,429,569,1014,421,593,830,405,403,1078,480,534
060730170063,500,211,289,514,213,301,622,305,303,520,225,255
060730170061,848,334,514,868,332,536,1066,524,517,891,364,458
060730170202,842,374,468,876,389,487,1041,510,505,907,413,432
060730170203,695,270,425,713,273,440,929,416,492,607,228,349
060730170201,620,259,361,642,266,376,782,383,380,658,273,350
060730170531,867,367,500,887,369,518,1073,529,518,903,421,427
060730170532,964,403,561,989,406,583,1229,615,585,1052,451,533
060730170543,451,206,245,460,204,256,604,309,282,523,232,260
060730170544,1214,536,678,1241,536,705,1560,794,728,1358,614,670
060730170211,942,357,585,967,358,609,1199,591,585,1026,409,543
060730170212,797,291,506,815,290,525,1000,416,561,976,361,556
060730170541,736,316,420,753,315,438,957,487,448,798,346,394
060730170401,718,332,386,734,333,401,1158,603,531,1017,480,481
060730170411,972,440,532,999,453,546,1194,621,545,1042,454,512
060730170501,596,288,308,610,291,319,792,439,328,643,306,306
060730170402,625,274,351,639,282,357,805,419,365,672,300,334
060730170412,726,362,364,748,361,387,1002,521,457,785,374,344
060730170413,346,175,171,355,173,182,494,258,226,391,185,179
060730170542,390,160,230,402,160,242,484,246,225,411,174,205
060730170091,1114,494,620,1147,497,650,1380,689,650,1308,533,671
060730170101,598,269,329,621,262,359,805,425,360,647,291,309
060730170102,788,340,448,811,333,478,1084,564,490,938,393,483
060730170092,542,246,296,558,241,317,932,464,437,639,261,322
060730170414,624,311,313,638,307,331,771,385,361,681,307,332
060730170403,553,272,281,566,276,290,649,338,295,535,257,246
060730170481,409,198,211,421,196,225,641,333,289,463,220,205
060730170482,428,206,222,438,202,236,650,338,294,485,236,214
060730170483,657,326,331,678,329,349,1024,532,464,782,386,344
060730170484,381,201,180,394,208,186,525,273,237,419,206,186
060730170492,723,345,378,751,349,402,1063,553,480,845,377,404
060730170491,435,213,222,451,205,246,576,299,260,482,216,230
060730166211,1198,509,689,1237,496,741,1563,669,853,1407,535,788
060730166201,1162,493,669,1205,481,724,1565,671,856,1302,462,745
060730166102,840,313,527,868,307,561,1124,470,623,1123,361,690
060730166142,866,378,488,891,379,512,1252,532,689,1003,402,525
060730166151,495,227,268,510,226,284,774,304,454,566,260,269
060730166073,610,215,395,627,216,411,691,259,414,604,198,367
060730166072,940,395,545,975,386,589,1362,570,755,964,356,545
060730166081,1178,368,810,1218,355,863,1719,609,1071,1459,417,961
060730166092,435,171,264,452,171,281,625,245,365,472,138,299
060730166093,778,291,487,809,290,519,1137,437,671,820,305,460
060730166091,1000,336,664,1035,330,705,1259,496,733,1107,347,680
060730166101,875,384,491,898,368,530,1266,530,701,924,372,485
060730166071,668,198,470,688,200,488,911,359,529,783,220,514
060730166074,619,256,363,629,249,380,878,368,489,741,267,452
060730166171,463,191,272,474,189,285,658,277,366,526,196,299
060730166152,523,213,310,541,210,331,746,325,404,574,225,310
060730166062,741,318,423,753,312,441,1003,429,547,870,306,491
060730166212,359,133,226,366,126,240,700,325,355,397,123,247
060730166061,738,316,422,766,306,460,1029,454,544,853,324,473
060730166132,607,242,365,621,238,383,807,347,441,713,261,410
060730166131,331,133,198,340,135,205,455,197,249,377,147,208
060730166141,703,326,377,728,321,407,1043,464,552,806,323,421
060730166181,719,353,366,740,355,385,1197,555,611,1101,475,566
060730166192,934,443,491,948,429,519,1322,613,675,1062,434,552
060730166182,573,252,321,590,238,352,799,370,411,653,244,363
060730166191,509,209,300,518,204,314,767,356,391,625,265,335
060730166193,380,157,223,386,151,235,473,219,242,284,121,152
060730166161,480,209,271,490,205,285,742,346,380,565,215,314
060730166162,975,364,611,1011,359,652,1454,656,759,1141,396,683
060730162021,263,129,134,264,125,139,453,220,222,366,164,177
060730166172,591,297,294,604,297,307,897,416,458,725,286,391
060730166173,175,75,100,181,75,106,282,121,155,213,79,121
060730167041,1082,450,632,1104,443,661,1502,603,867,1257,468,720
060730167031,638,262,376,652,253,399,957,403,536,753,279,436
060730167042,633,272,361,651,261,390,975,410,538,763,313,411
060730167043,883,328,555,905,318,587,1249,489,728,1027,368,607
060730162012,987,431,556,1009,419,590,1263,615,619,1048,458,539
060730162013,1187,494,693,1214,483,731,1525,755,731,1289,529,695
060730162011,826,309,517,851,307,544,1065,531,503,877,364,459
060730163011,529,258,271,543,249,294,808,435,354,672,315,316
060730165024,331,133,198,340,128,212,758,356,388,445,170,255
060730165041,470,270,200,476,260,216,798,418,357,604,308,250
060730165045,338,183,155,345,179,166,637,322,298,445,227,187
060730165042,174,88,86,177,85,92,311,154,152,200,99,89
060730163021,301,163,138,308,157,151,502,231,262,368,178,168
060730163022,408,222,186,420,217,203,738,383,334,553,284,236
060730163023,289,160,129,297,155,142,509,267,223,387,201,159
060730165022,432,240,192,443,237,206,796,418,356,574,269,262
060730165023,511,281,230,524,276,248,662,333,311,654,335,282
060730164013,889,335,554,913,325,588,1182,456,693,828,274,510
060730165021,408,159,249,416,143,273,562,233,316,434,143,261
060730164012,642,283,359,656,277,379,977,411,542,989,383,552
060730168074,673,253,420,682,252,430,998,410,565,731,265,427
060730168091,477,169,308,489,169,320,887,329,541,570,175,364
060730164011,344,115,229,355,117,238,442,179,256,427,131,283
060730164031,1063,316,747,1090,310,780,1411,450,940,1174,333,786
060730156011,597,279,318,615,275,340,1039,434,581,770,306,420
060730164032,325,127,198,332,126,206,457,172,278,375,133,222
060730164033,241,124,117,246,122,124,482,205,265,325,135,171
060730164042,371,191,180,378,187,191,702,298,386,498,248,218
060730156022,495,161,334,505,158,347,595,222,363,522,169,335
060730164041,273,123,150,278,121,157,471,201,258,314,131,165
060730161001,1057,536,521,1079,520,559,1450,721,684,1243,569,601
060730161002,815,392,423,836,388,448,1093,546,515,922,432,446
060730160002,802,356,446,820,367,453,1027,518,482,886,386,447
060730151001,535,295,240,551,287,264,712,418,273,577,303,226
060730151002,748,410,338,768,399,369,1015,594,388,857,458,331
060730159011,177,128,49,181,128,53,376,231,135,254,164,76
060730159012,170,122,48,173,122,51,388,238,139,239,153,72
060730160001,146,106,40,148,105,43,306,189,110,241,141,78
060730162022,465,317,148,478,307,171,866,477,366,582,346,192
060730158012,272,180,92,283,180,103,443,246,187,303,183,101
060730158011,295,189,106,296,180,116,632,367,254,392,204,165
060730163012,226,135,91,229,130,99,430,237,180,291,153,116
060730163013,275,165,110,279,158,121,513,284,215,356,188,143
060730157011,210,125,85,218,126,92,393,217,165,260,153,90
060730157014,174,104,70,179,104,75,333,183,140,225,117,91
060730157013,181,108,73,187,108,79,360,198,151,225,126,85
060730157012,266,159,107,276,160,116,499,274,209,340,204,115
060730156021,777,221,556,802,224,578,1021,321,681,862,234,590
060730157041,400,211,189,408,211,197,736,324,396,506,232,236
060730156013,272,145,127,276,145,131,489,215,262,327,150,153
060730157051,245,140,105,251,144,107,501,247,246,314,166,128
060730157061,308,179,129,315,185,130,612,303,301,396,210,162
060730157042,405,207,198,416,205,211,752,364,377,538,240,268
060730158021,106,55,51,107,57,50,265,114,145,147,76,62
060730158024,183,96,87,187,97,90,375,157,206,272,140,116
060730158023,202,106,96,209,107,102,378,164,210,294,151,123
060730154071,527,269,258,537,262,275,980,402,561,639,270,330
060730157052,271,162,109,277,158,119,636,281,341,415,216,164
060730158022,176,120,56,178,116,62,341,212,124,224,148,68
060730159022,290,162,128,295,156,139,484,232,239,355,184,155
060730159021,250,121,129,254,115,139,348,164,182,284,131,144
060730159023,309,148,161,316,141,175,460,212,234,359,160,184
060730153022,663,303,360,677,302,375,960,463,474,743,339,366
060730153021,744,369,375,759,368,391,913,465,429,821,386,392
060730153023,402,194,208,409,186,223,615,281,328,480,210,245
060730154031,621,272,349,638,267,371,862,397,447,721,287,397
060730154032,685,302,383,701,297,404,813,405,389,717,306,367
060730159024,295,181,114,300,172,128,558,307,235,427,226,178
060730153011,318,166,152,326,158,168,595,251,328,415,212,182
060730153012,342,180,162,352,174,178,615,261,340,392,200,167
060730154072,206,108,98,210,101,109,437,184,240,253,128,112
060730154081,767,279,488,786,282,504,976,376,581,874,315,517
060730154082,706,294,412,727,296,431,1024,400,600,819,292,481
060730156012,787,268,519,809,269,540,1169,429,724,943,324,580
060730154051,723,288,435,737,281,456,1168,423,726,900,337,517
060730165043,154,90,64,157,88,69,298,157,131,210,106,88
060730165044,119,70,49,122,70,52,213,113,94,167,84,71
060730165031,511,228,283,519,219,300,722,338,362,572,211,323
060730165032,434,184,250,444,180,264,664,290,361,564,201,327
060730168063,434,197,237,441,195,246,737,309,412,522,201,287
060730168061,567,199,368,581,194,387,842,302,517,657,200,420
060730168062,269,94,175,275,92,183,376,136,231,313,96,201
060730168072,1051,335,716,1074,323,751,1416,500,879,1240,327,850
060730168073,1081,349,732,1113,333,780,1426,555,837,1099,364,669
060730148041,490,284,206,501,287,214,610,369,229,504,280,196
060730148043,656,392,264,668,397,271,830,529,279,738,427,272
060730150011,769,444,325,793,438,355,861,517,324,872,464,347
060730150013,400,230,170,410,227,183,720,436,269,446,239,178
060730151003,374,228,146,380,217,163,582,347,219,446,238,177
060730151004,412,248,164,422,238,184,607,362,231,510,266,205
060730150021,394,246,148,406,242,164,683,411,254,441,245,172
060730150022,210,131,79,214,128,86,403,242,149,232,128,90
060730150012,583,356,227,611,347,264,823,496,308,680,354,287
060730148031,680,383,297,703,387,316,1027,643,358,813,440,318
060730148032,713,416,297,723,416,307,927,590,312,841,484,308
060730148033,367,206,161,380,210,170,502,321,167,413,223,162
060730149023,517,320,197,531,321,210,713,460,233,533,307,192
060730148044,331,198,133,337,195,142,478,288,178,368,209,136
060730148042,499,313,186,509,315,194,655,417,220,587,354,195
060730148052,673,436,237,687,427,260,1005,640,337,760,459,243
060730148051,376,246,130,382,240,142,564,359,189,460,290,139
060730148061,346,231,115,356,233,123,570,362,190,400,253,117
060730148062,404,270,134,412,267,145,696,443,234,541,347,156
060730147011,616,381,235,631,375,256,854,549,280,704,400,255
060730147021,682,434,248,700,425,275,927,602,304,765,460,256
060730147013,711,430,281,720,421,299,934,604,309,763,419,297
060730147012,353,236,117,361,231,130,504,326,164,393,241,125
060730146013,777,505,272,804,506,298,1051,676,342,844,502,275
060730146011,725,483,242,740,476,264,1088,703,355,794,488,249
060730146021,823,519,304,850,521,329,993,644,325,939,545,318
060730149011,528,344,184,539,339,200,676,434,220,583,335,209
060730149012,746,463,283,768,459,309,1027,661,335,825,479,284
060730149013,692,436,256,709,431,278,912,590,299,790,446,284
060730149022,583,368,215,593,364,229,641,420,211,626,361,224
060730149021,334,205,129,340,205,135,412,266,135,353,201,129
060730152001,743,365,378,762,368,394,936,539,378,850,422,384
060730152002,550,282,268,566,290,276,623,390,216,581,289,258
060730152003,546,278,268,559,284,275,624,380,227,559,279,253
060730152004,486,245,241,499,248,251,548,323,213,486,244,223
060730138011,782,437,345,802,435,367,1103,663,407,924,495,374
060730146022,352,216,136,363,213,150,545,353,177,387,229,133
060730145001,463,303,160,476,298,178,720,479,225,562,352,177
060730146012,242,142,100,250,141,109,337,219,111,261,148,96
060730146023,695,428,267,712,418,294,1046,683,337,800,471,276
060730145002,441,288,153,457,286,171,704,470,217,514,324,161
060730145003,342,223,119,351,222,129,452,306,141,393,253,118
060730136011,495,242,253,505,242,263,590,326,249,501,246,231
060730136012,806,427,379,819,420,399,1075,615,433,903,466,389
060730136013,739,374,365,757,370,387,1026,580,420,822,411,372
060730136053,809,413,396,824,412,412,988,532,436,859,438,385
060730137011,847,422,425,864,420,444,995,570,399,862,440,370
060730137012,413,208,205,420,205,215,525,301,209,460,230,200
060730135032,558,329,229,569,319,250,950,525,400,674,373,253
060730136014,227,148,79,230,142,88,423,242,169,278,171,86
060730138012,376,199,177,385,198,187,541,317,210,490,252,206
060730138013,505,299,206,517,302,215,709,425,267,586,349,195
060730137021,717,360,357,733,360,373,1082,635,418,897,470,385
060730137022,309,177,132,314,175,139,529,310,204,349,192,133
060730137023,403,224,179,409,222,187,594,348,227,474,260,181
060730138022,258,172,86,260,164,96,461,271,177,339,216,104
060730135031,529,254,275,542,246,296,730,383,334,614,283,292
060730135042,337,164,173,347,161,186,495,273,213,410,199,193
060730139062,575,342,233,579,333,246,861,511,320,661,379,237
060730139063,548,336,212,556,328,228,824,538,265,665,399,223
060730139072,467,319,148,474,310,164,943,618,299,786,552,186
060730139051,618,359,259,631,357,274,975,599,350,741,418,273
060730139053,326,194,132,330,190,140,491,303,175,382,226,131
060730138021,406,281,125,409,263,146,722,425,279,526,334,161
060730135051,979,501,478,993,489,504,1436,759,649,1234,602,574
060730135052,612,329,283,626,328,298,732,398,318,615,334,246
060730135053,218,116,102,221,112,109,422,231,183,251,129,109
060730135033,875,426,449,894,416,478,1203,623,559,1029,478,496
060730135043,741,381,360,755,370,385,1079,592,463,828,413,374
060730135041,330,194,136,337,190,147,491,284,194,372,204,150
060730139091,472,311,161,481,287,194,837,509,302,607,393,175
060730139092,665,413,252,674,393,281,1126,690,413,908,572,283
060730139061,204,129,75,207,125,82,346,227,110,246,155,77
060730140021,587,362,225,596,343,253,896,580,294,756,448,255
060730139071,219,144,75,223,140,83,437,286,138,308,210,82
060730139052,375,228,147,384,217,167,625,383,222,418,255,137
060730031081,523,306,217,535,287,248,851,555,280,720,413,260
060730140022,788,468,320,803,457,346,1177,753,390,937,568,309
060730031082,343,209,134,348,197,151,594,378,200,487,297,164
060730139081,335,235,100,347,229,118,485,298,181,406,253,133
060730139082,634,446,188,644,427,217,972,598,343,732,479,214
060730134232,1077,619,458,1095,608,487,1688,991,675,1244,740,455
060730139031,482,258,224,490,254,236,738,450,270,617,338,245
060730139032,822,421,401,835,411,424,1195,725,437,1051,563,431
060730032142,378,261,117,382,250,132,591,377,201,441,296,129
060730135063,438,263,175,446,248,198,781,426,337,564,291,242
060730135061,361,205,156,371,194,177,632,345,274,458,232,204
060730135062,322,177,145,332,166,166,497,268,217,393,199,178
060730144001,499,378,121,503,372,131,945,611,309,623,433,152
060730144002,339,231,108,344,223,121,636,421,203,434,297,110
060730143001,748,490,258,761,477,284,1177,775,376,952,604,283
060730143002,370,234,136,374,229,145,574,380,187,435,276,130
060730140011,324,205,119,327,201,126,451,287,152,376,224,123
060730140014,431,275,156,437,269,168,639,406,212,492,286,172
060730140012,301,183,118,303,183,120,428,272,143,352,206,125
060730141011,670,438,232,684,423,261,940,596,316,733,431,257
060730140013,591,371,220,604,361,243,820,519,275,712,426,246
060730142001,801,507,294,815,505,310,1175,776,376,921,549,315
060730142002,334,212,122,340,212,128,543,356,171,427,256,144
060730142004,417,261,156,432,259,173,563,371,180,449,249,176
060730141012,591,386,205,606,371,235,852,547,290,705,446,212
060730032041,757,409,348,774,409,365,1066,626,420,854,463,340
060730032042,572,391,181,579,379,200,924,603,303,730,498,185
060730032071,660,379,281,670,374,296,876,515,342,780,450,292
060730032072,909,543,366,925,522,403,1267,723,524,1091,636,405
060730134123,785,435,350,793,423,370,1069,651,399,904,531,332
060730134122,302,150,152,310,150,160,477,273,197,374,189,162
060730032073,816,429,387,830,421,409,1176,667,483,942,509,392
060730134223,400,215,185,410,214,196,590,328,252,465,253,193
060730134222,540,286,254,553,288,265,754,431,310,611,315,266
060730134221,567,300,267,581,298,283,782,455,319,692,368,295
060730134112,546,283,263,555,282,273,739,422,303,639,340,265
060730134114,554,311,243,562,305,257,750,427,313,601,341,230
060730134111,1020,546,474,1042,538,504,1357,788,551,1087,603,433
060730134113,402,207,195,407,207,200,562,319,231,443,240,178
060730219001,354,273,81,356,250,106,530,373,148,263,200,50
060730219002,239,185,54,240,169,71,301,220,81,292,222,53
060730117001,513,367,146,529,354,175,855,557,284,662,463,167
060730117004,251,186,65,254,174,80,398,274,115,308,235,63
060730118011,386,297,89,395,283,112,567,400,157,478,379,80
060730118021,390,301,89,396,286,110,616,422,175,517,404,89
060730118024,95,71,24,97,68,29,235,165,63,128,101,21
060730118023,154,114,40,156,110,46,294,204,79,213,165,35
060730118022,418,323,95,422,308,114,657,456,176,568,448,90
060730122002,574,430,144,579,414,165,946,652,272,758,552,161
060730121021,355,259,96,362,247,115,559,384,160,456,327,108
060730121022,402,290,112,406,274,132,616,393,211,468,343,103
060730122001,237,178,59,238,172,66,372,258,108,314,231,68
060730118012,230,179,51,237,176,61,312,219,84,293,232,47
060730118013,231,182,49,231,172,59,317,223,88,286,228,47
060730220001,347,219,128,355,211,144,592,370,214,400,286,94
060730220002,424,290,134,431,269,162,798,506,278,565,404,128
060730119022,560,389,171,573,372,201,832,552,262,731,505,182
060730119023,292,218,74,300,215,85,439,300,129,359,266,74
060730119024,386,292,94,396,292,104,555,381,162,485,362,95
060730120031,348,229,119,358,223,135,511,314,189,427,273,127
060730117002,364,271,93,371,259,112,543,375,145,436,317,92
060730117003,389,292,97,394,274,120,545,379,148,478,366,87
060730120021,227,140,87,236,137,99,363,223,135,256,184,63
060730120022,560,344,216,579,336,243,897,551,334,600,430,144
060730120032,572,404,168,579,392,187,854,523,318,687,500,150
060730116011,282,224,58,288,213,75,458,323,131,350,265,61
060730116012,329,275,54,331,260,71,503,351,142,399,335,48
060730116013,568,473,95,572,448,124,825,574,234,705,591,86
060730116021,392,317,75,397,304,93,685,469,190,514,405,76
060730116022,185,147,38,186,139,47,381,264,108,276,221,40
060730121011,560,390,170,575,377,198,813,566,232,671,454,183
060730125021,291,220,71,295,212,83,504,352,139,370,280,67
060730125023,308,234,74,311,224,87,473,337,132,374,284,68
060730133223,372,221,151,382,221,161,748,474,260,524,337,157
060730133231,573,381,192,582,381,201,946,618,308,665,446,190
060730133232,490,313,177,499,311,188,785,506,267,595,394,170
060730133233,701,453,248,710,439,271,1160,757,381,834,556,247
060730133251,485,322,163,496,308,188,905,578,315,628,426,171
060730133252,215,144,71,217,136,81,401,255,140,272,186,73
060730133253,595,392,203,608,376,232,1056,675,368,774,517,212
060730134151,675,438,237,682,429,253,966,616,336,826,534,249
060730134182,829,572,257,842,561,281,1348,829,494,1114,791,273
060730134242,325,215,110,330,212,118,530,329,194,379,250,117
060730134183,538,298,240,549,291,258,722,444,265,607,338,241
060730134184,481,263,218,492,256,236,644,395,235,551,300,225
060730134162,758,409,349,770,393,377,1061,653,393,844,466,337
060730213061,889,528,361,903,513,390,1535,936,575,1144,678,404
060730134231,476,284,192,485,277,208,748,442,298,533,332,182
060730123032,540,357,183,550,350,200,680,447,218,703,434,225
060730124012,470,356,114,474,336,138,838,564,252,652,464,137
060730123031,760,508,252,770,483,287,1149,752,369,932,571,308
060730124011,324,205,119,329,196,133,461,306,147,350,211,118
060730124021,377,265,112,384,252,132,564,391,155,470,319,121
060730124022,406,284,122,412,270,142,610,430,171,516,352,133
060730124023,536,392,144,540,382,158,868,606,239,691,516,134
060730127002,443,328,115,447,318,129,677,475,189,618,457,131
060730125011,362,275,87,367,274,93,636,444,176,539,392,118
060730125022,239,181,58,241,180,61,405,283,112,345,251,76
060730126001,335,256,79,344,247,97,677,464,201,488,369,89
060730123021,548,386,162,561,376,185,857,569,269,694,470,177
060730127001,414,301,113,420,289,131,660,459,185,574,414,127
060730130001,425,292,133,434,283,151,641,438,190,591,390,177
060730123041,318,209,109,321,198,123,392,249,138,316,200,97
060730123042,1092,723,369,1102,689,413,1514,952,526,1385,873,420
060730128001,372,233,139,377,226,151,552,350,191,445,292,124
060730128003,601,386,215,606,375,231,872,545,305,701,455,206
060730127003,264,197,67,267,190,77,422,293,116,358,264,76
060730125012,290,221,69,296,213,83,569,386,168,445,336,81
060730128002,430,267,163,437,261,176,648,399,232,509,324,158
060730134011,989,602,387,1010,582,428,1360,834,495,1100,670,377
060730134012,852,508,344,871,493,378,1141,703,406,945,556,332
060730130002,405,267,138,418,262,156,587,403,175,504,343,134
060730130003,444,315,129,452,311,141,692,475,205,624,446,148
060730130004,304,206,98,312,204,108,451,311,133,424,287,114
060730126002,271,205,66,274,195,79,457,313,129,399,277,99
060730126003,365,277,88,369,264,105,641,439,182,467,356,85
060730129001,513,332,181,521,321,200,791,492,287,634,372,222
060730129002,344,210,134,352,202,150,484,300,176,411,237,146
060730129003,549,347,202,562,344,218,758,469,271,663,395,221
060730134092,766,470,296,781,454,327,1179,725,434,1252,755,425
060730134121,908,548,360,924,547,377,1344,842,478,1136,724,363
060730134091,504,302,202,510,293,217,686,404,272,620,343,240
060730133272,154,98,56,155,96,59,257,161,94,194,129,57
060730133273,442,282,160,448,278,170,790,494,287,589,389,172
060730134093,688,434,254,700,418,282,935,577,348,815,509,269
060730134142,709,451,258,719,436,283,1049,657,374,928,597,283
060730134144,1001,608,393,1019,580,439,1381,861,492,1187,715,411
060730134202,805,516,289,824,505,319,1222,786,409,661,439,187
060730134143,415,243,172,420,234,186,602,382,210,483,273,180
060730134141,735,454,281,744,441,303,1131,722,387,787,507,243
060730133011,1096,694,402,1113,674,439,1575,998,537,1371,827,460
060730131021,356,244,112,363,240,123,690,447,228,567,384,154
060730131022,348,239,109,351,232,119,701,452,230,448,336,86
060730126004,337,235,102,343,233,110,572,390,161,402,307,74
060730131042,254,181,73,257,173,84,398,268,120,358,259,80
060730131044,281,203,78,285,193,92,425,287,129,376,269,82
060730131031,210,166,44,211,160,51,423,293,120,325,252,53
060730131032,312,250,62,317,238,79,563,385,172,489,376,87
060730132062,343,271,72,345,261,84,635,441,179,519,384,110
060730133012,774,500,274,787,481,306,1112,716,364,965,615,290
060730133091,475,299,176,477,286,191,697,434,250,595,367,191
060730133093,385,241,144,392,235,157,575,357,203,499,298,170
060730133095,549,334,215,563,334,229,800,512,272,685,432,225
060730133021,788,511,277,794,482,312,1157,776,358,998,642,291
060730133022,855,577,278,867,553,314,1250,845,374,1078,716,291
060730131024,305,231,74,307,217,90,565,367,186,467,315,128
060730131023,404,308,96,411,290,121,713,462,236,519,390,99
060730133032,374,250,124,378,241,137,570,398,164,500,348,120
060730133033,381,257,124,388,248,140,565,394,162,543,376,132
060730133062,728,502,226,732,478,254,1046,720,299,939,644,246
060730133151,936,594,342,945,580,365,1468,924,518,1133,730,356
060730133152,368,232,136,372,225,147,603,381,212,438,282,139
060730133191,691,434,257,700,421,279,1114,713,385,768,474,259
060730133192,645,400,245,649,389,260,1032,661,356,714,452,227
060730133202,1019,652,367,1037,638,399,1645,1048,566,1239,782,395
060730133031,694,525,169,701,486,215,1203,828,342,891,690,161
060730132034,281,220,61,284,207,77,456,316,130,367,290,58
060730132033,208,163,45,211,156,55,365,251,103,293,230,48
060730132035,231,178,53,235,169,66,432,299,123,355,280,56
060730133092,432,263,169,447,263,184,596,384,205,540,370,147
060730133271,772,487,285,787,463,324,1281,813,444,941,598,295
060730133261,729,432,297,740,391,349,1168,731,425,918,568,303
060730133094,647,407,240,656,396,260,929,597,319,820,519,257
060730133221,642,406,236,651,397,254,1014,644,352,746,478,239
060730133162,892,575,317,910,557,353,1465,926,514,1095,714,319
060730133164,240,158,82,242,156,86,399,260,130,292,196,84
060730134243,825,515,310,837,497,340,1269,788,465,965,608,312
060730134241,862,565,297,875,550,325,1211,751,442,950,600,306
060730134181,407,283,124,416,277,139,625,385,230,507,358,117
060730133262,641,371,270,648,363,285,1185,755,413,789,498,268
060730133211,304,207,97,309,203,106,548,361,179,372,263,94
060730133212,637,437,200,643,432,211,1144,744,374,821,569,221
060730133213,461,313,148,468,303,165,846,551,277,556,384,141
060730133214,770,472,298,785,463,322,1222,797,400,917,578,309
060730133071,484,367,117,487,350,137,764,519,221,617,458,120
060730133072,587,433,154,592,417,175,1034,710,297,855,629,176
060730133082,321,239,82,326,231,95,600,413,166,435,321,90
060730133061,698,482,216,707,468,239,1090,751,313,938,657,227
060730133181,781,508,273,793,495,298,1036,682,341,796,507,253
060730133171,741,482,259,748,465,283,1852,1189,636,714,468,218
060730134201,265,189,76,269,189,80,502,323,167,297,212,62
060730134213,466,323,143,476,322,154,788,509,263,392,272,96
060730133081,589,480,109,593,458,135,1005,693,287,871,688,142
060730133172,1066,693,373,1086,659,427,2767,1782,940,1122,726,340
060730133173,1153,765,388,1175,741,434,3325,2136,1120,1091,721,320
060730133182,537,333,204,545,315,230,1069,689,359,697,461,195
060730133183,393,270,123,402,266,136,735,484,242,563,388,146
060730133184,304,208,96,309,206,103,578,381,192,440,302,116
060730133121,583,390,193,590,367,223,900,576,306,706,491,171
060730133122,286,213,73,292,206,86,494,316,168,356,248,87
060730133201,571,397,174,578,379,199,1082,693,369,684,452,197
060730133203,170,125,45,169,115,54,314,203,106,210,146,53
060730213062,770,460,310,782,444,338,1237,766,456,879,514,321
060730134212,929,568,361,943,555,388,1361,877,453,1326,864,406
060730134161,786,398,388,801,392,409,1051,601,440,902,477,382
060730134211,369,230,139,378,228,150,531,342,177,428,282,124
060730134171,936,538,398,961,533,428,1285,781,487,1124,675,396
060730133161,345,240,105,349,230,119,623,393,219,435,305,107
060730133163,928,559,369,952,545,407,1328,839,466,1145,696,383
060730134251,830,485,345,847,475,372,1258,781,460,951,577,344
060730133222,454,263,191,464,260,204,619,395,216,495,316,159
060730133241,588,430,158,598,421,177,1087,712,357,770,564,171
060730131041,326,261,65,331,248,83,652,440,197,528,406,95
060730131043,335,234,101,338,225,113,578,388,173,454,329,105
060730132063,681,483,198,683,464,219,1086,750,313,903,666,196
060730132031,276,216,60,278,207,71,507,343,154,401,308,71
060730132032,299,234,65,303,226,77,515,357,147,490,386,83
060730132041,299,216,83,301,208,93,489,343,133,452,357,73
060730132051,377,298,79,378,282,96,832,578,234,747,579,124
060730132043,387,296,91,389,282,107,566,417,146,577,453,98
060730132061,372,281,91,373,269,104,621,431,175,460,333,104
060730132042,286,225,61,288,210,78,426,290,123,396,301,71
060730209031,213,88,125,213,87,126,258,121,133,213,83,120
060730209033,477,168,309,483,167,316,606,231,356,567,184,349
060730209032,528,215,313,535,213,322,668,280,368,594,192,341
060730210021,576,308,268,587,308,279,512,278,223,532,283,224
060730208072,390,105,285,395,102,293,554,184,362,424,118,275
060730208071,993,278,715,1023,284,739,1308,463,804,1066,287,723
060730208101,627,200,427,642,198,444,854,283,548,724,207,471
060730208012,1155,349,806,1187,351,836,1399,487,877,1220,345,801
060730208013,936,314,622,959,311,648,1202,403,774,1035,316,658
060730208051,470,140,330,484,140,344,712,250,448,576,154,385
060730208052,703,251,452,719,242,477,1013,369,619,841,292,502
060730208062,654,175,479,681,177,504,989,344,617,762,182,540
060730208132,848,239,609,870,233,637,1089,361,706,869,225,601
060730208102,339,101,238,348,101,247,496,162,321,439,125,291
060730208111,746,228,518,764,228,536,1026,340,663,826,234,547
060730208112,1034,324,710,1059,331,728,1363,446,886,1115,301,761
060730208061,544,192,352,557,189,368,777,283,471,589,198,354
060730208133,678,216,462,697,214,483,1006,364,615,788,230,517
060730208121,552,181,371,572,176,396,837,311,507,687,204,459
060730208104,666,193,473,685,193,492,956,318,616,759,204,513
060730208103,810,233,577,830,231,599,1111,366,717,930,249,630
060730208113,981,319,662,1011,318,693,1313,436,847,1095,313,715
060730169021,874,281,593,893,272,621,1344,447,875,945,268,623
060730208064,290,100,190,295,100,195,487,173,298,395,120,248
060730208131,452,159,293,462,157,305,680,245,416,583,185,355
060730208063,278,95,183,288,99,189,501,174,313,317,94,203
060730208011,534,195,339,546,196,350,700,253,429,587,203,351
060730169013,717,226,491,733,221,512,970,317,630,807,227,541
060730169014,326,110,216,336,109,227,490,160,319,368,106,242
060730169015,549,185,364,563,185,378,787,258,511,638,184,420
060730169011,855,257,598,875,250,625,1123,368,729,923,263,610
060730169012,594,169,425,610,167,443,754,247,491,631,182,412
060730168042,538,214,324,553,210,343,860,313,514,663,219,399
060730168043,478,191,287,488,186,302,738,268,443,581,193,349
060730168121,924,248,676,945,241,704,1290,368,907,1045,265,741
060730168041,665,202,463,684,198,486,963,275,673,868,220,606
060730168113,561,166,395,574,158,416,829,250,562,702,196,471
060730167032,205,77,128,208,74,134,356,125,221,260,87,158
060730167051,671,259,412,685,256,429,981,355,594,764,256,461
060730167052,198,76,122,202,75,127,338,119,210,265,91,159
060730167053,474,172,302,483,168,315,747,263,464,590,191,365
060730167062,680,221,459,693,214,479,946,332,588,808,234,530
060730168044,389,152,237,398,147,251,655,237,394,504,154,311
060730168101,1214,393,821,1257,383,874,1619,546,1025,1372,383,899
060730168132,1126,330,796,1154,333,821,1413,437,953,1223,338,841
060730168112,593,182,411,606,172,434,861,281,567,720,203,489
060730168111,764,238,526,779,230,549,825,265,547,897,262,592
060730168071,383,117,266,392,114,278,491,179,294,433,118,292
060730167061,324,108,216,331,106,225,530,186,329,366,108,238
060730168093,794,265,529,810,254,556,1404,477,904,941,284,614
060730168131,687,198,489,701,198,503,889,250,625,732,191,514
060730155013,974,299,675,1004,290,714,1425,402,1000,1128,308,769
060730168122,420,129,291,424,133,291,528,149,371,472,133,318
060730155021,589,184,405,600,184,416,821,268,536,640,168,443
060730155022,814,222,592,842,227,615,1025,301,698,918,231,635
060730212041,1305,339,966,1333,322,1011,1669,485,1151,1415,340,1010
060730212042,1506,475,1031,1560,471,1089,1870,598,1235,1713,505,1129
060730212052,740,228,512,757,231,526,1147,364,759,850,250,557
060730212053,843,245,598,863,237,626,1181,371,784,942,286,616
060730212062,669,179,490,690,173,517,924,257,648,597,144,431
060730212061,981,251,730,1008,250,758,1208,333,857,1152,289,820
060730212051,973,339,634,1004,337,667,1357,400,926,1141,337,751
060730155011,476,156,320,487,156,331,640,212,410,518,158,338
060730155014,523,163,360,543,165,378,746,239,490,586,168,392
060730155012,723,236,487,737,237,500,913,302,594,764,237,500
060730136051,1227,529,698,1259,535,724,1660,725,907,1370,562,748
060730136052,795,381,414,815,381,434,1116,552,543,902,399,457
060730136072,645,302,343,662,299,363,951,478,455,772,352,384
060730154052,874,315,559,891,320,571,1129,441,673,982,309,608
060730154061,1328,429,899,1354,424,930,1700,611,1066,1421,444,914
060730136071,278,156,122,284,160,124,400,218,175,289,147,129
060730136082,439,237,202,458,238,220,662,304,348,586,291,273
060730136081,958,454,504,982,456,526,1327,608,698,1071,484,539
060730136043,1016,399,617,1047,401,646,1522,578,923,1195,461,679
060730136044,371,179,192,383,181,202,736,279,446,429,203,208
060730136041,393,146,247,405,151,254,515,195,312,441,151,268
060730136042,371,125,246,383,124,259,533,201,324,436,141,274
060730213051,1135,385,750,1156,386,770,1502,502,979,1267,437,776
060730154053,821,292,529,847,301,546,1132,430,688,979,302,626
060730168092,746,209,537,769,205,564,1059,339,702,910,251,629
060730213052,927,305,622,953,306,647,1261,401,834,1034,333,651
060730213063,471,141,330,481,136,345,711,255,441,505,158,324
060730213041,779,264,515,795,257,538,1086,369,695,972,327,603
060730213042,624,240,384,635,238,397,745,277,454,647,196,424
060730213021,719,289,430,729,281,448,1076,412,637,854,378,423
060730213023,571,163,408,590,159,431,808,255,535,647,182,424
060730213022,679,216,463,692,209,483,852,325,503,738,227,466
060730210011,235,129,106,240,130,110,303,173,122,260,138,109
060730210012,260,140,120,265,140,125,330,188,138,249,135,106
060730210022,205,110,95,211,111,100,482,275,193,224,113,101
060730209044,469,191,278,486,194,292,536,223,302,468,174,269
060730209043,268,113,155,276,114,162,332,140,186,275,110,154
060730209041,411,166,245,421,159,262,519,219,289,437,152,261
060730209042,614,256,358,634,253,381,693,289,385,604,237,336
060730209021,264,97,167,271,92,179,355,115,235,269,84,169
060730209022,926,247,679,946,243,703,1193,338,831,926,227,659
060730212021,901,263,638,923,269,654,1291,422,845,999,270,686
060730212022,359,90,269,373,92,281,509,139,360,527,123,380
060730211011,410,206,204,410,188,222,746,257,470,585,311,241
060730211021,594,170,424,602,166,436,850,295,539,708,201,473
060730211012,615,191,424,628,178,450,879,304,556,706,189,478
060730211013,553,183,370,562,178,384,859,292,543,662,204,414
060730211022,227,99,128,233,100,133,332,113,211,249,93,146
060730210013,253,88,165,255,89,166,381,160,214,276,103,151
060730190011,462,175,287,473,172,301,548,226,299,621,248,334
060730094001,50,32,18,51,31,20,192,118,71,136,58,58
060730113001,42,17,25,44,19,25,95,50,42,41,13,25
060730062001,115,61,54,117,60,57,5,3,2,6,3,3
060730099011,13,7,6,14,7,7,12,8,4,9,5,4
060730076011,119,84,35,127,88,39,191,132,53,153,86,48
060730055001,16,11,5,17,11,6,55,46,7,17,10,5
060855068022,548,377,171,555,379,176,715,519,171,584,398,136
060855068023,349,241,108,358,240,118,481,339,126,394,268,99
060855068024,239,165,74,245,166,79,342,241,93,278,184,70
060855068025,436,301,135,448,300,148,572,403,155,491,330,126
060855068032,574,417,157,588,414,174,711,504,186,615,419,150
060855068034,408,288,120,424,295,129,550,398,140,457,319,108
060855068043,567,383,184,571,381,190,758,545,193,613,415,159
060855068044,276,195,81,281,193,88,356,256,95,294,202,75
060855068031,723,466,257,754,480,274,990,694,266,841,535,246
060855068033,866,607,259,898,624,274,1227,880,310,967,670,231
060855120522,672,467,205,686,467,219,1064,777,267,779,537,197
060855120523,382,266,116,387,264,123,518,372,137,425,293,110
060855120532,562,401,161,568,395,173,786,545,221,642,443,164
060855069001,492,330,162,504,337,167,660,474,164,572,372,173
060855069002,943,599,344,965,614,351,1189,834,327,995,646,284
060855069003,1097,700,397,1112,705,407,1394,990,371,1225,808,340
060855119161,405,284,121,413,285,128,971,679,266,762,519,186
060855119162,1151,761,390,1190,779,411,1542,1060,446,1284,844,358
060855119151,360,254,106,370,261,109,554,395,152,489,342,122
060855119153,289,203,86,299,207,92,388,277,104,289,204,70
060855029102,330,224,106,336,227,109,450,315,119,389,266,96
060855119152,154,111,43,158,113,45,262,188,69,199,141,48
060855119051,608,356,252,622,367,255,782,520,241,656,419,191
060855119102,320,184,136,327,191,136,479,321,151,411,236,152
060855119143,695,412,283,708,423,285,948,643,288,807,502,243
060855119142,1348,857,491,1368,859,509,1719,1182,492,1520,972,460
060855119131,633,393,240,643,405,238,792,550,224,707,467,202
060855119132,690,445,245,702,449,253,938,638,277,776,519,215
060855119141,675,404,271,683,408,275,893,619,252,748,474,225
060855119133,790,503,287,807,509,298,995,686,291,865,577,248
060855119182,1249,779,470,1271,798,473,1695,1148,512,1283,849,364
060855119101,549,316,233,559,326,233,712,463,236,622,379,206
060855119181,351,201,150,361,207,154,469,306,153,429,261,142
060855119052,778,473,305,793,481,312,1097,737,331,885,581,259
060855119103,656,379,277,670,386,284,860,558,287,714,437,239
060855119173,1092,698,394,1115,707,408,1373,970,374,1130,793,276
060855119171,888,570,318,909,582,327,1312,942,348,1096,755,286
060855119112,459,278,181,467,279,188,601,378,205,547,308,207
060855122001,772,369,403,789,369,420,1094,602,458,891,443,379
060855119122,711,483,228,724,485,239,975,695,265,788,542,197
060855119113,954,557,397,979,563,416,1194,795,367,1012,609,333
060855119121,1080,683,397,1095,698,397,1450,1031,390,1173,803,298
060855119123,552,350,202,559,363,196,764,540,205,554,366,160
060855119072,1202,741,461,1236,765,471,1556,1106,415,1285,854,355
060855119071,578,343,235,596,357,239,852,571,262,619,386,200
060855119111,833,552,281,850,556,294,1247,831,387,965,630,286
060855120521,314,217,97,319,217,102,399,293,99,357,241,97
060855120051,600,419,181,612,412,200,784,544,223,678,469,168
060855120054,635,445,190,652,438,214,901,626,256,725,498,178
060855120243,369,275,94,373,273,100,866,604,240,441,321,94
060855120241,485,335,150,497,343,154,606,425,169,544,361,141
060855120271,630,435,195,649,448,201,792,556,215,654,456,162
060855120242,735,529,206,746,519,227,799,563,222,912,628,219
060855120251,940,608,332,956,606,350,1298,865,415,1092,711,320
060855120531,656,503,153,662,499,163,978,714,244,784,572,169
060855120473,740,484,256,755,479,276,950,648,279,791,496,241
060855120533,394,252,142,401,248,153,481,327,140,422,260,131
060855120471,812,545,267,813,531,282,1136,788,325,931,610,268
060855120472,667,449,218,675,440,235,956,655,284,800,523,231
060855120454,752,508,244,765,492,273,930,642,266,858,555,246
060855120452,442,297,145,444,289,155,598,412,176,501,326,139
060855120453,399,268,131,401,257,144,534,366,157,451,292,128
060855120314,458,293,165,470,293,177,596,419,160,502,329,139
060855120192,623,468,155,631,466,165,931,679,232,687,510,126
060855120193,611,446,165,619,450,169,852,620,212,779,589,134
060855120191,356,223,133,365,228,137,479,321,141,481,310,142
060855120252,444,291,153,452,286,166,608,404,196,512,336,148
060855119172,314,190,124,321,185,136,512,369,135,338,230,91
060855033061,263,199,64,265,200,65,507,334,165,341,285,45
060855033062,344,272,72,348,271,77,606,424,178,453,388,53
060855033063,254,198,56,259,199,60,449,307,142,323,273,40
060855078083,473,349,124,489,353,136,540,400,128,450,346,79
060855079051,383,243,140,393,254,139,663,463,183,528,360,137
060855079052,573,369,204,588,379,209,860,607,240,661,454,171
060855079061,515,340,175,526,343,183,747,515,208,600,418,147
060855079062,424,273,151,430,277,153,630,441,180,486,348,114
060855079032,603,381,222,612,385,227,930,645,259,793,561,188
060855079033,969,613,356,988,631,357,893,635,240,729,517,175
060855079063,358,248,110,369,246,123,514,359,145,403,289,94
060855079064,407,280,127,418,277,141,550,387,155,447,320,106
060855079053,699,482,217,713,484,229,865,603,240,726,524,172
060855080041,581,416,165,603,431,172,953,695,236,688,512,139
060855080043,712,510,202,739,520,219,991,715,252,775,556,177
060855079041,636,427,209,652,444,208,1252,901,326,992,737,210
060855079042,645,427,218,657,436,221,846,619,217,707,501,167
060855079031,727,487,240,753,502,251,1007,725,266,889,666,178
060855062023,320,231,89,331,232,99,402,284,105,330,230,72
060855062022,817,588,229,837,593,244,1105,810,266,959,683,214
060855062024,670,479,191,679,482,197,904,687,198,808,575,184
060855062021,755,558,197,769,574,195,1066,781,259,936,689,190
060855062042,355,242,113,363,249,114,441,326,108,421,305,93
060855062043,371,256,115,381,263,118,549,405,136,431,311,99
060855062041,615,440,175,625,438,187,1067,767,274,808,581,165
060855062044,615,440,175,627,433,194,751,541,193,582,415,138
060855062031,246,191,55,258,199,59,480,350,118,358,269,66
060855062032,166,127,39,171,131,40,315,230,78,221,161,41
060855062033,280,206,74,286,213,73,370,274,91,300,229,55
060855062034,325,244,81,337,254,83,560,411,140,408,311,76
060855063011,256,213,43,260,212,48,441,330,100,316,245,47
060855063012,396,324,72,404,325,79,678,509,155,506,389,77
060855063013,419,289,130,444,306,138,580,437,133,493,341,119
060855063014,402,276,126,424,293,131,561,421,131,507,354,120
060855063022,763,510,253,764,511,253,963,716,227,947,615,256
060855063041,503,385,118,515,392,123,780,578,184,640,488,113
060855063042,194,149,45,198,151,47,312,233,75,244,181,41
060855063043,325,250,75,329,252,77,551,408,129,419,315,73
060855063051,271,180,91,278,184,94,368,255,100,315,211,80
060855063052,434,332,102,442,336,106,686,491,178,535,396,94
060855063054,382,285,97,389,283,106,616,449,154,469,339,88
060855063053,440,322,118,449,319,130,647,469,161,550,391,115
060855066051,840,592,248,860,601,259,1086,786,272,895,628,212
060855066052,531,377,154,533,371,162,753,550,190,726,522,159
060855066063,485,357,128,487,354,133,655,488,153,533,390,110
060855066011,624,445,179,635,445,190,807,594,194,690,496,160
060855066012,378,267,111,382,269,113,516,396,113,406,292,95
060855066013,487,363,124,492,366,126,719,530,171,578,437,111
060855066045,695,490,205,709,496,213,955,716,218,736,527,173
060855066041,271,188,83,275,192,83,397,301,88,409,288,98
060855066042,670,468,202,675,470,205,948,690,244,767,535,178
060855066043,687,480,207,694,480,214,838,607,216,741,509,175
060855074022,587,403,184,591,396,195,724,524,183,620,428,155
060855066032,854,576,278,871,571,300,1041,745,264,933,629,232
060855066044,622,431,191,635,432,203,899,623,252,757,500,201
060855067011,289,200,89,293,200,93,360,251,102,339,224,91
060855067013,665,447,218,685,460,225,955,679,256,756,510,202
060855066031,421,297,124,433,296,137,556,403,147,451,315,108
060855066033,491,352,139,501,356,145,664,476,165,565,395,127
060855067012,662,464,198,676,471,205,919,661,228,763,547,169
060855067022,817,570,247,827,559,268,1123,799,292,934,633,244
060855022022,419,299,120,426,300,126,514,390,115,452,310,118
060855022023,302,213,89,307,214,93,385,289,87,343,230,91
060855021011,443,334,109,452,338,114,582,437,126,531,382,114
060855021013,1154,830,324,1173,830,343,1507,1109,358,1201,866,256
060855120222,642,429,213,648,424,224,992,678,300,720,501,176
060855120272,835,582,253,858,597,261,1222,870,332,986,700,219
060855120261,739,529,210,756,531,225,1107,771,314,909,624,233
060855120262,592,425,167,604,422,182,844,590,242,678,470,171
060855120551,922,668,254,934,679,255,1316,965,323,1003,749,201
060855120211,602,443,159,611,440,171,829,588,225,699,507,158
060855120212,633,452,181,644,453,191,893,641,237,785,559,177
060855120213,484,337,147,491,339,152,708,506,187,557,396,126
060855120421,395,281,114,403,283,120,686,440,238,489,357,107
060855120221,418,313,105,418,298,120,574,394,172,483,357,99
060855120433,269,210,59,272,210,62,424,305,110,307,243,47
060855120214,503,357,146,515,359,156,824,526,287,610,443,131
060855120223,414,332,82,416,321,95,692,470,207,512,399,84
060855120231,529,388,141,543,388,155,803,615,171,664,498,124
060855120232,358,294,64,364,293,71,674,514,144,543,404,106
060855120233,381,295,86,389,294,95,660,503,140,477,372,76
060855120451,856,584,272,873,596,277,1103,780,299,971,646,252
060855032182,232,190,42,235,185,50,282,199,75,209,170,31
060855120542,321,248,73,328,251,77,512,380,123,398,308,67
060855120543,208,159,49,211,161,50,419,311,101,314,243,52
060855120541,125,100,25,128,100,28,211,156,51,165,128,27
060855120291,678,482,196,695,487,208,961,679,257,845,587,199
060855120292,837,599,238,846,594,252,1119,802,287,980,671,244
060855120294,704,514,190,718,512,206,1095,791,273,917,628,221
060855120594,2369,1689,680,2422,1683,739,2189,1603,536,903,631,211
060855120371,754,505,249,772,510,262,1067,734,303,838,560,223
060855120372,444,301,143,457,305,152,618,425,177,527,355,136
060855120301,846,538,308,862,537,325,1142,800,311,943,609,247
060855120302,464,308,156,470,307,163,672,468,185,576,368,166
060855120361,303,213,90,309,212,97,1006,701,277,787,561,182
060855120362,621,436,185,629,432,197,1225,854,337,923,660,217
060855120311,293,199,94,301,205,96,407,288,109,358,249,84
060855120312,530,357,173,541,366,175,714,504,192,581,402,139
060855120313,492,319,173,503,323,180,649,456,176,566,377,150
060855120293,314,239,75,321,239,82,454,328,113,375,255,89
060855120593,478,309,169,491,311,180,644,457,172,592,374,171
060855120592,555,365,190,569,361,208,796,562,213,647,411,188
060855120591,549,371,178,559,357,202,690,487,186,624,402,177
060855120321,497,351,146,510,354,156,718,506,193,637,437,152
060855120322,358,249,109,368,251,117,517,372,133,473,318,117
060855120323,372,259,113,382,262,120,1168,855,284,1233,901,258
060855120341,1016,675,341,1033,661,372,1373,932,392,1152,787,291
060855120352,819,540,279,831,522,309,1125,765,329,936,627,248
060855120342,277,194,83,282,190,92,379,262,101,307,215,70
060855120351,824,541,283,842,533,309,1134,766,343,975,660,244
060855121001,481,262,219,490,269,221,842,488,341,631,359,238
060855120013,481,335,146,490,337,153,660,445,198,529,379,114
060855120012,807,571,236,821,569,252,1091,758,313,871,626,192
060855031272,516,373,143,528,374,154,1701,1174,503,745,537,167
060855031271,796,573,223,808,574,234,878,616,250,737,541,151
060855033122,785,513,272,799,529,270,987,647,321,836,570,232
060855042022,703,480,223,716,482,234,1024,685,311,806,542,212
060855051002,36,31,5,36,30,6,47,40,7,35,29,6
060855051004,80,66,14,81,65,16,152,127,21,4,3,1
060855051001,409,326,83,416,326,90,615,451,154,341,261,60
060855051003,610,485,125,621,488,133,864,707,140,775,619,112
060855003001,583,505,78,588,496,92,946,828,100,755,628,74
060855004001,422,333,89,428,338,90,719,585,111,567,435,93
060855052031,751,601,150,759,604,155,1011,795,184,919,727,125
060855052032,367,289,78,371,293,78,467,376,82,409,323,60
060855004002,639,492,147,653,507,146,694,547,131,595,453,108
060855057003,626,494,132,638,501,137,763,602,147,727,551,120
060855058001,408,301,107,410,301,109,553,413,121,475,348,93
060855006004,440,350,90,447,349,98,569,459,95,499,378,90
060855002003,465,394,71,471,390,81,667,555,93,539,439,63
060855002004,646,558,88,656,550,106,899,758,122,738,614,79
060855008001,607,511,96,613,505,108,714,587,112,614,509,73
060855011011,603,508,95,612,499,113,858,707,131,808,669,89
060855002001,451,380,71,454,377,77,593,500,82,516,419,62
060855002002,46,39,7,46,38,8,22,19,3,82,66,10
060855001004,823,716,107,834,716,118,1382,1143,207,941,774,106
060855001001,305,247,58,311,242,69,304,241,58,313,261,36
060855001002,369,312,57,377,312,65,532,419,106,434,353,53
060855001003,389,328,61,398,328,70,604,468,116,452,366,56
060855036011,159,131,28,165,134,31,340,245,91,264,224,29
060855011021,528,439,89,535,438,97,651,499,130,598,492,73
060855011022,478,417,61,487,416,71,720,583,117,578,485,56
060855011023,433,367,66,436,362,74,576,449,100,528,436,57
060855012001,204,173,31,207,172,35,256,205,46,241,198,27
060855012004,415,357,58,417,352,65,549,436,85,482,387,45
060855011012,719,604,115,729,598,131,957,779,152,885,727,105
060855010002,279,243,36,286,243,43,303,242,51,289,238,31
060855008002,390,329,61,395,327,68,628,513,96,440,363,47
060855010003,255,216,39,259,215,44,310,245,55,264,217,29
060855010001,443,391,52,452,393,59,556,445,92,474,384,55
060855010004,260,222,38,258,219,39,312,245,55,320,256,39
060855010005,182,156,26,184,155,29,226,185,40,237,192,28
060855012002,298,250,48,304,250,54,410,322,83,343,284,39
060855012003,219,186,33,220,185,35,343,283,56,282,232,27
060855014012,208,170,38,210,167,43,325,259,66,224,182,32
060855014011,313,253,60,319,248,71,519,398,104,388,315,55
060855036012,368,309,59,373,305,68,625,482,123,461,385,52
060855014021,222,179,43,225,181,44,382,299,79,290,242,32
060855036021,264,229,35,270,227,43,436,350,82,396,340,35
060855014022,353,293,60,357,295,62,513,405,99,450,375,49
060855015011,423,336,87,433,344,89,765,554,196,576,478,66
060855036023,191,135,56,192,136,56,311,211,95,248,188,46
060855015012,289,232,57,295,238,57,422,321,88,311,255,38
060855015021,353,298,55,359,301,58,533,420,97,468,381,60
060855036022,382,285,97,385,285,100,649,459,181,488,384,79
060855013003,610,534,76,612,532,80,690,576,103,664,562,55
060855013001,543,475,68,544,472,72,559,457,87,595,496,52
060855013002,280,237,43,280,237,43,350,286,54,314,260,32
060855015023,159,128,31,160,128,32,334,253,72,425,345,51
060855016012,756,604,152,769,601,168,769,634,113,614,496,68
060855016021,122,108,14,124,108,16,177,139,32,147,122,13
060855016022,200,178,22,205,178,27,252,202,43,261,212,27
060855016023,335,296,39,341,296,45,509,405,79,434,350,45
060855009011,149,125,24,150,126,24,424,331,75,249,194,34
060855009022,423,365,58,425,364,61,419,329,75,582,460,69
060855009012,570,473,97,570,473,97,666,536,107,725,568,88
060855009013,291,249,42,291,249,42,536,441,79,234,188,25
060855008003,525,445,80,534,443,91,761,609,127,588,471,72
060855017001,222,198,24,224,197,27,422,349,62,166,142,18
060855017002,130,112,18,129,110,19,171,139,24,144,123,13
060855017003,281,243,38,280,238,42,406,340,58,275,235,25
060855017004,236,206,30,235,203,32,429,361,63,285,242,25
060855031131,533,462,71,532,452,80,830,693,116,656,545,72
060855031132,361,312,49,364,304,60,540,455,75,435,365,46
060855018001,335,285,50,340,279,61,474,377,82,378,293,54
060855018002,406,338,68,408,336,72,600,489,100,571,457,79
060855018003,503,418,85,508,413,95,646,531,102,580,453,89
060855024005,783,574,209,785,563,222,1038,801,208,916,645,196
060855024006,726,578,148,733,585,148,919,727,166,802,629,124
060855024007,388,308,80,391,306,85,491,384,96,416,327,58
060855015022,142,114,28,142,114,28,261,190,68,233,194,27
060855009021,171,152,19,174,152,22,186,144,33,153,125,14
060855019022,538,437,101,547,440,107,806,608,180,650,519,90
060855003002,856,750,106,863,737,126,1027,833,171,898,727,106
060855006001,572,461,111,576,463,113,624,518,99,599,485,90
060855006003,599,509,90,615,523,92,908,732,151,667,556,76
060855043181,259,177,82,265,175,90,819,506,302,456,346,90
060855023022,499,381,118,509,380,129,758,596,145,624,470,107
060855037102,320,250,70,324,247,77,605,433,159,466,383,63
060855037112,267,209,58,272,208,64,495,370,117,321,263,43
060855037113,305,258,47,304,247,57,389,267,120,330,280,36
060855005001,682,512,170,694,517,177,780,611,148,738,539,152
060855005002,793,632,161,802,631,171,1039,810,196,856,663,143
060855005003,316,252,64,323,250,73,388,306,74,333,239,73
060855032082,504,354,150,512,356,156,819,553,255,641,509,103
060855120562,298,235,63,302,233,69,533,383,142,421,330,74
060855120572,302,237,65,305,231,74,511,366,140,378,294,71
060855120561,638,498,140,644,488,156,982,709,259,817,633,137
060855120422,333,252,81,337,247,90,525,375,139,427,322,76
060855120431,588,457,131,596,449,147,949,684,248,677,524,111
060855033371,543,397,146,554,401,153,996,613,368,651,504,115
060855033372,422,314,108,429,315,114,698,432,257,541,434,84
060855033381,656,437,219,664,444,220,1136,762,356,781,571,175
060855031162,639,464,175,655,478,177,1037,712,306,574,413,134
060855031161,390,276,114,401,285,116,701,481,206,752,543,164
060855032071,802,516,286,816,518,298,1337,768,552,939,693,201
060855032072,464,291,173,477,297,180,741,411,324,597,432,139
060855038022,620,441,179,628,455,173,967,653,294,787,606,154
060855031112,371,259,112,378,260,118,629,391,229,468,372,69
060855031113,492,340,152,501,342,159,799,496,289,577,444,113
060855031181,325,240,85,329,241,88,531,355,170,408,333,58
060855031182,178,139,39,181,138,43,421,284,129,288,237,41
060855033051,426,323,103,436,332,104,699,440,251,540,433,76
060855033052,481,369,112,485,370,115,967,611,351,654,561,61
060855033053,478,365,113,479,361,118,829,519,298,664,527,113
060855043171,795,538,257,813,542,271,1230,830,380,962,704,219
060855043232,459,309,150,473,316,157,934,631,291,565,433,110
060855043233,354,247,107,364,249,115,550,375,170,419,309,94
060855037072,423,321,102,430,337,93,776,519,246,614,496,87
060855037073,280,243,37,283,240,43,468,367,86,382,316,43
060855037121,138,102,36,138,102,36,304,202,96,224,177,35
060855037122,234,169,65,236,172,64,468,304,156,300,238,52
060855037123,296,218,78,298,220,78,507,339,161,405,330,65
060855043161,670,460,210,686,477,209,1150,747,391,789,582,172
060855043162,677,471,206,693,476,217,1062,687,361,856,645,171
060855043152,252,166,86,255,167,88,371,237,130,280,207,58
060855043153,511,340,171,524,345,179,802,505,279,565,412,125
060855043154,379,253,126,388,253,135,558,355,196,447,318,111
060855043201,600,396,204,612,401,211,879,556,314,745,514,204
060855043202,357,234,123,361,235,126,524,331,185,440,301,120
060855031051,569,319,250,581,334,247,835,437,386,684,516,131
060855031171,271,195,76,278,196,82,463,303,148,348,279,58
060855039032,314,250,64,321,243,78,476,350,124,313,254,46
060855040011,341,277,64,346,279,67,540,397,140,431,340,67
060855040012,442,359,83,452,363,89,697,533,143,542,453,66
060855040013,262,212,50,265,213,52,437,317,111,314,259,42
060855040021,462,361,101,474,360,114,728,528,193,576,475,79
060855050113,188,144,44,191,145,46,255,197,55,217,167,38
060855050121,749,621,128,765,632,133,168,132,32,518,421,61
060855050142,322,256,66,329,258,71,576,452,112,409,302,92
060855050102,617,466,151,626,465,161,933,699,220,752,543,152
060855050141,205,170,35,207,171,36,309,245,60,253,205,29
060855050143,266,215,51,272,217,55,467,365,91,353,288,40
060855046021,1194,925,269,1213,924,289,990,762,213,698,560,99
060855050152,374,292,82,378,281,97,610,463,134,465,341,85
060855050132,377,311,66,380,301,79,572,447,111,503,384,83
060855050133,120,101,19,121,99,22,171,135,31,169,132,27
060855050151,267,208,59,271,201,70,994,771,205,346,251,63
060855050065,250,177,73,253,176,77,640,488,138,1034,788,175
060855043111,620,417,203,638,429,209,1057,765,277,798,601,154
060855043113,462,328,134,476,334,142,576,415,147,494,377,98
060855043114,698,491,207,717,501,216,833,603,216,722,542,145
060855043112,417,298,119,427,303,124,688,467,209,506,376,107
060855043222,271,201,70,277,204,73,441,326,103,334,256,58
060855043183,489,343,146,492,341,151,830,564,256,663,521,113
060855043231,487,323,164,497,332,165,689,456,222,605,449,130
060855044102,595,391,204,603,406,197,981,621,345,800,616,146
060855045091,177,133,44,181,136,45,1116,772,328,527,403,99
060855043172,504,342,162,518,338,180,830,536,280,670,484,156
060855043191,645,457,188,659,466,193,979,669,292,940,693,199
060855043192,734,521,213,753,525,228,1134,778,343,754,569,148
060855043193,304,216,88,311,221,90,511,370,132,362,283,62
060855043194,384,275,109,393,269,124,674,461,202,521,381,115
060855038033,355,248,107,363,246,117,533,368,160,508,371,107
060855038032,319,224,95,324,225,99,548,374,164,390,312,70
060855043072,834,583,251,850,582,268,1311,882,408,971,720,213
060855038031,542,373,169,554,370,184,939,640,282,659,476,145
060855038024,634,494,140,637,481,156,1022,726,287,762,631,105
060855038041,695,504,191,709,512,197,1045,700,333,822,620,168
060855038042,256,191,65,260,194,66,443,283,155,300,228,58
060855038043,377,266,111,383,277,106,653,436,208,507,383,105
060855039021,386,304,82,389,295,94,611,450,150,477,373,84
060855039022,246,195,51,250,189,61,596,438,148,329,255,59
060855039024,268,210,58,271,207,64,478,343,124,343,272,57
060855039031,457,353,104,463,351,112,743,512,221,581,463,89
060855038023,638,470,168,650,478,172,922,634,273,705,529,136
060855038021,496,359,137,507,365,142,668,459,199,548,406,111
060855043071,802,555,247,819,546,273,1292,858,408,1002,710,249
060855043083,545,360,185,563,357,206,724,490,228,609,430,144
060855042011,1198,789,409,1211,781,430,1593,1068,493,1265,826,365
060855043081,682,402,280,696,412,284,983,637,334,806,547,210
060855043082,555,364,191,576,363,213,760,501,248,661,484,144
060855044111,874,560,314,903,581,322,1348,856,464,1092,752,275
060855044241,395,220,175,401,225,176,533,340,189,467,306,133
060855043144,457,316,141,469,322,147,673,440,224,553,408,118
060855043155,387,276,111,399,285,114,655,430,209,466,355,88
060855043213,373,270,103,384,266,118,578,379,193,437,323,98
060855043211,729,515,214,756,533,223,1091,710,362,874,638,187
060855043151,488,325,163,497,328,169,763,483,266,588,428,129
060855043141,457,316,141,466,314,152,682,433,227,509,380,102
060855043142,357,249,108,368,248,120,599,390,198,439,333,85
060855043143,272,185,87,281,189,92,395,259,136,311,230,69
060855044101,567,402,165,571,391,180,975,611,345,713,520,159
060855044112,731,499,232,758,520,238,1182,754,409,907,654,184
060855050061,857,666,191,878,672,206,955,704,230,467,353,85
060855050063,282,211,71,292,213,79,571,431,124,364,276,66
060855050062,148,123,25,150,123,27,205,156,45,206,158,36
060855050064,214,178,36,218,180,38,337,255,73,290,214,54
060855043221,315,243,72,323,243,80,552,405,132,394,303,69
060855043223,311,240,71,315,238,77,578,423,137,481,361,89
060855045054,471,350,121,488,358,130,471,340,125,456,338,95
060855037081,821,606,215,832,610,222,1148,726,405,970,769,161
060855043212,339,245,94,347,241,106,577,374,197,393,313,70
060855050131,185,158,27,188,154,34,300,240,53,280,220,43
060855037091,410,303,107,423,306,117,1093,644,435,496,406,72
060855037131,382,300,82,389,293,96,620,414,195,496,400,74
060855037132,180,142,38,183,139,44,213,155,54,241,196,35
060855037101,329,277,52,326,262,64,507,341,155,373,320,38
060855037071,236,179,57,242,191,51,452,302,143,285,224,45
060855037111,164,138,26,163,131,32,296,201,90,201,174,21
060855035062,317,263,54,321,261,60,505,393,106,399,344,40
060855035071,367,299,68,370,298,72,651,495,146,484,418,52
060855037032,356,301,55,359,298,61,728,561,155,548,467,59
060855037031,247,209,38,252,207,45,453,345,97,335,286,37
060855040022,211,181,30,214,181,33,378,270,99,283,250,24
060855040023,361,310,51,366,310,56,643,466,170,497,449,41
060855035082,384,312,72,391,310,81,597,442,137,466,394,49
060855035083,353,295,58,359,293,66,651,485,152,479,388,67
060855041021,599,469,130,607,464,143,811,602,195,687,549,113
060855041022,251,211,40,256,212,44,472,357,105,369,318,42
060855041011,353,263,90,357,259,98,553,403,142,460,350,82
060855041013,408,328,80,414,321,93,559,414,134,490,386,80
060855041012,333,276,57,339,272,67,570,428,132,477,382,72
060855041023,292,244,48,294,243,51,465,350,103,388,327,47
060855035101,381,310,71,392,315,77,670,513,138,523,438,60
060855035102,291,240,51,292,236,56,550,409,136,412,353,42
060855035103,332,270,62,338,270,68,606,458,138,471,401,52
060855035112,440,355,85,450,359,91,724,535,182,585,488,71
060855035111,420,318,102,426,307,119,693,494,189,516,432,68
060855035063,365,298,67,373,298,75,646,489,143,444,380,44
060855035061,462,364,98,473,368,105,864,633,213,610,523,64
060855035041,255,220,35,258,224,34,398,307,85,307,270,23
060855035042,325,283,42,327,282,45,495,382,106,394,352,26
060855035044,359,300,59,365,301,64,609,456,149,481,418,49
060855035043,246,207,39,247,207,40,425,325,90,327,281,37
060855037092,292,194,98,299,200,99,458,267,184,356,285,59
060855034011,385,322,63,387,311,76,454,355,92,380,333,34
060855034012,320,267,53,318,257,61,519,402,105,422,372,36
060855034013,431,361,70,434,350,84,652,506,132,538,466,51
060855034021,274,228,46,272,221,51,546,431,111,416,360,42
060855034023,303,233,70,310,237,73,587,370,210,423,359,55
060855034022,78,60,18,80,61,19,142,89,50,110,93,14
060855042013,660,469,191,670,476,194,915,629,264,726,531,164
060855035091,412,340,72,418,339,79,629,483,134,496,416,67
060855035092,563,429,134,572,429,143,914,647,252,688,550,117
060855033221,365,289,76,371,289,82,663,443,205,513,415,76
060855033123,244,194,50,246,199,47,372,282,82,285,236,39
060855037093,365,235,130,373,244,129,607,336,262,454,355,81
060855042012,427,292,135,432,295,137,536,375,154,491,332,130
060855020011,291,243,48,296,244,52,403,320,66,354,280,47
060855020012,204,154,50,211,160,51,341,250,82,276,206,51
060855020014,563,465,98,570,466,104,791,633,131,680,535,92
060855020021,200,173,27,204,173,31,273,228,41,200,164,21
060855020023,621,515,106,627,513,114,832,678,135,669,526,95
060855033263,679,443,236,712,467,245,1130,750,369,706,511,168
060855033222,539,406,133,552,401,151,761,531,218,629,501,104
060855031172,263,194,69,270,195,75,454,308,139,437,355,68
060855031221,435,282,153,443,286,157,928,486,431,512,395,92
060855031222,331,240,91,344,247,97,366,190,170,341,250,72
060855005005,368,266,102,370,264,106,492,359,127,434,292,108
060855027043,620,410,210,639,423,216,808,564,226,705,478,184
060855027041,369,272,97,377,278,99,563,389,163,403,289,95
060855068021,610,429,181,620,433,187,828,601,201,733,508,171
060855032202,675,534,141,682,527,155,1008,698,291,785,635,111
060855032203,183,146,37,187,145,42,305,215,82,206,167,29
060855020022,307,270,37,310,261,49,505,414,79,344,291,33
060855033324,1804,1155,649,1830,1169,661,1650,1184,446,1771,1196,499
060855032201,352,274,78,360,274,86,591,407,171,485,380,84
060855031241,687,534,153,697,524,173,948,687,240,882,662,163
060855031242,169,133,36,172,126,46,284,207,71,196,150,33
060855019011,740,608,132,755,615,140,1350,1103,205,980,774,146
060855063024,237,188,49,239,185,54,391,291,93,386,291,72
060855063023,357,267,90,363,271,92,561,418,131,487,358,98
060855064012,322,255,67,325,251,74,498,376,107,445,323,94
060855064013,557,410,147,564,413,151,672,509,144,609,442,131
060855063021,769,566,203,785,569,216,1015,757,238,973,698,204
060855065051,384,295,89,395,304,91,519,386,120,366,283,56
060855065052,712,521,191,724,525,199,928,674,236,844,617,167
060855065041,185,132,53,188,136,52,336,250,78,250,194,38
060855065042,183,130,53,187,135,52,283,209,65,223,173,34
060855064021,451,334,117,459,335,124,615,468,133,518,376,115
060855064024,344,267,77,346,260,86,479,363,103,415,302,87
060855064025,367,284,83,373,278,95,491,374,106,402,299,73
060855064023,282,210,72,288,209,79,416,316,88,337,237,79
060855064022,360,266,94,366,263,103,391,300,82,419,293,102
060855064014,545,393,152,554,400,154,676,480,182,606,437,130
060855064011,118,85,33,120,87,33,184,130,49,155,112,33
060855058002,436,311,125,443,317,126,597,452,129,420,297,94
060855058003,448,324,124,452,326,126,532,400,117,476,342,102
060855059022,587,427,160,604,437,167,855,634,206,914,660,217
060855059011,401,279,122,410,285,125,519,397,110,433,309,93
060855005004,457,331,126,462,333,129,559,438,110,495,363,100
060855058004,511,380,131,518,378,140,708,525,156,598,444,113
060855006002,524,421,103,530,424,106,621,510,96,553,445,81
060855020013,469,355,114,481,361,120,669,509,134,551,404,108
060855019021,519,454,65,524,439,85,857,699,134,523,414,75
060855021012,358,269,89,362,268,94,495,369,110,451,324,95
060855021041,442,341,101,448,344,104,611,474,123,522,380,100
060855021042,238,184,54,242,184,58,356,276,71,305,217,69
060855026012,399,263,136,408,266,142,494,343,138,416,273,117
060855029021,1260,847,413,1294,867,427,1555,1154,363,1403,972,340
060855021031,378,291,87,383,293,90,555,428,112,425,317,73
060855021032,664,524,140,671,518,153,928,711,191,800,625,121
060855022031,804,628,176,823,640,183,991,740,224,852,638,162
060855022032,528,412,116,535,414,121,749,561,168,638,492,99
060855022042,174,140,34,176,139,37,268,207,53,253,196,36
060855022041,451,358,93,457,357,100,710,550,142,569,439,99
060855022021,563,414,149,569,420,149,621,482,124,581,448,101
060855023011,737,521,216,743,528,215,963,737,201,855,578,222
060855023012,855,616,239,862,621,241,1077,842,214,936,690,186
060855023021,649,472,177,671,482,189,816,650,145,721,529,146
060855026013,580,377,203,585,383,202,744,524,198,704,460,202
060855029031,1231,819,412,1251,832,419,1397,1057,319,1284,895,323
060855026011,491,331,160,495,329,166,628,448,158,507,341,130
060855025005,381,274,107,390,275,115,476,338,124,401,282,92
060855025006,694,495,199,711,497,214,860,612,227,761,533,177
060855025004,608,409,199,619,414,205,732,521,191,665,450,170
060855024001,413,301,112,417,304,113,496,389,98,453,342,88
060855024002,401,292,109,405,295,110,486,378,97,410,310,79
060855024003,374,273,101,378,278,100,473,365,97,399,301,72
060855031231,522,394,128,530,398,132,707,529,161,550,433,85
060855031232,333,257,76,341,258,83,593,440,141,421,325,69
060855018004,577,484,93,583,491,92,735,588,132,641,537,77
060855024004,547,399,148,559,413,146,645,492,134,543,414,91
060855025001,501,366,135,503,362,141,595,462,122,513,364,111
060855025003,594,433,161,604,432,172,698,539,147,642,460,139
060855025002,523,371,152,531,376,155,643,494,133,557,396,121
060855030011,665,461,204,682,472,210,826,623,189,750,522,187
060855030013,987,672,315,1006,679,327,1257,932,303,1084,757,268
060855031251,691,495,196,702,491,211,1121,813,281,809,591,173
060855031252,448,308,140,458,311,147,617,452,155,527,376,122
060855031211,268,179,89,277,179,98,319,180,135,266,189,59
060855032112,678,485,193,695,488,207,1042,586,453,851,661,147
060855032121,476,328,148,492,329,163,758,432,314,568,426,115
060855033273,602,443,159,612,445,167,781,555,218,686,514,141
060855033292,557,393,164,571,403,168,863,619,233,700,532,141
060855033301,828,627,201,843,633,210,1279,952,301,969,746,183
060855033303,662,472,190,674,479,195,939,701,223,667,525,125
060855016011,403,344,59,400,334,66,552,438,102,392,317,51
060855031123,305,256,49,308,248,60,448,354,82,363,300,42
060855031122,349,287,62,346,275,71,654,522,113,399,317,49
060855031121,296,244,52,297,235,62,464,368,85,363,295,43
060855031213,249,196,53,251,193,58,379,288,81,326,268,40
060855031212,514,417,97,517,408,109,741,582,138,697,539,119
060855031261,601,412,189,619,417,202,1168,800,349,1115,772,282
060855032222,930,633,297,951,638,313,923,518,388,694,536,141
060855032131,467,304,163,479,292,187,766,439,318,574,441,109
060855032132,560,366,194,574,369,205,1006,564,433,707,533,145
060855032211,195,118,77,198,127,71,354,197,151,245,194,42
060855032212,438,270,168,441,282,159,751,430,316,550,431,97
060855031101,322,235,87,331,233,98,530,331,191,412,344,53
060855031102,170,123,47,174,122,52,324,203,117,215,180,27
060855031103,62,45,17,63,44,19,211,132,76,70,60,9
060855031111,180,126,54,183,126,57,300,185,108,229,183,32
060855031183,250,200,50,252,199,53,448,305,135,307,246,46
060855032111,674,452,222,690,452,238,1002,592,396,845,656,153
060855032122,408,280,128,418,278,140,646,379,255,520,394,109
060855032123,335,224,111,341,224,117,496,290,193,416,312,88
060855032221,292,201,91,299,200,99,520,294,221,349,278,61
060855032191,282,198,84,289,198,91,574,382,180,388,301,66
060855032192,284,199,85,291,200,91,540,359,170,391,305,67
060855032101,491,338,153,494,333,161,946,560,372,726,584,105
060855032102,492,337,155,495,331,164,807,473,325,600,465,117
060855032081,490,384,106,491,371,120,716,507,192,566,455,83
060855120571,748,540,208,757,531,226,1207,775,414,926,682,189
060855032171,286,234,52,290,229,61,552,385,159,373,316,39
060855032172,275,220,55,276,218,58,417,297,114,354,299,38
060855032173,236,190,46,239,187,52,405,290,109,286,242,31
060855032183,268,223,45,269,214,55,440,316,119,389,320,57
060855032181,227,189,38,231,182,49,400,284,107,324,264,47
060855031163,464,312,152,475,314,161,657,394,255,544,386,130
060855120055,837,572,265,851,578,273,1182,800,352,983,657,261
060855120052,362,228,134,366,221,145,451,314,128,303,189,92
060855120053,368,232,136,371,224,147,472,328,134,309,190,93
060855033042,371,288,83,377,285,92,624,391,225,464,384,67
060855033043,439,297,142,439,290,149,681,423,246,590,433,132
060855033382,939,588,351,953,609,344,1749,1188,532,1292,848,394
060855120014,854,588,266,879,606,273,1019,717,284,847,610,193
060855033392,811,508,303,822,525,297,1249,848,376,1015,682,293
060855120391,348,236,112,357,243,114,700,466,223,446,316,104
060855120392,419,285,134,427,291,136,652,434,208,594,424,137
060855120393,550,377,173,557,381,176,837,555,266,650,465,149
060855033311,1141,758,383,1164,770,394,1576,1113,441,1282,863,359
060855033312,463,328,135,472,327,145,669,478,191,541,404,112
060855033304,726,517,209,740,527,213,1035,747,272,741,560,149
060855033332,897,658,239,912,661,251,1366,968,380,1103,828,229
060855120011,305,219,86,313,220,93,494,348,137,367,263,79
060855033321,965,610,355,974,610,364,1158,823,319,1006,625,347
060855033322,399,247,152,407,254,153,462,328,128,445,272,153
060855033302,333,249,84,339,253,86,905,671,213,594,472,96
060855033133,537,409,128,547,405,142,822,570,234,613,452,129
060855033231,699,516,183,712,516,196,1103,761,327,822,646,139
060855033391,625,435,190,638,439,199,1139,772,344,804,578,190
060855033323,420,293,127,425,287,138,712,502,197,457,330,99
060855042023,614,412,202,620,408,212,834,551,267,685,473,172
060855033262,823,570,253,850,603,247,1446,965,459,1054,788,227
060855033131,548,395,153,560,409,151,866,602,248,681,508,142
060855033132,664,448,216,670,446,224,954,673,277,775,572,166
060855033271,568,427,141,586,427,159,863,599,246,690,551,114
060855033272,553,415,138,560,414,146,875,615,248,707,550,128
060855033241,633,452,181,646,463,183,1035,705,315,767,606,133
060855033242,483,350,133,494,357,137,757,518,231,608,488,103
060855035081,428,367,61,439,365,74,721,546,159,561,466,66
060855033223,392,276,116,401,273,128,605,412,185,468,358,94
060855033121,242,168,74,241,163,78,349,244,99,266,193,54
060855033232,866,619,247,883,618,265,1325,870,447,1022,783,205
060855033211,600,391,209,615,418,197,1004,651,333,774,592,154
060855033212,739,525,214,756,546,210,1314,850,441,962,740,191
060855033151,620,453,167,626,456,170,1012,656,340,751,589,129
060855033152,308,229,79,313,227,86,597,390,203,433,341,76
060855033153,381,283,98,384,279,105,743,486,253,531,426,85
060855033154,556,416,140,569,413,156,936,610,318,689,550,114
060855033251,704,513,191,718,517,201,1157,784,356,894,683,172
060855033252,710,532,178,727,536,191,1194,827,352,925,742,149
060855033261,550,397,153,565,405,160,976,661,303,663,517,121
060855033291,642,454,188,667,484,183,1043,745,281,662,520,119
060855033362,609,437,172,615,429,186,961,611,331,777,617,138
060855033331,537,387,150,548,393,155,930,626,292,678,531,126
060855033361,301,223,78,307,228,79,539,381,153,359,294,53
060855033044,310,195,115,312,196,116,387,243,140,313,229,75
060855033041,300,235,65,306,234,72,553,343,199,414,344,58
060855120432,307,244,63,311,244,67,565,406,147,368,291,54
060855120381,354,252,102,364,260,104,630,419,200,492,359,109
060855120382,374,265,109,383,272,111,701,485,208,457,338,100
060855027011,683,495,188,700,507,193,873,619,233,829,579,193
060855027013,490,359,131,499,367,132,718,509,192,589,411,133
060855027012,686,464,222,702,473,229,888,629,233,763,525,194
060855029013,452,317,135,464,319,145,610,454,141,508,357,117
060855029014,663,479,184,677,486,191,966,694,241,800,551,186
060855026041,452,346,106,459,347,112,563,413,138,397,279,91
060855026033,582,370,212,588,373,215,687,519,156,626,431,153
060855029011,603,415,188,617,417,200,806,581,200,660,460,152
060855029012,692,506,186,709,497,212,898,676,198,824,582,191
060855029022,1208,882,326,1230,890,340,1566,1174,337,1356,969,288
060855029023,1122,813,309,1149,822,327,1528,1124,360,1269,885,297
060855029032,722,496,226,735,496,239,843,636,195,780,542,187
060855030012,560,371,189,575,376,199,667,478,178,572,396,143
060855029033,753,511,242,757,516,241,981,731,234,878,628,196
060855030022,955,660,295,980,669,311,1251,911,317,1051,721,267
060855029071,903,615,288,911,617,294,1085,788,278,1004,697,234
060855030032,652,434,218,658,427,231,874,585,264,775,483,236
060855030033,728,482,246,742,486,256,963,650,293,803,515,233
060855030021,602,420,182,617,421,196,801,591,194,745,534,165
060855030031,871,563,308,893,562,331,1160,776,351,1022,646,312
060855029093,623,421,202,635,418,217,713,513,186,703,483,175
060855029094,331,253,78,336,247,89,505,359,131,420,315,77
060855029104,306,234,72,310,228,82,408,291,107,391,293,73
060855029072,868,592,276,880,604,276,1088,781,280,971,646,261
060855029101,353,245,108,360,245,115,497,354,135,445,296,117
060855029103,191,130,61,198,133,65,284,200,76,246,168,60
060855029091,457,311,146,466,316,150,547,389,145,510,345,130
060855029092,395,269,126,403,273,130,454,328,120,435,298,110
060855029062,1004,694,310,1022,702,320,929,653,253,806,549,201
060855029063,544,384,160,562,386,176,782,552,214,679,456,175
060855029061,385,265,120,389,265,124,562,399,147,481,334,113
060855029082,1110,765,345,1128,756,372,1424,1014,373,1245,851,305
060855029083,717,490,227,733,488,245,930,674,241,835,568,207
060855029081,756,518,238,766,514,252,1051,754,267,881,601,212
060855028001,535,352,183,549,359,190,752,489,246,625,388,195
060855028002,621,431,190,628,440,188,823,602,203,751,501,194
060855028003,522,349,173,535,356,179,667,452,201,597,370,185
060855027042,507,333,174,520,338,182,702,482,204,577,373,169
060855027033,700,479,221,721,491,230,794,563,211,703,473,180
060855068041,336,218,118,341,223,118,440,311,119,355,234,97
060855068042,515,351,164,525,355,170,700,517,170,602,401,162
060855031243,239,187,52,242,188,54,460,348,106,311,253,45
060855117072,807,559,248,822,562,260,1037,756,256,765,524,191
060855113013,431,360,71,440,365,75,524,451,62,502,418,51
060855113011,713,617,96,718,617,101,817,719,95,780,656,82
060855113021,549,465,84,561,476,85,683,599,74,611,525,58
060855113022,329,279,50,335,284,51,377,331,39,386,333,36
060855113024,559,480,79,571,494,77,638,555,70,635,543,59
060855113023,334,286,48,341,293,48,395,346,44,386,330,35
060855116091,1107,898,209,1134,930,204,1381,1204,149,1297,1086,152
060855115011,539,469,70,551,471,80,655,572,74,605,541,42
060855115012,769,663,106,785,664,121,915,776,116,867,720,104
060855115013,925,804,121,940,804,136,1197,1023,149,1016,865,90
060855117051,487,409,78,494,413,81,713,594,106,592,490,69
060855115022,1091,994,97,1109,998,111,971,917,40,1015,949,28
060855094011,413,342,71,423,346,77,643,536,92,508,410,68
060855094012,302,231,71,303,225,78,423,337,73,303,235,49
060855107001,333,286,47,343,289,54,421,361,58,365,318,31
060855107002,667,554,113,686,562,124,847,684,136,759,627,84
060855093022,592,475,117,599,468,131,714,551,146,701,541,116
060855108021,474,385,89,483,394,89,548,445,90,526,443,57
060855108022,479,388,91,491,400,91,632,512,104,529,446,59
060855106001,331,276,55,336,277,59,378,320,52,310,263,31
060855106002,986,814,172,1007,825,182,1245,1050,172,1087,907,122
060855106003,927,719,208,948,728,220,1214,1009,179,1123,878,165
060855107003,907,696,211,932,696,236,1199,956,213,1015,758,184
060855093041,413,332,81,428,338,90,552,447,92,516,424,58
060855108031,786,622,164,804,624,180,789,660,112,695,570,90
060855108032,536,433,103,543,436,107,665,546,106,593,495,73
060855109003,648,519,129,665,523,142,795,671,110,727,587,94
060855109002,848,684,164,870,690,180,1239,1036,171,1092,897,137
060855109001,808,658,150,835,675,160,971,815,135,890,739,106
060855114001,362,294,68,370,295,75,427,368,51,396,323,45
060855114002,553,443,110,563,446,117,660,568,80,598,498,62
060855114003,412,329,83,419,331,88,490,418,61,444,367,48
060855114004,597,457,140,604,461,143,724,619,100,671,550,84
060855113012,686,574,112,698,584,114,817,696,92,814,686,81
060855112001,749,613,136,766,631,135,903,787,104,836,701,87
060855112002,824,665,159,838,684,154,951,823,109,888,740,93
060855112003,473,396,77,481,406,75,552,480,61,501,438,44
060855112004,561,487,74,569,495,74,666,577,85,592,522,46
060855111001,844,662,182,867,678,189,1058,905,134,963,818,107
060855111002,739,599,140,765,615,150,925,789,117,814,667,110
060855111003,661,521,140,676,531,145,849,706,117,722,595,100
060855111004,633,501,132,653,518,135,786,664,110,697,576,92
060855110002,622,525,97,627,526,101,745,604,126,678,554,90
060855110005,727,595,132,735,599,136,857,693,146,813,655,111
060855110001,528,426,102,539,431,108,711,578,120,632,502,88
060855110003,326,255,71,331,255,76,427,346,72,364,289,52
060855110004,561,424,137,574,426,148,738,598,126,661,512,108
060855046011,384,306,78,395,312,83,531,433,86,451,335,87
060855108011,851,710,141,874,736,138,1017,858,141,966,807,113
060855108012,1024,813,211,1049,829,220,1202,1006,175,1106,904,148
060855108014,440,341,99,451,345,106,542,450,81,495,397,73
060855108013,477,367,110,490,374,116,591,479,97,540,430,85
060855106004,424,315,109,436,316,120,568,453,101,498,388,81
060855105002,925,678,247,953,694,259,1168,936,213,965,757,161
060855117011,714,496,218,728,503,225,937,721,194,841,612,178
060855117043,1131,734,397,1151,737,414,1220,876,322,1050,695,287
060855105001,565,412,153,578,419,159,708,566,129,591,467,99
060855105003,1148,804,344,1180,822,358,1367,1096,248,1213,890,249
060855104001,715,513,202,749,544,205,1066,856,184,933,713,182
060855104002,517,382,135,534,398,136,463,375,80,422,331,72
060855098012,393,315,78,405,326,79,516,433,74,443,348,66
060855104003,509,381,128,525,395,130,653,525,112,587,464,96
060855102003,880,635,245,901,647,254,1093,862,209,923,676,195
060855103003,572,400,172,582,414,168,678,542,130,623,451,139
060855117012,1025,676,349,1044,687,357,1216,885,299,965,654,233
060855098013,703,581,122,720,593,127,854,713,121,738,612,83
060855102001,954,679,275,972,686,286,1143,901,215,1034,763,202
060855102002,552,407,145,563,419,144,676,534,126,601,460,111
060855100022,583,416,167,588,417,171,736,580,140,625,465,124
060855100023,641,432,209,647,433,214,786,623,151,689,512,140
060855101001,818,569,249,833,578,255,1030,804,196,972,714,199
060855117022,440,300,140,446,305,141,536,402,116,460,329,104
060855103001,857,626,231,877,643,234,1028,827,178,935,724,147
060855103002,853,649,204,887,667,220,1062,859,185,931,696,188
060855099011,694,527,167,705,536,169,937,759,161,803,630,131
060855100015,471,350,121,476,359,117,557,449,99,509,385,95
060855100016,427,322,105,437,331,106,541,434,96,477,366,80
060855100013,664,475,189,675,480,195,763,614,135,692,519,130
060855078051,403,295,108,405,294,111,493,374,109,504,375,100
060855100021,753,558,195,762,561,201,911,717,172,772,594,140
060855100012,945,687,258,963,688,275,1109,898,192,1014,760,196
060855100011,459,347,112,462,344,118,555,446,98,530,413,88
060855101002,871,613,258,886,618,268,1060,832,203,833,603,183
060855077041,410,304,106,420,308,112,584,458,117,483,355,99
060855117071,972,671,301,985,684,301,1179,926,232,989,724,199
060855100014,370,259,111,378,266,112,508,409,91,389,293,72
060855117021,1118,767,351,1147,775,372,1410,1052,308,1157,831,261
060855117013,558,370,188,564,376,188,680,498,155,699,495,153
060855117042,297,202,95,303,204,99,369,280,82,305,215,70
060855117041,1262,839,423,1286,846,440,1661,1232,384,1379,955,337
060855093021,812,682,130,819,672,147,961,782,152,886,715,112
060855093033,246,208,38,250,206,44,351,284,55,310,248,45
060855093034,322,266,56,328,265,63,397,322,63,365,292,54
060855094031,393,333,60,398,331,67,514,421,79,416,337,50
060855094032,232,196,36,234,195,39,317,258,49,282,229,34
060855094033,263,223,40,267,222,45,362,296,55,320,259,38
060855094042,226,189,37,228,188,40,309,255,49,356,291,41
060855091092,949,793,156,971,803,168,732,602,113,631,522,70
060855092011,482,411,71,485,414,71,815,677,119,699,583,72
060855092013,176,148,28,178,149,29,241,200,35,175,143,20
060855095001,464,404,60,476,404,72,574,471,89,632,528,55
060855095002,551,467,84,561,471,90,686,572,102,599,504,51
060855095003,611,513,98,616,517,99,758,640,110,724,604,70
060855092021,637,519,118,652,526,126,849,704,125,665,531,96
060855092022,379,300,79,391,307,84,454,376,67,469,372,70
060855092023,288,222,66,296,226,70,345,282,55,335,263,53
060855092024,344,258,86,356,267,89,422,348,70,424,327,71
060855093032,336,260,76,344,264,80,380,310,61,333,267,49
060855091111,642,507,135,654,514,140,882,724,144,691,533,113
060855091071,434,355,79,441,358,83,677,531,129,541,435,72
060855091112,722,564,158,737,571,166,832,680,133,765,609,109
060855091091,585,467,118,593,473,120,998,827,152,669,538,83
060855091093,307,257,50,315,259,56,552,457,83,559,467,59
060855091082,247,201,46,250,200,50,314,259,49,296,233,41
060855091021,766,611,155,772,612,160,864,708,136,911,719,140
060855091084,487,403,84,491,394,97,564,463,85,573,454,76
060855092012,434,355,79,446,361,85,527,433,80,586,471,76
060855092014,486,389,97,497,397,100,650,516,118,556,437,80
060855096002,369,319,50,380,327,53,487,424,55,426,361,36
060855096003,534,457,77,549,470,79,751,646,89,621,526,56
060855096001,437,354,83,443,356,87,491,426,57,463,383,47
060855098011,587,473,114,604,487,117,807,675,114,597,476,83
060855098014,794,611,183,807,620,187,940,771,151,850,666,131
060855047001,96,63,33,96,63,33,162,109,48,108,68,32
060855091081,342,277,65,354,283,71,490,402,78,397,308,62
060855091083,326,263,63,334,267,67,480,394,74,362,281,57
060855097002,427,367,60,438,372,66,406,347,48,473,405,41
060855094013,237,199,38,244,202,42,425,351,59,299,241,38
060855099012,456,343,113,462,346,116,535,436,88,479,377,75
060855098022,691,542,149,701,556,145,822,667,142,718,582,104
060855099021,1027,818,209,1046,827,219,1293,1043,222,1182,917,191
060855099022,633,474,159,643,472,171,755,605,132,725,539,142
060855099023,740,531,209,753,539,214,761,614,131,675,492,144
060855098021,542,446,96,553,446,107,726,613,93,649,525,83
060855097003,459,383,76,470,388,82,620,512,96,515,422,65
060855097001,530,454,76,542,460,82,598,518,70,568,486,48
060855094043,639,528,111,654,534,120,615,503,96,527,440,55
060855091072,166,136,30,171,138,33,254,194,52,214,158,42
060855091073,234,192,42,237,193,44,327,255,65,317,252,48
060855094041,426,349,77,436,358,78,800,668,114,666,549,85
060855094044,296,243,53,301,248,53,386,320,55,329,271,42
060855091101,467,373,94,474,375,99,729,594,122,646,502,101
060855084015,565,408,157,573,414,159,742,565,163,646,466,138
060855091102,459,371,88,467,374,93,452,369,73,426,335,63
060855093031,311,256,55,316,260,56,397,322,63,436,349,58
060855093042,627,510,117,637,516,121,750,608,123,680,559,75
060855116082,123,113,10,123,112,11,174,160,10,149,136,4
060855116081,19,18,1,19,18,1,22,21,1,17,17,0
060855130001,123,114,9,125,114,11,180,168,7,210,191,7
060855130006,305,282,23,308,280,28,622,583,24,427,388,13
060855130004,225,208,17,228,207,21,284,265,12,246,221,7
060855130002,586,540,46,591,537,54,200,188,7,649,586,17
060855130003,1,1,0,1,1,0,287,268,11,3,3,0
060855130005,182,168,14,185,168,17,206,193,8,218,196,6
060855115021,379,341,38,386,346,40,603,563,25,674,605,37
060855077042,918,636,282,940,645,295,1191,884,281,1037,739,239
060855077023,1166,819,347,1198,852,346,1530,1159,340,1209,909,249
060855081011,780,563,217,805,582,223,957,709,224,859,630,183
060855081013,638,478,160,644,481,163,968,728,223,784,615,135
060855081022,159,119,40,166,126,40,369,281,76,161,121,30
060855080061,920,642,278,944,661,283,1271,929,302,1031,763,201
060855080052,499,359,140,513,368,145,708,528,164,527,388,117
060855080062,462,307,155,477,315,162,636,478,151,522,362,127
060855080031,345,251,94,355,259,96,521,372,136,412,309,80
060855078062,272,200,72,278,204,74,435,326,101,407,311,82
060855078063,118,91,27,123,97,26,181,136,42,168,130,30
060855078064,387,291,96,397,301,96,579,431,133,430,332,78
060855081012,743,549,194,766,569,197,1050,783,245,899,667,176
060855077021,920,669,251,948,691,257,1291,985,284,1154,872,231
060855077022,803,560,243,829,571,258,1059,810,237,863,654,166
060855077013,510,339,171,525,348,177,681,505,162,602,437,135
060855078071,483,362,121,502,364,138,802,595,194,594,452,109
060855078072,661,468,193,682,481,201,946,710,216,754,567,153
060855078081,445,312,133,459,327,132,518,393,117,577,437,118
060855078082,498,356,142,512,366,146,749,565,168,681,519,138
060855080051,379,268,111,391,275,116,472,353,110,451,326,102
060855080053,352,249,103,362,254,108,472,356,110,403,297,84
060855080032,283,203,80,291,210,81,404,297,93,369,273,70
060855080042,504,363,141,519,367,152,696,496,182,539,399,111
060855077011,432,314,118,440,308,132,606,451,139,510,382,102
060855078052,500,365,135,511,362,149,610,459,139,499,374,101
060855078053,204,161,43,207,162,45,312,232,73,253,201,40
060855078054,460,319,141,466,328,138,637,467,160,558,404,120
060855082033,958,711,247,978,722,256,1041,796,212,934,699,184
060855083052,163,125,38,167,126,41,376,275,92,295,233,47
060855077051,911,632,279,934,662,272,1237,963,243,1024,767,194
060855077052,419,305,114,431,315,116,576,450,114,504,382,90
060855077053,495,387,108,509,396,113,615,479,122,538,410,93
060855078061,521,387,134,541,399,142,667,499,153,607,453,129
060855077012,672,466,206,709,511,198,1014,775,218,780,585,165
060855078084,794,562,232,817,581,236,1095,832,245,836,625,174
060855068014,338,220,118,348,224,124,465,342,116,413,285,107
060855069004,1200,803,397,1230,819,411,1489,1073,374,1310,893,329
060855071001,537,370,167,543,377,166,612,444,156,574,408,129
060855072031,514,354,160,522,358,164,710,498,191,561,376,148
060855072032,659,439,220,669,446,223,833,596,217,722,498,181
060855072053,732,482,250,748,495,253,978,694,255,846,562,228
060855071002,825,593,232,833,599,234,998,722,250,867,618,194
060855072061,775,472,303,786,477,309,1018,693,309,853,562,238
060855067032,392,292,100,397,291,106,560,398,149,401,289,88
060855067033,279,208,71,283,207,76,420,288,121,313,225,67
060855070022,761,518,243,772,510,262,695,518,161,637,454,149
060855072054,413,268,145,418,273,145,503,362,134,465,309,127
060855070031,518,371,147,525,374,151,614,473,127,519,379,110
060855070043,319,227,92,324,229,95,534,411,113,345,251,74
060855070021,1030,696,334,1052,709,343,1283,944,313,1204,847,300
060855070041,992,682,310,1007,684,323,1290,934,323,1152,830,262
060855070032,1105,686,419,1125,703,422,1301,889,382,1186,778,346
060855072051,335,222,113,336,222,114,443,318,117,370,250,89
060855072052,991,633,358,1013,659,354,1136,811,302,1095,717,321
060855068011,939,632,307,959,646,313,1266,915,319,1053,728,256
060855068013,805,555,250,811,561,250,966,733,220,875,618,209
060855073015,911,541,370,922,546,376,1118,764,331,898,578,261
060855068012,736,494,242,748,500,248,885,623,239,765,519,196
060855072062,776,487,289,790,494,296,946,652,276,805,539,218
060855070042,662,470,192,674,476,198,963,699,245,755,538,182
060855026031,332,233,99,340,232,108,383,284,88,373,260,84
060855026032,448,317,131,456,312,144,553,412,125,447,320,93
060855026042,369,275,94,373,273,100,544,405,122,388,273,88
060855026043,764,572,192,779,578,201,1133,854,253,913,687,167
060855065023,667,521,146,678,519,159,1098,834,238,770,565,155
060855065031,858,642,216,879,656,223,1184,859,298,1092,771,239
060855065021,665,497,168,678,501,177,869,659,183,758,559,143
060855065022,423,316,107,429,317,112,529,401,114,427,315,81
060855065032,890,661,229,906,677,229,1068,766,281,984,708,217
060855065033,511,379,132,518,381,137,886,657,207,643,471,129
060855067031,790,545,245,799,561,238,1016,725,265,935,631,248
060855067021,844,618,226,866,612,254,1162,848,290,945,664,212
060855067023,443,340,103,449,337,112,606,451,138,565,409,116
060855066062,800,606,194,816,609,207,1065,804,230,947,703,173
060855066061,219,177,42,226,179,47,305,230,66,289,218,55
060855027031,454,326,128,466,332,134,821,579,219,581,389,151
060855027032,514,368,146,526,376,150,656,463,174,755,511,177
060855123111,658,392,266,670,396,274,1012,654,337,724,429,256
060855123121,1411,908,503,1441,914,527,1988,1338,597,1551,950,495
060855123143,656,432,224,661,434,227,1201,765,405,698,451,199
060855123144,307,202,105,311,203,108,478,312,155,324,215,89
060855123051,1555,939,616,1578,942,636,2041,1295,695,1805,1075,616
060855123052,663,368,295,672,360,312,1002,572,397,843,445,337
060855123141,923,558,365,936,553,383,934,599,310,887,519,300
060855123142,276,177,99,281,176,105,375,240,123,306,187,95
060855123081,1158,655,503,1169,662,507,1939,1219,671,1160,680,407
060855123082,1374,808,566,1402,807,595,2053,1289,716,1579,931,549
060855123102,224,142,82,228,133,95,544,353,178,417,274,114
060855123071,665,401,264,671,392,279,1073,653,387,807,470,273
060855123072,1241,728,513,1243,704,539,1363,842,483,1141,654,397
060855123101,1125,757,368,1149,755,394,1606,1095,468,1138,767,304
060855123112,641,387,254,658,394,264,1202,801,369,673,413,221
060855123093,520,312,208,531,309,222,661,423,226,503,292,174
060855123132,408,249,159,415,246,169,677,456,202,435,273,129
060855123073,1228,700,528,1254,701,553,1556,945,573,1370,763,504
060855123083,1188,658,530,1210,649,561,1514,930,549,1252,702,460
060855123091,1149,678,471,1173,676,497,1360,871,456,1227,744,399
060855124022,420,218,202,430,212,218,526,299,218,480,253,197
060855123131,578,381,197,589,392,197,972,634,308,683,436,191
060855123092,715,434,281,728,436,292,942,602,314,771,455,255
060855125051,716,530,186,721,517,204,1221,880,314,786,570,176
060855125132,577,438,139,583,423,160,939,710,207,805,590,159
060855125131,380,291,89,386,288,98,606,436,163,428,301,102
060855125142,432,332,100,441,323,118,791,574,191,540,393,109
060855125102,670,410,260,681,408,273,887,614,258,775,473,250
060855125103,721,474,247,728,463,265,998,693,288,892,560,278
060855125111,675,440,235,685,437,248,939,624,305,707,490,175
060855125112,742,465,277,756,464,292,1035,672,343,840,525,262
060855125122,453,300,153,456,298,158,652,439,201,550,364,151
060855126042,463,373,90,463,364,99,794,613,155,560,428,93
060855125052,734,556,178,739,539,200,1094,776,298,867,622,197
060855125092,557,380,177,562,370,192,413,292,112,357,243,92
060855126032,138,105,33,140,103,37,237,165,67,158,112,36
060855126033,232,181,51,231,178,53,556,414,132,291,218,48
060855125121,659,425,234,669,429,240,905,615,270,764,505,214
060855125093,621,412,209,628,408,220,730,494,218,639,446,168
060855126021,368,228,140,370,225,145,614,405,202,418,277,123
060855126041,370,299,71,372,293,79,541,429,99,464,361,67
060855126031,162,127,35,161,125,36,282,218,60,210,156,34
060855125162,1019,569,450,1036,572,464,1578,971,569,673,373,265
060855122003,541,293,248,553,295,258,975,575,382,596,312,248
060855125101,1209,675,534,1241,689,552,1563,967,563,1173,689,418
060855124011,732,400,332,738,399,339,866,473,369,670,372,264
060855125152,827,461,366,846,463,383,748,439,293,993,582,359
060855125153,478,273,205,485,274,211,1152,753,378,572,342,206
060855125151,914,515,399,932,512,420,1289,762,491,1061,638,352
060855125053,555,408,147,551,395,156,772,569,188,565,416,114
060855125091,614,381,233,634,378,256,1658,1073,549,918,586,277
060855125161,1160,718,442,1173,713,460,1654,1042,560,1309,774,439
060855125141,183,138,45,185,134,51,525,399,117,226,163,48
060855124013,512,300,212,518,297,221,792,469,304,660,390,221
060855048051,914,647,267,941,638,303,1174,825,315,1054,749,245
060855090011,505,385,120,515,389,126,670,515,139,592,449,101
060855090012,392,297,95,398,299,99,582,443,118,469,356,80
060855048021,388,282,106,392,272,120,539,377,149,433,307,105
060855048022,611,444,167,627,450,177,885,641,219,745,572,134
060855048052,333,244,89,336,247,89,1134,785,320,831,588,198
060855048053,783,595,188,791,589,202,1056,795,232,885,614,207
060855087081,583,481,102,591,481,110,846,668,155,808,649,105
060855087072,619,504,115,629,506,123,1032,814,193,531,420,73
060855088002,277,224,53,281,224,57,365,289,68,410,322,61
060855090021,594,466,128,602,468,134,796,611,163,692,540,110
060855090022,440,347,93,442,345,97,615,477,127,536,420,86
060855048072,792,591,201,812,597,215,1097,844,231,479,375,81
060855048071,337,259,78,343,257,86,457,350,97,395,301,71
060855048073,156,118,38,159,118,41,211,161,45,538,421,90
060855088001,444,347,97,453,350,103,678,531,123,516,405,76
060855087071,407,330,77,412,334,78,474,373,89,460,360,61
060855091022,263,213,50,267,216,51,371,284,80,343,273,40
060855091023,193,155,38,195,156,39,345,270,69,218,171,32
060855086013,471,357,114,476,358,118,660,518,126,523,402,92
060855084044,468,350,118,473,349,124,664,505,137,492,348,114
060855085092,88,69,19,88,68,20,82,63,18,149,111,27
060855085093,158,124,34,160,126,34,256,198,54,244,183,43
060855085091,274,209,65,283,219,64,411,316,84,151,117,24
060855085094,292,227,65,296,232,64,405,316,81,343,259,60
060855085102,338,257,81,350,270,80,426,331,88,505,385,90
060855086023,623,501,122,634,508,126,1074,857,191,549,434,79
060855086021,414,326,88,421,322,99,612,488,111,543,407,97
060855086022,250,202,48,253,204,49,326,262,58,277,207,50
060855087052,109,84,25,110,85,25,60,49,10,136,105,21
060855087053,317,249,68,320,244,76,463,369,84,362,286,53
060855086024,270,219,51,273,222,51,428,340,75,319,239,57
060855086011,263,191,72,269,196,73,371,277,82,256,185,57
060855086012,641,466,175,655,477,178,830,624,183,742,533,167
060855048061,360,275,85,371,273,98,520,379,126,389,308,58
060855048062,429,339,90,427,335,92,663,511,138,572,450,88
060855048081,372,290,82,375,284,91,556,427,118,459,343,87
060855084011,304,224,80,309,228,81,383,292,85,352,260,71
060855084012,461,341,120,471,346,125,595,450,130,508,373,102
060855091061,369,280,89,375,283,92,503,395,97,420,321,75
060855091062,449,326,123,457,331,126,596,449,128,476,358,88
060855091063,329,229,100,333,231,102,477,355,105,386,281,77
060855084016,381,270,111,391,280,111,493,379,109,441,314,97
060855084013,384,292,92,396,293,103,507,408,89,464,353,79
060855084014,362,275,87,370,275,95,514,412,92,421,328,67
060855084041,658,471,187,666,473,193,874,673,179,726,522,157
060855084042,641,460,181,649,463,186,805,623,164,726,524,156
060855085071,318,242,76,324,247,77,403,307,89,399,299,73
060855085081,324,236,88,333,240,93,406,314,85,407,288,93
060855085082,299,223,76,304,222,82,498,382,106,344,257,65
060855082052,601,435,166,612,440,172,868,657,195,642,460,142
060855085052,469,348,121,479,353,126,598,460,123,556,418,99
060855085083,418,313,105,416,303,113,570,442,119,410,303,72
060855085084,238,176,62,239,173,66,343,263,71,301,216,66
060855083011,625,465,160,640,474,166,794,603,172,727,541,146
060855085051,573,418,155,587,427,160,713,548,147,576,437,101
060855085053,246,185,61,254,189,65,308,238,64,258,192,47
060855085054,241,181,60,247,184,63,405,312,83,336,251,60
060855084031,357,269,88,364,274,90,474,375,86,390,276,82
060855048023,476,378,98,489,385,104,826,638,169,593,460,87
060855089003,196,153,43,199,153,46,337,264,64,276,206,51
060855089004,216,168,48,219,166,53,389,304,72,348,261,64
060855089001,406,315,91,415,311,104,589,463,112,515,387,91
060855082042,413,309,104,422,313,109,534,411,105,487,368,89
060855082043,531,392,139,537,390,147,710,547,146,612,455,121
060855083012,602,442,160,618,455,163,789,600,172,700,525,139
060855083013,817,590,227,826,604,222,1059,809,230,890,672,176
060855082061,398,288,110,409,295,114,537,408,121,434,314,93
060855082062,548,384,164,569,400,169,713,527,164,618,436,133
060855082063,614,433,181,636,444,192,826,613,190,665,466,153
060855089002,284,220,64,289,218,71,412,330,77,357,283,49
060855084043,605,446,159,617,453,164,776,594,160,697,505,139
060855082051,422,295,127,428,298,130,618,461,143,654,456,155
060855082041,412,313,99,422,321,101,625,491,120,499,387,79
060855053012,572,433,139,579,432,147,674,496,162,413,307,77
060855085031,408,302,106,417,307,110,521,392,115,393,289,73
060855085032,421,328,93,430,334,96,568,443,110,484,373,81
060855085033,387,300,87,395,307,88,485,381,92,457,352,76
060855083031,623,452,171,632,458,174,787,602,169,695,520,139
060855084032,498,382,116,509,387,122,703,569,118,559,434,103
060855084033,421,323,98,430,329,101,529,430,89,455,346,81
060855085034,189,147,42,193,150,43,259,203,50,190,150,30
060855083032,698,508,190,701,510,191,839,641,180,769,589,144
060855083061,206,154,52,209,156,53,328,239,78,143,112,24
060855083053,354,267,87,364,267,97,588,420,151,473,368,78
060855083051,253,191,62,260,193,67,430,313,107,332,267,47
060855087063,423,329,94,431,333,98,612,464,139,495,381,84
060855087061,386,299,87,393,306,87,570,437,124,358,287,52
060855087062,465,357,108,470,363,107,603,459,138,558,426,95
060855083062,1015,747,268,1037,767,270,1286,980,277,1253,940,243
060855087051,392,299,93,397,306,91,506,404,93,534,413,83
060855082031,546,412,134,558,422,136,651,508,125,561,426,102
060855082032,539,404,135,546,410,136,693,548,133,632,471,124
060855085101,244,183,61,252,192,60,362,277,74,273,210,45
060855057004,513,406,107,521,406,115,782,615,148,630,483,106
060855052022,280,210,70,288,212,76,956,720,219,349,254,71
060855052021,431,315,116,435,313,122,657,483,161,506,384,91
060855052023,419,303,116,423,302,121,628,460,153,484,360,92
060855052024,271,198,73,273,197,76,379,278,93,344,253,69
060855053032,409,299,110,421,301,120,622,467,146,520,381,104
060855056001,354,269,85,362,269,93,464,353,106,391,300,71
060855057001,302,229,73,307,230,77,387,298,84,330,245,66
060855056002,261,197,64,268,198,70,303,233,67,348,257,68
060855054021,365,262,103,374,263,111,475,333,133,408,282,102
060855054022,673,481,192,692,485,207,854,607,230,794,559,190
060855055001,390,284,106,391,278,113,498,378,108,494,360,101
060855055003,534,388,146,538,380,158,689,526,147,602,422,140
060855055002,616,467,149,625,458,167,850,632,199,671,486,136
060855060002,385,284,101,392,279,113,409,312,94,389,285,91
060855060003,792,600,192,807,593,214,959,725,216,880,654,167
060855056003,388,304,84,392,300,92,495,374,107,549,424,83
060855060001,436,322,114,444,317,127,610,455,142,526,374,116
060855057002,398,316,82,404,316,88,550,414,128,505,362,108
060855059021,747,550,197,770,556,214,933,705,202,764,575,151
060855059013,347,245,102,359,256,103,460,339,113,422,311,85
060855060004,225,170,55,228,167,61,354,267,81,260,193,49
060855053022,596,441,155,610,437,173,834,620,198,636,458,133
060855053033,291,215,76,296,212,84,385,291,92,326,238,68
060855053041,389,291,98,394,292,102,456,340,108,414,310,78
060855053043,638,455,183,657,463,194,806,601,190,719,526,146
060855053042,284,212,72,293,216,77,390,288,93,329,246,63
060855053051,455,333,122,460,328,132,586,433,142,585,400,144
060855053052,331,240,91,338,239,99,448,330,109,398,276,97
060855053053,470,326,144,473,326,147,669,494,162,588,397,147
060855053054,477,333,144,481,329,152,688,512,163,534,363,134
060855054031,684,511,173,696,517,179,660,487,156,761,556,151
060855054032,551,410,141,554,406,148,1144,840,269,652,489,118
060855061012,810,590,220,829,593,236,947,717,217,865,647,164
060855054011,426,304,122,437,300,137,614,443,159,525,376,112
060855054015,195,146,49,196,145,51,235,170,61,210,157,38
060855054013,299,221,78,302,220,82,397,284,103,387,287,74
060855049022,556,434,122,565,442,123,832,636,180,699,554,109
060855049021,208,162,46,212,164,48,275,208,60,266,210,42
060855049023,254,198,56,259,201,58,521,395,113,329,262,52
060855050111,506,369,137,511,363,148,886,666,203,760,552,165
060855050112,443,325,118,447,333,114,702,538,151,520,399,90
060855053021,1012,765,247,1033,772,261,1295,955,306,1161,857,223
060855053011,332,246,86,335,249,86,559,408,137,372,278,70
060855053013,438,335,103,446,340,106,678,503,165,532,402,96
060855050071,498,311,187,501,310,191,728,442,263,693,434,207
060855050072,184,116,68,189,119,70,409,252,148,328,215,97
060855050073,383,244,139,393,247,146,449,275,164,300,197,88
060855049032,610,467,143,620,457,163,896,690,194,802,596,153
060855050103,232,173,59,236,177,59,356,267,84,265,194,54
060855050101,293,221,72,294,217,77,476,358,111,358,279,62
060855059012,403,302,101,409,301,108,563,434,118,484,349,105
060855061022,872,644,228,893,641,252,1233,924,283,1017,733,225
060855049031,83,65,18,84,64,20,176,136,38,106,81,19
060855049033,163,128,35,165,125,40,306,234,66,218,167,38
060855061021,730,526,204,746,522,224,896,659,221,797,559,189
060855061013,666,494,172,678,494,184,831,638,174,716,516,150
060855061034,400,286,114,420,296,124,551,420,125,434,321,94
060855061031,551,399,152,565,402,163,768,565,188,685,486,152
060855061032,339,239,100,347,242,105,442,327,107,386,276,88
060855061033,348,247,101,360,251,109,511,385,114,381,275,87
060855081021,702,543,159,723,540,183,969,735,219,821,623,155
060855061011,527,376,151,539,374,165,734,541,178,705,491,169
060855053031,464,363,101,466,358,108,713,531,166,569,434,98
060855053034,296,233,63,298,229,69,490,366,114,354,267,60
060855054033,619,456,163,625,443,182,975,717,230,767,547,164
060855054014,224,169,55,224,169,55,335,241,87,413,317,73
060855054012,250,189,61,251,191,60,394,282,102,164,125,28
060855085072,191,146,45,195,149,46,296,225,67,220,166,40
060855045071,326,224,102,329,226,103,480,321,151,381,268,91
060855045072,492,345,147,507,351,156,729,487,224,591,435,127
060855045074,494,328,166,509,336,173,779,521,243,624,448,143
060855045082,466,346,120,483,359,124,769,513,241,454,333,103
060855045051,208,155,53,215,162,53,338,240,94,328,244,65
060855045052,665,495,170,685,510,175,1062,757,292,889,665,178
060855045053,256,187,69,264,192,72,1009,713,276,333,252,64
060855045102,189,135,54,194,139,55,340,233,102,257,194,53
060855044211,638,420,218,652,431,221,668,454,203,700,518,140
060855044212,514,354,160,536,377,159,889,605,273,647,496,118
060014433012,543,384,159,569,399,170,871,618,240,682,491,156
060855044222,448,313,135,454,311,143,848,574,265,634,465,137
060014415032,337,231,106,354,242,112,773,548,215,395,285,96
060855045063,555,351,204,561,367,194,798,540,247,525,397,104
060855045081,11,8,3,11,8,3,48,34,14,334,246,76
060855044121,648,463,185,660,463,197,445,302,134,331,243,73
060855044181,339,244,95,345,250,95,571,386,177,414,306,83
060855044183,137,100,37,141,103,38,285,194,86,188,138,38
060855044231,773,506,267,794,520,274,1111,752,346,834,592,196
060855044182,611,418,193,628,433,195,930,610,300,714,528,147
060855045073,413,308,105,421,309,112,642,433,199,467,345,94
060855044131,561,402,159,583,423,160,817,568,237,734,561,144
060855044141,916,646,270,944,668,276,1321,915,385,1099,820,217
060855044142,451,329,122,470,338,132,655,456,191,512,376,104
060855044152,566,391,175,578,395,183,822,543,266,694,495,162
060855044161,677,471,206,690,476,214,940,634,289,758,561,161
060855044162,478,329,149,496,337,159,716,471,232,546,383,134
060855044221,549,396,153,563,388,175,866,587,271,656,491,127
060855044243,494,323,171,508,334,174,741,486,240,614,433,144
060855044244,271,184,87,274,182,92,448,301,139,310,226,70
060855044242,549,356,193,562,366,196,828,541,267,647,463,152
060855044122,256,185,71,262,185,77,497,328,160,343,251,75
060855044213,519,342,177,533,350,183,880,613,254,640,457,146
060855044143,400,286,114,414,288,126,625,425,194,419,305,96
060855044151,641,442,199,662,455,207,978,668,290,750,547,168
060855045061,284,202,82,288,202,86,412,279,128,309,218,73
060855044123,238,173,65,242,174,68,384,252,124,295,217,64
060855044124,282,204,78,289,207,82,451,294,146,342,256,71
060855044153,541,369,172,555,373,182,790,532,241,628,437,153
060855045062,101,75,26,104,75,29,372,251,115,137,102,27
060855045064,374,278,96,384,276,108,731,498,227,428,323,85
060855045101,393,283,110,408,291,117,799,557,231,541,409,104
060855074011,536,367,169,549,384,165,801,588,199,562,400,131
060855075003,646,416,230,656,428,228,843,623,202,701,501,167
060855076002,671,455,216,688,471,217,836,631,193,712,495,174
060855076001,374,237,137,382,252,130,563,401,150,441,301,114
060855076003,971,619,352,998,642,356,1292,923,339,1093,734,290
060855076004,895,568,327,906,579,327,1179,843,311,928,619,250
060855073021,913,575,338,943,585,358,1194,831,333,1017,661,273
060855073022,504,292,212,511,297,214,591,388,186,530,331,160
060855074014,579,389,190,593,393,200,742,558,171,641,457,150
060855074015,396,272,124,407,275,132,407,302,97,434,302,109
060855073011,365,233,132,374,238,136,483,352,123,417,283,108
060855073012,669,432,237,683,442,241,858,610,230,698,480,178
060855073016,685,416,269,702,421,281,879,609,252,753,492,216
060855074023,596,418,178,604,418,186,798,572,211,667,473,161
060855074021,717,508,209,728,501,227,987,689,274,800,557,194
060855073013,422,269,153,432,272,160,568,389,162,562,370,161
060855073014,348,217,131,354,219,135,480,336,133,385,254,111
060855075001,938,615,323,960,630,330,1193,861,300,997,686,254
060855075002,738,469,269,748,475,273,933,682,229,832,596,196
060855075004,630,403,227,640,411,229,891,656,218,726,508,181
060855074012,591,411,180,606,425,181,821,612,197,697,507,162
060855074013,702,475,227,720,484,236,922,702,203,742,534,171
060855118001,993,673,320,1004,672,332,1191,844,316,1250,822,328
060855118002,540,387,153,553,385,168,768,553,189,587,394,138
060855118003,600,420,180,612,424,188,647,459,164,559,366,138
060855124021,287,167,120,290,158,132,488,294,181,344,214,112
060855122002,660,335,325,669,335,334,836,464,351,1145,630,449
060855135001,315,136,179,320,130,190,448,212,229,366,153,186
060855124024,530,314,216,537,312,225,739,437,281,529,282,215
060855124012,492,281,211,498,271,227,730,424,294,618,347,232
060855126022,536,265,271,547,258,289,725,390,323,565,299,238
060855124023,649,369,280,651,365,286,908,535,345,704,390,262
060855042021,517,335,182,525,326,199,717,497,206,576,366,168
060855039023,303,231,72,305,225,80,471,353,116,383,296,73
060450109004,292,165,127,296,156,140,393,203,180,352,172,157
060450108011,262,159,103,270,158,112,344,195,133,365,183,135
060450108012,481,252,229,492,240,252,716,356,336,559,250,248
060450108015,416,215,201,423,204,219,623,307,288,503,229,231
060450108014,270,141,129,271,128,143,342,163,169,298,128,149
060450109001,471,330,141,482,318,164,599,401,174,342,202,90
060450108013,714,409,305,718,400,318,954,502,422,833,423,323
060450109003,540,309,231,558,307,251,885,522,349,722,384,286
060450117001,566,336,230,570,330,240,739,431,281,629,339,228
060450117002,448,240,208,463,238,225,563,322,220,433,212,185
060450115023,382,229,153,390,222,168,523,308,203,437,242,160
060450117005,64,36,28,64,34,30,98,57,41,76,38,34
060450117003,273,160,113,274,156,118,355,209,132,280,154,102
060450113001,475,263,212,477,261,216,694,400,270,619,334,239
060450115012,419,253,166,431,255,176,646,408,222,521,294,182
060450117004,282,161,121,284,156,128,396,226,156,330,176,119
060450118001,679,474,205,687,464,223,859,583,247,740,472,204
060450108021,377,210,167,380,206,174,502,269,214,443,215,189
060450108022,372,189,183,378,183,195,444,217,211,415,176,197
060450114003,446,298,148,452,298,154,478,310,147,518,314,159
060450114005,296,209,87,304,209,95,430,292,122,323,201,92
060450116001,467,335,132,472,334,138,656,446,188,528,333,147
060450116004,402,267,135,415,273,142,593,384,191,470,283,144
060450114001,575,428,147,593,429,164,736,527,181,618,399,145
060450114002,326,225,101,334,224,110,408,277,123,373,239,104
060450115021,322,215,107,332,223,109,479,314,143,369,224,104
060450115011,343,262,81,353,262,91,462,329,117,386,252,93
060450106021,587,399,188,595,396,199,782,510,249,717,409,212
060450106022,719,463,256,726,456,270,950,579,331,778,444,247
060450106023,450,290,160,457,286,171,638,386,230,503,281,172
060450107002,565,360,205,583,368,215,694,434,239,597,347,190
060450106013,389,224,165,403,223,180,481,277,187,421,212,157
060450106012,348,245,103,353,237,116,409,277,123,516,294,161
060450107005,224,147,77,228,142,86,316,205,100,250,136,85
060450106011,410,226,184,418,227,191,521,295,213,450,216,186
060450107001,167,106,61,173,110,63,243,152,83,197,107,68
060450107007,259,144,115,268,141,127,314,179,122,245,125,107
060450107003,384,273,111,390,272,118,445,291,145,397,241,112
060450107004,204,135,69,207,127,80,309,193,107,244,138,83
060450107006,207,132,75,216,135,81,312,193,106,263,145,91
060450102001,391,303,88,398,300,98,586,428,144,425,275,88
060450102004,426,317,109,435,311,124,474,332,130,404,261,101
060450102003,265,183,82,279,185,94,302,186,105,306,171,83
060450103001,325,226,99,330,224,106,418,302,108,371,244,99
060450103002,357,254,103,361,250,111,407,286,114,344,224,96
060450103003,429,289,140,437,276,161,566,352,207,445,264,136
060450104001,209,161,48,211,160,51,259,196,58,225,165,47
060450104002,355,272,83,365,271,94,437,325,106,393,262,95
060450103004,653,422,231,665,411,254,890,555,317,720,428,236
060450104004,580,397,183,589,383,206,695,488,197,598,398,175
060450105001,317,234,83,327,227,100,457,320,124,355,236,100
060450105002,318,233,85,319,223,96,365,265,93,311,203,83
060450105005,255,188,67,256,180,76,380,268,100,319,211,86
060450105004,171,125,46,176,125,51,239,166,64,201,131,56
060450110031,317,258,59,324,256,68,687,510,158,562,388,113
060450110042,517,408,109,524,403,121,464,368,83,430,302,69
060450110033,670,492,178,678,478,200,863,604,241,676,441,161
060450110043,682,555,127,683,540,143,839,688,132,701,507,117
060450110032,206,160,46,207,157,50,218,157,57,213,146,42
060450110012,739,654,85,751,653,98,854,731,97,772,588,101
060450112001,565,456,109,572,445,127,598,466,114,522,365,77
060450110011,560,482,78,564,476,88,678,575,82,610,446,84
060450112002,176,137,39,174,131,43,410,313,84,342,236,71
060450112003,331,258,73,335,251,84,237,177,51,212,145,43
060450113003,412,211,201,419,216,203,478,257,208,430,217,187
060450111021,533,413,120,538,402,136,519,399,107,411,272,91
060450111022,471,397,74,473,395,78,716,606,94,608,466,91
060450111023,915,747,168,928,743,185,1148,932,193,954,721,174
060450109002,192,98,94,196,96,100,282,157,114,229,109,105
060450116003,171,117,54,171,116,55,291,196,91,211,134,59
060450113004,366,220,146,369,217,152,587,357,207,408,221,155
060450114004,269,162,107,276,163,113,362,218,130,313,172,111
060450116002,298,194,104,304,179,125,464,299,152,384,229,122
060450115022,155,106,49,158,103,55,223,148,70,190,118,62
060450115013,320,212,108,324,204,120,465,311,146,389,234,120
060450113002,421,255,166,429,257,172,663,432,210,525,308,175
060450102002,509,397,112,522,399,123,604,455,131,572,374,129
060450101001,258,185,73,255,173,82,257,172,74,269,149,75
060450101002,183,116,67,182,108,74,270,155,100,204,106,69
060450101003,206,144,62,208,142,66,329,202,111,237,123,84
060450103005,160,122,38,162,122,40,238,175,57,205,136,50
060450105003,276,199,77,283,200,83,379,260,114,304,197,82
060450104003,248,190,58,249,186,63,368,267,87,290,191,68
060450110041,492,421,71,496,424,72,575,502,61,496,376,58
060450118002,317,205,112,325,203,122,464,295,149,409,226,145
060190009021,178,161,17,186,159,27,304,259,38,262,237,16
060190009022,145,128,17,146,126,20,247,211,32,207,181,17
060190009023,231,201,30,237,202,35,433,364,60,301,258,27
060190009012,136,121,15,139,123,16,248,210,34,201,176,18
060190010001,201,181,20,212,185,27,362,308,50,280,254,21
060190011001,222,192,30,223,188,35,314,261,48,299,264,20
060190011002,210,178,32,211,175,36,312,259,52,271,240,24
060190010002,327,273,54,327,260,67,482,397,75,385,334,37
060190018001,276,157,119,280,158,122,404,225,171,334,198,127
060190021002,308,234,74,315,227,88,431,315,108,359,240,87
060190021003,268,202,66,270,199,71,405,304,93,309,213,75
060190022001,273,206,67,274,201,73,364,269,90,272,188,62
060190022002,259,205,54,266,203,63,368,275,85,297,206,68
060190022003,311,242,69,319,241,78,422,312,94,352,241,78
060190023003,331,259,72,339,254,85,461,341,109,410,291,86
060190001001,166,128,38,168,127,41,308,221,75,227,171,40
060190002001,125,107,18,128,107,21,151,122,24,111,97,10
060190005021,206,162,44,209,158,51,358,265,83,255,195,42
060190006011,193,153,40,197,150,47,328,238,79,254,183,49
060190006021,175,139,36,173,130,43,277,207,61,219,169,35
060190007021,274,232,42,281,224,57,392,309,70,338,286,40
060190020002,279,188,91,282,179,103,440,294,133,313,213,86
060190020003,102,80,22,103,79,24,144,108,33,129,96,25
060190006012,189,146,43,195,146,49,334,249,80,235,162,51
060190006013,144,112,32,148,110,38,240,172,56,179,130,33
060190006014,92,72,20,95,72,23,163,117,36,97,76,14
060190003002,146,121,25,147,120,27,223,195,28,178,160,13
060190004003,182,142,40,185,139,46,365,279,76,236,190,33
060190004004,128,106,22,131,102,29,208,163,43,178,143,28
060190005012,132,97,35,134,94,40,258,186,60,174,130,32
060190012011,115,92,23,120,91,29,259,202,55,189,156,24
060190086004,167,115,52,168,117,51,251,167,77,207,145,48
060190009011,185,151,34,190,155,35,288,243,40,233,196,28
060190007011,502,447,55,511,428,83,726,600,106,664,575,58
060190020005,114,89,25,115,89,26,166,131,34,130,85,37
060190002002,235,209,26,237,209,28,372,312,60,279,249,23
060190003001,264,231,33,267,231,36,395,350,45,368,333,27
060190003003,162,140,22,162,140,22,275,233,30,217,193,11
060190005022,82,66,16,82,64,18,161,120,35,102,79,15
060190024002,91,72,19,88,62,26,167,126,37,98,83,14
060190024003,132,105,27,136,98,38,250,189,54,157,123,25
060190023001,208,152,56,214,149,65,323,226,91,214,152,47
060190005011,101,88,13,104,84,20,154,115,34,104,86,13
060190024001,136,105,31,140,105,35,193,143,46,169,133,26
060190025011,134,101,33,136,101,35,216,155,51,150,116,24
060190025012,154,117,37,156,117,39,236,176,59,173,137,35
060190025013,83,67,16,83,62,21,169,125,37,141,104,28
060190025014,109,88,21,111,84,27,231,169,52,334,252,62
060190028001,171,136,35,178,131,47,291,221,68,230,167,49
060190028002,76,59,17,75,56,19,114,89,25,97,71,21
060190028003,95,76,19,97,72,25,187,141,44,142,106,28
060190028004,128,101,27,129,95,34,220,167,53,171,132,33
060190025023,205,163,42,212,152,60,375,282,85,126,99,20
060190025021,93,74,19,95,69,26,196,137,45,103,85,16
060190025022,65,54,11,67,49,18,160,112,38,77,64,11
060190026011,166,141,25,166,126,40,253,189,63,227,188,31
060190026012,221,191,30,226,171,55,353,266,86,297,242,37
060190026013,243,186,57,246,176,70,364,279,82,295,225,53
060190027011,191,148,43,193,139,54,308,223,72,233,176,40
060190027013,161,122,39,163,117,46,262,192,62,191,149,35
060190027012,307,246,61,307,239,68,462,350,112,397,302,77
060190027021,186,153,33,186,141,45,285,212,68,241,187,43
060190027022,192,158,34,193,147,46,330,239,76,261,199,46
060190052041,351,205,146,360,200,160,544,340,191,425,237,156
060190052042,288,154,134,295,150,145,417,260,147,346,192,131
060190052043,268,156,112,272,149,123,420,262,147,333,191,119
060190052032,422,279,143,436,269,167,709,443,247,520,345,139
060190052021,227,143,84,233,142,91,419,258,153,296,187,90
060190052022,299,187,112,305,186,119,530,320,197,380,232,115
060190031042,742,369,373,752,370,382,1114,563,527,821,392,374
060190013041,72,56,16,73,55,18,138,107,27,100,80,15
060190013042,388,312,76,393,301,92,632,502,124,520,436,60
060190013043,86,71,15,89,66,23,171,133,33,128,105,16
060190012021,214,178,36,216,171,45,445,353,84,310,266,28
060190012022,399,321,78,404,309,95,631,502,121,527,455,55
060190027024,60,50,10,64,46,18,129,94,25,76,64,6
060190027023,74,60,14,79,52,27,160,118,33,106,88,14
060190029031,190,144,46,195,135,60,280,200,73,238,177,50
060190029032,266,195,71,273,187,86,458,306,139,352,250,83
060190029033,69,55,14,71,54,17,117,83,31,93,75,15
060190029041,302,223,79,309,209,100,474,334,140,365,265,90
060190029042,249,172,77,254,164,90,369,240,122,309,211,86
060190029051,433,302,131,449,288,161,726,474,229,565,385,143
060190033021,141,103,38,142,98,44,279,203,75,209,153,43
060190033023,177,136,41,181,129,52,328,230,90,265,190,60
060190026021,247,187,60,250,178,72,332,251,67,270,197,51
060190026022,279,211,68,287,204,83,350,274,70,330,249,62
060190026023,189,156,33,191,148,43,309,239,64,245,194,43
060190013011,183,149,34,189,145,44,247,189,51,243,189,39
060190013012,161,129,32,165,125,40,218,173,45,213,168,35
060190013013,153,127,26,158,121,37,205,158,44,165,145,15
060190013015,128,104,24,131,99,32,180,138,38,174,134,27
060190013014,186,155,31,191,146,45,274,215,59,245,216,24
060190013031,124,102,22,129,94,35,226,181,45,176,145,21
060190013032,104,86,18,106,77,29,185,146,37,153,127,17
060190004001,214,182,32,218,173,45,366,283,77,274,219,40
060190004002,179,147,32,183,135,48,332,257,67,253,215,27
060190012014,59,48,11,59,41,18,133,107,26,109,88,16
060190012012,289,228,61,292,220,72,399,303,92,376,299,61
060190012013,290,243,47,296,232,64,438,348,83,336,272,46
060190029062,526,360,166,542,332,210,822,549,263,671,440,189
060190029061,247,176,71,252,168,84,428,285,136,325,226,81
060190030011,175,128,47,175,125,50,335,234,93,214,161,45
060190023002,320,230,90,320,227,93,459,316,129,341,239,75
060190021001,298,214,84,302,205,97,408,288,116,356,235,91
060190021004,250,179,71,253,173,80,391,272,112,284,192,75
060190021005,293,212,81,298,204,94,449,310,128,333,223,84
060190014072,217,150,67,222,151,71,388,277,104,304,247,46
060190014081,367,265,102,378,256,122,430,307,117,430,275,131
060190014071,266,184,82,272,185,87,255,180,68,196,159,29
060190014082,237,164,73,246,166,80,339,243,92,328,208,102
060190014073,125,101,24,127,98,29,326,232,88,179,145,26
060190014074,31,25,6,31,24,7,55,40,15,45,37,6
060190042054,156,97,59,157,95,62,281,181,94,206,120,71
060190047031,347,235,112,353,224,129,594,408,168,548,357,152
060190047043,180,122,58,182,116,66,285,196,80,155,114,35
060190047042,185,125,60,185,122,63,285,200,81,203,140,49
060190047041,495,339,156,499,332,167,693,483,196,428,292,110
060190047032,199,137,62,200,131,69,294,205,85,247,178,58
060190047033,195,135,60,196,129,67,311,215,89,251,181,60
060190047061,458,276,182,466,275,191,667,430,219,538,360,147
060190047062,158,95,63,160,95,65,217,140,72,180,102,70
060190047052,293,176,117,294,174,120,391,253,129,360,204,139
060190047051,262,177,85,269,163,106,488,319,162,400,248,136
060190047063,263,176,87,272,163,109,481,310,159,340,223,100
060190038121,303,119,184,312,121,191,635,307,309,361,143,202
060190038112,498,325,173,503,314,189,757,473,272,594,368,188
060190038101,571,376,195,584,376,208,949,616,312,708,459,217
060190038102,492,312,180,494,304,190,798,490,291,561,338,185
060190038091,506,337,169,516,323,193,800,516,273,636,405,198
060190038092,456,299,157,459,284,175,700,453,231,532,332,167
060190038103,330,212,118,331,211,120,460,302,149,409,250,143
060190022004,326,251,75,329,247,82,456,340,103,331,227,74
060190024004,155,121,34,160,113,47,242,182,56,238,166,59
060190032022,265,181,84,268,175,93,400,274,119,326,218,90
060190032023,279,193,86,282,188,94,439,307,121,333,219,97
060190032024,155,108,47,159,107,52,265,187,74,215,148,55
060190032011,408,261,147,416,242,174,592,383,199,475,304,152
060190032012,461,282,179,468,277,191,747,472,258,605,383,178
060190035003,554,416,138,560,416,144,657,474,163,554,374,133
060190035004,393,272,121,405,274,131,519,367,129,424,275,115
060190036004,390,283,107,391,277,114,509,369,134,429,296,112
060190036005,313,232,81,317,227,90,378,274,101,356,245,91
060190036002,303,214,89,308,215,93,384,273,99,328,221,85
060190036003,329,220,109,336,225,111,445,320,118,370,244,104
060190036001,379,253,126,390,254,136,464,333,123,424,274,120
060190037021,367,268,99,373,263,110,590,392,177,587,403,149
060190037022,196,146,50,199,142,57,386,259,116,244,172,60
060190037023,163,106,57,166,107,59,230,157,70,194,123,60
060190037024,215,139,76,215,139,76,286,197,87,237,151,72
060190037011,304,203,101,311,200,111,464,323,134,376,247,105
060190037012,313,209,104,319,206,113,500,344,144,412,277,104
060190034011,136,101,35,137,93,44,266,174,76,172,130,32
060190034013,147,110,37,152,105,47,263,179,76,173,134,33
060190034012,135,99,36,139,96,43,217,146,64,195,139,45
060190034022,240,166,74,241,160,81,398,278,117,306,203,84
060190035002,262,171,91,266,171,95,382,264,115,308,204,83
060190035005,211,144,67,212,140,72,325,225,95,259,174,63
060190035001,159,116,43,161,113,48,250,168,72,212,151,47
060190033011,410,289,121,414,274,140,691,469,195,473,310,131
060190034021,177,126,51,184,123,61,289,203,85,212,138,60
060190032021,212,141,71,220,133,87,331,223,105,247,158,77
060190033012,318,213,105,323,207,116,434,299,123,386,252,111
060190046011,699,389,310,717,382,335,965,547,392,788,410,338
060190046022,506,228,278,518,232,286,587,318,254,496,233,231
060190048021,371,257,114,381,252,129,631,435,181,554,383,140
060190048023,202,141,61,205,133,72,317,213,97,279,178,87
060190048022,195,135,60,198,127,71,455,298,144,292,185,94
060190048011,345,224,121,348,216,132,649,434,201,537,323,174
060190048012,232,143,89,231,138,93,332,219,106,265,156,91
060190048013,190,138,52,192,134,58,244,178,62,162,123,31
060190049011,492,322,170,504,314,190,777,517,239,570,342,196
060190049012,463,308,155,471,300,171,675,468,198,555,350,172
060190049022,311,185,126,315,184,131,445,263,177,381,200,166
060190051002,260,170,90,264,164,100,419,272,134,308,194,93
060190051003,161,120,41,166,116,50,286,188,93,182,131,42
060190051004,96,72,24,98,69,29,186,120,60,119,84,28
060190051005,283,175,108,286,172,114,403,262,131,320,194,104
060190051001,394,233,161,406,232,174,500,327,165,437,250,154
060190058053,824,391,433,839,378,461,1395,682,671,646,278,330
060190058051,267,133,134,272,127,145,655,337,298,284,136,133
060190058052,1058,456,602,1085,450,635,1814,820,949,1186,492,634
060190059043,1372,483,889,1395,471,924,2090,769,1272,1575,506,1000
060190059042,727,339,388,738,333,405,1756,838,872,836,391,397
060190058041,329,154,175,334,153,181,529,234,286,366,151,196
060190058044,245,128,117,251,127,124,396,203,180,275,141,115
060190058045,282,147,135,290,149,141,508,261,231,373,193,153
060190058042,305,154,151,312,160,152,487,246,226,378,186,156
060190058043,684,323,361,689,314,375,995,428,546,756,307,417
060190052031,376,241,135,383,227,156,608,401,193,453,286,147
060190042081,873,358,515,891,359,532,1123,493,614,905,364,505
060190042101,467,218,249,469,218,251,630,283,343,645,302,314
060190042102,660,290,370,667,286,381,891,398,485,599,261,314
060190042141,625,251,374,631,251,380,774,346,418,676,268,380
060190042142,514,207,307,527,212,315,584,275,299,554,206,327
060190043012,724,222,502,742,234,508,856,325,512,684,196,456
060190043013,909,281,628,926,293,633,1073,430,627,968,289,638
060190043021,568,219,349,575,224,351,654,302,344,586,203,359
060190043011,857,231,626,879,247,632,975,403,559,954,291,628
060190042144,739,356,383,750,342,408,1018,496,509,792,370,390
060190042143,600,250,350,612,251,361,687,336,337,594,228,338
060190043022,601,242,359,611,245,366,736,337,383,622,251,342
060190043024,524,211,313,537,216,321,610,291,309,513,202,291
060190042131,409,247,162,416,238,178,710,344,349,512,288,189
060190042132,723,344,379,739,347,392,981,492,471,813,391,383
060190042125,194,129,65,196,131,65,321,206,104,246,154,77
060190043031,608,247,361,622,256,366,762,366,383,657,260,367
060190043032,479,183,296,492,195,297,589,282,292,484,214,247
060190046012,426,233,193,436,229,207,569,330,237,479,221,233
060190046023,407,183,224,419,189,230,482,259,207,366,178,163
060190043023,600,243,357,609,245,364,752,338,401,601,252,323
060190045031,1108,495,613,1123,487,636,1345,643,676,1180,514,608
060190043025,672,277,395,679,281,398,770,356,394,703,302,368
060190043033,1173,516,657,1207,531,676,1425,690,697,1161,508,589
060190045061,751,343,408,771,350,421,946,449,482,770,344,383
060190045062,983,491,492,1000,497,503,1240,645,565,995,470,468
060190045032,1114,535,579,1135,546,589,1471,720,719,1435,683,666
060190045042,400,203,197,411,209,202,562,289,260,436,203,208
060190045043,276,140,136,280,143,137,372,199,166,300,141,140
060190045044,437,227,210,442,230,212,607,337,256,220,106,99
060190045051,699,392,307,709,389,320,1034,569,443,772,387,333
060190084043,179,125,54,180,114,66,144,99,45,100,72,27
060190084031,292,192,100,299,177,122,512,346,160,420,272,131
060190084052,179,111,68,181,101,80,232,155,72,178,116,55
060190084042,231,188,43,230,172,58,388,260,121,290,213,56
060190084041,177,138,39,180,130,50,286,205,73,175,125,40
060190084053,162,85,77,161,82,79,313,177,134,241,131,96
060190084051,156,130,26,157,118,39,221,161,51,157,120,24
060190083012,362,302,60,366,275,91,393,289,100,334,280,43
060190083013,188,155,33,189,141,48,289,208,75,199,164,29
060190083011,118,96,22,119,86,33,298,217,77,248,199,42
060190083032,124,101,23,127,92,35,235,170,61,135,105,23
060190083031,175,144,31,176,128,48,284,208,73,213,168,36
060190083041,34,18,16,34,18,16,55,32,22,44,29,14
060190083043,54,46,8,57,42,15,86,65,21,72,61,11
060190083044,119,99,20,119,88,31,175,131,44,149,124,23
060190039003,189,93,96,195,83,112,382,168,207,257,112,134
060190039004,250,70,180,250,65,185,363,78,282,320,64,249
060190039005,259,79,180,265,74,191,342,125,207,288,108,166
060190040061,429,280,149,435,261,174,1020,659,349,743,507,197
060190040053,310,214,96,314,197,117,206,132,73,167,112,47
060190040051,227,162,65,231,149,82,358,241,113,306,214,74
060190041001,522,156,366,527,149,378,700,252,433,596,198,374
060190076001,184,81,103,188,76,112,247,95,152,217,90,122
060190076002,160,60,100,161,54,107,188,87,101,185,87,94
060190017001,322,135,187,327,131,196,489,244,230,355,160,184
060190017003,172,63,109,171,60,111,236,110,123,207,90,111
060190018002,222,99,123,226,94,132,256,145,107,226,124,89
060190018003,337,141,196,341,135,206,483,191,284,407,143,239
060190018004,391,192,199,400,191,209,521,245,269,469,198,246
060190039001,192,54,138,194,54,140,276,118,153,257,86,163
060190039002,231,83,148,234,80,154,240,106,132,210,83,121
060190040041,312,171,141,313,154,159,452,244,201,421,218,184
060190040042,603,333,270,611,303,308,960,520,421,540,293,218
060190041002,235,162,73,240,148,92,342,236,104,256,154,88
060190040031,195,102,93,199,94,105,443,229,207,194,102,82
060190040033,626,295,331,636,288,348,840,446,385,725,354,331
060190040032,171,94,77,173,84,89,251,136,115,196,102,88
060190040052,263,192,71,267,178,89,510,354,149,340,245,82
060190042183,320,149,171,326,147,179,491,253,233,361,163,186
060190082001,85,46,39,81,41,40,114,65,46,103,60,39
060190082002,131,69,62,129,63,66,179,103,73,172,101,65
060190082003,93,52,41,99,48,51,124,71,53,112,65,47
060190082004,159,136,23,163,125,38,270,224,45,253,216,29
060190082005,88,76,12,90,69,21,82,68,14,68,58,8
060190082006,103,57,46,100,48,52,142,78,62,140,78,57
060190083042,58,32,26,59,28,31,86,48,37,74,45,26
060190082007,172,150,22,178,137,41,298,249,49,263,225,31
060190086002,226,136,90,224,130,94,325,192,124,270,160,93
060190086003,192,130,62,188,124,64,259,171,86,226,153,67
060190075001,190,67,123,193,61,132,269,111,155,227,83,134
060190076003,206,100,106,207,91,116,273,133,139,269,135,126
060190077001,360,138,222,361,126,235,543,242,293,409,157,238
060190077002,208,97,111,211,87,124,350,168,177,239,101,130
060190077003,284,132,152,288,118,170,427,207,213,310,130,162
060190080002,311,131,180,318,126,192,425,181,240,363,140,208
060190080003,256,107,149,259,104,155,376,155,205,329,109,197
060190080004,324,115,209,328,111,217,402,143,256,352,115,217
060190081002,394,192,202,399,176,223,414,214,196,389,200,172
060190081003,143,73,70,145,70,75,211,109,101,142,75,61
060190081001,267,124,143,272,118,154,458,243,207,308,137,157
060190078011,80,69,11,83,65,18,114,93,20,144,125,11
060190078012,176,141,35,178,134,44,287,216,64,178,144,24
060190078022,28,25,3,30,24,6,89,69,19,32,30,1
060190078023,109,94,15,109,86,23,176,145,29,150,133,13
060190078024,107,93,14,108,86,22,156,128,25,144,129,11
060190079032,528,310,218,534,274,260,729,361,348,525,289,204
060190081004,346,183,163,348,174,174,555,274,269,288,157,114
060190080001,405,131,274,410,126,284,625,229,381,516,175,315
060190079031,133,60,73,134,59,75,204,98,101,147,78,62
060190016001,865,399,466,880,391,489,1185,622,548,889,400,452
060190017002,274,119,155,276,118,158,362,175,182,326,151,163
060190017004,679,356,323,686,329,357,1181,623,544,726,393,296
060190073002,247,97,150,251,95,156,319,131,188,275,118,150
060190076004,276,90,186,283,91,192,422,180,235,380,153,214
060190073001,215,87,128,220,93,127,314,135,173,242,94,138
060190073005,234,73,161,240,75,165,298,116,175,265,85,166
060190075002,203,63,140,206,62,144,307,126,180,241,88,145
060190075003,180,59,121,181,53,128,276,112,160,215,79,129
060190075004,216,99,117,218,92,126,327,159,166,256,128,117
060190075005,295,131,164,299,125,174,488,198,277,343,145,178
060190074001,169,55,114,170,50,120,234,87,143,219,58,156
060190074002,192,72,120,196,64,132,259,90,163,229,73,150
060190077004,123,57,66,123,49,74,207,92,108,135,58,74
060190078021,60,40,20,60,38,22,93,39,54,63,46,17
060190061012,253,169,84,254,159,95,357,229,123,245,171,68
060190069001,225,153,72,228,145,83,319,222,93,241,170,68
060190069002,155,87,68,158,85,73,235,123,106,179,95,76
060190069003,204,105,99,206,106,100,284,164,118,234,135,89
060190085042,172,134,38,178,123,55,355,267,79,269,220,40
060190060011,744,400,344,757,381,376,1083,569,498,714,379,303
060190060013,495,261,234,505,250,255,745,392,338,589,310,250
060190060012,496,252,244,505,248,257,705,376,321,584,292,265
060190060022,247,178,69,251,164,87,357,254,100,282,205,65
060190060023,435,249,186,438,242,196,600,323,270,490,276,193
060190060021,172,109,63,173,103,70,256,168,83,189,121,59
060190062023,285,224,61,284,204,80,450,332,112,341,269,61
060190062024,360,266,94,367,244,123,573,405,142,441,316,94
060190070021,359,175,184,368,155,213,442,237,203,393,179,202
060190070022,233,151,82,235,141,94,402,268,129,285,184,81
060190070023,266,159,107,274,144,130,424,251,169,303,176,120
060190071021,275,209,66,283,191,92,404,264,140,314,238,65
060190071013,185,109,76,189,99,90,299,165,128,227,135,86
060190071014,192,158,34,192,137,55,319,224,91,231,189,35
060190071011,194,151,43,194,128,66,373,239,124,243,183,46
060190071012,179,134,45,178,113,65,303,202,98,232,171,50
060190070031,431,243,188,439,222,217,702,387,306,513,296,198
060190070032,453,250,203,460,232,228,600,347,246,493,264,219
060190070043,287,150,137,294,138,156,260,156,99,336,164,159
060190070044,501,260,241,512,240,272,710,376,322,571,283,261
060190070041,435,189,246,443,171,272,726,378,336,438,189,234
060190070033,335,196,139,347,178,169,505,267,233,379,205,158
060190070042,402,229,173,406,216,190,601,319,273,443,228,195
060190070035,345,244,101,350,228,122,574,348,218,413,292,102
060190070034,325,222,103,330,207,123,511,301,205,387,260,109
060190085011,189,100,89,187,96,91,243,139,104,206,124,76
060190073003,182,62,120,187,65,122,281,101,178,215,79,128
060190073004,219,75,144,223,76,147,312,110,201,246,87,146
060190074003,281,94,187,290,91,199,392,133,246,307,145,146
060190072044,940,281,659,953,261,692,1337,436,871,980,290,641
060190072023,728,273,455,742,259,483,1030,361,638,770,265,464
060190072022,260,102,158,264,98,166,643,249,374,273,98,159
060190072041,606,120,486,613,105,508,820,197,611,627,133,471
060190072031,923,194,729,937,184,753,1234,329,874,974,178,757
060190072043,315,68,247,321,65,256,418,114,296,305,87,194
060190072042,342,120,222,345,112,233,488,170,315,374,116,228
060190072021,594,250,344,597,236,361,523,213,297,640,259,348
060190062021,358,221,137,356,202,154,534,303,227,436,275,145
060190062022,261,211,50,272,200,72,496,366,123,299,241,46
060190061021,299,200,99,298,184,114,465,302,158,331,228,96
060190061022,130,101,29,132,93,39,206,153,51,176,124,47
060190062011,124,96,28,123,86,37,196,144,49,158,127,24
060190062012,233,174,59,238,158,80,360,253,102,309,231,59
060190061023,332,216,116,334,201,133,474,289,173,382,228,128
060190061024,343,209,134,353,205,148,503,301,191,380,222,135
060190061011,470,298,172,478,283,195,665,396,256,480,273,177
060190060024,205,129,76,209,124,85,291,175,112,233,138,86
060190064101,172,51,121,177,52,125,266,76,186,204,52,142
060190064112,744,179,565,757,180,577,966,228,723,777,172,579
060190064113,643,170,473,651,179,472,874,238,617,723,166,522
060190064102,688,214,474,693,206,487,973,270,684,743,193,505
060190063021,556,174,382,565,175,390,702,238,449,611,197,389
060190063022,353,104,249,352,95,257,441,142,288,380,98,256
060190068021,169,133,36,169,118,51,229,163,64,183,146,27
060190068023,347,237,110,349,217,132,484,318,159,366,257,92
060190068024,73,60,13,79,56,23,112,83,29,87,74,13
060190085032,380,324,56,384,299,85,562,436,118,443,374,47
060190085012,199,165,34,204,148,56,259,196,57,238,200,28
060190085013,296,245,51,301,218,83,450,343,99,328,275,40
060190085041,205,174,31,211,159,52,214,166,45,171,146,21
060190085031,137,112,25,138,100,38,187,144,39,174,148,20
060190085033,110,96,14,109,87,22,175,138,33,123,107,10
060190015002,379,234,145,384,225,159,512,290,212,425,255,150
060190067001,682,230,452,686,225,461,851,349,481,891,294,545
060190067003,413,174,239,418,167,251,604,276,314,483,202,257
060190067004,517,190,327,521,184,337,702,290,398,362,134,211
060190067005,372,154,218,374,147,227,506,208,290,413,156,234
060190066061,354,245,109,356,224,132,546,370,167,403,266,115
060190066051,423,258,165,430,237,193,571,325,235,462,250,188
060190063012,693,305,388,708,282,426,921,425,476,754,289,418
060190066031,227,110,117,230,100,130,310,151,151,251,103,133
060190066032,272,141,131,274,125,149,419,215,194,266,129,110
060190066022,256,192,64,255,170,85,416,277,132,299,222,63
060190066023,244,151,93,247,143,104,384,241,138,294,173,100
060190066062,274,210,64,276,190,86,410,309,93,273,197,59
060190067002,177,110,67,177,102,75,275,170,103,215,128,72
060190063011,311,176,135,311,161,150,416,260,154,328,184,134
060190066021,242,159,83,244,145,99,330,217,105,280,183,81
060190066024,146,113,33,146,99,47,223,149,71,182,136,35
060190066063,101,77,24,103,70,33,145,110,34,102,74,23
060190063013,344,123,221,343,111,232,470,183,276,388,141,232
060190065014,316,235,81,318,215,103,521,348,159,373,273,80
060190065013,248,155,93,249,144,105,320,190,123,234,151,76
060190065022,388,292,96,393,275,118,555,397,151,425,321,86
060190068022,170,47,123,173,44,129,226,90,131,177,54,113
060190065012,162,136,26,164,127,37,213,158,52,190,158,24
060190065021,247,192,55,251,184,67,343,256,85,283,229,47
060190065011,127,108,19,130,102,28,186,138,46,141,123,17
060190038113,720,436,284,729,421,308,1278,802,447,833,512,281
060190038122,233,97,136,234,95,139,331,149,175,268,109,146
060190038041,452,271,181,459,266,193,713,424,274,526,327,179
060190064051,1481,362,1119,1501,353,1148,1971,484,1444,1220,271,885
060190064053,548,137,411,554,132,422,833,195,621,850,185,619
060190064062,589,135,454,596,134,462,624,147,466,514,111,373
060190064061,350,84,266,355,81,274,465,109,348,387,84,280
060190064052,722,186,536,736,182,554,952,227,710,660,149,472
060190064092,403,109,294,406,108,298,459,121,329,421,99,294
060190064081,533,135,398,538,132,406,668,177,478,577,138,407
060190064071,872,180,692,880,177,703,1174,272,868,936,172,716
060190064072,344,63,281,350,67,283,411,94,308,389,67,301
060190064093,59,15,44,58,14,44,60,15,45,59,15,41
060190064095,296,76,220,298,78,220,299,78,213,301,84,201
060190016003,500,317,183,504,295,209,743,422,313,578,364,186
060190016002,226,109,117,229,103,126,277,163,114,232,119,106
060190055032,1335,474,861,1361,481,880,1711,712,974,917,322,568
060190055293,1241,383,858,1265,374,891,1603,639,939,1272,395,830
060190055042,206,74,132,211,76,135,886,374,498,666,244,396
060190055291,614,194,420,632,187,445,885,347,520,646,197,421
060190055033,807,287,520,837,291,546,869,335,517,671,243,395
060190055053,907,394,513,934,398,536,1037,459,551,741,293,414
060190055052,610,254,356,629,260,369,898,399,477,620,246,343
060190055041,620,274,346,631,271,360,1013,428,572,699,253,402
060190055292,779,295,484,790,290,500,947,444,487,792,301,461
060190055031,980,355,625,1001,360,641,1359,534,803,1068,403,613
060190055281,754,307,447,766,302,464,962,425,524,848,343,464
060190055161,799,345,454,816,350,466,1135,525,587,899,384,477
060190055163,606,246,360,622,247,375,786,378,396,662,267,367
060190055051,353,162,191,360,160,200,804,356,429,653,279,343
060190055162,660,290,370,677,287,390,956,474,464,718,323,367
060190055054,586,239,347,600,246,354,836,371,444,671,265,372
060190055072,852,397,455,870,398,472,1240,616,603,920,418,463
060190055084,673,283,390,689,282,407,874,399,458,692,280,384
060190055083,568,256,312,577,253,324,772,353,407,733,306,395
060190044052,1114,434,680,1137,431,706,1376,612,732,1140,436,668
060190055074,548,244,304,568,254,314,747,342,393,587,240,322
060190055073,670,289,381,693,294,399,1013,452,546,743,300,410
060190055081,564,232,332,572,233,339,771,351,403,587,239,330
060190055071,346,141,205,356,140,216,450,199,241,373,149,207
060190044051,503,223,280,509,221,288,603,289,301,531,225,278
060190055082,770,344,426,785,344,441,1159,533,602,772,331,405
060190044053,476,222,254,487,220,267,597,293,291,512,227,255
060190055091,836,383,453,849,374,475,1059,521,511,870,358,468
060190055093,438,205,233,445,204,241,664,323,323,444,194,223
060190055273,591,255,336,599,264,335,768,341,414,639,271,335
060190055271,814,323,491,822,316,506,922,439,465,842,303,503
060190044042,200,151,49,206,148,58,378,254,115,247,175,60
060190044063,465,215,250,468,215,253,680,333,330,485,199,254
060190044061,327,138,189,332,137,195,404,200,197,363,137,206
060190044062,617,273,344,628,280,348,817,400,398,709,307,362
060190044064,339,174,165,344,179,165,547,267,265,362,167,169
060190055272,184,84,100,189,90,99,244,109,130,188,87,90
060190055261,387,187,200,410,198,212,565,280,270,454,208,211
060190055092,245,121,124,247,119,128,369,184,176,273,127,131
060190056051,677,302,375,693,297,396,823,407,395,718,302,379
060190054072,775,379,396,795,363,432,983,465,487,887,381,453
060190056062,895,316,579,910,313,597,1189,465,698,961,341,570
060190044102,277,131,146,281,127,154,399,199,190,317,143,152
060190044101,475,237,238,486,230,256,700,350,334,555,260,259
060190044111,574,246,328,581,248,333,783,394,374,799,340,420
060190044041,377,244,133,382,239,143,608,412,178,461,288,148
060190044091,418,211,207,426,208,218,651,293,347,476,232,215
060190044092,526,179,347,540,187,353,669,275,382,578,198,358
060190044093,345,160,185,351,160,191,521,213,297,384,177,187
060190042082,883,412,471,897,410,487,1237,594,623,1042,471,520
060190042083,1211,549,662,1233,544,689,1644,795,820,1518,670,787
060190045041,398,219,179,405,208,197,546,322,212,390,200,155
060190054061,524,288,236,529,274,255,746,393,336,633,286,297
060190054051,570,320,250,576,313,263,824,431,370,656,339,264
060190054052,540,254,286,543,257,286,675,352,304,591,269,292
060190054062,415,194,221,420,198,222,511,269,230,474,215,236
060190054053,622,296,326,636,295,341,745,351,371,644,291,315
060190054063,588,277,311,596,274,322,827,391,410,647,256,344
060190054081,209,135,74,213,130,83,174,105,65,247,148,80
060190054071,504,224,280,512,220,292,628,296,311,536,212,296
060190045053,351,215,136,351,215,136,467,276,176,340,206,113
060190045052,312,192,120,315,193,122,431,258,163,332,199,111
060190054102,717,395,322,734,385,349,910,559,333,811,418,351
060190054031,262,160,102,267,162,105,417,262,142,300,165,111
060190054033,164,101,63,166,102,64,273,172,92,183,99,68
060190054092,497,332,165,510,326,184,869,547,295,628,381,192
060190054091,279,174,105,283,176,107,422,266,143,301,170,107
060190054032,242,142,100,244,145,99,343,218,117,300,168,111
060190054101,250,147,103,254,151,103,361,215,137,301,170,112
060190050001,345,211,134,355,206,149,457,275,174,338,190,125
060190053022,690,431,259,699,414,285,986,614,338,801,466,284
060190053013,483,307,176,485,289,196,730,459,250,575,341,193
060190050002,246,168,78,247,169,78,401,273,118,314,203,91
060190053012,499,280,219,503,271,232,684,411,252,552,297,221
060190053021,501,338,163,506,314,192,828,527,277,611,382,184
060190053011,452,274,178,455,278,177,626,398,209,512,307,170
060190053041,353,220,133,360,222,138,492,310,172,321,196,104
060190053043,449,293,156,459,290,169,759,461,275,596,373,179
060190053051,470,256,214,478,245,233,705,442,241,578,311,240
060190053042,220,147,73,222,143,79,420,262,144,298,198,77
060190053052,439,279,160,440,277,163,729,442,275,558,341,177
060190020001,134,89,45,134,84,50,267,174,82,199,133,55
060190038053,396,263,133,400,257,143,626,399,215,477,323,134
060190038051,214,146,68,218,148,70,392,245,136,315,208,91
060190042051,262,180,82,265,173,92,358,232,121,287,184,85
060190042052,252,173,79,255,166,89,357,227,118,305,196,91
060190042053,533,351,182,536,341,195,910,583,305,702,438,222
060190042162,440,246,194,449,238,211,676,375,285,303,160,128
060190042161,642,367,275,654,362,292,917,512,386,726,388,294
060190042152,966,542,424,981,531,450,1539,856,647,909,497,372
060190042151,561,338,223,569,332,237,844,467,354,626,358,235
060190042123,646,381,265,660,384,276,958,555,381,1010,569,383
060190014121,798,416,382,820,410,410,1485,785,669,935,494,390
060190059161,330,113,217,331,107,224,435,165,267,369,126,235
060190059162,810,229,581,823,230,593,1117,367,727,826,212,579
060190059111,901,353,548,921,344,577,1282,561,694,786,274,471
060190059121,1340,409,931,1360,393,967,2954,1065,1838,1027,261,728
060190056021,545,240,305,554,247,307,732,338,383,575,236,293
060190056024,427,169,258,432,170,262,586,245,323,371,140,206
060190055221,907,268,639,927,275,652,1218,405,787,940,267,626
060190055223,652,204,448,661,204,457,936,335,584,700,208,457
060190055251,663,171,492,674,173,501,838,236,584,712,183,507
060190055131,559,185,374,571,189,382,858,307,533,757,256,472
060190055142,822,299,523,839,297,542,966,370,579,783,264,476
060190055121,1166,392,774,1179,390,789,1518,587,904,1195,383,750
060190055132,577,197,380,587,198,389,798,288,495,639,211,400
060190055122,1038,351,687,1048,349,699,1840,698,1101,1239,400,776
060190055201,614,210,404,623,202,421,1073,395,663,815,271,506
060190059071,1137,419,718,1163,412,751,1737,666,1039,1249,434,757
060190055202,641,221,420,655,216,439,693,254,427,408,135,248
060190055222,430,138,292,437,136,301,658,226,421,410,131,259
060190055181,999,390,609,1028,393,635,1787,747,1003,995,369,567
060190055182,1307,499,808,1330,496,834,1883,786,1050,1333,484,767
060190059142,1660,621,1039,1693,613,1080,2300,921,1341,1536,535,928
060190057022,584,214,370,596,208,388,816,305,493,644,223,385
060190057023,551,202,349,559,196,363,714,266,434,621,208,376
060190057012,323,114,209,326,114,212,418,172,236,302,103,179
060190057013,272,102,170,276,103,173,390,172,212,302,109,178
060190057021,346,124,222,351,124,227,551,228,314,379,133,224
060190057024,659,213,446,663,208,455,883,368,503,782,225,512
060190057011,486,207,279,494,204,290,673,277,382,522,200,283
060190057014,282,120,162,287,119,168,345,158,183,304,117,167
060190057041,300,183,117,306,174,132,570,260,298,364,181,162
060190056071,300,137,163,306,138,168,430,206,214,362,161,182
060190056072,267,138,129,275,139,136,475,227,237,343,161,154
060190056073,240,103,137,245,104,141,349,158,183,286,121,149
060190056022,399,213,186,414,214,200,597,288,299,450,220,207
060190056074,203,108,95,209,109,100,291,139,145,236,113,99
060190057043,679,303,376,693,298,395,1071,432,616,751,279,425
060190057042,572,207,365,577,219,358,750,342,391,684,238,406
060190057031,362,118,244,370,118,252,463,170,282,401,129,255
060190057034,539,182,357,547,179,368,735,282,441,594,190,379
060190057032,732,262,470,747,260,487,974,359,589,840,273,526
060190057033,789,261,528,804,261,543,1043,410,613,912,301,559
060190059141,554,217,337,568,208,360,827,326,486,623,235,365
060190059131,515,211,304,523,212,311,738,299,427,610,228,347
060190059112,1610,659,951,1640,659,981,2402,1002,1349,1075,418,611
060190059132,500,205,295,509,207,302,805,327,463,508,191,290
060190058021,954,336,618,967,338,629,1286,493,770,1059,362,642
060190058012,569,214,355,575,213,362,674,322,340,626,223,372
060190058013,356,165,191,362,160,202,548,271,265,425,201,201
060190058022,1117,403,714,1142,401,741,1493,592,876,1153,408,683
060190058011,756,297,459,774,291,483,1266,592,639,877,335,497
060190056082,437,172,265,447,175,272,685,330,343,555,206,320
060190056081,541,227,314,547,234,313,726,345,362,613,247,335
060190031022,254,127,127,263,126,137,478,226,239,312,159,137
060190031025,376,230,146,379,224,155,605,307,284,441,248,165
060190056023,334,167,167,337,161,176,580,278,294,438,201,206
060190031021,107,71,36,110,70,40,205,106,93,130,77,45
060190031034,298,159,139,305,153,152,401,208,182,363,158,181
060190031035,217,116,101,222,111,111,337,174,153,253,110,125
060190031041,351,133,218,358,138,220,473,194,273,401,140,247
060190055151,568,149,419,577,149,428,745,211,517,879,229,617
060190059152,1040,249,791,1053,245,808,1367,380,967,1151,274,826
060190059122,744,207,537,758,205,553,908,256,638,752,210,507
060190059061,955,250,705,969,247,722,1255,314,923,1007,243,733
060190014152,485,322,163,497,300,197,831,570,253,546,369,154
060190014153,201,160,41,206,153,53,352,268,78,244,194,40
060190014151,204,164,40,209,157,52,363,274,83,250,202,36
060190030041,271,149,122,279,149,130,444,275,159,315,184,116
060190030042,294,155,139,302,145,157,471,275,183,373,197,149
060190030012,279,177,102,282,161,121,450,284,159,345,215,114
060190020004,141,92,49,142,91,51,223,146,74,171,102,59
060190086001,258,144,114,260,142,118,376,218,155,313,166,133
060190049021,301,172,129,305,175,130,439,238,186,332,170,140
060190033022,202,139,63,208,136,72,316,218,91,259,167,76
060190033024,221,151,70,220,142,78,318,224,93,266,171,79
060190046021,386,175,211,397,177,220,455,247,196,415,190,199
060190050003,665,370,295,678,373,305,825,470,339,697,364,297
060390011003,287,91,196,292,89,203,343,132,208,321,104,203
060190031023,426,240,186,434,240,194,667,369,282,517,275,206
060190031024,277,156,121,285,159,126,462,255,195,350,187,139
060190031031,295,167,128,300,165,135,483,266,204,355,183,150
060190031032,297,177,120,301,172,129,497,273,210,367,192,156
060190031033,278,152,126,283,152,131,391,215,166,316,164,134
060190042122,1160,693,467,1177,687,490,1804,1099,660,1061,633,376
060190042121,410,256,154,425,249,176,546,355,177,477,276,172
060190042124,174,117,57,177,119,58,261,168,84,215,136,68
060190042126,432,250,182,436,244,192,723,418,289,482,265,192
060190042113,818,449,369,831,443,388,1136,654,453,902,488,352
060190042111,642,379,263,652,359,293,948,548,373,727,394,286
060190042112,610,364,246,621,355,266,955,551,379,711,384,273
060190014162,677,470,207,691,452,239,1196,819,359,797,565,196
060190014172,683,453,230,701,442,259,1133,745,374,793,522,235
060190014171,499,323,176,502,311,191,820,497,310,549,364,164
060190014173,430,278,152,434,266,168,704,431,265,469,310,136
060190014132,1041,608,433,1053,596,457,1925,1144,748,1219,686,476
060190014131,849,470,379,866,464,402,1147,639,474,747,406,305
060190055242,780,272,508,797,286,511,1235,474,740,837,294,519
060190055241,1053,369,684,1076,365,711,1496,575,902,1296,428,829
060190055141,588,179,409,608,183,425,732,286,432,648,185,430
060190055143,439,176,263,449,181,268,628,246,370,642,245,366
060190056061,752,288,464,772,291,481,1169,475,672,706,263,414
060190014111,313,177,136,313,171,142,506,299,201,375,210,147
060190014112,278,147,131,281,143,138,382,226,151,329,176,136
060190014113,602,347,255,614,346,268,812,478,322,381,225,135
060190014114,164,103,61,165,99,66,289,170,115,380,225,133
060190042171,261,198,63,263,196,67,559,358,189,342,249,80
060190014091,701,402,299,710,395,315,1020,619,377,749,417,289
060190014161,630,469,161,637,447,190,1126,789,317,698,532,144
060190030031,359,225,134,359,223,136,510,344,160,411,272,122
060190030032,290,170,120,297,175,122,493,315,167,365,215,129
060190042182,505,256,249,508,253,255,864,487,371,555,293,241
060190042172,230,145,85,235,146,89,440,276,152,312,195,99
060190042181,1277,725,552,1294,703,591,2032,1144,862,1359,755,549
060190038042,404,265,139,407,254,153,604,401,193,518,344,146
060190038043,623,415,208,632,411,221,876,580,273,729,469,214
060190038082,390,254,136,396,250,146,653,430,202,482,317,136
060190038052,334,230,104,335,217,118,591,396,179,432,290,114
060190038083,248,171,77,257,166,91,438,287,141,377,259,105
060190038071,269,172,97,272,169,103,427,264,155,327,205,102
060190038111,561,365,196,584,370,214,1113,705,381,731,436,248
060190038081,375,225,150,381,218,163,593,359,222,444,277,141
060190038072,333,197,136,337,196,141,534,312,209,422,243,151
060190014182,512,235,277,521,231,290,629,293,327,505,216,266
060190014181,339,155,184,345,154,191,452,209,234,348,149,183
060190059151,1206,411,795,1218,407,811,1472,486,962,1241,391,797
060190064111,123,36,87,123,37,86,193,44,144,133,25,99
060190059041,209,73,136,217,69,148,296,132,163,242,91,140
060190015001,130,66,64,133,66,67,180,87,91,160,79,77
060190084021,98,28,70,101,29,72,155,53,101,110,29,78
060190084022,66,38,28,67,33,34,90,51,38,81,52,29
060190064091,40,8,32,40,9,31,30,8,22,41,9,30
060190064094,33,7,26,33,7,26,30,7,23,35,9,25
060871215011,331,263,68,332,263,69,407,333,68,367,275,63
060871215021,928,770,158,942,771,171,1135,930,173,955,751,147
060871215012,615,509,106,625,509,116,837,682,130,604,473,94
060871215013,407,331,76,411,332,79,523,430,89,453,356,70
060871214031,671,551,120,681,551,130,829,673,135,689,525,117
060871214032,923,760,163,932,758,174,1088,885,173,1032,800,156
060871214021,846,689,157,871,686,185,1073,867,179,951,712,160
060871214011,453,371,82,467,381,86,590,473,103,477,364,75
060871214012,813,667,146,838,685,153,1045,860,158,791,606,124
060871009002,750,643,107,765,653,112,953,814,112,754,621,82
060871214022,878,677,201,896,682,214,1156,949,178,971,730,176
060871217021,725,565,160,734,564,170,912,722,171,760,542,153
060871213002,861,670,191,869,661,208,1062,848,193,920,692,152
060871213001,440,337,103,452,341,111,551,439,102,480,353,92
060871212001,603,456,147,611,450,161,841,649,172,603,439,118
060871213003,782,577,205,794,573,221,906,703,186,861,632,188
060871211001,390,295,95,399,296,103,668,499,149,418,301,84
060871211002,1542,1136,406,1563,1137,426,1570,1218,312,1622,1164,337
060871212003,922,633,289,948,640,308,1111,791,292,987,634,254
060871212002,1886,1312,574,1922,1324,598,2310,1733,510,2060,1398,491
060871208003,904,570,334,918,567,351,1124,820,282,956,594,299
060871208002,1456,952,504,1489,964,525,1741,1234,464,1391,925,357
060871216011,957,770,187,975,772,203,1154,941,189,1064,821,164
060871216012,865,677,188,884,686,198,1080,893,162,991,743,184
060871210001,960,671,289,973,668,305,1150,860,249,1093,739,256
060871216022,759,615,144,782,615,167,1046,833,190,823,629,138
060871217022,779,621,158,792,623,169,1028,812,192,801,595,145
060871205002,836,601,235,860,613,247,1025,772,225,874,610,202
060871216021,500,380,120,511,378,133,608,488,107,515,390,88
060871220052,694,575,119,705,572,133,895,700,174,788,589,141
060871210002,970,685,285,988,685,303,1233,917,280,1044,724,229
060871220011,1210,888,322,1224,890,334,1479,1118,327,1297,932,269
060871220012,1627,1264,363,1650,1268,382,1966,1523,394,1710,1239,321
060871217013,329,250,79,333,252,81,404,317,77,348,250,73
060871224011,1366,860,506,1388,849,539,1728,1136,545,1541,952,470
060871220051,1267,947,320,1296,952,344,1550,1224,288,1374,987,280
060871001001,1345,1030,315,1387,1051,336,1545,1238,272,1406,1059,251
060871217012,764,631,133,779,627,152,1033,836,170,815,619,141
060871217011,815,627,188,827,624,203,1002,787,196,865,640,168
060871209011,944,631,313,959,638,321,1213,865,309,933,608,245
060871209021,1154,729,425,1173,738,435,1512,1088,382,1255,798,354
060871107001,634,489,145,630,471,159,941,737,190,757,582,129
060871224022,1273,876,397,1297,861,436,1644,1141,453,1377,890,391
060871107002,259,199,60,255,190,65,356,281,69,289,220,49
060871231001,476,334,142,478,321,157,666,467,185,542,375,131
060871223001,245,174,71,243,167,76,349,256,87,262,182,64
060871223003,1119,854,265,1127,835,292,1321,1019,279,1244,934,229
060871223002,439,307,132,444,305,139,554,391,149,475,312,129
060871106012,557,454,103,564,439,125,862,717,129,682,539,108
060871231002,402,283,119,403,271,132,575,417,144,446,308,107
060871224021,1006,667,339,1017,669,348,1277,875,364,1071,693,296
060871220021,2196,1613,583,2236,1620,616,2636,1965,612,2192,1574,491
060871222041,549,373,176,554,374,180,758,563,176,586,406,154
060871222042,1049,779,270,1068,771,297,1317,1014,268,1188,854,249
060871221001,886,699,187,899,694,205,1112,867,222,960,730,167
060871220041,1021,748,273,1047,762,285,1242,964,249,1102,787,225
060871220042,555,421,134,558,407,151,753,585,151,625,445,131
060871221002,846,656,190,860,655,205,1107,861,222,882,650,167
060871222053,810,605,205,820,615,205,1004,782,199,887,663,179
060871222051,510,360,150,515,367,148,588,448,126,544,384,126
060871222052,527,390,137,536,399,137,659,511,133,565,418,114
060871222031,1269,897,372,1293,905,388,1539,1164,338,1460,1040,331
060871222021,1257,900,357,1281,914,367,1728,1275,409,1343,956,301
060871222032,885,591,294,897,601,296,928,686,221,761,495,213
060871218022,564,435,129,571,427,144,715,544,154,635,473,125
060871218012,402,297,105,408,297,111,485,375,104,445,328,94
060871218011,672,504,168,684,500,184,903,684,192,678,498,127
060871218021,782,602,180,799,594,205,1055,796,224,814,601,157
060871106011,612,518,94,617,502,115,997,818,162,816,680,94
060871106021,627,521,106,626,500,126,953,794,140,725,601,87
060871104021,216,177,39,218,175,43,304,239,56,260,211,36
060871005002,1377,1200,177,1400,1206,194,1909,1641,209,1568,1305,148
060871012002,290,235,55,295,237,58,249,216,27,348,268,55
060871202003,660,540,120,671,540,131,662,536,109,689,519,108
060871207003,580,425,155,586,428,158,288,218,62,598,428,130
060871202002,681,548,133,684,534,150,853,680,151,739,559,116
060871202001,976,794,182,985,787,198,1083,884,170,1020,768,156
060871203011,916,698,218,923,682,241,1238,920,275,1005,714,191
060871203012,1042,819,223,1049,808,241,1238,969,234,1091,791,206
060871204003,883,696,187,891,687,204,949,726,189,1015,712,197
060871207002,1129,867,262,1137,863,274,1349,1065,249,1201,889,215
060871009001,1227,1063,164,1249,1078,171,1401,1197,162,1247,1027,128
060871012001,1390,1181,209,1419,1195,224,1615,1397,183,1492,1197,192
060871005001,1532,1339,193,1575,1372,203,1643,1431,171,1551,1301,159
060871006001,636,566,70,649,571,78,739,653,72,676,576,62
060871003002,1041,877,164,1065,894,171,848,743,93,1083,884,131
060871006002,1336,1155,181,1365,1172,193,1891,1678,173,1420,1190,149
060871010011,708,644,64,721,645,76,829,747,64,720,612,51
060871011001,1189,1038,151,1216,1051,165,1233,1060,139,1217,1002,117
060871011003,1101,982,119,1118,992,126,1436,1255,144,1189,1002,94
060871011002,931,808,123,947,812,135,1128,990,120,1015,831,114
060871007002,522,485,37,534,491,43,983,875,86,611,519,36
060871010021,578,532,46,591,539,52,360,322,25,649,546,42
060871008011,829,743,86,838,749,89,1005,884,94,866,710,75
060871010012,941,873,68,955,875,80,1077,978,70,1059,905,51
060871008012,610,551,59,621,550,71,824,699,89,696,570,57
060871010022,541,490,51,552,489,63,659,556,81,564,462,45
060871010023,503,443,60,512,444,68,616,529,66,517,438,36
060871003001,1142,992,150,1155,1005,150,1710,1399,260,1153,927,123
060871004002,997,942,55,1029,958,71,175,160,7,1043,895,50
060871008021,881,790,91,893,788,105,1013,882,103,937,793,71
060871008022,847,727,120,861,735,126,917,791,106,845,700,83
060871009003,491,408,83,502,410,92,501,426,61,595,484,66
060871002002,1329,1145,184,1342,1144,198,1565,1351,167,1404,1129,155
060871002003,1312,1116,196,1332,1120,212,1554,1330,184,1363,1101,153
060871004001,1357,1287,70,1381,1284,97,372,345,15,1502,1320,54
060871104012,147,129,18,146,126,20,270,218,49,217,196,13
060871101011,929,695,234,932,677,255,1270,1000,262,1043,786,213
060871102023,465,351,114,474,344,130,677,527,136,570,430,106
060871225002,434,332,102,438,318,120,634,493,126,489,360,97
060871225001,468,334,134,480,329,151,652,486,158,540,359,143
060871233001,490,320,170,494,317,177,699,458,226,553,363,155
060871225003,494,409,85,494,386,108,679,547,121,586,472,78
060871225004,359,298,61,361,284,77,519,424,83,402,323,54
060871103011,240,213,27,239,205,34,362,306,51,306,268,24
060871103022,165,146,19,165,142,23,277,226,44,223,194,22
060871104011,175,155,20,176,150,26,310,257,48,230,210,15
060871103021,193,168,25,197,164,33,309,271,35,242,206,24
060871105052,349,292,57,355,288,67,529,419,102,453,386,49
060871104022,621,495,126,622,488,134,965,729,214,728,574,117
060871104023,310,253,57,310,248,62,419,337,71,342,288,43
060871101021,318,283,35,318,273,45,458,391,56,379,334,33
060871102011,646,546,100,646,536,110,1028,871,140,829,694,86
060871103012,232,207,25,231,200,31,393,336,53,315,278,28
060871105061,394,319,75,393,301,92,562,447,108,476,388,67
060871105062,369,305,64,368,299,69,554,459,83,439,356,55
060871105031,428,347,81,429,327,102,688,570,105,487,395,70
060871105051,400,337,63,403,330,73,632,526,94,481,391,58
060871102021,339,267,72,343,263,80,501,378,115,421,337,63
060871105041,478,399,79,478,391,87,743,615,118,596,498,74
060871105032,312,262,50,316,258,58,511,422,81,410,344,50
060871102022,477,366,111,486,356,130,662,507,142,527,388,110
060871101022,939,715,224,948,697,251,1263,990,255,1064,821,196
060871207001,738,459,279,749,467,282,934,618,293,742,451,225
060871208001,1333,851,482,1358,847,511,1583,1104,448,1447,944,411
060871206002,1184,895,289,1197,886,311,1448,1079,314,1271,866,268
060871206001,1482,1044,438,1501,1040,461,1735,1267,417,1599,1054,398
060871203021,868,644,224,883,649,234,929,708,201,899,620,192
060871203022,837,609,228,847,611,236,1055,793,236,922,636,195
060871203013,744,535,209,753,533,220,796,585,182,754,516,159
060871204004,606,476,130,614,468,146,656,494,142,599,423,111
060871209022,1249,849,400,1271,856,415,1592,1146,402,1338,881,362
060871209012,1016,714,302,1038,725,313,1255,905,318,1140,765,285
060871204001,572,452,120,580,445,135,979,750,189,639,459,112
060871205001,1352,1046,306,1361,1021,340,1121,855,225,1215,877,224
060871204002,524,369,155,530,370,160,627,472,135,534,358,123
060871205003,1086,821,265,1092,806,286,1659,1277,308,1358,929,275
060871007001,308,269,39,313,273,40,461,390,55,384,314,27
060871002001,913,793,120,926,797,129,1076,923,120,995,803,103
060552003011,858,603,255,873,593,280,1284,926,326,876,579,248
060552003012,361,274,87,364,261,103,519,391,117,391,269,97
060552003013,543,399,144,551,385,166,758,564,180,593,404,146
060552003021,687,445,242,702,438,264,898,624,253,713,445,211
060552003022,456,315,141,467,303,164,636,456,168,492,311,139
060552008022,686,450,236,706,448,258,907,644,250,764,492,225
060552008031,353,238,115,356,229,127,465,342,109,373,239,111
060552011021,521,326,195,534,322,212,778,522,239,719,443,225
060552011022,421,226,195,431,230,201,482,279,192,429,225,162
060552008032,745,460,285,772,464,308,883,573,281,809,512,251
060552008044,282,195,87,287,202,85,412,295,109,325,227,76
060552007031,1314,751,563,1348,758,590,1624,1034,554,1411,810,493
060552008021,291,212,79,296,206,90,398,291,90,306,219,65
060552007032,513,302,211,533,307,226,633,405,219,597,345,209
060552004003,433,318,115,437,315,122,507,381,112,456,314,105
060552005031,388,301,87,393,306,87,550,415,123,432,330,65
060552005032,135,106,29,133,105,28,194,148,44,131,109,17
060552004002,662,512,150,680,520,160,870,674,183,747,549,144
060552002021,224,179,45,226,185,41,312,261,43,236,176,43
060552002022,187,147,40,188,148,40,233,187,38,226,174,32
060552002023,492,394,98,499,393,106,598,482,100,528,400,83
060552002031,429,341,88,438,332,106,611,449,146,502,356,113
060552002032,332,264,68,336,263,73,420,336,74,402,301,67
060552002012,516,383,133,523,377,146,630,472,142,549,399,118
060552002013,373,274,99,374,268,106,507,384,112,401,283,90
060552010031,551,339,212,563,336,227,822,552,254,553,343,171
060552008043,262,197,65,262,189,73,351,275,68,272,193,62
060552011011,804,476,328,822,486,336,903,590,292,815,483,286
060552007042,375,249,126,382,249,133,539,386,145,423,275,119
060552007043,246,174,72,252,174,78,347,252,85,256,177,59
060552007051,1138,681,457,1158,697,461,963,609,329,1214,718,414
060552007052,303,205,98,305,197,108,879,585,267,312,187,108
060552007041,810,510,300,831,512,319,1028,690,316,873,543,265
060552011012,482,298,184,495,317,178,563,377,176,506,319,160
060552002011,378,302,76,379,301,78,504,401,90,433,324,85
060552008042,385,315,70,388,309,79,554,450,90,429,310,87
060552008041,396,324,72,399,315,84,560,440,108,442,328,77
060552005012,328,233,95,333,230,103,534,379,140,388,270,91
060552007062,723,436,287,735,430,305,869,569,274,720,435,237
060552007063,496,307,189,501,306,195,591,392,182,522,324,168
060552007072,681,400,281,700,404,296,853,563,274,721,427,247
060552007071,851,562,289,862,557,305,1135,776,337,933,596,278
060552007061,581,352,229,588,346,242,754,493,247,638,396,200
060552012001,449,266,183,456,265,191,517,330,176,466,266,170
060552012002,871,515,356,880,497,383,1167,731,417,934,556,339
060552006011,762,452,310,768,443,325,1008,631,356,827,482,283
060552006021,604,367,237,618,367,251,681,449,217,615,365,203
060552006014,391,253,138,399,244,155,485,314,158,432,271,136
060552006022,457,292,165,465,292,173,582,392,182,489,300,159
060552014011,464,229,235,468,232,236,559,313,230,551,292,219
060552012003,1046,642,404,1059,645,414,1293,827,445,1225,719,425
060552013001,532,381,151,544,384,160,678,494,174,560,393,139
060552013003,413,232,181,425,250,175,414,257,154,498,285,188
060552015002,419,252,167,422,252,170,481,317,159,416,253,130
060552018002,281,123,158,283,119,164,326,139,177,332,129,173
060552016012,395,277,118,405,276,129,512,381,120,447,310,110
060552018001,339,177,162,345,175,170,382,198,171,376,173,185
060552015001,552,361,191,556,357,199,639,438,187,556,363,148
060552016022,255,178,77,259,177,82,299,223,71,268,188,65
060552017004,368,214,154,374,213,161,439,267,156,393,222,130
060552017005,263,178,85,272,170,102,276,188,82,285,187,77
060552017006,237,148,89,245,142,103,289,189,93,283,179,84
060552014031,517,222,295,528,215,313,600,289,295,571,257,282
060552017001,319,183,136,323,181,142,286,175,101,286,166,92
060552019001,355,216,139,362,216,146,400,270,120,383,227,128
060552020001,341,247,94,344,240,104,451,339,103,359,239,97
060552020003,472,360,112,478,355,123,622,484,120,514,386,99
060552020004,616,478,138,629,477,152,743,588,148,651,479,134
060552017002,440,260,180,441,255,186,577,355,194,604,343,182
060552017003,335,198,137,340,196,144,429,263,145,379,215,114
060552016023,344,237,107,348,241,107,426,322,97,370,258,83
060552016024,581,397,184,591,401,190,681,503,164,586,408,143
060552016021,583,408,175,589,411,178,639,479,146,594,414,138
060552016011,531,405,126,540,408,132,630,488,128,574,425,126
060552020002,370,280,90,374,277,97,476,366,93,420,308,83
060552013002,480,319,161,488,321,167,555,395,150,497,340,128
060552004001,786,485,301,802,492,310,890,600,270,805,497,253
060552014012,843,441,402,859,446,413,959,561,382,965,501,418
060552005051,382,276,106,387,276,111,523,387,124,403,280,100
060552005052,418,303,115,418,294,124,593,419,166,456,312,114
060552014013,480,265,215,496,272,224,586,368,211,492,255,200
060552014022,418,237,181,423,230,193,495,298,185,455,262,157
060552014023,826,439,387,850,456,394,975,579,368,880,477,338
060552014021,435,235,200,435,238,197,517,315,194,454,238,187
060552005041,469,345,124,476,345,131,647,471,168,550,383,128
060552005042,435,322,113,441,319,122,577,416,149,489,346,112
060552005013,688,525,163,705,523,182,970,736,209,817,592,179
060552005011,354,252,102,364,247,117,540,391,134,428,300,108
060552005043,382,264,118,393,275,118,543,378,147,450,305,115
060552005044,695,479,216,697,477,220,909,631,254,818,552,212
060552006023,526,353,173,533,353,180,565,383,163,578,378,169
060552006024,673,450,223,685,450,235,928,636,267,715,468,209
060552006013,494,327,167,511,326,185,706,493,194,567,356,172
060552006012,488,293,195,493,287,206,657,411,225,551,331,184
060552009001,67,38,29,67,41,26,86,46,38,107,66,35
060552010051,439,303,136,446,300,146,659,467,180,465,317,118
060552010032,438,320,118,448,331,117,688,505,175,459,360,86
060552010071,734,533,201,741,522,219,764,553,201,803,570,184
060552008023,1287,883,404,1307,885,422,1710,1227,440,1355,862,395
060552010033,680,498,182,695,514,181,1051,776,264,744,579,138
060552010052,468,306,162,477,298,179,705,466,218,543,356,151
060552010061,557,368,189,568,359,209,1092,735,333,630,417,170
060552010062,637,420,217,646,412,234,895,601,281,728,456,221
060552010072,679,473,206,692,478,214,1013,706,280,790,561,180
060552010041,892,665,227,898,671,227,1434,1058,343,1017,760,206
060552010043,554,415,139,562,419,143,828,612,196,611,457,122
060552010042,504,375,129,509,379,130,819,606,195,586,438,117
060610208061,825,417,408,843,410,433,1200,582,576,918,391,444
060610208062,636,291,345,646,283,363,764,370,372,676,295,333
060610209011,353,177,176,362,175,187,539,264,263,378,180,173
060610209012,357,184,173,361,180,181,570,278,279,413,197,181
060610209081,823,330,493,831,324,507,1035,485,528,759,294,420
060610209082,643,312,331,655,296,359,914,443,437,767,331,365
060610210451,779,381,398,789,373,416,1324,685,612,811,350,397
060610210452,354,159,195,361,152,209,565,292,257,424,174,218
060610209083,672,367,305,686,354,332,1016,495,490,744,356,301
060610210036,193,97,96,197,96,101,289,140,139,216,91,107
060610209084,417,177,240,421,168,253,544,266,265,473,199,238
060610210384,1122,501,621,1140,494,646,1620,755,827,1256,531,626
060610210031,474,255,219,478,251,227,703,342,346,534,257,229
060610210032,349,142,207,357,143,214,471,215,240,389,148,217
060610210033,478,186,292,489,187,302,635,287,331,532,199,303
060610210471,832,410,422,847,396,451,1178,549,603,931,404,455
060610210472,917,397,520,927,389,538,1260,591,643,1035,438,520
060610210481,582,275,307,593,272,321,806,376,412,652,294,315
060610210482,698,336,362,711,328,383,974,456,499,760,344,361
060610210381,523,231,292,529,223,306,669,311,340,569,233,290
060610210383,595,262,333,598,251,347,872,405,443,681,278,340
060610210461,328,156,172,337,153,184,543,259,265,357,147,190
060610210462,724,343,381,732,328,404,971,465,476,776,328,402
060610210402,1643,744,899,1660,749,911,1775,850,886,1019,459,525
060610210371,921,413,508,939,404,535,1282,591,667,987,416,509
060610210382,840,368,472,854,351,503,1112,509,571,907,380,458
060610210463,687,324,363,696,303,393,1015,477,506,724,306,358
060610226001,1003,451,552,1022,445,577,1352,642,678,1131,481,566
060610213251,700,340,360,705,332,373,818,424,380,1329,662,621
060610213253,1486,739,747,1511,717,794,2472,1270,1145,2262,1076,1053
060610213261,245,123,122,253,119,134,430,221,203,158,80,74
060610213262,889,449,440,904,432,472,1569,807,731,580,286,267
060610213272,384,183,201,390,178,212,820,422,377,410,187,191
060610213273,162,79,83,165,78,87,300,154,138,123,57,56
060610213274,222,116,106,226,113,113,1023,529,466,0,0,0
060610213271,254,76,178,257,79,178,458,162,285,242,57,171
060610210392,591,256,335,599,252,347,603,286,305,589,245,329
060610210401,730,310,420,736,312,424,748,366,369,711,297,395
060610210403,784,341,443,789,328,461,805,370,421,799,337,444
060610210442,1262,519,743,1289,504,785,1659,760,864,1382,535,753
060610210443,776,340,436,790,324,466,1037,504,513,765,323,398
060610210431,731,263,468,743,261,482,1028,472,537,754,282,424
060610210432,902,343,559,918,327,591,1170,544,604,954,360,533
060610210441,578,256,322,586,254,332,999,482,490,607,251,319
060610210391,809,375,434,821,380,441,857,417,422,856,408,431
060610213252,849,413,436,869,403,466,1139,585,527,898,443,397
060610231001,906,433,473,932,441,491,1919,937,946,1435,628,722
060610231002,2669,1269,1400,2722,1247,1475,4910,2453,2350,864,375,437
060610213283,805,368,437,819,370,449,1149,560,566,1130,489,564
060610230002,1106,490,616,1126,478,648,1097,536,530,861,366,429
060610231003,1003,416,587,1024,410,614,1475,665,788,1257,530,639
060610225001,893,420,473,902,412,490,1306,596,686,859,418,401
060610225002,918,345,573,932,345,587,1334,605,706,971,349,571
060610232001,1314,552,762,1328,542,786,1624,701,877,1487,587,796
060610232002,1400,574,826,1424,564,860,1346,579,733,1342,512,716
060610235012,522,163,359,531,165,366,778,322,442,439,154,261
060610235021,661,216,445,670,212,458,1070,444,609,564,179,349
060610235022,693,223,470,707,222,485,1063,441,604,577,171,372
060610235024,676,223,453,687,216,471,1089,452,618,762,239,472
060610211234,963,381,582,978,370,608,1085,481,575,1220,476,679
060610235011,192,58,134,197,59,138,261,107,148,217,86,121
060610238002,1587,712,875,1600,699,901,1628,788,829,1331,604,693
060610235023,34,14,20,34,14,20,230,95,131,0,0,0
060610236002,1186,540,646,1187,529,658,1220,574,636,1159,496,627
060610236003,858,357,501,865,358,507,901,375,514,872,375,476
060610237002,1323,553,770,1337,537,800,1372,572,781,1399,583,772
060610236001,1681,679,1002,1694,666,1028,1734,863,857,1690,698,933
060610238001,1273,572,701,1286,555,731,1336,664,661,1124,511,580
060610233002,705,276,429,712,265,447,1834,784,990,607,218,336
060610233001,711,313,398,723,301,422,1308,587,694,846,336,439
060610237001,1275,585,690,1288,567,721,1373,683,680,1469,676,753
060610214031,248,115,133,252,113,139,651,274,354,480,190,251
060610239001,483,177,306,492,173,319,723,299,399,610,202,369
060610239002,775,281,494,781,261,520,1397,578,775,787,257,478
060610214034,349,165,184,355,163,192,740,305,410,428,180,217
060610214012,443,181,262,449,173,276,637,260,364,518,180,295
060610214032,312,145,167,315,142,173,457,186,262,338,143,173
060610214033,336,158,178,337,152,185,480,203,267,376,171,171
060610213044,910,286,624,917,273,644,1231,397,797,1035,315,646
060610214011,395,145,250,402,142,260,597,238,345,480,172,273
060610214035,433,204,229,442,200,242,631,251,360,492,198,256
060610234003,859,307,552,873,293,580,934,367,541,734,227,455
060610234002,833,311,522,841,301,540,1207,480,688,1047,361,619
060610234001,335,126,209,342,123,219,371,148,212,365,127,216
060610211301,203,97,106,208,96,112,431,214,205,225,93,109
060610211302,470,218,252,478,217,261,643,323,306,516,217,255
060610213242,737,340,397,756,341,415,2365,1180,1123,802,338,402
060610213232,728,327,401,743,323,420,250,116,127,527,219,269
060610213233,578,250,328,590,245,345,798,399,380,633,257,329
060610213234,729,327,402,751,328,423,1047,522,501,778,339,380
060610213231,1216,580,636,1241,573,668,2469,1209,1202,977,426,483
060610213241,821,318,503,836,316,520,1194,564,594,797,292,453
060610213243,809,321,488,822,312,510,1030,504,500,854,332,455
060610211232,752,346,406,762,344,418,1162,541,588,876,394,415
060610211231,1384,543,841,1406,541,865,1597,730,830,1445,582,779
060610211221,1300,547,753,1322,540,782,1522,703,773,1358,563,718
060610211222,651,304,347,664,296,368,797,369,403,671,285,329
060610211233,970,373,597,990,372,618,1075,478,568,1005,399,557
060610213281,249,48,201,253,47,206,313,78,227,265,50,201
060610213285,191,39,152,195,39,156,249,63,178,211,45,156
060610213041,978,252,726,991,239,752,1306,335,937,1042,256,728
060610213042,290,80,210,295,77,218,399,104,288,324,89,224
060610213043,714,199,515,726,190,536,916,249,639,821,220,555
060610216041,793,256,537,803,250,553,988,343,620,846,262,535
060610215014,881,338,543,889,329,560,1083,467,588,896,320,510
060610216031,880,369,511,885,360,525,1229,525,670,933,360,522
060610216032,295,135,160,297,132,165,420,181,228,308,130,161
060610205012,490,181,309,500,177,323,638,242,377,538,194,293
060610205013,647,239,408,656,232,424,863,321,512,678,237,390
060610205023,778,279,499,784,266,518,981,427,531,827,311,454
060610212041,926,308,618,947,304,643,1220,420,764,972,319,588
060610205022,405,151,254,410,144,266,505,189,298,371,136,203
060610204021,902,459,443,923,449,474,1072,554,486,1035,521,446
060610205021,1453,569,884,1467,553,914,1774,797,931,1288,506,682
060610205011,492,153,339,499,150,349,584,186,383,510,159,324
060610215011,475,170,305,476,163,313,622,234,374,536,195,305
060610215012,712,248,464,724,236,488,861,320,514,671,223,400
060610206072,1119,383,736,1138,372,766,1589,591,952,950,304,581
060610212031,1022,356,666,1042,336,706,1519,534,942,1292,419,764
060610212032,1136,375,761,1146,362,784,1540,571,927,1188,355,736
060610212033,877,293,584,893,276,617,1126,394,700,960,298,583
060610206081,1021,322,699,1026,308,718,1338,483,819,980,308,596
060610211081,240,104,136,241,100,141,359,159,192,255,103,131
060610211082,1368,588,780,1389,569,820,2166,962,1146,1040,420,534
060610211093,408,152,256,415,151,264,525,238,277,404,152,228
060610211091,1174,446,728,1189,444,745,1486,663,785,1277,513,684
060610211092,841,339,502,856,337,519,1108,494,584,924,361,505
060610206071,1200,401,799,1225,412,813,1630,646,950,1234,418,727
060610211291,646,294,352,664,292,372,919,409,487,805,315,422
060610211292,565,277,288,574,273,301,912,417,467,484,192,244
060610211282,885,416,469,901,404,497,1241,551,659,949,387,481
060610211062,767,311,456,782,314,468,988,440,522,740,290,398
060610211281,351,171,180,355,166,189,643,288,338,472,204,233
060610211033,667,266,401,679,259,420,1014,453,532,570,217,313
060610211034,367,151,216,372,144,228,512,228,273,379,146,209
060610211061,269,107,162,274,109,165,460,204,243,498,196,269
060610211031,429,173,256,440,168,272,600,269,318,480,149,290
060610211032,256,102,154,262,101,161,351,159,188,260,80,157
060610211311,764,305,459,775,290,485,978,444,510,810,308,428
060610228002,801,346,455,825,361,464,1196,596,567,945,404,476
060610229001,617,269,348,631,269,362,855,395,439,665,278,335
060610230001,590,278,312,602,267,335,825,365,437,750,355,338
060610229003,490,228,262,503,231,272,1251,564,655,577,266,268
060610228001,905,460,445,911,455,456,1275,635,606,993,452,489
060610229002,494,260,234,506,251,255,457,211,236,406,204,169
060610211313,838,381,457,846,391,455,1103,508,566,905,403,444
060610211312,589,295,294,603,288,315,935,432,482,676,314,326
060610206082,525,158,367,532,152,380,716,219,471,510,159,324
060610206083,475,136,339,485,135,350,594,181,392,504,155,323
060610206013,1146,411,735,1160,406,754,1397,555,805,1183,447,665
060610206014,887,353,534,897,337,560,1132,465,641,893,359,482
060610212042,563,191,372,572,189,383,598,211,376,509,168,305
060610208051,852,385,467,867,366,501,1103,532,543,898,352,470
060610208052,436,205,231,443,199,244,543,261,268,451,198,216
060610208053,324,176,148,327,171,156,507,245,248,352,168,145
060610207121,461,225,236,468,211,257,680,327,335,800,350,397
060610207131,628,301,327,634,290,344,849,412,416,677,280,350
060610207141,941,404,537,952,384,568,1230,498,713,1019,376,574
060610207142,983,417,566,1000,398,602,1228,525,665,1001,391,538
060610207151,650,266,384,657,255,402,869,369,478,704,265,387
060610207103,845,328,517,866,318,548,1095,468,607,877,332,483
060610207152,728,265,463,739,259,480,939,400,521,807,278,478
060610207101,695,241,454,704,225,479,880,355,505,698,244,401
060610207122,303,144,159,306,139,167,396,191,194,323,136,163
060610207123,581,280,301,594,268,326,771,374,379,646,286,315
060610207132,652,317,335,661,306,355,833,401,408,698,310,341
060610207102,703,309,394,712,299,413,844,379,443,725,323,351
060610207111,709,326,383,709,309,400,834,408,400,725,336,346
060610207112,654,302,352,667,294,373,1001,492,482,754,346,355
060610206062,554,230,324,570,224,346,726,365,348,559,223,291
060610206063,817,343,474,834,343,491,1018,484,512,887,370,471
060610206053,845,355,490,859,350,509,1114,543,552,845,357,439
060610207113,329,167,162,335,165,170,504,247,243,409,205,173
060610207171,231,112,119,231,112,119,364,180,175,278,130,130
060610207172,1000,467,533,1009,466,543,1359,673,657,1602,713,808
060610224001,1697,742,955,1729,739,990,2471,1174,1234,963,440,475
060610224002,918,393,525,939,397,542,1179,561,590,1014,450,522
060610210034,108,59,49,109,59,50,196,97,92,290,140,125
060610226003,733,392,341,746,387,359,1317,624,656,718,347,312
060610210035,794,337,457,811,334,477,1090,518,546,868,359,457
060610210341,778,360,418,785,346,439,1090,537,519,855,364,437
060610210343,292,134,158,297,133,164,414,197,206,348,148,177
060610210342,447,202,245,453,194,259,687,326,344,662,300,322
060610226002,14,5,9,15,6,9,19,9,10,16,7,8
060610206061,1015,378,637,1039,366,673,1238,551,656,1090,431,592
060610206051,1055,388,667,1066,378,688,1361,606,722,1104,427,613
060610206052,1190,423,767,1212,407,805,1554,691,827,1277,437,747
060610206042,1403,530,873,1415,524,891,1912,851,1013,1464,559,820
060610206044,747,297,450,762,297,465,953,404,528,788,305,441
060610206011,769,310,459,787,312,475,976,434,517,843,322,468
060610206012,1299,512,787,1319,497,822,1555,666,853,1346,537,730
060610206043,459,174,285,465,169,296,545,219,313,485,173,287
060610206041,500,162,338,514,167,347,605,257,336,528,180,313
060610220021,420,166,254,430,158,272,540,212,311,546,191,314
060610220023,687,286,401,700,267,433,938,392,517,527,191,290
060610220024,932,366,566,933,347,586,1171,434,711,952,323,545
060610220022,1060,376,684,1074,359,715,1380,524,824,1127,359,697
060610203001,923,514,409,948,508,440,1282,650,598,1015,527,407
060610215022,569,282,287,577,276,301,709,309,383,571,245,278
060610215013,633,257,376,634,242,392,853,383,451,671,242,379
060610215021,1348,615,733,1370,606,764,1626,778,797,1418,613,703
060610218024,493,206,287,499,201,298,626,273,339,443,169,240
060610218025,816,366,450,831,354,477,995,441,536,846,370,428
060610218022,427,172,255,431,163,268,542,243,285,463,179,244
060610218021,526,202,324,534,192,342,670,255,393,648,230,382
060610218023,501,199,302,507,190,317,618,262,341,519,186,298
060610218012,1013,353,660,1025,338,687,1213,486,698,1066,367,632
060610218013,350,135,215,355,131,224,467,175,277,370,142,209
060610218014,400,135,265,408,127,281,477,183,276,407,126,258
060610216033,417,157,260,420,147,273,513,224,277,469,165,281
060610218011,1062,378,684,1067,362,705,1261,512,717,1060,374,625
060610202001,1383,439,944,1414,429,985,1775,546,1193,1489,413,955
060610202002,1266,406,860,1287,386,901,1563,482,1052,1357,375,866
060610202003,218,77,141,222,78,144,404,144,250,404,138,235
060610202004,220,68,152,227,68,159,318,99,215,242,66,154
060610219012,971,352,619,984,342,642,1231,455,748,1058,343,638
060610219022,1131,465,666,1141,452,689,1385,600,752,1160,474,617
060610219023,325,128,197,328,122,206,384,147,231,359,123,207
060610219021,1094,437,657,1103,422,681,1323,549,741,1128,432,618
060610219011,660,271,389,667,263,404,843,355,474,748,289,401
060610220132,462,176,286,472,170,302,630,237,380,480,166,288
060610220133,378,141,237,384,139,245,497,183,304,401,147,228
060610220131,504,194,310,506,188,318,547,203,331,457,134,298
060610220112,595,420,175,604,428,176,826,614,193,534,364,129
060610220142,366,265,101,376,272,104,502,373,116,392,273,91
060610220141,275,209,66,285,218,67,362,269,85,252,174,58
060610221001,321,224,97,328,224,104,461,350,105,422,269,110
060610221002,100,70,30,102,70,32,151,113,34,107,67,30
060610222002,425,311,114,433,312,121,555,409,129,402,266,108
060610222001,112,81,31,113,82,31,148,114,34,116,78,31
060610223001,110,78,32,113,78,35,122,94,26,103,70,28
060610223002,192,133,59,191,132,59,266,204,60,204,131,55
060610201042,221,164,57,229,166,63,299,221,70,213,140,56
060610201043,369,253,116,379,259,120,453,331,101,373,228,113
060610201041,208,153,55,211,155,56,271,204,63,224,146,61
060610201052,408,291,117,419,297,122,473,361,104,407,285,95
060610201051,249,176,73,250,176,74,321,247,71,247,159,73
060610201061,298,215,83,303,215,88,459,348,97,334,213,98
060610201062,420,301,119,429,302,127,514,392,108,449,283,132
060610201071,362,281,81,370,280,90,489,369,105,405,299,73
060610201072,328,255,73,333,253,80,448,347,97,369,268,67
060610201073,116,89,27,118,89,29,176,135,38,123,94,22
060610204022,991,478,513,1003,463,540,1189,612,542,1062,485,483
060610204011,843,456,387,856,441,415,1121,584,511,759,388,304
060610204012,243,138,105,250,135,115,281,146,130,215,113,86
060610203002,561,286,275,568,279,289,759,382,356,705,322,325
060610203003,432,192,240,443,183,260,639,323,295,426,183,204
060610216042,1122,382,740,1139,379,760,1379,486,868,1150,406,687
060610220111,194,130,64,196,131,65,317,233,76,264,155,80
060610220143,175,138,37,174,134,40,234,195,36,166,122,35
060014211001,564,521,43,569,523,46,644,598,29,592,535,29
060014211002,837,787,50,845,784,61,984,924,46,892,823,42
060014215001,878,816,62,889,823,66,1002,942,47,926,851,37
060014215002,845,799,46,856,806,50,936,885,41,886,819,32
060014216001,607,574,33,615,576,39,691,641,30,649,583,34
060133540011,1119,867,252,1138,879,259,1309,1057,225,1216,929,212
060014001001,1054,935,119,1066,944,122,1314,1167,123,1130,989,82
060014216002,729,688,41,735,692,43,858,806,32,777,696,30
060014215003,795,756,39,799,763,36,894,853,29,857,799,23
060133560021,1311,849,462,1357,867,490,1780,1193,560,1462,948,450
060014216003,543,521,22,551,522,29,589,566,17,558,513,14
060014216004,433,408,25,437,413,24,522,492,16,495,458,17
060014225001,604,571,33,601,561,40,590,531,32,672,590,27
060014225002,261,247,14,271,253,18,266,240,13,398,354,16
060019821001,133,126,7,135,128,7,30,28,2,310,274,11
060014225003,609,565,44,624,572,52,711,651,35,803,716,33
060014224004,465,438,27,473,443,30,541,499,23,521,466,21
060014224001,290,267,23,293,266,27,256,238,11,363,322,18
060014217003,647,619,28,658,627,31,725,682,25,728,656,19
060014224003,557,525,32,567,534,33,608,557,27,634,570,19
060014227001,306,291,15,311,301,10,440,401,23,361,321,13
060014227002,279,256,23,287,262,25,315,279,21,395,346,15
060014227004,260,241,19,267,242,25,221,193,16,365,327,16
060014227003,297,270,27,305,276,29,264,232,20,443,384,21
060014228001,572,532,40,583,532,51,467,430,23,1239,1112,57
060014228002,236,224,12,243,229,14,212,193,13,498,444,19
060014228003,183,174,9,189,178,11,200,185,10,256,231,10
060014237001,571,517,54,581,520,61,535,493,28,788,700,42
060014237003,417,396,21,426,399,27,448,414,26,491,441,20
060014237002,704,667,37,719,679,40,847,794,40,763,686,30
060014238001,496,457,39,499,463,36,492,464,22,507,463,22
060014238002,769,712,57,778,723,55,873,826,34,814,747,35
060014002001,723,667,56,726,672,54,1078,1016,43,735,672,35
060014043001,779,701,78,789,707,82,909,848,51,823,726,64
060014238003,907,855,52,911,857,54,1299,1229,46,972,889,31
060014004001,994,957,37,1000,960,40,481,449,21,1087,993,23
060014239021,388,373,15,386,368,18,415,394,10,424,388,8
060014239022,480,467,13,481,467,14,486,469,10,548,510,8
060014004003,793,753,40,797,756,41,899,864,18,822,751,23
060014236011,891,854,37,900,859,41,1014,950,37,988,898,30
060014223001,464,449,15,469,450,19,666,621,26,613,558,15
060014223002,782,753,29,794,760,34,898,834,37,851,770,24
060014236022,591,557,34,605,570,35,622,574,36,739,669,21
060014236023,852,804,48,866,817,49,911,843,43,1031,919,44
060014236012,678,654,24,683,656,27,744,704,22,756,691,14
060014235003,639,618,21,644,617,27,677,629,28,665,597,15
060014235001,601,576,25,604,576,28,684,640,25,640,570,17
060014236021,623,580,43,633,582,51,732,680,26,796,683,31
060014228004,392,370,22,401,377,24,434,395,25,507,443,24
060014212001,464,438,26,473,450,23,546,517,22,500,462,21
060014212004,537,505,32,545,515,30,641,600,23,579,530,20
060133910002,1176,1076,100,1196,1102,94,1395,1296,82,1268,1124,73
060014212002,995,940,55,1007,948,59,1074,1015,41,1054,966,37
060014212003,572,544,28,583,555,28,689,654,27,589,539,16
060014213001,826,780,46,834,792,42,908,866,37,869,801,29
060014213002,683,648,35,691,657,34,763,731,29,722,661,26
060014201002,532,492,40,540,500,40,602,546,49,575,522,31
060014201003,387,359,28,390,360,30,442,402,36,424,383,26
060014214001,656,618,38,656,617,39,772,723,29,689,634,20
060014213003,637,608,29,645,614,31,638,605,22,727,667,25
060014213004,519,492,27,525,499,26,580,548,23,545,504,19
060014206001,771,724,47,785,736,49,863,803,52,796,734,34
060014219001,542,514,28,551,525,26,671,632,21,542,487,18
060014214002,445,414,31,450,419,31,517,487,18,491,448,14
060014217001,918,882,36,933,890,43,1059,1002,36,1010,924,29
060014217002,379,366,13,390,373,17,447,422,16,433,396,11
060014224002,351,321,30,359,329,30,393,369,17,455,405,16
060014218001,754,732,22,766,736,30,806,763,22,737,666,18
060014218002,735,708,27,745,719,26,770,739,20,720,672,17
060014223003,599,565,34,614,575,39,856,789,41,711,622,33
060014229011,289,271,18,295,271,24,272,251,13,360,312,14
060014229012,332,312,20,337,311,26,365,337,19,444,386,15
060014229022,242,225,17,248,226,22,310,286,18,283,242,15
060014229021,301,282,19,307,281,26,321,294,17,463,404,17
060014229023,137,128,9,139,128,11,226,208,11,148,128,8
060014230001,829,783,46,836,785,51,716,661,35,850,752,30
060014230002,1058,1012,46,1061,1012,49,1129,1047,54,1152,1030,36
060014230003,612,587,25,621,588,33,735,684,32,676,609,18
060014231001,774,739,35,785,743,42,935,871,40,906,808,23
060014234001,531,516,15,530,509,21,518,491,18,592,545,8
060014234002,471,459,12,472,452,20,629,595,22,497,457,6
060014234003,743,719,24,752,720,32,864,818,29,812,742,16
060014234004,676,646,30,686,655,31,855,804,28,786,713,18
060014235002,471,453,18,471,452,19,503,472,19,540,485,13
060014239011,591,573,18,604,577,27,816,768,32,699,611,19
060014239012,527,517,10,535,525,10,611,588,9,641,572,9
060014005001,1212,1180,32,1223,1191,32,1346,1263,40,1334,1206,18
060014005003,449,438,11,451,441,10,435,413,11,414,371,7
060014240011,435,421,14,434,421,13,529,492,19,508,455,11
060014240012,380,367,13,381,368,13,459,431,17,414,372,8
060014240013,461,449,12,466,450,16,549,513,21,513,462,9
060014240014,480,468,12,482,465,17,614,579,23,563,503,11
060014007001,629,613,16,640,620,20,729,697,19,695,631,13
060014240021,497,477,20,503,475,28,657,622,22,547,498,16
060014008001,920,885,35,940,886,54,794,744,33,897,806,21
060014240022,475,462,13,481,470,11,581,557,18,580,527,11
060014233002,750,720,30,751,725,26,877,830,30,877,790,21
060014233003,576,557,19,581,556,25,767,724,25,668,614,13
060014233001,647,625,22,654,626,28,709,667,28,712,643,18
060014231003,483,466,17,486,471,15,552,521,22,537,493,15
060014231004,459,443,16,463,450,13,514,488,20,495,459,11
060014231002,405,391,14,410,392,18,465,437,18,443,399,11
060014222001,722,694,28,728,697,31,905,859,33,772,701,20
060014222002,564,540,24,571,545,26,634,590,26,610,543,17
060014222003,586,561,25,593,565,28,650,604,27,655,580,18
060014219002,690,664,26,703,674,29,782,743,25,729,656,23
060014219003,637,604,33,642,611,31,696,660,23,679,619,21
060014206002,755,712,43,766,722,44,922,848,57,805,746,28
060014205002,728,663,65,738,673,65,834,770,51,786,705,40
060014206003,602,550,52,609,552,57,743,683,46,650,585,35
060014219004,527,503,24,530,500,30,618,580,22,573,524,20
060014221001,483,466,17,489,470,19,546,513,25,532,487,14
060014221002,912,868,44,927,881,46,1101,1020,49,1003,906,36
060014220001,782,742,40,787,752,35,987,934,38,817,746,22
060014204012,307,293,14,314,296,18,237,211,19,117,96,4
060014220002,344,330,14,346,332,14,658,606,36,356,322,13
060014204021,126,119,7,129,121,8,183,162,15,269,219,11
060014232001,589,557,32,595,559,36,773,727,33,635,573,15
060014232002,609,583,26,620,596,24,797,748,32,698,638,19
060014001002,728,606,122,742,621,121,897,800,87,812,677,96
060014044001,977,855,122,1014,880,134,1206,1070,117,1086,951,96
060014044004,342,284,58,349,291,58,438,388,42,376,312,47
060014044003,1092,974,118,1104,974,130,1359,1236,102,1160,1016,81
060133530013,396,299,97,404,304,100,416,346,61,388,297,67
060014044002,797,721,76,805,718,87,913,833,68,813,711,59
060014042001,638,568,70,645,576,69,756,691,53,719,634,56
060014042002,826,730,96,834,740,94,955,874,65,819,724,66
060014042003,669,601,68,685,615,70,804,740,51,729,636,49
060014261001,716,596,120,732,617,115,807,704,89,733,616,72
060014043002,596,533,63,608,541,67,685,636,38,650,586,41
060014043003,758,649,109,771,666,105,876,819,49,845,736,67
060014002002,621,574,47,620,576,44,806,753,38,653,587,33
060014003003,594,569,25,607,580,27,792,752,26,602,549,20
060014003001,726,683,43,734,690,44,806,744,45,757,683,25
060014003002,903,858,45,914,866,48,1005,955,39,883,803,32
060014004002,777,756,21,781,757,24,774,746,16,808,753,9
060014003004,955,907,48,965,915,50,1064,1010,36,1026,945,32
060014011001,448,430,18,452,432,20,507,477,20,457,417,13
060014011004,612,588,24,620,593,27,785,738,29,630,573,19
060014011002,884,854,30,890,857,33,970,904,37,936,842,22
060014011003,511,485,26,511,485,26,638,590,26,558,483,18
060014013001,602,582,20,608,584,24,659,607,38,547,475,17
060014012001,749,720,29,748,718,30,826,786,30,754,702,14
060014041011,784,743,41,791,740,51,894,843,33,791,723,31
060014041013,565,542,23,565,538,27,621,584,22,553,502,21
060014040002,791,747,44,810,759,51,894,850,33,874,803,27
060014041012,598,571,27,603,575,28,669,633,22,669,603,27
060014041022,510,487,23,516,490,26,609,574,22,589,536,20
060014041021,903,858,45,919,868,51,1018,961,38,976,899,27
060014050002,709,654,55,720,663,57,823,768,48,775,702,43
060014261003,728,549,179,748,574,174,895,759,120,813,636,138
060014050003,810,738,72,820,743,77,960,883,61,882,789,47
060014051001,605,546,59,617,560,57,712,663,40,678,612,36
060014049001,578,547,31,587,547,40,621,575,39,586,540,18
060014050001,433,403,30,443,408,35,515,476,34,520,464,31
060014049003,632,584,48,632,576,56,718,669,45,637,565,40
060014049004,745,697,48,751,692,59,871,802,53,784,707,40
060014049002,647,603,44,658,610,48,742,680,50,683,610,37
060014048001,722,673,49,734,670,64,859,800,45,778,691,51
060014048002,710,670,40,719,665,54,852,799,44,795,710,41
060014012002,546,531,15,541,528,13,664,624,23,564,520,8
060014012003,387,373,14,384,369,15,413,387,16,393,361,8
060014040003,455,434,21,465,437,28,510,479,20,473,431,15
060014040001,580,553,27,596,560,36,684,644,26,671,608,23
060014262003,672,603,69,692,613,79,821,743,66,721,643,47
060014039002,479,457,22,486,463,23,535,499,22,500,453,17
060014039003,948,904,44,953,909,44,1094,1020,45,1031,930,37
060014039001,845,786,59,851,796,55,950,891,38,914,803,43
060014036003,1383,1326,57,1396,1336,60,1651,1543,66,1457,1322,47
060014038002,564,535,29,570,539,31,635,596,27,600,548,18
060014038003,450,430,20,461,441,20,526,494,22,531,484,15
060014038004,871,827,44,881,832,49,988,927,44,937,854,28
060014038001,425,389,36,431,395,36,305,288,15,443,397,23
060014261004,705,559,146,729,586,143,810,703,91,724,587,98
060014262002,1215,1034,181,1246,1060,186,1447,1318,114,1316,1144,115
060014051002,476,420,56,481,425,56,518,483,29,498,447,33
060014051005,646,592,54,656,600,56,940,876,51,657,595,32
060014261002,496,391,105,507,406,101,585,499,75,523,420,73
060014051003,581,523,58,585,525,60,655,606,37,586,528,35
060014051004,445,419,26,453,423,30,449,418,25,455,419,18
060014052001,767,715,52,773,715,58,735,675,49,822,718,48
060014045021,635,568,67,641,568,73,704,642,49,684,588,53
060014045022,876,781,95,891,792,99,1147,1051,80,951,830,73
060014045023,1080,968,112,1092,976,116,1224,1121,85,1130,996,80
060014045024,1181,1062,119,1203,1084,119,1362,1248,97,1263,1116,88
060014046001,737,661,76,749,669,80,842,771,59,779,685,52
060014046002,493,441,52,500,448,52,563,514,39,522,460,35
060014045011,1152,981,171,1168,990,178,1231,1101,114,1190,1014,116
060014046003,768,679,89,775,683,92,887,812,63,804,701,60
060014046004,930,820,110,949,837,112,1120,1023,81,981,877,66
060014301021,1317,867,450,1348,862,486,1622,1115,466,1438,934,414
060133522021,1408,981,427,1448,1005,443,1664,1262,369,1445,998,332
060014080001,474,417,57,487,425,62,537,487,43,505,446,34
060014047001,590,547,43,599,556,43,685,634,38,622,571,29
060014047002,723,655,68,741,676,65,818,766,44,768,695,40
060014261006,443,333,110,454,345,109,620,524,82,482,382,78
060014204022,156,149,7,160,151,9,195,172,16,185,150,7
060014204011,91,86,5,92,87,5,108,96,9,86,70,4
060014203021,639,570,69,652,576,76,806,713,68,704,598,57
060014203011,887,778,109,900,788,112,1206,1074,100,979,827,87
060133830003,963,871,92,974,884,90,1215,1095,98,1055,916,80
060133892002,326,283,43,336,298,38,429,366,49,351,307,23
060014203022,385,339,46,396,345,51,482,435,38,452,389,45
060014202001,490,441,49,499,440,59,640,577,54,501,440,41
060014202002,417,379,38,424,383,41,513,465,44,432,378,31
060014202003,449,411,38,459,417,42,552,495,47,486,423,35
060014201001,529,489,40,526,487,39,644,584,53,577,520,37
060133891002,522,480,42,536,486,50,634,575,52,574,505,40
060014205001,432,397,35,441,407,34,556,510,35,477,412,32
060014262001,1002,878,124,1032,895,137,1205,1091,94,1097,959,86
060014261005,775,607,168,794,630,164,920,782,120,803,651,105
060014283011,1138,874,264,1200,901,299,1431,1118,291,1332,1014,244
060014283014,891,683,208,935,707,228,1527,1203,284,1023,791,184
060014090002,77,60,17,79,62,17,159,126,30,86,68,14
060014283022,1634,1220,414,1689,1263,426,2094,1700,354,1699,1326,300
060014283023,1061,816,245,1100,852,248,1275,1036,214,1188,934,200
060014283012,416,325,91,435,335,100,550,430,112,493,379,88
060014283013,416,337,79,433,349,84,410,329,74,487,403,62
060014283021,1071,808,263,1125,851,274,1475,1187,255,1317,1015,226
060014282001,623,505,118,642,510,132,764,645,109,669,538,108
060014282002,924,757,167,953,773,180,1095,911,158,1008,806,158
060014282005,575,480,95,590,488,102,707,593,103,619,509,84
060014271002,780,633,147,796,643,153,880,736,128,824,669,113
060014271003,901,724,177,921,735,186,1077,896,154,957,774,133
060014281001,651,537,114,668,542,126,804,667,116,755,622,93
060014281002,675,572,103,687,577,110,786,663,115,722,594,81
060014281003,583,487,96,590,493,97,743,620,107,635,512,75
060014282003,602,516,86,616,520,96,757,636,108,663,537,83
060014284001,868,735,133,900,753,147,1208,1012,173,985,802,120
060014285001,535,449,86,555,463,92,707,588,103,612,493,84
060014285003,353,303,50,369,314,55,500,419,71,420,347,48
060014282004,580,503,77,599,510,89,733,614,104,633,511,79
060014281004,456,379,77,473,393,80,603,500,86,524,420,67
060014271001,462,396,66,475,400,75,668,555,97,509,421,62
060014272001,450,386,64,460,389,71,480,399,69,488,395,64
060014272004,262,228,34,266,230,36,320,273,43,290,245,26
060014272002,602,523,79,607,523,84,774,650,105,643,534,76
060014272003,443,386,57,450,389,61,497,424,68,479,412,46
060014280001,294,254,40,301,257,44,277,231,38,308,257,36
060014280003,401,342,59,409,348,61,647,535,92,467,389,56
060014280002,469,405,64,475,406,69,641,536,88,556,465,64
060014279002,625,504,121,640,516,124,728,604,106,682,540,96
060014284002,477,409,68,488,417,71,618,514,90,539,438,57
060014284003,615,516,99,631,530,101,813,671,119,681,541,89
060014278002,566,468,98,575,474,101,757,641,98,596,483,69
060014285002,408,321,87,424,333,91,495,414,74,486,371,85
060014286001,550,445,105,573,462,111,825,682,124,622,481,111
060014279001,436,372,64,441,377,64,550,459,77,499,421,51
060014279003,366,307,59,372,310,62,419,349,62,403,331,52
060014279005,452,384,68,460,386,74,571,480,78,526,432,60
060014273001,768,640,128,789,645,144,618,521,86,822,658,112
060014273002,830,703,127,852,712,140,1582,1332,215,789,649,106
060014279004,475,394,81,489,399,90,557,465,78,531,420,77
060014278001,365,304,61,374,307,67,371,316,51,403,329,51
060014286002,879,754,125,904,768,136,1022,849,150,973,800,121
060014278003,413,365,48,418,372,46,484,411,63,452,383,42
060014273003,373,327,46,381,333,48,441,375,61,418,348,43
060014273004,281,244,37,291,254,37,357,311,46,315,261,35
060014278004,412,359,53,424,372,52,549,464,72,488,403,52
060014278005,495,436,59,510,444,66,668,567,86,570,480,58
060014273005,425,369,56,436,377,59,542,458,74,508,424,58
060014276002,577,496,81,590,508,82,814,684,113,671,559,78
060014277001,420,359,61,427,362,65,490,416,67,464,382,60
060014277002,851,729,122,867,732,135,964,798,144,936,760,116
060014277004,349,296,53,355,299,56,569,470,84,391,313,50
060014276001,429,382,47,440,396,44,759,637,105,612,523,52
060014287001,598,490,108,620,505,115,925,777,143,674,556,84
060014287003,133,113,20,134,112,22,316,265,46,108,90,12
060014276003,304,252,52,315,260,55,435,359,66,339,273,41
060014277003,669,552,117,686,562,124,790,654,119,794,640,102
060014287002,188,159,29,193,163,30,260,217,39,283,225,35
060014008002,548,527,21,556,528,28,673,629,28,627,555,16
060014008003,700,673,27,709,677,32,847,786,35,800,701,22
060014251032,383,361,22,393,367,26,453,413,36,399,365,17
060014009001,593,575,18,608,582,26,696,659,22,641,572,12
060014009002,567,551,16,583,561,22,743,700,24,642,571,11
060014251041,759,733,26,770,735,35,1010,938,51,802,736,28
060014251045,125,116,9,126,117,9,139,130,7,140,127,6
060014007003,448,437,11,455,444,11,569,540,13,479,432,5
060014007004,666,640,26,670,647,23,709,681,16,720,655,11
060014007002,701,684,17,709,691,18,868,829,18,744,680,14
060014005002,528,514,14,530,516,14,586,559,12,585,544,7
060014006001,606,584,22,606,585,21,691,649,20,609,557,9
060014006002,370,355,15,370,359,11,433,409,14,402,367,7
060014010001,435,424,11,445,427,18,516,485,17,488,452,7
060014010002,449,438,11,458,442,16,551,516,15,477,432,10
060014010003,619,604,15,627,604,23,723,678,21,650,593,13
060014010004,330,319,11,334,323,11,422,399,13,379,336,8
060014010006,562,546,16,569,550,19,773,726,25,607,544,12
060014010005,567,548,19,575,554,21,745,697,26,754,672,18
060014251042,250,237,13,254,240,14,355,332,19,262,238,11
060014052003,578,538,40,583,542,41,685,635,40,644,560,36
060014052004,716,696,20,732,708,24,937,863,49,887,791,26
060014052002,598,556,42,609,564,45,747,690,38,587,492,46
060014035012,1043,1004,39,1044,998,46,1191,1095,65,1105,1009,28
060014035022,722,685,37,729,695,34,820,764,35,770,698,29
060014035021,464,440,24,469,441,28,542,503,29,513,461,20
060014035011,535,498,37,540,499,41,653,600,36,624,551,34
060014035014,448,410,38,452,411,41,1207,1110,65,501,435,35
060014036002,686,662,24,693,662,31,798,754,26,740,681,21
060014036001,408,387,21,413,393,20,437,408,17,479,435,19
060014037011,723,693,30,728,696,32,807,761,28,775,704,24
060014037012,913,874,39,909,866,43,982,927,33,960,862,27
060014037022,822,782,40,825,784,41,873,807,44,909,809,34
060014034011,577,545,32,585,548,37,797,737,42,623,560,22
060014037021,377,358,19,379,360,19,412,380,21,425,378,17
060014034022,541,510,31,549,515,34,669,618,35,605,535,18
060014034012,536,507,29,543,507,36,588,541,31,564,510,22
060014034013,429,382,47,441,398,43,488,419,56,503,417,53
060014033022,352,322,30,362,331,31,158,129,26,408,361,24
060014033012,145,127,18,152,135,17,212,171,35,177,148,16
060014033011,174,150,24,183,161,22,254,205,44,189,161,18
060014033021,361,337,24,365,340,25,652,599,40,372,336,17
060014033023,272,255,17,276,257,19,358,331,22,328,295,16
060014060001,741,683,58,753,686,67,1052,917,117,793,689,51
060014053011,538,509,29,547,519,28,460,425,23,607,544,18
060014053013,605,579,26,609,584,25,721,646,55,657,587,19
060014053012,410,393,17,414,397,17,452,403,36,426,381,12
060014053021,621,573,48,636,585,51,770,692,59,689,594,41
060014053022,425,386,39,433,397,36,584,523,44,481,410,34
060014054011,475,439,36,488,453,35,603,500,83,527,452,21
060014060002,186,167,19,193,170,23,247,207,40,306,263,27
060014060004,212,191,21,218,194,24,338,279,56,271,231,22
060014060003,227,201,26,234,204,30,315,256,51,290,245,26
060014054012,309,278,31,323,293,30,484,399,69,365,314,20
060014054013,235,206,29,243,215,28,347,289,50,311,265,20
060014054021,388,348,40,398,359,39,582,486,83,452,396,25
060014054022,290,267,23,295,273,22,383,320,54,340,297,14
060014061001,236,221,15,238,219,19,357,313,38,259,229,9
060014061003,493,450,43,502,451,51,640,549,67,481,420,29
060014061004,424,386,38,436,389,47,561,488,58,574,495,36
060014061002,174,162,12,175,159,16,306,262,32,218,191,10
060014015001,379,360,19,381,363,18,472,430,25,452,389,14
060014015002,273,265,8,275,264,11,340,312,18,315,270,8
060014015003,322,313,9,326,313,13,417,382,20,350,296,10
060014016001,466,456,10,472,455,17,635,585,30,516,448,14
060014017003,456,440,16,464,446,18,690,638,31,538,458,13
060014014003,376,359,17,384,364,20,509,470,26,421,364,15
060014014001,455,430,25,459,436,23,549,496,31,495,430,15
060014014002,737,703,34,750,709,41,931,851,47,752,644,23
060014013002,466,446,20,468,444,24,785,720,44,527,471,16
060014013003,536,514,22,538,511,27,773,710,46,569,513,16
060014016002,406,388,18,411,394,17,551,510,24,467,412,6
060014028011,406,387,19,410,392,18,413,383,25,445,400,19
060014028012,196,187,9,197,189,8,319,293,18,200,181,8
060014028013,307,293,14,310,298,12,368,337,21,336,304,13
060014026001,355,325,30,366,336,30,429,393,28,420,374,22
060014027001,209,199,10,217,201,16,272,251,17,236,204,8
060014028022,305,287,18,311,291,20,436,391,31,304,263,24
060014028021,125,114,11,127,116,11,142,127,11,183,159,10
060014027002,464,441,23,466,446,20,557,523,27,480,427,12
060014017002,608,573,35,617,574,43,632,587,29,477,421,13
060014018001,402,390,12,409,392,17,518,473,30,459,404,5
060014022001,571,549,22,586,561,25,585,535,35,527,480,7
060014017001,457,432,25,462,432,30,743,686,35,519,453,15
060014018002,313,299,14,319,300,19,442,412,20,376,325,9
060014022002,177,171,6,176,167,9,259,238,12,281,244,6
060014022003,265,255,10,263,251,12,335,313,15,269,234,6
060014105002,309,296,13,320,307,13,414,378,24,364,337,10
060014105001,294,275,19,296,285,11,629,575,34,380,345,9
060014025001,320,294,26,332,306,26,528,480,30,444,396,23
060014025002,163,150,13,168,155,13,247,224,14,204,183,10
060019820001,84,79,5,89,83,6,103,95,4,99,90,4
060014024001,431,410,21,439,414,25,601,554,27,496,448,13
060014024002,541,515,26,545,515,30,675,616,31,607,545,15
060014031001,413,385,28,416,387,29,491,436,43,390,347,21
060014031002,276,258,18,276,258,18,354,317,32,307,271,18
060019832002,176,166,10,180,168,12,527,493,21,193,177,7
060019832001,144,137,7,147,138,9,211,199,7,172,160,5
060014030003,180,152,28,192,158,34,328,262,57,218,173,31
060014030001,268,231,37,281,236,45,416,333,72,310,248,44
060014030002,246,193,53,269,211,58,423,342,73,346,280,57
060014029001,275,253,22,279,254,25,721,646,52,304,253,24
060014029002,256,236,20,259,241,18,389,359,20,295,244,24
060014066011,291,268,23,303,272,31,421,371,44,352,311,20
060014066012,444,412,32,461,425,36,620,516,84,519,450,30
060014066013,461,424,37,473,436,37,648,570,70,524,463,34
060014066014,292,269,23,296,273,23,412,364,45,324,290,20
060014066021,409,376,33,415,384,31,581,509,56,493,440,27
060014065001,555,515,40,565,519,46,748,648,82,627,554,28
060014066022,312,287,25,324,298,26,507,448,44,379,344,17
060014067001,822,758,64,840,774,66,941,869,52,864,777,48
060014067005,449,406,43,459,416,43,502,462,27,476,425,27
060014067003,837,786,51,856,798,58,1052,953,75,939,847,42
060014067004,442,416,26,453,427,26,566,512,40,505,458,23
060014067002,384,356,28,385,350,35,441,399,32,405,357,17
060014068001,424,378,46,434,382,52,483,436,39,443,383,41
060014068002,388,354,34,400,361,39,507,455,42,425,376,30
060014068004,485,454,31,492,454,38,656,591,54,547,502,29
060014068003,514,464,50,530,474,56,639,579,51,551,477,46
060014069002,692,632,60,706,644,62,774,698,60,733,649,48
060014069003,712,663,49,723,675,48,981,889,72,804,707,41
060014076001,546,517,29,556,519,37,630,590,29,599,549,19
060014078001,409,386,23,418,390,28,495,463,23,452,416,14
060014078002,720,691,29,733,692,41,819,760,49,760,688,27
060014077001,790,753,37,808,764,44,955,892,42,828,760,27
060014079001,480,427,53,489,432,57,547,493,43,522,447,47
060014079002,466,424,42,466,421,45,555,503,40,485,429,31
060014079003,617,582,35,616,570,46,736,670,56,643,592,27
060014069001,442,407,35,452,414,38,489,442,39,466,414,28
060014080002,1036,908,128,1064,925,139,1200,1078,108,1119,990,100
060014070001,295,263,32,309,275,34,417,365,47,316,269,29
060014070002,380,344,36,385,348,37,481,417,53,394,333,32
060014070005,269,243,26,275,249,26,346,303,39,305,258,26
060014070003,329,302,27,340,316,24,549,474,61,406,353,25
060014070004,336,308,28,346,322,24,559,483,63,415,358,26
060014076005,271,248,23,272,255,17,393,350,38,312,279,15
060014071021,433,395,38,435,398,37,726,635,79,583,516,32
060014076002,327,309,18,340,312,28,474,434,32,383,352,9
060014076003,440,408,32,446,416,30,553,503,37,494,452,19
060014076004,399,375,24,407,377,30,577,525,39,448,407,14
060014077002,523,494,29,540,510,30,661,622,34,565,522,18
060014077003,547,521,26,553,523,30,630,591,30,581,531,18
060014055004,532,507,25,536,508,28,641,577,49,591,515,29
060014055001,211,193,18,211,193,18,304,272,32,237,213,11
060014055002,305,285,20,306,286,20,458,415,34,362,313,19
060014055003,282,264,18,284,266,18,384,349,29,313,273,16
060014056001,340,320,20,353,329,24,416,378,31,369,321,18
060014056003,611,582,29,617,577,40,734,660,55,686,585,34
060014056002,339,316,23,350,326,24,484,428,44,394,347,19
060014057001,429,407,22,435,408,27,586,533,43,491,429,24
060014057003,385,361,24,392,364,28,507,449,42,417,358,23
060014058004,170,154,16,171,155,16,261,217,36,214,188,11
060014059021,322,286,36,329,291,38,483,401,76,385,331,27
060014059022,325,288,37,330,292,38,484,407,76,383,336,26
060014058003,214,189,25,221,194,27,340,280,54,271,230,19
060014057002,287,267,20,295,272,23,410,366,38,341,298,18
060014064002,440,408,32,450,414,36,584,518,50,511,443,30
060014064001,298,275,23,303,277,26,366,328,32,326,285,17
060014059011,205,187,18,212,190,22,331,278,52,246,212,15
060014059012,294,269,25,301,272,29,482,394,76,387,338,21
060014059013,177,160,17,180,161,19,280,230,46,217,194,10
060014058001,262,236,26,274,239,35,430,346,71,367,313,29
060014058002,205,184,21,212,186,26,347,274,54,276,235,22
060014062011,225,209,16,231,211,20,402,341,51,277,242,17
060014062012,128,120,8,134,123,11,228,196,28,151,133,9
060014062013,215,200,15,224,205,19,341,290,43,292,252,20
060014062014,144,134,10,149,136,13,243,207,31,188,165,12
060014062023,248,227,21,256,233,23,417,353,53,308,276,16
060014062021,139,126,13,142,128,14,219,185,28,185,166,9
060014062022,236,214,22,245,220,25,378,318,49,284,255,14
060014063002,233,210,23,234,209,25,341,294,39,256,221,13
060014063003,185,174,11,191,176,15,283,243,32,219,189,11
060014063004,204,193,11,210,197,13,301,263,36,247,215,11
060014063001,296,265,31,297,262,35,391,333,44,326,279,17
060014065004,321,289,32,326,291,35,453,388,52,390,336,25
060014065002,171,160,11,172,156,16,248,221,24,206,186,9
060014065003,343,307,36,350,309,41,495,426,55,416,357,30
060014071012,409,376,33,412,377,35,482,418,53,372,324,22
060014071011,334,310,24,338,309,29,551,477,60,396,343,25
060014071023,184,168,16,187,169,18,274,239,31,227,202,14
060014071022,255,229,26,256,230,26,361,312,40,309,269,20
060014071024,252,227,25,256,230,26,336,295,38,299,265,19
060014072001,202,184,18,203,181,22,360,311,40,260,236,11
060014072002,261,237,24,265,234,31,372,321,45,303,267,20
060014072003,282,253,29,279,248,31,369,309,47,308,266,24
060014072004,337,304,33,337,300,37,495,420,62,404,355,28
060014073001,304,286,18,308,286,22,419,371,35,342,296,14
060014073002,284,265,19,285,262,23,407,369,31,344,299,18
060014088004,459,423,36,470,439,31,819,724,78,558,517,18
060014088002,272,255,17,283,262,21,455,405,37,414,393,12
060014088003,192,178,14,201,184,17,312,277,31,258,245,8
060014088001,156,152,4,164,156,8,272,252,18,224,211,5
060014089002,306,286,20,317,291,26,488,430,46,393,369,15
060014089001,238,223,15,246,225,21,360,312,35,348,324,11
060014074001,374,342,32,381,350,31,544,475,50,452,410,17
060014074002,163,147,16,165,146,19,311,271,30,221,198,11
060014075001,135,128,7,138,130,8,212,192,16,171,163,2
060014075002,281,267,14,284,268,16,493,451,38,375,351,9
060014075003,233,223,10,241,227,14,371,333,36,305,288,5
060014087003,287,270,17,292,275,17,436,396,28,376,350,13
060014087004,152,145,7,156,145,11,265,245,16,201,186,6
060014087005,293,278,15,294,279,15,489,450,31,371,346,12
060014087002,352,335,17,359,344,15,508,467,30,411,380,12
060014087006,284,270,14,285,275,10,359,333,22,316,299,9
060014077004,522,502,20,527,500,27,596,562,26,546,501,15
060014087001,483,460,23,495,470,25,538,490,30,533,489,24
060014086001,361,344,17,374,357,17,562,519,31,487,447,17
060014086002,467,444,23,479,455,24,637,573,39,563,518,16
060014086003,241,228,13,246,233,13,351,323,21,303,282,9
060014086004,223,211,12,225,212,13,305,283,19,255,243,6
060014085003,168,159,9,174,164,10,234,215,17,214,201,8
060014085004,167,157,10,170,157,13,236,214,18,220,201,9
060014085005,271,256,15,273,248,25,400,353,29,347,316,13
060014085001,243,229,14,248,234,14,371,333,28,317,295,9
060014085002,280,265,15,289,272,17,394,359,29,351,330,10
060014084001,297,281,16,306,287,19,467,432,28,396,364,10
060014084002,196,185,11,204,192,12,305,287,18,244,224,6
060014084003,364,345,19,372,350,22,551,509,30,435,400,12
060014081001,881,745,136,893,750,143,1061,903,142,974,795,136
060014081003,593,537,56,609,548,61,759,672,76,638,561,51
060014081004,453,400,53,466,409,57,542,480,54,492,422,50
060014081005,1104,964,140,1129,984,145,1284,1148,118,1193,1042,102
060014081002,595,534,61,612,544,68,978,872,90,699,608,54
060014082001,729,688,41,740,687,53,848,783,50,787,703,33
060014082002,603,569,34,618,588,30,896,821,51,705,640,26
060014083001,392,365,27,398,368,30,480,447,28,409,365,22
060014082003,366,348,18,374,352,22,503,463,30,416,375,14
060014083002,538,503,35,549,507,42,582,545,31,558,498,26
060014083003,530,496,34,546,503,43,599,549,32,573,508,27
060014083004,291,274,17,292,275,17,408,379,22,345,317,13
060014098001,485,459,26,489,457,32,511,472,33,425,394,18
060014083005,299,281,18,305,286,19,429,396,24,351,315,15
060014097001,232,220,12,235,219,16,356,323,25,288,266,11
060014097004,238,226,12,243,225,18,371,347,23,295,276,11
060014098002,464,436,28,471,437,34,716,646,51,653,601,23
060014090001,402,380,22,411,392,19,687,610,65,555,502,28
060014090003,372,346,26,381,350,31,579,519,45,492,456,17
060014324003,448,361,87,461,366,95,1479,1106,349,456,361,68
060014094002,362,335,27,371,338,33,479,415,49,476,431,24
060014094003,189,177,12,189,179,10,302,271,31,232,217,8
060014095001,222,204,18,226,206,20,493,434,49,283,257,15
060014095002,170,158,12,171,159,12,286,253,29,239,216,10
060014095003,151,142,9,155,144,11,234,211,23,197,179,8
060014096001,186,178,8,188,170,18,284,263,21,252,236,11
060014096005,219,206,13,223,205,18,342,316,26,289,273,12
060014097002,298,280,18,301,280,21,509,452,38,396,365,14
060014097003,214,202,12,218,204,14,336,306,26,261,244,9
060014251022,167,155,12,170,157,13,246,228,14,251,225,12
060014251031,286,270,16,293,274,19,371,331,33,322,293,13
060014251033,465,436,29,476,444,32,570,520,45,515,466,23
060014251044,283,263,20,290,268,22,316,294,17,333,301,15
060014251043,112,104,8,115,106,9,201,186,11,146,132,7
060014251011,544,460,84,557,473,84,685,610,62,622,504,72
060014251012,225,190,35,230,195,35,270,241,24,269,217,31
060014251021,336,306,30,340,304,36,798,711,72,413,358,30
060014251023,463,422,41,471,421,50,660,586,60,580,503,43
060014100001,545,458,87,550,463,87,644,574,57,589,485,71
060014304002,592,393,199,602,406,196,735,503,212,664,433,181
060014328001,356,266,90,364,269,95,427,337,80,422,305,90
060014100002,1147,1053,94,1169,1057,112,1370,1275,81,1280,1169,73
060014099004,561,516,45,558,509,49,642,590,39,614,561,30
060014099002,358,321,37,367,330,37,410,379,25,366,331,28
060014099003,768,710,58,786,727,59,887,823,53,833,762,50
060014099001,407,363,44,419,375,44,478,440,30,433,381,39
060014321001,911,804,107,922,801,121,1007,874,122,911,771,99
060014321002,514,449,65,522,449,73,692,595,85,553,469,61
060014101001,483,454,29,492,456,36,594,529,47,515,473,18
060014101002,494,468,26,508,480,28,686,617,51,609,572,19
060014098003,392,372,20,395,370,25,522,479,33,416,388,16
060014096002,235,218,17,242,227,15,325,295,25,266,245,9
060014096003,138,128,10,142,132,10,197,181,15,168,155,6
060014096004,155,144,11,157,147,10,220,201,18,193,183,5
060014103001,147,142,5,153,147,6,255,224,17,223,205,7
060014103002,174,166,8,182,173,9,298,271,22,238,221,9
060014103003,208,199,9,213,204,9,361,319,26,296,272,9
060014104001,247,236,11,255,240,15,393,348,30,310,287,9
060014104003,458,436,22,472,443,29,608,548,46,545,510,14
060014102001,399,381,18,407,388,19,588,536,45,491,467,16
060014102002,246,234,12,250,238,12,354,317,27,304,285,9
060014102003,338,320,18,346,327,19,454,410,35,301,283,9
060014104002,353,334,19,364,339,25,412,381,30,475,438,17
060014094001,117,109,8,121,113,8,195,175,20,158,145,8
060014093001,256,240,16,271,249,22,472,425,35,363,346,6
060014093003,234,219,15,240,223,17,384,351,30,302,285,10
060014093002,280,263,17,284,264,20,425,389,32,362,331,12
060014323001,379,335,44,379,330,49,534,440,85,435,373,42
060014093004,135,127,8,139,130,9,312,283,28,173,165,6
060014091001,212,203,9,216,204,12,324,289,26,274,248,12
060014091002,281,271,10,287,273,14,402,362,32,343,310,17
060014092001,483,462,21,492,471,21,734,651,59,603,556,23
060014323003,792,658,134,814,678,136,1247,1020,197,999,824,119
060014325021,575,482,93,588,481,107,836,642,181,742,619,86
060014092002,202,189,13,204,192,12,342,305,27,275,250,13
060014371014,310,234,76,313,234,79,243,168,72,225,159,57
060014372005,511,383,128,524,386,138,1128,852,258,598,455,115
060014372002,319,255,64,327,261,66,455,344,105,372,292,60
060014372004,409,325,84,420,325,95,714,539,162,565,441,95
060014372001,285,214,71,291,215,76,471,358,107,451,346,86
060014369001,290,250,40,291,245,46,492,380,93,381,321,38
060014369002,229,179,50,234,180,54,349,264,77,294,232,52
060014369003,279,219,60,284,219,65,441,334,98,339,266,59
060014369004,329,278,51,339,284,55,630,495,118,480,403,45
060014367001,329,266,63,335,274,61,510,400,100,401,317,60
060014367002,509,405,104,513,414,99,854,674,170,634,510,99
060014370001,450,349,101,458,349,109,662,506,147,537,419,89
060014370003,344,266,78,349,269,80,659,496,145,391,308,65
060014368001,455,368,87,462,366,96,712,538,157,582,468,86
060014368002,541,425,116,551,421,130,783,597,173,625,485,105
060014366021,322,272,50,331,278,53,432,336,87,437,367,52
060014374001,243,195,48,249,195,54,675,528,137,310,245,51
060014374002,702,572,130,715,571,144,903,710,184,906,731,129
060014375001,229,190,39,233,191,42,386,301,78,323,265,41
060014375002,401,332,69,411,336,75,652,503,132,529,431,71
060014376001,537,434,103,545,432,113,830,642,167,635,510,89
060014376002,260,208,52,265,208,57,383,299,80,322,258,46
060014377021,135,110,25,137,112,25,227,177,45,237,194,32
060014377023,71,59,12,71,59,12,128,98,26,123,102,15
060014377011,64,54,10,65,54,11,133,102,27,87,74,8
060014377012,258,219,39,261,218,43,499,386,102,349,301,30
060014377013,112,96,16,114,96,18,206,157,41,196,168,18
060014377022,118,100,18,118,99,19,222,172,45,143,123,13
060014372003,463,372,91,474,383,91,659,502,151,570,453,87
060014370002,372,291,81,383,291,92,404,302,89,431,342,72
060014373001,237,197,40,242,197,45,356,278,70,410,339,54
060014373002,356,295,61,363,294,69,406,318,79,336,277,44
060014373003,213,177,36,218,177,41,331,261,65,288,236,39
060014383001,286,242,44,294,244,50,503,395,98,392,329,45
060014383002,313,266,47,322,267,55,599,473,118,458,386,52
060014383003,229,194,35,237,196,41,371,295,74,302,254,35
060014384001,319,244,75,326,247,79,530,399,123,403,306,75
060014384002,398,302,96,409,307,102,577,435,134,438,335,84
060014371012,539,420,119,555,432,123,833,624,196,697,536,130
060014371022,380,301,79,388,303,85,623,464,148,470,369,78
060014371011,866,670,196,891,690,201,1480,1117,341,1056,857,162
060014371013,480,375,105,491,378,113,771,577,184,610,477,100
060014371023,339,263,76,353,269,84,521,388,125,442,345,72
060014371021,322,258,64,328,257,71,522,388,123,407,325,61
060014382011,297,261,36,305,266,39,548,429,107,402,345,44
060014382012,458,355,103,469,353,116,920,697,207,552,425,104
060014382013,314,256,58,322,262,60,514,388,119,419,353,55
060014382032,517,412,105,525,418,107,869,640,218,649,535,90
060014382041,451,366,85,459,373,86,709,521,180,633,518,93
060014382042,355,289,66,361,294,67,1041,800,219,450,364,70
060014382043,861,639,222,876,663,213,1296,953,322,965,741,196
060014382031,509,384,125,522,381,141,779,577,194,693,517,142
060014351044,127,108,19,129,110,19,229,173,48,300,260,24
060014381001,583,458,125,597,469,128,877,668,184,695,539,116
060014381002,296,232,64,301,235,66,443,343,94,350,273,58
060014381003,260,207,53,266,210,56,391,299,88,325,262,53
060014351041,637,505,132,649,514,135,1165,915,223,731,553,126
060014380001,653,508,145,668,500,168,949,705,225,792,591,147
060014380002,421,328,93,429,325,104,575,429,131,474,356,88
060014381004,500,397,103,512,400,112,702,538,150,603,463,103
060014381005,328,263,65,336,266,70,493,377,106,406,325,64
060014403014,479,396,83,496,393,103,741,565,145,641,501,97
060014381006,289,233,56,297,237,60,454,344,98,352,281,55
060014363022,306,260,46,311,256,55,532,421,93,415,332,53
060014363021,797,671,126,819,680,139,1334,1053,237,899,739,111
060014363023,173,146,27,177,145,32,288,232,52,227,181,31
060014363012,229,194,35,236,196,40,362,288,66,283,234,36
060014355002,356,291,65,371,298,73,514,428,77,457,355,69
060014355003,278,221,57,285,226,59,429,338,81,330,251,51
060014354001,534,474,60,542,477,65,796,640,140,703,586,76
060014354002,300,255,45,305,260,45,451,359,81,384,320,47
060014354003,379,323,56,383,324,59,539,428,96,444,367,53
060014312002,691,545,146,703,548,155,913,711,187,817,622,146
060014312003,837,641,196,859,647,212,1177,898,261,971,703,208
060014364034,240,193,47,246,191,55,347,270,67,240,181,42
060014353001,336,266,70,346,276,70,530,433,85,515,405,71
060014353002,515,419,96,530,431,99,809,633,153,649,499,98
060014353003,407,311,96,416,310,106,575,429,134,483,358,93
060014351021,914,693,221,939,710,229,1185,916,238,1020,766,191
060014364033,232,189,43,231,182,49,309,249,55,265,199,55
060014364032,403,328,75,409,325,84,582,452,112,478,369,74
060014364031,317,254,63,320,248,72,423,333,78,342,260,56
060014363011,357,299,58,369,309,60,600,477,104,509,436,52
060014366011,320,267,53,329,273,56,554,442,101,426,343,60
060014366012,539,455,84,551,458,93,896,705,167,755,617,90
060014366023,257,218,39,265,222,43,342,267,70,347,289,44
060014366022,305,253,52,314,259,55,720,567,132,424,334,63
060014366013,365,312,53,378,316,62,588,463,107,492,408,53
060014365001,316,263,53,324,263,61,756,596,146,511,414,64
060014365003,236,198,38,240,197,43,419,326,83,355,292,42
060014365002,299,233,66,309,245,64,450,360,82,376,299,55
060014378001,575,460,115,591,470,121,904,693,194,736,596,109
060014378003,463,362,101,474,358,116,693,530,150,556,434,98
060014378002,299,241,58,308,247,61,462,355,100,353,291,53
060014351043,383,325,58,390,332,58,405,308,84,240,208,19
060014351042,259,206,53,263,208,55,365,291,68,295,223,50
060014379001,279,227,52,280,227,53,422,328,92,382,301,56
060014379002,226,185,41,228,185,43,390,297,83,269,210,40
060014351022,412,326,86,422,331,91,376,291,77,762,628,101
060014364022,637,460,177,654,468,186,759,582,159,721,517,157
060014351023,746,583,163,761,583,178,918,710,188,758,589,135
060014351034,1218,931,287,1260,955,305,1808,1399,373,1210,922,218
060014364021,761,563,198,781,563,218,950,700,232,866,638,199
060014364043,484,376,108,496,376,120,674,509,153,525,400,101
060014359001,593,433,160,613,431,182,810,582,211,712,500,165
060014359002,494,359,135,503,360,143,722,523,191,626,458,131
060014359003,418,302,116,425,304,121,634,459,168,542,392,117
060014334004,463,352,111,476,368,108,766,549,208,558,437,100
060014359004,267,187,80,274,194,80,405,286,107,327,225,84
060014358002,494,370,124,504,371,133,634,454,162,534,393,110
060014358003,411,308,103,420,314,106,687,492,177,569,422,119
060014360001,299,224,75,306,223,83,478,342,123,371,273,75
060014360002,656,489,167,668,487,181,1006,716,260,850,631,166
060014361001,375,282,93,382,280,102,540,388,139,441,332,84
060014361003,574,427,147,584,429,155,877,629,229,731,541,152
060014360003,586,439,147,590,430,160,857,620,226,667,507,123
060014358004,409,305,104,418,315,103,584,422,151,509,377,107
060014358001,415,328,87,429,327,102,691,497,178,500,365,109
060014361002,614,471,143,632,469,163,959,730,218,773,600,145
060014357001,262,204,58,266,207,59,411,307,96,328,253,59
060014357002,283,211,72,291,211,80,421,317,94,361,270,77
060014357003,397,295,102,408,297,111,562,423,126,499,374,105
060014357004,325,241,84,337,245,92,466,356,105,415,314,88
060014331021,522,405,117,550,428,122,764,584,165,660,518,122
060014338021,512,422,90,532,424,108,906,695,186,669,537,94
060014338022,525,424,101,534,429,105,844,676,159,703,551,113
060014337001,350,289,61,358,292,66,521,414,99,428,352,52
060014337002,244,200,44,247,200,47,381,304,77,330,268,45
060014340002,241,197,44,246,201,45,413,326,78,293,237,43
060014340003,328,266,62,337,272,65,542,425,101,429,345,63
060014340001,391,318,73,409,328,81,666,546,108,558,449,72
060014339003,164,140,24,164,139,25,257,212,42,193,165,22
060014339004,303,258,45,305,257,48,460,376,75,390,329,43
060014305001,887,728,159,910,736,174,1176,916,237,1027,806,164
060014339001,410,358,52,417,358,59,588,476,97,536,460,55
060014339002,263,230,33,267,229,38,376,307,62,330,283,35
060014338011,185,152,33,189,156,33,267,210,52,205,164,29
060014338012,494,413,81,507,427,80,824,648,151,648,523,88
060014305002,546,444,102,556,449,107,848,653,174,666,514,112
060014305003,507,399,108,520,411,109,741,545,183,657,495,126
060014306002,342,253,89,351,254,97,596,422,158,396,281,89
060014306003,1243,893,350,1274,902,372,1686,1192,443,1444,992,349
060014335002,260,180,80,271,184,87,392,270,119,317,222,83
060014335003,490,338,152,507,344,163,714,487,214,591,411,153
060014335004,289,194,95,299,200,99,604,414,174,360,249,98
060014336001,299,218,81,305,218,87,470,342,124,343,255,72
060014336003,522,388,134,534,382,152,671,482,175,653,486,134
060014336004,470,345,125,483,344,139,766,546,201,565,419,118
060014334005,318,210,108,327,218,109,452,306,136,356,252,85
060014334006,431,298,133,445,312,133,639,442,186,491,366,106
060014333005,503,367,136,521,379,142,827,574,227,584,411,133
060014335001,309,216,93,320,218,102,485,331,147,372,260,95
060014333001,550,403,147,573,415,158,787,554,210,702,510,152
060014336002,352,254,98,357,254,103,616,439,161,425,316,90
060014333003,323,242,81,336,245,91,504,359,139,380,280,77
060014333004,467,355,112,484,352,132,756,536,204,601,448,112
060014333002,314,226,88,327,232,95,485,341,132,397,294,88
060014334001,300,232,68,310,239,71,434,324,102,375,290,68
060014334002,374,286,88,385,297,88,529,393,126,453,352,81
060014334003,315,241,74,323,249,74,461,341,107,383,296,69
060014324001,787,602,185,804,599,205,639,486,137,621,483,109
060014324002,204,158,46,207,156,51,320,241,75,761,573,152
060014326011,399,337,62,410,348,62,536,438,90,358,297,43
060014326023,341,286,55,350,285,65,491,386,91,437,367,53
060014326021,253,212,41,258,211,47,363,283,68,298,248,37
060014331042,192,165,27,197,165,32,282,224,51,240,199,30
060014325013,595,464,131,613,469,144,1023,771,234,780,617,128
060014325023,318,272,46,327,270,57,611,469,127,393,341,35
060014325022,248,204,44,253,205,48,425,326,92,317,254,44
060014325011,313,252,61,325,259,66,531,393,129,384,304,58
060014325012,186,149,37,193,153,40,335,244,81,231,181,34
060014332004,464,348,116,476,359,117,722,531,174,585,438,121
060014332001,569,436,133,583,440,143,793,592,189,693,528,130
060014332002,507,405,102,521,406,115,952,733,205,636,504,99
060014332003,250,204,46,259,209,50,410,323,78,345,279,47
060014331022,605,454,151,623,469,154,850,653,183,706,521,148
060014331031,790,687,103,807,688,119,850,659,179,994,835,109
060014331041,149,130,19,152,132,20,233,195,33,179,150,15
060014331043,453,384,69,465,388,77,1015,847,148,592,485,71
060014330001,416,332,84,428,344,84,636,512,116,547,441,85
060014330002,437,346,91,453,360,93,618,503,109,524,408,83
060014330003,284,245,39,290,245,45,438,350,76,297,246,37
060014331032,241,197,44,249,200,49,349,271,70,287,239,35
060014327002,318,244,74,321,248,73,399,317,76,387,302,66
060014326012,773,642,131,793,654,139,1120,916,187,877,705,119
060014327001,547,462,85,550,466,84,612,533,76,541,440,76
060014327003,390,299,91,394,303,91,477,378,88,431,330,73
060014321003,559,471,88,568,478,90,681,583,82,614,507,77
060014326022,439,377,62,448,379,69,581,489,78,483,406,51
060014328002,885,671,214,917,691,226,1099,873,206,944,698,196
060014328003,407,315,92,417,310,107,624,485,125,484,362,87
060014322003,853,734,119,867,738,129,1114,938,150,975,820,104
060014322001,432,370,62,442,374,68,593,497,80,522,431,63
060014322002,402,342,60,406,340,66,502,423,69,450,375,57
060014323002,307,272,35,310,269,41,424,347,68,357,305,36
060014312001,687,509,178,702,519,183,871,626,220,764,543,176
060014311001,503,351,152,518,357,161,676,479,175,561,383,134
060014311002,576,454,122,590,460,130,879,675,182,608,451,112
060014310001,370,263,107,373,265,108,583,416,155,477,337,114
060014310002,514,395,119,525,396,129,755,540,201,579,420,120
060014306004,360,250,110,371,254,117,464,323,126,411,279,106
060014306001,586,402,184,595,405,190,760,525,211,642,437,162
060014304001,518,351,167,528,358,170,631,439,181,575,387,147
060014309002,370,286,84,378,286,92,655,462,172,478,354,93
060014309003,260,191,69,266,192,74,420,297,110,318,227,70
060014309001,672,514,158,689,514,175,930,660,248,790,571,164
060014307001,417,287,130,431,292,139,528,366,145,467,309,128
060014307002,771,535,236,790,539,251,1084,757,295,898,593,246
060014307003,546,367,179,560,369,191,754,527,209,571,372,162
060014303001,846,537,309,861,558,303,1077,730,319,947,593,286
060014303002,540,366,174,555,368,187,704,487,201,589,375,175
060014303003,496,322,174,509,323,186,683,456,203,551,340,174
060014302004,667,463,204,680,462,218,864,605,238,743,492,204
060014302005,668,433,235,689,442,247,894,599,266,788,499,244
060014302001,1218,816,402,1245,828,417,1489,1048,401,1334,914,347
060014302002,625,429,196,637,430,207,787,557,211,650,436,170
060014308003,723,474,249,739,475,264,1160,790,344,871,583,234
060014302003,381,276,105,389,275,114,506,360,134,397,273,100
060014308001,375,260,115,387,259,128,516,356,148,427,277,114
060014308004,643,448,195,664,451,213,948,671,257,796,537,203
060014308002,364,246,118,380,244,136,470,311,148,457,281,134
060014301013,773,504,269,786,514,272,1095,776,297,842,556,232
060014301011,582,349,233,601,354,247,820,542,261,690,409,245
060014301012,986,684,302,1014,702,312,1304,957,316,1105,798,250
060014351033,778,556,222,800,564,236,1113,836,259,868,639,192
060014301014,535,347,188,557,367,190,778,575,185,633,447,147
060014351032,870,649,221,895,651,244,1200,906,274,930,703,189
060014355001,286,214,72,297,217,80,431,321,103,328,231,63
060014356021,251,195,56,258,197,61,398,293,100,345,263,65
060014356022,139,119,20,143,120,23,230,169,54,175,145,20
060014356023,314,258,56,320,262,58,483,388,90,423,344,62
060014356024,338,260,78,344,263,81,550,400,136,427,325,81
060014356011,298,252,46,303,250,53,462,375,78,364,301,48
060014356012,374,320,54,385,323,62,599,474,113,514,428,59
060014356013,230,192,38,235,191,44,380,304,65,322,272,35
060014362002,375,318,57,380,315,65,721,546,158,529,432,71
060014352001,791,640,151,807,636,171,1197,940,231,983,769,156
060014352002,700,583,117,711,584,127,1023,814,188,843,693,108
060014364042,468,357,111,479,356,123,597,445,139,600,446,115
060014364041,536,418,118,550,419,131,704,532,160,570,435,106
060014511042,919,544,375,950,565,385,1103,660,415,875,504,309
060014512014,478,271,207,488,274,214,1002,614,359,584,321,217
060014512011,694,429,265,710,431,279,948,588,334,772,446,282
060014512012,969,549,420,1001,560,441,1366,849,481,1166,650,412
060014512021,867,501,366,889,511,378,1349,789,529,1040,536,415
060014512022,319,177,142,332,185,147,478,287,180,389,207,145
060014512023,352,196,156,368,207,161,531,317,200,431,229,162
060014511041,828,427,401,864,441,423,1212,681,505,1104,573,454
060014512013,438,247,191,454,251,203,619,382,219,553,304,201
060014515051,553,261,292,577,267,310,679,431,235,576,282,243
060014515061,828,514,314,850,516,334,1328,834,451,898,564,263
060014515062,202,142,60,206,142,64,307,193,105,219,155,48
060014515041,678,418,260,707,439,268,1339,832,471,766,461,240
060014515052,1143,612,531,1179,616,563,1473,908,537,1270,659,507
060014515013,898,502,396,929,528,401,959,581,350,864,483,315
060014515031,732,429,303,753,429,324,989,628,331,995,574,346
060014515035,587,350,237,605,348,257,762,487,258,668,391,229
060014511031,314,182,132,323,191,132,3,1,2,1,1,0
060014511032,717,362,355,737,376,361,1396,809,550,773,408,312
060014515012,535,307,228,551,322,229,678,424,241,914,544,305
060014515032,354,220,134,367,218,149,485,311,161,407,238,134
060014515033,292,177,115,306,177,129,408,264,135,322,186,107
060014515034,292,179,113,306,180,126,396,255,131,360,210,119
060014515011,593,391,202,610,394,216,789,507,261,695,433,210
060014516011,676,412,264,698,422,276,893,587,287,689,415,209
060014514013,714,432,282,741,441,300,1321,836,449,698,412,238
060014516013,776,436,340,798,442,356,899,570,306,879,498,312
060014516022,454,287,167,476,298,178,613,402,197,510,315,157
060014516021,470,308,162,486,316,170,602,394,192,547,341,162
060014516025,298,195,103,309,200,109,470,304,150,368,233,105
060014517011,362,224,138,374,223,151,514,317,183,417,238,146
060014517012,513,315,198,528,313,215,735,455,261,617,352,216
060014517013,305,184,121,315,184,131,484,299,172,369,211,128
060014517041,643,354,289,672,361,311,821,496,308,736,415,274
060014517042,1033,594,439,1063,594,469,1329,831,474,1163,669,408
060014517043,336,183,153,347,187,160,460,285,163,375,210,138
060014511021,684,361,323,712,377,335,949,566,364,769,415,298
060014511023,633,331,302,655,356,299,769,459,296,711,411,256
060014516024,774,387,387,796,390,406,977,576,374,890,440,376
060014517032,1092,625,467,1130,630,500,1443,892,522,1248,707,448
060014511022,752,392,360,769,401,368,1029,621,395,836,452,338
060014517031,708,409,299,717,408,309,1009,631,354,795,445,283
060014516023,881,512,369,901,514,387,1124,664,431,969,539,358
060014516012,979,525,454,1005,542,463,1355,801,526,1070,574,419
060014514012,1397,784,613,1439,813,626,1652,1043,574,1593,901,574
060014513001,1343,791,552,1385,792,593,1662,1055,569,1555,863,568
060014514011,313,203,110,319,198,121,658,417,227,358,214,111
060014514032,528,318,210,548,329,219,716,464,234,614,338,212
060014514041,677,430,247,699,427,272,971,621,314,771,477,221
060014514031,304,187,117,309,186,123,455,294,147,368,218,110
060014514043,306,199,107,311,203,108,506,331,169,384,243,106
060014514044,349,225,124,356,227,129,624,410,206,426,265,123
060014514042,348,206,142,356,200,156,555,356,180,391,224,124
060014513002,712,438,274,730,446,284,994,599,366,758,431,267
060014513003,847,457,390,871,472,399,1159,697,425,963,505,386
060014507521,1650,1138,512,1697,1169,528,3472,2473,929,1390,945,367
060014507461,1040,646,394,1071,652,419,1592,1097,463,1218,756,377
060014507011,575,306,269,595,322,273,814,534,264,674,390,232
060014507015,1225,669,556,1264,690,574,1423,910,480,1204,671,443
060014507421,685,425,260,697,423,274,845,552,271,742,459,228
060014507422,776,453,323,805,459,346,955,633,296,879,525,302
060014507423,738,451,287,754,462,292,1385,929,426,836,486,302
060014507411,477,313,164,495,317,178,599,391,195,608,369,195
060014507014,1113,638,475,1153,642,511,1743,1155,546,1337,786,467
060014507412,597,393,204,614,398,216,844,564,262,680,427,197
060014507413,936,591,345,966,602,364,1201,799,375,1036,658,306
060014507012,526,310,216,546,326,220,713,477,218,649,409,202
060014507013,432,229,203,442,232,210,534,339,182,497,273,188
060014506013,747,389,358,766,394,372,940,577,338,749,424,287
060014506063,1250,769,481,1291,784,507,1742,1195,509,1181,752,365
060014506071,455,314,141,468,317,151,687,477,195,681,465,170
060014506073,410,293,117,418,295,123,684,475,190,432,295,106
060014506072,511,328,183,526,330,196,735,502,219,715,450,209
060014506082,663,415,248,678,417,261,960,670,266,787,490,250
060014506081,559,309,250,561,305,256,782,530,233,654,379,241
060014506034,604,379,225,620,382,238,765,509,236,682,416,209
060014506032,668,434,234,681,435,246,871,578,270,761,464,251
060014506033,75,48,27,76,48,28,99,66,31,86,52,28
060014506041,675,421,254,693,433,260,793,548,226,706,433,235
060014506044,370,232,138,381,242,139,468,324,135,414,261,125
060014506052,446,282,164,458,287,171,540,371,157,496,310,152
060014506053,529,321,208,536,326,210,659,456,190,594,344,214
060014507432,235,182,53,242,184,58,379,274,97,283,206,66
060014507431,495,384,111,512,389,123,790,570,201,557,407,129
060014507433,252,184,68,255,188,67,217,156,56,256,185,52
060014506031,619,394,225,635,401,234,874,581,271,761,472,242
060014506061,997,586,411,1035,622,413,1296,874,396,1120,695,343
060014506012,613,393,220,623,395,228,892,610,265,707,475,194
060014506093,852,530,322,868,533,335,1135,770,339,1018,642,304
060014506083,540,328,212,552,335,217,741,492,231,667,416,201
060014506092,860,548,312,874,547,327,1139,796,323,1022,660,301
060014506091,195,131,64,198,133,65,328,228,93,272,192,66
060014507434,399,276,123,406,285,121,836,599,218,414,299,87
060014507441,1195,737,458,1229,744,485,1495,1081,381,1454,924,431
060014507442,1534,934,600,1575,962,613,1876,1320,520,1538,969,471
060014506042,766,479,287,786,498,288,973,668,278,877,554,261
060014506043,433,269,164,444,279,165,552,383,160,469,295,142
060014507451,828,546,282,857,552,305,1367,954,385,1113,767,285
060014507452,789,468,321,809,484,325,786,546,222,838,550,239
060014507453,624,388,236,642,399,243,829,576,234,727,482,201
060014506051,787,501,286,807,500,307,911,626,263,889,555,265
060014507462,354,230,124,367,236,131,454,310,134,404,261,117
060014506062,758,470,288,778,485,293,948,646,282,812,508,260
060014505011,627,388,239,647,387,260,747,509,227,702,430,219
060014505021,1173,714,459,1208,719,489,1590,1060,499,1292,786,403
060014505022,1161,822,339,1180,824,356,1750,1264,454,1295,879,326
060014504003,650,429,221,669,427,242,1046,719,303,489,313,143
060014505012,863,546,317,884,532,352,1066,751,292,953,587,301
060014504004,563,359,204,583,356,227,846,569,262,860,532,262
060014503001,848,581,267,877,594,283,1203,841,338,999,645,260
060014504001,622,375,247,644,372,272,862,577,266,813,484,266
060133451014,544,336,208,559,346,213,826,558,247,663,420,204
060014504002,583,388,195,594,392,202,742,495,231,671,416,206
060014502003,644,468,176,656,472,184,914,645,248,383,272,87
060014503003,768,525,243,791,535,256,1077,762,293,926,614,243
060014503002,284,206,78,288,208,80,325,238,82,389,271,88
060014502001,473,351,122,485,355,130,873,628,223,637,456,146
060014502002,613,441,172,626,438,188,923,687,215,1082,803,209
060014501021,549,407,142,564,414,150,1080,850,208,675,496,138
060014501012,674,497,177,692,512,180,1006,769,218,1696,1279,328
060014501011,636,491,145,642,499,143,1491,1169,296,370,278,70
060014501022,408,305,103,417,308,109,1168,889,257,488,363,103
060014507511,2430,1776,654,2513,1850,663,4291,3230,1010,1782,1345,373
060014507512,586,414,172,606,432,174,928,686,230,732,542,156
060014507522,1100,769,331,1146,810,336,1592,1169,393,1056,769,240
060014507502,694,528,166,721,542,179,963,719,229,1166,858,248
060014507501,271,204,67,281,206,75,440,336,96,379,276,80
060014401001,836,618,218,855,636,219,1210,895,287,1050,769,227
060014403371,1023,721,302,1051,750,301,1250,936,294,964,691,241
060014412004,540,411,129,558,416,142,841,632,195,617,473,114
060014403381,370,293,77,382,300,82,328,247,77,241,195,35
060014412005,566,423,143,581,424,157,810,607,186,608,447,128
060014403383,299,230,69,311,230,81,409,306,98,411,330,71
060014403362,766,589,177,788,598,190,1417,1057,332,989,779,163
060014413012,352,246,106,363,253,110,477,347,121,386,276,95
060014403361,420,319,101,430,331,99,704,525,170,539,419,86
060014403081,597,468,129,607,467,140,820,620,188,730,559,144
060014403084,349,275,74,354,271,83,455,342,104,802,620,153
060014402002,423,361,62,427,351,76,1249,965,270,614,516,72
060014403082,203,168,35,207,171,36,260,201,49,212,175,31
060014403083,475,392,83,485,400,85,705,547,132,590,486,84
060014403071,782,566,216,803,574,229,988,682,292,952,698,209
060014414021,741,552,189,762,570,192,1047,761,265,859,643,183
060014403072,355,278,77,366,282,84,692,519,163,382,304,65
060014403073,306,241,65,317,246,71,475,358,110,378,299,65
060014403042,505,387,118,514,402,112,780,584,180,579,459,98
060014403061,579,482,97,592,495,97,1009,756,239,801,675,97
060014403062,352,270,82,365,279,86,565,424,135,429,338,72
060014403041,299,233,66,306,235,71,487,371,109,404,330,57
060014403043,511,382,129,521,391,130,742,532,194,597,465,107
060014403312,309,258,51,319,266,53,578,437,129,288,240,34
060014415013,625,484,141,644,503,141,912,692,201,750,582,127
060014415011,614,474,140,631,492,139,924,706,204,697,540,119
060014403053,632,483,149,649,491,158,1001,750,240,747,563,147
060014415012,944,726,218,966,743,223,1461,1117,324,1124,896,195
060014415034,702,548,154,719,561,158,1304,993,292,682,528,121
060014402001,333,289,44,335,284,51,592,465,117,461,394,51
060014402003,355,311,44,353,301,52,535,429,104,481,409,48
060014402004,312,276,36,317,272,45,481,387,94,385,334,36
060014403012,615,486,129,623,491,132,934,714,203,859,695,127
060014403013,604,459,145,619,464,155,854,654,187,704,555,119
060014403011,497,391,106,504,396,108,750,570,169,491,400,73
060014403341,535,426,109,543,427,116,932,700,218,722,589,103
060014403342,731,585,146,746,584,162,1033,776,242,830,656,136
060014415223,570,428,142,597,442,155,885,660,212,685,519,142
060014403321,472,360,112,486,377,109,603,463,132,479,386,77
060014403322,649,493,156,668,511,157,1059,793,248,801,629,138
060014403332,379,283,96,390,296,94,603,452,139,478,375,84
060014403331,548,385,163,560,391,169,819,595,214,669,493,136
060014403311,448,374,74,460,385,75,740,567,163,792,658,94
060014403051,369,279,90,374,282,92,489,365,115,437,330,86
060014403052,355,276,79,360,277,83,476,356,113,433,329,86
060014415221,406,296,110,415,302,113,691,516,165,486,360,103
060014415211,531,414,117,542,420,122,834,643,179,606,483,94
060014415213,454,336,118,461,339,122,681,499,162,526,391,108
060014415214,339,250,89,346,253,93,401,297,96,392,292,79
060014415241,790,602,188,816,613,203,1260,975,265,942,740,155
060014415212,485,385,100,496,396,100,773,601,158,630,522,83
060014415242,148,112,36,152,114,38,224,174,46,185,145,30
060014415033,476,371,105,490,380,110,561,432,118,418,324,74
060014415231,186,145,41,190,149,41,289,225,60,261,208,40
060014415232,420,330,90,434,340,94,734,572,150,526,422,80
060014415233,128,100,28,133,104,29,180,140,38,160,128,25
060014415222,384,283,101,404,290,114,797,592,191,453,339,92
060014414022,522,368,154,536,375,161,1014,736,258,751,542,162
060014414023,388,257,131,402,254,148,523,383,132,476,318,130
060014414011,423,309,114,444,314,130,512,372,131,422,311,85
060014414012,498,364,134,520,370,150,775,566,200,607,447,122
060014414013,259,189,70,264,190,74,286,208,73,291,208,71
060014414015,444,336,108,460,351,109,842,613,215,552,429,100
060014414014,324,243,81,334,249,85,502,368,129,406,310,82
060014416013,416,299,117,425,303,122,585,426,151,513,377,106
060014413011,541,411,130,564,421,143,857,616,230,707,539,136
060014413021,437,299,138,450,302,148,604,441,152,512,346,139
060014413024,643,444,199,659,451,208,853,622,214,726,505,188
060014413022,352,248,104,363,252,111,491,359,123,420,298,103
060014413023,437,307,130,446,310,136,655,480,164,511,362,124
060014417022,610,451,159,622,465,157,727,518,198,721,531,151
060014418001,634,466,168,661,487,174,765,563,188,776,559,173
060014416011,252,179,73,260,183,77,349,254,89,299,216,66
060014416012,762,550,212,781,557,224,1072,777,275,958,702,200
060014416023,568,420,148,583,425,158,812,582,208,733,547,149
060014416021,595,410,185,606,423,183,954,689,243,763,544,177
060014416022,581,418,163,596,426,170,798,579,202,728,533,153
060014417011,440,331,109,456,350,106,1038,749,267,541,401,108
060014417021,360,276,84,368,282,86,548,399,141,478,356,92
060014417012,261,204,57,267,203,64,411,293,104,332,249,61
060014426021,431,298,133,449,300,149,610,441,155,511,356,125
060014426023,364,251,113,378,253,125,523,379,132,467,333,109
060014426022,668,441,227,689,458,231,886,643,229,775,525,206
060014418002,323,231,92,332,234,98,724,541,168,382,268,88
060014419234,209,148,61,215,152,63,335,238,88,281,199,64
060014426011,446,305,141,458,310,148,721,498,205,582,398,152
060014426012,734,497,237,753,493,260,985,696,269,921,603,258
060014427001,434,294,140,445,296,149,520,361,147,494,332,130
060014427002,335,223,112,353,227,126,459,320,129,409,271,114
060014427003,390,260,130,408,265,143,551,385,154,469,312,128
060014425022,423,299,124,433,299,134,623,432,172,520,383,115
060014425021,556,399,157,569,395,174,806,567,221,660,477,148
060014419261,425,332,93,440,341,99,681,494,178,517,402,87
060014419262,226,175,51,233,181,52,348,250,90,266,202,48
060014425011,446,331,115,460,335,125,646,463,169,590,435,111
060014425012,488,356,132,499,353,146,841,603,221,606,437,129
060014428001,905,652,253,923,665,258,1228,879,326,1105,792,253
060014424001,358,267,91,365,268,97,588,426,149,457,340,93
060014424002,495,369,126,506,372,134,762,551,193,627,463,129
060014424003,445,323,122,457,322,135,643,460,171,562,404,130
060014424004,478,348,130,490,347,143,691,499,182,578,418,130
060014429001,613,451,162,630,452,178,900,642,239,790,581,160
060014429003,504,351,153,513,348,165,766,536,210,645,435,159
060014429004,258,196,62,264,196,68,431,308,115,340,257,66
060014429002,623,436,187,632,426,206,942,648,272,827,565,196
060014423011,492,342,150,502,347,155,686,492,174,592,427,137
060014423012,213,153,60,218,156,62,323,235,82,264,195,54
060014423023,413,288,125,423,293,130,733,530,186,488,354,111
060014430022,548,386,162,564,385,179,853,587,249,727,518,174
060014430023,762,540,222,772,536,236,1186,822,344,873,620,200
060014430021,361,252,109,370,249,121,601,412,174,439,313,108
060014422004,542,379,163,562,396,166,695,492,188,607,437,137
060014423013,415,315,100,426,319,107,751,555,184,531,380,124
060014423022,567,417,150,584,430,154,942,689,235,665,516,112
060014423021,251,190,61,259,195,64,402,299,96,318,248,53
060014430011,444,319,125,456,315,141,712,510,188,564,412,116
060014430012,308,221,87,316,218,98,465,330,123,425,309,87
060014412002,296,219,77,305,220,85,394,293,90,341,243,76
060014412003,784,578,206,807,581,226,995,738,233,961,679,214
060014412001,399,293,106,414,297,117,493,370,116,446,315,103
060014411001,997,738,259,1031,746,285,1285,955,304,1155,828,253
060014411002,826,621,205,854,629,225,1075,804,248,962,709,198
060014419281,14,10,4,15,13,2,239,180,54,122,94,22
060014418003,609,432,177,615,428,187,779,589,179,729,507,169
060014419232,226,173,53,236,181,55,408,303,93,284,210,55
060014418004,354,267,87,355,269,86,447,343,91,399,294,82
060014419245,485,368,117,501,374,127,764,580,172,568,428,106
060014419243,263,199,64,264,201,63,484,372,101,293,218,53
060014419231,146,113,33,154,120,34,297,222,68,208,157,38
060014419233,118,92,26,123,96,27,219,165,49,169,127,31
060014419271,508,401,107,520,406,114,521,400,108,335,262,54
060014419272,52,42,10,53,42,11,68,53,15,66,53,10
060014419242,655,491,164,669,482,187,842,625,196,783,587,141
060014419244,30,22,8,31,23,8,182,136,41,31,22,7
060014419241,433,338,95,448,342,106,570,441,121,539,412,88
060014419211,437,338,99,448,344,104,507,376,124,418,322,69
060014419212,396,308,88,408,312,96,1190,892,275,944,733,156
060014419291,478,400,78,490,398,92,203,155,42,547,423,87
060014419282,270,226,44,277,223,54,1033,800,216,357,277,58
060014419292,90,75,15,92,75,17,168,128,35,120,93,19
060014421003,382,274,108,397,288,109,560,380,175,468,345,106
060014420001,1051,716,335,1079,743,336,1473,1100,340,1119,833,236
060014421001,936,619,317,971,631,340,1395,1023,338,1088,751,275
060014421002,655,438,217,685,469,216,881,645,212,748,548,159
060014422002,861,520,341,899,536,363,1069,762,286,979,660,271
060014420002,416,273,143,427,278,149,611,461,140,496,373,106
060014422003,682,451,231,710,480,230,1009,708,282,793,559,187
060014422001,613,417,196,629,430,199,975,686,272,730,540,165
060014431044,385,272,113,397,278,119,1125,812,293,460,343,93
060014431041,779,544,235,802,551,251,917,674,227,844,618,190
060014431043,407,281,126,418,281,137,606,442,156,521,376,123
060014431051,765,546,219,782,560,222,1155,859,276,918,699,180
060014431033,444,314,130,453,317,136,698,510,175,518,390,108
060014431042,316,221,95,324,222,102,499,365,127,388,283,83
060014431052,977,700,277,1009,724,285,1483,1104,352,1137,858,233
060014431024,468,352,116,492,369,123,672,499,165,539,423,92
060014431021,550,385,165,573,398,175,835,616,203,648,484,136
060014431032,590,450,140,608,458,150,929,675,237,716,564,126
060014431031,660,496,164,677,508,169,1052,779,252,807,628,150
060014431023,457,313,144,478,314,164,713,515,188,537,394,122
060014431022,365,255,110,381,259,122,564,418,138,452,330,103
060014432001,1121,751,370,1160,771,389,1659,1203,432,1320,955,312
060014415252,0,0,0,0,0,0,160,116,41,2,2,0
060014415251,86,59,27,90,60,30,214,151,59,121,89,26
060014433211,280,191,89,283,191,92,264,182,79,364,269,75
060014433212,183,125,58,185,125,60,295,201,88,217,161,45
060014433221,526,342,184,538,345,193,1118,767,333,637,448,151
060014433011,556,363,193,574,372,202,775,547,220,711,494,182
060014432002,409,256,153,421,268,153,593,432,155,518,360,133
060014433013,243,168,75,250,173,77,400,283,110,293,210,69
060014433222,364,231,133,377,234,143,539,369,161,457,313,118
060014446011,790,559,231,810,563,247,1067,777,268,1007,733,214
060014446012,965,702,263,981,693,288,1201,883,299,1073,787,231
060014446022,396,297,99,404,293,111,949,698,235,474,347,96
060014446021,697,540,157,716,548,168,1324,969,322,870,656,160
060014441001,1147,835,312,1167,834,333,1514,1100,387,1333,958,294
060014445001,207,150,57,211,151,60,302,226,73,286,213,60
060014445002,453,333,120,465,337,128,780,578,192,566,426,121
060014445003,379,292,87,388,294,94,643,469,159,510,387,96
060014443041,558,433,125,583,436,147,707,536,161,524,409,86
060014445004,338,267,71,347,268,79,647,472,164,549,419,99
060014443042,640,476,164,662,486,176,1634,1233,372,790,606,147
060014443011,553,403,150,568,408,160,797,601,183,691,500,157
060014443012,730,538,192,749,548,201,1004,756,227,883,653,188
060014442002,762,571,191,784,568,216,1161,852,292,996,743,200
060014442003,780,565,215,794,575,219,1160,826,312,954,689,216
060014441002,710,498,212,718,493,225,894,639,238,838,577,206
060014441004,507,342,165,529,352,177,712,509,191,599,403,154
060014441003,516,384,132,530,387,143,865,632,222,650,480,139
060014444001,367,272,95,370,267,103,527,389,132,439,323,91
060014442001,477,359,118,494,361,133,654,474,167,612,447,124
060014444002,463,367,96,468,367,101,759,556,190,616,466,123
060014444003,361,285,76,362,283,79,583,428,146,452,343,88
060014351031,495,312,183,508,319,189,639,428,199,540,337,173
060014506011,286,184,102,294,178,116,463,296,146,401,244,126
060014035013,233,223,10,239,225,14,313,290,13,269,247,7
060014034021,67,59,8,69,60,9,72,62,6,65,56,6
060019819001,28,27,1,28,28,0,36,34,2,31,31,0
060014074003,85,77,8,87,75,12,170,154,14,130,117,8
060014337003,121,97,24,130,103,27,245,197,48,196,159,24
060014330004,291,208,83,303,217,86,386,272,106,340,246,77
060014362001,225,195,30,230,201,29,310,233,69,282,246,23
060014511043,617,277,340,625,274,351,600,248,339,580,230,313
060133040021,374,143,231,389,128,261,656,262,386,449,176,248
060014443031,3,2,1,3,2,1,4,2,1,2,1,1
060133211032,1133,709,424,1162,727,435,1290,860,395,1197,743,380
060133470002,1315,818,497,1347,828,519,1623,1119,479,1320,859,367
060133560022,1072,853,219,1117,881,236,1673,1337,313,1260,1008,197
060133592022,1237,861,376,1271,864,407,1504,1087,393,1316,922,334
060133480003,1014,683,331,1048,711,337,1282,961,291,1082,746,264
060133342001,942,583,359,963,589,374,1142,781,347,1050,656,338
060133342002,546,291,255,568,307,261,798,488,296,613,352,219
060133452041,1103,590,513,1143,617,526,1509,927,539,1221,704,435
060133452042,868,425,443,906,446,460,1059,578,470,969,467,444
060133461011,1292,802,490,1341,824,517,1650,1139,469,1464,937,423
060133461012,647,379,268,670,389,281,808,542,245,689,423,225
060133461021,1110,555,555,1135,554,581,1278,760,494,1173,617,476
060133461022,908,446,462,933,446,487,1131,665,441,939,497,376
060133461024,662,314,348,687,313,374,1061,588,455,695,353,293
060133461023,386,171,215,400,189,211,462,260,194,478,236,218
060133462052,843,389,454,868,417,451,984,576,384,812,418,348
060133342006,597,410,187,613,417,196,768,555,201,632,441,154
060133342003,669,461,208,699,473,226,843,631,201,777,560,169
060133462051,1331,663,668,1378,695,683,1780,1016,727,1497,792,610
060133462061,784,378,406,816,395,421,961,517,420,772,388,326
060133050003,219,162,57,229,168,61,334,237,90,230,161,62
060133050004,311,209,102,318,207,111,775,575,185,549,411,105
060133072011,454,304,150,466,316,150,788,552,218,573,396,142
060133131021,607,499,108,633,515,118,1059,847,195,810,634,140
060133072012,183,126,57,188,130,58,337,242,86,238,168,57
060133050005,223,169,54,220,162,58,398,291,97,296,215,64
060133071021,117,89,28,120,87,33,219,160,51,157,111,35
060133072041,395,276,119,406,277,129,603,433,154,535,379,130
060133072042,275,190,85,283,189,94,400,280,107,323,227,79
060133072043,490,349,141,500,343,157,780,573,189,620,445,144
060133072052,504,361,143,516,360,156,807,602,191,607,439,138
060133072053,350,248,102,363,249,114,597,415,165,442,299,116
060133072054,465,288,177,481,298,183,859,594,248,577,369,178
060133131062,698,507,191,712,498,214,1195,866,297,870,600,226
060133551181,752,571,181,783,587,196,1273,1010,244,926,720,159
060133551201,758,557,201,787,578,209,1271,959,298,1092,827,217
060133551092,351,245,106,358,247,111,527,380,140,433,301,108
060133551073,558,382,176,569,394,175,907,640,247,660,477,151
060133551072,557,339,218,572,346,226,825,530,274,674,424,217
060133551071,824,460,364,843,466,377,1115,702,376,589,316,241
060133551182,751,515,236,762,526,236,1060,736,305,826,585,211
060133071011,484,308,176,510,325,185,708,479,206,607,397,177
060133071012,301,192,109,316,197,119,450,300,142,368,231,117
060133080011,473,295,178,483,292,191,810,535,259,599,359,204
060133071013,519,329,190,543,335,208,787,518,254,648,396,214
060133071024,403,265,138,414,265,149,762,533,214,636,432,170
060133050002,214,153,61,224,155,69,349,235,98,239,166,56
060133071023,241,166,75,247,159,88,453,302,134,296,218,63
060133050001,216,163,53,227,169,58,344,240,95,274,183,75
060133060032,389,265,124,403,265,138,633,430,182,463,301,130
060133060031,386,259,127,401,262,139,561,404,150,484,323,130
060133060033,432,272,160,449,278,171,667,452,205,560,346,180
060133080013,520,320,200,531,315,216,803,527,265,640,376,221
060133080014,412,261,151,422,254,168,658,425,221,517,310,179
060133080012,857,551,306,874,539,335,1222,794,401,958,596,300
060133551091,437,287,150,445,291,154,662,438,212,876,555,272
060133551094,617,453,164,635,460,175,1018,753,243,645,460,157
060133551192,750,562,188,763,555,208,1024,759,238,859,652,157
060133551191,679,535,144,689,537,152,1132,909,209,871,704,146
060133032071,856,647,209,879,660,219,1299,969,295,952,692,205
060133551093,936,672,264,958,675,283,1377,1001,344,1098,776,271
060133060021,489,316,173,500,319,181,661,423,226,572,366,174
060133060041,510,341,169,534,357,177,786,553,209,669,463,178
060133060022,469,307,162,480,308,172,1207,775,405,610,405,169
060133060042,311,204,107,319,205,114,539,353,172,379,238,119
060133020132,339,172,167,348,170,178,445,231,201,341,180,144
060133080021,566,420,146,575,420,155,1150,856,275,752,537,180
060133080023,253,184,69,260,184,76,451,326,117,341,235,86
060133080022,680,443,237,693,439,254,1043,697,323,827,535,250
060133020094,949,692,257,977,706,271,1310,984,298,1043,757,236
060133551113,516,387,129,533,397,136,872,672,190,634,467,147
060133551112,609,437,172,623,442,181,1045,789,242,748,546,164
060133551111,713,528,185,733,546,187,1166,860,282,879,636,195
060133551101,698,491,207,719,495,224,1119,797,302,880,622,196
060133551102,521,392,129,532,398,134,859,656,183,659,473,146
060133020093,386,281,105,398,291,107,566,414,141,480,348,107
060133020092,372,257,115,377,251,126,666,465,193,421,297,107
060133020091,566,409,157,580,402,178,961,721,223,729,521,174
060133551202,430,336,94,446,342,104,651,480,160,542,419,101
060133032073,402,273,129,411,273,138,609,438,158,520,346,148
060133032072,431,340,91,457,358,99,1012,766,220,613,474,109
060133072051,331,238,93,342,245,97,474,343,116,342,244,80
060133072021,221,183,38,231,190,41,420,350,62,318,240,58
060133072023,195,162,33,205,170,35,148,122,22,98,73,18
060133071022,180,133,47,183,136,47,347,260,79,236,172,51
060133072022,121,89,32,122,91,31,180,144,30,153,111,31
060133331011,431,234,197,449,237,212,614,347,253,494,258,201
060133331021,649,356,293,676,364,312,911,575,322,677,378,263
060133141031,287,222,65,293,225,68,505,378,110,437,347,61
060133142002,473,357,116,486,366,120,924,695,202,589,426,131
060133141032,333,258,75,343,262,81,562,419,123,456,362,63
060133141021,552,441,111,564,448,116,1097,850,218,708,561,113
060133141022,296,239,57,305,245,60,503,392,100,349,280,54
060133141062,166,124,42,169,129,40,305,238,59,210,160,41
060133141033,225,180,45,233,180,53,456,351,95,255,206,37
060133141061,296,235,61,299,232,67,545,413,117,388,301,57
060133141052,366,294,72,384,313,71,664,527,120,541,439,72
060133141051,538,411,127,564,424,140,543,419,111,393,319,53
060133142001,270,208,62,282,214,68,453,356,84,301,227,58
060133150002,865,611,254,887,632,255,1303,929,348,1048,754,249
060133142003,323,244,79,330,238,92,583,425,146,386,287,78
060133132031,625,445,180,633,457,176,396,290,97,748,564,158
060133010001,456,206,250,477,205,272,559,238,306,536,230,274
060133010002,265,119,146,276,119,157,444,208,232,310,134,161
060133010004,541,299,242,560,294,266,969,534,408,697,357,296
060133010003,379,211,168,385,206,179,526,302,210,437,229,179
060133040012,784,439,345,797,442,355,1055,623,409,1316,719,537
060133040011,1100,631,469,1134,632,502,1706,1049,630,748,430,292
060133462043,939,476,463,972,492,480,1227,744,460,1005,559,385
060133551123,1411,629,782,1455,658,797,1856,988,840,1557,742,730
060133551122,654,283,371,674,302,372,893,479,406,736,351,348
060133462042,1061,533,528,1098,563,535,1538,939,578,1199,652,472
060133551131,871,475,396,905,489,416,1179,773,387,1048,593,384
060133551132,749,425,324,774,439,335,1121,706,406,862,498,312
060133551222,964,615,349,991,627,364,450,293,149,321,207,101
060133551121,722,298,424,749,301,448,1015,452,539,805,332,415
060133551133,633,323,310,652,331,321,928,545,370,748,388,317
060133551223,725,447,278,745,461,284,2453,1658,751,1598,1018,504
060133031042,1272,715,557,1305,722,583,1975,1187,749,1382,790,530
060133020141,919,489,430,941,472,469,1489,770,683,1114,585,461
060133032091,797,478,319,817,480,337,1690,1055,605,765,466,252
060133032023,1075,557,518,1106,562,544,1532,815,673,1485,775,617
060133032092,432,253,179,442,253,189,762,470,277,533,331,173
060133031041,822,441,381,854,437,417,1297,707,568,954,545,363
060133031051,772,446,326,799,450,349,1855,1107,692,986,581,342
060133031061,720,304,416,738,295,443,1036,453,557,823,353,417
060133031063,771,472,299,789,450,339,425,254,160,707,418,246
060133032081,515,262,253,532,268,264,706,380,310,621,313,266
060133031062,367,238,129,378,236,142,1650,1029,585,449,285,137
060133032082,1202,587,615,1245,601,644,2074,1112,921,1391,668,649
060133032022,989,518,471,1013,505,508,1508,817,652,1191,609,504
060133032021,1091,622,469,1125,636,489,1980,1161,765,945,507,375
060133031073,352,219,133,364,213,151,531,317,199,365,234,108
060133031071,436,280,156,449,280,169,592,398,185,511,331,152
060133032062,699,383,316,722,375,347,1083,634,431,795,429,326
060133032061,980,520,460,1017,516,501,1055,607,429,1162,612,497
060133032043,656,338,318,675,338,337,1116,582,502,785,379,341
060133032041,451,252,199,465,241,224,643,384,248,512,261,219
060133032042,283,159,124,293,152,141,443,224,212,441,224,187
060133031074,688,353,335,703,332,371,1142,598,515,822,407,359
060133031072,484,290,194,498,281,217,968,596,354,633,321,277
060133032102,1727,905,822,1774,906,868,2238,1352,855,1519,804,669
060133032101,1297,634,663,1347,652,695,1697,926,752,1448,728,656
060133032111,1138,576,562,1169,566,603,1681,874,760,1182,568,525
060133032112,635,343,292,646,339,307,1046,570,451,805,414,330
060133211031,1140,758,382,1172,774,398,1447,1065,354,1238,811,338
060133470001,1449,937,512,1491,954,537,1781,1292,450,1525,1046,380
060133470003,738,474,264,757,476,281,1078,771,288,825,536,227
060133260001,1253,852,401,1293,876,417,1561,1138,389,1369,942,345
060133400033,1069,755,314,1103,778,325,1244,938,281,1120,798,265
060133400031,513,360,153,527,361,166,631,459,154,565,380,140
060133553061,595,298,297,623,307,316,641,350,279,652,324,276
060133040072,380,160,220,400,162,238,620,297,307,505,214,264
060133040073,654,312,342,673,310,363,802,400,381,759,335,376
060133530012,943,713,230,967,725,242,1045,875,153,943,726,164
060133383022,683,405,278,700,411,289,880,572,284,730,454,236
060133553023,807,503,304,834,522,312,1070,762,294,874,586,244
060133553071,1079,614,465,1120,619,501,1436,914,502,1208,708,434
060133553082,676,379,297,696,387,309,889,568,305,726,422,268
060133553072,1005,620,385,1036,642,394,1481,995,461,1136,692,369
060133553102,594,378,216,607,385,222,956,627,302,768,476,244
060133553101,677,468,209,695,465,230,1006,706,276,782,505,211
060133553083,517,267,250,537,265,272,714,409,278,580,305,227
060133553062,558,299,259,585,306,279,721,420,279,611,329,236
060133553091,718,384,334,749,390,359,935,548,363,733,393,300
060133553063,974,538,436,1015,556,459,323,194,120,1133,634,433
060133553065,352,181,171,371,188,183,465,265,190,376,196,156
060133553081,624,292,332,652,299,353,801,436,351,673,320,307
060133553064,229,125,104,237,130,107,1298,794,479,232,130,89
060133150001,310,188,122,329,197,132,456,304,141,362,207,126
060133270011,445,323,122,455,322,133,644,460,161,542,387,121
060133270022,217,162,55,225,164,61,355,264,82,267,183,58
060133270023,363,272,91,377,274,103,566,420,129,432,299,94
060133270021,644,460,184,663,468,195,1018,723,267,788,520,208
060133290001,696,451,245,724,466,258,998,673,294,803,533,223
060133290002,577,374,203,597,382,215,815,560,236,673,443,189
060133290003,377,281,96,390,281,109,579,442,121,502,351,113
060133290004,474,350,124,490,364,126,887,663,205,558,392,126
060133300001,409,288,121,420,287,133,611,426,160,501,349,120
060133552022,156,112,44,159,115,44,287,211,73,200,150,43
060133300002,676,471,205,693,468,225,935,652,254,768,534,186
060133300004,633,474,159,661,477,184,899,685,194,687,479,152
060133300003,385,265,120,401,266,135,598,416,172,418,286,102
060133280001,290,216,74,301,230,71,423,317,97,328,230,74
060133310002,588,379,209,609,388,221,794,520,249,695,437,206
060133310003,260,170,90,266,175,91,373,243,117,318,200,90
060133310005,519,351,168,536,373,163,769,534,211,609,405,159
060133310001,240,152,88,244,155,89,359,236,113,299,191,87
060133320005,331,206,125,344,212,132,433,279,145,386,244,117
060133320007,228,148,80,231,148,83,340,233,102,266,174,74
060133320001,806,511,295,832,517,315,1093,710,355,914,577,283
060133320006,310,209,101,319,208,111,475,319,143,316,211,84
060133320002,409,255,154,426,260,166,612,389,205,486,313,142
060133320003,448,282,166,461,291,170,597,401,184,519,332,156
060133320004,571,360,211,591,372,219,786,520,244,672,429,203
060133270012,589,383,206,621,388,233,929,628,284,588,356,191
060133280002,333,261,72,345,267,78,374,288,78,532,397,102
060133361031,362,269,93,376,272,104,807,598,182,447,331,91
060133361032,154,118,36,157,118,39,286,233,46,206,151,43
060133361041,109,84,25,111,84,27,194,158,31,133,97,27
060133361042,229,180,49,238,184,54,406,328,66,301,225,56
060133362012,247,183,64,255,184,71,396,284,100,288,213,59
060133362023,158,121,37,167,124,43,290,215,67,198,151,36
060133361011,224,181,43,232,187,45,367,297,61,268,209,42
060133361012,294,238,56,305,246,59,485,391,86,350,272,56
060133361013,137,110,27,143,115,28,258,208,45,181,142,28
060133350002,518,363,155,539,370,169,509,345,150,590,404,150
060133350003,257,191,66,265,198,67,387,281,103,298,221,61
060133371002,717,418,299,743,438,305,1129,736,364,763,458,264
060133310006,357,245,112,375,267,108,534,387,136,407,279,101
060133310004,456,293,163,482,298,184,656,435,206,535,333,169
060133332005,584,413,171,603,413,190,828,586,221,683,454,172
060133332004,566,359,207,592,362,230,764,505,236,631,391,198
060133350001,607,393,214,632,387,245,799,523,260,635,388,209
060133340011,786,501,285,810,516,294,1274,865,383,947,597,285
060133340012,631,409,222,649,423,226,968,645,295,749,478,221
060133371001,762,464,298,790,475,315,986,666,307,1001,628,316
060133332001,413,265,148,433,269,164,548,370,161,467,292,150
060133332002,486,302,184,510,309,201,688,454,217,577,357,190
060133332003,538,335,203,561,344,217,721,477,225,637,395,205
060133340071,321,227,94,334,235,99,368,267,89,284,199,71
060133340072,488,350,138,506,360,146,847,622,200,678,472,160
060133340073,635,418,217,646,429,217,762,531,213,717,473,202
060133340061,427,282,145,433,281,152,601,416,173,486,319,135
060133331012,744,477,267,768,478,290,1007,651,328,881,558,262
060133331013,459,304,155,474,309,165,658,437,207,567,351,184
060133132042,554,357,197,571,360,211,792,552,222,683,456,186
060133331022,370,243,127,385,246,139,512,302,197,477,303,141
060133331023,622,410,212,644,412,232,872,616,240,701,445,208
060133340081,511,383,128,524,376,148,766,563,187,615,430,135
060133340082,760,526,234,786,537,249,1158,823,308,922,631,232
060133340062,1207,826,381,1244,846,398,1475,1063,381,1313,912,334
060133373004,441,276,165,453,281,172,696,458,230,476,310,141
060133373005,380,237,143,387,242,145,492,346,131,404,273,113
060133340063,540,372,168,558,383,175,880,645,220,598,419,149
060133553092,695,456,239,721,466,255,999,672,308,762,490,225
060133362011,452,342,110,468,348,120,714,534,166,566,424,112
060133362013,145,112,33,151,114,37,267,202,60,177,138,29
060133362022,101,78,23,106,79,27,199,150,46,170,132,30
060133362021,327,243,84,336,244,92,536,389,127,365,263,84
060133372021,225,137,88,232,145,87,263,179,79,234,149,70
060133372023,258,158,100,261,164,97,371,251,113,313,201,95
060133372022,596,382,214,616,391,225,778,523,238,680,443,199
060133372011,406,278,128,412,281,131,580,397,171,466,309,127
060133372012,508,351,157,517,355,162,672,487,164,583,388,156
060133381012,280,186,94,290,191,99,398,281,108,318,206,87
060133381014,227,181,46,235,182,53,335,262,64,272,199,55
060133381022,1173,780,393,1211,797,414,1604,1125,450,1312,853,375
060133381021,430,290,140,449,303,146,523,365,149,465,312,125
060133240042,508,385,123,523,390,133,746,539,182,553,400,115
060133372024,640,434,206,656,431,225,942,664,250,726,473,206
060133382011,997,655,342,1029,656,373,1278,850,403,1096,717,326
060133382012,902,578,324,933,583,350,1119,756,328,924,587,282
060133373002,634,404,230,655,418,237,865,606,229,638,422,177
060133553093,918,562,356,934,544,390,1168,762,377,953,573,317
060133381011,265,200,65,278,205,73,377,280,90,288,213,57
060133381013,389,302,87,400,304,96,602,462,126,468,344,93
060133373003,349,218,131,355,221,134,439,301,129,454,291,142
060133240023,703,523,180,725,537,188,1023,792,208,723,511,164
060133570002,618,469,149,631,473,158,748,567,161,651,464,136
060133570003,520,393,127,534,399,135,654,501,143,541,392,110
060133570001,415,311,104,419,313,106,592,436,139,465,329,96
060133580005,222,167,55,229,169,60,339,256,75,281,207,58
060133462062,1165,552,613,1191,580,611,1697,957,706,1237,644,516
060133551221,775,457,318,798,472,326,1071,698,348,913,559,303
060133551212,862,516,346,894,549,345,1250,855,379,996,636,314
060133452033,456,241,215,472,252,220,623,357,252,583,314,230
060133452034,965,535,430,1007,565,442,1325,810,487,1061,619,384
060133452031,1341,710,631,1396,738,658,1927,1135,750,1536,854,583
060133452032,601,323,278,623,332,291,826,489,325,615,348,229
060133462031,1460,803,657,1519,843,676,1896,1166,681,1591,923,579
060133462041,1265,729,536,1315,737,578,1753,1146,565,1447,851,505
060133462044,349,209,140,364,219,145,460,309,140,396,254,123
060133451143,1323,773,550,1374,800,574,1871,1253,581,1491,911,491
060133451132,1407,781,626,1451,802,649,1688,1072,581,1550,948,511
060133452051,630,386,244,649,402,247,750,511,223,706,435,229
060133451052,672,417,255,698,432,266,893,608,266,734,469,213
060133451053,490,285,205,509,287,222,699,446,241,531,306,189
060133451054,600,350,250,635,365,270,775,502,252,629,373,213
060133451144,348,214,134,365,224,141,467,327,134,380,247,112
060133451131,850,530,320,873,538,335,1252,860,377,909,585,283
060133451055,281,176,105,291,175,116,644,425,208,315,191,106
060133451051,996,623,373,1033,630,403,1146,753,366,1229,758,391
060133451141,850,501,349,893,530,363,1283,862,399,947,588,307
060133451181,1161,691,470,1209,715,494,1479,957,493,1220,736,392
060133451142,804,451,353,828,457,371,1015,654,343,851,479,336
060133462032,631,336,295,655,350,305,786,476,300,653,369,252
060133040061,921,464,457,940,465,475,2004,1001,965,964,474,433
060133040071,549,247,302,563,239,324,773,352,407,540,224,281
060133040042,494,186,308,513,165,348,888,338,533,567,202,343
060133040032,928,329,599,959,325,634,1161,461,680,1014,377,581
060133040031,788,300,488,813,293,520,1060,445,604,871,313,529
060133040041,1097,417,680,1144,380,764,1582,602,950,1293,440,778
060133840004,517,472,45,522,476,46,541,500,38,540,474,33
060133840002,569,501,68,587,512,75,834,729,89,643,540,61
060133840003,716,655,61,729,667,62,879,801,62,747,658,45
060133840001,644,559,85,651,564,87,697,615,76,681,583,67
060133610002,779,643,136,798,655,143,949,759,166,890,717,124
060133851001,1053,901,152,1077,917,160,1314,1142,144,1127,956,113
060133852001,412,361,51,423,365,58,514,451,56,429,364,42
060133700003,346,302,44,349,302,47,516,458,52,383,324,40
060133860001,470,419,51,482,429,53,658,565,76,522,448,41
060133820001,286,255,31,298,273,25,415,379,29,404,373,14
060133820003,641,575,66,666,606,60,1044,956,69,911,843,26
060133830001,624,565,59,637,574,63,807,718,75,720,628,38
060133860002,385,345,40,392,351,41,497,437,49,461,400,33
060133870003,378,328,50,384,336,48,595,503,71,429,360,43
060133852002,358,316,42,369,321,48,366,320,39,332,279,34
060133851002,588,514,74,604,520,84,698,621,62,616,536,49
060133870001,456,408,48,465,408,57,579,521,49,511,446,33
060133870002,342,288,54,352,296,56,422,367,51,374,305,50
060133901001,468,415,53,477,418,59,564,507,46,484,424,32
060133901002,511,464,47,519,470,49,606,547,45,534,471,36
060133901003,417,378,39,420,380,40,500,455,39,426,374,31
060133902002,477,434,43,484,434,50,573,527,43,507,449,33
060133880002,739,678,61,756,697,59,867,786,68,727,641,48
060133891001,463,426,37,473,435,38,582,520,49,505,444,34
060133880001,604,557,47,620,577,43,771,701,60,660,581,40
060133902001,636,581,55,643,584,59,721,652,57,663,585,48
060133860003,337,307,30,347,316,31,419,374,38,361,318,23
060133830002,641,578,63,654,591,63,915,830,65,692,608,47
060133892001,187,162,25,192,170,22,282,243,34,239,209,18
060133630001,588,489,99,606,496,110,1007,816,174,697,560,99
060133690021,214,183,31,221,186,35,321,263,49,263,223,27
060133602001,631,515,116,644,526,118,1000,815,162,856,668,137
060133602002,460,375,85,468,381,87,672,547,114,540,424,84
060133602003,466,383,83,473,389,84,681,555,114,556,432,93
060133610001,288,233,55,293,240,53,432,338,87,323,252,52
060133610003,602,477,125,611,479,132,916,707,185,727,548,132
060133601011,494,396,98,509,402,107,795,624,161,593,452,108
060133601012,821,650,171,846,655,191,1098,855,222,902,682,171
060133601013,655,503,152,678,503,175,951,724,206,802,610,158
060133601021,977,758,219,997,756,241,1286,992,270,1104,847,194
060133601023,342,265,77,348,262,86,463,362,93,352,266,64
060133630002,874,683,191,903,698,205,1011,801,192,932,709,164
060133630003,746,613,133,762,635,127,1029,863,148,882,728,106
060133630004,400,293,107,414,298,116,583,436,135,469,335,103
060133620001,517,463,54,524,464,60,628,552,66,576,497,46
060133620002,605,551,54,613,555,58,727,653,59,562,489,43
060133620003,545,494,51,552,497,55,663,595,59,569,498,42
060133700001,656,578,78,664,586,78,792,696,79,718,613,64
060133700002,365,318,47,368,318,50,441,379,44,385,323,39
060133690022,358,304,54,357,305,52,459,396,52,409,339,39
060133690023,252,216,36,259,221,38,369,309,45,310,262,30
060133922021,379,319,60,382,324,58,680,559,101,458,393,45
060133922022,364,277,87,373,281,92,591,444,135,413,323,73
060133640021,868,704,164,903,726,177,1185,911,247,921,729,153
060133640022,423,317,106,441,327,114,661,523,133,483,379,79
060133591022,724,551,173,736,551,185,1199,910,263,945,725,179
060133640023,445,326,119,465,327,138,682,502,171,586,435,129
060133922023,526,382,144,551,390,161,775,550,209,657,477,142
060133591052,926,721,205,960,745,215,1335,1062,252,977,765,168
060133591051,989,766,223,1016,788,228,1334,1057,248,1045,823,177
060133591031,456,343,113,472,348,124,629,477,139,532,405,99
060133592033,1043,803,240,1064,812,252,1641,1224,390,1182,931,207
060133592032,548,443,105,569,455,114,906,749,144,673,566,70
060133592031,893,693,200,919,711,208,1305,1011,271,1061,848,176
060133592041,338,254,84,350,263,87,516,397,115,440,346,78
060133592042,500,377,123,516,387,129,752,574,170,616,483,109
060133592043,931,699,232,967,721,246,1434,1081,342,1197,935,209
060133591032,517,391,126,529,392,137,705,529,163,530,404,100
060133591041,736,610,126,759,650,109,1151,961,175,948,794,123
060133592021,920,677,243,949,686,263,1268,956,291,1014,759,221
060133923002,447,345,102,467,373,94,624,490,127,613,511,88
060133580001,471,332,139,501,346,155,719,524,174,550,397,125
060133580002,224,170,54,231,170,61,394,315,76,313,235,59
060133923001,377,292,85,393,316,77,1336,1043,282,600,493,90
060133560013,383,291,92,392,290,102,598,457,134,449,337,90
060133910001,529,469,60,535,469,66,670,603,59,579,506,42
060133920001,743,677,66,757,694,63,845,777,55,785,700,47
060133920003,408,373,35,413,377,36,489,451,31,448,403,24
060133920002,442,404,38,446,404,42,538,497,32,491,449,24
060133020112,566,323,243,576,315,261,1031,586,416,617,345,238
060133480002,1141,702,439,1204,746,458,1469,1089,348,1292,865,331
060133540021,1509,960,549,1567,1016,551,1781,1357,381,1602,1121,367
060133480001,407,274,133,420,286,134,525,386,129,455,319,109
060133400042,797,578,219,817,598,219,1214,931,256,834,614,174
060133400041,357,253,104,365,261,104,465,354,102,453,323,97
060133500002,551,390,161,570,404,166,450,350,96,574,432,114
060133500004,800,588,212,820,596,224,1266,996,234,954,728,174
060133530021,435,297,138,447,304,143,467,346,113,412,290,99
060133530022,805,571,234,825,591,234,1236,965,243,924,681,191
060133500001,802,627,175,822,639,183,900,711,169,874,678,138
060133410002,956,700,256,981,708,273,1165,907,233,1001,732,204
060133512001,727,514,213,747,525,222,910,716,172,785,586,155
060133512002,1333,939,394,1389,991,398,1523,1206,285,1404,1052,275
060133512003,1433,1004,429,1478,1030,448,1875,1467,362,1556,1127,317
060133490002,1062,774,288,1089,786,303,1204,940,239,1037,769,199
060133490003,563,430,133,583,435,148,733,579,138,610,454,109
060133490001,980,715,265,1014,735,279,1371,1049,285,1097,791,210
060133410003,927,702,225,947,711,236,1080,860,202,1004,755,190
060133521011,1416,933,483,1446,950,496,1654,1272,352,1492,1054,335
060133160001,365,289,76,379,298,81,470,360,98,426,321,77
060133180001,471,368,103,483,372,111,649,506,124,449,321,91
060133180002,474,349,125,484,362,122,682,494,172,518,357,121
060133180003,599,439,160,614,448,166,810,575,218,742,492,198
060133170001,533,399,134,545,399,146,718,519,183,567,404,122
060133190021,456,328,128,476,335,141,629,442,170,500,343,114
060133190024,246,163,83,251,165,86,351,233,115,286,171,89
060133190022,328,235,93,337,236,101,454,318,127,356,233,93
060133190023,721,469,252,739,474,265,996,661,313,847,528,259
060133190011,562,393,169,577,402,175,882,615,247,652,422,183
060133190012,791,506,285,812,518,294,1161,733,390,897,558,279
060133200031,1331,888,443,1363,895,468,1808,1232,531,1499,970,431
060133200044,1231,787,444,1275,796,479,1480,988,442,1349,836,411
060133200043,674,454,220,696,461,235,1116,780,305,661,433,175
060133200041,218,128,90,228,123,105,313,182,128,243,146,82
060133211011,846,583,263,865,600,265,1167,807,329,969,645,260
060133212001,633,426,207,655,439,216,859,579,256,771,493,227
060133211012,634,409,225,659,412,247,846,569,253,872,558,256
060133211013,827,553,274,838,555,283,1096,748,313,870,555,258
060133211014,670,423,247,684,422,262,830,531,274,689,436,207
060133211023,916,622,294,941,628,313,1146,800,328,963,645,263
060133211033,343,214,129,354,205,149,445,277,153,389,235,134
060133211021,718,497,221,742,496,246,911,662,224,776,525,198
060133211024,1139,826,313,1163,834,329,1410,1026,346,1176,816,283
060133200042,508,376,132,520,379,141,786,565,199,689,462,171
060133200011,637,420,217,668,427,241,708,434,247,754,484,221
060133170002,379,297,82,393,291,102,554,407,128,506,349,111
060133200012,666,419,247,689,419,270,1203,757,412,771,462,256
060133211022,1017,677,340,1056,688,368,1323,945,351,1010,690,256
060133500003,911,654,257,941,663,278,1068,823,212,918,662,193
060133522011,1067,774,293,1096,785,311,1431,1080,324,1170,825,275
060133522012,783,512,271,797,514,283,1103,837,245,785,545,190
060133522013,1322,934,388,1347,955,392,1630,1288,309,1426,1058,287
060133521023,1005,680,325,1027,688,339,1270,970,274,1055,749,236
060133521022,533,341,192,550,348,202,630,467,144,559,382,133
060133521024,483,306,177,499,312,187,570,416,138,494,335,119
060133521021,808,529,279,834,545,289,1053,785,244,944,649,237
060133451151,1114,652,462,1150,675,475,1308,873,410,1191,735,388
060133452061,493,299,194,508,302,206,702,468,228,564,355,172
060133650021,337,295,42,349,311,38,530,445,73,494,444,28
060133650022,165,154,11,174,161,13,379,334,30,208,193,9
060133650023,210,185,25,223,195,28,346,303,36,287,267,16
060133780001,869,768,101,891,785,106,1090,976,100,921,790,77
060133922011,416,352,64,428,361,67,677,562,103,543,472,52
060133020051,460,253,207,468,256,212,585,349,221,584,348,197
060133020062,824,471,353,856,467,389,1269,721,515,998,539,380
060133020131,816,446,370,847,452,395,1335,704,606,1018,555,403
060133020052,430,257,173,445,254,191,734,410,303,586,343,200
060133020061,413,238,175,426,229,197,656,372,266,500,275,198
060133020111,796,555,241,819,549,270,1659,1125,496,545,376,148
060133020053,510,307,203,517,295,222,831,502,311,674,404,224
060133020054,353,214,139,364,213,151,631,370,234,456,271,157
060133020072,551,343,208,561,339,222,951,581,347,756,465,244
060133020142,907,463,444,923,447,476,1440,706,695,1075,533,466
060133020073,486,254,232,493,243,250,775,393,364,573,316,223
060133020122,550,342,208,566,336,230,948,627,302,659,392,224
060133020121,661,387,274,685,391,294,1143,638,467,795,455,276
060133020143,527,266,261,540,248,292,854,488,351,609,291,272
060133020071,901,534,367,920,536,384,1385,841,521,1144,647,430
060133530011,794,567,227,816,586,230,1279,1025,231,947,705,177
060133530023,708,510,198,725,525,200,824,656,156,741,570,137
060133540023,1031,684,347,1055,705,350,1298,985,287,1279,919,288
060133540024,1038,694,344,1063,710,353,1351,1001,332,899,636,216
060133530024,418,288,130,430,291,139,528,410,101,438,324,93
060133540022,453,302,151,465,315,150,484,373,104,478,349,102
060133212002,339,243,96,351,249,102,522,381,127,403,277,101
060133212004,488,359,129,502,367,135,715,500,198,659,467,147
060133591023,665,546,119,688,554,134,1030,827,184,703,564,107
060133591021,395,290,105,408,301,107,456,345,104,442,322,97
060133591033,490,380,110,503,385,118,686,530,143,573,445,101
060133591034,460,367,93,477,374,103,658,529,119,562,441,92
060133592023,741,542,199,760,534,226,973,734,230,835,613,187
060133601022,783,629,154,808,632,176,1061,874,172,952,776,142
060133212003,227,162,65,238,165,73,363,257,93,259,180,61
060133220001,242,172,70,253,173,80,372,265,97,276,196,63
060133220002,291,203,88,301,204,97,437,295,128,317,223,73
060133220003,1144,786,358,1189,798,391,1428,1017,374,1278,868,317
060133220004,904,623,281,938,638,300,1234,882,327,1095,746,273
060133260002,611,412,199,630,418,212,753,542,192,693,451,190
060133230004,461,313,148,474,317,157,595,423,162,513,350,131
060133230002,531,358,173,546,358,188,691,486,189,583,381,156
060133230003,710,516,194,726,512,214,882,641,215,776,545,178
060133240021,887,664,223,907,668,239,1311,979,293,968,708,196
060133250004,605,431,174,622,434,188,746,564,171,624,452,134
060133250003,884,649,235,916,666,250,1130,852,254,946,680,201
060133250002,255,190,65,265,195,70,330,245,77,273,193,60
060133250005,408,288,120,419,291,128,491,373,112,429,313,91
060133250001,486,355,131,497,362,135,667,504,149,544,394,111
060133400011,368,272,96,382,271,111,480,354,116,409,291,89
060133230001,498,359,139,521,371,150,689,517,155,558,387,116
060133240022,438,326,112,454,329,125,584,439,133,495,350,105
060133220005,356,264,92,365,269,96,521,355,149,396,282,89
060133240041,248,181,67,254,181,73,372,264,93,259,183,56
060133240043,266,199,67,274,201,73,406,294,101,555,401,117
060133240033,98,74,24,101,74,27,77,56,19,73,52,17
060133552021,856,619,237,876,635,241,0,0,0,1057,775,234
060133552013,649,480,169,670,499,171,1859,1362,465,844,624,184
060133552011,477,350,127,491,351,140,2150,1525,581,527,386,116
060133552012,694,521,173,713,542,171,1167,895,261,902,689,179
060133132032,409,293,116,416,290,126,1121,821,273,463,342,95
060133132051,496,358,138,505,349,156,768,549,197,599,432,123
060133131053,333,277,56,343,292,51,726,613,102,525,443,63
060133120001,564,487,77,568,484,84,1092,927,144,702,604,70
060133132061,349,284,65,355,284,71,719,574,133,477,397,60
060133132064,261,214,47,268,215,53,498,401,88,289,241,35
060133132062,197,162,35,206,166,40,340,278,60,245,206,29
060133132063,385,311,74,396,309,87,654,511,126,486,390,73
060133132043,430,322,108,446,325,121,613,449,146,485,355,104
060133132041,498,400,98,513,397,116,719,554,153,624,478,116
060133131051,589,439,150,596,435,161,895,658,213,859,624,192
060133131041,428,311,117,443,314,129,610,446,152,494,366,110
060133131042,260,189,71,271,192,79,511,374,126,156,116,34
060133131052,438,317,121,455,326,129,590,437,148,527,389,116
060133131072,571,405,166,590,406,184,857,618,220,672,478,161
060133131061,893,668,225,919,680,239,1455,1092,334,1066,801,207
060133131071,372,269,103,386,277,109,593,438,145,450,336,90
060133131022,489,366,123,495,367,128,743,553,179,595,443,123
060133100003,341,289,52,352,290,62,466,386,70,470,387,52
060133110003,397,315,82,413,324,89,753,568,164,527,438,70
060133110002,339,284,55,352,281,71,597,477,104,442,365,63
060133100002,204,167,37,208,170,38,330,266,60,274,219,42
060133110001,206,168,38,209,169,40,359,284,68,193,153,31
060133090002,291,242,49,299,250,49,367,301,61,266,222,32
060133100001,331,290,41,334,284,50,489,397,73,385,311,49
060133090003,408,335,73,421,344,77,587,481,97,580,473,79
060133100004,273,215,58,282,224,58,290,234,53,314,258,45
060133090001,536,432,104,555,448,107,968,776,166,864,696,129
060133141023,491,376,115,505,391,114,758,596,152,603,478,103
060133780002,1185,1011,174,1203,1013,190,1447,1245,171,1224,1005,147
060133800021,386,347,39,393,356,37,644,586,50,470,430,23
060133800012,943,839,104,960,849,111,1362,1202,137,1062,911,87
060133800011,877,781,96,894,792,102,1106,978,112,786,676,64
060133820004,521,462,59,535,481,54,631,538,71,464,415,24
060133820002,527,469,58,553,503,50,750,687,53,648,599,22
060133810004,562,511,51,575,529,46,862,779,61,695,650,27
060133810001,348,314,34,363,327,36,538,482,39,429,398,19
060133810002,389,353,36,408,367,41,614,553,53,574,531,24
060133790001,335,301,34,349,318,31,457,412,40,381,355,10
060133800022,236,212,24,243,223,20,519,466,42,316,300,8
060133790002,279,254,25,288,262,26,454,421,31,348,331,8
060133790003,304,276,28,320,291,29,476,442,26,363,346,7
060133770004,354,317,37,369,332,37,573,506,62,448,400,26
060133790004,326,295,31,341,313,28,529,471,46,412,384,10
060133770005,413,367,46,426,384,42,561,482,61,347,299,24
060133770002,139,126,13,144,132,12,210,186,23,183,167,9
060133770003,209,188,21,213,196,17,295,262,27,223,207,6
060133760003,184,165,19,187,172,15,279,243,25,263,242,11
060133770001,174,157,17,178,161,17,282,248,29,290,262,17
060133810003,277,248,29,287,259,28,362,316,42,328,293,18
060133750002,123,112,11,125,113,12,342,306,31,190,172,10
060133750003,129,113,16,129,111,18,230,197,26,161,144,9
060133710003,335,294,41,346,299,47,495,425,52,382,326,39
060133710004,295,261,34,303,268,35,448,394,44,346,297,36
060133710005,261,233,28,265,237,28,382,343,37,318,280,25
060133710006,318,284,34,327,288,39,447,390,46,353,308,31
060133740001,425,381,44,433,387,46,589,519,54,493,432,33
060133740002,357,320,37,364,329,35,524,469,52,415,369,29
060133690011,301,259,42,309,271,38,422,360,55,350,310,25
060133710001,267,229,38,273,229,44,395,329,59,323,274,32
060133710002,220,190,30,225,189,36,322,263,50,289,246,28
060133720003,289,247,42,293,246,47,401,327,68,318,270,33
060133720002,282,239,43,287,238,49,490,422,63,385,327,41
060133720004,302,262,40,310,263,47,440,376,55,339,285,33
060133680013,182,165,17,189,167,22,299,259,35,215,192,12
060133720006,286,251,35,295,250,45,421,364,44,320,273,26
060133690013,210,183,27,218,184,34,330,274,53,281,241,24
060133690015,179,154,25,184,158,26,298,248,44,234,203,18
060133720007,212,186,26,221,186,35,288,236,46,218,193,19
060133720005,246,220,26,255,222,33,353,310,39,275,240,22
060133740004,368,329,39,380,338,42,525,471,44,426,367,31
060133730002,251,227,24,259,235,24,370,333,33,304,270,23
060133730003,181,166,15,188,171,17,317,278,30,218,196,14
060133760001,211,189,22,224,203,21,378,340,30,301,280,11
060133760002,254,225,29,266,240,26,566,507,48,444,406,20
060133760004,183,164,19,189,176,13,320,287,25,275,256,9
060139800001,39,33,6,41,34,7,66,54,12,19,17,2
060133922013,617,511,106,637,522,115,1076,843,220,714,609,79
060133650031,640,577,63,655,594,61,871,756,101,865,788,45
060133671004,388,349,39,410,366,44,596,521,64,450,404,24
060133650033,117,105,12,121,110,11,206,179,25,149,133,9
060133922012,202,182,20,209,191,18,338,292,41,280,248,19
060133671001,482,443,39,502,459,43,736,651,71,585,533,31
060133672001,408,350,58,408,349,59,759,636,111,539,455,59
060133740003,277,248,29,290,262,28,337,299,33,302,265,19
060133750001,209,186,23,217,184,33,417,360,47,253,228,14
060133720001,208,174,34,212,175,37,388,332,47,299,254,30
060133730001,370,329,41,381,325,56,579,508,63,439,389,31
060133671003,351,309,42,362,328,34,689,625,59,463,413,24
060133672002,541,464,77,559,485,74,796,656,123,573,490,57
060133650032,133,121,12,137,123,14,415,363,45,201,179,14
060133650034,260,237,23,269,242,27,463,405,50,385,342,26
060133671002,288,261,27,300,268,32,494,436,48,370,329,19
060133560011,351,254,97,358,259,99,552,401,144,435,310,104
060133560012,612,468,144,623,461,162,872,667,194,687,520,139
060133580003,295,206,89,313,214,99,487,352,121,362,260,87
060133580004,305,230,75,313,231,82,501,391,97,409,306,78
060133672003,193,162,31,193,161,32,336,279,53,257,216,30
060133410001,882,661,221,901,673,228,1251,984,247,994,724,207
060133342004,481,351,130,491,357,134,603,475,114,655,493,124
060133342005,423,315,108,433,318,115,530,429,91,459,352,83
060133400043,1011,739,272,1034,751,283,1125,864,233,1075,783,228
060133511043,405,296,109,414,300,114,451,352,95,416,293,107
060133511051,571,406,165,589,419,170,673,524,143,608,425,160
060133383023,1192,867,325,1207,878,329,1596,1220,349,1295,947,278
060133430022,794,531,263,817,542,275,1054,746,285,884,611,228
060133430021,997,717,280,1030,751,279,1308,1008,282,1133,806,263
060133430023,390,259,131,403,267,136,490,349,133,413,277,112
060133680011,149,135,14,151,135,16,279,238,34,170,156,9
060133680012,410,375,35,419,382,37,518,455,54,420,380,21
060133680014,189,170,19,193,173,20,329,289,40,224,203,12
060133680021,204,178,26,204,175,29,498,418,69,324,290,21
060133680022,136,119,17,138,117,21,413,347,58,288,256,18
060133690014,275,238,37,286,246,40,383,324,50,339,291,32
060133690012,301,259,42,314,274,40,531,456,68,391,341,35
060133660011,315,263,52,319,266,53,513,416,90,355,296,43
060133660012,610,522,88,624,529,95,1027,833,169,905,787,79
060133660023,521,451,70,534,453,81,927,773,143,715,631,59
060133660022,372,325,47,378,323,55,591,493,88,480,421,40
060133660021,213,190,23,216,185,31,356,300,49,222,199,17
060133452062,1008,654,354,1058,687,371,1402,976,393,1201,770,356
060133452052,576,389,187,602,410,192,822,587,217,692,459,190
060133452053,449,307,142,469,328,141,1077,799,259,544,366,144
060133451152,753,459,294,773,459,314,982,657,306,819,508,269
060133451161,597,368,229,622,385,237,806,555,235,683,430,210
060133451162,718,432,286,741,444,297,980,643,316,823,507,254
060133451153,720,451,269,745,458,287,1451,975,447,871,550,266
060133451173,782,486,296,812,501,311,1079,707,355,898,576,269
060133451122,518,349,169,530,354,176,653,465,183,559,376,156
060133551213,469,329,140,482,339,143,723,532,179,577,425,127
060133451182,627,419,208,641,426,215,758,516,227,739,479,217
060133451172,454,303,151,463,304,159,638,453,177,502,334,144
060133451124,1567,1070,497,1624,1101,523,1468,1042,390,2296,1674,515
060133451021,508,310,198,523,319,204,731,477,238,769,466,256
060133451022,800,450,350,824,467,357,896,564,306,793,474,264
060133451023,487,296,191,504,304,200,616,399,200,509,308,169
060133451111,615,373,242,641,388,253,1163,776,361,691,430,219
060133451113,442,252,190,463,260,203,569,364,188,487,293,165
060133451121,541,362,179,562,382,180,1021,757,247,483,324,137
060133451033,1090,632,458,1125,655,470,1425,901,501,1231,751,407
060133451013,477,271,206,497,276,221,633,395,222,516,307,182
060133451032,539,307,232,561,311,250,727,453,256,615,366,218
060133451011,356,220,136,366,224,142,464,310,146,454,285,138
060133451012,953,588,365,980,597,383,1316,879,412,1007,629,311
060133451031,526,336,190,550,353,197,722,499,208,610,399,178
060133451123,489,313,176,514,330,184,690,473,203,558,364,163
060133451034,258,162,96,265,169,96,379,260,115,307,199,95
060133451171,377,260,117,384,260,124,606,461,135,450,323,110
060133551261,373,268,105,385,280,105,953,738,196,650,494,134
060133551262,724,539,185,743,551,192,1686,1303,344,1193,916,234
060133551251,382,274,108,394,288,106,708,559,136,461,350,96
060133551242,647,467,180,665,486,179,1245,945,270,664,505,132
060133551231,396,289,107,408,303,105,764,579,174,341,262,63
060133551232,352,254,98,365,269,96,626,475,140,316,246,57
060133551241,310,238,72,322,243,79,566,460,100,408,323,73
060133551153,1003,764,239,1030,771,259,3268,2487,740,950,727,183
060133551151,487,357,130,502,371,131,419,303,110,312,237,61
060133451114,259,176,83,269,186,83,378,271,101,318,210,86
060133451112,224,152,72,233,161,72,353,256,94,275,181,76
060133551211,768,564,204,804,589,215,1146,884,246,621,483,118
060133551252,104,78,26,109,82,27,176,139,34,116,90,22
060133551152,172,129,43,174,128,46,302,235,62,193,152,34
060133551243,233,153,80,237,164,73,387,276,103,254,192,51
060133382034,467,358,109,480,364,116,636,498,125,530,393,97
060133382035,461,352,109,474,359,115,567,438,117,534,397,101
060133382033,404,294,110,406,294,112,506,388,108,450,333,87
060133382041,740,542,198,763,558,205,1084,817,249,850,613,196
060133240031,372,285,87,381,289,92,310,230,72,265,193,56
060133240032,346,266,80,356,270,86,956,731,209,399,292,83
060133382031,381,298,83,391,304,87,560,462,83,501,373,85
060133382032,293,203,90,299,211,88,407,290,109,382,269,87
060133511031,684,479,205,711,493,218,900,677,216,567,395,155
060133511032,827,569,258,856,586,270,973,733,233,862,594,246
060133400014,697,502,195,725,510,215,922,688,217,739,522,170
060133400032,382,272,110,392,271,121,565,419,132,444,309,104
060133511013,1052,695,357,1083,730,353,964,729,230,1170,803,333
060133511011,619,439,180,639,459,180,649,495,150,595,426,148
060133511012,638,451,187,658,472,186,961,733,221,641,460,159
060133430031,1331,880,451,1391,908,483,1758,1250,472,1447,976,395
060133390013,448,324,124,463,337,126,701,525,160,395,291,80
060133390031,674,488,186,696,506,190,1034,788,233,702,514,144
060133390041,861,644,217,878,660,218,1126,825,276,881,637,198
060133382042,491,350,141,501,360,141,670,496,170,605,434,133
060133430011,658,428,230,687,444,243,719,509,202,709,477,190
060133430013,697,526,171,723,547,176,948,719,213,819,598,172
060133430014,564,417,147,587,434,153,740,552,176,641,458,142
060133383021,1254,744,510,1317,778,539,1571,1079,466,1346,878,402
060133400012,828,584,244,862,603,259,1103,821,262,1021,733,222
060133400013,636,460,176,665,464,201,805,577,213,669,477,153
060133382044,722,501,221,738,510,228,1042,779,246,792,560,188
060133373006,551,349,202,569,357,212,711,520,177,630,394,199
060133373001,728,508,220,754,522,232,913,684,200,787,533,199
060133511041,489,358,131,498,363,135,542,423,114,521,367,135
060133511052,651,462,189,671,482,189,772,597,171,683,485,169
060133511042,544,389,155,559,410,149,654,503,148,584,426,133
060133390011,226,183,43,233,189,44,348,275,64,288,220,48
060133390012,425,343,82,440,356,84,653,513,122,528,403,88
060133430012,386,272,114,396,287,109,520,389,120,434,311,93
060133390032,530,420,110,540,426,114,850,670,164,671,530,95
060133430032,828,541,287,857,558,299,1072,767,281,901,615,224
060133383011,987,620,367,1024,634,390,1278,881,361,1036,656,302
060133553022,507,316,191,521,323,198,662,462,192,557,360,165
060133390042,355,262,93,363,268,95,663,493,157,406,293,92
060133553021,540,333,207,545,335,210,674,454,209,581,364,188
060133383012,622,404,218,636,401,235,776,550,213,707,459,216
060133382043,546,403,143,559,401,158,807,625,167,720,524,156
060490004001,244,89,155,247,82,165,137,46,88,252,74,157
060490003002,423,109,314,424,101,323,467,122,339,227,58,165
060490004002,181,58,123,181,53,128,477,149,320,242,67,167
060490003003,350,90,260,351,82,269,739,192,532,547,139,375
060490001001,581,111,470,590,104,486,272,66,203,640,116,498
060490001004,339,94,245,344,91,253,487,129,343,327,87,224
060490001002,297,87,210,301,78,223,312,102,204,361,85,257
060490001003,194,72,122,194,72,122,215,80,130,238,75,145
060490003001,182,52,130,185,49,136,467,94,366,185,44,133
060490002002,386,75,311,388,67,321,431,93,332,420,80,325
060490002001,241,48,193,243,41,202,334,77,252,319,52,250
060890115012,775,224,551,780,213,567,740,209,522,752,202,511
060890115022,502,123,379,512,111,401,665,175,475,578,130,412
060890119001,712,163,549,723,157,566,897,223,659,776,166,573
060890121011,365,117,248,364,111,253,518,160,343,444,126,285
060890121012,586,201,385,596,183,413,668,204,445,662,186,426
060890121021,335,83,252,339,80,259,416,111,297,378,89,271
060890121022,255,84,171,261,77,184,361,110,242,311,86,201
060890120001,302,83,219,305,72,233,450,137,303,356,86,246
060890120002,358,132,226,358,118,240,574,174,389,427,118,276
060890121013,566,157,409,574,137,437,814,256,538,696,176,468
060890123011,512,161,351,518,154,364,632,187,432,576,173,374
060890120003,213,75,138,216,68,148,642,195,433,234,66,151
060890120004,571,176,395,575,155,420,838,231,582,569,148,379
060890114011,659,208,451,662,192,470,882,285,569,657,179,433
060890114012,582,171,411,596,160,436,680,225,446,727,194,495
060890114022,613,187,426,619,171,448,834,283,533,696,187,469
060890114031,694,194,500,705,182,523,1155,340,786,828,193,580
060890114032,511,163,348,515,149,366,706,228,460,574,160,377
060890126062,668,248,420,671,235,436,847,301,522,754,232,445
060890126051,961,240,721,966,227,739,1345,396,928,1070,259,751
060890126041,362,109,253,366,102,264,419,122,292,385,103,261
060890126042,484,112,372,495,106,389,632,170,455,531,121,390
060890122001,693,159,534,696,144,552,926,215,693,843,173,634
060890123021,374,101,273,380,88,292,475,123,341,452,107,316
060890123032,611,143,468,620,133,487,827,196,614,731,156,541
060890118022,928,239,689,932,213,719,1194,306,869,890,196,654
060890118031,350,97,253,354,88,266,421,113,303,458,113,317
060890118032,459,130,329,465,119,346,581,172,397,514,129,356
060890118033,370,113,257,375,102,273,488,143,336,419,114,284
060890126061,920,306,614,928,290,638,1152,368,762,1001,262,656
060890118011,754,190,564,758,178,580,932,238,680,839,193,609
060890118012,495,119,376,498,116,382,618,154,456,555,128,399
060890115021,717,187,530,728,168,560,952,260,677,804,189,573
060890115011,561,132,429,566,125,441,729,185,530,625,135,456
060890119004,574,140,434,576,125,451,679,173,490,597,142,432
060890126034,334,92,242,336,84,252,421,111,300,359,85,255
060890110024,667,222,445,675,212,463,914,302,593,755,223,481
060890123012,305,90,215,310,87,223,414,118,283,376,109,242
060890101002,226,100,126,233,98,135,344,150,186,244,95,129
060890104001,266,119,147,266,115,151,413,176,226,342,124,192
060890104002,431,189,242,438,186,252,579,244,315,532,188,297
060890110012,455,135,320,461,132,329,591,195,382,490,134,319
060890126031,540,184,356,545,162,383,648,209,427,549,170,348
060890126033,377,116,261,377,101,276,499,143,347,403,112,273
060890104003,269,93,176,276,87,189,406,150,244,309,94,196
060890104004,515,177,338,527,167,360,661,247,398,592,180,379
060890111001,838,260,578,850,245,605,1106,355,722,881,250,576
060890111002,686,208,478,700,194,506,864,275,566,738,205,487
060890107021,908,354,554,923,338,585,1123,435,655,1056,371,620
060890107022,911,338,573,915,313,602,1112,411,670,1111,375,671
060890108061,736,225,511,750,213,537,989,322,643,871,260,570
060890116002,605,174,431,615,155,460,824,216,590,730,179,506
060890116003,288,89,199,289,81,208,424,135,279,321,93,210
060890127011,573,141,432,584,137,447,769,220,531,660,162,458
060890127012,282,72,210,285,71,214,403,115,275,333,85,228
060890127013,406,104,302,411,100,311,548,157,378,485,125,332
060890125001,358,156,202,356,140,216,451,188,256,382,149,213
060890106011,602,231,371,613,220,393,753,290,445,638,217,372
060890106024,709,264,445,722,250,472,903,336,544,778,281,441
060890106031,351,131,220,356,123,233,454,176,268,482,162,284
060890106032,361,131,230,364,121,243,411,149,252,468,155,279
060890110011,418,131,287,427,127,300,512,175,328,455,129,296
060890110021,540,175,365,548,168,380,704,236,451,615,187,381
060890124003,785,248,537,798,241,557,897,305,578,898,280,566
060890124001,399,154,245,409,147,262,526,203,313,504,177,291
060890123022,417,108,309,425,96,329,464,116,339,473,110,337
060890123023,631,169,462,631,146,485,922,250,654,786,186,558
060890123024,816,215,601,826,197,629,1044,268,757,881,204,629
060890124002,402,108,294,403,101,302,607,179,416,503,131,342
060890108041,541,155,386,553,151,402,723,221,483,614,173,405
060890108051,401,107,294,406,103,303,659,176,466,476,114,335
060890108052,710,213,497,721,191,530,983,340,623,778,209,514
060890108071,1162,286,876,1182,268,914,1542,426,1094,1337,314,961
060890118021,450,115,335,455,103,352,570,143,417,508,117,361
060890119002,544,131,413,550,126,424,669,172,485,578,132,420
060890122002,308,80,228,313,71,242,396,90,300,355,80,256
060890122003,490,108,382,497,105,392,678,161,501,579,119,432
060890122004,412,113,299,416,102,314,595,143,445,523,126,372
060890123031,908,187,721,927,182,745,1224,285,919,1095,224,831
060890110022,493,170,323,498,162,336,648,228,408,572,181,351
060890110023,308,104,204,311,98,213,443,151,280,330,103,203
060890127021,479,122,357,480,112,368,560,167,382,567,145,384
060890127022,325,82,243,328,76,252,400,120,273,380,101,257
060890127023,339,82,257,341,75,266,426,115,303,373,89,259
060890125002,317,123,194,318,115,203,409,144,254,335,109,210
060890108031,1015,310,705,1030,291,739,1490,487,973,1138,311,749
060890108032,253,83,170,258,75,183,420,136,271,315,90,200
060890108053,859,248,611,873,232,641,1041,337,675,937,239,643
060890103002,658,237,421,668,217,451,1070,397,653,822,257,502
060890108042,601,199,402,609,181,428,731,257,460,659,207,417
060890109001,621,213,408,628,204,424,874,311,536,748,243,458
060890109002,669,206,463,681,181,500,949,308,621,812,215,541
060890113001,282,108,174,291,102,189,425,161,253,366,114,225
060890113002,294,110,184,298,102,196,503,185,298,387,113,240
060890103001,551,196,355,555,183,372,757,283,458,629,186,395
060890112091,452,165,287,466,162,304,725,272,427,525,170,314
060890112092,382,129,253,388,121,267,581,204,355,456,136,275
060890112094,213,72,141,217,67,150,349,124,212,257,77,154
060890113003,429,134,295,433,128,305,610,201,393,562,151,369
060890112093,412,150,262,423,147,276,587,221,347,479,154,291
060890114013,513,148,365,521,137,384,663,220,429,535,141,369
060890113004,397,118,279,406,118,288,592,186,387,486,130,316
060890117011,177,62,115,181,57,124,346,117,220,217,65,139
060890107031,568,199,369,579,198,381,789,282,494,673,213,417
060890107032,622,236,386,634,222,412,907,323,565,796,249,484
060890127014,188,45,143,187,43,144,242,70,169,216,53,149
060890119003,652,145,507,657,139,518,678,173,492,720,161,522
060890106023,819,322,497,831,304,527,1029,435,562,905,328,511
060890101001,227,102,125,231,97,134,342,150,180,280,116,143
060890102002,441,197,244,451,188,263,607,264,321,494,200,255
060890102001,370,166,204,376,155,221,470,206,250,375,154,197
060890106021,390,173,217,395,171,224,573,264,295,438,177,223
060890106022,516,198,318,525,202,323,628,289,323,607,236,328
060890105002,602,250,352,607,234,373,819,352,442,648,238,357
060890105003,442,201,241,448,194,254,647,288,345,512,203,265
060890106012,621,247,374,634,237,397,763,334,409,698,250,394
060890105001,500,242,258,507,233,274,771,356,390,564,230,280
060890108033,705,212,493,711,199,512,1052,343,687,855,231,568
060890108072,1240,312,928,1263,290,973,1544,442,1076,1303,313,926
060890107042,324,108,216,328,101,227,534,186,332,385,119,239
060890107043,574,192,382,583,182,401,805,281,499,699,221,435
060890107041,514,173,341,521,167,354,674,242,416,591,194,369
060890108062,357,131,226,358,130,228,520,185,319,408,130,243
060890126032,869,262,607,874,237,637,1112,322,764,926,246,624
060890114021,904,263,641,917,246,671,1184,377,781,984,258,675
060890116001,579,188,391,586,171,415,511,175,325,433,131,278
060890117012,558,166,392,565,156,409,747,247,477,671,189,439
060890117031,310,115,195,311,106,205,447,152,285,374,106,237
060890117032,260,76,184,262,69,193,430,147,276,368,94,243
060890117033,267,91,176,271,80,191,547,188,346,483,138,314
060890117021,225,91,134,231,87,144,383,134,243,299,90,182
060890117022,451,164,287,461,151,310,626,211,397,531,162,328
060890117023,315,126,189,319,118,201,492,168,318,415,132,246
060310004023,684,238,446,690,237,453,989,379,583,759,262,463
060310004073,619,223,396,622,222,400,842,340,471,655,239,364
060310004072,474,195,279,482,190,292,669,296,353,501,177,293
060310004071,769,297,472,783,301,482,1153,433,694,846,318,474
060310004054,434,226,208,436,217,219,738,388,321,486,235,211
060310004051,441,191,250,442,183,259,706,267,417,497,181,279
060310004053,173,92,81,178,89,89,277,148,117,190,94,80
060310004022,627,234,393,631,229,402,931,344,565,692,247,405
060310004052,247,94,153,248,93,155,340,154,178,295,107,165
060310016011,132,95,37,133,90,43,207,114,89,161,104,51
060310016012,212,112,100,213,115,98,362,176,179,307,118,164
060310016013,161,112,49,160,101,59,238,137,97,199,138,52
060310002002,269,50,219,273,55,218,327,73,252,316,68,242
060319800001,165,77,88,166,75,91,441,205,204,313,127,137
060310004021,358,100,258,362,97,265,502,123,367,369,100,262
060310012001,403,92,311,411,91,320,511,148,357,423,98,316
060310011001,246,114,132,250,116,134,315,177,128,280,151,113
060310012002,329,81,248,334,81,253,440,107,326,393,90,291
060310013002,338,163,175,340,159,181,485,265,208,393,201,171
060310015001,437,230,207,441,218,223,559,325,220,516,268,215
060310017031,262,188,74,266,170,96,321,211,93,285,209,59
060310011004,154,107,47,159,102,57,234,158,64,200,142,43
060310006031,806,326,480,811,326,485,1775,676,1051,951,342,548
060310001003,589,97,492,606,98,508,717,209,501,623,101,492
060310006042,1013,351,662,1029,350,679,1436,519,889,1076,333,671
060310006022,678,232,446,685,231,454,923,331,571,751,265,450
060310002001,458,76,382,470,85,385,577,116,451,517,97,403
060310005001,317,75,242,323,66,257,387,133,248,333,70,241
060310004031,384,142,242,388,141,247,639,255,371,448,158,259
060310004062,335,144,191,332,135,197,496,219,272,386,141,217
060310004032,627,230,397,634,234,400,996,378,588,686,251,391
060310006043,748,275,473,760,265,495,1047,369,649,755,280,436
060310009022,111,48,63,111,45,66,165,89,75,127,57,61
060310009023,104,44,60,105,42,63,146,78,68,119,49,60
060310009021,263,175,88,263,159,104,428,219,203,316,166,116
060310011002,287,192,95,293,181,112,497,250,225,310,214,75
060310011003,218,157,61,217,147,70,343,222,111,277,206,56
060310010013,798,307,491,806,285,521,784,383,374,617,224,355
060310010021,114,80,34,113,77,36,228,112,110,166,94,57
060310010023,192,134,58,193,128,65,384,189,186,237,140,82
060310010022,239,158,81,241,144,97,426,210,206,281,159,95
060310005004,271,138,133,273,136,137,397,194,194,331,138,174
060310005002,185,85,100,186,83,103,277,137,134,222,81,129
060310005003,425,224,201,434,222,212,687,341,331,523,303,187
060310010031,507,286,221,509,272,237,893,462,409,555,286,242
060310009012,224,98,126,225,98,127,298,127,165,258,99,145
060310009013,211,92,119,212,91,121,300,150,142,247,97,136
060310007011,771,232,539,779,229,550,1048,343,686,849,224,578
060310008004,161,68,93,160,66,94,220,108,111,180,76,100
060310008002,460,263,197,465,255,210,710,317,371,545,253,263
060310007014,458,132,326,458,137,321,566,236,313,507,159,320
060310008003,208,74,134,209,63,146,294,143,145,265,100,148
060310001001,301,55,246,307,57,250,362,60,300,357,67,281
060310001002,376,67,309,375,63,312,465,83,375,407,64,328
060310007021,636,235,401,644,234,410,847,355,467,703,235,424
060310007022,687,261,426,697,260,437,1015,426,563,662,282,339
060310009014,285,149,136,284,146,138,493,230,244,418,177,213
060310008001,217,116,101,223,106,117,312,131,176,294,115,151
060310014011,277,187,90,282,179,103,444,247,179,354,224,106
060310014012,161,107,54,160,102,58,231,133,93,197,141,50
060310014021,133,89,44,129,84,45,208,117,89,185,105,69
060310014022,173,113,60,173,108,65,260,154,106,210,128,67
060310015003,158,107,51,156,100,56,244,137,107,194,114,74
060310015004,143,99,44,151,95,56,231,128,103,186,109,73
060310013001,246,168,78,246,156,90,394,228,153,272,190,65
060310015002,165,112,53,163,104,59,221,129,86,190,134,47
060310017021,295,218,77,294,196,98,496,310,168,326,214,85
060310017022,242,181,61,241,164,77,353,233,115,250,183,64
060310017032,157,118,39,157,106,51,238,159,68,156,115,33
060310006024,458,127,331,466,129,337,533,175,349,483,141,323
060310006041,649,261,388,656,261,395,924,369,526,759,266,440
060310004061,360,155,205,363,150,213,589,254,320,429,173,232
060310004033,172,63,109,176,66,110,205,79,122,213,78,121
060310010011,344,119,225,347,122,225,464,177,277,388,130,235
060310010012,391,134,257,394,138,256,522,201,311,437,146,266
060310009011,164,77,87,164,84,80,241,118,119,226,74,140
060310010032,359,210,149,365,201,164,550,324,215,421,273,115
060310010033,404,235,169,411,227,184,692,343,329,408,246,133
060310006021,557,167,390,568,167,401,763,267,477,602,187,383
060310006023,491,149,342,494,148,346,651,226,405,527,165,334
060310007012,587,202,385,595,202,393,840,286,538,642,204,402
060310007013,257,99,158,259,98,161,396,134,259,280,100,163
060379108041,1535,442,1093,1557,427,1130,2031,590,1403,1685,440,1188
060379108151,835,229,606,854,233,621,1185,388,774,914,253,612
060379108152,1192,352,840,1208,341,867,1656,523,1107,1320,347,908
060379108153,274,79,195,274,76,198,376,139,232,294,67,215
060379304002,171,97,74,172,88,84,248,130,107,142,74,56
060379304001,37,20,17,38,21,17,55,31,24,44,25,17
060379108141,912,270,642,920,262,658,1150,364,769,991,256,679
060379108142,808,255,553,817,241,576,1042,342,683,847,240,562
060379102131,523,217,306,527,200,327,674,284,377,581,234,330
060378003361,954,576,378,973,576,397,1248,757,466,1077,608,399
060378003353,539,323,216,547,317,230,617,366,239,582,339,200
060378003362,580,293,287,589,285,304,708,424,264,615,307,270
060378001041,2055,1766,289,2076,1770,306,2488,2036,408,2189,1756,274
060378002021,505,351,154,512,344,168,636,424,199,545,370,149
060378003354,491,326,165,506,323,183,556,340,203,537,322,179
060378005041,1047,689,358,1073,693,380,1335,884,429,1217,792,367
060378005061,625,444,181,637,446,191,726,497,215,705,486,178
060378002061,914,530,384,942,521,421,1319,768,533,1095,635,405
060378002062,513,280,233,522,270,252,762,426,329,604,338,236
060378002041,843,511,332,855,509,346,1298,820,462,905,562,294
060378004061,581,378,203,598,383,215,611,410,189,741,473,225
060378003382,880,538,342,901,544,357,1148,737,394,991,605,329
060378003381,643,377,266,657,382,275,885,571,301,701,389,268
060378003383,693,411,282,702,403,299,921,587,323,800,495,275
060378003331,907,543,364,918,544,374,1395,866,503,1048,608,388
060378003341,468,264,204,472,263,209,591,361,221,504,287,192
060378003384,702,414,288,711,407,304,956,607,336,781,482,271
060378003244,827,503,324,834,503,331,1163,733,407,898,533,309
060378003243,826,516,310,839,521,318,1067,689,357,928,585,295
060378003241,536,351,185,546,348,198,688,446,226,562,354,184
060378003242,1158,705,453,1171,693,478,1512,977,505,1263,758,444
060378003342,775,453,322,790,455,335,1003,613,368,842,484,315
060378003343,583,362,221,600,369,231,759,463,277,619,362,223
060378003281,604,326,278,609,330,279,738,458,266,628,334,253
060379108081,889,415,474,909,414,495,1139,557,562,998,430,495
060379108101,1162,528,634,1181,533,648,1560,724,803,1257,520,669
060379200501,516,199,317,527,197,330,706,266,423,566,180,350
060374804003,770,572,198,783,562,221,1070,787,263,872,645,177
060374803042,219,168,51,223,166,57,363,260,95,256,201,40
060374804002,614,428,186,629,428,201,989,681,279,721,491,189
060374804001,527,357,170,541,357,184,757,529,217,627,411,184
060374803031,295,231,64,302,229,73,474,350,116,373,278,69
060374803032,587,460,127,598,453,145,1001,742,241,711,532,131
060374808041,656,510,146,665,506,159,1114,812,278,823,618,150
060374808042,564,437,127,575,442,133,908,655,232,690,533,114
060374819013,727,561,166,732,542,190,957,720,215,791,588,154
060374819014,799,625,174,818,618,200,1156,866,268,933,693,186
060374803041,381,290,91,389,293,96,729,522,191,512,369,110
060374803043,253,192,61,261,196,65,515,366,138,214,154,46
060374803022,461,312,149,464,310,154,696,496,196,532,358,145
060374803023,482,330,152,492,333,159,719,508,193,543,367,143
060374803021,494,330,164,509,322,187,703,480,205,576,350,187
060374808031,360,297,63,365,290,75,503,393,106,413,319,71
060374808033,373,299,74,375,290,85,541,420,112,440,340,80
060374808034,279,232,47,283,227,56,380,296,80,307,238,52
060374808021,223,171,52,227,168,59,358,263,92,268,210,46
060374808022,832,646,186,848,637,211,1196,869,309,977,750,182
060374808032,279,222,57,280,216,64,428,328,91,308,239,57
060374809011,320,260,60,319,251,68,555,398,150,406,305,73
060374809012,350,274,76,351,266,85,600,427,161,425,318,79
060374809013,295,226,69,301,223,78,501,357,133,364,270,71
060374810011,240,171,69,249,168,81,395,269,123,320,226,80
060374810012,483,318,165,500,306,194,742,499,227,573,380,168
060374810022,559,425,134,572,420,152,1013,678,310,707,530,140
060374810021,555,398,157,559,394,165,845,576,257,633,446,158
060374811011,439,330,109,449,330,119,751,519,213,485,366,100
060374810023,227,161,66,229,161,68,424,290,123,211,146,53
060374819021,633,494,139,645,486,159,1105,823,262,796,614,141
060374809021,520,398,122,530,400,130,919,650,245,630,479,109
060374809022,176,135,41,178,134,44,305,221,83,228,175,40
060374810013,335,245,90,342,236,106,532,373,142,414,304,92
060374816041,319,238,81,323,234,89,458,320,137,383,281,81
060374816042,540,397,143,553,391,162,914,626,270,611,432,161
060374816061,319,222,97,325,222,103,618,411,187,476,348,109
060374816062,340,249,91,346,252,94,598,402,184,387,282,88
060374816031,465,329,136,478,328,150,866,591,258,597,423,145
060374816032,253,179,74,258,177,81,451,309,136,312,215,85
060374815002,255,178,77,264,176,88,457,301,143,337,228,89
060374815001,449,324,125,466,315,151,766,519,236,508,344,148
060374815003,376,274,102,383,272,111,675,453,218,494,348,124
060374816063,203,136,67,206,137,69,351,235,108,176,128,42
060374819011,344,262,82,354,255,99,468,327,138,424,307,82
060374819012,231,175,56,238,171,67,334,247,87,286,209,58
060374809031,630,452,178,644,443,201,1149,786,335,766,540,186
060374816051,197,143,54,201,144,57,357,243,112,325,241,71
060374816053,186,143,43,191,144,47,321,215,102,171,124,40
060374816052,316,247,69,323,244,79,493,329,157,361,273,74
060374819022,258,185,73,265,185,80,414,288,122,287,203,68
060374818002,502,326,176,521,333,188,789,540,237,627,415,179
060374818001,313,221,92,323,222,101,502,346,152,370,255,92
060376025122,243,198,45,252,197,55,452,343,99,393,329,45
060376025121,211,171,40,217,170,47,365,277,80,315,264,36
060374603014,1033,807,226,1049,806,243,1272,1042,200,1071,810,202
060374604011,477,420,57,484,419,65,599,518,72,517,432,60
060374603011,570,494,76,573,495,78,678,563,98,599,504,61
060374603012,509,450,59,507,439,68,647,558,76,553,476,48
060374603013,432,387,45,426,372,54,525,465,56,439,383,37
060374601015,822,562,260,836,564,272,1088,784,281,890,607,231
060374612001,487,338,149,498,338,160,661,479,170,534,364,142
060374613001,639,443,196,650,446,204,887,614,266,676,465,179
060374601012,1084,845,239,1102,846,256,1328,1066,232,1128,878,196
060374602001,538,463,75,544,469,75,668,552,103,588,479,72
060374603022,393,360,33,400,359,41,537,469,61,435,380,37
060374603023,555,495,60,564,495,69,739,637,85,634,566,41
060374603024,366,326,40,369,322,47,558,475,68,440,382,32
060374603021,470,405,65,475,404,71,627,537,79,536,452,57
060374610004,576,504,72,581,504,77,794,685,99,632,533,63
060374612002,752,515,237,767,513,254,954,691,240,800,543,208
060374612003,494,339,155,505,337,168,644,465,166,516,359,124
060374610002,518,455,63,522,454,68,742,631,90,601,517,49
060374610003,520,459,61,526,460,66,716,618,86,608,510,63
060374610001,315,271,44,317,269,48,466,398,58,414,356,31
060374611002,719,587,132,727,591,136,970,805,146,766,609,118
060374611003,397,338,59,403,337,66,492,421,69,451,372,54
060374611004,356,306,50,358,303,55,503,432,62,410,340,51
060374601011,552,383,169,560,387,173,659,479,163,582,394,147
060374602004,417,346,71,422,344,78,533,445,77,480,393,60
060374602005,801,691,110,813,685,128,1039,878,140,876,728,102
060374611001,582,476,106,590,480,110,712,594,109,629,507,89
060374601013,584,463,121,595,464,131,711,581,118,610,473,108
060374601014,508,406,102,516,408,108,587,480,100,545,419,104
060374613002,644,447,197,650,432,218,927,623,282,741,467,225
060374613003,541,380,161,545,368,177,805,528,261,612,382,194
060374625003,1049,742,307,1055,729,326,1373,926,421,1112,736,310
060374613004,770,568,202,784,563,221,1073,765,292,843,578,223
060374612004,765,598,167,777,605,172,975,787,161,803,627,128
060374602002,499,436,63,506,435,71,596,502,81,536,467,42
060374602003,668,547,121,669,531,138,788,661,115,691,557,93
060374303012,2,1,1,2,1,1,0,0,0,1,1,0
060379013001,414,121,293,421,124,297,690,238,435,552,146,369
060374306001,259,131,128,269,131,138,389,222,160,295,166,113
060374306002,695,339,356,716,342,374,1044,596,430,771,405,314
060374306003,735,365,370,743,363,380,1055,616,420,803,410,345
060374304003,265,132,133,271,132,139,414,238,169,304,155,130
060374304001,653,308,345,658,317,341,961,567,378,742,376,315
060374304002,339,165,174,339,165,174,477,283,187,360,184,154
060374307012,637,361,276,646,366,280,925,549,355,767,466,255
060374307011,362,178,184,374,180,194,499,287,204,405,198,185
060374307211,300,162,138,307,162,145,442,249,179,348,187,140
060374307212,382,226,156,390,220,170,693,426,255,469,284,163
060374307213,244,131,113,250,131,119,400,227,162,272,148,111
060374307013,385,182,203,398,183,215,499,325,171,475,266,183
060374307014,419,196,223,432,198,234,555,319,230,488,225,235
060374307231,344,225,119,354,223,131,632,406,212,452,283,141
060374307241,492,323,169,504,316,188,893,577,298,599,381,178
060374307232,442,275,167,452,273,179,817,507,293,546,337,178
060374307242,475,299,176,488,299,189,816,507,293,608,376,199
060374317012,312,158,154,323,161,162,530,312,209,373,205,153
060374317013,346,172,174,359,176,183,561,326,228,431,235,182
060374317014,269,137,132,280,138,142,472,280,187,335,169,152
060374317015,525,298,227,537,288,249,911,520,371,617,356,235
060374316002,532,297,235,550,293,257,871,494,366,629,346,243
060374316003,252,128,124,263,128,135,443,247,193,306,169,125
060374316001,347,169,178,362,171,191,591,328,253,432,236,176
060374308011,196,113,83,203,116,87,341,219,121,262,167,81
060374308012,532,333,199,547,337,210,999,621,356,655,429,195
060374308013,190,115,75,195,116,79,361,226,124,242,159,71
060374308014,385,246,139,393,246,147,707,430,259,462,300,139
060374308024,289,150,139,304,149,155,503,300,193,332,186,129
060374317011,300,153,147,308,154,154,503,294,198,348,190,144
060374308022,346,193,153,361,191,170,573,351,208,340,194,126
060374309021,744,489,255,755,481,274,1198,821,352,854,546,250
060374308023,288,150,138,304,147,157,497,301,186,357,204,134
060374308033,390,244,146,404,258,146,662,379,268,465,273,162
060374308031,275,151,124,284,148,136,441,264,168,313,181,116
060374308032,439,234,205,452,234,218,694,396,287,504,293,182
060374308034,361,201,160,373,197,176,566,341,217,404,240,145
060374308035,229,129,100,240,126,114,361,210,144,281,168,100
060374315021,284,167,117,289,164,125,428,256,162,338,188,133
060374315024,351,198,153,359,200,159,526,315,201,391,218,155
060374304004,399,217,182,418,228,190,612,371,233,507,290,183
060374325021,404,281,123,415,280,135,683,453,215,529,367,131
060374325022,392,276,116,403,282,121,663,440,209,520,353,135
060374320022,225,125,100,232,124,108,399,242,154,260,155,92
060374318003,269,168,101,273,160,113,513,315,188,345,204,125
060374318002,585,333,252,601,324,277,890,559,320,636,377,228
060374800111,533,342,191,545,344,201,923,578,330,593,384,165
060374308021,254,145,109,263,143,120,424,258,155,404,233,147
060374313003,227,145,82,237,145,92,356,236,119,272,176,81
060374313002,392,219,173,402,220,182,553,322,216,457,253,174
060375548011,387,323,64,397,316,81,717,461,233,529,437,57
060375548012,293,169,124,295,170,125,425,273,138,343,211,114
060375545213,705,423,282,722,435,287,1098,673,406,853,542,272
060375548021,630,386,244,646,389,257,959,603,336,732,470,227
060375549001,431,292,139,449,295,154,712,442,252,533,361,144
060375549003,167,111,56,169,108,61,271,170,96,196,130,56
060375549004,520,324,196,540,329,211,921,563,337,653,403,214
060375545161,695,398,297,717,406,311,1143,712,413,880,553,286
060375549002,333,227,106,348,234,114,528,331,189,402,273,105
060375548022,480,314,166,486,304,182,744,429,302,566,377,158
060375548023,435,285,150,447,280,167,659,384,269,518,345,146
060375549005,229,136,93,241,143,98,410,260,147,278,170,98
060375408004,248,232,16,251,231,20,395,354,36,314,286,14
060375409011,241,227,14,245,225,20,416,358,44,341,306,17
060375409012,308,289,19,312,284,28,523,449,56,428,389,21
060375409013,443,407,36,443,398,45,699,612,79,664,615,29
060375409021,362,334,28,361,321,40,573,510,55,436,406,17
060375409023,439,411,28,443,402,41,645,578,54,551,509,25
060375409022,683,647,36,689,646,43,919,838,61,864,804,34
060375409024,26,25,1,24,23,1,20,19,1,29,28,1
060375990001,236,143,93,238,140,98,338,201,128,278,148,110
060375990003,136,82,54,139,82,57,189,113,72,198,103,79
060375990004,393,225,168,398,220,178,529,313,199,439,227,180
060375991002,104,69,35,104,70,34,134,84,45,141,91,40
060375990002,231,126,105,236,125,111,328,195,124,249,129,102
060374083031,1101,865,236,1118,828,290,1590,1149,410,1344,1001,274
060374083012,459,363,96,472,358,114,825,592,210,636,495,106
060374083011,159,126,33,163,124,39,284,209,69,206,164,33
060374083021,1279,954,325,1292,911,381,1845,1324,490,1603,1159,378
060374083014,212,159,53,215,150,65,305,214,86,296,223,60
060379800351,93,58,35,95,55,40,157,99,54,139,92,42
060374083013,339,258,81,341,242,99,582,415,154,467,353,90
060374083032,404,288,116,411,281,130,629,432,181,493,346,117
060374040004,363,257,106,372,249,123,641,426,199,463,309,129
060374040001,329,228,101,335,215,120,495,332,151,381,252,110
060374040002,336,231,105,339,217,122,477,322,146,388,257,111
060374041002,300,233,67,300,227,73,532,388,132,398,299,75
060374044011,227,172,55,230,171,59,379,267,105,315,239,63
060374044012,335,251,84,339,248,91,544,375,151,341,249,69
060374044013,289,222,67,293,215,78,495,354,126,367,274,70
060374043011,363,271,92,365,259,106,579,411,159,455,326,100
060374043012,248,191,57,251,183,68,447,326,118,335,251,64
060374043021,297,217,80,308,220,88,507,356,139,422,304,89
060374045011,73,61,12,74,59,15,225,163,58,125,97,18
060374041003,385,296,89,390,288,102,685,480,189,525,380,115
060374043022,222,162,60,231,164,67,403,277,110,317,227,67
060374045041,326,264,62,332,254,78,662,476,168,436,342,72
060374044021,409,294,115,413,286,127,653,456,185,438,308,99
060374044023,218,164,54,223,161,62,338,231,96,283,208,56
060374045031,606,486,120,612,470,142,1075,797,262,840,637,156
060374045042,359,293,66,364,281,83,610,451,147,510,409,79
060374044022,281,216,65,285,212,73,504,344,144,395,296,69
060374044024,214,166,48,218,163,55,359,251,106,319,244,55
060374045012,282,234,48,285,228,57,498,379,111,398,330,44
060374006023,448,300,148,455,292,163,644,451,183,545,359,145
060374006031,945,595,350,967,574,393,1497,948,514,1162,723,351
060374008014,454,211,243,459,211,248,822,449,353,494,238,224
060374006053,735,462,273,743,445,298,1005,635,348,776,481,247
060374042011,341,243,98,344,237,107,601,404,182,501,335,135
060374042012,469,334,135,472,323,149,746,493,232,468,315,123
060374042031,296,210,86,302,204,98,529,348,170,428,282,120
060374042032,382,276,106,385,266,119,654,444,201,495,337,137
060374006022,427,298,129,437,289,148,742,496,235,446,295,121
060374043013,256,195,61,255,191,64,424,311,107,207,158,38
060374043014,200,153,47,201,151,50,332,242,83,149,113,26
060374006052,791,467,324,793,442,351,1253,766,459,893,530,306
060374006021,382,261,121,391,251,140,621,359,243,467,285,146
060374006051,405,219,186,403,205,198,597,346,235,464,260,181
060374006032,402,251,151,408,250,158,619,394,208,464,290,137
060374006033,378,227,151,388,228,160,577,355,208,468,270,163
060374046001,488,373,115,492,367,125,814,567,238,652,471,136
060374050022,326,283,43,334,273,61,523,381,130,433,348,61
060374050021,294,253,41,297,244,53,493,359,124,395,320,55
060374050014,384,320,64,386,311,75,624,466,143,514,421,68
060374051011,464,386,78,464,375,89,735,554,163,579,467,84
060374049011,274,229,45,279,221,58,453,336,109,346,273,52
060374049021,397,327,70,404,316,88,661,479,164,513,398,84
060374049031,205,168,37,206,163,43,345,266,74,254,201,41
060374049012,401,331,70,404,321,83,614,459,138,502,399,71
060374049013,413,341,72,420,334,86,696,529,152,507,416,61
060374051012,292,243,49,290,234,56,487,374,102,379,301,55
060374051013,352,297,55,366,294,72,578,442,125,477,372,62
060374051021,499,421,78,505,414,91,809,604,193,695,566,88
060374052011,332,269,63,347,265,82,524,359,157,438,339,78
060374049022,437,344,93,442,331,111,730,517,196,573,430,111
060374049032,367,292,75,371,281,90,642,474,158,468,368,74
060374051022,415,336,79,417,326,91,668,521,134,509,404,85
060374048051,261,214,47,258,203,55,442,327,106,323,260,47
060374048052,198,161,37,196,154,42,331,247,79,248,199,37
060374048042,286,233,53,289,225,64,480,356,114,358,286,60
060374052032,365,291,74,368,280,88,620,427,177,488,373,85
060374052031,375,299,76,378,287,91,604,429,160,490,375,83
060374052021,203,173,30,205,165,40,387,280,96,271,231,30
060374052022,338,282,56,347,274,73,566,410,144,445,361,60
060374047011,473,391,82,479,378,101,827,609,201,610,489,79
060374047021,501,417,84,505,403,102,814,590,200,565,459,72
060374048043,184,148,36,186,142,44,298,208,85,252,197,45
060374048041,421,337,84,425,325,100,694,484,199,558,432,101
060374052012,447,353,94,453,348,105,754,531,215,555,426,96
060374052013,298,236,62,302,233,69,520,388,126,368,289,57
060374050013,300,246,54,308,242,66,470,364,103,392,318,55
060374050012,386,311,75,391,304,87,572,434,122,492,395,71
060374047022,355,297,58,355,290,65,548,406,133,437,359,54
060374047023,257,212,45,260,208,52,424,308,101,338,277,43
060374048063,365,298,67,366,287,79,588,432,140,479,379,77
060374047032,249,213,36,250,203,47,401,299,97,328,270,39
060374047031,304,259,45,306,248,58,482,356,116,395,325,47
060374048062,453,368,85,452,350,102,734,539,174,614,489,90
060374048061,388,317,71,386,301,85,562,417,138,500,402,68
060374069033,459,381,78,465,374,91,771,599,156,601,469,97
060374070012,413,352,61,420,344,76,705,551,148,548,442,78
060374047013,364,307,57,368,292,76,595,440,143,480,396,59
060374047012,251,207,44,255,201,54,407,305,98,324,264,41
060374050011,323,253,70,326,247,79,492,363,115,409,325,62
060374052023,389,311,78,401,311,90,610,439,160,504,389,85
060374070011,243,208,35,244,205,39,399,300,87,333,276,41
060374070013,494,420,74,497,412,85,788,599,173,658,540,86
060374070021,348,291,57,351,288,63,611,458,143,484,388,70
060374070022,395,330,65,397,324,73,674,504,157,566,463,75
060374069032,271,222,49,273,215,58,422,331,88,344,265,57
060374069036,346,287,59,348,270,78,571,399,153,427,341,66
060374069035,252,205,47,254,203,51,460,327,125,330,253,59
060375336011,252,220,32,254,213,41,426,339,80,377,336,29
060375336012,262,228,34,263,222,41,458,359,83,396,351,30
060375336013,163,143,20,163,134,29,269,212,49,225,188,23
060375336022,385,338,47,384,318,66,619,484,117,543,450,52
060375336023,164,143,21,162,134,28,242,193,45,194,162,20
060375338051,386,344,42,397,338,59,626,499,113,515,444,41
060375338052,245,222,23,249,214,35,378,299,64,313,268,30
060375338061,634,570,64,645,555,90,1031,823,179,811,706,68
060375323042,148,126,22,149,123,26,299,235,63,211,178,20
060375338034,299,263,36,305,254,51,533,423,100,381,331,35
060375338042,243,214,29,249,205,44,403,312,81,315,267,33
060375338043,312,275,37,317,261,56,499,388,97,389,332,41
060375338032,283,247,36,288,240,48,462,360,90,368,319,37
060375338033,197,172,25,200,167,33,319,246,64,245,213,24
060375338031,243,208,35,245,201,44,422,335,76,336,284,39
060375338041,223,191,32,226,185,41,400,319,67,304,256,37
060375336033,312,272,40,318,259,59,527,417,98,411,349,45
060375336032,370,323,47,374,310,64,631,501,114,531,456,49
060375344041,319,281,38,320,272,48,489,392,83,398,340,36
060375336021,265,234,31,272,225,47,447,352,85,442,368,39
060375336031,337,297,40,343,291,52,611,485,111,519,454,39
060375532022,390,273,117,400,272,128,578,386,187,473,316,132
060375532011,422,291,131,426,287,139,617,409,194,492,330,139
060375544032,484,397,87,489,380,109,911,675,207,573,433,107
060375544042,566,407,159,572,402,170,1068,752,285,763,555,165
060375532021,335,230,105,340,228,112,525,349,162,402,282,101
060375532023,370,255,115,378,254,124,595,396,185,458,320,114
060375531001,654,489,165,670,471,199,1102,756,322,822,605,171
060375531004,478,294,184,489,281,208,711,466,226,608,365,205
060375532012,317,223,94,321,213,108,507,330,166,434,294,120
060375532013,367,259,108,375,250,125,591,380,195,444,304,122
060375540011,328,205,123,333,198,135,558,348,198,423,272,123
060375540012,281,194,87,282,185,97,454,301,146,351,238,93
060375540014,266,173,93,274,170,104,443,276,156,327,216,92
060375544031,419,338,81,428,332,96,786,571,192,551,414,103
060375544041,294,227,67,302,223,79,478,346,123,377,287,69
060375543013,162,122,40,163,120,43,312,230,74,218,164,39
060375540022,480,346,134,482,338,144,820,550,244,590,411,146
060375540023,279,211,68,278,207,71,451,304,133,362,263,80
060375540021,493,357,136,499,339,160,827,557,250,611,428,146
060375541011,225,160,65,230,158,72,368,249,112,285,184,82
060375541012,372,290,82,378,285,93,685,469,194,489,372,85
060375541061,230,176,54,234,172,62,400,276,110,302,222,60
060375541062,263,200,63,268,197,71,466,326,130,376,277,76
060375531002,293,197,96,298,188,110,460,318,137,378,245,111
060375531003,313,182,131,321,174,147,426,274,140,386,221,143
060375533001,289,201,88,293,199,94,450,286,153,321,231,79
060375533003,358,249,109,357,243,114,556,349,185,425,299,106
060375542042,470,367,103,487,365,122,789,518,254,663,494,127
060375542041,441,329,112,448,324,124,800,537,243,591,428,123
060375542011,239,167,72,245,163,82,377,251,112,303,207,78
060375543011,252,194,58,257,192,65,467,337,118,321,245,55
060375542012,367,250,117,374,245,129,552,367,174,437,304,106
060375542013,505,363,142,518,357,161,743,515,213,652,462,162
060375543012,242,189,53,246,184,62,399,301,91,308,232,66
060375543022,230,179,51,233,174,59,395,298,91,322,242,69
060375541052,323,258,65,331,254,77,574,364,194,404,318,66
060375542032,220,167,53,223,163,60,346,230,109,269,202,54
060375542033,259,198,61,266,194,72,391,274,108,322,240,64
060375542031,400,230,170,403,231,172,668,403,245,539,294,217
060375544051,359,242,117,365,238,127,640,420,207,460,303,132
060375544061,566,355,211,570,353,217,910,547,340,694,421,240
060375544063,690,386,304,708,384,324,991,613,353,835,462,323
060375544052,388,287,101,397,278,119,647,466,169,481,352,100
060375533002,285,195,90,290,193,97,486,305,168,371,252,102
060375540013,280,193,87,283,188,95,458,289,161,359,242,99
060375544062,354,195,159,363,194,169,465,280,175,418,230,167
060375541063,450,300,150,453,295,158,731,482,233,564,352,175
060375541051,397,329,68,406,324,82,792,516,255,529,418,85
060375543021,510,447,63,517,447,70,853,646,196,628,528,79
060375339011,270,245,25,271,238,33,411,338,58,356,313,27
060375341011,187,170,17,190,161,29,312,262,44,250,223,19
060375341012,168,151,17,170,145,25,252,207,42,228,200,17
060375341021,189,171,18,189,163,26,275,231,39,258,230,19
060375339012,311,282,29,311,277,34,489,404,76,425,373,31
060375340011,268,241,27,270,236,34,436,339,83,358,314,28
060375340012,413,370,43,417,367,50,633,494,121,563,498,41
060375339013,287,256,31,292,251,41,466,365,86,391,340,27
060375339014,177,159,18,181,156,25,281,220,52,234,203,16
060375339021,410,366,44,418,364,54,669,530,124,543,481,37
060375341022,277,245,32,280,237,43,462,358,91,347,296,35
060375341023,232,205,27,236,201,35,370,288,73,288,246,29
060375341024,203,176,27,207,176,31,310,240,64,264,226,22
060375342021,381,342,39,380,330,50,573,460,99,476,417,37
060375342023,199,176,23,196,167,29,320,262,53,238,209,19
060375342031,269,237,32,269,231,38,342,280,60,348,308,31
060375342032,267,238,29,270,235,35,423,346,70,353,314,26
060375340013,205,184,21,210,178,32,343,269,67,257,231,18
060375340021,500,452,48,501,443,58,760,589,146,622,536,50
060375340022,251,221,30,253,201,52,395,311,78,329,286,29
060375342022,284,253,31,281,236,45,425,327,88,325,280,32
060375339022,251,217,34,255,218,37,373,288,76,329,280,27
060375342011,316,280,36,321,275,46,501,410,83,398,348,35
060375342012,268,235,33,271,230,41,427,348,75,359,311,33
060375307001,495,440,55,505,434,71,737,618,110,630,531,59
060375310001,364,327,37,365,310,55,559,450,87,472,406,37
060375310003,522,482,40,524,458,66,820,670,125,648,573,50
060375308021,454,405,49,457,391,66,692,570,98,538,457,48
060375308022,415,373,42,414,363,51,573,469,84,475,414,35
060375309022,536,486,50,540,459,81,721,588,118,621,544,45
060375311021,451,409,42,444,382,62,660,548,95,587,528,35
060375308011,252,227,25,253,219,34,362,306,42,306,263,19
060375308012,233,210,23,232,201,31,350,293,48,276,236,18
060375308013,430,382,48,429,362,67,657,546,89,518,438,49
060375309011,218,201,17,222,197,25,328,279,43,275,242,17
060375309012,248,228,20,248,222,26,392,330,51,321,281,17
060375309013,234,214,20,236,204,32,331,283,43,271,232,21
060375311013,290,266,24,289,257,32,454,385,56,374,332,18
060375310002,201,184,17,199,173,26,285,233,43,236,205,18
060375315031,293,265,28,297,262,35,477,392,74,317,275,27
060375309021,344,306,38,345,288,57,487,402,77,402,344,34
060375304003,506,454,52,504,431,73,760,613,127,614,535,47
060375305001,413,383,30,415,368,47,629,511,101,543,474,36
060375308014,268,241,27,271,228,43,463,388,57,336,282,31
060375306033,496,446,50,495,420,75,770,640,112,645,558,53
060375306032,254,230,24,256,217,39,393,324,60,333,288,26
060374820011,764,518,246,786,503,283,1138,794,323,896,598,264
060375306031,365,321,44,362,300,62,571,472,84,475,405,44
060375305002,340,320,20,339,309,30,476,383,75,386,341,25
060375305003,306,273,33,315,271,44,422,340,69,524,456,40
060375311012,273,250,23,278,244,34,397,341,50,349,310,18
060375311011,150,137,13,155,135,20,234,200,30,201,179,12
060375311014,183,167,16,187,161,26,281,239,36,116,105,7
060375311022,190,173,17,198,171,27,293,243,44,234,209,14
060377007001,425,230,195,436,233,203,635,258,362,518,302,200
060377008011,376,265,111,386,271,115,605,317,276,467,326,126
060377008012,651,445,206,665,449,216,1079,582,484,821,529,263
060377006003,381,215,166,396,221,175,485,229,256,430,256,165
060377006004,428,210,218,447,220,227,737,323,403,541,258,265
060377006005,373,208,165,382,208,174,530,234,292,410,240,159
060372611041,703,495,208,715,500,215,1018,776,229,778,551,196
060377006001,507,245,262,517,239,278,796,377,417,596,313,262
060377006002,576,328,248,605,342,263,740,396,343,651,383,246
060377007002,337,147,190,347,147,200,459,184,272,365,165,189
060377007003,658,310,348,688,297,391,1046,418,621,783,401,354
060372690004,753,519,234,764,519,245,1164,688,454,859,574,242
060377008014,246,163,83,247,162,85,380,205,175,280,166,111
060377008013,381,241,140,382,240,142,591,340,241,503,299,183
060372148003,329,279,50,331,278,53,399,328,68,362,298,50
060377008021,464,311,153,475,320,155,780,435,331,588,385,181
060377008022,460,310,150,472,313,159,781,417,358,632,429,171
060377008023,333,223,110,342,224,118,540,290,249,433,265,153
060377009024,606,438,168,618,445,173,847,492,346,714,515,164
060377010001,263,180,83,272,187,85,343,231,109,302,213,76
060377010002,447,315,132,460,322,138,631,430,197,509,364,125
060377010003,462,330,132,470,333,137,536,361,172,494,360,123
060377010004,866,618,248,888,619,269,1102,748,339,966,695,242
060377009021,495,331,164,503,335,168,735,422,306,591,373,195
060377009022,595,402,193,607,398,209,871,488,365,676,443,201
060377009023,678,474,204,690,475,215,1033,685,332,819,570,219
060377009011,285,192,93,292,195,97,457,257,193,345,239,92
060372164011,635,513,122,643,511,132,969,649,308,802,595,168
060377009012,250,168,82,253,169,84,356,203,150,310,214,84
060377009014,483,324,159,490,319,171,701,401,300,551,367,169
060377010005,540,401,139,544,402,142,664,437,215,555,400,131
060377009013,325,216,109,331,217,114,504,285,213,397,257,128
060375737004,667,346,321,686,336,350,903,527,360,744,375,318
060374302001,476,215,261,490,224,266,647,335,303,539,245,263
060374303014,1098,599,499,1122,589,533,1376,791,553,1205,603,511
060374310022,627,388,239,645,384,261,897,588,286,762,434,265
060374310021,682,408,274,702,403,299,942,609,307,810,469,278
060373102012,635,393,242,650,391,259,878,485,384,755,451,266
060373102013,393,248,145,404,252,152,569,328,225,467,273,163
060373103001,314,195,119,323,198,125,445,255,181,361,211,127
060373108003,461,337,124,468,332,136,698,498,187,526,374,117
060373108004,469,341,128,474,335,139,678,480,184,529,354,144
060373108005,637,456,181,650,456,194,829,587,235,690,453,209
060373104002,477,297,180,485,289,196,728,451,264,569,330,198
060373104003,528,324,204,548,322,226,781,473,296,634,389,201
060373106012,712,525,187,717,513,204,1087,759,306,835,587,195
060373106013,443,343,100,451,339,112,710,500,196,523,385,104
060373101001,666,356,310,680,353,327,947,499,432,800,418,337
060373014001,364,223,141,367,226,141,519,269,239,448,238,185
060373101004,633,330,303,640,329,311,909,465,422,703,338,328
060373102011,294,195,99,299,195,104,436,259,173,326,208,104
060373102023,307,198,109,313,198,115,451,253,193,371,228,122
060373014004,361,200,161,363,191,172,533,275,247,440,220,193
060373102021,560,372,188,571,370,201,871,509,340,667,386,238
060373116011,682,494,188,693,493,200,883,657,212,757,527,188
060373116012,335,237,98,337,234,103,546,408,134,372,254,97
060373117006,541,379,162,555,379,176,688,486,187,585,391,162
060373103002,608,341,267,623,342,281,833,458,353,671,357,266
060373103003,369,190,179,381,191,190,526,289,226,412,208,180
060373104001,311,176,135,320,177,143,430,246,175,356,187,142
060373106022,540,363,177,545,355,190,815,538,263,611,386,193
060373101002,590,314,276,601,313,288,865,438,416,674,344,296
060373107011,664,467,197,672,465,207,1124,734,371,852,559,245
060373107043,410,305,105,420,303,117,610,401,203,459,313,122
060373107042,512,383,129,524,381,143,736,485,232,593,406,155
060373107051,588,446,142,599,452,147,1033,676,334,792,546,200
060373116021,629,477,152,637,473,164,790,607,169,688,487,161
060373116023,355,270,85,362,268,94,446,342,95,369,262,87
060373105011,527,406,121,531,400,131,849,624,210,618,468,113
060373105012,500,405,95,505,399,106,732,533,183,614,473,109
060373102014,629,458,171,632,461,171,1015,657,330,722,486,189
060373102022,731,534,197,748,536,212,1148,733,387,843,551,238
060373107041,539,417,122,553,419,134,870,575,275,635,453,143
060373107031,692,538,154,709,536,173,1194,777,388,889,625,206
060373015022,347,268,79,361,263,98,769,381,369,485,334,114
060373117001,825,566,259,839,566,273,962,700,238,869,572,244
060373117002,485,343,142,491,341,150,614,436,164,513,345,139
060373117005,409,288,121,417,285,132,532,379,146,434,289,118
060373117004,381,277,104,390,276,114,554,392,150,411,286,102
060373110001,350,239,111,355,237,118,456,319,136,390,242,116
060373113001,340,233,107,343,230,113,460,320,132,385,237,114
060379800011,2,2,0,2,2,0,6,4,2,2,2,0
060373108001,292,212,80,293,207,86,452,315,126,354,247,90
060373108002,302,218,84,308,218,90,452,319,126,380,267,93
060373109001,462,334,128,473,332,141,713,490,207,563,387,149
060373117003,396,283,113,400,281,119,494,356,131,415,282,105
060373101003,565,311,254,574,311,263,813,409,393,640,348,261
060373106021,463,324,139,464,317,147,628,428,184,501,328,146
060373106011,499,396,103,503,389,114,761,527,216,582,427,116
060373110003,643,435,208,659,431,228,890,591,290,694,451,201
060373110002,666,450,216,678,446,232,888,580,284,719,466,205
060373107032,531,424,107,539,427,112,930,612,294,688,496,147
060373118021,579,453,126,591,453,138,883,642,227,687,512,128
060373118022,550,434,116,553,428,125,829,613,199,639,480,112
060373118011,509,408,101,511,399,112,786,586,184,607,459,103
060373109002,727,495,232,744,490,254,952,643,282,837,520,260
060373109003,334,234,100,336,232,104,524,353,153,397,262,115
060373109004,609,413,196,620,414,206,839,569,250,628,415,178
060373109005,526,338,188,528,335,193,652,449,191,557,363,157
060373109006,499,330,169,505,323,182,647,447,194,520,332,157
060373115002,951,739,212,962,725,237,1260,925,304,1021,748,224
060373115001,918,656,262,930,649,281,1181,870,288,974,676,246
060373115003,928,669,259,940,659,281,1216,894,298,1040,728,258
060373116024,526,422,104,532,421,111,752,574,161,610,462,118
060373116022,685,534,151,691,532,159,1039,791,222,769,582,148
060373113003,739,533,206,756,535,221,953,686,242,789,567,180
060373113002,810,564,246,823,560,263,1087,759,306,855,551,242
060373111001,684,481,203,697,483,214,1000,683,289,752,497,211
060373111002,635,452,183,661,469,192,923,634,269,738,500,193
060373111003,417,310,107,423,305,118,577,415,156,461,343,92
060373112001,507,374,133,509,366,143,706,510,185,566,369,149
060373112002,500,372,128,509,366,143,657,471,176,560,381,135
060373112003,484,348,136,490,344,146,638,462,159,476,321,114
060373114001,582,425,157,589,422,167,705,526,163,655,475,138
060373114002,699,511,188,701,509,192,875,648,210,732,479,218
060373118012,606,457,149,615,448,167,796,592,187,666,470,148
060378002023,1481,950,531,1527,976,551,2014,1271,716,1681,1067,533
060378002022,828,473,355,835,466,369,1206,753,439,943,553,336
060378001011,1621,1063,558,1654,1075,579,2112,1403,678,1782,1214,498
060378002042,1370,842,528,1389,837,552,1784,1163,594,1534,964,513
060378003372,1024,676,348,1051,684,367,1491,925,528,1178,738,361
060378003371,239,158,81,246,160,86,399,247,141,350,212,113
060378001012,1209,779,430,1239,779,460,1572,1026,515,1346,862,413
060378002052,585,365,220,595,368,227,844,530,294,730,426,252
060378002051,746,489,257,756,490,266,1123,704,393,832,516,260
060378001031,1276,1058,218,1303,1069,234,1595,1283,285,1326,1005,220
060379200491,628,287,341,642,278,364,1034,466,548,602,256,317
060379200492,1443,700,743,1467,666,801,2196,1095,1064,1444,635,715
060379108072,1110,585,525,1128,578,550,1742,972,732,1352,692,567
060379200401,1302,655,647,1326,635,691,1759,955,768,1323,578,650
060379108091,1179,381,798,1205,386,819,1550,582,943,1294,390,844
060379200341,1028,520,508,1051,506,545,1680,938,707,1140,549,537
060379200342,360,202,158,366,199,167,503,254,233,376,197,151
060375410031,461,410,51,471,406,65,663,552,99,576,504,54
060375410032,1143,995,148,1165,988,177,1554,1308,215,1617,1345,192
060379800251,142,130,12,148,134,14,254,225,24,212,190,17
060375434002,606,516,90,619,517,102,791,626,143,760,625,103
060375434003,261,226,35,269,228,41,308,252,52,338,286,43
060375434001,415,347,68,421,340,81,655,488,156,540,433,77
060375437031,311,237,74,319,230,89,524,375,141,368,271,81
060375437032,707,523,184,714,511,203,1125,797,303,918,665,216
060375435014,567,395,172,587,384,203,1025,658,354,699,492,183
060375436011,488,337,151,497,335,162,935,618,300,648,461,165
060375436012,462,339,123,471,343,128,754,502,240,629,469,141
060375436072,783,530,253,802,530,272,1303,851,427,933,645,250
060375436071,260,180,80,268,180,88,477,311,155,366,257,91
060375433212,1381,1212,169,1401,1204,197,1945,1655,270,1586,1365,171
060375433213,652,571,81,654,564,90,948,807,129,775,694,64
060375438011,888,633,255,915,635,280,1340,879,434,1158,806,291
060375438012,360,262,98,366,264,102,572,385,172,454,338,95
060375438013,210,153,57,216,152,64,400,271,121,267,189,68
060375438041,274,202,72,282,202,80,495,326,162,361,262,83
060375438042,500,346,154,521,355,166,840,543,281,600,416,155
060375433061,768,587,181,781,570,211,1221,862,339,863,633,194
060375439031,477,357,120,489,352,137,691,459,212,604,442,132
060375433063,856,662,194,867,657,210,1466,1044,397,1093,826,214
060375439032,735,546,189,757,553,204,1176,804,354,948,699,201
060375439051,92,83,9,94,80,14,192,150,36,119,104,10
060375438032,719,529,190,734,520,214,1107,740,338,830,603,188
060375438031,547,412,135,559,404,155,972,622,335,673,504,138
060375435011,147,101,46,147,100,47,373,238,125,177,123,48
060375435013,539,416,123,550,410,140,979,635,328,704,518,150
060375435012,459,312,147,466,315,151,852,544,285,595,408,168
060375436073,584,409,175,600,409,191,976,649,303,796,554,191
060379800371,0,0,0,0,0,0,2,2,0,1,1,0
060375437012,397,303,94,409,297,112,721,496,206,565,401,125
060375437043,291,219,72,302,215,87,478,339,133,379,277,83
060375437052,548,430,118,553,420,133,872,615,241,722,548,142
060375437042,351,266,85,361,259,102,579,410,154,459,335,97
060375437011,376,284,92,391,284,107,630,438,179,475,353,97
060375437051,380,294,86,389,292,97,613,431,178,506,383,101
060375437041,221,174,47,228,168,60,364,260,98,285,209,59
060375439052,323,287,36,329,278,51,618,489,107,426,362,36
060375439053,338,270,68,347,267,80,553,401,146,465,364,77
060379800021,0,0,0,0,0,0,0,0,0,0,0,0
060375433221,739,671,68,754,681,73,1012,894,103,843,765,56
060375433222,515,475,40,528,479,49,695,610,75,620,565,38
060375433225,652,580,72,669,591,78,825,723,92,724,644,56
060375433223,1129,1020,109,1147,1028,119,1498,1328,147,1248,1141,82
060375433224,432,404,28,433,402,31,550,513,31,513,473,26
060375431005,334,307,27,337,312,25,418,347,67,414,387,14
060375433041,545,510,35,563,521,42,666,602,52,611,565,24
060375433043,824,767,57,839,774,65,1052,965,72,917,855,40
060375433042,1262,1156,106,1278,1155,123,1708,1541,146,1433,1297,97
060375433062,411,305,106,419,306,113,711,525,172,540,388,133
060375433211,258,231,27,263,227,36,270,242,26,505,434,39
060375433044,679,633,46,688,630,58,850,732,97,771,714,39
060375440011,1,1,0,1,1,0,2,2,0,1,1,0
060375440012,318,252,66,325,253,72,519,385,118,455,358,76
060375440013,430,350,80,435,338,97,745,555,172,587,470,89
060375440021,2,1,1,1,1,0,7,4,3,2,2,0
060375440014,301,243,58,308,237,71,516,375,132,380,296,63
060375440023,494,353,141,498,354,144,857,621,216,634,459,148
060375440022,336,256,80,345,255,90,499,365,129,390,287,82
060379201021,271,150,121,279,138,141,479,234,233,299,176,100
060379201023,1135,545,590,1148,531,617,1571,718,812,1341,529,724
060379201061,994,605,389,1006,585,421,1538,888,613,1079,612,385
060379201182,781,375,406,798,375,423,1056,522,513,824,357,418
060379201183,1068,508,560,1080,510,570,1545,717,793,1195,556,572
060379201191,774,298,476,790,294,496,1161,457,684,879,359,472
060379201163,1018,408,610,1035,407,628,1435,610,797,1099,441,592
060379201162,802,334,468,813,326,487,1110,468,619,875,341,486
060379203393,74,27,47,75,27,48,136,46,86,86,44,38
060379201161,334,124,210,345,120,225,509,212,289,382,148,212
060379201181,673,297,376,686,303,383,886,376,489,763,332,394
060372756051,484,414,70,491,414,77,699,569,115,481,392,68
060375545171,1023,636,387,1048,634,414,1595,994,574,1186,763,372
060375545172,570,352,218,589,358,231,891,564,310,649,409,210
060375545183,605,382,223,619,377,242,923,589,312,691,448,219
060375545191,518,331,187,524,331,193,773,493,271,607,397,177
060375545211,1007,603,404,1024,594,430,1403,867,506,1132,706,377
060375545212,587,347,240,596,339,257,839,526,292,642,389,226
060375545221,366,221,145,375,218,157,514,313,193,495,307,166
060375545222,743,440,303,760,442,318,1121,679,420,821,507,288
060375545141,391,263,128,402,268,134,696,439,247,509,338,146
060375545142,492,355,137,507,364,143,754,455,290,580,409,140
060375545151,499,273,226,507,267,240,759,460,291,599,366,204
060375545123,920,571,349,939,565,374,1417,904,485,1105,723,340
060375545182,883,556,327,902,549,353,1405,904,477,1036,683,322
060375545223,825,493,332,847,496,351,1332,804,509,985,605,340
060375545143,612,333,279,633,341,292,915,553,347,699,420,244
060375545111,1006,619,387,1041,617,424,1478,935,523,1129,734,344
060375545112,457,268,189,479,273,206,698,442,243,539,338,176
060375545192,910,536,374,933,543,390,1368,872,479,1089,679,361
060375545162,713,410,303,726,403,323,1134,687,427,852,503,302
060375530001,576,405,171,589,391,198,937,645,271,755,523,189
060375546002,512,343,169,518,333,185,880,553,309,581,385,165
060375545131,832,532,300,865,560,305,1356,869,461,1010,659,313
060375545181,455,281,174,460,280,180,696,448,233,556,358,176
060375545152,921,549,372,935,534,401,1438,858,557,1073,637,381
060375545122,604,349,255,638,355,283,925,598,315,696,449,213
060375545121,919,585,334,941,595,346,1332,859,452,1018,662,316
060375526022,227,168,59,229,164,65,383,273,104,293,213,62
060374041001,279,220,59,283,220,63,481,345,122,378,294,63
060374041004,215,168,47,217,165,52,373,269,93,281,211,52
060374037211,351,207,144,360,203,157,579,374,191,462,257,174
060374038012,690,428,262,705,416,289,1168,687,450,810,476,274
060374038013,672,412,260,682,401,281,1028,608,395,839,474,308
060374037034,336,174,162,341,164,177,488,263,214,403,207,172
060374038021,549,342,207,559,334,225,899,536,342,689,416,226
060374038023,803,480,323,812,467,345,1246,729,489,977,544,367
060374037021,669,366,303,689,360,329,1081,581,471,763,400,318
060374038022,355,229,126,362,229,133,562,333,216,422,252,144
060374058003,743,526,217,746,492,254,1135,730,388,927,605,264
060374058002,346,233,113,348,221,127,597,379,207,427,274,128
060374057013,363,271,92,370,264,106,698,469,202,541,383,128
060374040003,209,138,71,212,130,82,341,231,106,231,154,65
060374038011,408,252,156,419,249,170,614,389,213,504,312,163
060374059002,651,461,190,647,436,211,1021,659,335,791,511,235
060374060001,412,280,132,418,276,142,681,446,223,441,274,144
060374060002,593,397,196,608,393,215,846,558,271,694,432,205
060379203031,504,297,207,509,298,211,818,488,317,579,318,227
060371082022,656,406,250,658,395,263,1366,841,503,701,435,237
060371132311,391,235,156,402,228,174,611,385,219,421,235,162
060371132351,703,407,296,707,404,303,978,585,376,844,477,315
060379304003,157,53,104,158,54,104,261,117,143,189,62,118
060374008012,722,383,339,734,374,360,1092,582,477,805,377,362
060374039011,358,202,156,367,200,167,615,351,250,455,242,183
060374020021,655,462,193,662,449,213,943,648,270,739,487,213
060374020022,352,260,92,355,255,100,425,303,108,378,262,95
060374020023,611,450,161,614,440,174,703,498,186,663,454,176
060374018011,1088,753,335,1099,759,340,1476,993,450,1198,795,336
060374019012,176,158,18,178,160,18,212,162,43,215,192,6
060374019021,498,416,82,509,426,83,568,445,119,804,627,136
060374019022,998,760,238,1013,756,257,1366,1025,310,1018,692,257
060374020011,689,496,193,698,485,213,858,593,237,795,532,210
060374017052,544,317,227,554,310,244,685,423,251,605,347,201
060374017071,323,225,98,327,225,102,494,315,166,401,265,110
060374018022,1446,932,514,1461,936,525,1871,1199,632,1592,987,506
060374019023,667,526,141,678,531,147,770,601,158,606,486,88
060374019024,792,567,225,806,569,237,919,680,229,730,582,108
060374002062,1334,781,553,1355,772,583,1724,1059,632,1422,790,534
060374018021,580,390,190,589,394,195,701,514,171,614,402,168
060374002061,1396,776,620,1416,773,643,1774,1110,625,1534,898,544
060374018012,767,517,250,772,518,254,811,594,197,859,552,255
060374020012,407,284,123,407,272,135,615,457,146,503,357,119
060374002051,1453,743,710,1469,745,724,1943,1198,714,1591,836,664
060374002092,885,389,496,895,383,512,1152,531,596,963,424,485
060374017051,874,514,360,889,500,389,1134,705,405,946,527,347
060375323021,368,329,39,369,326,43,540,456,71,490,429,34
060375323022,326,284,42,331,279,52,480,380,92,403,339,44
060375323023,525,456,69,540,452,88,791,621,154,681,570,78
060375323032,890,742,148,893,725,168,1228,935,250,1089,879,156
060375323031,272,230,42,274,222,52,438,346,89,352,279,55
060375323033,160,140,20,159,135,24,303,238,61,211,178,25
060375323041,625,535,90,629,528,101,1033,793,211,832,696,90
060375416061,191,176,15,203,179,24,308,254,39,266,244,11
060375416062,161,147,14,169,150,19,251,205,32,233,213,9
060375426021,234,215,19,241,217,24,372,320,47,320,301,13
060375426022,352,326,26,360,327,33,585,503,65,487,449,24
060375426023,280,259,21,285,259,26,473,402,52,400,362,20
060375424022,513,469,44,527,476,51,735,638,87,624,569,28
060375424021,307,284,23,315,287,28,442,376,52,393,357,18
060375416051,164,152,12,168,152,16,284,243,31,258,237,12
060375416052,373,347,26,375,337,38,610,522,70,544,490,25
060375416053,283,266,17,288,264,24,481,415,59,424,387,19
060375416031,124,113,11,126,113,13,214,176,28,173,157,8
060375416032,248,225,23,249,223,26,418,353,52,310,282,14
060375416041,284,258,26,292,258,34,532,442,76,399,360,18
060375416043,189,173,16,195,173,22,379,320,47,266,241,11
060375411003,347,327,20,353,322,31,478,423,50,452,407,25
060375428001,393,368,25,399,368,31,638,550,72,551,516,15
060375428002,483,450,33,488,449,39,726,640,78,656,608,28
060375422001,261,242,19,262,237,25,439,382,51,311,288,14
060375422002,236,219,17,238,217,21,395,336,48,296,270,13
060375424011,283,257,26,282,253,29,426,360,53,355,326,19
060375424012,354,323,31,358,322,36,519,450,65,462,432,22
060375424013,276,256,20,277,254,23,438,375,45,380,347,17
060375424014,301,279,22,303,276,27,499,439,52,436,398,22
060375422005,377,352,25,377,346,31,554,492,50,507,469,14
060375424023,65,60,5,66,61,5,109,91,14,87,78,5
060375412001,399,377,22,407,381,26,524,473,40,497,471,15
060375412003,760,714,46,765,713,52,1000,888,82,928,864,35
060375413003,354,329,25,345,311,34,496,446,46,480,451,14
060375413002,329,308,21,331,300,31,516,442,57,429,402,13
060375413001,653,616,37,657,602,55,1036,915,101,867,811,25
060375408002,235,216,19,242,219,23,443,387,44,321,295,15
060375426011,96,88,8,99,88,11,170,146,20,154,143,6
060375426012,272,249,23,277,249,28,504,415,69,409,357,22
060375427001,350,323,27,353,317,36,537,461,72,442,406,21
060375427002,302,285,17,306,281,25,542,465,61,433,394,20
060375427003,373,347,26,381,347,34,608,539,66,539,502,24
060375430002,277,254,23,281,253,28,406,369,34,352,323,11
060375430001,600,562,38,601,555,46,881,778,86,755,700,30
060375429001,360,324,36,362,316,46,568,473,82,474,437,23
060375429002,292,268,24,297,264,33,433,373,52,391,361,19
060375425023,206,187,19,215,190,25,368,318,35,283,260,13
060375425022,197,183,14,198,179,19,329,290,31,292,267,14
060375425021,233,220,13,230,210,20,439,381,46,351,320,17
060375431004,534,500,34,542,499,43,738,669,54,651,605,24
060375425011,629,565,64,619,551,68,904,792,92,813,733,47
060375425012,393,354,39,385,342,43,527,466,52,460,415,25
060375432031,166,152,14,166,154,12,292,253,36,231,216,7
060375432032,175,160,15,174,161,13,322,276,40,243,229,7
060375420001,368,339,29,372,333,39,652,552,79,515,469,22
060375420003,433,395,38,435,384,51,675,572,83,597,543,28
060375420002,239,221,18,240,217,23,373,320,45,301,271,17
060375421032,111,104,7,115,105,10,225,186,36,184,173,7
060375421051,325,302,23,333,301,32,520,434,69,398,362,17
060375421062,274,256,18,275,248,27,443,392,50,394,361,17
060375421061,190,177,13,196,174,22,324,276,39,310,281,11
060375422004,236,220,16,238,218,20,349,305,33,290,271,9
060375421052,233,214,19,232,211,21,346,292,46,335,304,15
060375412002,314,298,16,332,312,20,441,405,30,418,401,12
060375412004,598,550,48,613,550,63,962,865,84,771,717,35
060375418013,261,237,24,264,234,30,428,354,54,338,294,18
060375418021,430,372,58,446,374,72,564,473,78,513,469,25
060375421031,198,182,16,202,183,19,427,339,70,346,317,14
060375421033,258,231,27,262,233,29,349,292,54,332,294,22
060375421042,256,236,20,261,236,25,410,350,50,360,322,15
060375421041,177,159,18,179,160,19,402,335,55,243,226,10
060375432012,405,372,33,411,367,44,633,538,75,549,501,21
060375432033,233,216,17,233,213,20,360,314,40,318,291,11
060375431002,496,467,29,505,464,41,735,643,72,630,577,29
060375431001,313,295,18,318,293,25,468,411,47,421,387,19
060375431003,329,309,20,335,308,27,480,430,39,412,380,14
060375432034,212,193,19,213,189,24,314,268,39,270,250,12
060375432011,417,372,45,419,371,48,589,508,66,466,415,35
060375405023,245,225,20,249,211,38,450,373,64,336,307,15
060375416042,232,207,25,242,210,32,417,344,60,395,350,19
060375417003,224,204,20,231,199,32,358,300,48,292,258,17
060375405022,168,154,14,169,143,26,299,251,39,217,200,11
060374057021,618,435,183,629,421,208,984,664,300,889,603,231
060374060003,315,203,112,323,201,122,461,285,168,369,226,121
060374060004,434,251,183,453,252,201,598,353,233,513,280,205
060374061032,919,567,352,945,564,381,1385,807,550,1086,660,363
060374061033,398,250,148,408,246,162,633,398,229,472,280,164
060374061011,300,192,108,309,190,119,468,291,169,405,240,135
060374061012,381,244,137,391,240,151,656,411,241,501,299,165
060374061013,377,239,138,386,237,149,559,341,203,420,247,142
060374061031,483,330,153,497,329,168,865,544,294,626,411,171
060374061034,408,276,132,421,274,147,670,426,228,461,294,133
060374037212,662,411,251,678,408,270,954,599,331,749,444,258
060374037213,410,259,151,421,258,163,592,367,219,454,264,161
060374037221,471,322,149,479,318,161,830,539,272,574,367,177
060374037223,373,245,128,379,243,136,658,408,240,431,273,132
060374036014,880,512,368,896,503,393,1241,754,463,1026,579,393
060374037222,567,328,239,579,321,258,910,544,351,636,378,222
060374037022,847,451,396,876,445,431,1265,691,552,996,513,425
060374037033,420,241,179,425,236,189,614,363,234,492,279,187
060374037031,759,364,395,772,348,424,1046,547,479,865,420,400
060374037032,383,210,173,391,203,188,583,316,257,464,245,194
060374037214,261,157,104,266,153,113,419,276,135,289,169,104
060374036013,840,402,438,854,388,466,1168,623,526,954,449,454
060374036011,330,208,122,337,203,134,568,355,202,393,238,136
060374036012,385,213,172,393,210,183,745,446,283,597,333,229
060374059001,547,363,184,549,346,203,906,570,307,700,445,211
060374058001,474,324,150,487,328,159,781,532,232,553,358,163
060374057022,558,387,171,570,391,179,929,581,322,695,454,191
060374057012,185,128,57,188,129,59,347,217,123,234,153,65
060375344031,557,483,74,566,480,86,793,636,137,726,626,58
060375344061,273,250,23,271,231,40,505,392,95,410,359,27
060375344062,230,210,20,229,194,35,410,319,77,326,286,22
060375344051,125,114,11,126,108,18,221,179,34,177,158,9
060375344052,268,244,24,270,231,39,472,382,73,373,333,18
060375344053,136,124,12,138,118,20,236,191,37,199,176,10
060375343021,321,294,27,328,285,43,468,384,73,415,366,31
060375361041,175,148,27,178,144,34,298,227,58,214,177,25
060375343022,238,219,19,245,213,32,361,281,68,310,273,23
060375343011,290,257,33,291,245,46,487,393,80,362,309,32
060375343012,317,281,36,315,265,50,540,441,82,405,349,35
060375344042,287,252,35,288,244,44,447,353,82,340,290,30
060377024003,405,356,49,403,349,54,537,464,63,396,334,42
060377024005,334,295,39,333,289,44,442,384,51,349,300,34
060377028021,396,328,68,398,321,77,532,440,85,441,348,69
060377028022,577,476,101,580,470,110,771,630,126,658,516,103
060377028031,188,157,31,189,155,34,275,225,45,199,162,28
060377024001,696,594,102,708,587,121,848,733,98,776,630,98
060377024004,541,478,63,544,470,74,648,560,74,584,492,65
060377024002,389,325,64,392,319,73,459,403,50,430,344,57
060377025022,685,580,105,700,585,115,922,764,134,704,574,92
060377025023,812,696,116,819,699,120,1045,873,150,908,738,123
060379800381,40,33,7,41,34,7,80,69,11,45,36,6
060377025014,959,792,167,977,801,176,1340,1111,201,1097,870,164
060377027001,446,355,91,448,351,97,550,453,92,501,397,80
060377025011,463,384,79,469,386,83,695,583,95,497,406,67
060377025015,437,352,85,441,356,85,276,227,46,464,375,73
060377028011,913,762,151,917,759,158,1232,1015,186,1048,845,143
060377028013,708,594,114,714,593,121,841,693,130,738,601,100
060377027002,489,389,100,499,386,113,592,492,99,522,416,79
060377027003,390,310,80,398,308,90,455,377,74,418,334,65
060377028012,638,523,115,646,522,124,829,679,134,685,544,95
060377028032,309,258,51,313,262,51,449,367,75,322,256,48
060377028033,555,463,92,560,466,94,733,592,121,595,473,88
060377026006,652,533,119,663,534,129,782,612,155,697,560,99
060377027004,543,445,98,557,449,108,672,552,115,607,481,93
060377026005,418,330,88,423,328,95,523,413,100,435,332,86
060377026004,815,639,176,824,633,191,1037,827,193,879,661,183
060377026002,607,484,123,614,481,133,711,589,106,650,501,121
060377030033,297,240,57,301,238,63,352,290,53,330,260,56
060377026001,393,315,78,397,314,83,457,384,66,440,333,80
060377026003,433,354,79,439,354,85,549,460,79,480,377,77
060377025021,677,574,103,682,574,108,796,680,98,719,592,92
060377025012,367,323,44,372,322,50,451,387,54,412,352,36
060377025013,401,353,48,408,353,55,529,462,58,453,386,39
060377030032,925,812,113,935,815,120,1172,986,160,1022,861,98
060377030034,630,549,81,641,559,82,757,643,97,682,583,64
060377030024,1008,893,115,1011,891,120,1274,1126,136,1131,1007,94
060377030031,967,855,112,977,845,132,1225,1029,170,1131,948,113
060376022012,349,257,92,361,265,96,535,366,151,400,283,94
060376022011,331,245,86,340,250,90,541,373,153,298,212,71
060376022013,1273,874,399,1301,875,426,964,661,270,1388,898,380
060376023012,500,380,120,509,373,136,735,528,187,554,401,113
060376023013,594,414,180,600,411,189,861,592,255,641,418,178
060376023014,688,498,190,702,497,205,979,684,273,804,556,191
060376022014,260,204,56,264,195,69,396,285,111,347,257,69
060376023011,536,395,141,546,391,155,794,558,206,653,477,134
060379012101,659,218,441,670,199,471,910,309,570,721,202,463
060379012171,795,163,632,803,154,649,993,281,687,868,165,661
060379201022,213,71,142,217,62,155,230,80,146,207,51,141
060379012091,495,122,373,506,118,388,634,187,433,615,138,442
060379009022,203,47,156,207,52,155,282,81,198,246,63,173
060379009021,459,121,338,462,117,345,643,168,460,559,134,393
060379009012,474,129,345,480,128,352,681,188,478,590,155,399
060379012161,1057,392,665,1068,390,678,1534,629,876,1222,438,706
060379102153,511,306,205,520,301,219,785,476,285,644,338,245
060379102151,379,261,118,384,260,124,620,405,199,562,320,212
060379104012,1032,608,424,1053,611,442,1569,914,619,1270,703,489
060379102121,839,270,569,857,267,590,1147,334,796,1124,328,733
060379102122,559,171,388,564,166,398,747,255,476,544,169,348
060379102181,645,297,348,654,286,368,816,397,403,635,277,323
060379111001,417,296,121,424,291,133,705,468,232,657,450,174
060379102182,348,239,109,350,238,112,525,342,171,358,259,74
060379104011,82,36,46,83,37,46,120,62,56,102,47,49
060379107091,579,266,313,596,267,329,847,404,426,698,312,337
060379110011,530,203,327,534,206,328,746,288,434,720,247,426
060379110013,619,209,410,632,219,413,799,321,455,652,210,399
060374033241,341,166,175,349,166,183,556,322,228,382,206,166
060374033242,380,212,168,392,207,185,639,374,259,448,264,161
060374033243,992,529,463,1011,513,498,1456,855,582,1095,602,431
060374033244,283,135,148,289,135,154,493,286,199,332,175,145
060374033252,868,486,382,903,471,432,1399,806,572,1014,568,386
060374033212,717,448,269,737,447,290,980,599,378,834,497,298
060374033201,748,420,328,767,430,337,1160,689,460,837,494,300
060374033202,1119,606,513,1156,611,545,1623,956,634,1281,731,504
060374033261,580,349,231,593,341,252,879,507,360,713,431,242
060374087073,1003,544,459,1033,539,494,1575,909,645,1119,644,410
060374033283,653,394,259,656,377,279,1026,596,402,737,442,253
060374033251,666,352,314,688,343,345,976,564,401,746,407,297
060374033231,483,265,218,493,268,225,783,474,296,529,311,194
060374033233,389,214,175,394,213,181,629,382,240,457,268,166
060374033281,521,301,220,539,294,245,793,463,317,600,358,210
060374033282,558,317,241,577,309,268,849,494,344,704,397,272
060374033232,660,366,294,670,372,298,916,538,363,698,425,245
060374033163,726,416,310,740,403,337,1056,633,406,818,477,303
060374033161,751,449,302,766,430,336,1106,652,430,851,486,309
060374033162,942,543,399,962,535,427,1409,841,541,1054,635,364
060374033172,309,156,153,324,159,165,455,258,189,388,217,151
060374033211,917,503,414,933,494,439,1510,880,602,1038,587,382
060374033213,248,137,111,252,132,120,378,220,152,278,152,107
060374033191,651,428,223,656,407,249,955,577,361,772,479,241
060374033192,539,344,195,550,336,214,981,585,379,690,411,231
060374033271,760,452,308,772,446,326,1054,641,402,879,512,327
060374033272,387,225,162,393,221,172,580,349,218,437,254,159
060374033051,564,323,241,583,325,258,977,561,399,681,423,229
060374087033,475,252,223,492,250,242,800,445,342,565,318,214
060375433051,971,775,196,986,757,229,1428,1113,281,1118,855,210
060375518021,399,305,94,402,294,108,772,558,189,599,436,127
060375518022,259,200,59,262,198,64,428,308,113,323,239,69
060375518023,331,255,76,334,250,84,548,397,143,410,299,90
060375511021,149,106,43,149,102,47,274,188,79,228,161,53
060375511023,349,273,76,356,271,85,620,448,162,452,355,71
060375506011,526,406,120,540,399,141,871,599,250,651,476,128
060375506012,317,244,73,328,242,86,484,334,140,365,267,73
060375506014,349,253,96,357,245,112,500,342,144,395,271,99
060375518011,614,433,181,616,422,194,887,587,283,783,550,194
060375518012,313,239,74,318,225,93,481,316,153,389,276,92
060375513001,427,306,121,437,298,139,687,459,204,581,417,125
060375534001,359,284,75,361,279,82,557,407,135,471,363,74
060375534002,292,231,61,290,224,66,492,357,120,391,301,61
060375534003,354,278,76,355,273,82,554,408,137,432,334,68
060375517001,654,527,127,668,518,150,964,703,248,825,641,153
060375515011,649,449,200,653,429,224,1050,668,355,817,544,225
060375515012,446,300,146,449,276,173,672,405,250,550,351,168
060379800121,0,0,0,0,0,0,1,1,0,3,2,1
060375512031,340,255,85,345,252,93,515,347,165,440,317,101
060375512032,619,456,163,630,455,175,977,675,279,819,591,186
060375512041,400,287,113,405,275,130,645,430,203,539,376,129
060375513002,334,235,99,338,228,110,531,381,142,449,312,107
060375513003,429,339,90,438,328,110,699,448,229,577,407,133
060375512012,663,511,152,678,495,183,969,654,294,825,608,172
060375514023,418,289,129,421,282,139,644,415,210,514,349,135
060375517002,402,301,101,403,293,110,594,415,155,497,361,103
060375517004,417,312,105,419,306,113,617,443,158,491,365,106
060375517003,297,247,50,294,239,55,521,385,136,379,299,55
060375514022,615,422,193,623,414,209,966,639,308,790,552,191
060375515021,426,293,133,428,289,139,664,450,194,537,369,139
060375515023,441,272,169,446,270,176,639,390,241,517,336,155
060375515022,399,273,126,397,268,129,615,417,180,509,347,131
060375512042,497,353,144,504,357,147,795,536,237,663,481,150
060375514021,398,272,126,402,262,140,538,351,182,499,338,132
060375511012,214,167,47,217,166,51,335,240,86,250,185,50
060375511013,247,192,55,250,191,59,406,292,107,275,203,56
060375511011,338,264,74,344,262,82,516,366,142,427,301,96
060375514012,587,433,154,589,425,164,876,597,260,742,529,174
060375515013,274,194,80,277,186,91,445,288,145,329,226,83
060375512011,466,341,125,472,332,140,681,462,210,556,382,145
060375508021,406,281,125,416,278,138,657,427,219,547,376,148
060375508022,237,164,73,243,164,79,407,262,134,313,214,84
060375506021,367,255,112,372,248,124,549,371,171,458,309,126
060375506022,414,289,125,416,275,141,619,421,187,521,351,146
060375507002,499,341,158,511,337,174,772,509,251,613,419,162
060375507003,421,289,132,428,284,144,673,428,233,519,352,141
060375507004,293,202,91,300,199,101,429,283,142,379,258,99
060375507005,431,299,132,439,293,146,642,427,203,543,376,141
060375507006,284,200,84,292,200,92,444,292,146,373,256,99
060375507001,353,241,112,357,233,124,533,343,182,433,305,113
060375506013,334,221,113,341,217,124,515,340,165,395,267,106
060375508013,351,230,121,356,228,128,503,311,182,485,299,164
060375508014,341,216,125,344,211,133,529,322,200,375,221,132
060375508012,397,259,138,400,248,152,529,343,174,477,293,163
060375508011,599,381,218,600,362,238,881,531,328,712,425,250
060375509011,422,319,103,425,313,112,759,531,218,488,347,106
060375509021,394,306,88,401,308,93,653,451,190,473,355,89
060375509022,331,257,74,336,258,78,543,374,157,403,301,77
060375511022,395,280,115,399,274,125,645,441,189,489,360,104
060375505011,700,530,170,703,527,176,1110,758,322,921,681,190
060375505012,314,237,77,316,239,77,513,352,150,394,301,70
060375505021,468,285,183,481,278,203,687,415,255,543,339,181
060375505023,428,266,162,437,253,184,636,375,249,479,293,162
060375505024,343,212,131,350,202,148,482,283,191,376,234,127
060375505022,407,247,160,409,244,165,533,323,200,461,277,161
060375778001,467,328,139,473,306,167,694,456,226,528,376,126
060375510011,457,296,161,464,291,173,705,442,249,575,373,170
060375510012,326,212,114,333,208,125,460,287,163,372,240,113
060375510013,400,261,139,406,256,150,639,400,224,496,325,143
060375510023,422,278,144,429,276,153,593,363,217,494,312,155
060375506024,346,221,125,356,221,135,544,334,194,438,267,155
060375506023,373,238,135,385,238,147,583,364,210,469,294,153
060375509023,332,220,112,335,212,123,469,297,160,395,255,119
060375509024,395,258,137,397,250,147,558,360,187,448,290,136
060375509012,229,163,66,229,153,76,383,245,125,316,215,82
060375509013,356,253,103,356,239,117,610,392,200,397,273,103
060375514011,498,382,116,504,376,128,774,544,215,614,473,111
060375510022,406,269,137,410,265,145,579,357,215,459,289,143
060375510021,353,226,127,355,221,134,572,351,211,455,283,144
060374301011,577,386,191,592,379,213,927,612,295,730,478,204
060374301012,470,348,122,486,354,132,743,525,206,585,407,142
060374301013,322,228,94,330,226,104,497,341,148,395,266,102
060374300041,312,211,101,324,213,111,447,306,132,378,252,107
060374300043,379,251,128,392,253,139,610,382,216,465,320,124
060374300052,869,572,297,887,561,326,1182,755,407,960,644,267
060374300032,1432,820,612,1470,802,668,1903,1194,669,1690,961,638
060374300033,295,172,123,306,172,134,384,257,125,301,185,102
060374301021,426,331,95,436,333,103,676,480,180,519,381,108
060374301022,343,293,50,353,286,67,577,433,129,465,379,63
060374301023,425,363,62,432,352,80,667,503,148,566,462,75
060374300031,319,223,96,328,228,100,476,316,151,403,246,136
060374300042,426,303,123,430,294,136,633,421,202,481,318,137
060374300051,404,287,117,417,295,122,725,481,231,536,370,137
060374312001,456,391,65,457,385,72,655,507,129,556,480,50
060374312002,332,278,54,328,266,62,496,387,99,374,309,47
060374311002,645,474,171,656,467,189,1043,745,272,809,601,160
060374312004,551,380,171,559,375,184,796,534,249,645,443,172
060374314003,300,194,106,305,185,120,266,172,91,230,150,67
060374314002,319,206,113,321,195,126,452,286,153,376,242,107
060374314001,323,173,150,324,165,159,499,279,208,388,212,155
060374312003,237,195,42,236,185,51,378,296,76,305,245,42
060374315022,395,223,172,402,223,179,569,343,221,431,244,172
060374313001,328,186,142,338,186,152,466,273,180,382,214,147
060374314004,326,188,138,337,189,148,666,406,247,504,284,189
060374315023,273,162,111,282,162,120,430,263,159,331,190,125
060375537022,295,264,31,298,259,39,537,445,78,418,377,24
060375421053,143,133,10,143,128,15,252,211,29,219,200,9
060375422003,204,191,13,205,185,20,353,299,43,263,238,10
060375312022,431,397,34,441,390,51,685,571,101,567,500,37
060375313011,218,197,21,222,189,33,369,300,54,278,246,18
060375313012,196,180,16,201,177,24,289,244,38,241,209,15
060375313013,209,190,19,211,183,28,323,266,44,278,245,19
060375315022,342,311,31,348,308,40,525,451,64,486,443,27
060375313014,229,212,17,236,209,27,343,290,43,301,261,20
060375312011,422,389,33,434,389,45,700,595,87,734,657,48
060375312012,436,397,39,446,385,61,694,567,101,503,436,37
060375312021,290,264,26,295,255,40,483,399,72,362,312,26
060375315021,160,146,14,164,145,19,257,219,32,231,209,14
060375315032,181,165,16,183,164,19,310,252,49,255,222,18
060375315041,437,401,36,441,395,46,692,575,97,566,499,34
060375316031,178,165,13,179,160,19,266,219,41,221,195,15
060375303021,356,307,49,357,296,61,482,386,85,437,370,48
060375303022,495,455,40,496,442,54,751,620,108,649,563,44
060375316032,535,496,39,534,476,58,757,642,100,638,555,46
060375316021,208,188,20,216,185,31,341,288,49,298,259,24
060375316023,251,231,20,255,229,26,448,388,55,383,334,27
060375317021,287,255,32,288,244,44,390,328,61,354,308,30
060375315042,308,280,28,311,278,33,513,419,80,443,385,35
060375316041,391,360,31,400,344,56,594,490,78,483,420,31
060375303011,539,475,64,549,455,94,791,652,120,675,579,57
060375303023,342,300,42,343,292,51,506,405,77,397,333,37
060375303024,350,306,44,352,301,51,519,416,94,398,333,43
060375302021,476,400,76,488,400,88,705,548,141,569,464,75
060375302023,318,273,45,323,271,52,461,357,96,384,322,48
060375316042,273,253,20,278,237,41,387,325,52,339,300,19
060375318002,354,317,37,360,309,51,616,496,105,506,448,38
060375318003,214,192,22,218,190,28,368,298,64,320,286,22
060375313022,250,228,22,257,230,27,387,329,51,344,309,16
060375313021,204,187,17,211,188,23,371,314,49,295,264,15
060375313023,219,200,19,215,187,28,358,304,46,293,257,22
060375313024,269,247,22,272,235,37,438,373,58,389,337,29
060375317022,170,151,19,172,144,28,226,191,32,203,175,19
060375317023,323,291,32,333,289,44,535,447,79,468,404,40
060375316022,169,151,18,171,151,20,313,253,45,264,226,23
060375317011,597,547,50,599,528,71,916,757,128,794,676,64
060375317012,436,397,39,433,382,51,690,569,100,559,481,43
060375319013,391,340,51,396,335,61,621,508,103,527,458,45
060375319014,290,250,40,290,246,44,471,381,79,360,309,33
060375319022,466,418,48,473,409,64,752,603,139,564,482,53
060375319023,291,254,37,290,250,40,418,329,77,358,300,37
060375319011,270,237,33,276,235,41,468,380,74,372,319,34
060375319012,267,234,33,269,232,37,444,362,72,353,300,34
060375318001,316,282,34,320,273,47,520,433,71,446,393,33
060375319021,233,211,22,240,206,34,341,273,62,297,256,26
060374631032,505,297,208,517,293,224,654,424,222,567,351,197
060374631033,434,270,164,442,268,174,606,416,177,507,349,126
060374633001,559,376,183,562,381,181,696,487,187,608,413,162
060374642001,311,156,155,313,156,157,430,256,168,336,191,129
060374642005,318,130,188,336,141,195,458,276,178,342,166,156
060374633002,404,270,134,409,277,132,501,355,135,436,295,117
060374631031,314,257,57,328,258,70,583,395,166,408,304,82
060374632001,477,336,141,487,336,151,630,466,150,526,364,132
060374631034,234,168,66,240,168,72,340,234,100,276,181,76
060374631035,580,414,166,587,409,178,852,582,251,685,443,191
060374801023,315,208,107,328,208,120,500,330,164,361,235,107
060374801022,208,136,72,212,135,77,342,220,118,231,152,67
060374812031,511,346,165,519,341,178,892,573,300,593,396,165
060374812032,478,327,151,486,318,168,790,511,266,561,372,159
060374812033,284,194,90,289,190,99,438,281,144,318,211,88
060374812012,400,248,152,412,247,165,797,487,290,481,301,161
060374812013,225,144,81,229,141,88,387,230,149,303,186,96
060374801021,430,278,152,448,279,169,648,421,208,517,333,155
060374800121,298,192,106,306,193,113,500,313,179,360,220,117
060374800124,308,161,147,318,163,155,479,270,199,360,200,144
060374800021,368,209,159,377,209,168,533,337,184,406,242,147
060374800022,450,252,198,458,252,206,659,413,228,513,294,189
060374800112,575,373,202,594,372,222,1047,670,358,653,406,215
060374800122,451,270,181,460,274,186,721,439,265,477,279,170
060374800123,276,165,111,283,169,114,412,254,152,286,169,101
060374800023,472,282,190,475,281,194,735,472,247,549,332,186
060375002025,775,375,400,780,353,427,1077,583,467,887,407,428
060375001002,617,253,364,629,254,375,879,406,454,714,301,376
060376037021,360,290,70,371,295,76,548,404,140,369,292,60
060376037061,193,156,37,196,156,40,349,253,88,251,198,40
060376037062,292,236,56,299,237,62,502,364,126,398,314,64
060376037022,517,332,185,526,331,195,765,525,226,605,374,192
060376037023,548,347,201,558,349,209,824,499,310,635,387,208
060376037024,521,328,193,536,335,201,766,495,259,601,361,204
060374324011,331,246,85,341,242,99,569,380,177,425,321,83
060374324012,290,215,75,295,210,85,500,336,158,359,279,64
060374324022,285,230,55,291,227,64,479,327,142,384,308,56
060374324023,306,245,61,312,242,70,550,377,160,403,321,59
060374327002,321,267,54,324,261,63,484,347,129,388,312,56
060374327003,276,231,45,281,228,53,535,384,142,348,278,52
060374321025,297,187,110,304,187,117,580,360,213,397,245,133
060374328022,129,100,29,128,92,36,289,190,90,174,138,27
060374328023,161,126,35,164,118,46,392,265,125,229,181,36
060374329022,336,245,91,350,247,103,595,393,200,456,342,97
060374328011,258,210,48,261,201,60,471,333,126,337,273,44
060374328021,159,121,38,161,116,45,342,236,100,210,165,32
060374335052,189,163,26,196,159,37,376,263,106,276,226,37
060374335053,125,96,29,128,92,36,230,160,66,167,136,22
060374334022,244,216,28,247,209,38,469,361,97,338,284,34
060374334032,197,172,25,203,165,38,427,330,91,286,242,29
060374339032,65,59,6,66,58,8,121,96,24,95,83,8
060374338042,124,105,19,124,99,25,223,165,53,148,123,20
060374339031,124,112,12,123,108,15,230,178,45,160,141,13
060374331034,304,233,71,309,226,83,479,307,165,381,303,65
060374331031,265,197,68,271,190,81,546,360,180,372,279,79
060374331032,272,204,68,277,195,82,535,345,178,338,256,70
060374332003,255,193,62,261,186,75,381,271,110,310,229,63
060374335051,225,172,53,236,174,62,500,360,128,375,312,44
060374333051,297,234,63,301,223,78,577,407,161,408,316,63
060374333052,210,165,45,210,156,54,429,305,116,265,206,41
060374332001,204,164,40,208,164,44,359,252,97,254,198,45
060374332004,418,321,97,428,318,110,739,524,206,603,442,119
060374326011,175,135,40,178,132,46,308,218,85,224,174,40
060374327001,499,394,105,499,378,121,772,542,217,593,467,93
060374326012,325,250,75,330,247,83,548,385,155,432,323,84
060374326022,312,231,81,314,226,88,531,363,154,395,299,73
060374326023,286,203,83,289,200,89,488,327,153,347,257,73
060374333061,281,216,65,280,214,66,475,341,126,393,304,68
060374333021,171,133,38,176,133,43,318,229,85,226,177,38
060374339011,304,246,58,308,247,61,551,401,139,383,300,53
060374339012,121,97,24,122,98,24,215,161,48,172,138,23
060374339013,145,120,25,149,119,30,253,185,59,190,155,22
060374340012,407,356,51,408,350,58,719,553,148,511,426,58
060374333062,131,107,24,132,105,27,283,207,69,200,172,22
060374333072,155,127,28,157,125,32,317,232,77,255,218,28
060374328012,123,103,20,123,98,25,196,142,51,167,138,21
060374332002,136,111,25,136,105,31,232,168,64,179,135,34
060374334031,231,192,39,234,186,48,413,301,106,268,219,33
060374334021,173,151,22,175,141,34,393,306,77,236,193,26
060374333041,252,190,62,256,186,70,449,317,124,348,271,63
060374333042,320,246,74,329,240,89,610,426,170,434,339,76
060374333071,318,249,69,320,246,74,531,384,141,428,335,74
060374326013,302,228,74,306,222,84,541,360,172,402,293,87
060374326021,385,284,101,389,273,116,647,423,211,457,342,88
060374326014,365,275,90,372,272,100,658,436,209,478,349,104
060374324021,501,363,138,509,358,151,831,592,228,628,474,121
060374315011,186,119,67,191,120,71,307,202,105,239,157,71
060374323003,294,223,71,298,216,82,472,329,139,353,263,73
060374321011,388,233,155,392,229,163,632,384,242,450,273,154
060374323002,330,222,108,335,225,110,566,387,168,408,282,103
060374325011,544,388,156,555,378,177,953,632,304,702,499,167
060374325012,468,336,132,474,326,148,791,526,252,604,431,142
060374323001,225,177,48,228,168,60,370,255,107,269,203,50
060374321021,384,228,156,386,220,166,669,388,274,464,274,163
060374331033,144,108,36,148,106,42,280,180,92,182,146,29
060374334033,103,86,17,104,84,20,153,110,37,129,108,12
060374339034,291,229,62,293,228,65,500,380,113,407,325,56
060374339033,330,260,70,335,258,77,551,417,125,488,381,77
060374340011,262,218,44,265,219,46,439,322,111,327,267,40
060374340033,195,163,32,199,164,35,312,231,80,272,230,30
060374340032,254,209,45,255,205,50,406,314,86,339,275,46
060374340031,232,190,42,233,189,44,374,289,75,296,248,33
060376201012,1014,592,422,1029,579,450,1250,759,463,1069,591,399
060376201013,928,575,353,947,564,383,1295,814,446,1074,636,365
060376201021,511,343,168,516,337,179,691,450,225,521,326,155
060376201023,966,573,393,992,573,419,1331,863,431,1067,618,358
060376201011,743,498,245,770,503,267,948,656,269,821,505,245
060376200011,571,322,249,583,318,265,729,443,272,668,364,259
060376200012,596,336,260,609,333,276,717,441,260,645,351,245
060376200013,809,459,350,834,457,377,973,624,325,896,488,336
060376200023,481,286,195,495,287,208,591,375,198,545,308,190
060376201022,367,253,114,372,250,122,465,302,155,358,229,103
060376200022,604,362,242,618,362,256,904,566,315,622,355,217
060379800131,5,4,1,5,4,1,14,7,6,2,1,0
060376200021,533,331,202,546,334,212,801,510,272,586,344,190
060375351011,242,223,19,245,212,33,440,363,59,507,459,25
060375351014,296,271,25,300,260,40,506,439,64,336,314,14
060375351022,316,292,24,324,291,33,459,399,53,398,372,12
060375352001,299,274,25,297,268,29,498,428,55,451,419,16
060375349001,149,133,16,146,129,17,250,203,45,396,355,24
060375349002,301,272,29,301,266,35,556,449,92,269,242,14
060375349003,235,210,25,234,205,29,399,322,68,284,257,17
060375328001,234,214,20,234,207,27,416,351,56,352,321,24
060375328002,216,198,18,218,193,25,399,336,53,216,197,14
060375327001,133,120,13,135,118,17,249,209,38,280,255,18
060375327002,213,191,22,217,188,29,374,307,63,196,177,11
060375330021,151,136,15,153,133,20,246,201,41,391,354,22
060375330022,201,181,20,204,176,28,330,272,56,71,66,2
060375329003,305,288,17,315,283,32,429,367,57,477,444,16
060375329001,237,225,12,241,213,28,365,312,48,271,250,10
060375330011,279,254,25,284,252,32,515,425,77,438,400,25
060375330012,310,282,28,310,271,39,531,439,79,395,354,21
060375329002,271,257,14,275,239,36,455,383,59,370,337,15
060375349004,204,183,21,203,175,28,380,310,56,350,327,17
060375350021,194,174,20,196,168,28,337,281,52,358,329,12
060375350022,105,95,10,107,91,16,182,156,26,108,100,3
060375350023,149,134,15,149,131,18,256,217,38,181,170,7
060375350013,188,168,20,186,164,22,343,284,47,274,258,10
060375350012,149,135,14,151,128,23,281,238,42,235,213,9
060375351013,242,222,20,241,214,27,374,326,41,244,224,10
060375351012,395,365,30,398,358,40,578,497,70,543,491,33
060375351021,163,150,13,163,145,18,285,246,32,278,256,13
060375351023,192,176,16,191,171,20,359,316,39,247,230,10
060375352002,334,309,25,339,305,34,559,477,59,391,359,15
060375352003,317,300,17,326,289,37,513,442,57,427,388,23
060375350011,204,184,20,209,176,33,388,320,56,325,289,12
060375353001,270,240,30,270,226,44,408,335,57,368,328,22
060375353002,179,162,17,181,156,25,369,310,57,243,227,14
060375354001,242,223,19,244,215,29,460,380,59,361,323,12
060375354002,186,169,17,185,157,28,319,273,36,296,261,15
060375353004,310,275,35,314,261,53,451,378,62,286,254,17
060375353003,151,139,12,151,133,18,277,242,35,213,203,6
060374089003,1184,585,599,1212,563,649,1727,871,816,1371,657,635
060374016012,1098,546,552,1141,542,599,1605,844,732,1299,600,628
060374017072,416,308,108,420,303,117,635,415,205,529,398,95
060376026013,762,701,61,777,710,67,959,874,78,875,803,55
060376026014,477,440,37,489,448,41,590,534,47,539,492,34
060376029003,310,274,36,321,272,49,419,333,82,356,311,36
060376034001,431,320,111,434,308,126,629,477,142,506,417,72
060376034003,477,345,132,486,341,145,753,490,250,541,367,141
060376035001,272,205,67,279,199,80,405,292,107,371,273,78
060376035002,418,309,109,420,296,124,703,483,206,537,378,125
060376026021,697,643,54,708,645,63,980,884,77,801,736,47
060376026011,583,538,45,590,536,54,790,729,51,692,633,36
060376026012,439,407,32,441,403,38,591,530,52,488,451,22
060376029001,378,338,40,379,327,52,549,442,105,437,394,31
060376029002,360,322,38,360,311,49,530,417,99,439,390,33
060376026022,546,500,46,561,504,57,747,681,58,655,601,40
060376036001,490,336,154,498,331,167,739,483,231,538,359,140
060376036002,284,187,97,284,179,105,404,272,129,315,215,81
060376036003,589,421,168,601,417,184,878,582,278,707,498,170
060376031012,379,295,84,381,288,93,631,469,153,454,345,83
060376031021,343,271,72,346,264,82,562,399,151,402,312,69
060376031022,307,243,64,309,237,72,490,352,132,375,290,65
060376034002,420,303,117,427,303,124,666,435,218,511,351,128
060376030041,400,317,83,411,322,89,539,419,108,465,360,84
060376030061,393,293,100,402,294,108,600,412,180,466,347,98
060376030062,174,137,37,183,141,42,264,198,61,199,152,38
060376030082,459,375,84,462,372,90,716,552,148,461,365,71
060376030072,545,469,76,554,465,89,882,683,180,600,499,72
060376030051,430,353,77,430,346,84,753,564,172,557,449,75
060376030052,403,324,79,409,321,88,686,515,160,543,431,82
060376030053,377,313,64,378,306,72,660,492,149,467,381,62
060376030081,207,171,36,208,169,39,331,258,66,205,164,32
060376030071,382,339,43,394,337,57,579,454,116,516,444,52
060376031011,398,305,93,404,299,105,618,456,150,470,349,96
060376031013,353,271,82,357,263,94,515,381,124,440,328,90
060376031023,324,245,79,334,249,85,445,316,120,366,283,67
060376032003,424,320,104,437,326,111,592,420,163,463,359,84
060376032001,174,126,48,177,125,52,274,198,76,227,167,50
060376032002,332,240,92,338,239,99,527,369,144,389,284,83
060376033012,365,270,95,372,272,100,565,399,158,423,304,93
060376033021,261,196,65,266,199,67,408,283,115,316,229,69
060376033022,542,397,145,556,401,155,920,649,256,625,448,142
060376033011,240,174,66,243,173,70,384,270,106,275,199,63
060376033013,306,221,85,314,221,93,492,343,136,338,243,77
060376033023,231,164,67,235,164,71,345,242,97,252,179,59
060376035003,321,234,87,324,226,98,477,330,140,393,260,104
060373003011,707,387,320,726,386,340,936,547,367,772,436,293
060373003014,369,202,167,378,201,177,492,299,184,393,223,149
060373008005,219,125,94,225,126,99,355,206,142,261,150,97
060373009014,754,431,323,775,436,339,1177,689,463,883,520,328
060373003012,484,287,197,488,280,208,664,404,245,568,337,200
060373003013,368,207,161,380,205,175,515,308,198,414,234,161
060373003015,294,174,120,296,170,126,409,253,150,338,200,121
060371013002,454,259,195,462,260,202,624,350,257,501,262,210
060373004006,409,247,162,418,242,176,565,345,204,458,268,170
060373004003,405,244,161,414,245,169,581,344,227,462,265,163
060373004004,309,189,120,316,188,128,445,276,164,351,207,124
060373004005,298,175,123,304,174,130,400,249,148,316,180,118
060373004001,438,274,164,444,274,170,724,425,282,486,290,160
060373004002,388,220,168,402,223,179,510,306,192,434,237,165
060373007014,667,377,290,685,378,307,920,558,344,761,412,300
060373003016,450,245,205,466,242,224,680,400,271,479,259,196
060373005012,493,310,183,511,323,188,757,466,284,578,350,190
060373006012,566,379,187,589,382,207,919,564,341,645,394,200
060373006011,767,479,288,781,483,298,1287,785,478,891,541,290
060373006023,653,412,241,662,410,252,917,538,363,758,436,272
060373006021,502,317,185,514,316,198,662,390,265,572,329,201
060373006022,329,200,129,336,200,136,472,284,181,378,212,137
060373008002,473,296,177,482,295,187,636,400,224,546,313,194
060373008003,673,411,262,678,404,274,889,557,316,733,412,270
060373008001,754,474,280,769,478,291,1182,692,460,907,529,316
060373008004,453,283,170,461,281,180,662,388,259,535,308,199
060373007015,792,450,342,815,448,367,1198,668,504,936,522,371
060373007011,328,211,117,338,211,127,486,290,187,396,240,136
060373007012,346,213,133,351,211,140,509,304,196,403,244,138
060373010001,479,344,135,488,341,147,639,387,235,561,367,161
060373010002,498,322,176,505,327,178,739,451,272,610,377,196
060373010004,420,275,145,432,279,153,630,378,238,453,275,158
060373011001,342,225,117,347,226,121,485,318,154,363,236,112
060373019011,608,429,179,617,430,187,990,588,390,735,476,217
060373019021,425,303,122,435,309,126,666,411,246,593,397,169
060373019022,366,254,112,376,257,119,550,334,212,436,285,130
060373007013,427,250,177,438,250,188,664,396,255,550,312,215
060373007021,1180,655,525,1225,653,572,1759,954,782,1437,771,603
060373007022,1109,637,472,1139,646,493,1613,851,737,1315,675,587
060373011003,511,339,172,522,340,182,697,455,222,510,315,169
060373011004,211,148,63,212,148,64,354,220,132,284,178,94
060373011005,407,295,112,411,293,118,653,367,274,513,328,159
060373011006,447,320,127,450,318,132,739,416,310,522,321,173
060373011002,376,247,129,382,249,133,507,339,164,403,261,125
060373016011,245,193,52,251,193,58,497,255,232,385,256,105
060373016014,219,167,52,228,168,60,447,226,211,326,216,87
060373015011,223,152,71,226,152,74,388,193,187,299,190,90
060373015021,436,285,151,442,283,159,757,409,331,518,315,171
060373015023,277,204,73,284,203,81,573,275,283,410,275,105
060373015024,177,126,51,182,129,53,362,174,179,276,183,75
060373012031,523,362,161,537,369,168,857,514,322,678,421,219
060373012032,722,498,224,738,497,241,1108,631,456,923,549,314
060373013001,408,231,177,412,233,179,524,280,234,445,254,165
060373013002,462,275,187,475,279,196,634,337,287,565,325,212
060373014002,487,309,178,494,318,176,702,359,326,610,335,244
060373014003,207,123,84,210,120,90,372,187,179,292,159,115
060373023022,248,195,53,253,195,58,451,286,156,333,240,78
060373023023,176,138,38,180,139,41,327,206,113,260,187,61
060373024011,268,219,49,272,218,54,438,266,161,351,253,82
060373024012,378,306,72,384,303,81,598,370,216,507,368,119
060373015012,260,160,100,265,155,110,458,229,224,380,213,142
060373022023,222,171,51,227,169,58,427,260,161,322,211,89
060373025033,168,125,43,169,120,49,313,168,139,239,147,73
060373025042,119,92,27,120,90,30,229,137,86,165,110,45
060373025052,94,73,21,96,71,25,200,132,64,129,86,35
060373012052,486,317,169,496,313,183,778,435,332,580,336,204
060373012063,298,194,104,305,189,116,448,259,177,355,221,113
060373022021,223,162,61,228,163,65,475,233,233,357,232,109
060373022022,293,218,75,300,218,82,663,337,319,482,308,151
060373012051,265,175,90,269,173,96,417,230,183,322,179,120
060373012041,370,280,90,382,281,101,695,442,242,484,327,126
060373012042,361,269,92,372,272,100,572,351,209,421,286,112
060373025051,285,223,62,285,223,62,493,325,158,362,273,67
060373025053,252,198,54,251,195,56,492,317,163,315,234,59
060373025062,387,312,75,388,301,87,619,408,196,480,356,94
060373017021,324,227,97,331,227,104,668,370,287,431,265,144
060373017022,355,247,108,363,247,116,656,364,286,465,294,153
060373017024,204,141,63,210,142,68,380,211,165,258,165,83
060373012061,357,238,119,371,236,135,750,409,325,513,325,157
060373012062,290,191,99,297,184,113,475,278,185,370,235,112
060373012064,264,176,88,273,176,97,589,317,260,400,252,122
060373023021,251,196,55,251,181,70,418,264,145,342,237,91
060373023024,216,170,46,217,157,60,419,264,150,276,191,73
060373024014,239,187,52,241,174,67,420,266,146,329,229,88
060373018021,581,450,131,587,433,154,1076,669,385,645,431,174
060373018022,458,344,114,465,336,129,883,536,325,522,346,146
060373016021,644,496,148,648,491,157,974,690,263,772,557,160
060373016022,285,218,67,286,212,74,386,275,106,319,237,66
060373016023,338,257,81,336,250,86,506,362,139,406,302,85
060373024013,336,278,58,343,278,65,676,438,226,369,270,87
060373024015,121,101,20,126,101,25,209,136,69,159,115,37
060373017011,426,296,130,432,292,140,628,353,269,518,342,148
060373018013,302,213,89,307,212,95,503,318,173,380,252,107
060373020041,414,317,97,424,313,111,780,475,291,558,387,145
060373021031,262,190,72,268,187,81,513,280,224,367,241,107
060373021032,386,277,109,395,276,119,773,450,309,559,347,181
060373018011,186,135,51,189,134,55,463,294,157,240,158,68
060373018012,670,489,181,686,489,197,1164,749,391,731,488,203
060373020021,248,175,73,254,178,76,443,261,174,281,175,87
060373023012,477,354,123,489,348,141,849,534,296,607,409,159
060373017023,223,155,68,231,157,74,479,264,209,289,185,93
060373016012,310,213,97,313,210,103,545,315,220,404,270,111
060373017012,504,339,165,506,334,172,738,434,299,612,383,194
060373016013,299,207,92,304,207,97,547,276,256,376,262,97
060373023011,327,243,84,335,238,97,585,365,209,484,330,126
060373010003,330,225,105,333,225,108,490,299,179,387,249,114
060373025061,143,117,26,144,112,32,216,142,68,168,124,34
060373025063,336,275,61,342,265,77,479,297,173,399,293,82
060373021022,304,235,69,312,228,84,573,388,173,407,272,111
060373021023,317,246,71,326,238,88,497,295,197,426,288,116
060373021024,343,264,79,351,264,87,466,319,141,383,265,96
060373021025,414,318,96,424,319,105,557,380,168,456,316,113
060373025031,276,200,76,280,193,87,533,269,254,387,231,129
060373025032,217,158,59,220,152,68,418,239,172,298,183,94
060373021033,280,199,81,290,202,88,564,299,258,416,266,131
060373025041,408,295,113,415,287,128,755,432,310,561,365,164
060373025043,121,88,33,122,84,38,214,123,88,166,109,49
060373021021,490,368,122,497,368,129,817,528,273,606,417,163
060373021042,290,221,69,295,220,75,485,298,180,348,243,90
060373020042,397,319,78,410,316,94,721,424,288,575,413,132
060373022011,171,121,50,177,124,53,309,152,156,235,153,70
060373022012,238,170,68,246,172,74,428,208,212,335,221,98
060373020031,435,328,107,450,329,121,790,458,320,600,391,168
060373020023,153,105,48,158,110,48,252,146,104,203,123,66
060373022013,427,310,117,437,309,128,746,427,302,564,360,166
060373020032,176,137,39,184,136,48,357,190,163,247,158,70
060373021041,203,161,42,205,157,48,331,205,117,255,184,56
060373021043,370,295,75,376,288,88,645,403,231,468,343,104
060373020022,500,344,156,507,351,156,832,495,322,636,391,204
060373019012,627,444,183,636,442,194,1061,652,385,817,527,241
060373009011,805,454,351,831,457,374,1176,648,511,920,510,369
060373009012,523,312,211,530,309,221,706,406,287,582,337,213
060373009013,567,329,238,575,330,245,803,453,334,645,359,247
060373009021,500,336,164,513,329,184,496,321,166,410,256,135
060373009022,788,529,259,807,518,289,814,525,271,682,427,227
060374607002,332,189,143,334,181,153,431,253,172,353,209,131
060374608002,861,510,351,866,503,363,1093,707,362,895,563,269
060373012043,346,265,81,362,268,94,660,372,273,427,288,109
060374005011,1122,398,724,1141,400,741,1468,621,814,1210,390,752
060374008011,416,175,241,426,177,249,557,267,280,490,209,253
060374008013,539,249,290,547,247,300,805,384,401,524,222,261
060374010022,697,327,370,709,327,382,884,412,450,754,338,358
060374010023,483,241,242,486,233,253,660,336,303,556,259,253
060374012011,649,310,339,662,303,359,883,444,417,765,336,364
060374004041,931,315,616,952,304,648,1302,524,750,1055,317,676
060374004043,768,245,523,786,246,540,1072,419,631,888,275,561
060374010011,662,245,417,675,233,442,913,372,518,750,277,433
060374010012,505,207,298,519,207,312,643,278,352,589,245,316
060374010013,373,139,234,380,134,246,540,231,297,418,156,240
060374011022,355,184,171,366,182,184,756,396,338,395,184,177
060374011021,404,213,191,423,210,213,633,325,294,550,258,246
060374039013,352,198,154,356,194,162,531,306,211,436,223,185
060374004022,812,355,457,828,349,479,1183,534,620,968,408,489
060374011011,385,173,212,393,171,222,545,242,288,467,202,232
060374012012,643,260,383,666,262,404,901,450,425,774,307,408
060374011012,297,151,146,305,150,155,691,366,306,512,257,215
060374011014,599,321,278,613,316,297,773,405,346,559,293,223
060374039021,266,136,130,273,131,142,427,219,199,317,154,136
060374039022,596,306,290,613,298,315,948,506,434,726,354,315
060374012032,906,466,440,934,458,476,1376,750,602,1110,530,507
060374012022,429,227,202,439,224,215,631,327,293,535,272,222
060374012031,965,505,460,986,502,484,1407,750,636,1144,549,520
060374039012,309,183,126,314,174,140,494,288,196,340,199,121
060374039023,588,350,238,596,339,257,943,547,371,704,377,281
060374010021,497,220,277,506,222,284,747,333,400,603,262,304
060374011013,490,218,272,498,216,282,740,343,373,609,251,311
060374012023,724,404,320,739,373,366,1053,543,486,857,447,366
060374004021,970,388,582,985,377,608,1328,570,731,1095,399,630
060374004042,512,174,338,519,170,349,590,228,350,581,181,365
060374011023,259,132,127,263,131,132,397,209,178,300,157,126
060290060112,539,123,416,546,121,425,761,190,557,588,113,448
060375016001,1255,739,516,1263,718,545,1646,1011,602,1394,828,476
060374086282,452,278,174,468,284,184,737,437,292,557,343,189
060374086283,319,197,122,333,201,132,558,329,221,404,250,136
060374086291,463,282,181,478,289,189,723,423,294,509,314,173
060374086231,876,557,319,901,547,354,1256,813,423,1065,692,332
060374086241,650,388,262,671,382,289,1008,629,362,761,468,254
060374084011,629,471,158,636,466,170,904,612,275,747,533,178
060374084012,557,415,142,566,394,172,920,630,271,702,505,158
060374085032,450,269,181,459,258,201,624,365,248,474,295,163
060374085034,602,335,267,616,326,290,876,512,349,671,389,249
060374085033,723,393,330,741,385,356,1100,649,432,806,457,307
060374091003,401,302,99,408,286,122,627,427,182,481,347,110
060374091001,194,149,45,196,142,54,310,218,82,268,195,58
060374091002,343,260,83,348,250,98,559,386,161,443,320,97
060374086313,608,413,195,617,401,216,875,581,271,692,447,200
060374086311,462,306,156,469,296,173,688,461,212,548,366,154
060374086242,362,214,148,368,214,154,566,346,214,396,233,143
060374086252,453,272,181,459,269,190,656,401,247,503,298,183
060374086312,378,268,110,388,265,123,597,398,184,454,314,99
060374085031,582,339,243,595,330,265,825,516,289,671,389,247
060374086251,465,270,195,475,271,204,701,430,265,526,313,191
060374086253,579,340,239,598,342,256,858,521,324,655,393,234
060374086281,678,381,297,706,394,312,1017,620,383,723,448,236
060374091004,362,271,91,367,254,113,566,380,172,423,303,100
060374086292,504,303,201,521,308,213,746,456,283,551,332,197
060374084021,510,339,171,522,329,193,723,459,249,582,383,176
060374084022,566,340,226,575,328,247,825,503,309,633,369,237
060374085051,470,291,179,479,294,185,732,438,276,531,341,161
060374085052,458,289,169,463,285,178,690,415,262,508,324,157
060374085041,392,267,125,395,257,138,634,420,195,482,321,140
060374085043,299,204,95,299,195,104,541,344,185,362,243,106
060374084023,1003,687,316,1019,662,357,1496,972,495,1186,792,335
060374085042,554,352,202,570,343,227,862,542,299,638,398,200
060375551062,376,281,95,379,269,110,640,452,170,450,348,79
060375551061,251,189,62,256,184,72,443,312,116,298,227,52
060375552121,413,327,86,420,317,103,693,495,182,492,381,79
060375552111,316,263,53,316,245,71,511,384,122,368,299,52
060375552113,424,347,77,426,325,101,700,520,156,480,381,71
060375552112,323,275,48,324,257,67,512,373,128,400,331,51
060376021041,555,489,66,556,483,73,954,767,162,763,666,63
060376021042,534,468,66,537,461,76,888,718,158,696,600,66
060376021051,437,383,54,450,381,69,665,557,106,398,331,47
060376021052,436,381,55,437,379,58,672,544,127,454,388,45
060376021032,352,305,47,353,298,55,552,437,97,454,362,63
060376022022,323,274,49,326,267,59,551,427,107,454,367,58
060376021061,575,482,93,574,460,114,927,715,188,745,623,86
060376021063,301,243,58,304,232,72,407,316,83,344,277,54
060376023023,344,214,130,355,213,142,1221,907,293,374,230,121
060376025071,474,427,47,482,424,58,874,720,131,592,519,52
060376025072,388,353,35,398,348,50,716,579,117,483,423,42
060376020021,250,227,23,254,229,25,440,362,70,321,291,21
060376020022,417,377,40,427,379,48,658,539,106,503,450,33
060376024031,257,226,31,261,229,32,405,320,74,311,267,28
060376024032,425,370,55,426,365,61,650,516,114,533,450,58
060376024033,345,289,56,352,284,68,535,398,125,464,375,63
060376024041,366,298,68,377,293,84,609,450,140,491,390,71
060376024043,503,424,79,510,417,93,846,630,198,626,525,69
060376025052,233,204,29,233,200,33,346,276,60,297,260,24
060376024042,382,310,72,390,304,86,616,456,144,467,374,67
060376021031,399,351,48,399,342,57,656,516,122,523,458,39
060376024021,360,289,71,376,287,89,567,426,118,424,335,69
060376024022,452,356,96,463,354,109,708,509,179,549,420,97
060376017002,231,207,24,233,202,31,419,332,77,287,256,20
060376017001,245,222,23,249,217,32,467,369,88,325,292,22
060376021033,531,470,61,535,459,76,876,702,154,682,596,57
060376024024,421,314,107,422,305,117,606,445,147,520,370,117
060376024025,472,345,127,476,333,143,639,477,151,557,390,131
060376025101,307,273,34,313,274,39,530,427,90,378,331,29
060376025102,360,320,40,363,316,47,553,443,100,433,376,40
060376025112,295,262,33,300,266,34,534,439,81,374,327,30
060376025111,374,330,44,376,329,47,550,448,87,443,387,42
060376025041,549,494,55,560,496,64,865,703,136,625,553,45
060376025051,388,346,42,396,346,50,657,519,114,521,450,48
060376023015,3,2,1,4,2,2,1,1,0,1,1,0
060376039012,408,314,94,411,311,100,591,457,128,521,397,99
060376023021,359,222,137,369,222,147,459,295,150,405,247,131
060376023022,340,206,134,350,206,144,442,286,145,366,227,116
060376023024,709,460,249,724,459,265,942,648,267,772,477,247
060376025131,339,300,39,347,309,38,554,453,76,430,380,34
060376022021,311,247,64,317,242,75,557,418,125,452,354,75
060376027001,850,799,51,866,809,57,1107,1010,77,758,708,33
060376027002,1056,976,80,1065,980,85,1379,1256,100,1375,1249,71
060376037051,664,597,67,663,579,84,1051,870,162,846,715,91
060376021062,524,436,88,506,409,97,770,590,163,670,541,92
060376024023,398,305,93,396,301,95,585,424,150,498,364,104
060376025042,317,284,33,320,283,37,563,464,83,389,338,33
060376025061,390,354,36,395,358,37,610,518,81,448,401,28
060376037031,504,333,171,512,328,184,814,540,268,608,428,140
060376037032,386,257,129,393,252,141,618,400,196,453,285,139
060376025062,468,425,43,466,420,46,747,635,99,552,484,46
060376210056,502,320,182,514,321,193,706,483,210,561,338,174
060376210051,344,218,126,339,208,131,449,307,134,442,271,134
060376210053,418,265,153,430,267,163,516,352,153,533,333,157
060376210055,352,225,127,353,220,133,492,335,147,313,195,93
060376210054,479,303,176,484,300,184,612,416,180,487,301,149
060376210052,699,444,255,715,437,278,950,643,276,834,510,258
060376211042,320,205,115,332,210,122,454,308,131,377,236,107
060376211043,391,251,140,396,248,148,569,390,167,465,283,137
060376211045,438,279,159,448,281,167,563,386,164,478,293,141
060376211044,1028,694,334,1065,704,361,1510,1019,436,1139,745,293
060376208023,500,297,203,516,298,218,685,449,218,575,342,202
060376210013,951,630,321,966,638,328,1258,898,327,1233,792,344
060376211041,757,534,223,777,537,240,1025,714,278,692,466,169
060376212042,296,190,106,300,188,112,401,260,132,330,196,114
060376210012,589,405,184,598,404,194,777,557,202,646,431,165
060376210011,594,393,201,609,398,211,792,567,208,661,434,168
060376211021,565,375,190,580,382,198,732,518,192,713,471,181
060376211022,941,659,282,958,658,300,1275,899,333,952,656,237
060371373022,1273,792,481,1289,788,501,1760,1137,591,1444,939,445
060371370002,1250,823,427,1263,813,450,1697,1044,621,1387,922,414
060375335042,242,211,31,246,208,38,400,312,80,302,267,23
060375335043,218,192,26,225,190,35,371,289,73,361,314,26
060375335041,207,181,26,213,179,34,329,260,65,243,215,18
060375331032,244,217,27,242,201,41,399,327,54,354,304,21
060375331031,150,133,17,150,125,25,242,197,34,216,187,14
060375325003,331,296,35,334,288,46,542,432,94,481,422,36
060375331051,322,287,35,324,281,43,527,436,86,411,375,25
060375332011,134,121,13,137,121,16,235,187,40,167,152,9
060375332012,269,240,29,269,228,41,422,341,71,366,323,27
060375326072,194,178,16,192,168,24,263,215,44,196,173,13
060375326075,147,134,13,151,132,19,237,203,33,218,195,16
060375326073,126,113,13,127,111,16,210,178,30,199,173,15
060375326074,132,120,12,135,118,17,220,188,31,203,175,17
060375326071,264,238,26,266,231,35,369,299,65,302,264,23
060375326051,323,288,35,333,285,48,537,430,92,420,364,32
060375331041,159,140,19,160,137,23,288,230,53,211,182,17
060375331042,280,249,31,283,242,41,535,426,97,412,358,35
060375345011,334,294,40,340,284,56,546,433,102,421,355,42
060375345012,290,259,31,296,251,45,465,369,86,378,326,31
060375345022,434,385,49,437,370,67,703,570,122,590,503,54
060375326062,196,174,22,197,168,29,297,246,51,263,232,20
060375326063,150,133,17,150,128,22,271,219,43,211,183,16
060375331083,256,227,29,255,219,36,446,364,77,351,308,27
060375331081,263,237,26,265,230,35,482,378,91,363,313,32
060375331082,208,185,23,209,178,31,440,346,79,335,292,32
060375332041,242,215,27,238,204,34,355,291,62,304,261,27
060375332042,288,256,32,285,240,45,450,369,74,368,317,31
060375332043,293,265,28,292,256,36,471,375,89,386,335,32
060375345013,386,351,35,389,339,50,640,515,111,505,443,34
060375347002,456,410,46,469,397,72,706,573,122,595,510,48
060375355021,362,330,32,369,318,51,577,471,93,448,408,24
060375345021,401,358,43,406,343,63,684,555,111,553,474,53
060375335011,242,215,27,242,211,31,377,307,60,81,72,5
060375335012,249,224,25,249,217,32,404,327,72,552,487,37
060375325002,244,220,24,245,209,36,361,288,68,280,243,21
060375326052,245,217,28,250,209,41,391,312,71,284,251,20
060375326061,216,190,26,215,181,34,333,259,63,258,225,21
060375325001,105,96,9,106,93,13,148,120,28,141,124,10
060379800161,48,37,11,48,36,12,101,69,32,153,130,15
060374033262,240,136,104,243,138,105,353,205,142,299,184,103
060374082122,433,274,159,440,266,174,794,473,313,585,370,178
060374077012,446,372,74,456,365,91,665,496,155,557,436,88
060374077022,475,353,122,490,343,147,769,547,209,671,486,150
060374078021,19,9,10,20,9,11,27,12,13,21,6,14
060376008011,436,407,29,451,416,35,544,507,25,547,510,20
060376008014,455,420,35,470,428,42,610,572,34,495,461,20
060376009121,653,602,51,654,585,69,939,822,102,820,732,52
060376009122,555,514,41,560,507,53,815,698,92,608,547,33
060376009123,308,290,18,311,288,23,456,398,46,351,323,16
060376007023,846,791,55,866,800,66,1102,1022,73,942,887,31
060376014022,355,295,60,363,295,68,511,419,78,440,368,47
060376014023,229,195,34,236,197,39,342,275,57,272,231,29
060376015011,249,229,20,252,228,24,422,355,54,325,289,19
060376015012,252,233,19,255,233,22,444,381,55,329,293,17
060376007031,1152,1095,57,1175,1118,57,1333,1264,57,1589,1487,63
060376008021,475,449,26,483,453,30,592,538,44,767,717,26
060376008022,375,354,21,382,357,25,464,423,35,396,372,13
060376008023,403,382,21,413,385,28,545,491,41,114,108,3
060376009022,363,332,31,380,339,41,578,516,51,415,379,20
060376009023,237,216,21,244,218,26,416,365,43,291,270,14
060376008012,421,401,20,443,414,29,536,504,24,510,481,18
060376007021,508,478,30,519,484,35,640,590,39,562,524,23
060376007042,805,735,70,817,737,80,988,910,64,887,809,52
060376007041,715,663,52,736,671,65,943,889,54,593,551,20
060376012111,401,380,21,406,375,31,582,510,57,474,434,24
060376012112,381,357,24,390,356,34,567,494,60,489,447,25
060376007022,555,529,26,558,526,32,676,614,51,612,586,12
060376013023,523,488,35,535,490,45,687,620,52,575,527,31
060376013024,712,668,44,722,663,59,998,886,84,916,841,44
060376008013,364,345,19,372,349,23,457,428,27,321,302,10
060376006021,356,333,23,357,329,28,618,554,59,465,430,17
060376019001,478,449,29,488,452,36,841,734,87,562,520,18
060376006012,499,463,36,506,468,38,650,601,41,610,564,28
060376006013,417,380,37,417,379,38,499,459,31,455,415,26
060376005011,684,646,38,710,663,47,825,753,61,776,735,23
060376005012,546,506,40,559,518,41,786,702,66,659,605,35
060376010011,374,337,37,376,336,40,487,436,41,413,370,22
060376010012,597,551,46,609,566,43,759,677,64,655,595,36
060376042001,419,397,22,430,399,31,576,523,47,521,476,30
060376042002,523,490,33,525,493,32,692,622,60,604,562,25
060376042003,540,509,31,540,499,41,801,687,95,718,669,24
060376010023,652,604,48,655,607,48,859,766,79,721,664,31
060376010021,359,334,25,364,331,33,560,488,56,409,371,22
060376010022,480,438,42,489,434,55,757,664,76,600,542,35
060376011003,427,385,42,441,397,44,778,646,112,509,455,34
060376014011,635,592,43,635,574,61,870,759,91,691,624,46
060376014013,464,408,56,468,405,63,782,662,109,577,499,55
060376011002,437,414,23,439,412,27,583,517,53,523,479,12
060376017003,225,204,21,225,197,28,411,324,75,291,264,17
060376018012,393,364,29,394,357,37,624,512,97,518,464,30
060376018011,213,198,15,214,193,21,344,289,53,269,246,14
060376018023,240,215,25,240,211,29,321,270,46,263,231,21
060376019002,355,335,20,365,339,26,575,504,63,461,430,14
060376020032,520,491,29,523,473,50,756,656,89,704,639,33
060376012121,430,392,38,441,392,49,664,568,80,531,474,33
060376012122,314,284,30,318,282,36,444,383,54,381,340,25
060376014012,295,257,38,303,260,43,522,455,58,369,315,35
060376014021,396,351,45,405,351,54,590,489,97,490,430,43
060376011001,355,333,22,362,333,29,547,483,48,367,332,20
060376013022,677,627,50,685,630,55,951,857,74,773,705,38
060376012021,377,338,39,382,329,53,552,460,87,483,432,33
060376012023,282,246,36,285,241,44,418,351,63,374,329,29
060376012022,330,280,50,337,280,57,512,440,72,409,359,35
060376014024,254,222,32,256,223,33,348,287,59,325,283,30
060376012124,234,215,19,240,217,23,363,315,44,283,257,16
060376012123,374,341,33,375,336,39,552,474,68,466,422,26
060376013032,321,302,19,330,304,26,461,420,32,382,355,15
060376013033,589,549,40,601,554,47,886,788,76,741,683,29
060376013012,604,542,62,609,544,65,738,658,71,652,568,55
060376009024,775,717,58,786,717,69,1043,937,83,773,707,37
060376013031,381,357,24,389,359,30,593,525,50,486,452,18
060376009021,368,338,30,368,334,34,590,506,70,483,441,28
060376009111,407,381,26,407,363,44,622,534,74,481,426,32
060376009112,713,653,60,718,644,74,938,804,111,775,677,50
060376013011,433,389,44,434,386,48,550,491,48,452,392,41
060377030023,1551,1423,128,1560,1419,141,1821,1692,117,1627,1474,107
060376013021,195,185,10,196,181,15,282,254,23,253,236,9
060376006011,305,287,18,310,292,18,430,394,27,357,332,13
060376020031,461,423,38,459,417,42,776,662,90,554,475,42
060376042004,410,383,27,413,377,36,697,624,62,549,506,26
060374600011,822,477,345,829,472,357,940,580,343,895,502,342
060374600021,826,466,360,835,460,375,1133,668,439,921,508,361
060374605011,903,505,398,909,495,414,1179,748,411,944,524,359
060374606011,716,401,315,725,397,328,914,548,350,757,425,287
060374606012,557,312,245,573,318,255,719,459,249,620,359,222
060374606013,835,464,371,855,465,390,1111,687,406,906,507,340
060374605012,489,271,218,487,263,224,648,410,226,568,312,218
060374605021,701,402,299,720,397,323,951,603,330,754,471,237
060374607005,787,415,372,802,413,389,1040,625,400,838,470,323
060374605013,1349,779,570,1375,777,598,1752,1120,601,1469,876,508
060374605023,782,469,313,802,467,335,1013,655,343,878,541,291
060374605022,695,362,333,707,353,354,875,555,307,742,428,264
060374607001,386,198,188,393,194,199,538,336,195,467,247,192
060374607003,381,207,174,391,204,187,490,292,195,411,230,160
060374607004,683,328,355,697,326,371,920,562,338,739,379,314
060374606014,469,254,215,475,248,227,668,387,268,505,261,210
060373005033,513,322,191,525,307,218,857,513,330,634,376,211
060373001001,858,530,328,878,533,345,1063,688,360,913,530,326
060373001003,615,376,239,627,380,247,814,526,271,704,427,225
060373001004,771,469,302,786,471,315,1098,695,377,904,530,304
060373001002,525,322,203,536,323,213,710,444,248,595,352,211
060373002002,423,269,154,426,263,163,589,384,194,473,281,166
060373002003,265,171,94,265,168,97,397,266,125,289,172,104
060373002004,295,190,105,297,189,108,454,301,143,316,192,110
060373002005,595,359,236,597,358,239,907,561,316,692,426,228
060373002001,539,327,212,537,313,224,739,452,266,597,365,199
060373005011,589,360,229,609,374,235,882,532,331,673,402,227
060375002041,1073,437,636,1087,430,657,1391,616,749,1113,440,614
060375001003,339,132,207,341,125,216,462,206,250,380,145,214
060375001001,661,258,403,675,250,425,854,366,469,698,267,393
060375040022,325,168,157,326,162,164,477,261,207,393,199,163
060375040023,265,138,127,265,131,134,387,228,152,308,155,127
060375040024,302,148,154,308,148,160,439,252,175,349,168,157
060375040021,513,237,276,528,235,293,704,389,300,590,276,278
060375040025,513,245,268,523,246,277,709,399,295,585,271,273
060375037041,586,323,263,600,325,275,1073,595,463,703,429,250
060375037042,909,451,458,936,457,479,1387,736,628,1107,586,477
060375040011,471,247,224,484,249,235,674,359,299,521,276,208
060375040012,533,264,269,548,263,285,695,343,336,602,300,260
060375040013,455,241,214,458,226,232,635,312,305,568,263,263
060375038021,395,215,180,404,208,196,582,301,269,451,241,181
060375038023,902,478,424,920,464,456,1364,726,617,1029,552,418
060375037051,792,366,426,811,355,456,1072,531,528,912,417,445
060375037052,579,282,297,595,280,315,931,463,454,715,384,301
060375036011,864,444,420,880,428,452,1315,695,594,1012,512,442
060375036021,641,320,321,650,304,346,899,472,410,697,328,324
060375036022,1051,477,574,1084,480,604,1435,701,706,1255,554,627
060375039022,525,292,233,529,282,247,836,444,367,636,340,252
060375039021,579,292,287,594,284,310,901,462,425,731,329,356
060375039023,560,279,281,572,267,305,847,427,400,662,332,281
060375039012,596,309,287,604,306,298,879,494,372,771,393,330
060375039024,2,1,1,2,1,1,29,19,10,27,16,10
060375039011,378,190,188,386,189,197,576,311,253,464,239,192
060375038022,387,198,189,389,190,199,616,320,282,467,253,191
060375038011,423,235,188,427,228,199,652,365,280,488,259,199
060375038013,493,268,225,499,263,236,792,413,361,554,291,232
060375038012,427,226,201,430,224,206,626,334,274,477,245,200
060375036012,311,187,124,314,180,134,505,277,214,374,211,140
060375036013,326,197,129,329,189,140,509,281,217,405,227,150
060375041011,736,506,230,736,481,255,1258,719,512,928,606,269
060375041012,395,275,120,397,260,137,668,418,239,515,344,140
060375041013,270,187,83,276,181,95,429,268,154,362,246,92
060374077011,228,172,56,229,167,62,379,258,113,313,249,43
060374077013,216,172,44,223,169,54,369,273,87,275,218,38
060374077023,285,226,59,293,222,71,463,337,115,387,296,71
060374077024,508,423,85,511,410,101,785,576,196,595,481,91
060374076022,249,191,58,254,186,68,381,260,113,263,198,55
060374076023,278,223,55,282,213,69,408,290,103,373,297,54
060374077021,355,260,95,356,250,106,524,356,158,366,262,84
060374075012,158,131,27,160,123,37,243,178,59,200,157,31
060374075013,227,180,47,225,169,56,394,279,109,310,226,58
060374076011,345,286,59,347,267,80,569,426,130,406,319,63
060374076012,250,208,42,254,197,57,396,286,95,301,235,47
060374072022,456,385,71,460,368,92,716,521,179,576,461,80
060374073014,219,186,33,220,180,40,364,261,100,273,217,41
060374076013,169,137,32,171,130,41,267,199,60,215,171,35
060374076021,197,156,41,198,150,48,351,248,89,286,219,51
060374076024,212,172,40,212,162,50,317,243,71,283,229,41
060374071022,380,318,62,385,306,79,717,535,152,560,456,74
060374071023,318,270,48,318,258,60,533,399,115,414,342,52
060374071011,243,198,45,250,188,62,364,267,90,293,230,48
060374071012,461,382,79,464,360,104,708,535,161,563,456,84
060374071021,356,289,67,362,272,90,536,392,129,441,345,72
060374069031,108,87,21,110,82,28,162,118,41,135,105,23
060374071013,402,338,64,404,321,83,645,485,143,514,424,71
060374072011,479,397,82,487,385,102,746,546,177,580,461,90
060374072012,311,258,53,317,254,63,508,385,114,383,306,59
060374072021,452,374,78,452,347,105,653,489,145,536,427,83
060372964023,423,305,118,429,300,129,570,392,169,523,347,148
060376099001,327,222,105,327,213,114,457,293,149,323,193,101
060376099002,254,174,80,254,166,88,340,219,110,232,138,71
060374089002,650,342,308,663,333,330,908,475,418,770,378,342
060374016011,485,236,249,493,233,260,719,378,329,556,240,295
060374016023,390,216,174,399,211,188,608,336,262,460,254,171
060374089001,789,436,353,804,422,382,1089,590,480,929,481,389
060374016021,1089,587,502,1119,587,532,1656,912,698,1402,714,577
060374017062,574,387,187,578,388,190,875,603,255,681,446,190
060374015001,788,468,320,808,457,351,1139,659,456,948,527,351
060374022003,913,598,315,925,575,350,1392,907,448,1101,722,324
060374015002,710,395,315,726,384,342,1010,568,423,827,412,360
060374002093,889,359,530,912,353,559,1196,508,669,974,396,520
060374002081,835,354,481,850,348,502,1107,482,604,909,367,491
060374002071,983,396,587,1004,393,611,1346,626,697,1092,437,592
060374002072,675,288,387,678,277,401,913,426,467,710,303,368
060374016022,538,293,245,552,285,267,751,421,324,432,232,172
060374003043,514,266,248,522,257,265,741,389,335,596,299,266
060374015003,304,163,141,312,159,153,469,260,195,366,204,140
060374004032,739,349,390,757,341,416,1015,502,495,841,401,386
060374002091,672,259,413,685,251,434,939,402,521,778,306,427
060374002073,632,218,414,646,211,435,849,365,471,686,248,413
060374016013,649,313,336,658,308,350,956,501,438,706,353,309
060374017061,630,382,248,645,388,257,1000,649,325,775,441,281
060377030022,735,651,84,746,654,92,883,797,77,805,720,70
060377031004,557,519,38,566,523,43,760,701,50,707,639,38
060377031005,430,398,32,436,401,35,584,538,36,567,510,33
060377030021,756,695,61,764,705,59,963,885,67,835,769,40
060375700031,372,209,163,384,211,173,587,331,236,461,265,168
060375700032,342,199,143,351,198,153,507,291,204,418,245,149
060375700033,357,223,134,359,216,143,537,305,217,401,241,136
060375550022,675,403,272,684,396,288,1030,640,370,764,428,275
060375700021,371,198,173,377,205,172,528,292,224,440,240,168
060375700023,442,247,195,450,248,202,622,341,261,521,278,205
060375700011,504,256,248,517,259,258,704,399,286,586,294,250
060375700012,297,150,147,307,153,154,427,243,177,358,182,153
060375700013,514,273,241,530,273,257,780,442,315,621,323,254
060375700014,336,179,157,345,178,167,540,305,221,408,212,166
060375700022,292,168,124,297,164,133,397,221,170,341,180,136
060375709011,513,260,253,528,264,264,776,437,324,609,310,262
060375708001,525,320,205,528,309,219,706,427,261,590,328,213
060375708003,468,279,189,477,277,200,657,411,228,525,303,184
060375708004,371,217,154,380,213,167,565,339,210,439,254,151
060375708005,377,221,156,386,217,169,529,323,198,421,248,144
060375709021,400,209,191,408,204,204,583,321,254,482,252,210
060375709023,460,240,220,472,236,236,681,372,295,544,280,236
060375709012,463,240,223,477,239,238,662,373,277,530,272,224
060375708002,529,307,222,538,307,231,692,445,230,599,331,228
060375709022,597,304,293,609,309,300,845,456,368,684,360,290
060375707012,751,588,163,763,577,186,1140,766,348,863,610,209
060375707015,854,581,273,875,569,306,1239,834,383,957,637,265
060375709015,426,227,199,435,215,220,577,299,265,485,246,212
060375709014,386,196,190,395,193,202,537,279,248,435,222,191
060375709013,631,310,321,643,309,334,946,491,435,766,347,373
060375700034,536,338,198,555,334,221,783,518,241,663,431,172
060375707011,279,179,100,284,176,108,420,283,128,353,221,99
060375707031,575,363,212,581,354,227,845,555,268,632,410,186
060375707032,820,570,250,831,570,261,1149,757,364,940,638,252
060375707013,265,166,99,272,165,107,362,252,107,300,190,90
060375707014,347,217,130,355,214,141,464,318,136,366,218,128
060375713002,480,292,188,485,283,202,635,397,226,498,294,174
060375713003,631,381,250,641,363,278,894,557,318,743,430,261
060375713004,307,187,120,312,180,132,446,262,173,376,216,133
060375713001,561,341,220,571,333,238,812,478,314,664,391,237
060375714001,451,291,160,467,287,180,644,439,201,487,297,163
060375720011,813,601,212,828,594,234,1037,766,243,838,581,199
060375714002,529,352,177,541,340,201,728,485,227,593,357,193
060375714004,553,348,205,569,339,230,748,473,260,635,389,206
060375714003,448,283,165,459,272,187,602,377,213,503,292,181
060375711011,285,143,142,296,142,154,406,216,184,325,150,151
060375711012,346,174,172,358,172,186,489,259,221,410,190,190
060375711015,318,160,158,329,157,172,462,247,206,368,175,172
060375711013,465,244,221,475,237,238,649,362,275,560,290,236
060375711014,553,289,264,560,279,281,757,419,323,640,327,271
060375710001,476,240,236,490,237,253,664,348,306,531,258,241
060375710006,566,286,280,577,278,299,796,413,363,655,319,295
060375710002,400,206,194,410,202,208,559,302,243,452,226,197
060375710004,338,169,169,344,166,178,505,274,225,405,200,181
060375710005,333,162,171,346,162,184,457,248,201,381,183,174
060375711023,406,229,177,413,229,184,548,303,233,456,259,165
060375711024,281,160,121,286,159,127,389,216,165,318,180,114
060375712011,481,259,222,493,260,233,645,377,254,554,290,229
060375711021,338,172,166,346,171,175,471,252,209,392,199,165
060375711022,376,191,185,382,188,194,553,301,231,420,216,180
060375711025,301,154,147,307,152,155,444,246,190,365,183,152
060375710003,439,228,211,444,222,222,620,336,270,474,241,204
060375737001,674,365,309,684,366,318,865,535,314,742,407,296
060375550011,419,273,146,425,257,168,642,399,230,471,288,150
060375550014,313,214,99,309,209,100,404,281,115,370,259,87
060375551053,274,202,72,278,196,82,516,358,144,350,255,72
060375551052,273,202,71,276,194,82,480,334,138,355,259,73
060375551051,373,273,100,378,264,114,674,461,193,450,342,84
060375551072,702,463,239,716,454,262,1091,710,359,822,516,253
060375550021,335,239,96,343,237,106,544,374,156,395,276,91
060375551071,364,255,109,375,255,120,545,393,146,407,270,107
060375550012,343,252,91,349,246,103,646,407,224,385,269,92
060375550013,386,283,103,392,276,116,675,470,189,494,350,119
060375551054,307,215,92,314,214,100,485,348,129,402,268,100
060379008051,497,274,223,508,276,232,683,392,272,555,274,239
060379008052,634,348,286,643,348,295,935,531,383,666,364,250
060379010082,192,116,76,197,117,80,343,195,139,259,143,98
060379008053,434,223,211,445,228,217,559,330,220,469,210,225
060379006061,574,389,185,579,380,199,854,578,247,773,503,215
060379006072,412,271,141,419,266,153,592,399,175,493,293,169
060379006062,148,103,45,151,103,48,259,184,75,223,163,50
060379006071,365,269,96,372,267,105,612,417,174,523,340,148
060379007012,261,167,94,261,160,101,377,222,145,350,205,124
060379007013,393,249,144,388,234,154,616,363,233,490,281,174
060379007031,308,198,110,317,202,115,589,305,266,499,272,191
060379007032,207,132,75,209,127,82,315,201,102,253,149,89
060379007033,425,273,152,426,261,165,689,440,223,418,246,146
060379005061,530,376,154,536,357,179,867,596,248,683,445,203
060379005062,515,365,150,521,345,176,891,597,267,719,479,200
060379005013,655,435,220,665,429,236,1023,678,313,831,562,215
060379005052,580,374,206,593,366,227,905,606,285,731,413,273
060379007011,278,175,103,277,167,110,433,255,163,361,208,130
060379007014,201,127,74,199,120,79,343,202,129,243,140,87
060379005041,364,226,138,370,219,151,588,360,217,493,295,167
060379005042,815,504,311,824,492,332,1345,814,490,930,525,352
060379005043,769,476,293,776,475,301,1037,630,377,801,465,306
060379005093,173,111,62,177,108,69,273,171,94,188,122,53
060379005103,257,175,82,265,171,94,407,260,134,328,209,98
060379005082,603,332,271,608,316,292,973,555,394,656,335,276
060379005081,552,341,211,569,335,234,851,485,342,752,412,289
060379006022,430,306,124,435,288,147,747,510,217,553,365,156
060379008082,347,226,121,353,223,130,591,394,180,434,274,132
060379008041,355,263,92,362,257,105,662,442,200,524,371,122
060379008042,238,175,63,240,171,69,403,267,122,326,232,75
060379010091,1017,394,623,1028,398,630,1388,646,708,1116,446,600
060379003011,826,434,392,837,420,417,1210,687,495,1238,500,682
060379006101,274,171,103,275,161,114,435,273,152,481,273,177
060379006111,656,461,195,669,457,212,1166,772,361,820,528,240
060379012151,766,295,471,777,289,488,1006,404,584,864,303,516
060379009011,336,194,142,341,194,147,627,361,247,319,178,122
060379010121,505,268,237,508,266,242,909,499,386,546,267,246
060379011012,985,480,505,999,470,529,1556,734,780,1203,466,657
060379006021,364,260,104,367,244,123,588,400,171,539,353,152
060379010122,989,504,485,996,495,501,1699,910,745,1169,572,525
060379011023,752,294,458,747,283,464,996,394,581,928,364,505
060379006102,412,265,147,414,247,167,618,350,255,212,121,78
060379006112,268,173,95,269,160,109,419,278,129,272,174,82
060379006081,582,394,188,585,395,190,864,576,267,670,429,195
060379006082,329,222,107,331,222,109,486,326,150,372,220,119
060379008061,344,237,107,347,230,117,694,476,204,591,384,175
060379010092,257,145,112,261,141,120,448,243,192,358,184,149
060379005011,481,331,150,487,328,159,723,479,214,554,362,160
060379005051,527,352,175,538,354,184,723,477,225,621,416,175
060379008081,470,304,166,475,301,174,775,448,299,546,312,198
060379008071,717,442,275,729,441,288,1168,705,430,897,531,315
060379006091,244,180,64,247,178,69,365,246,105,239,157,70
060379006092,403,295,108,406,293,113,670,494,158,487,318,146
060379006093,384,282,102,392,282,110,631,465,146,487,337,120
060379007052,631,343,288,633,330,303,976,531,412,831,414,364
060379007051,551,251,300,555,246,309,681,377,281,547,294,214
060379007053,193,105,88,195,103,92,279,160,108,178,90,77
060379005012,437,306,131,445,305,140,718,476,213,629,429,162
060379010071,339,129,210,340,129,211,535,225,299,362,129,216
060379102111,798,311,487,794,306,488,1077,447,608,827,310,470
060379010101,447,225,222,451,223,228,701,364,315,609,272,303
060379010103,371,181,190,374,178,196,622,327,282,458,242,188
060379010104,351,172,179,359,171,188,542,284,245,513,215,270
060379010111,879,440,439,896,439,457,1218,594,596,984,455,466
060379010113,430,215,215,441,216,225,622,310,297,522,242,244
060379008062,449,310,139,448,300,148,871,598,249,709,457,203
060379010072,490,162,328,497,158,339,603,300,295,594,209,357
060379005101,248,179,69,253,178,75,435,299,126,328,209,103
060379005092,145,106,39,148,105,43,256,175,73,186,118,58
060379005102,295,203,92,300,197,103,492,319,158,339,225,96
060379005091,468,322,146,479,314,165,763,495,244,615,392,182
060379010081,587,337,250,597,336,261,1008,560,418,782,367,363
060379010093,688,344,344,693,318,375,960,523,417,799,331,416
060379007041,441,315,126,444,311,133,799,457,311,560,334,186
060379007042,144,103,41,143,100,43,242,138,94,176,106,58
060379010141,546,250,296,548,245,303,875,440,408,629,264,321
060379010131,728,337,391,739,332,407,1039,527,480,860,376,433
060379010142,953,511,442,969,510,459,1708,923,734,1113,539,512
060379010102,438,227,211,445,228,217,717,362,333,643,292,312
060379012141,828,358,470,843,366,477,1414,664,717,1058,442,564
060379010112,503,254,249,511,248,263,726,363,346,524,242,252
060379008072,496,277,219,506,279,227,843,498,319,666,362,256
060379012142,412,191,221,425,195,230,690,327,352,552,257,253
060379012152,805,337,468,821,346,475,1194,481,693,937,325,560
060379010132,666,301,365,678,298,380,1025,518,475,706,320,345
060376039011,660,528,132,674,530,144,1017,770,222,821,645,129
060376039022,372,289,83,378,288,90,562,415,135,454,340,84
060376038012,194,147,47,199,148,51,349,257,85,262,197,46
060376038013,226,180,46,230,179,51,357,263,88,252,189,42
060376038021,528,397,131,539,402,137,947,677,244,761,577,133
060376038011,541,444,97,551,438,113,773,583,172,578,490,64
060376039021,475,374,101,483,369,114,713,515,173,584,435,102
060376040011,383,303,80,389,303,86,651,467,165,488,378,88
060376040012,383,299,84,392,299,93,638,449,171,456,331,95
060376041011,280,225,55,282,220,62,514,372,141,409,313,72
060376041012,263,209,54,271,208,63,494,343,133,356,272,64
060376041013,254,203,51,257,200,57,441,315,118,343,266,58
060376041022,347,258,89,351,256,95,540,378,146,383,270,88
060376041021,328,242,86,335,242,93,519,366,141,393,289,80
060376038022,392,289,103,401,291,110,524,372,141,466,359,78
060376040021,238,181,57,241,177,64,395,277,109,285,212,56
060376040022,469,358,111,477,351,126,768,541,204,580,437,117
060376040023,195,144,51,199,142,57,318,227,86,249,188,50
060376040013,201,148,53,203,144,59,298,214,80,231,170,47
060376040024,224,165,59,227,161,66,361,256,97,280,210,55
060376018022,225,205,20,227,201,26,363,297,56,277,250,17
060376018021,238,220,18,239,216,23,416,345,59,312,289,16
060376015021,388,353,35,397,343,54,707,589,94,516,474,23
060376016001,231,207,24,233,204,29,369,300,62,281,246,21
060376016002,303,271,32,305,267,38,473,396,64,358,313,28
060376016003,243,217,26,245,215,30,399,337,56,309,272,23
060376015022,152,137,15,154,132,22,268,224,36,191,176,8
060379102171,631,371,260,636,357,279,1039,614,400,610,353,214
060379100021,767,406,361,785,404,381,1280,687,551,996,505,420
060379100022,473,243,230,485,239,246,738,403,313,619,295,290
060379100023,484,262,222,487,249,238,564,296,252,556,262,258
060379800311,91,55,36,94,55,39,158,105,49,111,67,37
060379111002,504,350,154,508,338,170,752,483,256,614,382,182
060379111003,514,352,162,516,336,180,783,525,228,540,352,148
060379110012,274,75,199,276,74,202,333,107,220,291,78,197
060376700011,562,305,257,572,310,262,801,457,322,631,329,263
060376700012,674,383,291,692,393,299,956,546,385,751,398,289
060376510024,430,246,184,445,246,199,643,371,260,484,262,187
060376700031,219,119,100,220,110,110,354,195,152,282,147,113
060376700034,776,416,360,793,403,390,1110,612,464,882,437,380
060376700032,510,298,212,516,298,218,741,438,282,647,339,251
060376700033,487,266,221,493,261,232,724,412,288,554,271,243
060376701021,737,464,273,750,461,289,1181,702,448,916,561,307
060376701022,349,227,122,354,225,129,578,341,221,422,264,134
060376702012,1263,598,665,1280,587,693,1733,927,772,1294,618,579
060376700021,408,242,166,416,239,177,642,384,236,515,299,176
060376700022,786,473,313,804,466,338,1168,695,437,1007,582,359
060376701011,1029,608,421,1044,594,450,1325,813,490,1205,710,419
060376701012,257,156,101,264,157,107,384,230,147,317,190,114
060375704031,233,207,26,238,205,33,377,312,53,362,311,34
060375704032,283,259,24,281,249,32,440,375,61,383,338,25
060375704033,243,220,23,244,214,30,386,328,55,256,226,17
060375718001,711,472,239,721,471,250,928,628,279,754,476,230
060375704041,357,318,39,364,313,51,551,466,76,457,393,43
060375704042,389,347,42,392,340,52,612,503,83,544,462,49
060375759021,518,445,73,527,444,83,1027,830,162,740,582,103
060375759022,467,392,75,482,398,84,747,616,105,585,462,79
060375759023,410,350,60,423,352,71,670,556,95,529,428,65
060375704021,410,349,61,419,343,76,594,487,98,477,398,57
060375704023,351,299,52,359,294,65,502,427,65,445,362,56
060375702023,223,182,41,227,180,47,340,264,71,295,239,46
060375702025,439,362,77,443,349,94,738,554,154,613,505,75
060375758011,172,151,21,176,151,25,285,224,48,281,224,33
060375758012,140,123,17,143,120,23,213,163,31,135,106,14
060375758021,246,215,31,253,221,32,470,364,84,361,295,44
060375758022,502,438,64,510,430,80,727,595,110,547,440,62
060375760011,688,517,171,708,524,184,958,732,203,749,548,149
060375760013,831,692,139,849,694,155,1205,967,204,882,658,164
060375760012,559,418,141,562,420,142,977,749,203,713,510,157
060375703061,357,291,66,361,292,69,535,424,104,357,289,54
060375703062,283,234,49,290,237,53,476,371,91,358,283,53
060375703031,314,262,52,319,260,59,484,375,92,414,331,59
060375703032,506,417,89,512,409,103,732,580,137,627,498,94
060375702022,243,202,41,247,201,46,394,309,78,319,261,44
060375702024,277,226,51,286,227,59,411,317,84,361,286,60
060375702021,165,139,26,167,138,29,280,216,55,266,224,31
060375702032,178,151,27,180,143,37,320,251,58,252,208,31
060375705021,324,251,73,333,248,85,584,444,123,475,367,73
060375705024,295,230,65,298,224,74,495,374,115,331,245,62
060375705042,532,424,108,541,421,120,783,582,171,640,500,107
060375730022,193,168,25,193,166,27,365,292,67,280,234,25
060375730042,167,143,24,169,139,30,262,208,45,192,160,21
060375732022,358,315,43,358,312,46,676,526,128,515,435,53
060375705041,455,366,89,458,353,105,664,505,150,557,439,86
060375732012,399,336,63,410,335,75,705,556,131,523,432,63
060375731011,338,284,54,343,275,68,529,401,110,365,296,47
060375705031,451,367,84,453,356,97,743,564,152,572,449,88
060375705032,368,301,67,370,290,80,602,448,133,472,359,80
060375705022,416,348,68,422,335,87,714,533,161,537,421,84
060375705023,312,242,70,313,233,80,482,351,122,377,288,65
060375731021,672,585,87,675,576,99,954,766,158,823,690,84
060375731013,302,267,35,307,265,42,419,332,78,355,308,31
060375702031,426,359,67,427,340,87,732,584,125,583,488,66
060375702041,324,253,71,329,246,83,485,367,108,400,313,64
060375702042,504,402,102,507,387,120,841,618,205,605,489,87
060375752021,241,203,38,243,194,49,521,408,97,357,302,39
060375752022,182,155,27,187,154,33,349,273,67,250,209,31
060375752023,126,102,24,125,98,27,238,186,45,162,133,20
060375701001,377,286,91,382,281,101,581,413,149,422,303,102
060375701002,457,342,115,466,330,136,683,485,178,628,452,143
060375730031,557,466,91,558,447,111,773,615,146,630,487,103
060375730043,223,192,31,220,186,34,378,311,55,276,216,36
060375730044,260,224,36,262,220,42,431,357,63,308,242,41
060375731022,353,298,55,355,291,64,480,383,96,442,354,64
060375703042,290,250,40,291,246,45,545,426,105,437,364,52
060375703043,225,192,33,229,190,39,363,285,69,304,247,37
060375717011,296,242,54,296,238,58,544,408,109,479,389,63
060375764011,198,166,32,205,167,38,364,284,66,280,237,25
060375764021,218,188,30,223,194,29,420,341,74,328,282,29
060375764031,305,263,42,311,267,44,553,439,100,383,320,38
060375703041,331,271,60,335,269,66,469,364,90,370,316,35
060375764032,395,348,47,401,340,61,687,542,118,491,397,55
060375706031,255,218,37,259,217,42,493,390,95,431,356,54
060375706032,419,373,46,430,374,56,725,630,76,476,428,27
060375706033,112,100,12,114,100,14,234,202,24,189,166,14
060375706024,224,175,49,229,172,57,414,305,105,300,239,42
060375715051,372,268,104,377,266,111,600,436,158,494,358,109
060375715052,525,388,137,533,388,145,738,519,201,666,476,145
060375719003,773,546,227,796,551,245,956,684,251,846,563,220
060375742022,416,275,141,420,263,157,632,392,225,483,301,148
060379800181,8,6,2,9,6,3,11,9,2,16,12,4
060375750011,527,379,148,531,369,162,815,525,267,613,391,173
060375764012,302,267,35,308,261,47,556,437,96,467,388,41
060375769011,254,220,34,260,216,44,481,372,94,346,284,40
060375769013,270,234,36,269,226,43,518,414,87,364,300,35
060375748002,610,382,228,615,381,234,760,526,218,643,368,224
060375770001,625,515,110,632,507,125,923,734,163,729,564,106
060375770002,645,534,111,659,528,131,1003,793,176,799,618,114
060375770003,520,430,90,530,431,99,780,616,135,602,444,96
060375770004,340,274,66,347,273,74,539,416,106,401,291,69
060375770005,280,212,68,284,209,75,400,289,103,293,201,66
060375765031,515,450,65,521,453,68,805,695,88,617,506,61
060375745001,889,491,398,900,483,417,1165,677,456,970,516,380
060375745004,816,490,326,833,487,346,1042,633,384,879,497,323
060375715022,385,291,94,388,286,102,576,424,136,429,309,100
060375715023,564,411,153,565,403,162,885,628,232,661,461,160
060375715021,483,360,123,489,356,133,676,471,185,514,364,128
060375717032,235,185,50,244,185,59,405,300,97,324,270,37
060375717033,289,228,61,297,227,70,488,354,116,278,228,39
060375717031,169,131,38,175,132,43,288,208,68,245,203,28
060375717012,361,288,73,364,286,78,633,491,130,393,316,55
060375736013,392,221,171,389,208,181,522,302,200,427,235,161
060375736014,0,0,0,0,0,0,0,0,0,0,0,0
060375736015,0,0,0,0,0,0,2,1,1,0,0,0
060375741004,557,310,247,562,300,262,747,445,292,636,344,247
060375741005,529,295,234,535,286,249,737,433,284,586,321,225
060375719001,714,525,189,726,518,208,942,695,229,777,562,168
060375719002,563,391,172,574,390,184,753,528,201,661,463,155
060375722023,293,222,71,300,221,79,439,321,114,359,269,65
060375722021,387,290,97,395,287,108,523,387,128,432,320,87
060375722022,334,252,82,337,250,87,472,344,123,396,290,86
060375762003,347,296,51,351,296,55,518,420,78,419,321,61
060375762005,536,456,80,548,455,93,802,654,118,520,400,74
060375722013,740,540,200,749,544,205,1087,755,303,899,630,213
060375722014,646,482,164,653,468,185,983,702,241,731,527,163
060375720012,555,414,141,557,408,149,754,568,169,605,427,139
060375720014,577,434,143,575,428,147,804,613,181,695,482,165
060375779004,823,621,202,827,609,218,1013,755,237,889,660,182
060375720013,539,391,148,550,384,166,688,503,167,631,413,169
060375779002,481,346,135,489,340,149,611,451,148,519,349,139
060375732021,244,213,31,247,211,36,522,397,107,353,294,39
060375758031,305,245,60,310,250,60,401,314,77,336,256,58
060375763011,266,215,51,267,216,51,437,348,83,325,252,51
060375763014,130,105,25,132,107,25,175,136,37,172,132,29
060375751011,295,260,35,297,254,43,626,495,110,388,309,51
060375777002,372,325,47,376,319,57,562,430,129,465,400,43
060375777001,368,329,39,374,324,50,533,403,114,471,401,50
060375725001,344,274,70,353,272,81,635,481,140,489,391,74
060375725002,454,394,60,459,380,79,678,514,150,525,416,77
060375777003,428,370,58,433,362,71,660,513,134,582,495,57
060375726001,424,348,76,424,331,93,680,493,173,512,407,76
060375726002,434,333,101,439,321,118,715,521,180,542,415,91
060375727001,255,206,49,258,204,54,433,324,102,333,266,53
060375727003,292,237,55,298,236,62,519,386,126,392,313,60
060375727002,383,289,94,389,292,97,665,470,175,534,409,95
060375726003,294,231,63,299,229,70,537,393,134,421,317,73
060375726004,158,124,34,161,123,38,293,214,72,223,170,39
060375722024,150,114,36,150,112,38,242,177,64,178,140,30
060375731012,245,205,40,243,196,47,385,296,80,262,212,35
060375780001,280,239,41,287,237,50,471,363,89,419,349,49
060375780002,233,199,34,237,195,42,446,353,85,339,294,35
060375767001,715,575,140,733,576,157,869,689,164,723,538,123
060375767003,866,708,158,886,715,171,1186,952,204,970,754,147
060375768012,497,423,74,509,430,79,610,503,92,527,416,76
060375768022,789,673,116,805,673,132,1140,944,167,927,726,125
060375730021,258,229,29,267,228,39,449,368,81,325,286,21
060375730041,241,203,38,241,194,47,375,298,64,284,237,31
060375771004,811,665,146,824,664,160,948,774,153,934,707,155
060375771005,668,551,117,678,548,130,880,720,134,785,601,123
060375753002,207,187,20,211,188,23,374,284,78,277,243,21
060375753003,263,235,28,269,238,31,467,349,99,316,284,21
060375753001,185,170,15,192,172,20,343,265,72,253,216,22
060375703051,495,417,78,512,407,105,912,703,185,773,623,116
060375703052,74,63,11,74,60,14,115,93,22,100,80,14
060375764022,436,389,47,442,387,55,696,573,101,566,471,59
060375732023,404,357,47,415,355,60,718,551,150,541,453,59
060375733001,414,351,63,419,349,70,792,593,178,528,426,69
060375733002,176,145,31,176,144,32,304,239,61,250,202,34
060375768011,405,362,43,407,352,55,566,474,72,482,391,48
060375768013,803,692,111,820,697,123,1094,908,155,888,697,121
060375752011,178,154,24,185,154,31,340,265,66,271,231,29
060375752012,220,184,36,228,191,37,405,313,84,329,269,45
060375752013,313,266,47,323,270,53,555,433,111,453,380,49
060375765022,361,322,39,365,322,43,448,392,44,378,312,32
060375765023,353,315,38,358,315,43,473,391,66,356,293,31
060375749011,414,266,148,422,264,158,569,357,198,450,287,134
060375749012,413,267,146,422,266,156,531,335,186,432,277,130
060375763023,295,240,55,301,234,67,507,397,96,410,327,51
060375769031,383,335,48,391,335,56,614,499,95,516,416,56
060375769032,356,311,45,358,304,54,578,469,89,409,340,33
060375751031,369,330,39,369,316,53,586,480,82,484,383,58
060375751032,487,416,71,494,405,89,769,621,119,640,508,79
060375751033,286,230,56,293,230,63,455,350,88,378,297,48
060375750022,642,513,129,656,508,148,900,687,193,707,514,134
060375750023,480,365,115,492,364,128,631,472,144,550,385,115
060375732011,332,288,44,333,283,50,677,538,121,522,429,70
060375754011,55,48,7,57,50,7,119,96,23,121,101,14
060375754012,144,125,19,147,127,20,260,201,48,202,172,20
060379800111,16,15,1,17,16,1,50,41,9,63,54,7
060379800331,25,21,4,25,21,4,51,42,9,82,60,15
060375765012,451,391,60,463,389,74,649,546,82,656,503,86
060375766012,617,516,101,630,512,118,850,688,146,753,578,123
060375766013,630,528,102,642,520,122,924,738,162,767,587,121
060375771003,506,395,111,514,391,123,640,499,127,569,405,116
060375772004,772,613,159,784,606,178,1010,793,192,752,553,139
060375772002,518,396,122,526,392,134,717,564,139,644,454,134
060375772003,594,453,141,600,444,156,828,645,162,586,420,111
060375763021,148,126,22,150,128,22,280,229,51,214,170,23
060375763022,117,102,15,118,103,15,225,183,38,170,135,20
060375723011,448,372,76,455,362,93,803,611,167,583,477,76
060375766011,479,382,97,491,378,113,695,545,134,589,435,114
060375766021,596,457,139,600,450,150,841,686,130,639,471,125
060375766022,397,322,75,401,319,82,582,479,81,518,404,75
060375766024,367,307,60,371,306,65,572,462,98,418,328,59
060375766023,349,301,48,358,303,55,488,403,70,247,196,33
060375745003,555,300,255,565,296,269,696,429,252,596,316,246
060375746021,649,338,311,665,331,334,860,517,320,767,388,334
060375718003,294,195,99,298,191,107,383,270,107,322,206,93
060375719004,690,451,239,699,448,251,826,585,223,717,454,206
060375772001,731,564,167,740,561,179,995,787,186,813,572,183
060375771001,695,533,162,710,538,172,883,685,176,692,529,110
060375771002,614,468,146,628,474,154,795,611,159,666,480,147
060375768021,811,697,114,822,697,125,1002,852,128,885,699,115
060375769041,460,401,59,460,387,73,686,570,101,565,458,67
060375769042,473,416,57,477,406,71,707,580,102,550,447,59
060375769012,476,406,70,478,395,83,609,487,110,542,425,69
060375758032,312,268,44,313,267,46,521,420,89,396,315,60
060375750021,507,393,114,518,398,120,771,586,160,623,425,139
060375776051,1027,507,520,1040,507,533,1256,793,442,1089,625,388
060375776052,1054,541,513,1068,542,526,1255,668,565,1157,574,523
060375776062,963,672,291,979,674,305,1269,905,339,999,655,286
060375776053,668,377,291,685,376,309,809,497,295,697,403,244
060375776021,838,538,300,849,525,324,1125,708,395,932,582,301
060375776022,969,516,453,980,504,476,1174,715,441,1014,545,397
060375774001,413,265,148,419,265,154,511,340,157,469,303,134
060375774002,315,205,110,322,207,115,413,278,133,312,203,88
060375776061,863,570,293,879,571,308,1092,736,329,901,594,244
060375773001,333,227,106,339,227,112,520,368,134,387,253,110
060375773002,518,369,149,523,364,159,708,508,184,593,401,153
060375773003,330,236,94,334,231,103,496,352,127,385,262,95
060375773004,576,397,179,590,400,190,722,493,214,625,402,179
060375774003,435,293,142,442,292,150,594,384,189,518,317,156
060375774004,474,286,188,487,286,201,585,385,189,533,309,185
060375773005,520,341,179,531,344,187,654,388,248,543,323,184
060375775041,396,198,198,401,198,203,478,285,186,343,176,145
060375773006,324,213,111,334,216,118,403,249,144,336,209,102
060375775012,699,326,373,711,326,385,860,488,361,745,368,335
060375775013,638,314,324,657,319,338,757,435,310,657,331,285
060375775042,355,180,175,359,177,182,425,250,168,543,281,234
060375748001,459,275,184,464,277,187,533,326,197,458,254,167
060375748003,492,295,197,498,296,202,595,386,195,483,294,153
060375754013,217,185,32,218,185,33,411,317,78,290,247,28
060375743005,502,291,211,513,289,224,622,381,224,518,289,203
060375743006,559,325,234,571,322,249,692,426,249,591,329,233
060375749013,524,309,215,534,305,229,699,436,243,566,330,201
060375749014,554,326,228,566,324,242,701,441,244,626,368,221
060375767002,409,315,94,418,314,104,461,356,94,521,362,116
060375742011,470,269,201,483,266,217,608,374,224,518,289,192
060375742012,465,265,200,477,262,215,573,351,210,483,268,179
060375742013,553,339,214,568,332,236,771,490,266,674,394,230
060375742021,321,198,123,329,192,137,445,282,153,344,204,116
060375743003,495,297,198,506,289,217,674,421,235,555,311,211
060375743004,552,329,223,567,327,240,732,458,257,627,352,237
060375744004,659,366,293,673,363,310,858,524,318,703,367,278
060375715042,285,223,62,287,218,69,490,361,120,344,264,61
060375743001,429,245,184,432,240,192,581,359,209,487,266,188
060375743002,447,255,192,451,248,203,565,349,204,502,275,194
060375727004,302,230,72,306,234,72,542,383,153,429,331,82
060375780004,234,170,64,239,176,63,451,312,127,334,250,59
060375740001,543,367,176,550,366,184,682,440,226,593,373,187
060375740002,444,301,143,449,300,149,583,374,193,476,298,149
060375740004,510,299,211,516,304,212,640,414,212,528,299,196
060375740005,869,503,366,893,512,381,1070,672,377,922,512,343
060375706012,484,371,113,489,355,134,740,555,157,614,475,99
060375706023,281,211,70,284,202,82,394,275,95,343,261,57
060375738001,580,330,250,589,316,273,799,466,317,666,369,258
060375738002,580,330,250,594,319,275,797,460,316,675,370,269
060375738003,507,272,235,519,275,244,654,393,247,547,278,230
060375738004,476,255,221,487,259,228,617,378,224,547,296,210
060375740003,504,291,213,524,296,228,653,398,235,576,315,213
060375741001,395,241,154,409,242,167,542,328,199,442,271,138
060375765032,622,543,79,630,547,83,824,704,95,677,563,65
060375741003,474,263,211,480,256,224,619,371,242,497,248,209
060375762004,175,146,29,178,145,33,301,250,43,186,144,25
060375736017,355,188,167,361,181,180,484,276,200,416,217,177
060375736018,392,212,180,402,212,190,520,292,215,449,234,188
060375736019,346,186,160,354,188,166,468,263,191,384,206,156
060375736016,369,195,174,370,182,188,500,280,204,402,214,156
060375759011,274,238,36,273,232,41,428,362,56,357,283,43
060375759012,226,198,28,229,195,34,323,270,44,215,172,26
060375759013,175,152,23,175,149,26,283,235,36,160,125,20
060375759014,167,146,21,167,143,24,238,200,31,178,144,20
060375736011,792,446,346,802,434,368,1010,585,402,895,477,344
060375736012,410,231,179,416,227,189,535,311,214,457,252,174
060375712012,409,225,184,418,224,194,534,311,210,473,253,186
060375712014,436,250,186,443,245,198,593,350,234,492,277,177
060375712013,399,236,163,406,228,178,578,338,225,448,260,150
060375712022,412,245,167,422,244,178,554,338,208,469,256,175
060375712023,674,405,269,686,400,286,941,580,341,737,423,260
060375712021,598,372,226,615,371,244,873,533,314,704,431,223
060375704022,383,349,34,382,339,43,519,441,67,438,398,27
060375706013,157,132,25,162,131,31,302,216,78,231,186,36
060375717041,280,227,53,283,225,58,493,372,99,390,310,51
060375717042,135,109,26,134,107,27,248,192,55,147,118,21
060375717043,302,235,67,307,233,74,465,351,104,378,294,64
060375780003,339,292,47,340,282,58,468,371,91,415,340,51
060375716001,381,331,50,398,335,63,619,517,76,554,481,44
060375775011,710,367,343,717,367,350,864,487,357,737,377,315
060379800061,0,0,0,0,0,0,1,1,0,0,0,0
060375779001,320,213,107,324,211,113,509,351,148,360,240,97
060375744002,439,248,191,451,247,204,543,326,208,506,275,200
060375744003,444,265,179,457,264,193,567,353,200,485,271,180
060375715024,267,179,88,270,175,95,393,273,108,280,185,79
060375718002,641,426,215,651,425,226,847,571,252,683,433,207
060375706022,484,383,101,494,380,114,790,565,192,617,470,112
060375706021,389,309,80,395,303,92,706,513,181,531,424,78
060375706011,469,368,101,477,356,121,759,572,171,641,488,109
060375715043,464,324,140,472,323,149,602,445,149,504,347,124
060375715044,475,344,131,481,340,141,647,472,158,487,343,115
060375715041,445,305,140,453,304,149,646,460,164,484,331,121
060375779003,468,341,127,480,338,142,642,474,154,526,353,141
060375722011,342,270,72,348,273,75,569,431,127,439,321,92
060375722012,264,208,56,272,212,60,422,311,102,294,219,59
060375763012,247,213,34,248,206,42,409,326,66,303,239,43
060375763013,266,230,36,270,224,46,389,317,66,244,186,29
060375762001,265,231,34,269,230,39,302,256,44,421,337,51
060375762002,329,283,46,330,282,48,455,372,67,370,293,48
060375765011,349,305,44,358,308,50,547,460,73,418,348,43
060375765021,652,586,66,663,580,83,943,805,113,860,716,81
060375751021,297,243,54,291,236,55,487,379,96,365,281,58
060375751022,291,251,40,294,245,49,449,356,86,376,294,55
060375751012,552,455,97,560,449,111,751,603,125,666,505,105
060375750012,758,608,150,771,596,175,1094,835,224,949,689,181
060375734032,850,615,235,857,608,249,1150,844,282,864,594,211
060375749021,288,211,77,295,212,83,413,321,84,360,237,86
060375749022,378,278,100,384,278,106,515,396,102,429,301,81
060375749023,699,562,137,719,571,148,984,742,213,785,583,143
060375737002,478,317,161,491,315,176,648,400,232,564,347,178
060375737003,409,271,138,420,270,150,555,335,207,460,284,146
060375741002,574,351,223,591,352,239,771,457,293,615,342,225
060375744005,373,198,175,382,196,186,506,314,183,423,251,148
060375744001,362,226,136,371,226,145,470,294,166,413,237,145
060375744006,454,284,170,467,284,183,637,395,227,486,290,162
060375781001,351,309,42,358,295,63,118,72,44,521,420,54
060375552021,758,399,359,768,393,375,1097,610,460,857,458,342
060375552022,851,479,372,860,468,392,1118,649,444,921,499,365
060375717013,554,443,111,566,436,130,975,721,234,749,594,116
060375723012,250,201,49,254,194,60,507,384,112,338,269,50
060375754021,244,201,43,244,197,47,479,373,95,313,253,37
060375754022,113,94,19,113,92,21,203,158,39,147,121,18
060375021001,370,266,104,374,260,114,553,388,150,464,333,100
060375021002,538,412,126,535,393,142,877,646,217,696,500,148
060375010023,736,552,184,723,516,207,1015,742,260,845,637,177
060375021003,574,426,148,569,406,163,809,563,222,671,476,152
060375022004,622,471,151,624,460,164,926,682,227,774,560,172
060375022003,436,322,114,444,318,126,642,456,174,541,387,126
060375022002,511,386,125,513,373,140,816,564,237,602,434,135
060375023032,552,450,102,561,441,120,827,619,189,725,566,121
060375023031,429,352,77,434,337,97,797,580,194,565,414,104
060375023034,296,248,48,305,245,60,469,344,114,379,308,52
060375023033,253,214,39,260,205,55,372,282,81,322,259,46
060375023035,470,392,78,482,379,103,778,581,182,675,534,103
060375012002,750,582,168,757,561,196,1112,803,279,894,663,168
060375004031,891,711,180,903,690,213,1394,967,401,1071,800,206
060375010012,400,333,67,405,325,80,685,515,149,538,434,80
060375010021,380,297,83,384,289,95,631,439,171,489,370,95
060375010011,337,254,83,342,246,96,505,361,136,410,291,88
060375010022,594,433,161,609,426,183,897,642,244,794,559,192
060375022001,355,275,80,359,264,95,628,450,160,425,305,90
060375403001,246,226,20,246,217,29,364,298,58,362,337,14
060375403002,375,336,39,381,324,57,568,459,89,498,446,28
060375403003,117,105,12,115,100,15,190,156,29,218,194,12
060375403004,251,217,34,256,203,53,382,309,60,322,278,26
060375402011,59,55,4,60,55,5,154,129,25,116,109,4
060375402012,107,98,9,109,96,13,271,218,44,204,184,8
060375402021,113,103,10,114,102,12,294,237,47,225,205,10
060375402022,156,137,19,159,136,23,296,242,43,259,231,15
060375402023,253,220,33,259,219,40,416,341,64,357,313,32
060375402024,267,229,38,270,230,40,417,337,70,353,302,41
060375402031,452,412,40,459,405,54,699,580,101,584,530,28
060375402032,184,167,17,188,164,24,326,271,47,233,211,13
060375402033,168,147,21,172,145,27,292,241,48,239,213,17
060375401012,381,343,38,388,333,55,582,479,82,480,437,28
060375401013,434,380,54,447,378,69,684,535,124,589,497,53
060375401014,527,473,54,543,463,80,832,664,141,669,600,44
060375405014,279,248,31,287,242,45,474,390,72,396,358,20
060375417001,229,203,26,238,203,35,351,291,50,294,267,15
060375417002,251,221,30,256,220,36,386,319,56,330,300,17
060375401011,173,151,22,178,151,27,288,228,54,243,205,24
060375405011,261,233,28,268,226,42,437,357,66,359,320,21
060375405012,192,170,22,200,168,32,293,239,43,233,208,13
060375405013,267,239,28,275,233,42,448,366,68,369,333,21
060375401021,372,337,35,376,330,46,598,500,82,503,452,28
060375401023,546,498,48,559,497,62,831,683,121,725,653,36
060375401024,378,340,38,383,335,48,599,501,80,557,499,31
060375400001,279,250,29,278,231,47,525,425,91,369,326,25
060375400002,329,293,36,335,280,55,622,497,105,428,382,27
060375401022,394,353,41,399,349,50,610,521,77,526,479,29
060375405021,291,262,29,294,248,46,496,416,65,425,387,22
060375417005,407,364,43,407,354,53,600,507,80,537,478,38
060375417004,327,294,33,331,287,44,514,427,68,413,372,25
060375400003,383,333,50,389,324,65,655,533,101,514,456,34
060375418011,275,245,30,277,239,38,449,365,76,348,319,19
060375418012,428,392,36,439,385,54,723,576,118,570,518,30
060375418023,474,406,68,489,407,82,633,523,93,552,498,29
060375418022,259,227,32,265,225,40,426,353,63,318,283,20
060378005062,210,145,65,213,147,66,240,156,78,256,176,67
060378004122,1342,936,406,1370,942,428,1501,1014,457,1512,1005,402
060378004062,455,277,178,465,276,189,577,369,195,469,286,157
060378004112,778,497,281,792,492,300,803,513,272,926,589,284
060378004111,730,474,256,751,476,275,920,614,288,822,515,269
060378004121,521,333,188,528,338,190,616,417,187,580,364,183
060378004101,845,539,306,852,530,322,1078,738,307,996,640,274
060376203051,327,214,113,330,209,121,424,291,122,380,250,103
060376203053,309,197,112,309,192,117,353,246,101,309,191,95
060376203055,288,175,113,299,179,120,381,253,128,374,236,114
060376203057,604,372,232,626,379,247,778,515,250,517,330,157
060376203052,855,539,316,870,546,324,1102,713,341,1173,764,324
060376203054,377,219,158,390,223,167,477,307,153,397,240,123
060376203056,304,176,128,313,181,132,385,247,131,254,156,78
060376209041,413,236,177,418,233,185,522,339,179,913,553,289
060376209042,534,310,224,559,310,249,712,449,235,118,72,40
060376209043,424,234,190,438,235,203,583,373,197,573,358,170
060376203033,628,368,260,648,365,283,796,533,244,672,410,221
060376203034,459,275,184,471,272,199,621,417,192,396,252,125
060376203011,689,427,262,709,428,281,859,566,273,715,464,217
060376203031,655,414,241,670,413,257,834,549,266,734,499,196
060376203032,660,418,242,678,418,260,798,536,246,700,455,193
060376203013,639,393,246,658,393,265,805,547,236,863,538,244
060376203014,559,338,221,574,346,228,698,472,205,470,295,144
060376203012,628,376,252,643,389,254,768,519,230,644,407,195
060376204003,572,349,223,576,359,217,770,540,212,782,507,230
060376204004,675,396,279,680,402,278,879,619,242,599,363,206
060376204001,1084,648,436,1108,649,459,1375,920,423,1186,710,417
060376204002,396,261,135,404,258,146,522,368,144,437,285,129
060376208022,575,355,220,585,355,230,740,481,237,610,376,189
060376208021,568,345,223,579,345,234,717,460,236,627,382,202
060376208013,363,222,141,374,221,153,471,311,149,370,224,124
060376208011,390,244,146,399,244,155,483,321,152,558,354,169
060376208012,527,337,190,538,332,206,692,462,215,601,381,184
060376208015,379,237,142,390,240,150,490,323,155,349,220,106
060376209011,671,381,290,693,379,314,857,545,295,822,481,283
060376209012,361,204,157,363,198,165,438,280,150,369,220,120
060376209013,346,197,149,355,193,162,432,278,149,312,181,113
060376208014,522,336,186,530,327,203,700,463,217,536,340,163
060376202011,316,207,109,319,205,114,471,325,132,383,256,112
060376202012,324,212,112,333,212,121,462,314,131,341,228,97
060377029003,949,755,194,964,749,215,1708,1261,416,1117,827,241
060377029001,959,738,221,972,733,239,1355,1014,317,942,694,199
060372742021,1095,837,258,1116,853,263,1422,1119,274,1225,940,225
060377029002,1167,975,192,1191,975,216,1606,1228,339,1437,1097,259
060377029004,705,526,179,712,518,194,1105,825,258,944,668,225
060375333001,123,112,11,123,108,15,190,161,26,593,525,42
060375333002,381,345,36,382,332,50,546,452,74,54,48,4
060375334011,334,301,33,338,290,48,493,403,79,484,426,37
060375334013,271,245,26,270,237,33,414,339,65,165,147,12
060375334021,401,366,35,403,356,47,578,473,99,660,577,54
060375337012,339,306,33,343,297,46,503,380,104,145,130,10
060375337021,407,368,39,415,357,58,574,441,116,459,398,39
060375337022,208,188,20,212,182,30,298,230,59,240,207,21
060375334012,324,288,36,326,275,51,497,394,82,409,354,36
060375334022,310,277,33,310,267,43,440,351,75,279,242,24
060375334031,430,389,41,434,381,53,607,484,105,574,511,36
060375334032,168,151,17,168,148,20,241,197,40,195,160,23
060375337011,276,249,27,279,242,37,386,297,81,603,540,37
060375337031,278,248,30,277,235,42,412,334,68,416,366,29
060375337032,406,361,45,410,346,64,654,532,102,490,428,35
060374303021,451,270,181,462,266,196,596,382,195,466,263,163
060374303024,570,337,233,577,327,250,773,474,276,623,361,219
060374303025,481,287,194,488,281,207,662,408,231,532,301,190
060374303011,535,287,248,542,283,259,680,380,286,581,299,245
060374303013,704,372,332,717,368,349,871,480,367,735,372,317
060374303022,844,495,349,859,483,376,1121,687,408,935,531,339
060374303023,465,268,197,476,260,216,588,369,208,525,291,197
060374310031,368,255,113,371,251,120,510,352,148,412,269,120
060374310032,918,624,294,929,611,318,1338,895,413,1022,664,296
060374310041,535,377,158,546,373,173,812,569,229,629,416,156
060374310042,571,401,170,586,402,184,783,550,213,654,443,161
060374309012,357,257,100,360,250,110,497,353,130,419,291,100
060374309013,497,357,140,502,346,156,790,558,207,523,368,120
060374309022,309,211,98,315,210,105,492,338,145,392,256,106
060374309011,477,360,117,492,366,126,776,570,187,565,388,139
060374311003,356,266,90,363,268,95,592,431,146,461,333,98
060374311004,372,270,102,383,272,111,682,489,180,428,292,107
060374311001,493,370,123,508,369,139,833,568,238,599,457,100
060374309023,183,125,58,187,125,62,280,190,85,211,139,57
060375302022,543,455,88,543,449,94,777,597,161,683,553,92
060375302041,321,267,54,326,257,69,460,358,96,445,349,70
060375302042,479,413,66,490,406,84,776,597,156,605,498,70
060375302031,391,332,59,393,308,85,698,530,145,506,402,79
060375302032,389,323,66,397,309,88,563,427,117,405,316,65
060375301012,291,221,70,295,218,77,507,378,117,402,294,82
060375301013,258,220,38,257,210,47,382,288,91,393,313,59
060375301014,187,143,44,191,141,50,300,227,73,173,127,35
060375300052,769,503,266,785,483,302,1099,735,352,882,597,244
060375322001,403,336,67,408,332,76,633,494,126,511,429,55
060375322002,219,180,39,222,177,45,347,270,68,276,231,32
060375322003,608,502,106,617,491,126,946,736,187,757,634,83
060375006001,254,217,37,252,209,43,391,307,75,367,311,38
060375301011,399,346,53,398,330,68,570,431,129,467,388,57
060375300051,829,567,262,855,582,273,1281,848,410,1009,684,268
060375300061,659,518,141,669,510,159,1058,720,308,821,602,172
060375300062,295,219,76,304,216,88,398,303,87,418,281,105
060375301022,394,311,83,403,297,106,513,388,113,568,448,95
060375301023,395,312,83,399,294,105,543,396,137,404,318,68
060375301024,433,347,86,437,336,101,651,478,165,368,289,63
060375300073,644,430,214,662,434,228,890,619,255,786,527,221
060375300074,545,358,187,564,366,198,755,533,208,614,409,174
060375301021,352,282,70,358,276,82,524,364,149,475,370,82
060375005001,751,639,112,760,618,142,1243,914,309,967,780,132
060375300072,650,499,151,663,496,167,1001,717,263,765,576,149
060379800361,96,69,27,102,69,33,192,129,60,128,97,23
060375300071,484,369,115,501,364,137,735,518,206,577,412,133
060375320011,455,380,75,463,367,96,651,491,144,536,440,71
060375320012,383,313,70,390,303,87,549,421,117,468,379,66
060374825223,340,267,73,353,264,89,456,356,92,420,328,78
060375321011,397,344,53,402,333,69,686,523,140,567,471,64
060375321013,377,322,55,382,312,70,687,520,144,456,373,55
060375320022,499,414,85,507,417,90,800,626,158,596,479,87
060375320021,192,162,30,193,157,36,297,230,63,232,192,28
060375321022,532,433,99,534,416,118,807,602,188,627,488,98
060375321021,486,390,96,489,373,116,773,573,186,714,556,117
060375321012,425,364,61,427,360,67,676,537,124,602,499,62
060374825221,388,299,89,400,297,103,627,445,172,478,359,91
060374825222,520,413,107,538,408,130,861,618,223,615,472,112
060374817121,465,351,114,481,341,140,777,507,266,617,450,138
060374817122,295,215,80,303,210,93,602,387,205,374,265,89
060374820024,295,212,83,302,209,93,478,346,123,342,246,79
060374820022,561,398,163,568,384,184,902,660,226,661,451,178
060374820023,581,419,162,597,411,186,1001,677,299,709,500,175
060374827013,298,240,58,304,233,71,502,366,123,386,300,65
060374820021,515,338,177,522,320,202,795,583,193,616,422,172
060374817131,272,189,83,281,181,100,528,325,193,349,240,91
060374817132,146,100,46,147,95,52,257,158,94,184,123,48
060374817141,222,147,75,226,137,89,484,296,176,308,202,95
060374821012,328,233,95,336,227,109,498,349,148,394,278,96
060374821013,460,327,133,480,323,157,801,527,260,576,406,142
060374822011,200,141,59,209,141,68,355,236,115,255,175,64
060374822012,182,134,48,187,132,55,362,235,117,237,173,55
060374822013,256,174,82,265,174,91,465,302,151,278,184,75
060374822021,160,111,49,161,109,52,343,225,116,200,139,52
060374822022,283,193,90,293,193,100,545,355,180,327,220,92
060374826001,598,416,182,614,402,212,905,605,292,660,427,207
060374826002,729,499,230,755,490,265,1079,727,338,837,573,230
060374826003,377,262,115,386,252,134,596,395,193,441,310,111
060374826004,500,323,177,520,322,198,736,495,238,612,401,180
060374821011,222,161,61,233,161,72,412,272,132,286,206,68
060374821022,302,211,91,319,212,107,523,345,167,389,271,101
060374821021,533,400,133,557,402,155,836,556,265,674,486,158
060374827021,414,318,96,426,311,115,582,421,155,476,349,99
060374822023,232,162,70,236,160,76,536,349,180,298,204,77
060374828012,341,247,94,351,243,108,513,354,150,398,282,91
060374828011,343,247,96,347,240,107,553,401,138,406,286,90
060374828013,651,472,179,666,467,199,998,688,292,777,540,187
060374827011,209,167,42,214,161,53,335,248,82,265,203,45
060374827012,364,291,73,377,288,89,583,434,143,473,371,81
060374827014,224,169,55,226,164,62,339,247,84,247,182,55
060374827022,355,276,79,367,267,100,507,375,124,403,308,72
060374817111,199,129,70,202,125,77,409,250,154,266,184,70
060374817112,228,148,80,235,146,89,466,285,175,314,217,81
060374820012,294,202,92,308,201,107,422,297,120,333,220,101
060374817142,131,87,44,134,82,52,270,167,102,186,122,58
060375304002,565,455,110,577,444,133,783,570,195,711,554,117
060373005032,445,261,184,457,266,191,672,401,260,512,302,175
060373005031,628,397,231,640,379,261,1040,626,400,758,450,252
060379203123,827,403,424,847,393,454,1202,615,551,976,440,468
060379203261,1291,617,674,1317,612,705,1834,985,817,1365,623,664
060379200431,1611,856,755,1628,841,787,2760,1526,1187,1584,765,753
060375004032,416,329,87,424,317,107,638,460,162,538,420,95
060375003001,1276,802,474,1285,776,509,1751,1084,638,1453,913,465
060375012001,858,588,270,863,575,288,1407,913,456,1103,714,326
060375503012,122,100,22,121,97,24,237,175,57,163,119,31
060375503013,192,157,35,193,154,39,333,247,81,264,212,41
060375503014,280,229,51,281,224,57,509,375,123,382,308,57
060375519001,243,189,54,244,184,60,410,294,108,315,243,57
060375519004,437,321,116,448,315,133,764,531,215,572,413,125
060375527003,362,274,88,364,266,98,592,405,165,464,342,99
060375527004,253,189,64,257,186,71,434,300,121,339,236,78
060375527005,311,233,78,318,231,87,540,379,154,419,294,96
060375778003,499,351,148,503,335,168,812,527,259,663,455,168
060375503011,303,206,97,306,197,109,513,337,164,409,285,103
060375778002,502,359,143,510,346,164,803,523,259,638,441,164
060375502021,439,319,120,446,308,138,701,488,190,555,409,115
060375502024,419,303,116,429,298,131,682,473,193,540,383,127
060375502022,386,282,104,394,274,120,603,421,169,506,368,110
060375502023,231,166,65,236,164,72,342,239,93,293,202,74
060375502011,424,309,115,429,290,139,648,455,189,508,370,111
060375028013,432,299,133,439,296,143,647,413,217,537,381,135
060375502012,289,219,70,294,206,88,482,331,136,358,276,71
060375501012,324,251,73,325,243,82,523,368,143,415,314,79
060375501011,487,376,111,494,369,125,740,531,199,639,489,126
060375501013,297,230,67,301,222,79,488,349,128,384,292,72
060375553002,372,289,83,377,277,100,616,435,162,495,376,91
060375553003,233,181,52,234,172,62,397,282,107,304,234,57
060379800341,16,8,8,16,9,7,70,43,25,14,7,6
060375523011,300,221,79,303,214,89,703,467,211,376,276,80
060375523012,543,412,131,552,400,152,1024,710,293,686,509,138
060375523013,226,174,52,231,168,63,467,316,140,272,205,52
060375523021,267,190,77,277,187,90,431,300,121,337,235,83
060375523022,291,206,85,297,199,98,458,318,129,384,265,92
060375523023,406,282,124,412,270,142,560,395,155,598,414,145
060375522004,381,277,104,388,270,118,702,488,202,474,340,102
060375520021,328,250,78,339,246,93,580,405,158,463,352,86
060375522001,223,177,46,230,172,58,631,422,191,296,223,53
060375522002,178,141,37,180,136,44,504,336,152,254,192,46
060375522003,202,149,53,210,148,62,397,274,115,247,181,50
060375520022,352,276,76,356,273,83,631,437,175,518,396,94
060375520011,400,286,114,411,278,133,670,465,182,514,380,102
060375520012,325,249,76,327,241,86,571,393,160,422,319,79
060375520013,270,205,65,271,199,72,464,319,131,345,261,64
060375519003,280,199,81,287,194,93,480,333,136,373,266,89
060375521004,237,181,56,244,180,64,387,258,129,327,248,62
060375521005,334,255,79,341,253,88,561,380,171,441,338,78
060375521001,332,246,86,337,236,101,633,418,200,447,323,99
060375521003,305,227,78,312,219,93,509,331,165,416,294,96
060375521002,300,221,79,309,218,91,603,399,185,434,328,87
060375524001,216,169,47,217,164,53,375,263,105,258,199,51
060375524002,307,242,65,310,232,78,518,370,142,380,286,77
060375527001,526,404,122,531,393,138,819,573,226,666,496,134
060375527002,245,185,60,251,181,70,414,289,114,301,223,65
060375528001,223,170,53,226,168,58,376,276,95,296,226,54
060375528002,517,387,130,525,381,144,864,620,223,695,503,158
060375528004,406,297,109,416,291,125,617,424,187,527,383,121
060375528003,300,216,84,306,213,93,453,305,137,402,287,97
060375529004,435,311,124,439,303,136,785,524,241,566,409,124
060375529005,344,246,98,351,242,109,624,408,196,480,351,106
060375530003,470,354,116,476,348,128,715,495,199,531,396,109
060375530002,351,254,97,356,248,108,546,383,158,421,289,107
060375529003,346,247,99,351,236,115,529,354,175,399,279,105
060375529002,277,198,79,281,188,93,465,303,151,401,311,71
060375529001,182,131,51,184,124,60,282,210,72,225,157,60
060375526011,248,211,37,250,201,49,413,320,80,342,286,36
060375526014,331,277,54,340,265,75,556,397,145,478,393,54
060375526023,234,174,60,236,171,65,415,300,103,292,215,59
060375547001,349,274,75,355,274,81,581,429,137,459,369,64
060375547002,355,288,67,365,290,75,585,437,132,483,393,63
060375547003,326,268,58,335,268,67,521,388,118,424,348,52
060375546001,529,351,178,545,343,202,895,568,310,667,429,198
060375553001,136,99,37,139,98,41,252,168,76,190,134,48
060375553004,336,244,92,342,241,101,571,387,176,454,320,116
060375526012,261,227,34,268,226,42,410,324,82,368,313,34
060375526013,262,227,35,268,226,42,397,309,76,350,301,33
060375526021,493,327,166,508,339,169,818,557,243,638,436,172
060375519002,364,257,107,362,250,112,602,410,177,472,337,114
060376702011,765,382,383,775,379,396,1047,596,430,834,428,355
060376702021,1392,660,732,1429,663,766,1795,992,763,1454,707,648
060376704171,1326,663,663,1341,659,682,1770,1065,673,1510,804,623
060376705001,931,316,615,946,319,627,1229,528,675,1089,384,639
060379104051,222,163,59,229,161,68,368,248,112,327,230,72
060379104041,352,250,102,352,242,110,495,329,150,421,289,103
060379104042,671,473,198,676,456,220,910,612,276,777,538,187
060379105043,131,100,31,133,96,37,188,134,50,186,132,42
060379105041,331,252,79,337,245,92,525,369,136,380,273,81
060379105042,439,332,107,446,325,121,691,488,179,503,358,114
060379105051,310,230,80,317,222,95,502,337,153,372,260,89
060379105052,404,299,105,414,291,123,676,456,209,479,339,115
060379105021,315,240,75,313,229,84,546,380,150,375,271,80
060379105022,332,250,82,332,237,95,563,393,152,410,294,89
060379106011,339,251,88,339,243,96,566,394,158,437,315,95
060379106012,300,234,66,292,220,72,455,326,121,336,243,73
060379106022,319,235,84,318,228,90,522,365,144,393,287,85
060379800041,0,0,0,0,0,0,2,2,0,4,2,1
060379104052,273,211,62,273,206,67,460,341,106,483,349,96
060379104053,182,141,41,184,139,45,312,230,70,186,134,38
060379106021,426,315,111,430,301,129,709,506,184,546,381,133
060379107211,460,339,121,467,327,140,803,550,233,550,382,134
060379102183,423,202,221,430,197,233,560,280,269,494,216,252
060379102142,598,365,233,611,352,259,950,566,363,772,458,277
060379106013,573,433,140,571,414,157,921,657,251,673,484,145
060379102103,1054,526,528,1070,514,556,1487,765,691,1142,523,553
060379102172,973,633,340,983,619,364,1610,964,608,1090,627,392
060379104013,758,447,311,788,451,337,1060,656,382,854,498,309
060379102161,644,293,351,654,300,354,872,391,460,684,282,358
060379102162,1101,586,515,1111,570,541,1545,837,677,1234,605,545
060379102141,550,334,216,562,321,241,786,451,318,665,386,243
060379107181,556,425,131,566,413,153,877,633,218,711,525,140
060379107133,580,460,120,588,451,137,854,617,210,693,524,122
060379103011,642,224,418,647,218,429,905,363,525,683,233,409
060379103021,553,193,360,560,189,371,730,305,412,594,207,357
060379103022,590,240,350,599,240,359,884,374,493,665,250,381
060379102101,1120,553,567,1140,529,611,1659,833,792,1303,603,633
060379102102,564,263,301,581,246,335,789,381,394,624,260,332
060379103023,723,310,413,746,303,443,1060,459,577,878,344,486
060379103024,669,279,390,677,283,394,913,398,493,790,298,441
060379102152,955,636,319,968,625,343,1398,867,505,1116,653,387
060379107162,888,609,279,899,605,294,1299,837,432,944,629,261
060379107141,567,454,113,568,433,135,867,641,208,652,481,131
060379107142,288,237,51,292,232,60,398,290,95,340,243,75
060379107061,723,576,147,729,558,171,1240,895,311,896,686,167
060379107062,628,503,125,634,490,144,1028,773,240,787,608,139
060379107121,766,562,204,769,531,238,1205,821,355,937,672,215
060379106081,413,295,118,418,277,141,611,421,179,493,301,144
060379106082,339,243,96,346,231,115,512,353,147,416,268,111
060379107183,483,384,99,489,370,119,788,597,176,625,472,117
060379107182,297,239,58,302,237,65,499,380,111,371,281,69
060379107171,623,491,132,628,484,144,1015,754,238,769,583,148
060379107191,261,208,53,264,202,62,418,296,115,314,233,62
060379107131,501,398,103,505,385,120,760,535,210,561,419,121
060379107202,348,270,78,354,262,92,671,459,193,463,337,100
060379107201,641,484,157,651,470,181,1020,723,268,784,567,171
060379107072,829,569,260,835,547,288,1390,941,417,1129,767,296
060379107071,313,219,94,315,213,102,522,353,156,464,315,122
060379107151,615,451,164,619,427,192,928,630,275,723,524,164
060379106051,537,416,121,541,404,137,830,578,225,680,498,135
060379106061,477,348,129,481,336,145,751,519,212,589,406,144
060379107152,389,292,97,393,283,110,629,440,180,463,316,120
060379107153,651,481,170,662,469,193,1000,694,287,822,563,205
060379106052,461,332,129,463,318,145,764,530,211,573,397,142
060379106062,232,167,65,233,161,72,349,244,96,279,190,71
060379106071,386,284,102,394,275,119,605,406,186,453,317,103
060379107212,243,173,70,246,169,77,430,303,118,333,248,62
060379107161,837,552,285,844,537,307,1220,809,395,993,648,283
060379105011,208,171,37,211,164,47,443,309,120,322,248,54
060379105012,236,195,41,239,185,54,432,316,100,467,343,94
060379105013,183,150,33,185,144,41,329,240,74,124,96,21
060379107132,387,300,87,390,295,95,598,433,149,445,331,97
060379107192,669,555,114,679,531,148,1067,792,253,782,596,146
060379102143,810,426,384,825,418,407,1129,619,485,950,454,441
060379106072,446,340,106,450,318,132,833,567,243,613,423,151
060379012181,1017,381,636,1047,386,661,1474,592,855,1190,416,701
060376703281,473,214,259,491,222,269,596,314,267,511,249,233
060376703282,584,243,341,592,246,346,816,428,366,657,310,305
060376704161,861,425,436,878,429,449,1210,708,479,964,495,401
060376703283,1283,616,667,1305,615,690,1724,909,771,1395,686,615
060376703262,880,418,462,891,416,475,1118,596,499,938,452,420
060376703263,365,167,198,381,175,206,484,254,218,391,193,176
060376703261,741,329,412,756,332,424,962,519,426,772,386,345
060376703241,608,310,298,628,320,308,727,439,273,609,319,252
060376703242,656,328,328,682,346,336,809,488,306,650,333,274
060376703244,843,427,416,860,428,432,1050,611,419,919,482,385
060376703243,848,391,457,859,390,469,1085,583,477,910,436,414
060375536012,555,446,109,565,444,121,945,696,231,751,610,108
060375535043,307,261,46,312,257,55,469,373,89,417,351,50
060375362022,345,293,52,349,279,70,530,409,108,406,336,57
060375536022,340,303,37,352,300,52,600,490,93,482,423,31
060375536023,192,172,20,193,169,24,329,270,51,251,222,16
060375535041,451,386,65,456,370,86,748,593,138,551,479,53
060375535042,307,276,31,310,272,38,508,411,81,404,362,27
060375535021,386,333,53,392,321,71,662,514,132,506,435,51
060375535022,447,396,51,455,388,67,742,568,150,514,439,46
060375535031,489,412,77,500,406,94,822,652,153,656,543,82
060375536021,315,261,54,324,257,67,543,398,133,415,341,57
060375537011,50,45,5,51,44,7,90,74,13,75,69,4
060375537012,196,175,21,203,174,29,355,294,52,278,252,15
060375537013,252,225,27,253,218,35,442,361,68,368,330,26
060375537021,444,390,54,440,378,62,728,591,117,604,543,43
060375538023,417,361,56,426,357,69,732,576,140,525,467,43
060375538022,602,512,90,599,489,110,954,747,179,794,653,106
060375538011,158,131,27,161,128,33,246,197,47,180,154,24
060375538012,134,119,15,136,117,19,216,179,30,174,151,17
060375538021,229,183,46,233,177,56,388,305,72,295,235,46
060375539014,227,190,37,233,185,48,403,312,79,289,238,38
060375539011,369,296,73,369,289,80,612,451,149,514,422,71
060375539012,383,301,82,387,293,94,646,478,153,528,427,78
060375539013,482,369,113,484,356,128,776,571,183,585,467,92
060375539022,330,274,56,334,257,77,578,438,122,464,379,63
060375539023,305,255,50,314,243,71,526,402,107,435,360,56
060375536011,434,404,30,440,388,52,766,634,109,610,538,49
060375539021,406,323,83,417,306,111,616,482,126,508,390,88
060375538013,318,282,36,324,276,48,559,450,90,443,386,43
060374608001,1095,639,456,1101,629,472,1297,847,422,1119,677,363
060374609002,439,400,39,436,379,57,739,631,87,542,480,37
060374609004,479,415,64,486,410,76,647,557,85,556,483,51
060374609005,303,259,44,312,259,53,424,358,56,377,323,39
060374609001,494,447,47,493,430,63,782,667,95,630,532,68
060374609003,425,379,46,431,379,52,636,540,81,524,456,32
060374616001,449,394,55,451,383,68,580,484,88,483,417,41
060374616004,291,254,37,293,249,44,420,358,57,340,292,31
060371810001,506,401,105,512,389,123,654,507,139,570,430,113
060374617002,484,371,113,494,370,124,522,429,88,521,401,96
060374600022,687,392,295,694,386,308,920,545,357,769,405,323
060374630001,394,250,144,401,254,147,520,368,144,449,272,148
060374630002,701,447,254,713,451,262,987,696,272,742,448,244
060374615011,451,388,63,455,384,71,606,509,88,500,426,47
060374615012,419,361,58,422,357,65,550,452,84,487,409,49
060374615013,657,565,92,663,559,104,892,739,130,728,612,70
060374621001,463,404,59,469,403,66,646,510,120,509,423,56
060374621003,631,550,81,635,545,90,804,685,99,693,578,74
060374624001,575,433,142,582,431,151,767,594,154,658,505,112
060374624002,470,377,93,467,372,95,573,457,101,503,394,79
060374624003,364,294,70,365,291,74,489,385,95,406,323,60
060374619011,474,415,59,473,397,76,713,588,109,581,493,51
060374620012,369,326,43,371,320,51,557,458,79,446,383,40
060374621002,564,488,76,567,477,90,902,772,111,752,634,80
060374625002,627,434,193,634,424,210,780,544,220,661,462,165
060374626001,612,445,167,615,439,176,792,560,207,677,485,153
060374626002,573,413,160,580,405,175,749,540,183,611,440,141
060374625001,659,424,235,666,419,247,860,588,258,685,460,183
060374629001,787,534,253,799,525,274,1031,702,305,833,539,231
060374629002,451,308,143,457,303,154,611,428,171,530,367,130
060374615021,449,396,53,453,384,69,699,590,101,580,504,48
060374615022,440,388,52,445,378,67,683,568,98,528,454,49
060374615023,214,187,27,217,186,31,333,282,40,278,243,20
060374615024,350,304,46,351,303,48,554,469,76,448,389,36
060374620011,534,478,56,541,477,64,841,722,101,633,559,47
060374620021,219,192,27,221,189,32,366,300,55,302,261,28
060374620023,225,201,24,228,198,30,327,270,49,302,264,23
060374620022,283,247,36,287,243,44,526,433,75,371,317,36
060374622011,444,366,78,446,362,84,580,461,110,484,398,60
060374623011,558,470,88,567,470,97,778,625,137,646,517,82
060374623012,331,281,50,339,281,58,487,393,82,357,286,44
060374623013,470,397,73,481,398,83,703,576,113,592,464,91
060374627003,506,382,124,512,377,135,668,499,159,546,419,93
060374623023,352,287,65,359,287,72,501,389,97,379,294,56
060374627002,363,288,75,366,280,86,573,441,118,408,308,72
060374627004,334,273,61,336,271,65,478,364,100,398,309,58
060374627005,450,369,81,457,368,89,707,539,147,452,344,75
060374627001,385,272,113,388,273,115,512,378,121,451,330,96
060374628001,621,438,183,622,436,186,874,625,232,686,485,166
060374629003,442,319,123,451,314,137,651,472,173,566,402,138
060374632002,720,515,205,733,514,219,930,689,222,779,549,186
060374632003,265,205,60,268,207,61,382,270,105,303,227,58
060374634004,770,608,162,777,605,172,1118,824,259,862,641,159
060374628002,470,372,98,475,365,110,735,559,162,594,426,129
060374638001,490,341,149,492,340,152,558,402,146,523,333,158
060374638002,594,417,177,604,423,181,683,525,148,604,460,120
060374638003,641,446,195,646,444,202,739,537,189,662,444,181
060374638004,673,471,202,682,470,212,778,599,167,736,563,143
060374639001,526,360,166,530,359,171,636,456,167,544,364,145
060374639002,544,417,127,546,411,135,671,522,132,623,452,129
060374640005,611,471,140,622,472,150,782,610,153,698,531,124
060374640001,558,379,179,570,381,189,669,499,163,589,388,173
060374640002,492,318,174,505,321,184,588,454,126,532,375,125
060374640003,659,479,180,670,481,189,877,645,211,701,507,156
060374640004,611,414,197,628,416,212,734,547,174,646,464,142
060374806011,526,434,92,531,426,105,670,549,105,573,436,95
060374635001,628,494,134,635,491,144,852,650,176,645,493,105
060374635002,604,446,158,612,444,168,779,614,153,830,624,145
060374635003,703,557,146,712,557,155,1013,801,184,836,659,121
060374636024,390,326,64,396,328,68,515,422,81,487,396,68
060374636023,668,557,111,675,558,117,917,759,134,741,616,90
060374637002,1007,718,289,1018,720,298,1446,1062,350,1022,711,249
060374636021,370,294,76,378,297,81,587,468,102,404,311,67
060374636022,613,488,125,627,493,134,972,805,142,707,537,123
060374636012,655,540,115,658,536,122,885,724,141,694,547,110
060374636013,590,487,103,592,483,109,762,601,147,681,524,116
060374625004,433,297,136,437,296,141,600,398,192,532,343,154
060374636011,524,432,92,534,436,98,689,567,107,549,427,87
060374636014,622,514,108,636,517,119,822,681,127,687,554,91
060374614001,550,376,174,563,374,189,749,513,215,665,423,202
060374634001,510,412,98,514,407,107,664,511,136,531,400,95
060374634002,678,513,165,686,508,178,860,667,178,718,522,151
060374637001,665,416,249,675,412,263,787,553,222,651,391,218
060374639003,842,520,322,855,515,340,1052,730,302,899,574,280
060374614002,344,255,89,352,255,97,420,340,80,421,323,81
060374614003,417,312,105,420,305,115,549,438,103,484,372,94
060374616002,698,585,113,708,572,136,885,738,129,813,661,108
060374617001,362,303,59,363,293,70,448,379,62,391,331,42
060374616003,488,439,49,491,434,57,783,641,129,544,468,46
060374619012,199,179,20,203,179,24,289,236,48,221,190,19
060374619021,192,149,43,196,149,47,218,181,35,192,139,38
060374619022,470,364,106,480,364,116,694,568,113,534,390,106
060374622021,593,481,112,605,475,130,827,670,136,536,422,77
060374622022,375,303,72,380,300,80,607,498,96,404,317,59
060374622012,328,277,51,336,274,62,465,369,88,371,302,45
060374622013,397,335,62,406,331,75,564,469,82,427,349,53
060374624004,321,274,47,321,266,55,558,436,109,499,393,75
060374634003,389,290,99,395,286,109,505,390,106,433,309,97
060374641023,325,138,187,343,144,199,491,284,195,364,179,163
060374619013,473,412,61,473,393,80,687,568,106,515,429,45
060374623021,443,359,84,449,357,92,670,534,115,452,344,66
060374623022,324,263,61,331,263,68,487,387,83,356,274,53
060375004044,420,317,103,425,307,118,633,451,170,539,397,110
060375004043,437,342,95,441,335,106,682,499,174,585,442,119
060375004042,326,259,67,328,256,72,504,379,119,400,317,62
060375004041,250,207,43,250,201,49,405,302,95,316,249,49
060375025001,477,394,83,483,374,109,694,524,152,616,480,100
060375026021,307,256,51,306,238,68,497,382,105,452,343,82
060375026022,462,379,83,469,362,107,743,548,184,582,442,103
060375026023,384,307,77,389,301,88,609,442,150,452,341,82
060375004021,295,260,35,299,257,42,510,398,107,385,331,39
060375004022,243,212,31,247,211,36,398,302,91,300,256,33
060375009001,441,359,82,445,346,99,643,484,142,579,442,101
060375009002,379,313,66,383,301,82,552,420,121,479,371,81
060375009003,505,423,82,514,422,92,754,584,156,602,475,96
060375006002,236,206,30,237,199,38,336,266,58,317,274,27
060375006005,343,293,50,346,286,60,517,404,102,465,387,51
060375006003,221,188,33,223,181,42,364,273,81,285,227,46
060375006004,290,246,44,290,239,51,461,344,105,377,303,47
060375007001,334,268,66,339,261,78,495,378,113,411,312,78
060375009004,213,170,43,214,166,48,356,275,73,256,194,48
060375007002,386,307,79,392,300,92,582,429,138,465,365,90
060375007003,411,336,75,415,327,88,566,419,133,480,377,83
060375007004,412,339,73,415,331,84,608,455,144,493,392,73
060375007005,300,247,53,303,241,62,434,328,102,350,279,51
060375007006,180,152,28,180,143,37,288,213,67,235,185,33
060375008002,604,493,111,619,487,132,955,731,210,813,641,132
060375008003,674,563,111,674,548,126,982,746,220,806,645,122
060375008001,366,305,61,366,298,68,559,424,125,444,358,68
060375024011,486,393,93,489,384,105,783,585,186,655,510,111
060375024022,625,513,112,624,495,129,947,717,208,788,634,107
060375024021,572,476,96,579,469,110,904,696,182,697,567,93
060375024012,307,251,56,311,242,69,456,333,111,394,320,54
060375024013,581,478,103,585,458,127,859,634,210,702,576,92
060375025002,513,426,87,517,425,92,859,658,190,644,535,72
060375026031,850,696,154,863,671,192,1215,888,304,1023,809,156
060375026042,332,265,67,335,256,79,518,384,122,424,333,71
060375026041,453,359,94,454,343,111,704,528,174,561,433,96
060375026043,418,356,62,426,339,87,628,467,146,507,408,78
060375026032,320,271,49,324,260,64,470,341,118,382,314,54
060375004023,439,375,64,442,365,77,735,555,155,545,443,75
060374017073,508,388,120,512,377,135,732,509,201,572,437,104
060374017074,909,624,285,925,624,301,1372,964,379,921,632,241
060374090001,229,181,48,229,173,56,385,268,108,288,221,45
060374025011,193,168,25,192,160,32,376,277,89,270,228,30
060374025012,348,301,47,350,291,59,675,503,152,474,395,54
060374025031,206,170,36,205,164,41,366,271,87,245,201,30
060374021011,436,347,89,440,335,105,955,660,261,562,447,86
060374021021,623,487,136,634,475,159,1035,754,255,771,590,132
060374021012,332,297,35,339,293,46,545,424,109,442,384,36
060374021013,320,277,43,323,270,53,547,421,108,420,357,42
060374021022,542,417,125,548,401,147,865,587,260,674,516,122
060374022001,626,403,223,629,387,242,871,593,255,683,416,224
060374022002,674,454,220,682,451,231,948,625,304,794,502,232
060374028031,170,142,28,170,135,35,296,215,75,207,174,24
060374029021,344,280,64,345,269,76,642,464,160,481,381,68
060374024032,633,486,147,647,487,160,1004,726,256,849,634,161
060374090004,358,243,115,367,239,128,553,383,153,395,263,105
060374024031,276,232,44,282,234,48,455,343,99,342,279,42
060374024041,625,563,62,634,532,102,45,37,8,763,583,72
060374024052,429,374,55,435,366,69,711,576,127,575,492,55
060374024051,232,203,29,237,200,37,383,303,70,287,247,28
060374024061,141,120,21,143,119,24,270,206,56,199,159,25
060374024063,445,380,65,451,373,78,740,578,145,593,473,77
060374024062,235,201,34,238,199,39,394,302,80,303,251,33
060374023011,524,411,113,534,398,136,950,681,238,722,556,118
060374023012,445,348,97,455,340,115,808,590,193,640,497,98
060374023041,261,204,57,266,199,67,470,346,110,314,259,35
060374023042,159,131,28,158,121,37,328,241,71,222,171,32
060374088001,171,138,33,174,135,39,292,220,66,274,205,47
060374088002,301,253,48,302,250,52,551,435,105,491,400,66
060374023033,275,207,68,280,198,82,466,339,115,346,249,63
060374023032,169,128,41,173,122,51,323,234,81,236,166,44
060374023031,198,149,49,201,142,59,349,252,87,246,173,48
060374026021,268,197,71,274,194,80,369,256,101,330,223,81
060374026022,371,273,98,382,270,112,528,377,126,483,324,118
060374026023,563,407,156,564,390,174,788,556,222,653,443,164
060374026011,288,215,73,289,208,81,456,318,131,368,264,89
060374026012,266,198,68,265,191,74,402,281,116,328,233,80
060374026013,174,134,40,177,132,45,311,218,83,220,154,49
060374027032,579,444,135,598,451,147,1019,755,240,802,617,142
060374027052,554,427,127,561,415,146,883,653,204,715,536,138
060374027063,268,207,61,275,205,70,464,341,115,361,271,65
060374027022,139,113,26,139,109,30,262,195,59,200,154,33
060374027024,245,189,56,245,184,61,424,314,97,336,253,58
060374027051,292,224,68,292,221,71,479,356,110,391,295,67
060374027021,182,160,22,182,150,32,388,290,89,266,211,39
060374027023,125,103,22,120,96,24,200,148,45,179,139,27
060374028011,161,135,26,162,132,30,319,250,58,277,227,38
060374028012,166,142,24,168,138,30,296,233,51,168,140,23
060374027031,416,324,92,425,319,106,728,543,173,560,422,106
060374027062,211,166,45,219,165,54,375,270,94,294,222,60
060374027061,399,323,76,403,314,89,679,490,171,447,353,70
060374090002,322,238,84,323,232,91,498,337,146,381,258,98
060374090003,581,427,154,586,417,169,931,620,292,659,463,152
060374025042,209,172,37,209,168,41,367,265,88,280,227,36
060374025032,353,291,62,359,283,76,584,426,135,432,349,55
060374030003,496,411,85,504,401,103,821,613,183,606,484,84
060374025041,250,205,45,251,203,48,394,289,102,334,275,43
060374030001,509,421,88,512,407,105,857,642,195,669,533,95
060374030002,280,241,39,280,233,47,497,376,102,329,270,37
060374028013,156,135,21,155,132,23,241,193,43,191,152,25
060374028032,244,203,41,244,197,47,431,311,111,298,244,38
060374088003,156,137,19,157,135,22,278,218,50,135,107,18
060374029022,367,289,78,370,282,88,627,458,149,495,379,85
060374029032,508,416,92,516,410,106,888,654,218,641,521,86
060374029041,331,264,67,335,258,77,559,408,132,444,343,70
060374028041,130,107,23,132,104,28,261,187,67,176,142,23
060374029031,274,226,48,277,222,55,474,348,117,365,301,46
060374029023,358,293,65,369,285,84,531,382,129,471,362,73
060374029042,408,330,78,420,323,97,644,462,155,536,415,81
060374033182,652,419,233,662,423,239,930,614,294,753,479,239
060374033171,949,630,319,971,621,350,1502,922,554,1133,690,382
060374033183,773,459,314,792,450,342,1128,679,426,889,565,275
060374033173,655,385,270,675,389,286,933,568,346,781,493,246
060374033181,443,297,146,458,299,159,662,418,236,524,369,137
060374033184,402,230,172,412,231,181,694,440,242,495,292,180
060379011021,758,270,488,763,270,493,1207,467,699,974,324,573
060379011022,315,113,202,324,115,209,496,189,298,344,124,197
060379103012,1136,370,766,1168,357,811,1651,636,987,1385,387,917
060379011011,755,292,463,768,283,485,1173,439,705,939,336,534
060374063001,694,366,328,705,363,342,1136,634,483,820,440,346
060374054001,273,200,73,282,196,86,478,321,149,348,250,86
060374054002,374,271,103,379,266,113,616,413,193,457,317,116
060374054004,293,214,79,300,208,92,477,321,148,401,286,98
060374053012,340,230,110,347,230,117,557,368,176,469,313,129
060374054003,394,283,111,397,278,119,633,421,198,471,329,117
060374055001,366,256,110,372,252,120,564,380,178,472,316,134
060374057011,349,229,120,350,233,117,530,363,156,410,280,105
060374013031,960,459,501,978,449,529,1408,724,664,1107,553,504
060374035001,664,324,340,673,314,359,920,479,421,756,391,329
060376704131,921,473,448,934,473,461,1253,761,458,1037,564,420
060376704132,1120,611,509,1142,611,531,1513,950,530,1275,720,501
060376704051,896,449,447,910,440,470,1213,716,467,937,485,405
060376706043,355,181,174,361,177,184,457,269,178,364,193,156
060376706031,859,442,417,876,442,434,1154,670,466,955,521,396
060376704181,990,527,463,1006,518,488,1392,829,525,1093,580,439
060376704071,796,455,341,816,445,371,1201,738,436,918,525,339
060376704072,476,272,204,489,265,224,716,442,258,569,343,195
060376704073,645,380,265,657,369,288,973,616,334,768,469,256
060376704182,948,496,452,972,499,473,1306,785,495,1028,548,428
060376704162,890,464,426,909,470,439,1307,761,518,993,542,399
060376706042,908,475,433,923,478,445,1183,683,481,995,541,400
060376707022,619,281,338,625,278,347,844,429,393,665,304,332
060376707012,882,444,438,904,443,461,1120,618,478,965,472,440
060376707023,540,244,296,546,244,302,714,366,331,619,288,301
060376707024,770,345,425,789,356,433,1011,525,467,841,390,404
060376706041,1579,749,830,1602,746,856,2022,1082,902,1735,838,791
060372964011,974,575,399,993,561,432,1299,764,515,1071,619,379
060376707013,604,309,295,626,313,313,854,468,361,670,341,287
060376707025,552,253,299,557,257,300,798,409,369,705,332,338
060376704052,367,201,166,373,200,173,518,309,205,402,224,157
060376707011,1013,567,446,1018,561,457,1472,807,627,1188,672,466
060376707021,338,149,189,343,145,198,445,234,203,365,160,177
060376707014,433,257,176,452,264,188,651,360,278,514,290,189
060376213261,398,266,132,415,270,145,574,372,185,479,290,153
060376213263,621,407,214,639,406,233,870,558,290,718,435,227
060376214001,847,509,338,867,505,362,971,621,327,820,488,280
060376214002,673,404,269,692,404,288,867,561,280,732,436,248
060376214003,343,200,143,350,200,150,419,261,148,347,197,125
060376214004,526,301,225,528,296,232,667,410,236,558,299,214
060376513042,543,315,228,555,311,244,849,510,316,703,412,244
060376213262,441,282,159,447,277,170,609,390,210,459,278,149
060376213012,873,544,329,885,542,343,1201,782,379,985,620,298
060376213011,804,561,243,824,568,256,1035,711,299,856,555,242
060376213014,729,440,289,744,437,307,926,609,300,762,437,263
060376213241,657,425,232,669,419,250,948,613,313,760,466,248
060376213243,518,336,182,527,329,198,753,486,247,575,352,187
060376213242,474,291,183,487,294,193,659,434,212,566,342,183
060376212012,1003,607,396,1035,616,419,1340,857,446,1124,656,386
060376212013,1012,627,385,1052,636,416,1401,942,426,1198,713,398
060376212043,744,454,290,757,454,303,991,621,345,875,508,318
060376212041,416,254,162,424,254,170,564,354,198,485,282,174
060376212011,938,608,330,963,610,353,1333,902,398,1128,693,349
060376207031,444,289,155,455,289,166,599,411,171,492,314,143
060376207033,693,448,245,710,450,260,945,654,271,792,509,226
060376207011,820,552,268,831,552,279,1119,789,297,1000,638,275
060376207012,853,566,287,874,575,299,1160,801,331,915,590,254
060376207013,589,388,201,601,396,205,752,516,223,648,418,183
060376206022,361,214,147,382,219,163,509,318,182,464,252,179
060376206023,370,220,150,383,221,162,521,331,179,468,256,180
060376206024,621,377,244,634,368,266,864,556,290,725,422,252
060376206011,446,299,147,450,296,154,736,526,193,519,340,146
060376206012,529,356,173,538,355,183,710,506,186,613,397,171
060376206013,523,357,166,531,350,181,909,651,237,598,378,166
060376206014,683,502,181,696,507,189,991,711,252,793,532,181
060376205212,407,287,120,414,293,121,613,458,144,470,313,124
060376205221,567,398,169,571,397,174,731,532,180,650,445,162
060376205223,708,477,231,720,478,242,944,670,244,770,493,220
060376205214,386,269,117,392,272,120,527,382,136,437,289,118
060376205222,835,558,277,854,564,290,1154,800,315,920,598,260
060376205211,490,350,140,501,360,141,746,528,197,573,377,148
060376205012,364,227,137,367,228,139,502,333,153,398,238,127
060376205013,523,329,194,532,334,198,701,463,215,637,396,196
060376205011,481,341,140,488,336,152,666,445,193,586,386,152
060376205014,356,233,123,362,232,130,491,328,146,401,251,121
060376205016,492,366,126,498,358,140,717,500,199,560,386,130
060376205015,309,197,112,316,198,118,423,294,116,341,211,108
060376205213,281,201,80,281,200,81,371,276,87,303,206,75
060376207014,844,561,283,856,564,292,1083,753,313,939,606,267
060376213013,877,559,318,890,561,329,1183,775,372,961,597,294
060376207041,915,596,319,938,595,343,1252,852,364,1023,667,290
060376207032,521,345,176,530,343,187,692,483,194,576,373,162
060376207042,634,413,221,649,410,239,888,602,258,720,469,199
060376206025,520,345,175,524,332,192,686,446,224,570,361,167
060376206021,490,279,211,501,271,230,662,411,235,566,318,206
060376505013,464,221,243,476,221,255,645,352,281,519,249,236
060376514011,569,305,264,578,306,272,784,434,335,642,323,280
060376704061,782,389,393,806,395,411,1115,657,442,894,482,377
060374322012,564,391,173,570,369,201,989,647,322,650,452,174
060374322021,355,260,95,369,261,108,578,376,192,429,303,109
060374322011,310,217,93,318,212,106,563,377,184,379,263,97
060374322022,185,137,48,193,140,53,344,234,109,223,168,47
060374322023,387,290,97,404,292,112,675,454,209,458,342,98
060374329012,217,159,58,223,163,60,429,280,142,304,226,66
060374329013,176,128,48,180,127,53,281,184,96,223,166,50
060374813001,366,266,100,374,263,111,594,388,197,445,325,101
060374813002,306,213,93,309,205,104,570,369,193,395,285,94
060374329021,359,261,98,374,264,110,637,418,210,476,352,102
060374329011,392,288,104,406,300,106,724,471,247,511,378,109
060374823031,179,132,47,185,136,49,362,240,114,269,210,43
060374823032,247,186,61,255,189,66,522,348,165,342,256,69
060374823033,272,201,71,285,208,77,585,388,189,402,308,76
060374824041,229,175,54,236,176,60,386,269,108,299,228,55
060374824042,519,387,132,529,383,146,824,585,228,666,476,159
060374336012,510,371,139,521,367,154,940,629,297,664,510,123
060374336011,360,261,99,376,265,111,699,464,225,463,326,110
060374824011,266,198,68,278,199,79,525,354,169,340,253,71
060374823041,211,166,45,212,160,52,424,292,128,281,224,41
060374823042,194,153,41,195,147,48,400,264,126,262,212,40
060374825021,230,186,44,236,181,55,417,289,124,302,239,49
060374825022,253,205,48,257,197,60,445,306,132,355,282,58
060374825032,293,233,60,302,234,68,606,413,180,371,299,52
060374825212,550,422,128,565,416,149,943,624,304,704,530,129
060374824031,521,412,109,533,421,112,989,672,295,688,546,104
060374825031,205,161,44,212,165,47,422,288,128,284,228,41
060374336021,403,301,102,415,294,121,857,583,256,546,420,104
060374824012,263,196,67,265,192,73,524,355,165,357,276,64
060374082131,335,221,114,347,218,129,600,381,206,419,260,139
060374082132,311,206,105,324,203,121,607,386,211,450,299,125
060374086263,548,323,225,564,328,236,848,516,324,635,392,206
060374086271,578,343,235,597,340,257,905,532,360,664,398,228
060374086272,319,188,131,330,188,142,523,314,201,370,223,129
060374087221,538,327,211,554,323,231,910,532,366,646,394,210
060374087251,269,174,95,275,172,103,490,304,175,359,224,113
060374087241,193,125,68,200,124,76,366,228,131,261,176,72
060374086262,257,163,94,263,165,98,531,337,183,276,176,86
060374087071,619,350,269,627,357,270,960,548,400,697,405,258
060374087252,569,367,202,580,364,216,983,603,368,694,434,212
060374087242,212,138,74,215,135,80,413,258,149,249,154,76
060374087243,81,53,28,84,53,31,156,96,56,108,66,33
060374087222,570,333,237,594,329,265,937,561,362,730,430,259
060374087032,590,332,258,616,325,291,1108,647,443,681,394,251
060374087072,464,234,230,475,232,243,764,417,337,534,290,216
060374087053,476,275,201,480,275,205,788,436,337,555,316,215
060374087253,391,250,141,401,247,154,699,423,261,449,282,137
060374087051,306,193,113,312,187,125,476,295,171,359,219,115
060374087052,604,382,222,620,370,250,968,559,385,693,430,219
060374082133,316,218,98,324,216,108,402,269,125,303,205,81
060374082121,611,364,247,628,356,272,1049,611,424,748,494,233
060374086261,273,183,90,281,184,97,343,213,126,297,201,83
060374013112,631,321,310,642,309,333,964,490,459,734,357,324
060374013114,626,311,315,634,300,334,888,447,419,735,337,341
060374004031,949,424,525,968,431,537,1316,623,660,1106,470,575
060374013041,1325,605,720,1340,590,750,1826,876,920,1477,685,718
060374013043,859,389,470,867,385,482,1153,576,560,948,444,455
060374013111,736,320,416,746,311,435,1027,479,533,827,351,425
060374003044,463,212,251,472,207,265,630,334,283,540,258,249
060374003045,554,250,304,563,243,320,770,398,357,729,323,357
060374003041,557,327,230,562,315,247,919,503,395,604,330,230
060374012021,573,311,262,590,301,289,803,381,402,641,323,287
060374013122,1120,548,572,1133,533,600,1626,814,779,1312,617,615
060374013042,465,219,246,468,213,255,653,329,310,520,208,287
060374013121,884,433,451,902,409,493,1404,691,676,1052,476,519
060374003042,403,241,162,410,235,175,660,361,279,467,253,176
060374013113,488,252,236,496,245,251,750,387,345,562,335,184
060373203003,387,339,48,393,327,66,583,472,102,499,434,46
060373203004,412,360,52,411,343,68,594,480,102,492,417,56
060371066491,329,277,52,330,262,68,560,428,123,452,354,76
060373203001,379,328,51,376,306,70,648,512,120,543,460,52
060373203002,335,288,47,329,269,60,551,439,98,485,411,49
060373202011,176,145,31,176,136,40,297,226,67,221,181,29
060373202022,366,306,60,365,288,77,623,470,135,470,374,70
060373202023,243,200,43,241,185,56,423,318,92,310,255,43
060373202024,292,239,53,292,225,67,441,329,97,354,287,45
060373201012,417,328,89,414,313,101,656,493,155,560,439,88
060373202012,326,257,69,326,245,81,528,397,114,400,298,76
060373202021,546,421,125,540,402,138,804,599,181,662,486,130
060373201021,419,352,67,424,345,79,724,554,151,611,487,90
060373201022,370,310,60,372,302,70,626,483,130,479,399,50
060373201011,515,410,105,522,396,126,879,643,214,612,483,94
060373202013,199,168,31,200,161,39,360,277,81,248,206,36
060374802011,677,403,274,692,405,287,906,593,294,706,436,240
060374802012,481,281,200,489,281,208,593,389,195,481,283,181
060374801024,277,168,109,292,172,120,469,289,172,346,217,106
060374802022,343,214,129,350,212,138,501,327,164,447,272,152
060374811022,93,61,32,96,60,36,177,113,60,115,78,33
060374811023,300,212,88,305,208,97,561,372,173,388,276,90
060374802021,283,181,102,290,179,111,373,262,110,327,208,102
060374802023,339,216,123,344,212,132,461,320,126,395,232,141
060374811021,311,220,91,315,214,101,512,345,155,362,261,80
060374802013,607,412,195,623,413,210,876,595,267,699,449,218
060374811012,395,291,104,406,289,117,695,470,209,499,370,109
060374811033,340,225,115,355,234,121,559,358,186,403,271,107
060374811034,246,160,86,255,165,90,394,253,133,286,188,80
060374814011,341,232,109,344,221,123,738,477,241,430,296,113
060374814012,442,295,147,453,299,154,702,460,230,563,373,167
060374811031,281,208,73,287,209,78,513,325,181,369,274,67
060374811032,275,205,70,282,202,80,487,313,171,364,275,70
060374814013,143,102,41,148,100,48,276,183,89,186,133,45
060374814041,170,120,50,178,118,60,310,201,109,218,147,60
060374814042,375,266,109,389,262,127,716,462,238,453,313,117
060374814043,218,153,65,228,151,77,390,252,134,274,187,75
060374823011,267,198,69,278,197,81,469,325,137,338,251,66
060374823013,145,111,34,153,111,42,290,195,88,204,153,41
060374823014,129,99,30,135,99,36,298,202,90,194,145,40
060374823012,152,116,36,157,116,41,314,211,94,211,157,44
060374814031,213,156,57,221,155,66,377,251,118,253,190,50
060374814032,299,212,87,310,219,91,583,383,196,406,293,93
060374641021,553,317,236,560,307,253,757,432,299,568,333,208
060374641022,469,268,201,478,262,216,596,346,238,498,295,181
060374641011,436,215,221,455,219,236,601,365,227,506,281,191
060374641012,366,167,199,377,171,206,519,310,200,420,217,171
060374641024,494,237,257,514,242,272,668,402,251,541,296,210
060374641013,337,141,196,351,146,205,488,286,194,393,190,178
060374642006,558,281,277,576,284,292,830,503,317,570,322,214
060374642002,276,137,139,283,139,144,399,237,155,320,181,123
060374642003,339,178,161,357,177,180,525,308,201,356,201,135
060374642004,360,187,173,378,186,192,565,338,212,423,244,158
060379203341,341,190,151,351,190,161,472,246,218,407,193,194
060379203343,989,548,441,1024,553,471,1274,712,533,1032,569,392
060379200182,659,266,393,679,261,418,872,396,450,738,289,405
060379200181,407,165,242,418,161,257,562,257,293,457,180,249
060379201111,736,350,386,744,345,399,946,463,464,808,355,401
060379201112,783,366,417,785,357,428,1037,528,488,835,365,418
060379200171,591,285,306,604,281,323,819,396,405,656,270,341
060379201123,618,304,314,626,297,329,809,424,371,655,324,297
060379201151,539,251,288,545,244,301,672,340,320,569,254,281
060379201152,530,270,260,538,263,275,703,377,315,554,260,263
060379203122,871,402,469,896,405,491,1206,549,631,913,402,451
060379201153,799,417,382,810,413,397,1059,595,447,771,413,314
060379203291,622,328,294,639,326,313,854,475,363,640,321,271
060379203292,1133,585,548,1160,580,580,1500,782,689,1230,604,544
060379203311,752,382,370,762,377,385,938,486,434,791,383,365
060379203312,721,371,350,732,363,369,876,469,392,781,378,361
060379200314,657,368,289,673,371,302,1014,558,440,789,437,298
060379203142,440,177,263,447,172,275,565,237,315,559,203,321
060379203321,481,158,323,490,162,328,631,341,277,511,193,284
060379203421,207,154,53,207,148,59,381,248,119,257,186,54
060379203322,406,131,275,412,134,278,569,248,311,460,114,320
060379203344,853,466,387,881,467,414,1094,609,462,922,490,382
060379203141,818,362,456,833,348,485,1081,452,605,899,381,461
060379203313,473,248,225,482,239,243,640,344,285,491,236,227
060379203431,318,230,88,322,222,100,489,318,153,351,255,74
060379203432,462,321,141,471,310,161,690,454,216,585,369,184
060379203422,134,101,33,135,97,38,222,150,72,118,90,26
060379203221,560,283,277,571,282,289,690,360,319,567,277,264
060379203342,672,339,333,685,338,347,821,428,380,715,317,357
060379203402,378,236,142,387,235,152,529,330,186,345,217,106
060379203281,863,458,405,883,461,422,1221,667,530,956,475,428
060379203222,916,479,437,935,482,453,1210,646,545,972,497,427
060379203401,381,199,182,388,200,188,497,254,225,353,184,146
060379203132,668,340,328,683,337,346,854,484,359,702,332,314
060379203131,761,393,368,780,386,394,1003,542,437,789,385,337
060379203133,1024,467,557,1047,474,573,1357,673,651,1088,479,532
060379203121,507,221,286,526,219,307,647,308,320,505,225,243
060379200381,651,405,246,664,398,266,1153,654,471,724,457,213
060379200382,420,260,160,429,257,172,671,371,286,527,297,192
060379200391,784,399,385,801,388,413,1016,540,453,896,404,436
060379200172,680,333,347,697,323,374,922,444,454,751,320,376
060379200173,631,289,342,651,289,362,800,381,397,674,269,351
060379200441,906,446,460,937,445,492,1253,600,615,1024,457,482
060379200452,1279,599,680,1322,604,718,1773,887,853,1465,655,736
060379200453,417,206,211,434,209,225,557,278,268,449,213,205
060379200442,241,119,122,249,118,131,350,173,162,258,116,119
060379200451,390,180,210,400,179,221,522,261,244,411,185,194
060379200202,1290,555,735,1320,543,777,1777,822,907,1490,598,784
060379200203,725,310,415,744,304,440,1008,456,530,799,331,414
060379200201,866,376,490,879,366,513,1347,629,685,989,416,509
060379200281,889,447,442,919,434,485,1342,684,631,1030,482,488
060379200291,723,350,373,748,339,409,1025,537,470,796,363,388
060379200151,1400,635,765,1438,634,804,1890,867,988,1478,658,746
060379200152,1463,650,813,1500,651,849,2026,900,1089,1514,607,826
060379200161,486,251,235,504,249,255,692,358,324,532,257,242
060379200162,1696,732,964,1718,719,999,2319,1075,1205,1855,814,941
060379200301,365,219,146,373,215,158,532,311,210,389,219,148
060379200302,848,526,322,864,520,344,1254,754,474,926,533,330
060379200303,1037,588,449,1050,594,456,1535,862,640,1079,563,468
060379200312,1221,590,631,1263,587,676,1495,821,657,1333,629,637
060379200132,1600,839,761,1635,833,802,2639,1391,1201,1186,513,587
060379200481,837,488,349,847,497,350,1117,636,453,910,485,360
060379200292,418,212,206,428,203,225,615,318,284,479,237,216
060379200293,185,94,91,191,91,100,284,146,130,203,99,92
060379200355,341,202,139,344,189,155,541,326,207,393,219,143
060379200482,537,310,227,543,288,255,855,465,367,610,330,236
060379200483,468,270,198,472,252,220,614,335,264,508,275,198
060379200353,298,195,103,303,187,116,424,268,149,327,197,111
060379200352,713,448,265,726,447,279,1031,611,401,818,482,287
060379200354,384,241,143,389,229,160,626,391,224,473,270,170
060379200311,244,157,87,246,152,94,369,232,131,284,174,90
060379200351,494,320,174,502,312,190,795,513,263,614,366,211
060379200313,594,278,316,613,281,332,741,372,359,584,262,300
060379201091,1284,596,688,1307,602,705,1713,943,745,1362,668,632
060379201142,681,385,296,697,388,309,1033,597,423,710,395,273
060379200421,676,371,305,688,364,324,952,488,446,735,377,326
060379200422,484,261,223,495,256,239,678,349,318,512,267,220
060379200423,440,249,191,449,243,206,584,321,252,442,234,183
060379200411,742,379,363,748,362,386,1251,705,521,870,478,341
060379201101,680,320,360,691,322,369,912,467,429,758,348,369
060379201102,761,358,403,776,359,417,1038,533,486,795,370,377
060379200432,1249,754,495,1266,743,523,1926,1127,769,1335,810,455
060379200131,929,508,421,942,510,432,1382,764,592,917,464,393
060379203293,785,381,404,796,373,423,1012,501,491,865,401,419
060379203302,482,253,229,491,248,243,570,304,257,523,260,228
060379203303,695,318,377,707,306,401,878,448,415,726,339,340
060379203304,700,320,380,710,307,403,865,442,409,728,321,358
060379108082,635,304,331,653,295,358,918,445,453,723,317,355
060379108071,1123,552,571,1148,541,607,1538,791,719,1261,589,592
060379203301,731,413,318,746,410,336,895,468,409,767,408,308
060379201212,875,503,372,900,499,401,1715,983,703,912,461,407
060379201143,398,218,180,407,217,190,642,382,247,470,242,194
060379201144,348,189,159,353,188,165,589,349,226,447,259,156
060379201211,1088,666,422,1109,654,455,1589,911,651,1152,677,400
060379201213,861,512,349,886,506,380,1261,716,528,833,497,278
060379201121,613,307,306,619,298,321,805,404,379,695,341,310
060379201141,728,346,382,738,339,399,911,472,421,895,427,412
060379201122,779,377,402,790,370,420,1057,525,515,879,410,411
060379201201,1046,563,483,1073,553,520,1597,875,694,1188,595,527
060379201202,410,230,180,419,226,193,731,413,305,407,206,180
060379201092,915,435,480,935,429,506,1172,618,531,950,473,423
060379201093,384,206,178,394,216,178,564,295,258,469,218,237
060379203411,188,127,61,193,126,67,275,180,88,235,147,72
060379203412,185,125,60,191,124,67,352,204,147,178,97,75
060379200461,463,295,168,471,275,196,602,395,193,518,289,187
060379200473,191,153,38,196,152,44,453,328,111,272,193,55
060379200471,276,221,55,282,218,64,477,353,112,344,245,73
060379200472,202,162,40,206,159,47,323,236,75,253,180,53
060379200133,764,398,366,775,390,385,1143,617,502,974,495,414
060379200425,451,292,159,460,291,169,734,474,248,491,284,179
060379200424,454,295,159,461,291,170,701,451,238,536,314,189
060375027001,470,363,107,495,372,123,748,515,214,629,478,120
060375027002,479,354,125,494,358,136,741,499,224,575,428,115
060375028012,694,460,234,708,438,270,1033,660,346,875,571,247
060375028014,428,306,122,433,292,141,652,447,192,535,368,140
060375028015,380,286,94,385,274,111,574,398,159,458,321,111
060375042001,397,276,121,400,272,128,1282,870,389,525,371,123
060375027004,1155,893,262,1191,896,295,1332,937,355,1499,1125,282
060375042002,428,310,118,428,295,133,709,511,179,545,388,130
060375028011,340,239,101,341,224,117,483,327,144,409,276,109
060375027003,440,336,104,447,322,125,661,455,187,520,390,98
060375029012,785,583,202,799,558,241,1256,844,383,1001,707,244
060375030001,165,132,33,165,124,41,277,202,73,213,164,37
060377012011,484,352,132,493,358,135,543,424,116,682,515,136
060377012012,572,421,151,593,428,165,690,534,146,687,519,133
060377012014,568,417,151,583,421,162,707,538,150,611,467,121
060377012022,914,777,137,936,776,160,1052,878,159,966,817,107
060377013023,793,642,151,816,642,174,1042,843,178,961,761,147
060377013042,783,610,173,793,609,184,980,754,208,861,644,172
060377013043,1173,896,277,1189,896,293,1409,1082,300,1302,979,265
060377017023,529,440,89,537,441,96,739,611,115,592,462,88
060377018023,445,373,72,459,383,76,596,474,109,572,459,76
060377018024,273,238,35,280,241,39,349,290,49,342,285,37
060377019021,925,740,185,948,740,208,1320,1000,291,1036,766,204
060377019023,616,506,110,633,513,120,928,737,171,849,659,133
060377013022,810,664,146,828,668,160,1003,804,181,899,722,127
060377014024,648,515,133,655,509,146,877,688,172,786,603,139
060377015013,1037,840,197,1063,858,205,1270,1005,240,1172,913,192
060377016012,925,703,222,939,716,223,1155,907,229,1087,862,181
060377016013,443,349,94,449,354,95,520,418,98,557,445,88
060377016014,593,485,108,597,484,113,695,570,122,457,362,71
060377012021,886,712,174,901,726,175,1082,886,177,947,749,156
060377012013,428,314,114,437,318,119,547,418,115,407,310,77
060377012015,404,298,106,411,301,110,487,381,105,350,267,63
060377019022,269,217,52,276,217,59,456,341,105,378,287,67
060377014021,474,376,98,484,384,100,602,468,124,561,437,93
060377014022,1219,983,236,1238,994,244,1421,1077,315,1315,1018,211
060377014023,811,610,201,826,628,198,1042,795,234,878,652,171
060377017013,769,661,108,779,666,113,954,797,142,886,733,109
060377018011,403,339,64,412,341,71,535,440,86,520,414,74
060372676003,348,290,58,353,291,62,488,394,86,403,315,63
060377018021,623,553,70,639,562,77,800,673,107,888,732,97
060377018022,454,391,63,459,391,68,543,442,86,464,389,49
060377018013,802,710,92,811,717,94,1126,968,133,1517,1271,146
060377023004,695,594,101,703,586,117,807,693,103,478,388,58
060377023005,914,773,141,919,765,154,1138,957,163,776,639,88
060377016011,336,242,94,339,244,95,429,331,84,374,275,80
060372643052,715,537,178,723,536,187,927,702,219,886,662,192
060377015011,888,745,143,900,749,151,1049,863,168,936,755,136
060377015012,651,538,113,661,545,116,777,636,128,736,586,114
060377015022,570,482,88,570,485,85,740,613,115,621,509,78
060377015023,610,513,97,622,509,113,810,664,124,669,520,105
060377016022,787,662,125,806,676,130,1038,855,155,869,706,111
060377016023,370,309,61,380,316,64,494,410,74,483,387,66
060377016021,747,642,105,758,641,117,936,784,135,784,650,92
060377017012,530,440,90,536,441,95,675,539,116,583,471,85
060377017011,296,239,57,301,240,61,383,303,73,293,229,48
060377017021,413,338,75,417,340,77,517,407,99,473,375,69
060377017022,457,391,66,462,396,66,611,492,109,510,424,48
060377015021,426,361,65,425,365,60,519,435,79,508,420,60
060377018012,287,242,45,291,245,46,407,338,66,319,258,36
060377018014,767,682,85,793,698,95,1137,965,147,862,728,79
060377020022,678,593,85,692,594,98,830,713,100,897,756,81
060377020023,842,748,94,855,738,117,993,866,105,961,822,72
060377022012,406,342,64,408,341,67,489,413,62,478,386,61
060377022014,460,405,55,473,412,61,547,480,67,530,447,56
060377022015,356,312,44,364,316,48,434,373,55,362,309,39
060377022013,537,450,87,542,444,98,688,587,88,566,451,73
060372713003,702,559,143,705,562,143,950,755,168,792,613,121
060377023001,633,529,104,643,528,115,826,694,119,618,510,78
060377023003,597,506,91,600,498,102,697,594,95,627,506,81
060377022011,615,520,95,630,531,99,752,632,101,546,435,79
060377021024,433,358,75,439,363,76,523,413,101,477,382,63
060377021025,356,308,48,364,313,51,427,360,59,379,318,36
060377021026,400,353,47,403,350,53,498,440,52,434,367,39
060377021027,877,777,100,887,777,110,1029,869,134,969,814,95
060377022021,454,387,67,459,390,69,556,459,85,484,399,56
060377022022,382,317,65,391,321,70,463,391,69,436,354,62
060377022023,398,317,81,408,323,85,478,402,71,404,317,67
060377022024,504,405,99,512,409,103,597,496,92,643,505,104
060377022025,392,331,61,395,334,61,493,410,77,407,332,51
060372713004,673,514,159,679,519,160,832,667,151,733,554,129
060377023002,636,535,101,645,537,108,770,643,114,691,565,91
060372731001,348,301,47,350,299,51,419,355,59,388,323,47
060377021022,321,287,34,322,285,37,395,338,55,397,338,35
060377021023,306,274,32,311,273,38,392,328,53,343,294,28
060377013021,913,740,173,931,741,190,1090,870,205,1017,802,154
060377020021,751,643,108,768,650,118,932,776,138,888,729,103
060377020024,774,668,106,777,663,114,959,806,135,593,491,63
060377021021,644,513,131,652,519,133,798,628,152,691,528,120
060377013041,907,695,212,923,687,236,1085,851,228,1030,787,204
060377013044,427,327,100,431,327,104,488,382,104,367,284,67
060379200282,501,280,221,508,273,235,672,376,283,533,275,224
060379200283,893,496,397,909,487,422,1528,853,646,1012,517,421
060374305014,739,491,248,757,497,260,929,614,293,778,488,233
060374305013,402,269,133,416,272,144,513,340,163,441,279,130
060374305023,671,417,254,686,417,269,921,606,293,777,470,254
060374305024,296,196,100,303,196,107,390,261,121,341,218,103
060374305026,723,469,254,733,465,268,953,630,292,787,500,236
060374305022,890,537,353,902,527,375,1106,716,361,1020,597,354
060374305025,505,318,187,510,306,204,623,413,192,558,337,182
060374305021,405,235,170,411,234,177,486,319,156,424,230,168
060374305011,607,380,227,619,379,240,745,491,233,652,393,215
060374305012,585,366,219,594,364,230,722,478,227,645,396,204
060375734011,454,347,107,462,353,109,619,470,145,551,406,122
060375734021,19,13,6,21,16,5,202,147,49,64,45,16
060375734022,273,211,62,275,207,68,506,370,123,305,230,55
060375734023,468,363,105,472,357,115,756,555,172,476,356,87
060375734031,612,427,185,613,425,188,628,449,163,650,432,176
060375734024,511,365,146,526,374,152,876,641,216,603,418,141
060375734025,688,502,186,697,495,202,927,687,220,793,557,176
060374338041,281,238,43,283,229,54,486,368,104,362,302,38
060374335061,265,234,31,266,225,41,448,351,84,361,316,30
060374335062,175,155,20,177,151,26,339,256,80,238,201,26
060374341002,354,309,45,357,298,59,648,489,142,465,381,58
060374341001,110,97,13,112,96,16,219,165,52,162,140,16
060374341005,246,201,45,249,196,53,397,280,108,304,247,41
060374341003,241,200,41,245,193,52,360,256,96,297,243,38
060374338043,373,314,59,369,291,78,564,409,144,482,391,70
060374338031,469,385,84,474,365,109,713,506,186,566,448,87
060374341004,225,188,37,224,179,45,400,293,90,291,236,36
060374338032,434,346,88,438,336,102,695,506,168,533,411,89
060374340041,595,490,105,603,471,132,998,723,240,799,627,126
060375361021,439,329,110,442,313,129,695,491,193,604,437,133
060375361022,479,365,114,481,346,135,766,535,209,655,480,149
060375362011,435,346,89,436,330,106,723,518,188,565,412,119
060375355011,264,240,24,267,233,34,424,324,84,370,325,29
060375355012,292,260,32,295,255,40,475,376,86,385,340,27
060375355022,483,439,44,492,425,67,741,577,139,612,548,37
060375357011,425,377,48,429,369,60,680,548,114,551,480,39
060375357012,463,407,56,468,391,77,736,585,122,622,537,53
060375360001,234,209,25,234,202,32,371,299,62,254,222,18
060375358041,504,452,52,508,431,77,800,627,144,632,557,46
060375359013,354,313,41,357,297,60,571,456,103,491,431,35
060375359014,279,257,22,286,246,40,469,367,89,359,326,21
060375356031,171,153,18,171,149,22,296,238,50,245,217,18
060375356032,426,378,48,433,371,62,712,579,122,525,469,31
060375359012,382,327,55,383,316,67,608,456,134,470,393,53
060375360002,433,376,57,441,364,77,665,534,120,633,543,59
060375359022,353,293,60,355,286,69,580,443,126,458,377,59
060375359023,328,275,53,331,264,67,521,405,109,447,369,58
060375359024,540,453,87,548,427,121,858,674,173,733,608,87
060375357013,404,352,52,411,340,71,630,511,101,538,467,48
060375357022,238,216,22,240,208,32,392,319,65,322,286,23
060375357023,197,177,20,196,167,29,315,254,54,271,237,22
060375357024,346,310,36,346,293,53,544,441,93,455,397,35
060375357021,256,232,24,261,227,34,432,350,72,357,316,25
060375361031,165,141,24,168,139,29,281,219,54,228,192,26
060375361032,632,542,90,635,523,112,1038,793,217,880,722,115
060375355031,423,382,41,428,373,55,735,593,125,626,550,46
060375356071,266,244,22,276,237,39,402,338,58,361,323,20
060375356072,288,262,26,296,256,40,451,366,71,411,365,27
060375356073,128,115,13,125,111,14,227,188,38,156,136,13
060375356074,234,212,22,234,206,28,397,323,61,320,274,24
060375356041,310,284,26,313,271,42,503,412,81,400,365,23
060375356061,277,254,23,278,240,38,464,389,63,342,308,20
060375356042,415,373,42,416,359,57,692,571,107,543,466,44
060375356052,360,329,31,360,309,51,582,491,84,472,413,31
060375359011,377,320,57,384,314,70,504,391,112,460,381,61
060375356051,333,303,30,335,292,43,556,460,83,466,420,32
060375358032,230,208,22,231,201,30,396,320,68,324,283,27
060375358033,158,143,15,161,139,22,269,221,46,207,181,17
060375358021,416,369,47,422,355,67,626,498,113,508,450,34
060375358024,474,420,54,478,403,75,729,577,137,599,530,43
060375358031,257,231,26,259,224,35,435,349,72,364,310,36
060375358042,544,482,62,550,463,87,800,628,155,708,612,65
060375361033,494,434,60,503,422,81,782,602,166,633,534,67
060375361043,423,366,57,426,347,79,620,486,121,548,447,66
060375361042,232,209,23,238,207,31,386,297,75,289,256,21
060375358022,144,127,17,145,123,22,244,194,48,183,162,14
060375358023,397,346,51,401,333,68,620,484,120,523,451,43
060375359021,438,360,78,442,356,86,659,505,143,552,467,67
060375362012,475,386,89,481,364,117,752,553,180,583,458,92
060375362023,390,317,73,390,294,96,605,448,140,465,362,73
060375362021,334,283,51,340,271,69,494,379,101,390,320,53
060374806021,618,494,124,625,496,129,777,622,137,654,500,116
060374806022,366,271,95,371,274,97,389,307,76,361,279,60
060374806023,374,304,70,377,305,72,693,565,115,588,454,100
060374806012,423,347,76,426,340,86,499,409,79,424,327,70
060374806024,474,352,122,479,354,125,555,436,110,450,322,101
060374806013,642,520,122,657,510,147,937,769,147,681,533,100
060374805004,615,485,130,625,485,140,749,594,142,659,504,116
060374807032,800,658,142,809,660,149,988,804,169,814,638,128
060374807041,595,477,118,607,472,135,762,605,137,641,486,120
060371831032,621,536,85,626,514,112,869,697,149,739,585,101
060374807022,1250,952,298,1265,958,307,1536,1185,316,1281,929,280
060374805001,767,577,190,787,580,207,939,730,183,818,606,169
060374805002,985,740,245,1004,738,266,1249,969,248,1057,792,200
060374805003,533,401,132,544,402,142,635,496,124,568,423,115
060374807042,839,637,202,847,632,215,1165,919,211,930,711,166
060374807043,530,399,131,541,397,144,696,542,138,571,428,103
060374807021,973,728,245,984,728,256,1244,922,297,1023,730,236
060374807031,815,610,205,821,598,223,1023,823,181,856,639,167
060374825211,312,236,76,319,233,86,545,360,174,392,289,80
060374825213,360,267,93,361,255,106,614,421,182,447,348,81
060375035013,438,279,159,443,274,169,703,429,255,532,334,173
060375035011,457,290,167,466,280,186,651,403,236,485,285,169
060375035012,785,502,283,804,485,319,1284,803,455,950,576,309
060375032021,582,410,172,596,404,192,956,621,316,718,502,169
060375033022,691,483,208,692,468,224,1293,809,445,969,640,268
060375029011,451,319,132,457,310,147,665,446,209,563,381,149
060375029013,448,328,120,454,319,135,671,449,205,542,372,142
060375031061,405,258,147,407,256,151,718,426,262,545,353,164
060375033023,392,241,151,397,236,161,609,387,213,477,296,147
060375033021,611,412,199,617,403,214,903,554,327,742,471,227
060375035021,493,294,199,500,288,212,770,465,295,587,323,231
060375035022,434,258,176,441,254,187,703,420,271,517,286,195
060375037012,833,452,381,851,433,418,1223,679,523,992,522,409
060375034013,477,263,214,483,253,230,695,380,299,580,306,243
060375037011,781,416,365,803,392,411,1116,586,505,856,457,350
060375037021,1120,581,539,1133,562,571,1560,839,690,1252,621,566
060375037022,853,446,407,866,418,448,1286,661,593,1030,497,463
060375030003,267,222,45,268,210,58,402,289,97,333,267,52
060375030004,293,244,49,293,232,61,448,328,109,364,289,55
060375031031,377,284,93,380,279,101,590,412,160,457,344,87
060375031052,383,262,121,385,257,128,638,438,187,488,337,124
060375032023,332,241,91,338,230,108,533,352,168,449,311,112
060375031062,161,109,52,162,107,55,272,186,80,210,144,54
060375031032,309,234,75,311,230,81,508,345,148,407,302,82
060375031034,256,202,54,259,199,60,410,292,109,330,253,61
060375031033,155,118,37,155,115,40,262,179,77,194,144,39
060375031041,475,369,106,475,359,116,827,586,217,619,465,116
060375030002,282,239,43,284,233,51,484,362,107,363,287,56
060375032011,535,341,194,534,332,202,737,467,253,632,372,214
060375032012,533,337,196,547,338,209,801,515,266,660,411,206
060375032013,313,198,115,320,198,122,493,312,167,381,238,119
060375042003,357,284,73,362,266,96,649,460,175,508,383,98
060375032022,244,165,79,245,158,87,428,288,129,351,223,104
060375020052,536,345,191,543,326,217,846,562,261,689,429,222
060375020051,411,284,127,425,279,146,589,386,184,514,331,148
060375031051,372,254,118,382,255,127,578,378,185,494,343,122
060375031063,352,240,112,362,241,121,551,361,176,445,309,108
060379203263,861,511,350,884,505,379,1262,734,501,990,564,380
060379203262,376,226,150,389,226,163,559,331,219,473,267,183
060379203383,776,416,360,786,409,377,1091,637,435,835,441,350
060379203392,1172,633,539,1197,619,578,1727,973,729,1275,676,536
060379203382,971,514,457,997,517,480,1389,801,567,1043,545,443
060379203391,1582,807,775,1605,789,816,2337,1277,1028,1720,841,792
060379203381,687,358,329,712,361,351,937,496,426,747,384,316
060371041242,539,398,141,546,395,151,869,605,242,695,505,154
060371041243,212,135,77,213,124,89,302,171,114,266,138,93
060371042042,316,260,56,321,254,67,570,436,123,429,342,63
060374801011,405,221,184,423,221,202,776,471,290,506,281,186
060374801012,195,115,80,206,118,88,356,228,124,222,139,69
060374812011,203,131,72,207,127,80,378,223,148,265,162,85
060374321022,317,190,127,325,187,138,571,338,226,418,250,147
060374321024,195,118,77,204,120,84,331,204,127,258,159,89
060374319003,354,196,158,360,195,165,595,357,228,416,244,151
060374320023,256,141,115,262,141,121,439,264,169,299,176,106
060374320021,544,301,243,563,296,267,889,501,362,650,351,260
060374320024,415,224,191,430,226,204,665,388,259,509,286,189
060374321023,297,160,137,308,163,145,467,273,188,349,197,131
060374319001,244,138,106,250,136,114,388,232,148,278,157,105
060374319002,321,182,139,329,179,150,529,315,200,376,214,139
060374801013,394,228,166,416,231,185,612,374,230,459,269,164
060374318001,486,254,232,507,259,248,795,444,328,537,300,213
060374320012,293,161,132,298,165,133,476,301,168,356,225,113
060374321013,345,193,152,349,193,156,543,329,205,450,267,161
060374315013,396,253,143,413,254,159,677,427,244,495,314,152
060374320011,405,243,162,410,236,174,639,402,224,493,311,154
060374315012,421,258,163,433,258,175,690,432,245,524,324,173
060374321012,401,231,170,408,228,180,698,397,289,502,288,187
060378001032,422,328,94,432,333,99,527,410,106,454,329,95
060378005063,724,463,261,737,463,274,907,654,230,767,536,203
060376500011,401,231,170,412,239,173,582,358,211,473,281,163
060376500012,288,168,120,295,171,124,423,261,156,321,192,111
060376500013,670,425,245,694,428,266,1030,674,332,796,498,248
060376500014,345,206,139,357,213,144,490,309,170,413,253,136
060376500041,261,162,99,267,162,105,388,240,142,292,175,94
060376500043,387,240,147,391,242,149,566,368,184,422,259,129
060376500042,242,155,87,243,156,87,351,224,119,300,191,84
060376500031,479,326,153,488,322,166,748,472,254,538,345,158
060376500032,338,228,110,343,227,116,527,332,178,384,246,112
060376503001,334,191,143,333,186,147,454,289,158,406,235,144
060376503002,586,350,236,588,344,244,839,530,289,595,352,200
060376514012,528,278,250,538,281,257,650,356,284,626,313,275
060376500015,321,208,113,335,209,126,475,315,151,373,236,112
060376500044,294,192,102,297,194,103,482,310,159,372,241,100
060376501021,272,158,114,276,153,123,392,249,132,326,190,115
060376501022,611,354,257,625,345,280,905,567,321,747,428,266
060376502003,545,326,219,555,323,232,876,516,335,664,394,227
060376501013,651,394,257,672,387,285,959,605,325,733,429,257
060376501014,484,296,188,505,287,218,710,441,251,530,301,199
060376501011,600,391,209,621,413,208,880,562,297,702,470,209
060376501012,403,241,162,412,242,170,541,354,178,435,263,142
060376507011,358,198,160,365,197,168,477,273,193,402,213,162
060376507012,881,480,401,892,472,420,1225,719,481,988,530,397
060376507022,765,415,350,779,410,369,1005,600,388,866,451,337
060376503003,440,294,146,448,295,153,688,429,244,561,356,167
060376503004,475,302,173,486,305,181,713,431,265,598,367,187
060376503005,566,378,188,586,380,206,850,552,275,708,451,210
060376511021,552,332,220,570,333,237,901,548,327,710,398,258
060376512212,351,220,131,355,216,139,552,337,204,407,240,139
060376512211,619,389,230,631,385,246,988,559,406,748,449,239
060376509012,375,246,129,383,248,135,574,365,198,429,270,136
060376509013,584,363,221,597,362,235,734,472,258,659,389,223
060376509014,684,437,247,693,428,265,965,602,331,746,442,253
060376502002,394,234,160,402,232,170,587,344,231,460,257,165
060376502004,721,427,294,738,423,315,1094,671,401,892,494,337
060376502001,448,250,198,465,256,209,652,389,245,551,300,201
060379800051,0,0,0,0,0,0,1,1,0,2,2,0
060376509041,218,142,76,222,136,86,345,217,118,253,160,84
060376509042,534,347,187,544,336,208,723,460,247,591,373,194
060376509033,287,172,115,294,169,125,458,289,159,360,213,129
060376505021,1190,658,532,1211,659,552,1627,941,649,1388,723,571
060376509031,583,348,235,601,343,258,912,573,319,733,419,260
060376509032,491,310,181,508,312,196,808,517,278,583,345,193
060376505022,756,378,378,780,386,394,1021,589,413,835,424,348
060376506031,958,502,456,984,499,485,1287,802,463,1129,583,470
060376506032,679,394,285,692,386,306,928,560,350,769,434,291
060376506062,614,377,237,624,372,252,942,578,337,756,459,256
060376506071,591,380,211,607,385,222,1025,668,338,693,446,211
060376504011,414,202,212,429,207,222,619,356,239,484,229,216
060376506051,809,518,291,822,519,303,1181,774,382,932,556,316
060376511012,884,496,388,910,494,416,1258,749,480,1032,560,416
060376507021,668,356,312,690,362,328,865,515,334,760,368,336
060376509011,624,414,210,639,419,220,944,585,316,731,455,223
060376504015,301,157,144,309,156,153,423,245,171,343,172,145
060376506042,280,191,89,284,192,92,500,301,186,312,212,80
060376507023,694,362,332,704,357,347,975,556,393,774,403,322
060376504012,308,178,130,312,173,139,404,247,152,353,201,132
060376504013,426,250,176,436,243,193,586,361,209,477,271,175
060376504014,435,254,181,443,247,196,593,363,215,461,262,171
060376506043,412,292,120,421,296,125,773,462,290,588,391,159
060376510011,519,283,236,531,283,248,686,384,287,565,299,227
060376510012,504,286,218,510,280,230,677,398,263,547,302,212
060376510021,422,218,204,433,219,214,609,340,254,474,243,202
060376510022,553,281,272,566,280,286,808,459,330,671,339,293
060376511011,1129,581,548,1151,578,573,1538,901,607,1290,664,545
060376510023,418,237,181,428,234,194,613,353,248,491,262,194
060376510013,737,413,324,744,404,340,1082,643,406,831,446,326
060376510014,398,219,179,404,215,189,559,334,212,463,243,185
060376508022,459,289,170,468,286,182,689,446,235,564,351,179
060376508012,625,395,230,636,386,250,993,639,338,680,431,209
060376508011,792,497,295,802,492,310,1219,772,432,872,559,273
060376512012,883,427,456,905,429,476,1163,609,526,960,465,433
060376512011,551,270,281,566,277,289,766,398,344,586,302,251
060376512013,349,165,184,355,164,191,441,249,182,412,190,189
060376511022,755,441,314,779,439,340,1077,645,405,894,493,342
060376512223,820,475,345,843,482,361,1115,656,431,892,506,335
060376512222,389,236,153,398,237,161,572,356,203,480,278,175
060376512014,637,306,331,655,296,359,863,466,373,734,356,337
060376513022,977,537,440,996,537,459,1259,739,487,1077,583,427
060376514021,404,223,181,417,226,191,581,340,234,456,256,173
060376514022,696,393,303,713,400,313,926,569,350,798,440,308
060376514023,859,478,381,885,479,406,1240,705,514,961,539,363
060376514024,358,198,160,369,199,170,516,300,207,425,235,162
060376512221,697,411,286,703,401,302,1041,623,391,841,471,319
060376513021,458,258,200,465,257,208,666,392,260,518,281,200
060376513023,398,202,196,405,202,203,456,253,188,405,213,173
060376513024,417,218,199,425,215,210,548,323,212,460,228,197
060376513025,463,240,223,472,237,235,579,342,227,468,234,201
060376513041,394,231,163,399,231,168,595,352,229,463,272,156
060376513044,283,164,119,286,163,123,341,202,132,284,154,112
060376513045,472,264,208,482,260,222,584,343,226,444,247,167
060376513026,494,257,237,503,252,251,575,338,229,509,255,220
060376513043,769,455,314,781,455,326,1076,626,420,843,476,311
060376506041,252,179,73,257,181,76,441,288,142,294,196,75
060376506044,219,156,63,224,157,67,391,254,126,240,160,60
060376506061,358,233,125,369,235,134,613,397,204,463,299,140
060376505012,400,189,211,409,189,220,517,281,226,460,218,214
060376505011,542,274,268,553,268,285,744,406,324,632,322,266
060371437003,670,559,111,676,554,122,805,678,117,656,543,90
060379800391,0,0,0,0,0,0,1,0,1,1,0,1
060374081381,204,168,36,203,161,42,344,261,74,255,204,37
060374081382,517,432,85,521,414,107,903,692,189,682,561,87
060374081383,262,226,36,261,207,54,420,309,100,388,326,41
060374081391,305,267,38,310,260,50,587,459,112,424,374,33
060374081392,428,366,62,433,354,79,635,490,131,557,479,51
060374081401,412,347,65,410,333,77,709,541,146,562,464,63
060374081402,172,151,21,173,143,30,280,219,58,240,197,28
060374081411,226,185,41,228,179,49,368,281,79,306,247,43
060374081412,422,346,76,429,336,93,708,541,147,552,440,77
060374081413,368,292,76,372,280,92,647,476,157,456,353,74
060374081373,372,266,106,379,266,113,573,380,180,437,303,112
060374066023,421,285,136,417,272,145,702,459,231,525,355,135
060374075021,228,180,48,231,175,56,428,300,112,296,224,50
060374075023,276,218,58,280,215,65,445,329,112,336,267,50
060374079011,349,276,73,353,272,81,575,423,142,420,317,80
060374075011,295,240,55,296,230,66,525,374,141,360,295,52
060374073012,324,263,61,326,254,72,497,352,135,417,326,66
060374073013,297,246,51,299,236,63,478,340,129,382,309,54
060374073021,280,234,46,287,227,60,444,340,100,359,288,49
060374073022,311,259,52,311,250,61,467,352,104,391,316,56
060374073023,239,203,36,238,193,45,395,303,89,320,255,48
060374075014,174,136,38,175,133,42,306,217,87,240,173,46
060374075022,326,256,70,327,242,85,566,382,159,418,312,81
060374079012,302,237,65,304,226,78,487,343,139,399,289,89
060374078023,450,355,95,449,337,112,771,558,192,606,467,104
060374078022,354,278,76,357,268,89,584,425,146,471,370,76
060374078012,440,349,91,450,342,108,742,533,192,589,447,110
060374078013,294,235,59,300,230,70,491,354,129,430,325,81
060374078011,339,276,63,347,270,77,569,408,149,443,346,75
060374080041,665,470,195,673,455,218,1072,746,307,801,570,193
060374073011,303,238,65,310,229,81,463,332,128,340,268,53
060374066012,618,429,189,629,424,205,960,622,320,735,504,190
060374080031,582,431,151,594,424,170,934,640,272,761,561,158
060374080032,684,477,207,701,473,228,1114,738,364,793,555,208
060374066022,359,249,110,351,234,117,583,380,189,443,302,110
060374079013,345,272,73,351,258,93,536,369,154,428,323,84
060379800171,148,109,39,149,107,42,271,194,72,165,118,38
060377032001,682,646,36,684,650,34,843,789,36,748,704,25
060377032002,528,498,30,532,498,34,681,630,38,580,539,25
060377032003,389,367,22,397,365,32,509,475,26,410,373,16
060377032004,572,539,33,574,534,40,701,653,45,628,575,29
060377032006,545,514,31,543,502,41,702,649,48,580,531,24
060377031002,703,655,48,717,666,51,854,812,41,783,719,37
060377032005,730,686,44,739,692,47,850,799,38,782,722,31
060377031003,641,588,53,657,599,58,789,727,48,717,657,37
060377031001,490,460,30,496,464,32,564,540,24,502,473,14
060377031006,330,309,21,339,312,27,401,379,22,253,238,8
060374034011,489,285,204,498,284,214,690,431,243,569,343,195
060374034012,428,245,183,447,246,201,606,351,248,525,314,183
060374034021,704,406,298,730,411,319,1128,703,407,833,511,284
060374034041,311,188,123,324,183,141,576,349,217,417,244,149
060374034042,513,331,182,520,318,202,755,455,286,574,361,191
060374034071,384,228,156,397,227,170,511,313,193,374,222,132
060374034092,900,560,340,926,544,382,1324,806,497,1009,596,351
060374034072,388,232,156,405,232,173,672,412,249,448,273,153
060374034091,737,458,279,762,463,299,861,523,324,725,439,244
060374034031,787,461,326,820,472,348,1140,696,432,863,538,293
060374034022,408,236,172,422,236,186,631,385,236,467,276,166
060374034081,326,212,114,333,208,125,473,294,172,364,238,110
060374034083,694,451,243,715,443,272,1113,694,404,796,520,241
060374034033,471,279,192,498,282,216,747,453,281,568,367,176
060374034013,817,496,321,833,482,351,1280,803,464,980,626,314
060374034082,376,240,136,387,232,155,566,355,204,407,264,119
060374034084,368,234,134,375,225,150,546,338,198,425,275,126
060374034085,483,298,185,499,287,212,776,482,284,586,354,200
060374034032,546,310,236,559,314,245,775,488,280,622,398,208
060375348031,278,247,31,280,238,42,509,396,97,387,333,33
060375348032,245,216,29,248,208,40,434,352,71,334,289,28
060375348041,345,313,32,348,303,45,641,534,87,463,410,31
060375348042,263,243,20,264,235,29,463,389,64,357,323,20
060375348021,370,332,38,366,318,48,623,489,112,520,448,45
060375348022,221,197,24,221,190,31,357,286,67,315,270,29
060375347001,556,500,56,556,479,77,842,681,145,752,644,69
060375348033,320,278,42,320,270,50,502,413,82,451,389,41
060376001001,474,443,31,478,439,39,749,661,75,537,498,22
060376001002,228,209,19,231,206,25,413,359,38,235,220,11
060376001003,389,354,35,393,349,44,624,543,64,541,501,26
060376002012,313,282,31,319,285,34,465,405,53,560,490,22
060376002013,217,197,20,223,200,23,339,292,41,116,102,4
060376002021,328,295,33,329,292,37,557,484,60,424,383,23
060376004003,450,424,26,451,416,35,565,519,35,528,492,22
060376004004,569,540,29,573,537,36,789,721,51,664,624,22
060376002022,588,554,34,595,556,39,904,794,89,709,658,24
060376002023,335,315,20,339,317,22,526,456,59,391,362,13
060376002011,303,280,23,307,281,26,492,454,31,397,367,18
060376003021,583,546,37,586,544,42,722,635,65,692,647,25
060376004001,332,317,15,332,318,14,516,478,26,405,388,9
060376004002,250,239,11,250,240,10,373,344,20,315,298,8
060376003022,320,299,21,334,310,24,436,401,32,374,343,16
060376003023,352,334,18,361,334,27,504,458,38,437,408,17
060376003032,149,143,6,152,143,9,330,293,31,213,201,7
060376003033,183,168,15,181,164,17,337,293,35,254,229,12
060376003043,119,115,4,123,115,8,246,212,24,174,162,6
060376003041,274,245,29,276,246,30,401,348,40,372,333,27
060376003042,145,130,15,145,130,15,211,187,22,176,162,13
060376028011,324,302,22,328,303,25,540,475,46,420,382,16
060376028021,403,374,29,413,376,37,568,510,48,528,483,21
060376028022,343,317,26,348,316,32,492,443,43,377,354,11
060376028012,441,408,33,447,408,39,661,597,53,584,535,27
060376028023,355,328,27,358,327,31,462,421,40,535,485,29
060376028024,517,481,36,525,482,43,698,626,59,611,562,33
060376003031,230,210,20,232,209,23,416,371,43,306,280,15
060372920011,367,308,59,374,307,67,750,577,156,558,448,79
060375435021,326,254,72,328,245,83,563,370,178,419,311,86
060375435022,240,187,53,244,182,62,388,259,124,312,236,67
060375435023,624,400,224,630,380,250,915,599,288,745,468,235
060375435031,610,386,224,620,386,234,1005,632,350,739,486,211
060375435033,626,422,204,633,422,211,1010,654,336,726,494,192
060375436062,699,498,201,710,494,216,1109,725,362,834,589,197
060375436052,573,416,157,593,426,167,874,587,267,731,529,159
060375436051,774,522,252,782,500,282,1198,803,368,913,600,262
060375436031,815,556,259,814,555,259,1188,815,348,934,606,282
060375436032,890,715,175,886,683,203,1234,867,346,1014,771,188
060375436061,269,191,78,273,188,85,402,265,128,323,225,78
060375435032,308,195,113,312,194,118,467,294,167,380,246,117
060375411001,191,180,11,195,178,17,224,200,22,223,200,12
060375411002,364,342,22,367,338,29,545,468,67,469,425,22
060375430003,459,419,40,455,415,40,658,577,66,593,540,29
060374053021,453,328,125,455,312,143,806,528,258,534,380,127
060374053011,350,255,95,360,247,113,659,439,207,500,363,104
060374053022,531,369,162,539,359,180,853,568,270,656,446,167
060374053023,491,323,168,503,324,179,768,508,242,582,374,170
060374081332,278,228,50,283,216,67,601,443,149,427,323,85
060374055004,280,194,86,282,185,97,441,292,137,360,244,94
060374055003,423,292,131,430,283,147,678,453,214,540,359,151
060374055002,505,343,162,506,332,174,751,489,240,555,363,164
060374056001,584,393,191,591,386,205,746,482,249,629,405,190
060374055005,204,138,66,209,138,71,564,357,196,414,271,121
060374056002,436,297,139,442,291,151,585,372,200,439,285,136
060374079021,542,412,130,552,398,154,905,629,270,684,503,148
060374056003,256,174,82,261,173,88,409,267,137,318,204,99
060374056004,297,203,94,305,201,104,492,317,164,355,234,106
060374056005,367,251,116,376,252,124,616,398,205,441,297,119
060374062011,344,235,109,354,237,117,575,375,191,439,296,115
060374068012,533,355,178,545,357,188,980,647,317,763,523,214
060374063002,565,333,232,578,331,247,870,518,335,680,363,282
060374063003,622,325,297,634,313,321,861,506,343,664,349,293
060374064135,555,348,207,559,334,225,848,534,299,625,405,189
060374064133,395,249,146,403,241,162,584,359,219,433,259,154
060374064134,561,354,207,569,342,227,861,508,343,641,381,229
060374064131,291,210,81,291,213,78,523,360,153,379,269,89
060374065001,279,199,80,279,198,81,467,323,136,366,249,95
060374065002,571,397,174,572,389,183,969,631,326,701,468,195
060374067021,264,189,75,269,187,82,463,307,144,365,254,89
060374067024,442,308,134,448,294,154,885,575,294,626,402,182
060374068011,301,218,83,311,218,93,433,287,138,378,259,100
060374068013,451,327,124,462,329,133,779,513,247,626,427,165
060374080051,578,322,256,594,315,279,834,503,313,651,365,255
060374080052,468,294,174,475,283,192,755,456,285,621,366,223
060374074001,623,455,168,640,445,195,996,689,289,660,472,141
060374067011,398,292,106,400,290,110,607,395,199,475,333,112
060374067012,566,408,158,572,398,174,843,565,262,678,472,169
060374067022,306,221,85,313,212,101,483,324,152,412,275,119
060374067023,525,359,166,518,329,189,784,525,244,575,406,134
060374064136,263,164,99,270,160,110,410,258,146,314,177,119
060374064132,391,254,137,397,246,151,596,378,207,475,318,132
060374081351,746,523,223,752,504,248,1261,835,405,899,629,234
060374081372,298,216,82,302,216,86,533,359,164,347,240,87
060374081331,403,282,121,415,269,146,621,398,214,459,333,105
060374081333,420,299,121,428,289,139,762,503,248,532,369,137
060374081361,544,378,166,560,370,190,968,637,320,721,470,210
060374081362,521,351,170,531,349,182,751,507,231,633,421,178
060374081341,892,611,281,909,605,304,1358,900,444,1035,718,276
060374081352,304,219,85,309,214,95,523,350,168,391,273,101
060374069034,420,302,118,434,312,122,716,484,220,544,373,141
060374062012,428,314,114,426,298,128,714,495,197,562,394,133
060374065003,499,343,156,505,330,175,790,508,275,604,424,148
060374065004,492,349,143,496,345,151,755,521,228,640,444,153
060374066011,576,385,191,579,370,209,881,558,307,710,466,204
060374066021,486,335,151,490,322,168,804,516,271,648,408,206
060374066013,601,405,196,610,398,212,926,589,321,692,455,206
060374080053,311,200,111,313,192,121,492,296,184,334,229,89
060374080061,864,620,244,870,606,264,1640,1013,587,1080,749,273
060374081371,212,171,41,213,161,52,409,277,127,270,206,46
060377001023,658,566,92,651,562,89,889,695,174,756,602,113
060377002006,645,566,79,651,568,83,730,591,129,720,600,86
060377003001,642,570,72,643,571,72,777,668,103,707,612,72
060377005012,460,400,60,463,398,65,591,491,93,520,434,66
060377005021,718,611,107,726,608,118,1010,825,178,802,655,119
060377001013,446,381,65,450,384,66,566,441,112,475,363,88
060377001014,627,535,92,632,540,92,824,650,164,689,528,133
060377002003,507,466,41,516,475,41,621,539,70,568,503,45
060377002005,469,417,52,475,420,55,586,496,85,541,465,57
060377003003,1042,946,96,1053,955,98,1202,1029,157,1131,983,103
060377003002,979,888,91,988,893,95,1102,927,164,1019,884,106
060377005022,1024,927,97,1032,927,105,1195,1026,157,1062,929,96
060377005023,503,446,57,500,437,63,640,549,85,532,457,54
060377005011,808,714,94,818,719,99,1004,824,164,918,784,108
060377005013,678,579,99,686,584,102,727,598,119,691,587,87
060377002001,445,396,49,448,398,50,482,411,64,481,416,48
060371898011,679,588,91,684,588,96,913,752,145,727,620,76
060377002002,735,671,64,740,675,65,998,834,153,804,703,67
060377002004,717,642,75,731,653,78,963,819,131,796,688,83
060377001012,569,489,80,575,491,84,793,629,151,635,514,97
060377001015,394,349,45,395,346,49,473,374,94,431,344,69
060377001011,612,546,66,616,544,72,839,651,167,587,476,78
060377001022,598,523,75,603,518,85,891,664,208,543,444,69
060377001021,557,481,76,558,478,80,686,521,151,634,508,88
060377004001,876,772,104,890,775,115,1125,912,201,980,841,111
060377004002,271,244,27,274,245,29,354,300,51,313,274,31
060377004003,1015,898,117,1028,906,122,1180,976,184,1057,914,111
060377004004,510,443,67,518,451,67,572,488,83,559,482,61
060377003004,701,605,96,707,613,94,851,708,130,767,650,92
060371352051,731,485,246,737,483,254,914,620,289,799,543,227
060378003385,302,169,133,310,163,147,453,256,187,325,176,133
060378003251,927,518,409,948,523,425,1150,666,456,981,536,402
060378003252,1000,533,467,1020,541,479,1278,753,504,1091,567,472
060378003351,816,428,388,834,434,400,1043,591,429,856,453,348
060378003352,1124,581,543,1148,583,565,1455,831,598,1231,668,496
060375002023,343,199,144,348,192,156,492,281,202,387,218,148
060375002024,508,277,231,515,265,250,719,410,296,571,303,240
060375019001,502,300,202,504,284,220,738,444,271,592,339,218
060375019003,427,263,164,432,254,178,634,385,234,493,304,153
060375020053,260,178,82,265,172,93,453,292,145,330,219,92
060375016003,454,263,191,460,256,204,606,375,217,472,265,178
060375016004,417,239,178,425,235,190,503,307,191,448,254,172
060375017001,465,280,185,472,268,204,570,340,219,487,282,179
060375018021,425,268,157,427,261,166,584,375,193,463,287,152
060375018022,261,170,91,260,165,95,381,245,124,302,192,91
060375015042,319,224,95,326,223,103,516,356,152,394,277,95
060375016005,354,216,138,359,211,148,433,280,138,375,214,136
060375019004,279,185,94,282,183,99,476,287,174,359,240,98
060375020031,360,245,115,365,240,125,589,429,151,481,327,129
060375020032,238,185,53,245,180,65,461,336,118,354,273,60
060375013021,567,385,182,574,381,193,745,510,227,643,407,199
060375013023,228,168,60,237,166,71,396,270,120,273,180,70
060375013011,492,360,132,499,360,139,788,533,233,586,413,138
060375019002,299,177,122,304,169,135,475,293,179,365,203,142
060375015011,1051,695,356,1066,678,388,1421,938,454,1222,772,377
060375013022,595,437,158,608,428,180,1053,715,312,697,476,163
060375015031,348,256,92,353,249,104,523,339,172,421,296,93
060375014001,393,291,102,404,282,122,618,440,156,486,327,113
060375015033,535,364,171,541,346,195,788,504,266,605,379,175
060375015034,296,221,75,297,212,85,552,388,139,402,280,84
060375015041,371,265,106,375,258,117,577,379,184,469,311,121
060375015032,298,196,102,305,193,112,408,264,142,326,204,101
060375034021,709,398,311,726,385,341,1018,556,443,795,427,316
060375035023,482,265,217,489,252,237,734,413,296,572,297,244
060375016002,396,250,146,396,248,148,612,380,216,446,280,139
060375018023,452,303,149,446,292,154,682,440,224,576,366,170
060375017003,398,252,146,399,241,158,574,364,195,450,272,149
060375017004,336,215,121,338,203,135,507,323,178,391,239,130
060375018031,376,296,80,379,287,92,628,443,160,445,333,80
060375018032,344,277,67,350,267,83,631,470,148,454,340,83
060375018042,101,82,19,104,79,25,214,149,59,133,101,24
060375014003,341,247,94,347,241,106,498,368,115,430,310,91
060375017002,411,261,150,417,254,163,608,385,214,463,279,158
060375033011,425,267,158,432,265,167,633,380,236,503,304,170
060375033012,436,267,169,445,272,173,642,390,240,505,300,169
060375002033,1032,519,513,1050,514,536,1415,742,646,1158,551,542
060375034011,483,235,248,492,223,269,724,370,339,508,235,251
060375034012,658,346,312,678,333,345,978,505,458,819,413,360
060375002031,411,196,215,410,189,221,584,300,273,473,198,242
060375002032,459,238,221,474,232,242,622,340,270,520,257,229
060375020041,344,250,94,350,240,110,539,394,129,442,309,111
060375033013,461,299,162,462,286,176,675,412,257,551,337,186
060375034014,383,211,172,386,191,195,579,323,250,484,270,179
060375002021,378,175,203,380,172,208,507,259,230,431,192,208
060375002022,290,134,156,293,133,160,467,240,216,331,146,160
060375034022,640,368,272,656,359,297,890,510,361,708,392,269
060375034023,419,247,172,430,242,188,613,352,251,464,263,168
060375034015,450,250,200,456,241,215,767,428,326,547,291,229
060375013012,546,398,148,555,394,161,816,570,235,669,475,159
060375014002,233,177,56,240,177,63,420,307,99,297,218,57
060375015043,208,158,50,214,158,56,375,276,89,279,203,55
060375018041,310,242,68,311,235,76,572,419,139,428,310,81
060375020042,504,408,96,519,393,126,859,636,209,695,548,114
060375406001,520,486,34,528,486,42,808,696,94,706,642,38
060375406002,228,212,16,232,211,21,399,342,50,326,297,17
060375407002,387,357,30,392,355,37,573,495,62,466,435,13
060375407001,295,275,20,304,281,23,480,413,56,379,350,20
060375404001,170,148,22,171,141,30,227,192,30,213,195,11
060375404002,241,210,31,239,198,41,316,267,41,301,273,16
060375408005,487,450,37,489,445,44,797,707,68,577,526,25
060375414011,271,249,22,271,244,27,497,433,52,388,356,16
060375414012,227,212,15,227,208,19,390,341,42,311,293,13
060375414021,143,133,10,144,131,13,245,211,31,204,187,8
060375414023,202,190,12,204,184,20,378,322,35,285,253,13
060375408001,238,221,17,242,222,20,330,302,28,284,262,14
060375414022,178,168,10,179,163,16,310,280,29,246,225,10
060375415001,250,228,22,253,224,29,407,340,57,344,312,17
060375415003,324,297,27,322,283,39,498,426,62,483,444,25
060375415002,220,201,19,229,204,25,364,306,46,328,299,15
060375408003,311,289,22,314,289,25,493,434,40,367,333,16
060379001042,391,232,159,398,211,187,726,413,290,574,302,233
060379001043,479,283,196,484,262,222,672,389,255,558,311,205
060379001021,149,63,86,153,65,88,270,128,139,214,110,98
060379001031,366,215,151,371,201,170,579,343,219,502,272,196
060379001032,413,234,179,424,240,184,655,385,249,550,276,223
060379001033,425,239,186,432,229,203,656,367,264,518,289,185
060379001041,443,245,198,452,237,215,686,380,277,547,269,240
060372717041,388,312,76,400,316,84,451,371,74,455,362,69
060372717031,481,401,80,494,404,90,611,500,95,552,449,73
060372760003,610,445,165,616,444,172,823,604,199,772,541,189
060372760005,478,351,127,483,348,135,582,430,142,516,368,123
060372127021,554,452,102,564,458,106,848,659,178,665,550,86
060372127023,305,254,51,310,250,60,395,308,83,324,272,41
060372161001,309,254,55,314,253,61,383,307,76,332,282,42
060372161003,366,323,43,370,325,45,467,404,58,399,343,36
060372162011,573,495,78,573,492,81,695,600,90,608,519,72
060371064051,341,276,65,347,270,77,554,413,128,466,372,74
060371064052,282,227,55,285,219,66,480,356,113,391,303,68
060371065201,529,412,117,534,384,150,804,567,222,659,489,137
060371065203,327,259,68,328,239,89,496,359,126,421,324,73
060371831031,629,540,89,634,528,106,854,725,111,718,582,94
060371831041,845,715,130,853,693,160,1156,930,206,998,798,141
060371112043,752,419,333,756,416,340,1044,600,429,837,448,357
060371131021,725,391,334,734,391,343,1032,573,439,881,490,348
060371131022,670,369,301,679,369,310,906,504,384,812,424,350
060371112041,1120,683,437,1139,681,458,1520,919,573,1315,785,454
060371112042,869,549,320,901,559,342,1203,780,411,1023,651,319
060372756043,2208,1866,342,2248,1891,357,3286,2730,501,1835,1506,250
060371014002,660,399,261,666,392,274,932,532,375,705,406,253
060371014003,460,282,178,465,277,188,676,377,279,548,322,185
060371131011,709,397,312,729,398,331,984,558,403,779,418,315
060371131012,837,471,366,853,474,379,1122,640,458,919,523,338
060371132121,476,294,182,485,286,199,711,424,273,578,322,228
060371132131,1029,615,414,1041,611,430,1494,908,559,1232,705,464
060371132132,559,369,190,567,368,199,866,577,272,615,390,184
060371041031,486,408,78,491,397,94,784,604,167,648,536,80
060371133232,431,314,117,436,306,130,704,473,218,569,402,137
060371133231,630,436,194,641,437,204,921,620,287,775,491,245
060371133011,346,201,145,351,202,149,439,269,161,408,215,169
060371133221,896,530,366,914,536,378,1182,708,446,961,572,347
060371133031,1002,626,376,1026,636,390,1423,910,484,1170,719,392
060371133222,856,534,322,872,527,345,1254,808,420,985,590,339
060371133241,436,321,115,439,310,129,814,532,264,583,420,131
060371133012,948,623,325,975,622,353,1531,1057,452,994,647,297
060371133032,604,398,206,609,398,211,938,584,338,733,459,231
060372043003,353,335,18,351,321,30,532,459,62,387,340,25
060372043001,355,332,23,353,314,39,569,479,74,480,420,35
060372753132,617,500,117,626,501,125,868,687,167,667,520,111
060372753121,957,744,213,969,756,213,1268,985,259,1054,823,193
060372756052,528,445,83,534,447,87,775,640,121,646,525,96
060372766011,547,376,171,553,370,183,694,494,186,713,481,191
060372781022,668,507,161,679,510,169,812,631,166,680,486,151
060372781023,578,403,175,584,406,178,702,500,190,481,319,130
060371032021,789,403,386,816,402,414,1089,573,494,947,482,413
060379800211,28,23,5,27,21,6,17,11,6,32,29,3
060371916102,493,446,47,499,438,61,752,629,110,546,469,46
060371925201,501,452,49,499,429,70,788,627,139,606,525,52
060371926102,201,181,20,202,175,27,295,246,45,233,196,22
060371926103,420,373,47,422,357,65,648,508,119,532,446,50
060372117032,518,445,73,527,440,87,782,610,159,582,486,65
060372117041,348,294,54,355,291,64,529,397,120,382,321,42
060372117042,463,387,76,470,383,87,665,482,166,486,407,58
060371926101,306,273,33,308,264,44,456,365,80,345,296,30
060371927001,342,307,35,347,303,44,553,462,84,422,363,35
060371927002,514,456,58,521,447,74,798,642,143,667,564,66
060372087201,260,219,41,268,215,53,506,403,92,332,278,31
060372087202,223,188,35,230,185,45,346,254,83,265,224,25
060372111231,303,254,49,312,252,60,654,526,115,268,214,43
060372122041,252,216,36,258,211,47,424,314,99,324,277,30
060372211201,166,153,13,172,153,19,329,270,56,283,257,17
060372211202,225,208,17,229,204,25,431,349,72,402,365,23
060371814001,555,477,78,552,457,95,723,572,139,624,530,71
060371816001,667,585,82,665,565,100,867,708,138,784,649,95
060371319003,489,386,103,490,371,119,697,524,157,565,419,111
060371319004,328,258,70,330,250,80,481,361,107,390,292,77
060371323011,512,397,115,523,384,139,855,606,234,710,550,131
060371323021,337,249,88,343,237,106,558,389,159,498,365,104
060371154041,313,228,85,319,231,88,480,325,143,407,291,95
060371154042,408,297,111,419,305,114,683,467,202,538,385,123
060371327003,629,471,158,637,465,172,782,565,205,690,509,139
060371327001,318,238,80,320,233,87,433,310,114,376,268,81
060371327002,411,333,78,421,325,96,746,539,191,567,435,100
060371041081,362,324,38,362,314,48,539,448,77,427,383,27
060371041082,405,346,59,413,339,74,738,591,129,611,522,59
060371041083,285,244,41,290,241,49,503,407,89,355,314,27
060371042011,249,228,21,258,228,30,434,369,58,372,334,21
060371042012,317,290,27,327,286,41,536,451,70,456,410,25
060371042013,285,257,28,289,250,39,455,383,64,414,374,24
060371044011,256,232,24,261,220,41,423,353,59,359,312,28
060371044012,320,289,31,323,277,46,538,439,85,446,393,31
060371044041,229,209,20,233,205,28,396,327,55,320,279,21
060371044042,267,241,26,270,233,37,453,372,73,374,325,29
060371152041,517,386,131,525,381,144,829,585,227,637,431,158
060371152042,592,455,137,595,452,143,879,640,223,683,503,140
060371098001,384,247,137,393,244,149,622,404,205,483,307,155
060371098002,340,233,107,340,223,117,470,313,154,393,264,102
060371098004,405,278,127,411,267,144,605,401,198,516,347,136
060371174041,391,239,152,391,233,158,579,358,214,496,292,175
060371174042,355,216,139,356,212,144,497,307,183,444,263,157
060371974102,679,617,62,683,613,70,819,725,79,730,611,71
060371974103,489,447,42,492,443,49,603,544,51,525,449,39
060371974201,658,606,52,663,593,70,846,724,99,719,623,52
060371974202,741,686,55,745,671,74,944,837,91,820,715,51
060371190031,307,277,30,315,261,54,456,369,73,388,327,42
060371190032,259,221,38,258,211,47,431,338,82,347,290,38
060371190042,397,334,63,393,308,85,627,477,137,466,380,63
060371192012,292,245,47,295,238,57,449,356,83,387,316,50
060371194001,334,282,52,332,270,62,544,425,106,450,369,58
060371173031,879,590,289,897,583,314,1324,864,436,1063,713,304
060371154012,336,245,91,341,240,101,555,361,184,406,273,113
060371154013,389,284,105,395,279,116,649,409,226,463,309,128
060371311001,574,412,162,576,401,175,826,566,242,664,458,171
060371312001,500,356,144,504,346,158,704,484,206,572,392,148
060371312002,516,368,148,525,365,160,722,494,208,579,397,151
060371312003,329,234,95,330,224,106,476,325,139,397,273,101
060371343021,322,203,119,325,196,129,461,285,161,377,232,123
060371343022,623,386,237,631,369,262,856,523,316,734,451,246
060371343023,532,344,188,536,337,199,747,461,269,609,373,196
060371274001,87,73,14,88,70,18,168,125,39,116,93,17
060371274002,361,290,71,366,283,83,546,410,130,435,341,73
060371274003,400,317,83,403,311,92,618,463,144,476,367,83
060371274004,189,158,31,188,151,37,333,239,86,259,209,37
060371272101,183,155,28,185,147,38,288,221,60,243,197,32
060371272201,217,188,29,221,177,44,362,268,85,309,254,41
060371272202,282,231,51,286,224,62,466,338,120,361,284,59
060371272203,385,310,75,393,305,88,685,470,201,498,384,87
060371210102,357,280,77,365,272,93,589,402,177,491,376,90
060371212211,182,152,30,184,145,39,314,228,84,254,211,30
060371212212,353,286,67,356,273,83,600,458,126,456,369,63
060371218021,239,198,41,245,192,53,392,287,98,330,274,43
060371218022,421,348,73,426,335,91,710,526,168,568,452,92
060371343033,452,313,139,459,309,150,672,445,210,540,365,141
060371343034,578,396,182,592,385,207,904,589,300,677,441,201
060371048231,403,339,64,404,321,83,700,526,153,516,428,69
060371212101,450,360,90,458,354,104,719,532,174,566,450,84
060371212102,219,176,43,222,171,51,375,272,89,289,224,53
060371212221,223,183,40,226,178,48,388,285,93,290,239,30
060371343041,252,165,87,253,159,94,354,241,106,304,199,91
060371343042,651,438,213,660,429,231,930,628,279,825,541,237
060371343062,438,307,131,449,304,145,599,421,164,568,380,159
060371190011,584,428,156,590,421,169,890,630,231,696,525,138
060371197002,376,275,101,380,273,107,679,462,194,542,407,111
060371197003,411,308,103,419,305,114,721,523,182,595,458,116
060371343052,120,94,26,120,90,30,210,142,62,146,113,25
060371343051,183,143,40,183,138,45,329,224,98,213,166,37
060371343053,170,133,37,170,128,42,308,209,92,200,155,35
060371343061,318,248,70,322,242,80,551,387,150,401,310,69
060371132343,195,137,58,196,134,62,330,221,100,220,151,56
060371132344,239,174,65,240,171,69,371,249,112,277,198,61
060371342012,289,219,70,290,212,78,506,342,154,371,271,77
060371342013,404,299,105,403,292,111,693,484,189,473,343,100
060371340022,580,400,180,589,397,192,943,622,296,719,492,187
060371342011,372,257,115,378,255,123,576,385,183,458,313,120
060371199001,338,276,62,344,271,73,570,432,128,458,365,69
060371199002,464,370,94,465,361,104,735,565,157,608,476,102
060371201052,242,189,53,244,187,57,401,289,103,314,244,56
060371132371,1040,611,429,1056,602,454,1451,868,557,1196,670,469
060372421001,377,349,28,390,359,31,501,420,57,501,470,12
060371219002,427,349,78,434,342,92,734,542,186,661,543,76
060371221211,296,254,42,295,243,52,524,389,121,406,333,51
060371221222,197,169,28,195,163,32,325,239,82,269,222,29
060371221221,150,129,21,150,126,24,265,200,65,201,166,23
060371222002,380,331,49,384,320,64,655,496,136,529,443,56
060371061142,348,284,64,351,277,74,588,445,129,459,375,56
060371061143,496,399,97,504,387,117,858,651,193,680,562,84
060371310212,342,257,85,346,248,98,566,403,156,455,338,91
060371310211,226,170,56,227,163,64,413,299,106,300,222,60
060371232051,274,235,39,275,231,44,459,357,91,328,280,34
060371232052,154,134,20,155,132,23,259,201,52,188,160,17
060371241031,398,343,55,400,335,65,679,524,146,524,410,80
060371113023,474,313,161,481,314,167,712,441,250,555,354,173
060371113022,328,227,101,329,225,104,480,314,153,369,240,107
060371113024,263,182,81,264,181,83,383,250,122,290,189,84
060371151031,364,328,36,362,322,40,287,213,66,592,505,40
060371241041,354,300,54,358,291,67,594,451,126,468,374,61
060371241042,185,157,28,187,151,36,302,233,65,233,185,31
060371253105,174,146,28,178,145,33,317,269,40,212,177,20
060371253104,194,161,33,194,159,35,351,300,44,182,152,17
060371253103,281,239,42,285,237,48,452,380,60,299,250,29
060371253221,326,283,43,330,283,47,574,490,72,389,324,38
060371236011,249,194,55,252,200,52,398,291,103,288,225,51
060371236012,631,487,144,641,484,157,927,598,309,692,491,167
060371236021,448,348,100,451,356,95,692,500,174,540,422,94
060371347101,443,316,127,453,310,143,738,491,231,548,388,129
060371347201,347,248,99,351,245,106,602,408,183,436,308,104
060371347202,489,358,131,495,354,141,787,525,241,607,435,135
060371347203,350,269,81,354,263,91,600,414,173,453,337,89
060371314002,345,267,78,349,261,88,508,371,129,416,311,84
060371314003,529,411,118,534,400,134,788,577,198,601,450,121
060371314001,738,579,159,756,572,184,1205,896,288,984,757,168
060371061123,462,332,130,466,312,154,746,512,222,537,362,145
060371061131,566,435,131,571,418,153,894,664,209,707,514,151
060371061132,477,372,105,484,357,127,752,542,196,607,430,138
060371061141,288,225,63,292,213,79,592,443,137,335,278,33
060371234101,463,375,88,464,369,95,744,526,203,559,434,96
060371234102,250,203,47,253,200,53,429,298,123,298,232,51
060371278042,458,360,98,463,351,112,698,490,195,530,383,100
060371278043,379,301,78,382,294,88,575,425,137,450,331,81
060371278031,421,347,74,419,342,77,782,561,208,463,367,71
060371278032,472,390,82,471,384,87,795,568,212,546,432,84
060371279102,453,364,89,457,358,99,741,523,202,523,404,86
060371278053,228,192,36,233,192,41,380,289,84,297,238,43
060371278061,230,194,36,236,194,42,386,296,86,297,239,41
060371281022,305,259,46,314,259,55,561,426,124,426,340,57
060371064061,1085,749,336,1095,715,380,1756,1214,507,1248,812,372
060371065101,520,368,152,527,361,166,815,549,244,687,462,186
060371065102,484,347,137,485,337,148,857,582,258,665,485,140
060371282201,386,303,83,391,299,92,621,425,183,469,334,106
060371282202,407,320,87,409,314,95,585,401,172,473,338,107
060371060101,439,317,122,451,313,138,698,471,212,513,353,140
060371064062,260,203,57,263,197,66,440,321,112,362,262,79
060371064063,289,227,62,292,219,73,491,360,124,355,263,73
060371276031,275,213,62,277,208,69,467,336,118,324,243,60
060371276041,296,236,60,300,232,68,475,345,117,376,280,72
060371276042,386,308,78,394,302,92,583,424,144,430,323,81
060379800081,17,14,3,17,14,3,62,46,16,33,27,6
060371276032,215,179,36,217,175,42,363,274,77,257,186,52
060371273002,520,417,103,533,418,115,809,585,203,673,515,121
060371277121,278,228,50,286,223,63,415,308,99,322,240,59
060371277122,343,280,63,348,272,76,507,375,120,419,312,78
060371276052,384,336,48,388,329,59,646,493,138,468,394,51
060371276061,284,234,50,289,232,57,403,312,83,333,261,51
060371276062,510,422,88,521,418,103,772,598,157,593,461,91
060371277111,661,519,142,674,510,164,972,725,227,735,546,143
060371247001,484,356,128,492,363,129,655,453,192,511,382,110
060371247002,566,426,140,574,431,143,736,570,158,598,451,125
060371321011,561,432,129,567,428,139,806,606,181,643,475,124
060371321012,343,267,76,346,264,82,512,387,115,395,290,77
060371321013,422,325,97,425,321,104,595,452,134,505,373,99
060371276051,180,158,22,182,155,27,301,232,62,242,203,27
060371112051,612,414,198,622,410,212,914,559,335,654,419,192
060371321023,857,649,208,874,642,232,1271,908,330,990,728,205
060371320021,305,233,72,309,231,78,481,340,133,384,258,99
060371320022,305,230,75,307,226,81,441,315,123,356,257,77
060371320023,498,376,122,504,374,130,723,511,200,604,419,140
060371091001,333,236,97,341,231,110,493,348,131,412,281,113
060371091002,568,436,132,588,432,156,831,584,224,687,502,147
060371092001,278,194,84,283,192,91,446,287,149,335,228,88
060371093002,446,306,140,453,300,153,689,450,228,585,379,172
060371255011,762,654,108,752,641,111,949,802,129,770,633,88
060371255012,657,566,91,649,555,94,823,674,132,661,541,78
060371096011,381,269,112,387,262,125,605,422,171,483,344,115
060371096013,296,229,67,299,214,85,484,351,125,380,283,74
060371096014,455,344,111,458,326,132,743,540,189,583,435,120
060371329001,506,386,120,516,383,133,727,515,200,596,412,148
060371329002,610,420,190,611,395,216,1056,633,404,748,465,241
060371199003,447,360,87,452,356,96,703,507,187,542,423,95
060371171022,428,321,107,429,318,111,723,519,191,542,405,112
060371172011,357,264,93,360,266,94,537,385,145,442,337,89
060371310241,305,244,61,312,243,69,557,406,145,423,325,82
060371310242,404,327,77,409,322,87,608,427,167,488,374,90
060371323012,230,185,45,235,182,53,372,269,96,307,240,52
060371323022,305,247,58,313,242,71,533,387,139,411,322,70
060371325021,621,488,133,627,473,154,951,630,296,719,544,139
060371325022,400,297,103,407,285,122,625,406,204,452,333,98
060371317021,831,614,217,844,600,244,1196,839,333,1063,743,252
060371325011,514,401,113,520,398,122,952,669,265,644,484,131
060371325012,392,293,99,397,294,103,616,435,167,517,380,113
060371198011,304,248,56,303,240,63,497,368,119,391,316,57
060371198022,341,281,60,344,275,69,541,405,128,432,342,67
060371198012,442,372,70,443,362,81,691,525,151,571,467,76
060371331021,761,563,198,767,555,212,1025,686,320,893,625,218
060371331022,244,182,62,247,180,67,359,238,114,295,207,72
060371319001,386,305,81,394,307,87,558,407,140,452,331,89
060371319002,392,312,80,401,313,88,560,411,133,465,343,93
060371281023,200,170,30,204,168,36,365,276,84,277,223,38
060371281021,269,228,41,274,227,47,467,365,94,379,301,48
060371311003,360,263,97,366,262,104,532,365,157,425,293,110
060371321021,129,100,29,133,100,33,221,165,51,153,115,30
060371321022,668,494,174,670,491,179,956,699,237,760,547,171
060371278041,170,141,29,173,141,32,287,215,66,191,149,30
060371278051,129,107,22,131,107,24,245,186,52,167,130,26
060371278052,268,222,46,271,221,50,446,340,97,308,242,49
060371349011,460,326,134,469,328,141,705,429,262,535,364,145
060371349012,303,213,90,309,215,94,432,262,163,331,224,88
060371349013,410,290,120,422,295,127,588,408,174,480,329,130
060371134261,742,496,246,747,481,266,1148,761,358,856,565,237
060371134281,352,233,119,356,225,131,534,353,171,418,274,118
060371134271,377,267,110,378,255,123,615,413,189,457,314,111
060371134272,240,175,65,240,166,74,408,273,124,315,220,72
060371134282,378,246,132,377,236,141,587,377,199,452,290,128
060371351021,484,314,170,488,310,178,723,458,251,550,345,170
060371351022,563,356,207,571,351,220,717,467,237,647,389,223
060371351023,431,274,157,438,271,167,598,376,214,512,306,180
060371285002,447,357,90,453,357,96,606,472,123,460,349,85
060371285004,506,396,110,510,396,114,683,534,134,529,394,102
060371286023,659,510,149,677,512,165,827,645,169,685,519,136
060372766081,840,678,162,859,682,177,1109,881,205,906,703,148
060371092002,408,285,123,413,283,130,629,407,213,507,341,140
060371092003,201,141,60,205,140,65,311,201,106,284,196,74
060379800221,62,43,19,63,43,20,96,61,31,90,62,23
060371093001,300,200,100,308,199,109,464,300,150,464,291,147
060371093003,310,208,102,315,204,111,477,311,155,501,314,160
060371395051,261,186,75,270,188,82,424,254,161,308,202,92
060371395052,393,280,113,407,284,123,637,380,243,474,307,142
060371395041,717,516,201,731,512,219,1172,723,429,875,588,242
060371393021,389,308,81,399,309,90,685,483,192,534,372,136
060371393022,445,352,93,456,353,103,744,525,208,543,403,112
060371393023,157,124,33,161,125,36,259,182,72,186,138,38
060371393012,364,245,119,366,243,123,556,312,229,439,274,144
060371393013,753,512,241,755,506,249,1111,651,433,908,599,265
060371153011,552,369,183,560,362,198,695,489,191,644,419,185
060371153013,436,291,145,441,286,155,634,429,190,503,324,148
060371245001,608,462,146,614,458,156,776,569,197,606,442,133
060371246001,403,323,80,408,324,84,529,395,121,461,356,85
060371246002,537,433,104,546,436,110,692,543,140,569,441,105
060371047031,125,108,17,126,103,23,249,200,44,161,136,15
060371047042,203,175,28,204,167,37,356,286,64,246,207,25
060371047032,182,152,30,183,147,36,338,272,61,219,183,23
060371047041,429,378,51,431,362,69,695,565,115,547,466,49
060371047043,194,174,20,194,169,25,307,256,45,254,218,22
060371370001,912,593,319,933,600,333,1289,825,438,1059,670,339
060371903031,636,568,68,642,567,75,867,684,169,731,569,121
060371903032,243,218,25,247,221,26,301,221,71,281,212,53
060371903022,442,388,54,449,391,58,618,454,146,532,393,110
060372013011,461,412,49,467,400,67,738,605,119,561,481,51
060372013012,493,426,67,502,414,88,811,664,124,658,554,67
060372031001,175,159,16,176,151,25,318,257,51,242,210,19
060372031002,300,270,30,305,261,44,493,399,80,390,337,34
060372031003,294,269,25,303,260,43,584,469,93,453,399,29
060371349052,466,305,161,470,306,164,764,528,225,573,377,167
060371393011,557,363,194,563,363,200,831,528,293,667,448,190
060371957103,245,215,30,248,214,34,360,291,61,308,262,33
060371958021,380,338,42,384,338,46,501,396,94,420,357,43
060371958022,370,329,41,371,325,46,560,441,104,420,355,43
060371991201,346,308,38,350,297,53,599,501,84,437,368,45
060371991202,323,295,28,322,284,38,541,452,74,475,397,34
060371351131,328,246,82,331,246,85,499,342,146,364,252,91
060371351161,170,124,46,172,122,50,272,199,69,191,135,48
060371351162,292,220,72,298,216,82,473,346,120,345,248,80
060371351152,210,146,64,215,145,70,395,261,120,258,176,72
060371371034,436,311,125,447,311,136,729,503,213,509,354,132
060371371031,373,281,92,377,280,97,523,373,143,419,303,96
060371256001,456,345,111,463,343,120,558,414,133,478,333,121
060371256002,512,379,133,522,379,143,622,464,146,524,362,136
060371255022,656,561,95,663,557,106,839,682,139,661,528,91
060371255021,520,416,104,528,416,112,716,561,141,540,411,103
060371390012,686,543,143,693,537,156,978,707,249,757,552,157
060371390013,367,279,88,374,281,93,490,356,124,404,303,80
060371390014,361,280,81,366,280,86,500,348,143,412,298,92
060371392001,435,327,108,441,329,112,568,399,159,472,331,114
060371392002,318,234,84,322,230,92,494,335,147,390,269,91
060371392003,382,281,101,385,276,109,650,442,192,492,341,114
060371392004,677,492,185,693,501,192,1035,597,422,859,588,218
060371393033,501,364,137,512,371,141,803,542,245,607,418,153
060371393032,256,187,69,259,190,69,434,293,132,319,224,77
060371416001,1023,774,249,1030,760,270,1255,943,292,1104,815,239
060371417003,352,256,96,358,252,106,433,311,114,385,273,94
060371895012,688,626,62,696,632,64,786,694,76,694,599,60
060371895011,468,414,54,474,417,57,598,522,63,510,419,59
060371895022,499,449,50,505,446,59,625,533,78,512,428,57
060371894001,822,722,100,817,711,106,943,825,109,864,739,95
060371894002,427,385,42,430,388,42,540,470,62,480,417,40
060371894003,744,668,76,750,673,77,921,804,101,837,726,83
060372643053,518,395,123,528,402,126,668,513,142,559,441,90
060372623021,694,480,214,713,484,229,884,645,226,742,531,178
060372623022,684,494,190,697,492,205,886,654,223,746,550,159
060372654102,480,343,137,494,353,141,609,448,156,531,402,109
060371288021,677,566,111,686,570,116,974,756,197,757,601,111
060371288023,523,434,89,528,438,90,730,568,150,596,471,90
060372712002,393,337,56,396,337,59,584,482,89,401,330,47
060372110001,484,405,79,489,399,90,561,391,165,523,407,96
060372110002,361,248,113,368,245,123,461,322,134,391,265,108
060372044101,182,159,23,183,151,32,258,213,34,341,288,28
060372044102,221,210,11,221,194,27,309,263,42,163,144,9
060372044201,283,263,20,285,257,28,484,406,62,421,376,17
060372044202,151,141,10,152,136,16,249,218,26,121,108,6
060372048101,358,333,25,359,321,38,560,473,76,437,390,28
060372048103,316,291,25,315,282,33,491,411,67,436,392,26
060372039001,197,182,15,200,177,23,263,225,35,237,207,15
060372039002,485,446,39,489,431,58,749,626,104,422,367,30
060372048102,224,204,20,225,197,28,361,309,43,517,469,27
060372267021,174,158,16,172,149,23,265,225,33,175,157,10
060372267011,250,226,24,249,216,33,383,329,50,252,224,15
060372267012,194,175,19,180,161,19,367,309,48,443,392,24
060372267022,148,135,13,134,121,13,273,234,35,222,198,10
060372352021,434,409,25,421,388,33,780,695,69,539,484,27
060372352012,373,346,27,373,343,30,505,459,40,413,382,23
060372352013,352,326,26,359,328,31,556,494,39,334,307,17
060372352022,563,521,42,576,525,51,712,638,63,666,622,28
060372379003,413,374,39,418,371,47,595,548,39,474,439,20
060372381004,442,402,40,450,401,49,600,549,39,490,454,20
060372379002,438,396,42,442,397,45,548,502,40,515,474,24
060372381001,396,363,33,401,361,40,655,589,47,739,682,31
060372751021,370,331,39,372,327,45,465,402,54,421,355,41
060372752001,435,390,45,437,387,50,625,540,72,520,435,55
060372752003,457,413,44,462,408,54,614,531,70,492,413,47
060372380004,364,341,23,368,339,29,473,428,27,421,397,11
060372380005,533,502,31,545,502,43,677,624,37,602,573,11
060372384004,558,519,39,570,520,50,690,634,45,599,554,27
060372400102,333,305,28,334,297,37,538,469,55,443,411,17
060372402001,165,154,11,166,147,19,262,233,25,221,205,9
060372402002,401,371,30,409,361,48,656,566,68,605,561,25
060372402003,359,335,24,361,321,40,535,476,51,408,377,17
060371033001,817,359,458,834,342,492,1072,499,545,946,415,460
060371033002,826,418,408,845,407,438,1213,599,581,997,456,480
060372407001,203,185,18,206,188,18,316,273,38,290,272,10
060372407002,213,199,14,215,196,19,333,289,35,283,264,8
060372408001,242,223,19,240,217,23,356,310,38,308,288,9
060372407005,209,196,13,212,193,19,319,281,34,273,259,8
060372412025,226,206,20,229,207,22,344,312,27,258,237,12
060372412021,341,311,30,345,312,33,440,395,33,347,317,16
060372412022,283,261,22,289,265,24,464,412,43,357,329,11
060372412024,190,175,15,194,176,18,287,255,26,206,190,8
060371065202,469,382,87,472,368,104,721,532,172,633,489,108
060371066043,307,253,54,308,242,66,507,392,105,377,301,60
060371070203,355,304,51,357,287,70,622,491,115,496,418,52
060371070101,312,263,49,315,248,67,509,408,95,416,347,54
060371070102,387,325,62,392,308,84,661,511,131,528,432,73
060371070204,290,239,51,289,231,58,497,378,106,344,276,47
060371070202,288,239,49,289,228,61,473,356,102,344,277,47
060372013021,398,325,73,398,320,78,543,438,91,446,351,70
060372013023,472,376,96,477,375,102,651,527,115,511,401,87
060372013022,682,556,126,688,550,138,896,731,148,716,556,122
060371066042,355,268,87,362,262,100,532,390,130,380,292,65
060371436031,766,634,132,775,634,141,1060,859,181,800,626,123
060371436032,378,314,64,380,312,68,508,412,87,413,323,64
060371061111,563,387,176,571,368,203,873,586,266,663,465,167
060371061112,1000,693,307,1023,677,346,1505,1024,444,1209,815,328
060371899062,495,414,81,507,416,91,708,566,132,601,463,103
060371899071,464,403,61,470,403,67,682,546,126,528,426,75
060371899061,544,480,64,553,487,66,773,617,137,584,479,71
060371042031,397,355,42,403,339,64,665,553,88,498,435,38
060371042032,431,388,43,442,373,69,688,577,87,572,500,41
060371043213,149,133,16,150,128,22,264,216,40,201,177,14
060371132111,837,479,358,850,469,381,1165,715,431,920,506,359
060371132112,949,571,378,965,553,412,1354,862,468,1068,602,412
060371895021,571,511,60,576,503,73,729,611,103,470,379,56
060371896002,435,383,52,438,380,58,568,480,80,415,348,45
060371134283,367,235,132,371,228,143,595,384,205,454,287,138
060371861003,822,653,169,827,644,183,1078,843,212,912,679,174
060371862011,342,288,54,342,282,60,540,422,104,367,291,54
060371862012,680,581,99,681,569,112,983,805,161,717,582,101
060371862022,407,339,68,409,335,74,598,475,111,424,336,66
060371043221,217,197,20,219,192,27,407,328,63,304,268,21
060371043211,178,162,16,180,157,23,336,273,55,239,211,15
060371043222,136,122,14,136,119,17,256,212,41,211,191,12
060372012001,652,584,68,656,561,95,931,775,139,791,675,79
060371043101,195,176,19,197,167,30,304,256,45,268,245,12
060371043102,324,292,32,329,278,51,546,450,77,453,411,21
060371060202,447,330,117,452,315,137,676,478,187,591,417,143
060371060203,548,408,140,552,389,163,867,623,223,681,515,128
060371953003,868,799,69,875,801,74,914,777,114,916,765,88
060371094001,365,285,80,377,280,97,586,423,147,456,343,84
060371095001,266,225,41,270,220,50,412,333,73,350,293,42
060371095002,423,358,65,427,348,79,725,578,129,582,479,69
060371011102,402,263,139,403,256,147,683,367,302,505,308,165
060371012221,404,267,137,409,265,144,703,393,292,508,337,133
060371012211,211,138,73,215,136,79,375,200,166,259,158,86
060371014001,250,159,91,249,154,95,363,205,152,304,186,97
060371034021,333,204,129,340,200,140,516,285,212,405,235,144
060371034022,299,185,114,306,181,125,442,247,181,386,222,139
060371094002,269,214,55,280,216,64,475,339,119,369,285,62
060372963001,603,383,220,618,375,243,910,587,304,757,470,244
060372963002,253,164,89,259,160,99,382,250,124,325,208,97
060372963003,743,500,243,760,487,273,1146,749,369,827,539,239
060372964022,247,174,73,252,172,80,352,236,107,294,198,81
060371112011,454,298,156,463,289,174,640,399,232,523,316,176
060371112012,623,382,241,632,370,262,911,539,347,722,412,257
060371066451,505,301,204,515,295,220,705,407,290,623,360,235
060371066461,701,439,262,716,429,287,1008,620,372,864,484,337
060371066462,492,326,166,504,312,192,743,462,265,591,391,164
060371200201,390,333,57,389,324,65,590,441,132,520,425,62
060371200301,315,274,41,314,269,45,480,360,107,476,398,46
060371991101,302,271,31,300,264,36,436,359,66,357,294,37
060371991102,424,383,41,426,371,55,587,487,90,506,421,51
060371992021,370,332,38,369,321,48,541,451,74,472,393,47
060372933021,747,480,267,763,480,283,1147,734,392,916,568,297
060372933022,511,340,171,520,336,184,875,566,287,638,414,182
060371111001,478,324,154,485,324,161,722,460,245,571,378,157
060371111002,577,394,183,584,392,192,873,550,292,763,513,208
060371114022,684,462,222,699,477,222,1027,654,351,831,542,241
060371114021,379,260,119,387,266,121,611,383,214,459,307,126
060371060201,622,479,143,620,455,165,1014,742,248,815,614,152
060372932041,386,266,120,394,275,119,659,458,183,505,344,134
060372932031,462,320,142,472,329,143,775,510,237,604,410,160
060371436021,544,443,101,550,442,108,674,545,119,551,435,91
060371436022,878,706,172,898,716,182,1114,897,206,952,743,179
060371436061,632,533,99,642,537,105,848,681,151,703,557,103
060371436023,839,709,130,850,704,146,1060,862,177,830,687,114
060371081021,426,253,173,438,252,186,673,405,256,491,308,156
060371082031,932,605,327,942,592,350,1383,826,536,1072,688,354
060371082032,463,278,185,476,274,202,698,416,271,533,304,201
060371082041,655,398,257,671,393,278,1065,681,368,787,493,255
060371097002,660,473,187,668,455,213,1004,687,295,789,531,194
060371097003,373,273,100,377,264,113,551,380,163,458,320,112
060372410012,214,197,17,214,195,19,336,296,30,291,263,12
060372411101,352,319,33,355,317,38,605,517,70,473,427,21
060372411201,172,159,13,170,157,13,306,264,30,228,208,9
060372411203,124,113,11,122,110,12,212,188,21,163,149,8
060372411204,160,145,15,162,145,17,277,242,27,217,199,10
060371098003,383,246,137,391,242,149,599,385,205,458,293,148
060371814002,465,383,82,464,375,89,600,476,117,470,371,73
060371814003,677,560,117,678,544,134,874,677,180,730,571,118
060371172021,547,376,171,552,364,188,813,561,240,661,437,187
060371172022,406,277,129,412,271,141,591,396,179,448,295,131
060371173012,525,347,178,542,342,200,756,490,247,594,388,172
060371173013,408,287,121,413,280,133,578,379,186,471,320,124
060371340011,242,190,52,247,185,62,420,317,94,331,246,64
060371345211,148,116,32,152,115,37,268,203,59,212,157,41
060371345212,96,75,21,96,73,23,193,143,43,124,100,17
060371907011,341,293,48,338,286,52,518,406,99,387,307,58
060371907012,205,184,21,204,182,22,319,256,58,231,202,17
060371907021,185,169,16,188,168,20,298,237,59,241,207,18
060371908022,198,176,22,199,175,24,249,204,40,222,186,20
060371097001,489,357,132,499,350,149,750,511,221,617,436,148
060371173011,564,367,197,590,367,223,832,531,284,681,406,229
060372381002,388,362,26,394,362,32,611,549,39,335,313,14
060372382004,409,378,31,417,379,38,676,608,49,498,459,21
060371976001,271,248,23,271,248,23,300,258,36,301,261,23
060371976002,519,478,41,519,464,55,713,611,81,611,531,44
060371977001,663,600,63,660,590,70,897,719,150,752,639,68
060371881001,724,647,77,731,638,93,960,794,148,802,663,88
060371881002,432,385,47,438,384,54,531,426,96,435,359,49
060371881003,470,420,50,476,408,68,643,537,94,571,473,60
060372080022,464,424,40,464,415,49,670,557,90,523,462,30
060372080011,477,435,42,495,437,58,761,630,111,529,451,43
060372080021,428,390,38,441,390,51,683,570,92,489,416,36
060371096032,389,286,103,396,283,113,635,457,164,505,361,111
060371096033,369,279,90,373,275,98,639,464,157,453,329,99
060371096041,225,168,57,226,161,65,402,288,109,295,214,65
060371096042,287,216,71,290,209,81,474,333,125,406,292,89
060371096043,341,252,89,343,239,104,513,367,138,488,345,118
060371245002,623,495,128,629,494,135,879,659,195,630,486,107
060371096031,425,321,104,427,320,107,708,521,165,549,383,120
060371192013,442,378,64,445,364,81,666,523,124,570,488,56
060371192021,151,127,24,151,122,29,241,185,52,199,162,25
060371192022,288,245,43,288,236,52,490,381,98,377,306,49
060371190033,345,309,36,349,290,59,490,404,79,420,357,43
060371192011,256,209,47,259,199,60,435,329,94,345,278,53
060371194003,560,455,105,561,436,125,930,706,202,785,628,121
060371233031,209,161,48,213,161,52,348,221,123,249,182,56
060371233042,182,139,43,185,140,45,291,184,103,223,160,49
060371233043,311,239,72,319,241,78,477,298,165,399,288,89
060371238001,398,303,95,401,301,100,629,414,204,459,335,97
060371193411,498,404,94,504,397,107,969,668,275,684,527,120
060371193421,296,244,52,301,243,58,510,392,106,405,335,47
060371193422,190,155,35,193,153,40,380,291,81,274,226,32
060372951033,659,385,274,668,379,289,867,521,330,723,397,280
060372951031,778,476,302,791,459,332,1156,690,449,975,565,356
060379800151,184,118,66,190,115,75,206,133,69,190,116,66
060371908011,383,340,43,386,339,47,530,427,93,397,336,42
060371908012,358,306,52,357,299,58,530,402,114,419,331,65
060371918101,287,263,24,288,262,26,374,314,50,309,269,22
060371918102,279,256,23,282,256,26,372,313,50,321,279,23
060371044031,316,281,35,317,271,46,521,434,69,427,370,36
060371045002,402,364,38,404,350,54,660,553,83,545,476,43
060371048221,419,361,58,423,351,72,666,533,113,587,489,63
060371045001,164,146,18,165,139,26,254,218,34,219,190,18
060371046101,301,270,31,302,255,47,540,449,73,456,414,28
060371046202,337,303,34,342,289,53,620,513,83,501,448,34
060371253102,371,316,55,376,312,64,507,427,72,418,332,59
060371253211,544,475,69,551,470,81,822,678,120,559,456,69
060371253212,462,412,50,466,407,59,726,602,103,540,449,59
060371132381,263,215,48,265,208,57,425,319,90,315,233,64
060371132382,423,345,78,430,338,92,710,529,156,534,391,108
060371132383,239,175,64,245,173,72,399,273,118,264,195,53
060371909011,134,122,12,136,119,17,191,158,26,146,123,15
060371909012,316,285,31,318,278,40,440,371,61,378,315,44
060371909013,292,266,26,292,256,36,407,342,57,330,276,36
060371048211,429,358,71,430,347,83,656,504,136,548,443,71
060371171021,350,270,80,356,264,92,542,391,142,466,334,103
060371171011,526,390,136,536,388,148,874,616,240,632,465,131
060371171012,357,264,93,363,262,101,586,416,161,445,329,93
060371193402,180,156,24,183,151,32,369,300,60,274,225,32
060371193401,81,70,11,81,67,14,175,144,28,125,103,15
060371201031,78,68,10,80,66,14,164,134,27,126,104,15
060371201032,106,92,14,106,88,18,243,199,39,178,147,22
060371201081,316,264,52,321,257,64,592,451,124,385,318,45
060371132321,1055,639,416,1066,621,445,1452,902,528,1154,694,404
060371132322,694,437,257,706,432,274,1039,649,371,834,490,300
060371285001,539,435,104,538,424,114,775,595,170,625,486,104
060371287032,453,366,87,450,355,95,662,503,145,544,421,92
060371201041,286,230,56,283,219,64,547,408,128,402,327,55
060371201051,372,290,82,372,284,88,591,458,125,472,371,77
060371200202,202,170,32,202,167,35,339,262,71,282,231,40
060371201071,135,113,22,137,114,23,244,188,50,189,157,21
060371201072,184,154,30,186,155,31,365,273,84,244,203,27
060371201061,100,82,18,99,77,22,196,152,40,126,103,18
060371201063,164,134,30,161,126,35,326,242,77,198,163,29
060371201062,126,103,23,123,96,27,255,184,68,155,126,23
060371174072,190,160,30,192,159,33,371,279,84,249,208,28
060371174081,345,291,54,348,286,62,654,484,154,470,376,69
060371175301,86,72,14,87,71,16,158,117,37,114,91,17
060371175303,286,233,53,291,232,59,514,376,126,350,279,52
060371434012,470,388,82,477,387,90,589,474,106,480,378,77
060371435003,790,654,136,800,649,151,1031,828,185,835,664,133
060371435004,551,458,93,559,457,102,708,580,118,567,452,88
060371439021,834,682,152,851,681,170,1046,837,191,886,717,138
060371173032,411,276,135,416,271,145,662,451,197,474,306,135
060371341042,511,387,124,523,380,143,831,585,231,683,505,144
060371347102,166,130,36,165,125,40,283,197,78,182,139,33
060371347103,187,147,40,188,142,46,341,239,94,227,172,41
060371341031,551,396,155,563,389,174,949,611,325,744,524,183
060371341041,479,328,151,487,318,169,849,553,278,656,444,173
060371200101,267,225,42,270,225,45,459,353,94,331,278,37
060371275201,197,165,32,204,170,34,424,327,86,255,217,25
060371275202,167,140,27,173,145,28,342,267,70,216,185,22
060371021031,611,341,270,625,337,288,914,450,449,703,365,295
060371021042,325,192,133,329,187,142,525,269,247,438,235,182
060371174043,631,476,155,650,475,175,991,663,310,794,549,189
060371313003,610,474,136,613,463,150,998,723,253,795,597,152
060371313001,491,377,114,494,369,125,749,549,190,630,467,124
060372947012,111,89,22,113,86,27,231,178,49,150,119,24
060379800141,50,29,21,48,28,20,84,66,18,64,39,21
060371252003,487,407,80,494,405,89,619,505,104,516,411,79
060371433012,882,734,148,890,726,164,1239,983,234,943,735,159
060371433011,452,375,77,457,374,83,594,471,106,485,372,83
060371311002,277,202,75,284,201,83,402,275,117,335,230,87
060371910002,534,473,61,542,478,64,699,528,149,627,518,66
060371910003,419,364,55,421,361,60,830,645,162,457,367,61
060372962201,126,103,23,128,100,28,208,154,48,248,197,39
060372962202,345,282,63,348,274,74,568,423,132,368,293,59
060372962203,262,216,46,267,211,56,480,356,113,323,252,51
060371431011,532,390,142,536,387,149,581,431,142,710,495,175
060371431012,717,528,189,716,516,200,840,610,217,712,493,177
060371431021,1101,863,238,1111,864,247,1359,1056,279,1157,872,217
060371436051,510,413,97,522,422,100,773,622,136,609,481,91
060371831011,316,283,33,317,279,38,411,354,51,353,292,41
060371831012,603,538,65,606,521,85,767,645,107,637,533,67
060371831013,651,584,67,657,569,88,859,715,124,732,611,77
060371200102,347,299,48,352,293,59,500,384,104,429,350,56
060371832211,323,290,33,322,283,39,413,345,58,370,312,39
060371832222,592,506,86,604,496,108,815,672,122,634,499,97
060371832223,544,486,58,548,479,69,658,549,93,596,496,69
060372913002,298,195,103,304,201,103,490,333,150,333,214,103
060372753114,720,552,168,727,552,175,883,694,168,832,598,179
060372756032,497,411,86,502,403,99,605,484,102,560,439,91
060372755001,286,249,37,290,248,42,415,339,64,327,269,34
060372755004,500,451,49,503,439,64,761,626,119,598,518,41
060372764003,416,289,127,425,291,134,550,401,137,407,280,105
060372764004,394,270,124,401,274,127,488,360,116,619,410,174
060372780012,614,424,190,627,425,202,853,621,210,223,151,56
060372244101,263,235,28,266,232,34,399,330,58,367,308,29
060372244102,327,297,30,332,291,41,474,392,68,140,124,13
060372244201,175,159,16,176,155,21,250,205,36,191,154,13
060372244202,175,156,19,178,154,24,248,204,37,247,209,20
060372774001,31,28,3,31,28,3,17,12,3,263,237,15
060372774002,22,22,0,24,22,2,9,8,1,164,147,9
060371212222,195,167,28,199,162,37,368,280,77,291,238,35
060371212223,346,295,51,357,289,68,652,494,146,534,442,70
060371918201,516,455,61,519,452,67,744,626,103,416,347,47
060371918202,334,308,26,337,304,33,448,382,56,375,319,33
060371918203,267,246,21,270,244,26,333,287,41,290,246,26
060371210104,338,265,73,344,251,93,492,350,134,414,322,68
060371210101,209,167,42,212,160,52,330,211,107,275,206,53
060371210103,238,176,62,240,170,70,406,259,131,298,211,73
060371210202,418,308,110,428,304,124,696,444,232,528,381,120
060371218012,219,180,39,222,174,48,356,264,84,303,244,43
060372071011,340,292,48,346,287,59,574,452,105,412,338,52
060372071012,160,137,23,163,135,28,312,268,35,224,184,28
060372071031,103,88,15,105,87,18,196,156,36,120,99,15
060371190041,277,234,43,276,217,59,425,320,96,331,269,45
060371871011,646,547,99,649,541,108,831,680,140,692,564,94
060371871012,771,656,115,778,648,130,997,810,166,823,671,110
060371871021,461,396,65,465,391,74,649,524,110,515,423,67
060371048241,187,162,25,188,154,34,303,244,53,253,215,28
060371048242,259,218,41,258,205,53,462,348,101,349,286,50
060371175304,165,133,32,167,131,36,290,209,77,198,156,29
060371175302,231,186,45,235,184,51,431,309,114,287,227,42
060372060101,444,385,59,443,379,64,740,606,113,454,369,54
060372071021,522,448,74,532,448,84,911,692,181,520,414,76
060372071032,244,209,35,248,209,39,347,272,66,233,187,34
060371198021,446,378,68,452,372,80,710,543,150,589,483,77
060371190012,587,467,120,602,445,157,938,707,200,752,591,129
060371220003,270,207,63,277,202,75,427,276,141,352,260,74
060371838101,476,435,41,477,427,50,667,584,65,495,422,38
060371838201,401,358,43,402,351,51,572,486,72,437,360,46
060371851012,696,636,60,695,618,77,888,777,94,744,638,57
060371851011,351,316,35,352,312,40,530,456,63,399,336,36
060371911101,503,436,67,507,422,85,756,539,204,598,444,117
060371911102,168,146,22,169,141,28,213,152,58,204,154,39
060371241021,293,252,41,296,245,51,458,357,87,339,282,37
060371241022,386,345,41,385,336,49,575,469,93,456,376,55
060371241051,248,216,32,252,212,40,397,313,75,283,223,43
060371241052,277,242,35,280,235,45,452,353,85,336,267,51
060371224101,430,349,81,439,344,95,692,548,134,478,396,62
060371224102,156,126,30,158,124,34,253,201,49,177,146,23
060371233011,635,494,141,651,492,159,1054,708,323,769,558,175
060371271021,212,171,41,215,167,48,361,250,99,251,195,45
060371271023,412,334,78,419,324,95,745,535,189,488,385,82
060371271022,231,188,43,236,183,53,405,291,103,284,225,47
060371832202,437,391,46,436,378,58,700,594,87,464,398,38
060371832203,430,386,44,428,373,55,586,493,77,469,400,43
060371836101,304,276,28,301,263,38,420,363,46,380,329,34
060371836201,818,751,67,832,740,92,1069,922,123,874,759,60
060371256003,445,322,123,452,323,129,590,440,140,495,343,127
060372073041,359,327,32,362,323,39,472,390,69,466,394,43
060372073051,497,430,67,509,438,71,639,547,76,543,455,48
060372073071,479,431,48,487,430,57,631,537,77,715,616,54
060372073081,487,440,47,495,438,57,602,504,82,519,447,40
060371204001,560,437,123,566,426,140,931,615,298,721,544,139
060371204002,365,273,92,368,263,105,588,397,187,492,368,105
060371912031,354,296,58,353,291,62,575,439,124,428,327,72
060371912032,245,205,40,244,202,42,371,285,80,300,229,51
060371197001,339,224,115,352,233,119,632,387,229,441,298,112
060371220001,427,306,121,433,303,130,762,441,303,592,407,156
060371220002,475,327,148,480,318,162,806,473,312,606,412,171
060371216001,478,352,126,483,347,136,812,475,318,644,442,168
060371193101,409,338,71,416,337,79,725,563,149,554,450,73
060371216002,237,176,61,237,171,66,416,245,161,315,218,83
060372073062,411,374,37,411,374,37,445,389,43,395,342,26
060372073061,283,243,40,290,247,43,405,335,52,278,241,22
060372075022,561,444,117,606,473,133,856,658,179,689,556,110
060372075021,480,401,79,505,418,87,755,579,158,557,457,69
060371271031,487,396,91,490,396,94,881,647,212,610,475,92
060371271041,429,347,82,436,346,90,714,513,186,543,418,92
060371974101,730,679,51,732,668,64,888,791,77,783,680,52
060371271042,316,255,61,324,252,72,510,352,150,400,303,76
060371904013,354,327,27,357,327,30,473,396,68,418,342,54
060371904012,411,375,36,414,376,38,568,472,82,478,392,62
060371904011,375,346,29,377,346,31,478,397,69,417,343,49
060371203001,259,188,71,259,180,79,435,304,123,337,248,75
060371203002,381,294,87,385,281,104,583,410,156,456,342,90
060371203003,349,279,70,349,272,77,555,393,149,461,360,80
060371210201,360,276,84,369,275,94,668,427,229,453,342,92
060371218011,467,387,80,468,371,97,805,616,166,634,502,92
060371255023,443,370,73,449,369,80,579,463,102,467,358,74
060371863011,277,239,38,278,233,45,405,330,65,326,268,41
060371863012,167,149,18,169,146,23,266,220,40,203,170,20
060371863013,203,181,22,207,178,29,323,268,48,243,205,24
060371863021,658,571,87,660,559,101,847,710,125,694,576,86
060371864011,500,446,54,508,432,76,718,597,109,552,475,52
060371836102,633,581,52,639,567,72,831,720,88,674,580,43
060372134021,299,260,39,299,248,51,459,339,115,365,310,38
060372134023,314,273,41,316,261,55,490,358,122,359,304,38
060371232031,188,173,15,193,169,24,378,304,65,275,233,26
060371232032,118,108,10,119,105,14,260,208,43,169,144,16
060371232041,156,144,12,158,139,19,317,252,53,219,186,21
060371232042,348,299,49,350,289,61,587,453,116,436,342,68
060371230201,395,344,51,398,336,62,685,509,152,524,431,58
060371230202,267,232,35,268,226,42,463,370,81,357,300,37
060371852021,497,459,38,497,445,52,666,581,72,564,486,43
060371852022,549,498,51,548,484,64,668,593,63,578,494,51
060371852023,396,370,26,396,357,39,556,484,61,418,362,31
060371990021,268,249,19,266,239,27,382,318,57,293,253,20
060371221201,421,360,61,426,346,80,724,551,158,564,470,64
060371221202,569,468,101,581,458,123,860,630,207,733,597,100
060371221212,273,224,49,280,219,61,406,294,105,348,283,52
060371853102,309,285,24,310,277,33,422,362,49,354,311,27
060371853202,283,262,21,285,253,32,467,396,55,371,320,29
060371990022,345,307,38,350,292,58,610,486,115,420,354,39
060371340021,308,248,60,310,242,68,466,338,124,357,281,64
060371349042,278,224,54,279,218,61,451,324,119,315,247,57
060371349041,381,277,104,384,276,108,560,400,151,443,313,105
060371903021,457,389,68,463,388,75,605,445,143,534,381,124
060371231031,495,398,97,501,399,102,759,572,170,624,488,99
060371231032,558,448,110,566,445,121,886,664,198,677,514,126
060371066041,484,385,99,488,376,112,743,553,179,555,422,100
060371066492,479,387,92,487,377,110,764,576,172,572,451,98
060372325003,283,266,17,289,266,23,412,369,37,372,342,16
060372325004,218,206,12,224,210,14,364,325,31,290,267,11
060372346001,421,392,29,425,395,30,658,578,60,643,592,22
060372346002,307,285,22,305,280,25,431,390,34,331,302,16
060372011102,466,408,58,471,399,72,651,531,113,544,453,63
060372011101,325,287,38,325,278,47,458,370,79,378,317,43
060372011201,431,374,57,437,366,71,656,520,120,514,424,59
060372011202,412,359,53,416,353,63,591,471,106,475,396,52
060371231041,331,276,55,335,271,64,496,367,119,393,307,59
060371231042,399,334,65,405,329,76,594,441,141,470,371,68
060371243001,310,262,48,313,257,56,429,350,74,363,297,42
060371243002,369,322,47,370,322,48,562,451,96,453,362,59
060371901021,480,426,54,484,428,56,716,595,105,554,458,60
060371919011,564,501,63,570,497,73,813,676,119,694,577,73
060372414001,233,213,20,234,214,20,386,343,29,309,282,14
060372414002,434,403,31,433,397,36,644,586,49,546,506,26
060371235101,512,414,98,523,418,105,833,590,228,598,462,111
060371235102,397,309,88,398,308,90,614,397,206,458,342,91
060371281011,565,453,112,569,448,121,906,657,224,653,497,121
060371905201,316,274,42,322,270,52,483,349,125,366,255,82
060371912011,417,357,60,424,349,75,644,441,192,541,358,145
060371912012,647,520,127,653,492,161,1114,611,486,981,539,360
060372756041,817,655,162,827,657,170,936,772,146,919,741,137
060372756042,406,325,81,411,325,86,549,453,86,510,412,76
060371233032,387,324,63,393,317,76,686,477,194,518,407,86
060371234201,423,357,66,428,347,81,747,517,212,534,432,76
060372247011,254,223,31,261,221,40,191,154,29,311,253,36
060372653011,2455,2277,178,2528,2332,196,475,414,53,4399,3890,271
060371233012,526,446,80,531,432,99,798,628,155,607,491,91
060371233041,427,352,75,440,349,91,708,490,201,563,422,110
060371239012,532,441,91,535,427,108,808,621,175,651,497,116
060371351132,394,297,97,398,296,102,761,519,225,469,325,117
060372656021,470,332,138,474,332,142,690,474,208,512,366,129
060372656022,674,476,198,683,477,206,995,716,260,770,555,185
060371151011,845,590,255,856,575,281,1054,710,324,994,682,262
060371151044,300,228,72,302,220,82,328,231,88,332,246,63
060371151042,222,169,53,224,163,61,251,177,69,251,186,48
060372742022,537,422,115,542,424,118,694,548,134,585,442,106
060371234202,163,124,39,162,121,41,308,208,97,247,177,61
060371234203,129,100,29,130,96,34,277,182,89,191,134,46
060371237001,148,113,35,151,112,39,308,181,124,245,173,61
060371237004,308,239,69,310,234,76,481,299,175,385,278,91
060371235201,571,424,147,569,418,151,963,619,322,699,496,158
060372657011,895,686,209,910,693,217,1153,803,335,1012,772,197
060372657022,376,282,94,384,286,98,522,359,153,416,308,90
060371237003,402,323,79,407,315,92,602,405,186,436,325,88
060371238003,648,500,148,655,491,164,976,631,323,720,507,168
060372932042,295,210,85,299,210,89,486,349,133,355,244,92
060372932032,177,126,51,180,126,54,302,213,81,211,143,54
060372932061,303,226,77,310,226,84,512,384,119,382,272,87
060371238002,741,573,168,757,572,185,1134,796,309,873,623,199
060371044032,236,212,24,237,203,34,370,304,56,330,292,24
060371236013,588,463,125,594,454,140,824,574,234,499,371,102
060371244001,373,301,72,378,294,84,547,385,152,427,324,81
060371279201,468,386,82,480,391,89,721,512,187,558,441,86
060371279202,404,332,72,412,332,80,655,470,172,491,384,79
060371281012,328,264,64,331,261,70,528,388,131,392,297,73
060372047001,418,386,32,424,375,49,616,519,82,506,442,41
060372047002,361,327,34,366,320,46,500,427,64,446,390,38
060372036011,291,269,22,291,254,37,388,328,52,342,300,25
060372036012,286,265,21,285,249,36,396,335,55,333,291,23
060372036021,416,383,33,417,361,56,649,535,99,520,452,35
060371810004,694,551,143,701,535,166,866,665,183,748,556,157
060371815002,710,559,151,711,537,174,931,728,180,779,576,153
060371815003,529,458,71,527,444,83,692,577,108,608,500,77
060371891022,620,566,54,624,571,53,749,667,68,652,569,57
060371891023,646,584,62,653,590,63,799,710,73,672,575,69
060371231043,361,288,73,366,284,82,579,430,138,427,328,77
060371833001,370,326,44,371,317,54,525,443,69,415,343,46
060371833002,284,251,33,288,247,41,395,337,52,309,256,34
060371833003,467,412,55,470,400,70,683,569,103,537,438,71
060371834012,358,321,37,359,314,45,495,417,75,401,338,44
060372011203,256,217,39,257,208,49,366,286,70,325,260,42
060371835102,509,457,52,502,439,63,725,619,95,575,501,48
060371835101,428,382,46,432,372,60,596,497,86,472,391,56
060371992011,178,159,19,176,152,24,291,242,42,214,176,19
060371992012,290,260,30,287,247,40,485,393,78,321,268,28
060371992013,227,205,22,227,196,31,373,300,61,271,228,23
060371992022,452,405,47,446,385,61,653,542,92,504,422,50
060371883001,604,502,102,616,505,111,761,599,148,649,502,115
060371883002,594,500,94,602,495,107,736,591,135,636,496,113
060371883003,518,444,74,527,437,90,634,510,113,530,428,83
060371909021,372,332,40,376,328,48,576,473,89,420,356,41
060371909022,370,331,39,376,329,47,556,458,87,400,340,40
060371909023,194,173,21,196,171,25,256,211,40,223,189,23
060372085021,234,207,27,234,198,36,355,272,72,263,223,29
060372085022,211,179,32,213,172,41,285,213,65,254,212,28
060372085023,218,184,34,221,178,43,361,267,83,249,208,27
060372086203,337,299,38,339,288,51,502,380,109,391,330,43
060371239022,494,398,96,503,397,106,708,517,175,539,405,106
060371251011,625,513,112,638,511,127,895,708,169,709,529,147
060371252001,590,517,73,595,510,85,933,763,147,597,478,82
060371239021,510,422,88,514,414,100,700,529,152,591,460,98
060371241023,418,345,73,416,340,76,512,416,87,447,356,62
060371917101,244,215,29,244,212,32,326,255,61,304,259,32
060371917102,382,336,46,383,331,52,595,498,90,444,379,47
060371924103,317,270,47,321,268,53,412,349,55,369,309,46
060371924104,406,343,63,408,340,68,567,488,69,537,448,69
060371914201,483,441,42,487,437,50,702,612,73,571,486,47
060371914202,253,231,22,255,229,26,387,336,41,319,275,25
060371244003,563,321,242,570,319,251,838,521,302,678,403,247
060372284102,202,186,16,205,185,20,335,291,37,276,249,10
060372284101,229,211,18,229,208,21,379,326,42,260,233,9
060372311001,215,198,17,217,195,22,334,293,36,277,249,13
060371344241,772,448,324,784,440,344,1110,693,397,882,556,283
060371344242,646,401,245,649,393,256,842,546,281,689,432,240
060371032012,622,341,281,627,333,294,941,503,413,690,404,249
060371032011,645,372,273,647,364,283,971,537,403,759,409,298
060371031021,272,165,107,282,165,117,456,242,201,359,191,146
060371031022,205,125,80,210,122,88,353,188,157,253,153,87
060371031023,344,201,143,349,196,153,537,285,242,449,247,176
060371031024,220,134,86,221,129,92,382,204,173,285,173,98
060371031011,663,360,303,677,354,323,992,514,449,755,388,322
060371031012,305,168,137,308,162,146,464,238,212,373,189,162
060371031025,333,187,146,335,175,160,519,273,230,413,218,167
060372404011,282,260,22,292,261,31,484,418,51,593,547,27
060372404012,295,274,21,304,274,30,489,419,55,380,350,18
060372404013,224,206,18,232,208,24,347,296,38,300,280,14
060372404021,258,237,21,264,237,27,425,370,45,153,142,6
060371011221,789,449,340,812,447,365,1225,643,555,1014,529,425
060379800261,3,2,1,3,2,1,5,3,2,6,3,3
060371011101,498,310,188,509,306,203,875,470,385,647,388,210
060371011222,486,285,201,497,283,214,772,415,343,665,355,264
060371013001,416,231,185,426,229,197,646,343,290,535,281,215
060371012202,445,280,165,451,282,169,872,475,377,597,364,187
060371013003,321,177,144,323,172,151,477,251,215,403,205,166
060371013004,261,144,117,266,140,126,400,211,182,336,170,138
060371908021,440,385,55,441,384,57,546,461,80,489,406,54
060371908023,225,195,30,226,195,31,297,240,51,256,210,30
060371011103,295,179,116,307,180,127,472,254,210,343,206,111
060371012212,361,246,115,365,240,125,643,356,266,484,321,129
060371012201,266,175,91,268,174,94,510,275,227,399,225,143
060372965002,394,316,78,399,313,86,668,486,159,481,380,69
060372965003,225,181,44,230,179,51,384,281,90,290,226,42
060372181201,437,388,49,438,377,61,723,574,141,522,449,43
060372181202,236,209,27,238,204,34,371,302,65,327,282,28
060372181203,167,150,17,167,147,20,264,217,38,105,92,8
060371278062,224,185,39,226,182,44,318,248,63,252,199,41
060371278063,293,242,51,298,239,59,449,343,96,340,268,57
060371852031,521,472,49,532,466,66,653,560,78,583,511,39
060371852032,429,387,42,433,375,58,612,522,74,505,430,43
060371853101,511,469,42,510,453,57,664,568,83,559,486,43
060371853201,432,397,35,436,383,53,622,531,79,517,449,46
060371955002,772,668,104,774,656,118,923,808,93,771,647,86
060371955003,524,467,57,531,461,70,636,564,63,572,485,53
060371956002,366,337,29,365,329,36,444,381,51,395,336,34
060371956003,267,245,22,266,239,27,337,291,39,280,241,24
060371956004,335,309,26,335,302,33,410,358,44,353,307,25
060371958041,339,308,31,337,297,40,485,412,63,364,304,36
060371958042,621,567,54,623,557,66,753,640,99,681,575,59
060371917201,389,346,43,390,338,52,606,482,107,429,366,40
060371917202,291,259,32,293,253,40,413,324,78,298,255,27
060379800091,3,3,0,3,3,0,5,5,0,3,3,0
060371242011,354,290,64,359,287,72,557,426,120,429,331,73
060371242012,429,350,79,433,347,86,593,462,127,462,364,73
060371242013,182,150,32,182,146,36,280,216,59,217,173,35
060371317022,237,178,59,240,174,66,364,256,102,286,212,62
060371882022,466,394,72,473,394,79,564,473,85,519,422,80
060371882023,369,311,58,375,316,59,457,381,69,381,308,62
060371239011,648,538,110,654,521,133,1014,765,222,694,545,107
060371882011,776,710,66,793,718,75,1027,920,94,839,742,66
060371882013,604,554,50,614,558,56,695,622,62,619,550,46
060371952011,1055,958,97,1067,966,101,1254,1117,117,1110,971,89
060371882021,509,428,81,513,426,87,624,521,93,555,456,78
060371952021,566,516,50,573,519,54,661,592,63,589,520,46
060371952022,569,519,50,570,519,51,716,635,72,636,551,55
060371952023,595,544,51,602,545,57,737,649,75,625,531,62
060371892022,326,293,33,331,296,35,412,332,73,339,285,38
060371892023,652,583,69,660,584,76,790,636,140,683,573,79
060371893002,605,502,103,614,504,110,721,565,151,641,483,129
060371893003,375,331,44,380,332,48,450,383,65,384,329,43
060371174071,69,59,10,69,58,11,144,110,30,92,77,10
060371175202,125,107,18,127,106,21,253,195,54,183,155,21
060371310231,603,475,128,609,468,141,1009,712,271,755,572,146
060371318011,590,447,143,596,440,156,1016,716,278,774,561,175
060371893001,713,626,87,718,626,92,857,753,92,724,625,78
060371253222,245,220,25,249,221,28,493,421,62,311,259,31
060371254041,943,840,103,949,839,110,1503,1290,178,999,814,111
060372292001,270,241,29,279,236,43,440,373,55,326,297,15
060372292002,359,331,28,367,319,48,592,503,75,463,421,21
060372294201,332,304,28,332,291,41,523,450,64,501,447,28
060371905101,622,543,79,626,535,91,1109,859,229,692,533,112
060371905202,454,389,65,456,387,69,744,529,201,566,410,113
060371277112,260,210,50,262,205,57,402,301,95,298,232,48
060371283021,567,461,106,564,447,117,756,603,142,667,523,104
060371082021,751,501,250,773,501,272,1229,786,430,654,445,185
060371082023,814,515,299,825,506,319,1560,982,553,1068,698,325
060371924201,380,328,52,385,320,65,582,472,103,424,361,45
060371925101,393,337,56,398,333,65,576,456,113,459,390,52
060371925102,388,333,55,393,329,64,618,486,118,444,372,51
060371253101,379,319,60,385,316,69,541,426,106,411,323,62
060371390011,563,428,135,571,432,139,757,555,185,636,488,109
060379800241,85,65,20,88,67,21,120,89,30,94,74,16
060371287042,687,542,145,701,540,161,916,704,193,741,565,142
060371287031,898,741,157,910,723,187,1269,971,277,990,762,185
060371911201,521,451,70,529,448,81,817,593,206,623,490,97
060371911202,296,250,46,303,253,50,493,372,112,383,304,61
060371916201,480,416,64,477,402,75,822,618,186,571,469,69
060371237002,289,213,76,296,216,80,419,239,167,318,208,94
060371413061,559,451,108,556,446,110,720,536,168,611,475,113
060371413041,859,695,164,856,691,165,1080,801,258,957,737,174
060371810002,609,466,143,617,451,166,783,576,193,678,470,170
060371810003,370,277,93,375,268,107,493,364,122,393,268,107
060371810005,915,732,183,914,705,209,1195,905,272,1035,753,227
060371813001,531,428,103,531,416,115,707,538,155,560,427,103
060371813002,426,331,95,430,322,108,577,438,129,471,349,98
060371813003,716,563,153,716,547,169,945,725,202,790,586,158
060371286012,364,305,59,372,309,63,547,416,118,459,352,76
060371286013,302,254,48,308,256,52,462,354,101,378,291,63
060371286021,375,313,62,380,311,69,539,405,120,439,340,73
060371832221,372,320,52,373,311,62,507,428,69,397,318,56
060371320011,443,331,112,452,325,127,611,432,164,492,342,114
060371320012,343,257,86,353,252,101,486,344,132,404,280,93
060371832212,870,768,102,874,749,125,1159,973,159,983,807,117
060371902011,413,368,45,420,367,53,754,557,176,511,404,61
060371902012,290,260,30,291,254,37,382,313,62,366,305,38
060371910001,347,311,36,349,303,46,548,398,137,376,280,65
060371913022,358,314,44,361,305,56,429,280,143,425,311,86
060371957201,349,323,26,351,318,33,384,329,44,378,324,31
060371975001,714,661,53,720,653,67,861,763,79,742,642,57
060371975003,321,299,22,326,296,30,420,380,35,342,300,24
060371834011,521,469,52,521,458,63,753,619,113,577,488,59
060371834021,400,355,45,401,349,52,550,453,89,418,353,47
060371412021,349,277,72,360,284,76,452,355,88,390,302,72
060371412022,583,465,118,593,471,122,785,612,161,647,494,120
060371412023,450,356,94,461,360,101,560,442,109,518,400,97
060371272102,351,282,69,357,283,74,607,459,137,635,498,102
060371272103,562,448,114,571,448,123,972,708,246,959,742,165
060371836202,266,244,22,270,243,27,327,282,38,277,242,18
060371837012,335,293,42,334,285,49,476,400,65,367,301,44
060371837021,541,450,91,537,437,100,729,601,110,594,473,87
060371871022,881,771,110,887,747,140,1516,1227,269,963,800,111
060372371014,199,184,15,203,177,26,292,253,36,271,245,15
060372371012,141,130,11,139,122,17,220,193,27,196,178,11
060372371013,180,165,15,178,155,23,286,243,35,246,223,13
060371835201,541,498,43,541,483,58,727,638,70,587,503,40
060371835202,437,400,37,435,386,49,661,577,66,496,424,34
060371394011,301,186,115,306,186,120,484,275,198,348,213,117
060371394012,496,352,144,504,347,157,825,472,337,618,425,163
060371394021,525,341,184,533,340,193,705,447,248,613,399,185
060371394022,362,229,133,369,228,141,520,317,195,412,265,132
060371394023,302,190,112,307,190,117,446,257,184,362,232,120
060371395021,565,361,204,576,361,215,959,549,398,696,444,220
060371837011,439,396,43,440,385,55,569,479,71,446,377,33
060371838102,548,508,40,550,495,55,772,661,90,573,484,51
060371838202,451,418,33,448,402,46,618,521,79,463,380,48
060372281002,267,250,17,267,238,29,465,392,59,305,276,13
060372288001,226,205,21,225,198,27,406,351,43,139,127,6
060372288002,240,218,22,239,210,29,438,374,48,345,310,19
060371851021,819,681,138,819,673,146,1008,870,120,868,698,131
060371851022,885,800,85,888,784,104,962,845,95,925,796,78
060371154031,319,227,92,326,230,96,523,349,164,378,271,94
060371154032,315,225,90,322,227,95,539,356,170,402,283,99
060371898021,612,536,76,615,533,82,760,613,135,623,517,75
060371898022,348,305,43,350,305,45,427,347,77,380,322,44
060371898012,388,340,48,389,339,50,466,381,82,415,352,46
060371899051,343,288,55,345,286,59,458,371,83,390,303,59
060371899052,589,489,100,595,490,105,869,697,156,730,556,119
060371437002,654,516,138,653,514,139,819,633,173,714,541,134
060371852041,605,517,88,605,511,94,770,649,108,637,525,82
060371852042,301,276,25,303,270,33,394,341,46,330,283,27
060371863022,887,782,105,894,775,119,1102,926,155,907,768,91
060371912041,499,438,61,502,427,75,730,513,200,604,473,92
060371958031,657,612,45,657,601,56,834,756,68,717,629,44
060371958032,513,474,39,519,470,49,598,537,53,543,473,38
060371882012,487,439,48,489,441,48,581,520,54,564,492,49
060371954001,445,411,34,452,414,38,539,489,46,481,429,32
060371954004,681,637,44,693,639,54,782,706,61,736,658,42
060371955001,951,886,65,961,880,81,1106,1002,92,1004,891,56
060371832201,286,248,38,291,245,46,414,345,60,325,262,41
060371951003,668,610,58,678,614,64,834,759,66,695,618,51
060371951004,962,888,74,967,884,83,1142,1048,82,983,889,68
060371954002,698,650,48,704,651,53,880,779,80,728,649,45
060371954003,528,489,39,532,491,41,673,606,58,549,491,36
060371864012,248,220,28,251,214,37,324,268,55,269,234,25
060371953001,308,289,19,305,283,22,415,357,53,386,334,33
060371953002,389,365,24,387,358,29,494,420,62,472,409,41
060371837022,549,472,77,545,452,93,738,597,129,639,515,84
060372126101,434,357,77,441,350,91,753,565,177,463,380,60
060372126102,418,347,71,427,341,86,724,563,152,467,386,56
060372126201,389,315,74,395,308,87,673,499,160,429,344,61
060372126202,316,258,58,321,253,68,574,427,139,382,312,48
060372127011,618,484,134,629,478,151,943,705,224,669,521,108
060371993001,515,454,61,513,435,78,680,577,86,607,507,62
060371993002,856,770,86,857,751,106,1149,971,149,929,775,84
060371994001,288,260,28,291,256,35,428,369,51,336,283,31
060371994003,441,396,45,441,386,55,683,568,99,520,439,43
060371905102,329,294,35,330,286,44,514,399,105,388,317,47
060372015012,395,348,47,399,335,64,600,498,84,478,393,54
060372015014,529,462,67,539,448,91,814,651,134,674,561,69
060372016021,262,225,37,268,222,46,400,319,69,339,284,34
060372016022,332,283,49,336,279,57,480,384,86,398,333,47
060372014011,672,599,73,682,585,97,1032,855,159,817,686,80
060372014012,464,404,60,468,394,74,741,613,116,554,457,63
060372015032,334,301,33,338,293,45,502,420,74,399,340,36
060372016023,250,217,33,258,214,44,378,303,64,307,255,35
060372294202,313,296,17,308,280,28,547,461,68,374,328,24
060372014021,632,555,77,638,541,97,908,727,154,772,635,88
060372014022,343,292,51,346,289,57,445,363,73,417,341,51
060372014023,374,320,54,377,316,61,546,443,93,486,397,59
060372347001,230,214,16,233,212,21,317,283,33,371,340,16
060372348001,250,231,19,253,230,23,349,309,37,340,315,16
060372348003,264,240,24,268,245,23,367,328,35,431,393,24
060372372022,240,225,15,247,225,22,315,287,28,269,250,10
060372015011,270,242,28,274,233,41,399,319,72,298,246,35
060371972001,443,376,67,454,370,84,685,564,111,476,384,69
060371972002,389,331,58,396,323,73,624,494,122,510,398,76
060371972003,231,194,37,230,188,42,355,285,58,272,222,37
060371151041,379,257,122,383,258,125,566,401,157,470,303,138
060371151043,291,198,93,296,199,97,418,282,124,349,226,102
060371990011,319,283,36,326,273,53,553,440,97,394,330,35
060371998021,166,147,19,169,143,26,285,230,46,214,180,23
060371998011,262,235,27,266,227,39,498,402,80,326,277,32
060371999002,181,160,21,177,151,26,318,257,50,223,192,21
060371994002,291,263,28,297,263,34,458,391,59,352,292,33
060371973001,703,661,42,701,651,50,847,762,70,805,714,43
060372699031,478,429,49,487,430,57,650,557,77,536,442,55
060372699092,572,512,60,580,513,67,758,658,82,660,551,61
060372718041,443,392,51,449,391,58,584,499,72,479,393,54
060372718031,487,443,44,494,442,52,607,525,71,492,433,36
060372325002,321,302,19,327,299,28,504,448,42,402,368,17
060371959011,1004,963,41,1007,956,51,1237,1131,80,1098,958,53
060372364001,646,607,39,650,606,44,877,816,45,695,644,24
060372364002,835,782,53,838,773,65,1005,938,50,934,873,35
060371941021,617,491,126,623,489,134,828,626,189,694,524,128
060371941022,627,463,164,627,456,171,817,595,209,665,462,168
060372941102,245,199,46,245,188,57,371,278,87,326,245,57
060372941103,280,228,52,284,218,66,412,316,90,362,276,64
060372941202,181,160,21,181,158,23,351,272,74,275,238,21
060371437001,699,576,123,703,570,133,848,710,127,712,571,111
060371897021,520,441,79,522,444,78,658,547,102,524,431,70
060371897022,629,559,70,631,561,70,770,656,93,695,581,77
060372094021,145,123,22,149,122,27,198,150,48,169,140,19
060372094022,147,123,24,152,123,29,196,145,47,184,150,21
060372094031,272,224,48,279,224,55,443,326,104,308,252,35
060372094032,125,103,22,129,103,26,212,158,51,154,125,18
060371914101,432,398,34,433,382,51,629,507,105,516,444,44
060371914102,594,557,37,600,538,62,838,672,141,688,594,53
060371959031,493,456,37,506,457,49,648,573,62,569,497,42
060371959032,334,309,25,343,309,34,444,388,46,381,332,28
060371957101,456,420,36,457,410,47,607,523,73,488,417,42
060371957102,359,327,32,357,317,40,533,454,66,404,340,39
060372084011,251,206,45,254,198,56,378,299,67,297,248,33
060372084012,364,300,64,374,291,83,567,422,131,466,388,52
060371956001,260,241,19,262,237,25,323,273,39,297,249,27
060371957202,455,421,34,461,418,43,546,470,63,486,415,35
060372293001,250,233,17,256,225,31,423,362,54,358,323,17
060371240001,393,277,116,398,278,120,535,358,168,442,306,115
060371249031,892,695,197,900,693,207,1220,840,355,989,712,214
060372118021,372,315,57,378,315,63,620,463,146,408,339,47
060372123041,337,292,45,339,285,54,480,385,84,365,311,30
060372124101,203,174,29,206,172,34,343,252,81,231,188,31
060372124103,174,149,25,177,147,30,257,206,45,188,162,14
060372124102,231,198,33,236,196,40,381,291,80,237,199,25
060372124201,254,219,35,257,215,42,383,304,67,320,264,36
060371249032,442,370,72,444,368,76,622,476,134,465,351,82
060372946101,309,263,46,313,258,55,440,324,99,406,334,51
060372946102,512,431,81,523,424,99,779,579,177,709,574,96
060372947013,196,164,32,196,157,39,345,260,78,215,181,24
060372945101,343,285,58,346,281,65,575,448,123,440,360,56
060372945102,323,272,51,328,268,60,529,407,114,436,356,52
060371066481,647,540,107,658,521,137,1107,854,228,805,660,108
060372119102,273,232,41,278,231,47,404,313,83,294,246,31
060372121011,256,207,49,261,207,54,418,333,76,267,216,34
060372121021,309,258,51,313,255,58,413,305,98,294,235,47
060372121022,297,240,57,303,240,63,509,391,107,344,277,43
060372215001,415,363,52,419,359,60,658,553,97,634,565,41
060372215002,285,249,36,284,244,40,468,391,69,248,216,21
060372944101,323,242,81,328,236,92,591,426,148,413,314,78
060372944102,599,451,148,601,434,167,1080,780,274,765,577,149
060372944212,132,100,32,134,97,37,239,176,63,171,131,33
060372944213,137,105,32,138,100,38,224,162,57,169,125,34
060371240003,629,496,133,635,493,142,781,588,181,680,515,134
060371240004,613,465,148,623,467,156,814,612,190,647,475,144
060371434022,231,187,44,234,186,48,328,256,67,225,174,43
060372319011,404,369,35,411,352,59,645,537,90,487,436,31
060372319022,235,213,22,236,202,34,408,350,56,313,279,21
060372328001,245,226,19,248,219,29,413,345,58,320,293,18
060372971202,323,240,83,324,231,93,526,369,147,372,270,79
060372976013,263,173,90,269,170,99,459,294,153,300,183,93
060372976021,329,208,121,335,207,128,450,285,151,417,240,137
060372976023,483,313,170,491,306,185,644,411,220,521,316,164
060372125011,442,383,59,441,377,64,686,545,126,521,439,52
060372125022,352,312,40,351,306,45,553,420,120,420,360,35
060372132011,180,159,21,182,155,27,302,234,61,208,179,18
060372132013,200,177,23,200,173,27,371,297,68,231,197,21
060372131001,239,200,39,246,198,48,395,299,92,288,239,38
060372131002,308,259,49,316,258,58,501,378,116,415,338,53
060372213041,344,292,52,353,293,60,528,411,102,425,349,46
060372213042,206,180,26,210,179,31,315,247,59,235,205,17
060371288011,570,456,114,577,456,121,801,619,166,639,485,119
060371288012,814,653,161,824,653,171,1140,881,241,896,682,166
060371289103,607,489,118,621,485,136,889,661,214,713,531,142
060371284004,441,362,79,444,358,86,641,507,122,457,350,78
060371374011,360,255,105,363,255,108,638,449,182,399,274,105
060371374013,896,617,279,905,622,283,1165,796,344,971,652,266
060371374022,681,462,219,700,472,228,864,587,265,780,534,205
060371374023,686,481,205,693,478,215,957,687,251,732,509,181
060371375021,389,286,103,400,292,108,533,373,156,440,321,102
060371375022,768,554,214,777,555,222,1024,713,301,861,609,214
060371375023,833,585,248,839,590,249,1141,772,350,911,613,254
060372085012,322,280,42,324,274,50,492,396,82,358,294,44
060372086101,397,343,54,403,332,71,616,482,122,463,371,67
060372086201,274,238,36,278,228,50,411,325,78,327,259,48
060372218101,322,299,23,327,295,32,437,363,62,403,356,26
060372219002,185,173,12,185,168,17,228,191,33,234,206,15
060372226001,261,244,17,267,244,23,369,323,40,394,353,21
060372226002,502,462,40,513,456,57,640,541,80,691,619,39
060372226003,322,300,22,324,296,28,435,379,48,358,321,19
060371374021,1039,720,319,1060,728,332,1415,956,429,1168,793,319
060372222001,510,468,42,518,464,54,791,676,99,641,566,36
060372222002,357,321,36,359,312,47,530,459,60,438,381,24
060372318002,105,94,11,107,90,17,179,155,24,149,133,10
060372319021,165,148,17,167,141,26,295,249,38,288,257,17
060371375012,687,471,216,691,464,227,1093,694,373,817,549,225
060371375013,493,327,166,502,329,173,763,513,232,620,409,184
060371375041,1002,636,366,1020,644,376,1334,837,470,1077,673,353
060371380001,1053,742,311,1067,739,328,1343,932,393,1119,767,294
060371375011,307,208,99,313,206,107,446,285,158,364,240,107
060371380002,402,284,118,406,280,126,551,400,147,434,296,116
060371380003,798,571,227,809,562,247,1099,780,304,898,613,240
060372427001,187,175,12,189,177,12,285,249,29,313,293,8
060372427003,273,253,20,281,260,21,480,416,50,443,411,17
060371398021,866,565,301,878,561,317,1129,682,426,916,589,295
060371398022,1014,622,392,1028,618,410,1344,825,502,1115,689,386
060372240201,241,217,24,244,218,26,454,383,60,457,386,44
060372240202,153,139,14,156,140,16,286,243,34,153,131,15
060372098201,197,169,28,202,165,37,311,236,63,213,181,21
060372098202,163,140,23,164,136,28,266,207,55,214,182,19
060372100102,136,118,18,141,115,26,184,143,40,196,167,18
060372100103,275,236,39,282,235,47,412,316,82,357,303,32
060371397041,1230,843,387,1244,842,402,1662,1052,588,1332,943,343
060371397031,1147,691,456,1167,692,475,1691,1015,660,1265,742,477
060371433021,345,280,65,353,283,70,422,348,70,377,301,60
060371433023,598,482,116,614,490,124,769,620,140,643,505,112
060371433022,700,568,132,710,570,140,911,732,166,792,631,126
060372246002,196,172,24,198,169,29,247,205,35,207,184,16
060372283101,206,191,15,207,181,26,306,265,36,253,228,13
060372283201,166,154,12,167,144,23,243,205,29,215,192,14
060372286001,365,337,28,366,320,46,567,483,73,493,445,29
060372286002,256,236,20,260,225,35,433,373,54,302,273,17
060371397011,402,286,116,413,291,122,522,358,157,523,386,119
060371414003,940,681,259,958,692,266,1242,851,366,1049,718,274
060371998022,186,167,19,189,162,27,339,275,53,253,218,24
060371999001,225,200,25,226,195,31,420,344,67,280,239,26
060371288022,696,587,109,697,579,118,903,709,179,691,562,97
060371201082,381,310,71,392,308,84,666,507,139,513,424,61
060371041241,495,394,101,497,379,118,797,584,191,583,450,101
060371397051,535,374,161,551,381,170,742,489,242,578,424,129
060371397053,747,515,232,755,513,242,954,622,318,796,579,185
060371416003,725,562,163,735,562,173,878,689,178,752,583,136
060371415001,1561,1095,466,1586,1103,483,2048,1468,561,1645,1182,392
060371414002,522,361,161,533,365,168,681,488,180,627,421,180
060371042041,246,224,22,258,218,40,413,356,45,367,325,24
060372111241,238,199,39,242,195,47,402,311,81,318,264,38
060372111242,171,143,28,174,141,33,301,236,61,219,185,26
060372111221,208,177,31,204,168,36,330,255,67,168,136,24
060372111222,296,251,45,297,239,58,521,402,104,188,146,30
060372113201,220,193,27,222,183,39,365,295,63,246,204,26
060371413062,714,565,149,724,563,161,1026,766,239,840,639,164
060371416002,556,425,131,559,424,135,693,544,139,576,441,111
060372283202,269,247,22,274,242,32,391,337,46,362,337,14
060372285001,245,224,21,248,218,30,393,337,50,362,333,18
060372285003,122,113,9,125,111,14,221,191,28,201,184,6
060371289101,622,493,129,635,488,147,849,617,212,688,507,149
060371289102,585,452,133,592,452,140,726,534,183,645,482,139
060371413032,585,466,119,597,469,128,837,639,184,666,494,135
060371413042,487,399,88,496,399,97,687,526,151,518,400,93
060371414001,674,527,147,686,527,159,950,680,252,721,533,148
060372122031,149,129,20,149,124,25,298,240,53,138,118,12
060372122032,264,228,36,266,220,46,397,292,95,326,279,29
060372122042,153,137,16,159,136,23,269,198,65,180,152,17
060372123032,283,245,38,286,237,49,542,435,95,276,235,24
060371417002,892,666,226,906,668,238,1206,922,270,992,746,213
060372612001,1400,986,414,1418,992,426,1788,1156,606,1515,1050,395
060372612002,711,488,223,722,496,226,980,642,323,783,543,213
060372073042,353,304,49,356,306,50,529,463,51,464,390,40
060372077111,543,471,72,555,469,86,890,703,172,826,672,108
060372077122,369,318,51,373,319,54,638,523,100,388,319,47
060371287041,597,465,132,609,465,144,719,555,153,659,504,128
060372701021,371,337,34,375,337,38,445,389,46,407,352,31
060372701022,676,603,73,684,605,79,815,713,85,710,617,55
060372701011,382,346,36,384,346,38,442,387,45,432,374,33
060371247003,796,682,114,799,674,125,1130,873,238,926,748,130
060371247004,602,489,113,607,491,116,775,620,144,657,517,109
060371412011,830,707,123,838,696,142,1123,880,219,888,722,101
060371412012,602,504,98,608,500,108,819,646,155,598,477,87
060371411022,911,715,196,919,717,202,1276,1016,235,1019,775,203
060371411012,627,521,106,636,518,118,917,709,190,728,557,126
060371411013,546,450,96,552,447,105,783,596,173,666,507,119
060371417001,416,322,94,422,322,100,493,389,99,439,339,86
060371439022,748,581,167,760,574,186,943,742,187,789,615,140
060371913011,337,303,34,335,292,43,475,400,71,401,346,41
060371913012,385,346,39,383,333,50,560,467,83,442,379,45
060372246001,295,263,32,298,257,41,485,421,57,393,345,23
060371439013,1015,806,209,1028,803,225,1268,986,262,1098,868,190
060371439011,613,520,93,619,520,99,712,591,118,693,572,97
060372422012,214,197,17,218,196,22,386,329,45,329,305,11
060372422022,193,176,17,200,178,22,329,281,33,308,284,11
060372423001,283,262,21,284,252,32,486,409,62,433,399,18
060372423002,157,143,14,158,139,19,282,244,35,226,208,13
060372431001,396,360,36,401,354,47,588,508,61,573,535,20
060372431002,224,204,20,229,204,25,397,332,46,363,341,9
060372431003,140,128,12,143,128,15,252,215,28,225,214,5
060371432001,828,691,137,842,696,146,1032,844,171,814,630,130
060371432002,601,505,96,607,504,103,707,580,115,560,432,93
060372723011,410,338,72,417,336,81,443,378,60,431,339,61
060372723012,532,443,89,541,441,100,649,550,89,578,458,79
060371438011,1044,841,203,1063,851,212,1191,915,260,1100,864,186
060371438012,434,354,80,442,360,82,577,472,99,472,374,79
060371438022,672,499,173,668,494,174,865,639,210,714,524,163
060372170011,466,319,147,470,319,151,620,380,239,510,360,135
060372170021,700,545,155,710,541,169,1012,630,359,849,630,173
060372170023,718,552,166,730,559,171,985,673,304,821,618,168
060371439012,525,377,148,528,374,154,721,527,185,585,417,152
060371438021,474,390,84,475,392,83,606,502,97,514,424,62
060371897041,405,336,69,409,333,76,603,494,101,507,398,89
060371897031,422,362,60,425,364,61,553,466,80,497,403,74
060371897032,355,296,59,360,296,64,609,499,101,358,270,65
060371897042,349,287,62,353,287,66,676,553,111,462,377,58
060372430012,218,199,19,217,196,21,331,278,36,304,276,13
060372430021,217,198,19,218,196,22,352,297,42,317,292,16
060372430022,307,282,25,308,278,30,405,358,43,388,360,19
060372372023,252,228,24,259,227,32,366,312,51,217,200,9
060372372024,319,294,25,324,293,31,466,407,51,454,414,20
060372373002,311,288,23,320,287,33,449,410,37,511,471,22
060372373005,248,232,16,256,231,25,374,333,37,276,252,13
060372110005,534,352,182,545,351,194,712,535,176,648,442,181
060372110003,359,273,86,365,269,96,501,368,126,358,272,73
060372110004,462,358,104,468,354,114,764,571,177,479,370,85
060371896003,534,457,77,535,458,77,680,572,101,609,530,60
060371901011,311,272,39,317,274,43,467,365,84,352,280,45
060371941011,553,488,65,554,490,64,726,589,127,607,503,73
060371896001,751,668,83,757,667,90,1038,892,117,841,716,72
060371941012,926,786,140,935,793,142,1165,904,245,1036,839,139
060371941023,409,353,56,415,354,61,515,433,73,429,366,46
060371997001,470,441,29,478,439,39,646,544,88,562,487,37
060371997002,407,371,36,415,369,46,594,506,75,514,440,40
060371998012,287,255,32,297,252,45,437,357,67,390,334,36
060372611031,1011,866,145,1021,865,156,1173,895,266,971,821,121
060372717033,438,385,53,451,388,63,568,480,71,468,387,55
060372717032,492,425,67,502,426,76,590,505,72,513,427,59
060372611021,321,216,105,328,217,111,451,331,115,353,250,94
060372611023,933,635,298,952,640,312,1299,866,421,1056,730,289
060372655231,454,369,85,464,368,96,549,420,121,511,411,73
060372655232,401,324,77,409,324,85,511,387,117,459,369,66
060372656012,772,604,168,793,607,186,1054,784,252,896,702,156
060371942003,672,576,96,677,575,102,861,697,154,746,626,91
060371942001,523,432,91,525,430,95,685,539,139,601,493,84
060371943001,434,337,97,437,338,99,535,425,107,536,420,105
060371943002,424,346,78,428,345,83,525,427,91,436,352,74
060371942002,489,436,53,496,437,59,601,505,87,540,468,53
060371915001,365,304,61,374,301,73,513,386,114,427,330,73
060371915002,366,305,61,376,303,73,534,402,120,446,349,76
060371915003,344,295,49,345,286,59,524,395,117,407,330,56
060371943003,551,497,54,555,498,57,696,588,97,612,539,54
060372734031,359,322,37,367,326,41,449,392,48,434,371,39
060372734032,260,229,31,265,229,36,324,278,46,318,273,24
060372735023,407,368,39,413,370,43,517,434,75,482,416,37
060372735021,427,386,41,432,388,44,555,477,63,494,425,36
060372735022,415,379,36,423,382,41,493,436,46,495,445,28
060372413001,239,228,11,239,221,18,349,326,23,282,267,11
060372413002,313,299,14,314,290,24,468,425,33,378,352,16
060372672021,536,438,98,552,443,109,724,554,156,611,485,97
060372672022,586,482,104,599,485,114,772,600,157,613,485,93
060372672013,490,412,78,497,413,84,691,549,131,537,432,75
060372672023,302,246,56,312,248,64,385,308,76,314,250,50
060372671011,904,748,156,917,745,172,1152,876,257,996,789,150
060372671012,423,349,74,426,346,80,543,430,110,434,345,66
060372671022,1033,814,219,1047,806,241,1273,962,285,1072,838,184
060372671021,472,360,112,483,360,123,574,406,165,502,385,100
060372679011,551,407,144,563,409,154,727,526,193,600,437,145
060372679012,711,515,196,726,516,210,944,692,241,799,556,212
060372679023,546,394,152,556,394,162,678,497,173,586,470,95
060372652012,345,256,89,352,256,96,405,279,123,518,401,95
060372652031,388,285,103,394,284,110,528,362,161,465,348,103
060372652032,352,274,78,362,276,86,457,359,88,396,307,72
060372651001,548,381,167,560,386,174,773,512,252,582,417,139
060372652011,566,417,149,575,417,158,728,497,221,621,466,130
060372657021,548,394,154,556,399,157,760,504,246,584,412,148
060372655221,317,254,63,323,254,69,419,321,90,370,286,62
060372655211,312,248,64,312,247,65,424,323,90,409,318,65
060372655222,344,278,66,349,277,72,455,341,105,408,319,66
060372656011,489,381,108,498,386,112,669,494,167,524,412,94
060372655212,241,196,45,244,196,48,324,248,68,281,219,44
060372655241,273,224,49,278,224,54,403,300,97,322,252,50
060371114023,343,246,97,347,245,102,599,367,216,428,298,105
060372657023,350,273,77,355,277,78,436,303,125,401,314,71
060372673002,468,408,60,477,410,67,656,532,109,546,452,59
060372673003,483,420,63,491,423,68,661,535,110,570,470,62
060372677001,652,566,86,662,569,93,938,784,132,691,574,74
060372655242,741,596,145,754,592,162,1002,749,241,863,691,129
060372673001,404,350,54,408,351,57,533,434,88,455,379,49
060372079021,1036,891,145,1055,887,168,2165,1757,355,634,524,70
060372079012,375,304,71,385,304,81,647,518,113,292,232,45
060372079011,323,262,61,330,261,69,708,576,115,345,277,50
060372079022,441,360,81,454,359,95,606,488,105,446,362,57
060372240102,328,288,40,335,288,47,529,436,79,323,264,35
060372690002,452,352,100,460,354,106,572,458,103,483,391,80
060372695002,422,354,68,421,353,68,512,362,145,419,350,53
060372697003,386,331,55,387,330,57,437,340,88,413,342,48
060372697004,397,338,59,399,338,61,469,357,102,431,358,52
060372698001,552,475,77,561,480,81,720,616,92,653,552,67
060372697002,458,417,41,473,426,47,577,499,67,534,463,39
060372698002,873,785,88,897,800,97,1141,973,140,971,844,74
060372674061,786,679,107,804,679,125,1081,882,180,871,721,97
060372674052,689,590,99,698,590,108,881,721,143,775,642,84
060372674041,380,325,55,388,326,62,527,428,88,450,366,54
060372675042,598,518,80,610,518,92,775,652,111,658,542,76
060372675021,595,509,86,608,514,94,809,669,125,706,575,81
060372675022,560,473,87,571,477,94,817,682,123,638,512,81
060372675041,562,479,83,571,479,92,785,650,121,614,505,76
060372676001,525,433,92,537,437,100,686,545,122,584,456,94
060372623032,440,307,133,450,310,140,556,395,155,454,332,103
060372623033,543,400,143,553,406,147,659,494,159,584,444,116
060372640001,476,319,157,485,321,164,612,438,170,499,360,118
060372640003,512,353,159,521,354,167,657,454,195,561,398,148
060372623031,731,548,183,746,549,197,941,695,235,778,597,152
060372640002,689,519,170,704,520,184,891,651,231,752,568,154
060372641021,504,398,106,510,397,113,659,514,136,549,426,98
060372641022,841,673,168,850,677,173,1082,850,219,921,722,162
060372641031,640,497,143,653,501,152,827,642,173,663,525,105
060372376002,167,155,12,170,150,20,289,253,35,233,216,8
060372376003,152,140,12,156,136,20,257,225,31,223,207,6
060372376004,115,107,8,119,105,14,208,178,26,160,150,6
060372377102,275,255,20,281,250,31,512,439,61,348,322,12
060372641032,535,413,122,545,417,128,689,532,148,572,456,85
060372643031,586,476,110,594,473,121,825,633,177,635,503,96
060372643041,303,246,57,309,246,63,371,291,74,339,271,53
060372643032,541,440,101,548,438,110,748,586,147,606,480,93
060372761022,440,413,27,448,414,34,537,475,55,485,437,28
060372911301,291,237,54,296,236,60,437,344,86,386,320,46
060372911303,268,219,49,274,218,56,403,314,79,339,284,40
060372912101,283,236,47,285,233,52,434,323,96,377,317,38
060372396021,240,224,16,244,219,25,363,312,39,306,277,14
060372396022,271,252,19,272,244,28,396,341,42,295,268,12
060372643042,719,586,133,732,586,146,1004,794,192,815,649,128
060372654201,435,335,100,439,332,107,483,372,106,469,355,88
060372654202,509,391,118,515,390,125,541,437,95,584,442,112
060372651002,651,442,209,662,445,217,828,551,272,690,503,158
060372653032,333,304,29,343,309,34,350,290,47,456,392,31
060372653041,505,460,45,525,475,50,522,459,49,777,662,59
060372653042,229,209,20,236,214,22,232,204,22,296,253,21
060372653033,284,254,30,290,255,35,387,318,56,348,302,25
060372653071,374,350,24,382,356,26,450,364,76,465,408,30
060372653072,342,319,23,349,325,24,353,284,58,414,362,27
060372654101,355,269,86,365,279,86,439,322,113,404,328,66
060372621001,261,181,80,263,180,83,326,217,102,269,186,72
060372621002,349,240,109,346,237,109,424,285,136,362,252,99
060372621003,934,631,303,936,633,303,1205,785,397,1004,677,283
060372622002,1167,724,443,1191,724,467,1583,997,563,1251,805,395
060372622003,433,303,130,443,308,135,599,397,191,496,353,114
060372622001,527,365,162,539,370,169,711,473,229,589,416,139
060372015041,603,535,68,608,517,91,938,764,151,722,604,75
060372623011,1439,1014,425,1463,1018,445,1698,1221,450,1254,865,333
060372624002,986,717,269,1012,735,277,1247,882,341,1351,1009,288
060372624001,635,411,224,656,419,237,759,565,184,670,465,165
060372063022,277,239,38,282,236,46,245,189,45,271,214,43
060372625011,519,383,136,523,386,137,624,475,140,545,404,111
060372625012,464,342,122,468,344,124,534,417,111,467,347,96
060372625013,1085,810,275,1091,816,275,1312,1019,272,1171,874,236
060372628021,866,684,182,876,691,185,1072,824,229,918,736,143
060379800191,84,58,26,85,58,27,100,74,26,90,64,22
060372761011,615,543,72,619,539,80,784,678,89,720,610,69
060372948102,177,155,22,180,148,32,329,250,68,272,228,28
060372948301,280,246,34,285,239,46,528,404,105,441,375,43
060379800281,7,3,4,7,3,4,30,25,5,10,6,4
060372627041,720,532,188,732,543,189,922,710,195,801,603,152
060372627042,1119,808,311,1133,813,320,1423,1064,329,1240,907,259
060372780011,508,353,155,511,344,167,745,540,193,508,343,127
060372972012,380,279,101,387,270,117,612,409,184,294,205,69
060372972023,187,140,47,190,134,56,285,180,98,215,146,54
060372973002,477,322,155,492,317,175,672,429,239,445,279,138
060372975022,331,243,88,338,236,102,495,315,171,390,261,102
060372063011,299,266,33,301,262,39,354,288,54,411,340,43
060372260021,294,265,29,296,264,32,383,316,57,394,328,38
060372047003,282,262,20,282,252,30,398,349,46,326,288,17
060372051102,135,127,8,137,125,12,230,200,27,177,160,7
060372051101,238,224,14,239,220,19,415,357,47,302,272,12
060372051202,179,168,11,179,164,15,259,215,38,225,204,10
060372060501,484,443,41,489,427,62,796,686,94,655,574,50
060372611022,599,397,202,612,408,204,801,519,272,674,445,200
060372084021,297,263,34,301,262,39,437,353,69,384,327,38
060372085011,286,250,36,291,250,41,412,316,81,346,295,36
060371899031,610,513,97,618,522,96,852,661,177,673,525,107
060371899032,202,170,32,204,169,35,256,199,53,222,172,33
060371899041,416,353,63,418,355,63,645,514,119,491,386,78
060371899042,410,348,62,414,352,62,605,480,111,482,379,76
060371944021,586,536,50,591,530,61,700,601,94,651,571,64
060371944022,571,514,57,575,509,66,652,559,87,643,563,63
060371944011,628,546,82,631,544,87,840,704,130,712,592,91
060371944012,459,411,48,463,410,53,588,498,82,511,441,51
060371944023,507,439,68,512,439,73,634,542,90,582,500,64
060372911101,521,487,34,534,491,43,702,624,62,631,589,25
060372911102,316,291,25,322,298,24,586,517,56,382,351,19
060371920021,386,345,41,391,344,47,483,411,69,456,381,53
060371920022,311,277,34,313,276,37,404,314,86,359,304,41
060371919021,660,536,124,662,527,135,906,658,232,776,581,145
060371919022,698,603,95,704,602,102,881,736,139,733,605,90
060371920012,665,560,105,659,547,112,945,698,232,765,596,125
060371920011,371,318,53,377,316,61,466,355,99,421,352,48
060371920023,505,416,89,510,412,98,666,518,141,589,459,99
060372149041,383,303,80,388,300,88,549,381,162,413,317,81
060372149031,270,212,58,273,209,64,393,270,115,300,228,58
060372149032,277,222,55,281,220,61,376,261,111,306,237,56
060372947011,125,106,19,126,99,27,247,193,50,165,133,24
060372948302,176,151,25,179,144,35,295,221,68,251,212,26
060372149042,210,175,35,214,174,40,309,213,91,263,209,46
060372149021,348,290,58,355,289,66,495,376,113,474,376,80
060372149022,554,443,111,555,440,115,795,600,185,602,465,122
060371349051,681,532,149,686,512,174,1437,1051,364,837,612,184
060372164021,465,370,95,478,376,102,698,469,224,553,417,112
060372164022,466,369,97,477,374,103,668,448,214,551,419,107
060372164012,331,264,67,337,267,70,574,382,183,417,308,95
060372163011,705,594,111,715,594,121,896,730,159,797,671,92
060372678002,425,345,80,424,345,79,524,425,94,527,419,82
060372678003,641,520,121,643,523,120,964,773,169,834,666,123
060372264101,281,262,19,283,252,31,389,336,41,389,348,16
060372264102,229,211,18,230,204,26,325,279,37,223,199,9
060372679021,555,454,101,568,459,109,683,549,124,594,486,81
060372679022,688,562,126,697,565,132,858,654,192,735,595,111
060372693003,479,386,93,490,391,99,567,467,92,507,412,74
060372711001,405,318,87,406,323,83,471,382,86,451,352,77
060372711002,376,304,72,384,305,79,473,381,85,405,315,68
060372693002,500,405,95,507,409,98,578,485,91,519,428,74
060372693004,448,358,90,452,358,94,544,428,102,445,357,69
060372693005,386,308,78,389,308,81,465,371,89,419,341,64
060372691003,351,232,119,355,232,123,506,284,213,410,265,123
060372170012,319,188,131,322,180,142,475,219,247,414,227,163
060372170013,228,134,94,225,126,99,340,156,177,240,133,95
060372691002,244,151,93,248,149,99,388,179,204,246,147,87
060372691004,515,328,187,522,328,194,785,406,364,561,356,173
060372691001,551,335,216,551,324,227,810,470,330,583,381,183
060372695004,487,317,170,501,322,179,681,432,243,527,367,144
060372037101,248,234,14,255,230,25,405,349,53,323,290,16
060372037102,319,295,24,322,283,39,519,435,66,411,362,22
060372037201,312,288,24,312,280,32,488,422,51,419,363,30
060372037202,364,331,33,361,313,48,542,466,63,453,392,28
060372129001,354,308,46,361,306,55,551,433,105,396,322,40
060372129002,487,414,73,498,413,85,751,594,142,514,421,53
060372695001,437,320,117,441,324,117,545,316,222,469,363,96
060372695003,658,433,225,683,444,239,922,623,282,736,520,191
060372920012,279,214,65,285,211,74,485,336,129,377,273,75
060372693001,425,328,97,433,330,103,538,433,96,465,373,77
060372164013,363,294,69,364,289,75,545,367,174,440,329,86
060372170022,490,395,95,496,399,97,753,519,216,550,427,94
060372976012,270,183,87,277,180,97,375,240,126,317,197,97
060372976022,579,387,192,590,375,215,799,509,268,623,388,193
060372975021,579,370,209,591,373,218,882,549,296,663,411,213
060372975012,539,324,215,548,323,225,709,435,252,611,347,221
060372975013,457,248,209,468,247,221,559,323,227,342,180,141
060371864041,346,307,39,346,299,47,587,496,76,444,377,43
060371872001,538,469,69,546,466,80,754,629,106,605,501,65
060371872002,575,513,62,583,500,83,795,659,122,592,505,52
060372753113,500,440,60,502,437,65,697,553,133,566,468,64
060372755002,322,276,46,329,276,53,427,347,67,366,298,45
060372755003,312,264,48,315,265,50,403,326,71,338,276,43
060372696011,264,246,18,268,249,19,404,335,56,286,255,15
060372696012,268,250,18,273,252,21,406,348,48,295,261,16
060372696013,312,291,21,317,294,23,450,380,60,351,313,19
060372696021,606,525,81,607,526,81,802,663,118,664,573,71
060372696022,294,255,39,296,257,39,407,340,60,331,286,36
060372089021,78,67,11,77,64,13,122,90,31,84,72,9
060372089022,54,47,7,56,47,9,86,64,22,70,63,5
060372089041,226,197,29,230,193,37,339,245,83,304,266,23
060372089042,102,90,12,105,89,16,208,150,52,129,112,10
060372091051,207,181,26,210,177,33,361,271,79,258,226,20
060372091061,397,340,57,399,334,65,618,482,117,347,283,43
060372091041,267,236,31,273,231,42,517,405,97,343,297,26
060372699032,907,802,105,920,802,118,1103,944,132,975,829,90
060372699051,458,403,55,465,403,62,673,582,80,452,385,42
060372713001,377,306,71,380,303,77,517,433,74,432,349,60
060372713002,432,350,82,439,348,91,553,467,78,467,380,64
060372715001,479,386,93,486,385,101,575,481,86,533,419,83
060372715003,746,578,168,757,584,173,923,733,173,793,605,139
060372717042,767,653,114,775,652,123,1021,835,164,819,671,99
060372717021,609,525,84,620,528,92,798,661,117,652,534,75
060372717023,423,367,56,434,371,63,574,475,84,465,379,54
060372716001,358,304,54,361,306,55,493,416,64,402,333,46
060372716003,444,376,68,450,376,74,562,480,71,499,412,61
060372716002,537,452,85,543,451,92,658,557,86,573,468,73
060372716004,467,395,72,475,398,77,625,529,82,548,451,66
060372718011,350,302,48,351,302,49,473,404,62,396,330,46
060372718012,649,561,88,657,563,94,909,772,120,704,579,83
060372718042,544,484,60,550,484,66,721,617,90,623,529,61
060372718032,704,647,57,712,645,67,929,804,107,802,698,59
060372124202,207,179,28,208,175,33,337,266,59,239,204,21
060372132012,217,189,28,220,182,38,455,350,96,278,229,34
060372133101,231,191,40,234,185,49,349,268,81,301,257,28
060372133102,283,234,49,291,227,64,482,366,110,356,305,33
060372133201,262,219,43,266,211,55,409,308,93,331,285,31
060372133202,193,165,28,194,159,35,318,243,73,258,221,23
060372115001,410,330,80,410,322,88,528,416,108,420,336,64
060372115002,668,548,120,671,536,135,962,749,195,721,583,102
060372732001,333,302,31,337,304,33,411,367,40,370,328,22
060372732002,356,327,29,370,333,37,442,393,42,434,385,26
060372732004,438,401,37,448,404,44,583,510,46,517,450,33
060372733003,431,396,35,443,395,48,541,485,49,467,412,29
060372732003,252,230,22,257,235,22,380,336,35,313,281,18
060372736003,502,462,40,509,472,37,569,517,43,568,511,35
060372736002,366,333,33,372,338,34,428,386,36,424,375,27
060372731002,842,741,101,846,738,108,1136,988,127,858,721,92
060372731003,431,388,43,433,384,49,532,461,67,488,417,46
060372737001,438,387,51,444,390,54,558,486,63,467,390,49
060372737002,417,375,42,426,381,45,523,451,57,461,388,44
060372737003,533,481,52,538,486,52,650,572,63,583,510,51
060372714001,362,276,86,363,277,86,423,337,80,376,292,67
060372714002,557,432,125,562,434,128,695,561,122,620,479,115
060372714003,925,728,197,932,728,204,1146,922,203,1012,783,186
060372721004,445,363,82,453,361,92,573,461,104,512,411,71
060372721005,312,254,58,316,252,64,422,344,67,365,294,49
060372715002,337,276,61,340,276,64,399,334,63,365,293,55
060372719022,618,510,108,621,509,112,762,616,126,660,533,90
060372721001,538,439,99,546,440,106,680,552,119,588,466,97
060372392021,340,315,25,338,306,32,600,529,60,602,557,27
060372392022,136,126,10,135,123,12,258,225,26,279,256,13
060372392023,148,138,10,147,134,13,271,239,29,148,140,6
060372719012,553,469,84,559,467,92,714,604,101,577,468,74
060372719021,411,333,78,415,336,79,495,420,70,435,352,60
060372719023,840,705,135,836,698,138,1001,837,140,908,752,108
060372719011,400,347,53,406,343,63,523,443,70,417,338,50
060372719013,305,264,41,309,261,48,398,338,54,310,252,37
060372721003,437,364,73,439,359,80,508,427,76,447,353,67
060372721002,440,372,68,442,368,74,475,401,67,471,374,66
060371901012,278,244,34,284,245,39,370,293,68,316,251,44
060371901022,356,315,41,362,315,47,493,397,84,430,346,65
060371902021,344,304,40,347,305,42,466,373,80,401,331,44
060371902022,444,393,51,450,394,56,610,503,94,538,445,57
060371862032,488,451,37,488,441,47,630,529,90,514,448,35
060371902023,237,211,26,241,212,29,467,376,79,329,267,33
060372317103,230,209,21,238,209,29,346,289,50,174,156,10
060372317202,105,95,10,105,93,12,167,139,26,142,130,6
060372317203,260,240,20,268,244,24,392,324,59,367,333,14
060372321201,198,180,18,199,174,25,321,271,49,240,218,13
060372321202,220,201,19,225,197,28,358,298,52,290,262,16
060372321203,352,309,43,363,307,56,577,477,86,474,421,26
060372317101,123,109,14,125,106,19,192,160,28,228,203,13
060372317102,242,216,26,248,209,39,382,313,54,392,349,23
060372427002,314,291,23,319,287,32,531,467,48,480,443,19
060372095101,119,104,15,120,100,20,193,150,41,154,131,18
060372095102,180,158,22,182,153,29,326,250,69,222,183,29
060372095201,196,172,24,204,168,36,321,249,67,239,201,28
060372095202,92,79,13,92,76,16,149,115,33,106,87,13
060372216022,325,305,20,326,291,35,415,324,79,249,228,10
060371919012,619,549,70,622,546,76,1003,838,135,738,604,77
060372948101,189,164,25,192,159,33,335,257,66,244,213,20
060372948201,213,186,27,217,181,36,380,291,73,287,250,24
060372141002,519,365,154,528,366,162,675,444,229,554,384,149
060372141003,246,180,66,250,179,71,361,219,136,274,192,72
060372141004,602,452,150,607,447,160,780,423,340,669,473,172
060372970011,509,279,230,517,276,241,694,402,278,578,310,235
060372970012,277,167,110,284,164,120,433,266,160,435,259,144
060372974003,355,184,171,362,189,173,488,282,195,399,209,171
060372189002,341,321,20,342,312,30,502,434,56,409,376,19
060372214011,355,324,31,360,321,39,531,452,64,413,371,25
060372115003,600,469,131,603,467,136,672,536,129,643,500,110
060372751023,466,397,69,471,395,76,622,516,97,562,471,57
060372751022,232,197,35,235,196,39,360,298,55,281,234,28
060372117011,392,317,75,394,311,83,565,442,110,366,301,47
060372117012,368,298,70,374,296,78,502,402,96,403,328,61
060372117013,242,195,47,240,191,49,340,272,65,251,208,34
060372117031,480,418,62,488,410,78,799,628,156,553,462,59
060371918103,286,268,18,287,266,21,401,346,50,341,304,17
060372114101,395,319,76,400,308,92,643,479,151,480,377,79
060372114102,167,134,33,168,129,39,280,208,65,202,158,33
060372114201,507,435,72,507,420,87,756,556,179,574,471,75
060372114202,322,273,49,323,261,62,484,357,115,366,296,51
060372118031,245,199,46,246,189,57,449,336,102,277,220,42
060372118041,175,142,33,176,139,37,286,216,66,207,164,30
060372118042,349,280,69,354,269,85,570,426,131,413,324,67
060372118032,307,250,57,309,238,71,528,394,120,342,271,52
060371279101,309,246,63,314,244,70,514,363,141,380,294,64
060371904021,553,488,65,559,491,68,751,603,137,622,498,89
060371904022,255,225,30,257,226,31,324,256,63,346,277,50
060372094011,275,244,31,282,239,43,428,315,103,297,245,29
060372094012,249,219,30,251,213,38,389,288,94,254,212,24
060371977003,362,310,52,367,303,64,621,493,109,395,310,57
060379800101,47,41,6,47,41,6,98,77,16,117,94,15
060372033001,304,274,30,308,264,44,464,372,74,379,320,39
060371284003,444,366,78,450,363,87,581,460,110,499,383,86
060371413051,527,419,108,537,428,109,773,579,180,620,483,111
060371413052,563,450,113,572,453,119,836,633,192,677,525,121
060372121012,244,206,38,247,203,44,544,412,122,312,254,43
060372123031,236,204,32,237,199,38,379,303,67,224,192,17
060372088021,369,326,43,378,322,56,530,413,106,512,430,45
060372088022,290,255,35,293,249,44,375,277,90,311,261,28
060372212101,212,193,19,216,191,25,324,249,69,307,271,22
060372212102,422,388,34,424,381,43,592,484,93,529,457,32
060372213022,343,308,35,349,302,47,518,426,79,428,368,30
060372221001,355,331,24,364,334,30,533,468,48,474,422,27
060372111211,156,137,19,157,134,23,263,203,53,206,166,27
060372111212,311,272,39,310,264,46,532,409,106,424,344,56
060372060102,220,193,27,221,193,28,420,335,74,315,259,28
060372060201,222,195,27,224,195,29,267,171,70,124,103,11
060371331011,308,210,98,312,212,100,485,304,172,384,238,126
060371331012,322,220,102,326,222,104,518,323,183,379,251,108
060371061122,583,450,133,589,435,154,897,642,236,723,521,155
060371924101,473,423,50,480,418,62,696,587,96,513,434,56
060371924102,397,355,42,402,351,51,536,450,74,456,396,39
060372092011,475,407,68,476,399,77,874,697,142,426,347,53
060372093003,234,200,34,235,196,39,293,218,64,244,199,30
060372282101,295,273,22,301,267,34,397,333,53,354,324,18
060372282102,290,263,27,295,256,39,515,439,66,426,385,23
060372282203,224,208,16,229,201,28,401,342,50,248,225,14
060372283103,222,204,18,224,198,26,332,286,38,291,262,14
060372283102,175,163,12,179,159,20,272,236,32,224,201,12
060372161002,547,508,39,558,514,44,678,606,62,602,528,40
060372294101,239,221,18,242,208,34,423,361,52,252,226,11
060372294102,197,183,14,197,171,26,369,317,45,243,218,9
060372181101,554,504,50,561,505,56,802,670,112,640,562,49
060372181102,314,287,27,317,285,32,473,405,57,371,326,30
060372764001,443,296,147,453,296,157,560,407,140,504,337,135
060372764002,422,279,143,428,276,152,526,379,132,499,331,136
060372764005,408,281,127,414,283,131,534,387,133,451,318,112
060372321101,191,177,14,191,175,16,312,263,39,287,267,11
060372321102,286,264,22,287,258,29,478,402,62,400,372,13
060372213021,389,340,49,394,332,62,660,543,109,507,429,48
060372188001,313,289,24,318,290,28,499,427,68,514,452,21
060372188002,291,268,23,292,264,28,429,369,58,240,211,17
060372911201,453,418,35,461,423,38,642,571,60,536,487,27
060372912102,492,417,75,509,417,92,950,723,203,635,494,101
060372912103,270,225,45,280,225,55,472,357,106,306,242,49
060372189001,587,535,52,602,538,64,832,718,99,666,596,39
060372214012,458,416,42,464,417,47,692,595,80,574,522,28
060372187021,336,313,23,339,312,27,447,389,45,455,413,22
060372187022,276,258,18,281,259,22,395,347,40,255,232,10
060372216011,308,287,21,316,282,34,541,465,67,447,391,25
060372216012,255,238,17,257,230,27,457,386,56,384,335,22
060372098101,154,132,22,157,128,29,247,190,53,189,156,20
060372098102,114,98,16,115,94,21,193,147,40,144,119,15
060372221002,290,268,22,299,277,22,445,398,39,365,333,13
060372221003,217,200,17,223,207,16,324,285,38,279,254,12
060372219001,461,401,60,474,397,77,377,284,78,550,460,53
060371066421,407,231,176,416,242,174,613,331,273,498,278,192
060371066422,450,269,181,456,265,191,654,355,288,505,293,188
060371066431,1004,560,444,1020,560,460,1455,777,644,1117,625,426
060372225002,453,418,35,457,409,48,654,542,93,535,479,28
060372225003,359,332,27,364,328,36,511,437,61,458,414,23
060371318021,386,286,100,392,283,109,600,418,171,485,351,112
060371318022,286,214,72,296,212,84,469,333,131,357,256,84
060372189003,468,440,28,471,437,34,776,681,76,529,482,18
060372190102,439,411,28,438,401,37,611,534,61,342,319,14
060372193001,281,264,17,284,259,25,404,359,37,402,367,18
060372193002,280,263,17,287,262,25,436,390,41,262,236,14
060372193003,410,389,21,414,387,27,597,535,51,455,420,22
060372220011,431,394,37,437,397,40,613,535,70,695,636,31
060372220012,527,482,45,533,486,47,702,599,88,421,382,24
060372190201,520,480,40,528,477,51,832,731,84,708,633,42
060372190203,348,322,26,350,320,30,487,435,46,231,207,14
060372225001,293,265,28,302,261,41,452,375,66,357,316,21
060372190202,442,403,39,448,406,42,696,607,73,538,484,32
060372190101,404,373,31,404,367,37,519,451,60,657,612,28
060372220021,296,277,19,297,273,24,427,369,49,450,408,20
060372220022,249,232,17,251,231,20,367,320,42,249,229,11
060372220023,277,257,20,277,253,24,438,377,50,316,284,15
060372220024,337,314,23,341,312,29,515,445,58,425,386,19
060372426001,155,138,17,153,133,20,280,244,31,226,204,13
060372426002,221,196,25,225,194,31,446,380,48,334,315,8
060372426003,211,189,22,212,186,26,282,237,32,269,257,4
060372212201,168,144,24,169,139,30,239,189,48,222,192,19
060372212202,322,276,46,326,267,59,522,406,104,406,350,36
060372216021,227,196,31,229,189,40,346,269,70,286,246,25
060372197003,558,514,44,576,518,58,846,734,90,694,620,41
060372198001,230,214,16,231,210,21,316,280,33,277,255,11
060372198002,330,314,16,329,306,23,446,391,49,356,328,15
060372198003,274,262,12,274,254,20,402,352,41,294,273,12
060372201002,320,294,26,324,294,30,442,385,50,360,330,22
060372197001,420,397,23,424,392,32,644,559,72,494,451,26
060372197002,291,275,16,294,271,23,413,362,40,335,306,18
060372200003,265,250,15,267,250,17,362,322,30,317,294,14
060372200004,291,275,16,294,275,19,389,344,33,323,299,13
060372200005,353,332,21,354,332,22,505,447,45,393,359,17
060372200001,540,506,34,546,508,38,734,659,65,595,540,28
060372200002,454,424,30,467,437,30,587,527,54,492,447,23
060372187011,320,296,24,323,290,33,478,411,58,354,312,25
060371916101,562,512,50,575,513,62,752,625,111,677,575,63
060372403012,271,252,19,278,253,25,411,356,47,335,311,13
060372403022,157,147,10,159,145,14,251,219,29,211,196,9
060371925202,347,313,34,348,298,50,550,444,99,422,367,36
060371926202,357,319,38,355,306,49,516,411,95,416,358,35
060371926201,304,269,35,306,257,49,481,381,87,365,309,31
060371112021,517,326,191,526,326,200,756,445,292,590,353,199
060371112023,777,512,265,780,498,282,1165,720,427,916,561,298
060372112011,172,156,16,173,154,19,251,211,35,186,161,16
060372112012,304,275,29,304,270,34,463,374,78,328,284,28
060372112021,535,475,60,540,458,82,856,692,145,589,501,51
060372113101,221,197,24,225,197,28,334,283,46,235,203,22
060372113102,330,294,36,332,292,40,559,467,79,385,331,37
060372113202,346,307,39,349,300,49,575,475,90,438,372,41
060372083021,164,147,17,167,147,20,273,223,47,215,188,18
060372083022,242,219,23,248,219,29,373,308,60,273,237,24
060372084022,321,291,30,325,288,37,534,438,86,403,346,36
060371891021,548,419,129,553,423,130,682,510,162,596,470,102
060371892021,500,381,119,504,385,119,613,458,147,534,399,117
060372973001,321,180,141,325,179,146,419,244,164,582,323,220
060372975011,334,203,131,340,201,139,392,240,147,343,198,124
060372086102,403,340,63,416,341,75,721,542,159,529,431,80
060372086202,224,188,36,232,190,42,422,317,93,288,234,43
060372083011,168,152,16,171,152,19,295,234,52,213,187,18
060372083023,359,324,35,367,324,43,674,529,120,454,401,38
060372035002,222,201,21,233,201,32,1056,738,246,264,225,20
060372032003,255,240,15,260,235,25,412,344,58,357,320,16
060372042001,244,218,26,244,209,35,375,324,43,295,257,18
060372042002,298,268,30,300,257,43,489,418,61,342,299,20
060372038001,198,180,18,198,172,26,275,233,35,254,221,18
060372038002,253,231,22,253,220,33,344,291,46,299,261,19
060372038003,300,272,28,300,258,42,478,402,63,360,314,22
060372038004,271,248,23,272,238,34,377,318,49,313,272,23
060372046001,484,454,30,489,440,49,766,645,99,568,494,33
060372046002,275,260,15,271,253,18,422,365,45,340,299,20
060372060531,217,188,29,223,183,40,358,289,61,227,190,22
060372060532,313,273,40,313,259,54,470,386,71,383,323,37
060372741001,357,269,88,362,272,90,593,461,121,412,292,94
060372741003,446,336,110,453,340,113,603,469,123,500,355,114
060372211101,143,120,23,145,116,29,255,186,63,186,156,19
060372211102,258,215,43,263,210,53,460,372,78,316,266,32
060372766013,449,309,140,456,306,150,556,396,147,386,262,100
060372766014,638,456,182,649,447,202,703,529,159,626,424,161
060371340012,344,278,66,354,266,88,599,448,133,440,354,61
060371345201,222,178,44,224,168,56,423,308,106,320,255,47
060371349061,232,189,43,237,182,55,442,341,93,303,238,46
060372742024,326,267,59,332,273,59,404,318,77,385,300,65
060372742023,385,318,67,391,325,66,451,353,81,418,343,57
060372035001,145,129,16,150,126,24,223,183,38,187,158,17
060372035003,230,206,24,241,206,35,372,295,68,271,231,22
060372060521,863,770,93,872,756,116,1428,1183,223,891,748,90
060372060541,426,367,59,436,358,78,682,538,126,500,417,51
060372041101,251,232,19,254,223,31,352,298,43,314,276,26
060372041102,169,156,13,170,149,21,240,207,31,178,157,14
060372041103,229,212,17,229,201,28,353,297,46,276,242,23
060371393031,332,244,88,337,250,87,538,364,164,436,310,102
060371395061,329,226,103,331,219,112,548,320,215,405,272,117
060371395062,426,292,134,430,284,146,713,417,280,522,351,150
060372041201,267,249,18,269,241,28,391,332,48,377,334,29
060372041202,266,248,18,266,239,27,396,336,54,318,283,24
060371395022,436,271,165,443,277,166,667,425,240,482,298,164
060371396003,396,269,127,400,271,129,538,357,174,446,296,128
060371396002,657,458,199,664,461,203,878,591,273,773,513,218
060371396001,995,690,305,1004,690,314,1412,932,454,1127,782,301
060371397013,532,358,174,539,360,179,676,429,237,565,385,156
060371193102,335,280,55,339,275,64,583,435,133,428,344,61
060371193202,198,166,32,201,163,38,337,249,77,246,206,26
060371193203,278,236,42,283,233,50,476,358,109,365,306,38
060372048201,225,208,17,226,197,29,320,269,45,232,204,16
060372048202,280,259,21,279,242,37,410,348,48,307,269,21
060372049101,198,177,21,196,168,28,433,359,63,322,279,27
060372049102,259,231,28,259,222,37,507,422,76,442,387,37
060371046102,191,175,16,192,166,26,317,265,47,275,238,25
060371046201,228,209,19,229,198,31,364,304,54,313,266,29
060371048212,238,221,17,238,209,29,357,291,57,339,294,25
060372051201,492,463,29,493,446,47,733,612,99,596,548,23
060371232033,190,161,29,192,156,36,293,224,63,232,184,37
060372217101,369,332,37,368,321,47,510,415,76,454,408,22
060372217102,197,177,20,197,171,26,272,225,42,331,299,15
060371411021,405,322,83,411,324,87,622,484,129,465,347,97
060371246003,596,469,127,600,467,133,739,577,148,660,498,129
060372264201,189,172,17,184,164,20,326,273,51,257,232,11
060372264202,233,213,20,232,205,27,344,289,53,298,270,13
060372264203,327,299,28,329,290,39,536,436,82,434,390,21
060371434011,1128,940,188,1136,936,200,1433,1168,245,1205,991,169
060372247021,332,286,46,348,287,61,252,202,38,524,437,59
060371434013,712,597,115,724,595,129,899,721,163,747,598,114
060372270103,191,175,16,195,170,25,336,274,53,265,238,14
060372270102,182,168,14,189,164,25,322,261,52,260,230,15
060372270101,156,145,11,162,140,22,256,215,40,212,188,11
060372734042,329,290,39,337,290,47,410,339,56,397,326,50
060372734041,332,290,42,339,291,48,413,345,58,402,340,37
060372281001,216,202,14,214,193,21,323,273,44,496,455,17
060372281003,202,184,18,200,178,22,279,231,37,58,53,3
060372270201,230,214,16,229,207,22,421,346,55,330,304,14
060372270202,164,151,13,161,147,14,289,247,35,235,214,10
060372227001,365,316,49,376,312,64,170,148,21,826,694,73
060372311002,214,193,21,214,183,31,266,228,31,265,226,26
060371907022,356,313,43,361,313,48,425,354,58,391,321,42
060372218102,161,139,22,164,137,27,226,189,32,200,170,22
060372218201,130,112,18,130,108,22,135,101,31,167,141,18
060372218202,253,218,35,255,213,42,298,220,67,282,238,32
060372407003,327,299,28,334,307,27,538,463,60,387,361,13
060372407004,248,231,17,254,235,19,411,354,47,321,299,11
060372317201,438,386,52,440,379,61,747,616,111,609,546,33
060372411102,185,172,13,186,166,20,279,245,31,236,223,9
060372411202,262,244,18,259,235,24,405,349,43,334,310,13
060372284201,150,140,10,156,139,17,309,269,37,239,217,9
060372284202,147,137,10,149,133,16,296,256,34,222,200,8
060372285002,214,198,16,219,192,27,405,346,53,238,217,11
060372318001,130,117,13,132,116,16,225,196,28,195,176,11
060372318003,192,173,19,192,170,22,328,280,37,335,302,19
060372318004,160,144,16,161,142,19,270,235,30,158,142,9
060372375001,201,186,15,202,182,20,307,260,41,387,353,21
060372375002,211,195,16,214,194,20,340,293,47,230,212,11
060372377101,269,246,23,276,252,24,403,345,47,343,318,14
060372282201,134,128,6,135,124,11,250,215,32,216,202,8
060372282202,144,139,5,142,132,10,269,232,34,226,211,8
060372699062,747,674,73,756,679,77,959,850,91,811,703,61
060372699071,661,598,63,671,603,68,833,739,76,778,678,56
060372699052,530,473,57,539,476,63,652,559,78,560,480,51
060372287101,316,296,20,320,287,33,516,449,51,423,391,18
060372287201,172,161,11,172,156,16,261,238,20,234,218,9
060372287202,203,191,12,206,185,21,333,304,27,288,267,10
060372287102,193,178,15,199,176,23,361,302,50,265,239,15
060372287203,224,206,18,230,204,26,372,316,54,286,257,16
060372291001,322,294,28,324,290,34,574,479,77,481,441,21
060372288003,222,208,14,225,204,21,344,300,38,500,450,24
060372289001,276,256,20,282,248,34,413,367,42,425,383,23
060372291002,208,192,16,214,191,23,389,335,47,331,304,14
060372213031,217,194,23,216,189,27,362,302,55,244,212,18
060372213032,144,129,15,145,127,18,232,191,37,173,152,12
060372293002,186,170,16,186,160,26,313,267,38,263,236,13
060372293003,170,156,14,170,146,24,312,269,39,230,208,10
060372702001,362,329,33,364,331,33,487,420,55,417,366,31
060372702002,377,338,39,383,339,44,521,454,62,434,367,40
060372702003,466,419,47,472,421,51,668,576,81,525,443,49
060372328002,315,291,24,324,288,36,550,468,70,408,378,20
060372134011,292,252,40,292,248,44,458,351,96,336,286,32
060372134012,162,140,22,163,138,25,247,194,48,187,159,17
060372134022,191,165,26,190,161,29,274,203,64,232,199,21
060372327021,507,469,38,511,461,50,810,697,90,622,567,29
060372327022,181,169,12,188,169,19,288,251,33,227,207,11
060372327011,411,381,30,419,369,50,599,516,71,507,471,15
060372371021,257,237,20,260,227,33,399,348,47,350,322,13
060372371022,316,290,26,318,278,40,498,430,58,313,290,12
060372376001,157,144,13,161,140,21,270,228,31,215,196,9
060372392011,170,159,11,177,159,18,304,254,40,302,277,14
060372392012,176,165,11,183,165,18,302,251,40,143,131,7
060372392013,126,117,9,130,117,13,216,183,30,160,147,7
060372393102,173,161,12,175,157,18,323,279,37,222,205,8
060372393101,171,160,11,171,153,18,269,233,36,224,212,6
060372393103,168,156,12,168,150,18,268,225,38,225,208,8
060372312102,371,342,29,378,334,44,656,556,82,462,421,30
060372312202,241,218,23,247,213,34,421,352,56,304,271,22
060372393201,238,223,15,242,223,19,373,320,41,288,268,10
060372393202,256,240,16,261,240,21,402,344,48,303,283,11
060372393301,163,150,13,164,145,19,272,241,29,125,115,6
060372393302,211,195,16,214,189,25,384,340,42,309,289,13
060372395011,192,173,19,196,167,29,317,277,36,292,265,15
060372395012,150,142,8,155,140,15,277,241,28,229,209,8
060372395013,169,159,10,170,154,16,309,269,33,207,192,6
060372395022,161,149,12,159,142,17,261,225,33,270,248,13
060372395023,137,127,10,140,123,17,266,221,36,133,122,7
060372395021,178,160,18,179,153,26,311,270,34,208,188,11
060372398011,183,164,19,186,159,27,314,271,35,224,203,12
060371873001,930,847,83,937,847,90,1127,1018,94,864,767,59
060371873002,868,789,79,873,781,92,1053,958,78,979,884,58
060372397011,303,282,21,310,276,34,527,446,68,449,420,19
060372397012,239,215,24,242,212,30,413,356,55,283,262,14
060372397023,288,270,18,292,264,28,427,375,44,352,325,16
060372398012,173,160,13,176,155,21,295,249,42,218,199,12
060372398013,167,153,14,168,149,19,281,238,42,215,196,10
060371863023,612,536,76,618,529,89,819,694,114,679,570,81
060371864031,337,294,43,340,284,56,497,401,82,384,314,49
060371864032,502,438,64,507,429,78,718,581,118,581,480,72
060372398022,194,181,13,199,179,20,323,279,33,300,265,20
060372398023,208,196,12,209,194,15,346,301,37,302,277,13
060372398024,184,173,11,188,172,16,319,276,37,27,26,1
060372049202,224,203,21,225,200,25,305,257,44,288,253,15
060372060511,386,358,28,389,357,32,479,415,56,448,388,28
060372397021,183,168,15,184,164,20,273,236,28,212,199,6
060372397022,142,130,12,145,129,16,228,201,25,119,113,3
060372383102,335,311,24,344,302,42,580,496,69,456,409,25
060372383202,136,125,11,140,123,17,260,223,30,100,89,6
060372383203,114,106,8,114,102,12,219,186,26,250,224,14
060372195002,426,394,32,432,395,37,541,480,52,487,440,30
060372362031,676,627,49,691,633,58,948,858,71,813,738,44
060372362052,134,126,8,137,127,10,173,156,14,145,133,6
060372362051,499,465,34,503,463,40,757,674,63,605,554,27
060372362062,234,220,14,238,221,17,455,417,30,264,240,12
060372340012,444,415,29,452,420,32,562,513,42,416,385,18
060372342001,474,446,28,493,460,33,629,580,48,561,524,22
060371977002,248,214,34,248,209,39,370,293,67,310,244,42
060372313021,211,196,15,213,197,16,293,256,30,277,252,14
060372313022,229,211,18,233,214,19,341,298,32,277,252,12
060372313023,227,214,13,230,214,16,376,334,36,321,295,17
060372313011,536,491,45,550,496,54,727,625,83,633,577,29
060372315001,505,449,56,512,439,73,717,617,82,603,541,39
060372316011,298,264,34,303,260,43,423,369,50,350,317,22
060372342002,357,330,27,363,334,29,420,384,27,374,333,23
060372342003,539,502,37,549,507,42,621,556,56,551,493,35
060372340021,705,657,48,713,656,57,930,827,81,803,735,43
060372340011,380,355,25,383,353,30,469,432,35,510,465,27
060372340013,402,377,25,412,380,32,499,463,25,588,545,24
060372340022,412,385,27,420,386,34,535,496,39,400,366,18
060372343021,691,646,45,702,649,53,888,827,43,766,708,31
060372343022,338,319,19,340,321,19,457,429,21,384,359,8
060372343012,472,444,28,473,444,29,615,571,38,565,528,21
060372314003,401,375,26,414,381,33,640,559,65,472,436,25
060372315002,481,446,35,488,444,44,680,602,72,690,639,32
060372315003,473,438,35,483,435,48,696,599,79,446,401,24
060372063031,230,180,50,238,191,47,267,195,62,329,267,43
060372343011,384,364,20,390,367,23,548,506,33,449,418,19
060371837013,364,329,35,366,321,45,483,407,62,348,294,26
060372043002,156,148,8,155,144,11,259,224,27,282,246,17
060372314001,441,410,31,441,405,36,658,577,62,512,462,26
060372195001,316,287,29,325,292,33,416,362,45,357,322,22
060372361011,546,496,50,565,507,58,726,640,82,606,554,39
060372361012,352,328,24,356,327,29,680,600,65,472,434,20
060372364003,651,608,43,661,618,43,856,796,42,738,677,35
060372119101,225,204,21,229,202,27,381,305,66,242,213,19
060372119103,275,249,26,279,247,32,449,361,78,282,248,22
060372119221,238,208,30,242,206,36,409,315,85,279,234,30
060372119222,286,251,35,290,248,42,493,388,94,350,292,37
060372362061,257,238,19,259,236,23,393,349,32,303,279,13
060372314002,337,316,21,344,316,28,519,453,54,405,378,13
060372362032,185,172,13,186,172,14,293,260,26,268,250,11
060372362042,280,262,18,289,269,20,411,364,36,381,356,13
060372361022,689,656,33,708,663,45,904,812,69,827,758,29
060372362041,416,394,22,426,394,32,631,563,51,527,491,20
060372351001,519,489,30,530,496,34,721,668,44,603,558,19
060372351002,562,527,35,565,527,38,788,724,47,636,589,27
060371313002,310,234,76,311,230,81,452,333,111,386,285,79
060372347003,432,396,36,438,394,44,622,572,45,576,527,26
060372347004,261,238,23,267,238,29,374,341,30,240,224,10
060372346003,416,386,30,409,373,36,555,496,37,413,373,22
060372346004,690,656,34,697,655,42,939,880,51,780,731,28
060372349022,380,341,39,390,348,42,594,525,57,497,461,21
060372349023,267,243,24,273,247,26,456,409,42,343,322,14
060371204003,429,344,85,440,346,94,653,459,182,528,405,98
060372351003,591,550,41,591,547,44,777,717,44,664,610,35
060372351004,588,557,31,592,556,36,735,691,40,579,538,26
060372345021,286,270,16,292,269,23,426,382,33,300,275,13
060372345022,239,225,14,243,225,18,354,317,27,279,254,12
060372345023,400,378,22,407,378,29,564,508,49,473,428,25
060372324021,313,285,28,314,284,30,462,408,40,433,389,26
060372324022,621,574,47,625,572,53,900,791,80,657,607,30
060372324013,262,247,15,268,246,22,406,363,43,314,292,14
060372345011,420,389,31,425,394,31,575,508,56,624,581,23
060372345012,608,572,36,622,578,44,869,769,87,589,528,39
060372091032,164,145,19,168,142,26,341,273,56,243,210,18
060372091031,106,94,12,107,91,16,203,158,38,157,136,12
060372092021,175,156,19,179,153,26,376,301,61,285,246,22
060372322003,238,223,15,237,221,16,461,394,56,305,282,11
060372324011,195,184,11,196,184,12,360,317,41,258,239,8
060372323002,277,247,30,282,250,32,498,432,63,435,400,17
060372323003,240,220,20,248,224,24,410,355,49,247,229,8
060372326011,436,394,42,444,393,51,683,579,86,556,520,20
060372361021,375,353,22,382,362,20,553,514,30,437,397,15
060372325001,356,323,33,362,320,42,559,472,70,457,426,17
060372372011,236,218,18,244,213,31,384,333,46,331,301,17
060372372012,291,267,24,302,262,40,475,407,56,479,436,25
060372372013,214,197,17,218,194,24,304,262,35,163,150,6
060372372021,266,238,28,272,238,34,406,345,54,455,408,25
060371924202,598,521,77,611,505,106,878,704,155,658,557,68
060372077121,639,553,86,653,550,103,1368,1098,243,595,488,74
060372374021,312,289,23,319,286,33,515,460,40,458,421,18
060372374022,285,266,19,288,261,27,437,391,43,332,309,10
060372374023,278,259,19,278,256,22,491,433,42,317,298,10
060372347002,242,225,17,244,222,22,363,327,31,288,269,9
060372373001,340,308,32,343,308,35,413,368,35,416,381,17
060372373004,439,405,34,444,404,40,562,507,49,465,424,20
060371864042,222,196,26,222,192,30,357,289,58,301,253,31
060371951001,742,678,64,751,681,70,864,757,90,839,735,71
060371951002,362,331,31,371,336,35,400,357,39,391,346,33
060371955004,423,387,36,428,387,41,491,432,51,449,407,27
060372352011,296,273,23,305,279,26,419,382,31,452,414,21
060372373003,445,409,36,447,402,45,566,505,48,439,409,17
060372760001,724,538,186,741,542,199,1249,946,275,904,645,206
060372760002,609,453,156,618,452,166,766,569,178,488,351,114
060372761012,326,282,44,333,285,48,503,436,57,419,350,40
060372761021,906,784,122,917,787,130,1340,1164,139,1033,858,119
060372771001,502,360,142,507,360,147,630,453,165,572,407,129
060372771002,439,326,113,441,328,113,563,407,151,394,291,83
060372760004,649,485,164,659,481,178,777,580,184,666,485,154
060371816002,654,547,107,653,521,132,852,680,155,731,568,122
060371834022,557,458,99,556,439,117,698,567,115,582,450,99
060372360014,446,411,35,446,402,44,565,521,32,526,461,38
060372771003,510,405,105,514,411,103,708,530,158,533,412,90
060372772001,359,289,70,362,292,70,478,401,65,444,348,70
060372772002,303,253,50,309,255,54,397,334,55,341,275,48
060372352023,373,346,27,384,350,34,526,481,42,400,376,14
060372379001,309,282,27,311,287,24,430,393,35,531,500,17
060372379004,309,284,25,315,290,25,474,436,37,271,254,10
060372381003,380,350,30,389,348,41,498,463,32,497,450,31
060372384003,426,395,31,438,405,33,552,509,39,496,454,20
060372378003,254,231,23,257,232,25,326,294,28,271,248,13
060372378004,417,383,34,423,386,37,518,474,43,483,440,22
060371232061,515,431,84,519,419,100,858,657,179,679,551,89
060371242031,204,179,25,209,181,28,338,270,65,259,214,30
060371242032,356,311,45,361,312,49,634,497,118,430,357,47
060371243003,431,377,54,434,377,57,674,546,115,545,436,71
060371242041,391,346,45,394,334,60,619,509,98,436,346,57
060371242042,304,269,35,306,259,47,482,396,77,343,274,44
060372140001,317,182,135,319,179,140,479,334,142,348,186,148
060372140003,373,230,143,374,228,146,568,309,256,410,241,154
060372140004,334,206,128,335,203,132,572,305,261,398,236,149
060372144001,649,598,51,656,600,56,753,636,103,673,591,57
060372144002,569,529,40,572,527,45,637,538,88,550,491,36
060372144003,419,391,28,421,390,31,493,394,89,420,378,22
060371945001,431,360,71,434,361,73,577,455,114,477,388,72
060371945002,569,459,110,575,461,114,688,550,137,635,518,98
060372163021,821,724,97,826,722,104,1071,905,150,870,744,87
060372163022,794,699,95,809,699,110,1068,878,175,850,717,93
060372145012,381,330,51,385,329,56,573,472,92,401,334,51
060372145011,197,172,25,200,172,28,268,224,43,228,189,26
060372145013,321,279,42,324,279,45,481,398,78,316,265,36
060372151011,655,582,73,662,580,82,897,790,95,738,632,72
060372145051,416,353,63,419,350,69,653,550,95,423,349,53
060372145042,419,357,62,423,356,67,642,537,95,458,378,57
060372145041,507,439,68,520,446,74,818,675,125,570,477,66
060372145031,314,270,44,322,271,51,437,363,67,342,282,45
060372145033,353,300,53,357,295,62,512,420,82,371,303,54
060372145032,255,215,40,257,213,44,305,255,48,256,210,38
060371320013,474,355,119,479,355,124,718,506,193,546,385,120
060371171013,237,193,44,239,190,49,423,301,114,315,248,50
060371172012,232,189,43,235,186,49,440,313,119,315,249,50
060371172013,194,158,36,193,154,39,361,255,97,260,205,40
060372146003,517,441,76,516,437,79,622,515,102,482,409,58
060372148001,608,523,85,613,530,83,764,597,158,633,547,62
060372148002,435,373,62,441,369,72,575,460,104,500,411,69
060372146001,414,358,56,416,351,65,556,459,90,451,378,60
060372146002,385,323,62,388,319,69,436,360,74,493,402,68
060372147001,440,374,66,443,369,74,579,473,97,438,366,52
060372147002,404,342,62,407,338,69,495,406,84,423,355,50
060372147003,467,397,70,471,393,78,574,468,98,498,415,61
060371194002,312,255,57,314,247,67,513,396,113,431,361,50
060372168001,490,419,71,485,411,74,605,489,105,555,459,73
060372168004,417,364,53,415,359,56,536,449,82,470,401,53
060372168002,438,392,46,446,393,53,557,478,68,463,401,44
060372168003,331,295,36,335,295,40,413,356,53,394,344,37
060372167001,564,512,52,574,521,53,820,721,80,662,592,51
060372167003,554,512,42,563,517,46,725,637,81,627,562,44
060372169013,421,389,32,426,393,33,536,487,40,493,446,32
060372167002,506,463,43,511,466,45,628,552,75,593,522,48
060371224201,345,293,52,350,289,61,559,433,119,483,404,57
060371224202,293,244,49,300,245,55,486,369,99,365,310,42
060371224203,240,200,40,245,200,45,395,313,77,306,257,36
060372183005,405,372,33,405,368,37,553,478,59,473,421,26
060372703001,403,376,27,408,368,40,570,496,60,480,423,27
060372697001,606,525,81,613,525,88,713,587,104,656,549,65
060372703002,653,570,83,657,559,98,800,691,97,762,676,53
060372182201,411,374,37,412,377,35,538,474,56,488,433,34
060372182202,731,669,62,733,664,69,964,841,105,860,763,56
060372182203,158,144,14,158,145,13,233,203,24,180,166,11
060371349062,266,221,45,272,219,53,444,343,93,342,260,60
060371349072,275,229,46,281,227,54,520,400,109,363,275,63
060371349071,300,250,50,307,248,59,517,399,108,373,283,65
060371236022,301,237,64,307,236,71,385,280,99,185,143,33
060371236023,377,296,81,385,296,89,527,387,125,234,177,43
060371174052,95,83,12,96,79,17,207,161,38,154,131,16
060371174051,132,115,17,133,109,24,296,232,55,201,170,21
060371175101,88,76,12,88,72,16,195,153,37,145,124,14
060371175103,65,57,8,67,55,12,148,115,28,104,87,11
060371203004,424,345,79,418,339,79,713,495,201,550,438,90
060372182101,188,175,13,191,170,21,291,255,32,204,180,13
060372182102,340,316,24,345,306,39,536,466,61,441,391,24
060372182103,232,215,17,237,210,27,367,319,42,319,284,18
060372183001,359,331,28,365,327,38,540,466,61,479,425,26
060372183002,339,314,25,348,319,29,361,323,32,374,330,21
060372183003,333,308,25,339,312,27,417,374,34,375,331,22
060372183004,358,326,32,357,326,31,467,417,42,398,357,25
060372186001,315,289,26,320,293,27,392,341,41,363,323,21
060372186002,265,248,17,266,246,20,337,301,29,291,267,12
060372186003,376,346,30,379,349,30,541,465,57,429,382,25
060372187012,528,496,32,533,492,41,655,586,58,612,567,22
060372360012,699,648,51,714,659,55,822,763,48,764,706,41
060372360013,433,405,28,441,412,29,518,484,31,452,418,22
060372360011,1044,966,78,1065,975,90,1157,1070,72,1135,1034,61
060372184002,376,353,23,376,349,27,529,470,49,417,379,27
060372184003,260,244,16,259,240,19,366,323,35,299,270,20
060372185001,456,421,35,462,419,43,663,583,68,505,450,33
060372949001,282,235,47,285,224,61,514,403,96,377,306,47
060372949002,258,216,42,260,203,57,407,327,77,362,301,45
060372185002,467,423,44,475,425,50,679,604,63,531,465,38
060372199021,506,473,33,504,465,39,771,678,78,586,521,30
060372199022,299,279,20,302,277,25,483,426,52,360,322,18
060372199023,215,202,13,214,198,16,318,281,33,237,214,10
060372199011,295,277,18,297,274,23,469,408,47,381,341,21
060372199012,289,274,15,295,272,23,481,430,49,394,354,22
060372201001,325,295,30,323,292,31,427,370,48,361,325,25
060372396011,210,195,15,213,187,26,366,314,44,288,270,9
060372396012,257,237,20,262,231,31,428,365,56,424,395,14
060372199013,310,298,12,316,294,22,525,465,49,428,391,22
060372015013,186,168,18,187,162,25,329,265,56,236,205,19
060372015031,351,318,33,351,305,46,609,507,84,421,364,36
060372016011,672,593,79,683,568,115,950,770,163,789,664,78
060372184001,337,315,22,343,318,25,513,451,51,406,369,19
060372184004,250,234,16,256,237,19,391,344,40,312,284,15
060372690001,426,351,75,432,356,76,550,454,87,465,387,60
060372690003,349,294,55,358,298,60,462,380,73,392,324,47
060372690005,490,404,86,504,415,89,604,494,95,508,420,68
060372242002,227,205,22,227,195,32,340,280,51,495,412,38
060372243101,167,149,18,169,142,27,272,215,52,190,160,14
060372243102,125,110,15,126,106,20,198,157,39,141,119,11
060372243201,330,301,29,326,284,42,468,384,72,358,311,31
060372243202,184,163,21,182,155,27,303,238,58,244,207,19
060372712001,532,456,76,536,456,80,750,634,98,588,483,69
060372701012,607,539,68,615,540,75,696,614,69,642,561,47
060372699061,524,470,54,533,474,59,690,607,71,582,511,45
060372699081,391,350,41,400,352,48,521,438,73,436,373,36
060372699072,476,426,50,483,429,54,603,533,58,526,445,47
060372722021,436,380,56,444,386,58,570,493,74,475,405,47
060372722022,796,702,94,808,713,95,1064,924,120,870,728,90
060372738003,252,224,28,257,225,32,333,289,40,297,255,28
060372739021,508,439,69,515,441,74,600,513,78,555,471,65
060372739022,393,340,53,397,340,57,502,421,65,391,328,44
060372739023,312,270,42,319,268,51,379,324,49,371,312,41
060372741004,471,400,71,476,401,75,655,540,105,538,433,74
060372741002,476,408,68,482,409,73,595,503,79,529,429,68
060372754001,634,528,106,642,527,115,784,657,112,698,556,104
060372754002,704,595,109,717,595,122,1014,849,146,720,587,90
060372754003,553,467,86,564,469,95,970,811,139,548,453,65
060372753111,467,392,75,462,387,75,590,489,95,507,407,70
060372753112,544,468,76,544,463,81,764,631,122,621,501,79
060371048232,217,189,28,222,182,40,355,291,61,291,251,28
060372752002,425,381,44,431,381,50,641,533,92,532,446,56
060372751011,480,378,102,496,384,112,688,543,135,549,404,119
060372756031,356,284,72,361,281,80,449,365,73,403,312,71
060372756033,374,297,77,376,291,85,473,381,77,403,312,70
060371310221,243,185,58,244,180,64,445,309,126,277,208,53
060371310222,402,307,95,403,298,105,661,457,186,495,370,94
060372781021,361,245,116,366,247,119,446,313,126,268,172,78
060372766012,509,363,146,519,362,157,670,483,176,696,494,151
060372766071,306,228,78,308,224,84,442,341,92,356,256,77
060372766072,561,417,144,559,409,150,738,571,153,487,349,106
060372766051,685,545,140,692,546,146,885,700,163,759,567,141
060372766052,307,246,61,311,250,61,396,317,68,328,251,55
060372920021,242,171,71,246,169,77,384,254,127,306,206,77
060372920022,236,169,67,240,165,75,376,247,125,300,203,74
060372765003,563,415,148,577,425,152,693,516,167,729,520,164
060372765001,298,221,77,308,225,83,236,186,49,321,234,69
060372765002,260,234,26,266,233,33,315,245,64,430,351,49
060372770001,660,448,212,663,443,220,845,601,227,829,554,227
060372770003,721,494,227,732,500,232,897,685,191,773,529,197
060372770005,614,409,205,615,406,209,723,516,194,645,426,179
060372770004,402,279,123,411,285,126,523,396,111,448,309,112
060372770002,604,434,170,610,433,177,745,532,193,607,418,148
060372312201,396,354,42,404,345,59,688,576,99,520,463,37
060372312101,247,231,16,252,226,26,411,354,49,306,281,15
060372316031,166,154,12,173,154,19,293,254,35,251,230,13
060372316022,280,260,20,291,257,34,452,388,53,385,351,20
060372316032,249,228,21,255,227,28,385,325,46,269,243,13
060372316021,232,212,20,236,212,24,366,317,45,279,255,14
060372322001,245,220,25,246,215,31,333,288,41,327,301,14
060372322002,235,212,23,240,209,31,326,283,39,318,293,14
060372323001,413,378,35,418,379,39,666,573,84,518,472,21
060372326022,374,346,28,376,338,38,678,577,83,525,479,28
060372326021,392,362,30,394,352,42,663,571,79,562,510,30
060372371011,206,191,15,213,188,25,301,256,35,272,248,14
060372374012,292,270,22,297,266,31,449,398,46,400,371,15
060372374013,321,298,23,321,292,29,491,426,54,412,385,16
060372374011,259,245,14,265,243,22,388,338,47,319,299,10
060372378001,304,270,34,309,269,40,481,412,53,566,522,26
060372378002,354,317,37,359,312,47,492,441,51,292,269,16
060372377201,199,183,16,205,185,20,314,272,34,310,284,14
060372382001,528,483,45,538,486,52,703,631,66,636,593,30
060372382002,469,427,42,468,424,44,553,506,41,571,536,25
060372383201,220,195,25,227,193,34,362,316,33,301,268,18
060372403021,296,270,26,299,272,27,493,421,56,410,377,15
060372403011,149,136,13,150,137,13,246,211,29,207,191,8
060372404023,224,212,12,226,212,14,390,348,35,350,322,18
060372412011,296,276,20,297,275,22,514,452,43,413,378,20
060372382003,383,361,22,393,366,27,545,504,30,562,530,17
060372384001,425,393,32,433,392,41,546,502,38,556,513,26
060372384002,597,549,48,608,557,51,815,752,54,595,557,24
060372380002,379,351,28,380,353,27,536,501,33,486,455,18
060372380003,398,369,29,400,374,26,566,523,33,498,465,20
060372380001,276,259,17,277,263,14,431,398,27,347,322,13
060372380006,526,500,26,538,511,27,652,605,38,608,570,20
060372412012,245,226,19,247,223,24,349,318,31,314,290,17
060372412013,167,154,13,171,154,17,233,208,21,202,186,10
060372422021,254,228,26,266,235,31,396,344,39,383,362,14
060372405001,273,257,16,275,250,25,454,390,47,461,413,20
060372405002,237,223,14,241,224,17,377,334,39,177,165,6
060372405004,228,215,13,233,212,21,422,375,39,292,266,13
060372400201,361,326,35,366,316,50,555,491,55,469,426,21
060372400101,174,161,13,173,158,15,378,323,44,210,195,10
060372400203,227,212,15,231,208,23,428,373,51,320,293,17
060372400202,283,259,24,287,255,32,436,381,47,357,330,12
060372406001,192,178,14,195,180,15,306,258,41,304,281,11
060372406002,165,154,11,167,154,13,268,237,29,210,197,8
060372406003,220,206,14,224,206,18,371,320,41,284,263,11
060372406004,244,227,17,247,229,18,397,340,43,312,287,13
060372420003,123,111,12,122,106,16,226,192,28,183,164,12
060372423003,157,140,17,156,137,19,292,246,34,227,204,13
060372422011,244,228,16,249,226,23,458,393,53,372,345,14
060372420001,261,243,18,267,249,18,409,342,50,307,281,9
060372420002,278,253,25,282,251,31,491,419,56,364,333,16
060372430011,228,213,15,228,207,21,409,360,41,323,297,14
060372405003,227,215,12,231,217,14,379,338,37,287,267,11
060372408002,225,212,13,227,211,16,393,339,45,327,300,14
060372408003,214,201,13,211,196,15,389,344,41,293,269,13
060372409021,294,271,23,299,273,26,436,374,52,395,364,18
060372409022,242,223,19,246,223,23,384,328,46,334,310,11
060372412023,160,148,12,164,150,14,275,242,28,218,202,8
060372409012,227,209,18,227,207,20,359,305,44,326,297,16
060372409011,193,178,15,192,176,16,301,258,38,299,272,14
060372410013,353,322,31,357,319,38,513,451,52,446,412,16
060372410011,217,199,18,220,196,24,333,289,30,266,246,12
060372410021,255,231,24,258,236,22,494,421,55,329,298,17
060372410022,274,249,25,277,244,33,390,327,51,391,354,19
060372410023,258,235,23,264,235,29,413,355,49,353,324,16
060372912201,154,125,29,157,124,33,269,200,63,180,142,29
060372912202,345,283,62,357,282,75,566,421,130,443,344,71
060372912203,119,99,20,122,99,23,196,144,44,147,123,15
060372127022,375,310,65,383,317,66,630,493,128,429,347,57
060372943011,387,300,87,392,296,96,577,421,143,489,377,84
060372943012,287,219,68,290,217,73,431,309,110,367,283,65
060372945201,279,232,47,277,221,56,496,374,109,418,335,58
060372945202,276,230,46,278,222,56,486,370,109,411,334,57
060372943022,512,424,88,519,419,100,835,638,172,661,532,92
060372943021,312,260,52,316,251,65,526,411,96,407,323,54
060372941101,442,359,83,435,329,106,664,495,153,548,423,93
060372942001,275,223,52,277,219,58,430,326,97,355,286,56
060372942002,455,373,82,458,363,95,707,532,148,590,459,95
060372942003,351,286,65,354,280,74,580,439,129,458,362,72
060372946201,360,315,45,367,311,56,544,424,105,475,401,52
060372946202,250,218,32,257,217,40,378,294,77,335,284,38
060372946203,265,232,33,269,229,40,377,288,79,338,286,35
060371975002,410,383,27,413,377,36,543,486,45,486,433,27
060372966001,291,228,63,299,230,69,461,347,106,455,342,87
060372966002,292,218,74,296,218,78,465,328,128,305,220,65
060372966003,231,173,58,236,175,61,392,273,108,207,148,46
060372969011,394,315,79,401,311,90,645,465,163,567,414,114
060372969021,265,200,65,266,198,68,450,324,116,377,274,83
060372972011,563,399,164,576,387,189,860,586,247,850,579,215
060372972021,474,325,149,483,327,156,733,469,244,601,397,170
060372972022,453,305,148,464,306,158,693,445,235,478,303,141
060372398021,183,175,8,188,173,15,302,268,34,345,322,11
060372969013,330,221,109,336,220,116,527,325,185,374,247,108
060372969023,410,276,134,420,273,147,664,421,221,524,340,152
060372970022,498,321,177,510,314,196,752,476,262,626,383,200
060372970023,433,260,173,447,260,187,509,323,184,487,277,178
060371114011,818,530,288,823,512,311,1209,779,408,917,582,277
060372974002,1186,626,560,1198,615,583,1532,841,656,1297,668,546
060372976011,396,259,137,407,256,151,508,328,171,421,256,138
060371286022,421,349,72,425,344,81,566,424,127,439,341,75
060372383101,182,167,15,184,167,17,447,393,42,275,255,6
060372017001,406,355,51,406,343,63,549,458,78,557,456,57
060372017002,502,439,63,511,432,79,739,612,107,611,500,67
060372017003,343,294,49,346,294,52,540,455,77,452,372,51
060371923001,560,469,91,565,471,94,660,534,116,610,499,86
060371923002,393,286,107,399,289,110,461,320,134,410,289,101
060372032002,398,365,33,394,352,42,593,500,81,473,416,31
060372032001,226,209,17,228,202,26,333,282,45,272,239,18
060371096012,332,225,107,336,220,116,559,382,165,423,295,108
060372964021,530,378,152,539,370,169,673,468,195,642,430,176
060372676002,266,215,51,272,218,54,371,300,66,305,236,53
060371952012,631,578,53,635,578,57,721,648,64,669,583,50
060371175102,238,197,41,237,183,54,371,285,73,292,244,37
060371175201,307,254,53,308,237,71,515,392,109,384,318,49
060371959021,486,453,33,488,451,37,552,505,39,518,462,26
060371959022,539,504,35,543,503,40,644,588,45,601,536,31
060371211021,220,122,98,227,124,103,359,194,155,269,153,101
060371211022,264,128,136,273,129,144,368,173,183,306,144,143
060371219001,435,377,58,439,365,74,688,528,141,597,492,69
060371230102,304,265,39,309,258,51,505,386,106,403,341,41
060372260011,298,269,29,299,259,40,499,435,57,422,368,26
060371066482,136,112,24,135,109,26,360,273,77,214,173,34
060371070201,203,167,36,203,163,40,353,264,76,228,182,31
060372739025,435,368,67,441,377,64,578,463,108,487,410,45
060371249021,486,415,71,487,408,79,743,489,241,581,459,85
060371249022,515,433,82,518,427,91,741,545,179,577,448,99
060371043103,325,293,32,331,275,56,527,433,74,452,392,38
060372718013,215,186,29,217,186,31,301,248,44,232,191,27
060371192023,603,528,75,609,515,94,985,766,193,851,727,85
060371094003,313,230,83,315,218,97,516,371,129,372,272,80
060371041052,404,361,43,406,347,59,712,566,128,558,470,55
060371041053,307,268,39,313,257,56,506,386,103,412,340,48
060371047011,185,167,18,182,160,22,344,280,58,268,227,24
060372911302,377,331,46,386,330,56,663,529,127,567,501,41
060372722011,565,485,80,565,478,87,735,610,108,603,480,82
060372722012,417,358,59,417,353,64,515,445,59,438,346,59
060372739024,419,362,57,425,357,68,558,474,74,458,386,49
060372316012,273,246,27,279,243,36,407,351,46,381,350,18
060372289002,152,141,11,154,139,15,239,212,27,182,170,9
060372123051,312,268,44,319,259,60,542,411,113,362,295,38
060372123061,166,143,23,169,138,31,321,242,70,187,154,20
060372123062,202,174,28,205,167,38,353,265,76,226,184,24
060372717022,343,300,43,357,308,49,486,391,86,388,315,45
060372672012,309,262,47,313,263,50,408,309,91,363,290,49
060372711003,401,328,73,407,324,83,511,412,91,452,350,76
060372766062,897,708,189,901,701,200,1185,929,230,978,730,193
060372653012,4,4,0,4,4,0,2,2,0,3,3,0
060372652041,324,270,54,329,268,61,407,322,78,425,352,51
060372653031,310,280,30,322,289,33,341,295,42,543,461,43
060371861001,436,361,75,440,352,88,604,475,117,466,357,84
060371861002,413,344,69,418,335,83,573,450,111,434,332,75
060371861004,362,292,70,364,284,80,493,390,95,392,295,77
060372140002,449,289,160,449,284,165,630,371,251,493,306,170
060372118022,303,256,47,306,256,50,533,400,122,311,258,36
060372118023,230,194,36,230,193,37,380,282,89,262,217,31
060372074001,280,235,45,283,233,50,419,289,123,268,210,42
060372075012,269,224,45,271,221,50,363,250,106,310,240,49
060372075011,417,348,69,422,344,78,511,353,150,469,363,74
060372736001,303,275,28,308,279,29,350,318,32,343,309,21
060371371041,789,547,242,799,546,253,1043,676,355,931,638,250
060371371042,362,244,118,368,244,124,533,344,181,427,277,129
060371413031,686,551,135,695,549,146,1009,765,225,746,572,129
060372733001,659,597,62,669,603,66,1010,863,122,798,701,44
060372733002,263,242,21,268,240,28,366,328,34,316,287,13
060372324012,331,298,33,335,293,42,523,452,62,460,419,20
060372753131,966,747,219,965,742,223,1198,943,226,1087,830,214
060372049201,310,283,27,310,271,39,505,422,75,424,371,28
060372971101,422,357,65,432,344,88,704,523,158,630,478,99
060372971102,390,306,84,399,294,105,728,538,158,475,352,92
060372962102,249,202,47,253,198,55,460,334,109,318,255,48
060372965001,301,249,52,311,249,62,452,332,110,394,314,58
060372966004,364,287,77,373,289,84,573,432,125,493,373,92
060372653061,465,415,50,476,423,53,497,448,36,769,656,59
060371132341,372,238,134,383,233,150,511,361,138,445,272,148
060371132342,312,201,111,317,194,123,439,294,134,386,235,129
060371060102,591,416,175,603,409,194,895,590,288,713,499,181
060371066452,886,472,414,904,457,447,1241,663,558,1028,525,443
060371173021,400,256,144,400,246,154,620,386,221,487,304,153
060371173022,387,249,138,388,239,149,632,394,227,458,285,146
060371395042,350,253,97,358,251,107,607,395,201,438,294,118
060372941201,177,157,20,179,156,23,367,275,77,268,230,21
060372125021,274,233,41,273,229,44,582,429,142,277,234,30
060371913021,354,315,39,352,306,46,475,400,71,414,330,58
060372404022,299,274,25,303,275,28,497,436,51,411,384,15
060372260022,117,97,20,116,97,19,184,145,32,209,170,20
060372060512,479,445,34,480,443,37,596,515,68,495,430,32
060372944211,217,159,58,217,156,61,560,359,188,154,119,28
060372063021,178,141,37,182,138,44,212,162,47,259,201,40
060372073032,213,181,32,216,178,38,366,307,52,254,214,23
060372073031,360,307,53,365,303,62,681,545,122,425,359,39
060372240101,306,271,35,313,270,43,510,428,70,259,211,28
060372122021,277,253,24,289,253,36,476,375,93,347,291,34
060372122022,128,117,11,135,117,18,216,170,43,155,131,15
060372134013,137,126,11,144,126,18,244,192,48,169,141,17
060372162012,543,475,68,550,475,75,817,679,123,543,459,63
060372119211,320,269,51,324,266,58,578,444,121,438,354,55
060371230101,429,375,54,444,373,71,774,616,135,543,462,52
060371132122,604,369,235,614,359,255,947,549,371,701,386,266
060371193201,199,172,27,200,167,33,387,267,110,256,215,27
060371112052,242,164,78,249,168,81,329,215,105,284,191,83
060371112053,395,268,127,402,270,132,534,350,171,447,299,130
060371344231,801,466,335,814,444,370,1054,663,376,928,527,358
060372678001,367,300,67,371,299,72,461,372,82,285,230,38
060371064071,256,212,44,257,204,53,481,365,103,356,290,44
060371064072,139,114,25,139,110,29,270,205,59,210,173,25
060371064081,427,357,70,431,346,85,755,575,159,521,430,61
060371064082,70,58,12,71,56,15,138,104,30,94,78,11
060371899072,542,487,55,547,486,61,682,545,127,618,518,70
060372933042,349,264,85,349,260,89,534,386,136,439,329,86
060372933071,292,221,71,295,219,76,558,358,185,444,336,82
060372933072,161,123,38,163,122,41,288,194,87,203,154,38
060372962101,220,175,45,223,172,51,439,320,106,283,225,44
060371891011,524,483,41,529,482,47,654,576,65,564,477,51
060371891013,401,370,31,406,370,36,490,436,45,436,372,31
060371371032,351,271,80,352,270,82,538,384,147,422,308,90
060371371033,404,313,91,409,313,96,597,423,163,459,335,98
060372111243,267,222,45,271,219,52,455,351,92,328,272,40
060372087101,448,378,70,450,372,78,763,607,140,480,389,68
060372087102,325,274,51,326,270,56,538,428,98,352,284,50
060372088011,306,263,43,308,253,55,506,396,97,277,229,31
060372088012,185,159,26,185,152,33,327,255,63,215,178,24
060372089031,171,147,24,172,141,31,285,206,70,208,171,24
060372089032,124,107,17,124,102,22,207,161,40,141,118,15
060372932062,266,220,46,271,221,50,508,387,109,324,266,41
060372932052,198,164,34,203,166,37,342,263,73,242,198,31
060372932051,227,188,39,232,190,42,507,387,107,283,231,35
060371273001,500,398,102,508,400,108,765,547,200,678,506,138
060371892011,697,640,57,705,645,60,941,772,149,782,653,88
060371892012,680,626,54,686,625,61,861,720,124,794,681,79
060371891012,384,356,28,390,356,34,520,456,59,447,379,49
060371251013,520,444,76,528,444,84,667,517,134,582,455,87
060371251012,441,377,64,449,378,71,629,483,134,486,379,73
060371252002,561,473,88,570,470,100,641,522,110,596,480,89
060371251021,678,562,116,681,564,117,893,722,155,741,581,117
060371251022,382,315,67,383,317,66,474,390,81,422,333,68
060371240002,570,462,108,576,456,120,737,597,128,611,471,111
060371254021,722,627,95,734,628,106,1002,824,154,871,689,124
060371254022,378,328,50,383,328,55,497,383,108,440,339,74
060371254023,771,672,99,783,672,111,996,853,120,845,687,99
060371254031,413,366,47,417,363,54,541,451,73,457,367,56
060371254032,483,429,54,488,425,63,733,616,95,521,424,57
060371432003,605,497,108,614,499,115,748,604,132,719,571,107
060371285003,270,222,48,274,221,53,342,262,72,296,226,53
060371286011,480,394,86,479,388,91,647,498,137,511,395,89
060371284001,422,339,83,430,330,100,537,417,109,432,330,80
060371284002,410,330,80,418,322,96,539,424,106,435,332,79
060371282101,443,388,55,443,378,65,675,546,116,580,487,65
060371282102,267,235,32,270,230,40,449,361,77,350,295,39
060371283022,244,217,27,252,216,36,467,363,95,323,266,41
060371283031,118,105,13,121,103,18,224,169,49,178,149,23
060371283032,250,224,26,256,221,35,490,379,100,345,283,44
060371434021,669,557,112,676,556,120,853,688,152,711,576,103
060371411011,732,598,134,748,601,147,941,750,173,769,593,146
060372348004,339,309,30,343,316,27,417,376,38,240,219,14
060372349011,258,238,20,263,237,26,417,370,40,319,293,15
060372349021,219,197,22,216,194,22,390,341,37,270,246,12
060372913001,312,199,113,319,201,118,480,301,163,394,246,125
060372913003,279,178,101,282,178,104,422,266,144,367,237,113
060372723021,752,640,112,761,641,120,1014,831,155,818,654,110
060372723022,657,560,97,666,562,104,922,743,154,760,609,102
060372723013,402,344,58,406,346,60,552,445,92,451,367,58
060372128001,454,381,73,465,381,84,729,589,126,555,457,61
060372151023,566,516,50,579,519,60,652,548,95,632,540,62
060372151022,347,317,30,355,318,37,411,343,62,394,335,40
060372151012,401,362,39,406,360,46,538,473,57,464,396,43
060372151021,558,518,40,564,515,49,736,621,105,689,596,54
060372169011,537,502,35,540,502,38,611,562,48,608,559,34
060372169022,781,736,45,788,739,49,888,793,78,803,722,48
060372169021,402,368,34,401,367,34,468,423,39,438,399,23
060372171022,352,323,29,356,325,31,434,393,35,379,341,23
060372171023,437,402,35,445,406,39,565,511,43,458,408,31
060372171012,406,373,33,409,373,36,611,552,45,463,426,20
060372171011,403,376,27,408,376,32,533,485,40,466,427,24
060372169012,467,439,28,474,440,34,564,514,45,502,454,30
060372171021,557,513,44,569,516,53,759,690,55,587,514,45
060372172001,348,313,35,352,316,36,492,430,53,413,356,35
060372172002,254,234,20,261,236,25,374,340,31,289,258,20
060372172003,425,393,32,432,395,37,608,548,48,463,413,28
060372141001,426,328,98,428,326,102,554,278,271,508,386,105
060372132021,239,211,28,242,195,47,421,311,100,285,240,26
060372132022,324,283,41,325,264,61,569,420,132,367,313,36
060372214021,424,380,44,428,367,61,606,489,102,480,417,38
060372214022,305,274,31,310,265,45,422,343,73,350,305,28
060372699091,232,207,25,234,206,28,332,279,45,253,215,20
060372699082,351,313,38,354,312,42,476,397,71,356,304,28
060372377202,186,170,16,191,165,26,330,277,42,243,220,12
060371397012,725,485,240,732,486,246,955,624,317,800,559,207
060371397015,301,202,99,304,202,102,397,261,130,331,218,94
060371244002,467,327,140,478,328,150,722,421,288,543,343,164
060371973002,401,374,27,402,372,30,487,433,45,437,381,32
060371973003,645,600,45,646,593,53,834,743,75,693,604,49
060371412013,334,277,57,340,276,64,467,371,88,422,326,71
060371211011,261,210,51,267,210,57,445,326,110,357,271,69
060371211023,250,200,50,256,201,55,447,324,110,357,271,71
060371021071,827,439,388,838,404,434,1226,588,618,1009,473,472
060371222001,410,337,73,418,328,90,673,505,155,553,439,84
060371021051,263,199,64,267,195,72,394,282,108,329,237,71
060371021052,227,172,55,232,168,64,364,257,99,275,195,60
060371043212,146,135,11,145,129,16,256,211,40,191,170,12
060371047012,253,235,18,256,224,32,459,372,71,306,269,19
060371047013,100,92,8,101,88,13,174,140,27,115,104,7
060371021041,790,502,288,798,495,303,1229,636,572,1033,641,332
060371041051,364,315,49,370,300,70,535,404,116,400,327,50
060372093001,304,260,44,305,247,58,455,339,99,369,315,30
060372093002,143,123,20,144,117,27,250,187,54,156,133,14
060372100101,149,127,22,148,120,28,215,163,47,137,117,13
060372674051,483,413,70,491,413,78,572,461,98,541,445,60
060372674033,392,337,55,396,335,61,507,419,77,437,360,53
060372674032,422,363,59,427,361,66,547,450,82,499,413,60
060372675031,689,580,109,696,582,114,917,755,144,774,634,98
060372643061,935,749,186,946,751,195,1313,1027,264,1037,810,176
060372643051,539,408,131,547,414,133,731,555,159,577,462,83
060372672011,385,326,59,392,328,64,491,372,110,430,343,61
060372627061,945,692,253,964,705,259,1134,865,249,1019,761,208
060372627063,379,282,97,386,287,99,450,343,103,399,306,74
060372627062,655,417,238,674,426,248,781,580,195,687,447,193
060372626043,699,468,231,703,456,247,852,631,206,720,502,183
060372626012,1441,933,508,1465,944,521,1872,1273,563,1566,1050,429
060372626042,735,519,216,742,526,216,941,688,232,795,575,180
060372626041,373,269,104,375,269,106,449,336,109,407,299,87
060372626045,1069,745,324,1081,758,323,1244,906,318,1141,817,274
060372626044,427,305,122,427,302,125,512,395,108,448,326,103
060372626011,533,335,198,540,339,201,742,506,223,597,396,170
060372628022,414,332,82,416,333,83,530,401,118,435,350,66
060372628023,824,597,227,836,606,230,1011,766,229,855,636,179
060372738001,763,663,100,776,672,104,974,827,125,859,734,82
060372738002,428,380,48,435,382,53,510,440,60,455,391,42
060371065103,380,272,108,382,269,113,649,443,195,448,329,98
060371064031,312,259,53,310,242,68,514,383,119,409,324,62
060371064032,254,211,43,258,202,56,429,325,100,344,272,49
060371064033,303,255,48,307,248,59,487,375,101,401,325,53
060371095003,303,254,49,306,243,63,492,364,116,414,310,74
060371066031,668,420,248,678,418,260,892,543,329,749,450,258
060371066032,633,383,250,644,379,265,882,507,360,732,461,240
060371066432,394,206,188,397,202,195,539,293,239,426,234,165
060371066433,351,200,151,357,194,163,507,282,221,409,233,156
060371066411,970,595,375,980,576,404,1346,756,563,1115,663,399
060371066423,407,247,160,410,237,173,596,329,261,444,262,160
060371081031,775,452,323,789,453,336,1100,632,449,854,498,316
060371081032,677,382,295,688,379,309,880,485,375,743,433,272
060371081041,816,466,350,826,465,361,1075,637,414,884,504,340
060371081011,923,532,391,937,524,413,1344,714,594,1034,585,391
060371081022,353,185,168,365,188,177,496,276,215,314,167,130
060371081023,730,383,347,749,388,361,1018,561,435,670,358,273
060371112013,353,213,140,354,203,151,480,291,187,393,222,143
060371113031,562,387,175,564,373,191,860,527,311,668,444,196
060371113032,930,593,337,942,570,372,1342,825,487,1096,669,351
060371151013,621,372,249,633,370,263,840,545,283,704,407,257
060371173024,555,360,195,560,350,210,792,521,248,671,430,202
060371151012,1059,650,409,1079,647,432,1349,854,467,1149,688,402
060371173023,578,342,236,587,337,250,712,452,245,615,361,228
060371132372,434,283,151,442,275,167,668,414,243,430,237,168
060371113021,557,351,206,574,355,219,769,482,274,639,397,217
060371134241,688,496,192,697,487,210,1138,790,329,808,591,171
060371134242,378,255,123,381,247,134,555,379,165,429,304,102
060371134231,352,243,109,358,240,118,506,324,172,426,276,122
060371134232,438,304,134,445,300,145,688,443,228,492,318,140
060371862031,891,764,127,892,759,133,1105,933,155,1016,831,130
060371862021,316,261,55,317,254,63,434,361,69,364,286,60
060371815001,555,444,111,568,439,129,671,524,137,620,459,117
060372766061,726,537,189,742,546,196,949,756,169,865,661,158
060372951032,669,408,261,682,406,276,912,580,308,794,494,266
060372964012,435,255,180,442,245,197,577,342,229,481,260,196
060372933011,1057,605,452,1082,600,482,1510,894,589,1235,718,462
060372933041,600,455,145,607,453,154,850,611,218,742,544,158
060372933061,362,217,145,361,205,156,469,305,159,445,256,161
060372933062,432,261,171,436,247,189,588,378,196,532,307,192
060372969022,307,212,95,315,206,109,488,324,147,384,243,113
060372970021,482,303,179,492,296,196,712,449,242,545,339,166
060372969012,252,209,43,259,206,53,425,289,121,257,188,48
060372971201,289,226,63,296,219,77,509,382,112,390,287,75
060372974001,366,189,177,380,197,183,524,300,208,402,211,168
060371153023,383,285,98,385,278,107,561,412,138,520,375,114
060371153022,202,154,48,205,150,55,315,228,76,255,196,45
060371153021,187,142,45,189,139,50,300,219,73,228,177,39
060371132391,160,108,52,163,107,56,268,173,89,200,131,58
060371132392,303,205,98,305,200,105,510,329,169,367,241,106
060371132312,586,353,233,598,340,258,858,531,313,674,375,254
060379800231,3,2,1,4,2,2,8,5,3,5,3,2
060371317011,712,551,161,717,526,191,1135,789,322,818,631,157
060371317012,510,390,120,520,382,138,820,570,233,650,485,132
060371316004,346,255,91,350,247,103,494,327,160,431,311,96
060371341011,498,326,172,508,328,180,804,520,263,619,413,179
060371341012,819,553,266,831,547,284,1296,835,427,1017,674,294
060371341032,587,384,203,606,379,227,974,638,318,731,459,234
060371343031,294,205,89,301,205,96,476,316,146,332,228,80
060371343032,357,249,108,359,247,112,569,377,176,445,303,109
060371345222,196,159,37,199,153,46,369,260,100,255,196,40
060371345221,242,197,45,247,191,56,398,286,104,320,248,48
060371345223,233,189,44,235,181,54,355,260,94,307,239,47
060371330001,427,333,94,433,331,102,656,463,181,554,416,114
060371330002,465,363,102,473,361,112,713,504,191,625,466,128
060371330003,368,287,81,373,283,90,600,435,158,447,339,83
060371348021,460,358,102,466,351,115,747,533,197,600,442,112
060371348022,505,393,112,510,385,125,810,562,229,635,466,117
060371348011,538,404,134,547,397,150,854,605,228,706,514,150
060371348012,391,289,102,398,286,112,588,408,171,481,344,107
060371344232,786,467,319,800,473,327,1159,697,437,922,522,351
060371344221,592,371,221,598,358,240,943,614,309,726,439,246
060371344222,1378,863,515,1417,869,548,1942,1275,641,1572,974,523
060371344212,532,325,207,548,329,219,689,454,228,599,370,202
060371344211,626,397,229,641,399,242,812,514,281,676,426,218
060371345203,330,265,65,333,253,80,558,402,140,414,312,75
060371345202,227,182,45,227,173,54,372,265,93,298,222,54
060371351111,324,230,94,326,226,100,476,319,147,408,279,100
060371351112,444,315,129,446,307,139,639,424,194,534,346,159
060371351113,298,210,88,304,208,96,463,308,141,341,228,98
060371352021,509,320,189,518,317,201,707,454,238,568,354,183
060371352022,573,357,216,584,355,229,792,503,272,682,427,219
060371352023,749,475,274,758,465,293,1052,669,369,850,533,273
060371352011,649,456,193,662,448,214,963,638,304,842,548,244
060371351151,401,280,121,411,277,134,692,470,204,506,344,142
060371352041,939,576,363,960,566,394,1409,901,483,1146,704,388
060371352042,380,247,133,384,244,140,548,367,179,446,276,148
060371352043,600,382,218,613,369,244,885,575,295,723,457,232
060371373011,1088,683,405,1106,672,434,1458,903,528,1238,768,411
060371373021,827,572,255,829,566,263,1098,728,354,924,614,273
060371352012,330,198,132,335,197,138,464,281,173,386,228,137
060371372023,330,236,94,337,234,103,453,307,136,367,241,103
060371372021,220,159,61,223,159,64,336,227,100,254,175,66
060371372032,624,424,200,634,416,218,822,531,276,668,424,203
060371372022,409,297,112,416,298,118,617,418,184,493,338,126
060371374012,666,479,187,671,473,198,912,624,269,770,531,203
060371397014,542,374,168,551,375,176,699,476,214,584,406,156
060371397052,549,380,169,565,387,178,706,478,217,596,434,138
060372062011,204,171,33,207,172,35,277,226,42,252,216,28
060372062012,421,367,54,426,358,68,651,539,101,383,321,42
060372062021,641,552,89,652,544,108,833,676,138,652,549,72
060371435001,608,507,101,615,508,107,745,613,124,661,523,102
060371435002,648,539,109,657,540,117,834,698,119,683,542,106
060372348002,267,246,21,273,244,29,450,392,47,349,318,16
060372349012,347,323,24,348,324,24,600,537,52,421,392,17
060372128002,360,324,36,364,321,43,481,395,77,424,354,44
060372128003,395,351,44,399,352,47,554,460,86,462,390,46
060372162021,719,668,51,727,664,63,888,793,82,763,693,37
060372162022,626,565,61,625,561,64,858,747,94,675,590,53
060372172004,417,391,26,423,393,30,524,474,44,473,424,26
060371034023,264,160,104,273,158,115,380,220,150,341,191,131
060371034024,385,233,152,393,226,167,515,284,220,430,243,160
060371034011,824,489,335,837,476,361,1200,652,508,973,541,374
060371021072,427,205,222,439,197,242,623,298,319,491,213,253
060379800201,4,2,2,4,1,3,7,3,4,6,3,3
060371211012,276,222,54,282,214,68,496,367,117,375,274,76
060372201003,363,330,33,360,327,33,484,419,54,419,372,33
060371923003,526,458,68,530,458,72,630,528,90,543,461,61
060372674031,308,255,53,320,259,61,406,328,68,396,310,59
060372674042,557,465,92,576,468,108,782,624,144,628,495,91
060372677002,760,651,109,770,652,118,1034,882,138,803,664,93
060372242001,191,175,16,191,166,25,265,219,40,226,197,20
060371061121,620,462,158,632,447,185,930,661,254,794,585,163
060371064053,249,203,46,253,199,54,413,310,93,344,277,51
060371112061,386,231,155,398,234,164,551,339,207,457,267,164
060371112062,429,255,174,435,257,178,607,363,230,514,298,183
060371112022,611,391,220,622,395,227,909,541,355,774,473,250
060371113041,356,281,75,356,272,84,545,402,132,452,320,99
060371113042,306,242,64,305,234,71,511,377,124,373,265,81
060371152032,201,149,52,204,145,59,310,219,81,251,174,57
060371152031,588,436,152,600,425,175,852,604,221,684,479,155
060371112063,407,247,160,414,252,162,551,343,200,466,278,165
060371112064,378,227,151,385,229,156,524,313,202,461,270,171
060371112065,431,258,173,441,256,185,593,355,228,478,276,182
060371153012,285,189,96,284,184,100,489,329,147,365,234,112
060371153014,293,194,99,289,187,102,451,302,138,336,215,104
060371152021,581,423,158,592,409,183,766,516,228,719,486,181
060371152022,669,496,173,681,485,196,947,643,279,757,540,175
060371152023,450,351,99,457,345,112,686,478,195,521,385,105
060371154011,329,228,101,334,221,113,546,359,178,394,259,114
060371154014,396,275,121,398,264,134,606,378,220,461,304,135
060371134251,209,174,35,210,168,42,405,294,99,286,224,44
060371134252,380,316,64,380,304,76,704,512,172,512,401,79
060371316002,399,306,93,403,292,111,577,383,192,495,366,100
060371316003,314,240,74,321,233,88,443,300,138,402,297,82
060371316001,513,368,145,521,351,170,875,581,266,639,420,182
060371349043,472,345,127,477,342,135,654,471,174,563,397,134
060371344213,741,473,268,759,469,290,1010,635,357,816,514,264
060371352052,433,257,176,442,260,182,614,391,206,479,275,185
060371372031,306,221,85,311,218,93,464,307,152,345,226,99
060371398012,1041,687,354,1063,691,372,1403,800,588,1150,751,353
060371398011,601,356,245,607,359,248,860,500,341,727,467,235
060371041032,594,510,84,589,476,113,823,642,156,751,629,83
060372948202,140,122,18,142,115,27,234,172,53,189,159,19
060670070261,717,507,210,727,494,233,1546,1093,431,283,195,81
060670070163,828,584,244,845,582,263,1254,883,338,893,624,212
060670070171,480,298,182,491,295,196,636,389,225,470,285,155
060670070263,451,322,129,453,310,143,1037,751,260,286,186,86
060670070202,500,340,160,504,341,163,630,441,172,488,327,129
060670070203,783,523,260,797,529,268,1050,745,285,816,542,219
060670071011,109,41,68,110,38,72,136,51,80,104,39,56
060670071072,256,173,83,257,167,90,372,266,96,256,167,70
060670071064,520,366,154,524,363,161,759,494,245,572,374,169
060670071081,955,706,249,980,702,278,1518,1064,423,1075,774,247
060670071091,1059,662,397,1072,658,414,1302,852,431,1034,637,363
060670071111,777,561,216,786,556,230,1303,923,350,850,602,187
060670071092,1141,710,431,1157,709,448,1386,959,412,1141,754,339
060670071082,522,407,115,528,403,125,1146,872,255,393,303,70
060670071101,817,597,220,831,585,246,1170,840,297,917,645,209
060670071052,839,617,222,851,598,253,1334,957,347,980,707,215
060670071061,415,307,108,416,300,116,596,437,147,462,332,104
060670071062,1090,779,311,1100,774,326,1603,1128,419,1178,843,270
060670071051,812,586,226,823,571,252,1223,866,334,906,643,206
060670071053,465,331,134,472,325,147,725,491,216,537,378,120
060670072061,608,210,398,622,205,417,845,274,547,687,219,419
060670072062,830,284,546,844,273,571,1200,390,778,927,318,539
060670072071,528,169,359,533,164,369,687,231,440,533,164,334
060670072021,398,166,232,402,151,251,623,234,383,499,193,275
060670072022,395,174,221,404,157,247,553,220,323,450,176,243
060670072072,436,169,267,445,160,285,688,238,435,526,194,289
060670072081,246,100,146,252,94,158,353,134,209,292,111,165
060670072082,654,266,388,656,243,413,978,372,582,768,290,435
060670072091,474,194,280,483,183,300,715,272,424,538,210,304
060670072073,397,151,246,404,145,259,692,229,442,527,179,305
060670072092,588,223,365,596,211,385,897,357,523,698,259,403
060670072083,470,192,278,473,174,299,702,267,415,552,203,315
060670072023,317,119,198,323,114,209,505,173,327,344,131,192
060670071073,398,277,121,407,274,133,698,497,179,449,305,114
060670071071,782,544,238,796,537,259,1056,745,285,840,569,213
060670070262,433,311,122,440,305,135,369,271,89,347,230,101
060670070252,537,395,142,543,395,148,886,644,217,599,439,138
060670070251,541,398,143,547,398,149,851,623,210,607,428,140
060670070161,564,410,154,577,410,167,819,585,214,640,437,162
060670070162,408,302,106,415,302,113,626,444,161,486,342,111
060670070282,358,281,77,360,271,89,759,582,163,439,328,89
060670070283,390,299,91,394,296,98,944,717,208,248,189,50
060670070172,573,437,136,587,436,151,873,636,218,618,467,115
060670071031,827,638,189,827,617,210,1205,915,261,904,661,192
060670071032,349,264,85,353,255,98,535,391,129,445,327,94
060670071112,611,431,180,619,429,190,836,609,208,644,449,159
060670071102,756,533,223,765,532,233,1015,723,274,859,600,210
060670071063,622,457,165,631,438,193,917,648,232,692,498,158
060670067033,362,258,104,362,252,110,601,443,145,494,367,104
060670067031,264,183,81,268,183,85,408,299,105,301,206,76
060670067032,322,229,93,323,225,98,514,378,123,376,278,80
060670070011,385,301,84,392,292,100,609,420,170,438,329,83
060670072043,504,343,161,510,341,169,780,555,203,600,408,153
060670072042,310,167,143,315,160,155,473,251,211,353,195,138
060670070272,203,165,38,205,161,44,383,299,74,257,201,39
060670070271,180,146,34,183,144,39,285,222,55,187,147,28
060670070192,274,220,54,273,217,56,788,620,157,89,68,15
060670070191,143,116,27,144,113,31,241,187,47,159,124,24
060670070281,475,371,104,474,358,116,705,528,162,527,393,107
060670070212,419,329,90,424,320,104,688,514,153,511,383,96
060670070071,642,530,112,646,506,140,980,742,220,773,572,155
060670070073,515,415,100,520,399,121,790,593,176,632,481,118
060670070131,450,351,99,452,340,112,616,463,144,504,383,94
060670070234,475,348,127,479,338,141,648,468,172,538,398,110
060670072041,552,295,257,551,279,272,800,426,359,626,346,247
060670067043,283,202,81,285,198,87,448,325,118,362,246,92
060670065022,175,115,60,174,110,64,308,191,108,222,159,56
060670065011,292,226,66,295,220,75,470,334,121,337,281,40
060670065013,302,246,56,305,236,69,499,377,117,348,287,42
060670065021,289,220,69,289,207,82,492,336,145,357,251,86
060670067041,158,120,38,157,113,44,323,231,84,211,150,51
060670067042,163,124,39,163,117,46,273,195,73,199,139,47
060670064001,265,162,103,269,155,114,391,221,159,333,169,132
060670064002,219,128,91,223,124,99,357,182,158,280,142,112
060670073013,116,79,37,119,85,34,200,150,41,127,70,37
060670064005,196,150,46,198,145,53,301,218,81,214,150,56
060670064004,196,153,43,196,146,50,305,229,72,225,158,56
060670066001,240,194,46,240,188,52,413,297,89,284,209,52
060670063001,301,205,96,301,193,108,481,315,152,341,219,101
060670063002,306,211,95,309,205,104,483,317,146,359,233,107
060670064003,193,132,61,196,126,70,323,211,103,224,142,51
060670070201,555,365,190,568,369,199,791,572,197,646,408,180
060670070101,343,253,90,347,248,99,533,382,133,416,290,93
060670070102,610,448,162,617,441,176,822,610,184,692,483,155
060670070103,270,199,71,271,194,77,418,310,93,319,223,72
060670070221,324,249,75,330,246,84,504,407,80,292,235,37
060670070222,337,267,70,345,265,80,527,433,83,398,322,50
060670070114,330,262,68,335,259,76,505,379,115,400,292,79
060670070111,273,216,57,275,212,63,378,292,79,292,213,56
060670070112,535,423,112,543,419,124,796,598,184,631,459,132
060670070121,682,530,152,691,522,169,904,690,186,776,590,134
060670070122,597,456,141,605,450,155,844,633,190,677,505,129
060670070113,324,256,68,328,251,77,511,399,96,381,277,74
060670070132,419,324,95,425,320,105,617,458,145,504,375,94
060670070233,379,287,92,379,281,98,512,387,114,426,315,82
060670070232,371,297,74,376,293,83,569,440,113,427,327,71
060670070116,122,101,21,123,101,22,201,172,26,146,117,19
060670070231,230,185,45,234,185,49,438,335,92,291,228,43
060670070241,636,507,129,643,502,141,995,800,174,666,515,106
060670070211,721,566,155,730,546,184,1387,1017,338,821,594,173
060670070012,196,154,42,196,146,50,294,204,82,208,149,48
060670070013,180,141,39,182,134,48,274,190,77,218,157,49
060670070072,180,141,39,181,134,47,490,370,108,215,155,48
060670067052,178,148,30,178,143,35,348,252,86,221,182,28
060670067051,101,83,18,103,82,21,164,118,41,118,97,15
060670067053,221,183,38,223,179,44,400,286,100,269,217,34
060670067054,280,229,51,286,223,63,415,314,88,299,242,38
060670068031,302,247,55,310,242,68,506,384,109,362,270,67
060670068032,178,143,35,180,138,42,272,210,62,205,160,40
060670065012,237,199,38,237,190,47,404,310,74,310,250,40
060670067061,237,201,36,241,190,51,389,314,73,303,258,40
060670067062,290,237,53,297,232,65,598,452,137,310,245,52
060670066002,232,186,46,233,182,51,408,304,96,241,182,47
060670066003,204,142,62,208,143,65,330,220,103,235,178,43
060670066004,181,127,54,183,125,58,288,192,87,201,142,41
060670066005,231,162,69,235,160,75,435,290,128,301,205,74
060670068011,258,188,70,264,187,77,429,291,115,324,243,59
060670063003,199,141,58,201,140,61,323,210,107,209,145,55
060670063004,169,118,51,170,117,53,276,187,80,167,117,40
060670068021,112,86,26,115,86,29,205,149,45,149,113,27
060670068022,156,119,37,156,118,38,265,195,58,258,177,55
060670069021,145,112,33,146,108,38,216,166,49,153,110,37
060670069022,319,235,84,323,232,91,469,347,113,280,200,59
060670055021,132,87,45,131,83,48,218,146,70,158,106,47
060670069023,235,171,64,239,169,70,316,226,82,188,133,39
060670069011,278,202,76,281,198,83,364,255,92,387,249,108
060670069012,398,288,110,403,282,121,488,346,125,515,330,143
060670062021,242,154,88,245,150,95,378,233,131,264,162,83
060670062022,347,230,117,351,230,121,575,381,180,445,281,133
060670055022,503,337,166,509,323,186,788,505,262,584,383,164
060670054021,382,265,117,385,261,124,647,486,146,434,276,124
060670054022,309,251,58,317,252,65,488,386,86,405,294,78
060670074171,325,169,156,325,162,163,535,241,281,358,131,197
060670074172,595,313,282,595,300,295,1145,542,575,628,298,287
060670074273,431,222,209,435,213,222,728,400,304,495,241,219
060670074303,591,288,303,599,281,318,963,481,457,710,340,318
060670074311,531,257,274,539,246,293,825,413,390,606,274,284
060670074312,615,297,318,623,285,338,948,455,471,705,321,327
060670074274,389,194,195,395,186,209,617,321,275,439,212,194
060670074272,605,318,287,610,308,302,899,491,385,660,327,287
060670074304,952,486,466,971,475,496,1461,744,685,1122,562,490
060670074301,140,75,65,142,72,70,231,121,104,178,91,76
060670074302,479,256,223,489,247,242,852,444,391,583,300,249
060670074261,284,173,111,289,162,127,506,292,198,358,182,150
060670074262,243,147,96,247,139,108,459,239,207,318,160,136
060670074271,422,225,197,425,219,206,664,346,299,465,230,203
060670074391,585,293,292,595,283,312,930,479,440,660,321,290
060670074392,812,408,404,822,390,432,1253,601,621,863,423,384
060670074381,746,389,357,760,379,381,1342,645,677,833,437,351
060670074351,485,236,249,490,220,270,787,346,418,566,291,225
060670074342,528,290,238,538,280,258,925,473,427,661,356,257
060670074343,457,256,201,458,238,220,732,367,346,531,271,211
060670074341,284,157,127,288,150,138,474,247,216,323,177,129
060670074021,423,232,191,428,225,203,677,343,308,489,241,211
060670074031,485,293,192,488,286,202,736,402,305,543,297,200
060670073011,516,312,204,519,303,216,837,492,323,639,348,233
060670074023,309,179,130,308,172,136,468,249,205,363,190,144
060670074024,311,182,129,314,176,138,491,260,214,363,190,147
060670074022,501,268,233,507,259,248,845,443,369,628,329,243
060670074032,578,344,234,583,329,254,973,501,452,650,359,238
060670074142,452,228,224,451,218,233,690,342,324,525,256,231
060670074282,518,261,257,521,252,269,796,341,444,558,264,261
060670073012,209,124,85,212,120,92,358,200,138,252,135,95
060670074162,520,296,224,529,290,239,827,449,353,626,330,250
060670074233,537,351,186,543,339,204,905,593,283,685,436,200
060670074232,234,162,72,239,158,81,417,285,117,301,202,76
060670074231,9,6,3,9,6,3,11,8,3,8,6,2
060670074321,689,327,362,704,313,391,1093,507,559,796,364,366
060670074322,841,393,448,859,383,476,1289,602,658,911,421,422
060670074371,949,450,499,967,443,524,1461,676,739,1103,534,487
060670074372,525,247,278,536,244,292,784,370,393,625,273,306
060670074361,640,323,317,659,315,344,1084,501,558,790,365,371
060670074373,775,380,395,794,367,427,1315,597,700,970,495,412
060670081271,623,299,324,632,280,352,964,410,534,716,322,331
060670081272,816,368,448,825,352,473,1282,547,699,941,386,483
060670081301,361,178,183,364,165,199,535,246,276,395,167,203
060670074281,503,279,224,505,263,242,801,421,368,560,278,242
060670074291,457,252,205,460,241,219,713,374,325,488,273,179
060670074141,530,284,246,533,280,253,817,453,341,582,288,252
060670074292,316,169,147,319,168,151,545,231,301,323,180,118
060670074293,317,169,148,317,167,150,545,297,240,407,230,149
060670074221,380,210,170,384,206,178,634,317,299,483,222,227
060670074222,207,114,93,209,113,96,356,177,166,268,135,111
060670081302,532,273,259,537,258,279,812,377,408,631,279,306
060670081303,345,170,175,350,161,189,506,247,247,400,191,181
060670081313,310,152,158,315,148,167,458,219,222,333,149,156
060670081311,301,141,160,305,134,171,398,187,202,319,142,154
060670081315,425,235,190,430,232,198,674,363,283,489,245,206
060670081312,37,20,17,38,20,18,47,25,20,33,17,15
060670081331,395,210,185,397,206,191,574,303,248,437,214,191
060670074161,589,312,277,597,304,293,899,460,410,703,355,298
060670074151,462,249,213,467,242,225,639,330,293,529,267,222
060670074152,629,355,274,637,344,293,932,518,387,721,390,282
060670075011,408,200,208,408,195,213,628,318,288,459,218,203
060670075012,295,145,150,300,144,156,415,211,193,332,155,148
060670075013,221,108,113,221,106,115,318,161,148,249,116,112
060670081281,393,174,219,399,172,227,583,251,313,448,176,246
060670081282,378,164,214,390,164,226,576,244,319,441,172,241
060670081131,776,361,415,790,347,443,1270,571,646,915,361,476
060670081132,327,160,167,333,153,180,392,184,196,379,160,188
060670081431,750,324,426,759,310,449,1086,495,551,843,333,448
060670081432,581,242,339,591,228,363,842,370,438,641,220,380
060670081111,604,270,334,613,257,356,857,401,428,668,272,338
060670081112,743,312,431,753,296,457,1015,444,536,821,316,441
060670081113,578,251,327,582,237,345,809,355,432,631,249,333
060670081114,640,270,370,652,268,384,802,303,469,636,277,313
060670081291,589,296,293,605,293,312,822,417,381,654,291,312
060670081292,561,281,280,570,275,295,810,406,374,638,282,303
060670081321,837,360,477,847,353,494,1116,529,566,926,384,489
060670081322,815,354,461,830,348,482,1116,491,602,860,353,451
060670081314,772,371,401,785,359,426,1013,492,498,832,369,418
060670081341,487,257,230,494,251,243,585,317,253,472,209,225
060670081342,696,366,330,702,355,347,990,530,423,810,379,375
060670081351,297,144,153,302,142,160,399,212,173,349,159,163
060670081352,443,215,228,451,213,238,663,353,287,540,246,252
060670081353,461,229,232,468,217,251,559,278,266,508,224,245
060670081354,495,246,249,503,235,268,585,293,278,487,210,242
060670081361,285,139,146,287,133,154,420,203,204,311,141,151
060670081362,669,326,343,682,319,363,982,474,482,748,342,361
060670081191,521,242,279,525,238,287,757,386,351,546,225,274
060670074241,389,217,172,394,209,185,673,357,297,474,253,184
060670074242,355,198,157,360,191,169,557,294,243,411,217,158
060670074131,347,184,163,352,177,175,651,311,314,439,226,190
060670074132,450,241,209,452,227,225,797,396,377,551,291,227
060670074133,361,185,176,367,180,187,498,250,237,361,180,157
060670075041,345,177,168,352,173,179,488,241,231,377,170,175
060670075042,408,210,198,418,205,213,575,286,271,459,225,198
060670060033,218,131,87,220,127,93,261,158,95,224,129,79
060670060032,534,319,215,538,313,225,683,408,245,546,315,192
060670060031,634,393,241,636,379,257,851,494,332,708,408,247
060670060022,289,188,101,288,178,110,489,311,160,396,233,129
060670060041,327,213,114,330,206,124,452,287,149,393,233,128
060670060043,386,209,177,390,201,189,460,244,205,378,181,170
060670059012,791,408,383,797,391,406,938,526,392,767,425,281
060670060021,288,152,136,291,148,143,356,185,161,336,156,153
060670060042,519,275,244,525,266,259,601,359,225,484,264,184
060670055023,470,350,120,478,345,133,737,524,187,587,415,133
060670062023,141,105,36,142,103,39,192,144,41,177,121,46
060670061013,317,202,115,319,199,120,491,319,157,391,218,144
060670062031,230,147,83,230,143,87,290,190,89,237,141,79
060670062032,497,308,189,503,303,200,622,413,194,532,344,149
060670062042,393,238,155,395,234,161,552,339,198,497,301,159
060670062041,529,313,216,534,309,225,749,413,310,607,352,210
060670061011,527,316,211,536,308,228,782,503,256,551,322,183
060670061012,615,371,244,625,357,268,880,555,300,688,386,260
060670056011,376,233,143,379,228,151,521,347,161,442,261,151
060670056012,477,299,178,484,296,188,684,455,210,494,290,170
060670061021,370,232,138,377,228,149,520,340,167,403,234,139
060670061022,480,301,179,488,295,193,690,449,224,528,317,177
060670061023,354,222,132,358,216,142,445,293,144,365,219,124
060670075015,369,240,129,375,238,137,585,368,197,431,263,119
060670075014,373,209,164,376,207,169,624,326,280,489,269,180
060670075031,443,249,194,445,245,200,637,334,288,452,243,181
060670075032,323,192,131,324,184,140,481,294,172,410,218,158
060670081172,455,238,217,458,233,225,603,319,274,484,236,217
060670081332,352,182,170,356,181,175,536,280,239,412,203,183
060670075033,120,71,49,121,70,51,190,98,86,132,70,51
060670075034,375,226,149,380,218,162,592,302,267,401,212,154
060670076041,728,382,346,736,372,364,978,566,378,796,411,318
060670076042,699,378,321,707,365,342,996,611,345,740,405,266
060670079031,350,179,171,355,172,183,467,228,223,451,197,215
060670079032,526,285,241,536,274,262,712,351,338,495,226,231
060670079033,281,146,135,282,139,143,362,182,175,293,133,141
060670079034,512,276,236,516,268,248,665,353,283,561,259,259
060670079035,480,244,236,485,238,247,607,311,280,512,235,238
060670076031,695,364,331,703,355,348,914,511,376,775,389,333
060670076032,582,308,274,591,303,288,770,413,329,624,337,241
060670076021,455,252,203,461,248,213,608,351,242,494,256,195
060670076022,497,277,220,505,274,231,640,378,248,567,291,235
060670059014,772,401,371,779,391,388,897,517,359,802,396,349
060670059011,710,369,341,715,360,355,844,517,315,761,407,296
060670059013,951,480,471,964,468,496,1152,617,498,988,467,446
060670076023,626,346,280,629,334,295,783,441,321,650,326,278
060670076024,359,198,161,362,192,170,447,252,182,373,189,153
060670059042,433,238,195,439,234,205,582,328,241,471,245,188
060670059043,474,253,221,484,252,232,577,320,243,477,250,192
060670059044,863,475,388,875,474,401,1108,627,444,918,493,356
060670059031,451,265,186,459,261,198,598,362,212,553,296,210
060670059032,272,157,115,275,154,121,337,207,121,297,159,115
060670059041,427,238,189,433,231,202,552,311,229,497,256,197
060670081192,562,262,300,569,246,323,710,319,368,615,260,311
060670081193,386,184,202,390,173,217,478,230,233,404,169,206
060670081343,628,323,305,630,317,313,851,437,382,714,338,315
060670081194,485,237,248,490,231,259,674,322,329,540,221,265
060670081195,356,170,186,357,165,192,470,223,239,368,151,186
060670081372,402,184,218,405,181,224,562,285,264,489,214,241
060670081171,335,170,165,341,165,176,454,228,214,361,176,151
060670079041,664,325,339,672,315,357,877,425,416,651,275,323
060670079042,685,339,346,696,336,360,814,409,384,729,328,344
060670079043,600,296,304,611,293,318,788,397,367,615,282,289
060670079044,379,193,186,387,189,198,478,239,219,378,174,172
060670079051,952,477,475,965,476,489,1228,645,546,1021,505,449
060670079061,1268,649,619,1279,634,645,1515,814,663,1309,638,566
060670079062,502,268,234,506,259,247,639,349,272,530,254,236
060670079052,1104,542,562,1119,540,579,1387,734,619,1146,568,505
060670078011,587,310,277,594,306,288,811,428,364,633,322,267
060670078012,717,379,338,730,375,355,955,509,425,778,391,330
060670078013,453,236,217,460,231,229,591,324,256,492,239,219
060670078014,577,300,277,586,295,291,757,414,329,629,301,285
060670078021,587,331,256,591,321,270,718,416,282,646,342,257
060670055051,636,389,247,638,378,260,835,508,299,651,379,218
060670055053,418,298,120,420,292,128,616,409,180,493,334,120
060670056013,267,168,99,272,165,107,364,245,107,333,222,94
060670055052,219,167,52,220,163,57,341,224,102,248,183,47
060670055061,346,254,92,352,255,97,368,276,78,398,272,86
060670055062,365,279,86,369,275,94,583,439,123,400,275,84
060670055081,248,185,63,251,178,73,352,248,96,247,173,56
060670055091,450,348,102,457,349,108,702,542,134,569,394,124
060670055103,444,349,95,449,344,105,635,482,129,519,380,94
060670055104,231,183,48,232,180,52,363,272,75,284,211,48
060670056051,476,325,151,482,319,163,687,462,201,535,340,156
060670056014,606,369,237,613,365,248,736,492,216,614,409,171
060670057024,391,239,152,396,235,161,459,299,146,432,250,154
060670057025,572,338,234,576,329,247,660,421,222,597,345,206
060670054046,389,230,159,392,225,167,453,303,145,365,220,125
060670054043,423,275,148,425,269,156,370,261,104,309,197,90
060670055083,394,267,127,399,262,137,698,506,174,562,372,149
060670056061,516,275,241,523,273,250,575,338,224,549,295,227
060670055102,422,323,99,428,316,112,631,475,134,454,326,91
060670055101,143,110,33,144,107,37,194,147,39,170,121,34
060670056062,553,376,177,565,373,192,729,489,214,629,395,183
060670056052,534,344,190,542,336,206,777,509,247,573,352,173
060670056063,380,247,133,382,239,143,541,325,195,400,248,122
060670056064,320,207,113,323,202,121,444,272,163,341,214,103
060670055082,499,371,128,508,362,146,713,521,172,558,389,126
060670054045,577,294,283,583,292,291,697,415,262,598,326,238
060670054041,535,308,227,537,303,234,617,414,195,529,311,184
060670060023,397,250,147,403,241,162,486,310,162,406,232,135
060670060024,384,243,141,394,235,159,473,299,156,407,231,136
060670060025,371,234,137,376,225,151,503,320,165,429,244,142
060670057011,699,406,293,714,397,317,862,528,312,740,413,270
060670057012,436,230,206,439,227,212,527,307,216,457,229,196
060670057013,527,309,218,533,301,232,660,409,238,575,323,205
060670058013,898,483,415,905,472,433,1104,638,430,927,532,329
060670058011,499,276,223,505,270,235,622,366,232,501,279,181
060670058012,715,385,330,715,375,340,866,494,350,768,405,308
060670058014,605,328,277,612,324,288,725,417,290,644,345,253
060670057021,570,331,239,577,323,254,689,435,234,587,342,202
060670058031,938,458,480,949,456,493,1148,659,470,974,514,404
060670057022,644,357,287,652,361,291,759,475,266,657,373,231
060670057023,742,411,331,754,417,337,883,552,311,767,436,269
060670054044,849,447,402,854,448,406,1083,668,391,874,490,324
060670058032,741,375,366,752,376,376,858,501,341,778,417,313
060670058033,605,332,273,610,334,276,668,412,246,608,345,228
060670077011,417,232,185,417,222,195,520,284,223,410,209,167
060670077012,652,363,289,656,349,307,868,469,370,798,396,339
060670077013,319,178,141,322,169,153,461,265,180,335,163,145
060670077014,331,185,146,335,175,160,485,280,189,381,185,166
060670077015,505,282,223,510,268,242,663,383,260,585,304,240
060670077021,944,548,396,956,536,420,1148,689,438,1004,564,384
060670077022,313,181,132,317,178,139,383,230,145,341,191,131
060670078022,438,246,192,438,238,200,550,318,217,442,234,175
060670078024,629,356,273,629,347,282,734,437,277,622,339,242
060670077023,1032,561,471,1042,567,475,1199,708,464,1043,579,406
060670078023,637,362,275,635,352,283,857,520,311,643,358,243
060670058041,717,346,371,724,351,373,845,506,322,748,400,302
060670058042,984,547,437,991,533,458,1117,695,399,957,517,382
060670081242,770,327,443,777,310,467,1097,452,617,853,346,446
060670081422,417,188,229,425,183,242,578,257,304,461,199,227
060670081401,510,239,271,518,231,287,769,334,416,568,237,292
060670081421,623,294,329,642,292,350,976,437,516,695,299,349
060670081251,1076,460,616,1088,436,652,1454,638,789,1160,439,641
060670081252,394,160,234,399,152,247,552,231,308,448,170,244
060670081253,724,302,422,733,283,450,1028,430,573,846,321,468
060670081241,1264,484,780,1277,475,802,1637,645,946,1329,519,731
060670081402,543,251,292,549,236,313,765,330,413,597,247,308
060670081412,434,201,233,440,189,251,632,270,339,510,207,268
060670081371,372,161,211,376,160,216,556,255,291,410,178,208
060670081411,335,145,190,338,144,194,500,224,263,382,164,192
060670081413,244,106,138,249,106,143,322,161,151,277,113,146
060670081414,310,191,119,311,188,123,493,265,208,393,186,169
060670081415,294,181,113,294,179,115,559,303,238,362,171,157
060670081203,233,152,81,235,151,84,509,263,227,359,176,154
060670081381,226,131,95,228,130,98,377,190,178,274,142,108
060670081382,515,260,255,523,258,265,776,366,394,517,258,211
060670081201,635,284,351,647,276,371,845,340,476,705,263,396
060670081202,620,276,344,632,271,361,819,387,403,641,283,313
060670081451,615,234,381,624,228,396,856,340,485,671,231,395
060670081452,629,252,377,641,245,396,809,324,459,675,244,380
060670081453,333,132,201,341,129,212,467,188,264,364,129,208
060670081454,641,261,380,653,245,408,829,328,478,675,250,381
060670081441,311,128,183,315,121,194,418,171,234,323,122,180
060670081442,1030,428,602,1044,426,618,1351,615,692,1047,451,514
060670081455,567,211,356,573,207,366,725,297,413,604,213,344
060670081456,508,194,314,519,193,326,659,274,363,540,198,301
060670082033,958,342,616,973,323,650,1256,463,765,1024,341,610
060670082032,791,296,495,802,286,516,995,359,616,833,278,511
060670082112,468,153,315,467,145,322,567,195,364,465,153,283
060670082111,963,317,646,973,305,668,1262,433,800,1007,325,614
060670082031,604,227,377,612,221,391,794,324,449,653,249,351
060670082081,405,140,265,410,134,276,547,193,339,439,140,264
060670082084,467,188,279,475,179,296,673,288,368,511,185,282
060670082082,407,177,230,410,167,243,597,249,334,459,175,247
060670082083,431,187,244,439,179,260,619,292,313,489,188,257
060670082091,986,431,555,995,427,568,1247,587,632,1066,463,539
060670082101,1418,526,892,1439,526,913,1791,814,933,1450,561,807
060670082092,1228,540,688,1255,538,717,1528,733,751,1325,544,690
060670082103,579,252,327,594,249,345,760,367,376,606,247,318
060670082102,1126,473,653,1152,484,668,1364,617,717,1156,496,585
060670084021,801,346,455,818,360,458,1000,475,498,843,368,399
060670084022,576,265,311,595,267,328,798,382,390,659,272,325
060670084023,1068,462,606,1107,452,655,1412,645,724,1191,488,592
060670085011,1258,569,689,1287,571,716,1600,794,776,1344,602,626
060679883001,44,19,25,45,20,25,32,16,16,38,17,18
060670085014,441,207,234,448,202,246,684,377,295,461,211,215
060670085013,603,299,304,620,299,321,819,465,332,706,345,303
060670085093,940,464,476,967,469,498,1292,707,550,971,485,421
060670085102,583,276,307,593,274,319,768,402,349,543,239,275
060670085103,934,432,502,951,424,527,1171,595,543,955,435,452
060670085122,666,307,359,678,311,367,1230,649,549,697,362,283
060670081383,536,258,278,542,255,287,678,346,314,585,260,285
060670081393,365,222,143,373,221,152,596,351,225,464,248,171
060670081391,230,138,92,235,137,98,325,191,126,236,125,90
060670081392,381,232,149,390,231,159,591,352,226,434,233,160
060670081221,418,183,235,427,182,245,550,268,267,448,172,242
060670081222,834,367,467,854,366,488,1181,577,574,817,317,442
060670081223,345,155,190,353,155,198,480,233,238,383,159,190
060670082041,1041,441,600,1058,439,619,1362,598,729,1114,461,565
060670082042,1069,456,613,1088,453,635,1395,627,725,1075,450,537
060670080071,756,336,420,765,337,428,1008,491,492,780,340,370
060670080072,690,314,376,699,315,384,905,440,444,744,326,351
060670080081,847,405,442,859,401,458,1093,552,513,870,384,433
060670080082,826,395,431,845,393,452,1017,516,482,845,383,405
060670080083,747,391,356,754,378,376,1026,515,476,817,389,367
060670080093,679,389,290,687,381,306,873,508,340,727,375,285
060670080094,573,314,259,576,305,271,720,412,291,611,309,249
060670080062,726,334,392,738,335,403,842,409,406,775,359,363
060670082062,1190,503,687,1205,480,725,1617,649,913,1240,489,643
060670082061,325,141,184,329,131,198,444,198,232,358,142,183
060670082074,339,151,188,342,144,198,505,233,251,383,156,185
060670082071,280,117,163,285,110,175,414,182,219,326,125,166
060670082072,301,125,176,309,119,190,393,171,206,350,134,177
060670082073,787,375,412,792,361,431,971,454,482,814,354,381
060670082063,820,357,463,832,351,481,1170,521,612,924,364,474
060670080051,518,258,260,523,249,274,614,333,269,529,266,238
060670082075,396,190,206,395,182,213,532,266,248,432,191,202
060670080052,1391,687,704,1404,669,735,1719,908,770,1444,674,664
060670080053,719,344,375,727,342,385,879,432,414,797,398,344
060670080061,849,382,467,866,379,487,1062,526,508,870,387,414
060670080064,729,341,388,737,331,406,941,480,439,757,305,396
060670084032,939,504,435,948,490,458,1337,750,540,997,522,400
060670084033,649,347,302,658,341,317,904,498,369,721,370,292
060670084041,269,140,129,273,137,136,362,189,162,286,134,129
060670084042,544,284,260,555,279,276,706,374,319,578,274,262
060670084043,475,222,253,490,223,267,669,328,327,519,224,251
060670084031,548,254,294,560,258,302,875,480,373,655,299,305
060670085051,526,244,282,539,249,290,681,374,287,527,242,246
060670085052,560,285,275,574,289,285,723,405,300,588,295,251
060670085082,796,400,396,811,394,417,1061,601,432,859,445,349
060670085083,1234,615,619,1267,614,653,1664,891,730,1272,637,540
060670085063,224,117,107,229,119,110,352,199,145,268,138,112
060670085062,163,85,78,167,87,80,304,171,125,202,104,84
060670085061,295,154,141,301,156,145,422,237,175,328,169,137
060670085071,717,368,349,733,380,353,1032,531,480,769,364,350
060670085012,892,400,492,913,387,526,1137,538,560,944,402,467
060670085091,683,323,360,706,332,374,958,517,414,734,352,334
060670085092,480,224,256,484,220,264,686,351,317,512,233,245
060670085101,1084,489,595,1106,482,624,1283,640,606,1112,499,534
060670085121,1335,624,711,1357,633,724,2052,1067,940,1216,573,578
060670085131,837,433,404,852,436,416,1414,780,602,897,469,372
060670085132,571,268,303,585,269,316,801,447,333,595,284,270
060670080101,376,179,197,389,176,213,520,266,233,416,199,184
060670080102,632,299,333,649,294,355,788,381,390,670,293,325
060670080103,727,363,364,745,362,383,943,499,411,752,334,357
060670080091,552,271,281,562,262,300,692,372,304,565,274,249
060670080092,455,222,233,464,217,247,616,331,271,476,229,210
060670080104,649,333,316,657,329,328,914,481,405,724,343,323
060670080063,903,433,470,910,419,491,1129,580,520,934,438,434
060670085041,392,204,188,398,201,197,687,390,277,316,161,130
060670085042,1304,680,624,1320,666,654,1846,1054,749,1453,712,626
060670085043,286,155,131,288,151,137,386,216,161,307,157,127
060670085081,1048,537,511,1063,534,529,1370,766,568,978,525,378
060670085072,704,360,344,720,371,349,1023,568,435,812,402,343
060670053011,129,99,30,130,99,31,197,148,46,247,200,34
060670053013,125,99,26,124,98,26,188,143,41,116,96,13
060670005011,308,268,40,310,265,45,423,355,58,307,241,34
060670005012,449,390,59,451,386,65,612,515,76,479,377,52
060670006001,293,255,38,293,251,42,437,364,62,231,175,38
060670006002,241,210,31,243,207,36,353,292,50,216,171,23
060670007001,280,213,67,282,207,75,392,295,88,258,193,44
060670008001,219,172,47,220,169,51,282,210,63,263,195,49
060670008002,419,325,94,422,318,104,526,394,119,530,392,97
060670011031,39,30,9,39,29,10,52,42,9,41,34,4
060670011033,275,210,65,282,206,76,423,328,79,273,208,46
060670005022,255,218,37,258,218,40,318,277,33,273,232,21
060670005021,437,374,63,443,373,70,578,502,57,462,387,38
060670011022,304,262,42,309,262,47,413,325,75,322,260,33
060670011021,244,210,34,248,210,38,306,236,57,264,212,28
060670011032,138,117,21,140,117,23,159,126,29,157,125,21
060670021001,410,346,64,410,344,66,517,442,59,415,322,48
060670021002,305,260,45,307,258,49,409,351,48,308,244,33
060670021003,251,211,40,252,211,41,350,294,41,287,219,33
060670012022,583,489,94,586,490,96,685,561,94,538,433,71
060670012012,673,580,93,675,570,105,855,723,99,693,558,72
060670012011,279,235,44,281,236,45,409,344,50,246,201,24
060670012021,306,256,50,309,258,51,411,339,56,335,272,44
060670013003,588,513,75,593,502,91,734,626,84,628,514,53
060670004004,335,290,45,340,287,53,416,354,51,344,285,35
060670004005,437,376,61,445,374,71,576,490,75,469,388,50
060670004002,326,285,41,329,282,47,405,349,38,342,284,32
060670004003,407,355,52,412,355,57,521,447,54,465,381,46
060670004001,436,380,56,439,379,60,546,478,55,449,383,38
060670014002,328,283,45,330,281,49,389,325,58,360,278,48
060670014003,620,536,84,622,526,96,800,659,120,647,507,81
060670014001,343,292,51,342,285,57,473,389,69,396,323,41
060670013001,467,399,68,475,397,78,631,531,83,495,392,47
060670013002,495,423,72,497,418,79,664,550,88,542,422,55
060670018001,530,453,77,537,450,87,684,557,106,564,454,66
060670019004,300,261,39,304,258,46,361,304,41,280,224,34
060670020001,249,212,37,252,213,39,323,276,45,260,210,29
060670020002,509,436,73,515,439,76,668,561,83,479,372,62
060670020003,284,246,38,289,248,41,373,319,52,324,260,36
060670019003,456,403,53,463,401,62,595,507,66,474,379,57
060670019001,325,287,38,326,283,43,433,373,47,336,271,40
060670019002,347,304,43,350,302,48,419,356,47,364,281,46
060670003001,543,408,135,543,396,147,609,473,121,509,393,90
060670053012,168,128,40,169,126,43,499,419,67,0,0,0
060670003003,1081,824,257,1085,810,275,1225,961,232,1111,841,209
060670015001,502,378,124,506,377,129,573,448,107,504,373,100
060670015004,409,321,88,412,319,93,494,387,102,434,330,72
060670015005,734,584,150,741,581,160,936,751,170,783,608,118
060670002001,481,357,124,481,349,132,554,425,112,465,343,96
060670002004,575,427,148,578,418,160,650,500,129,564,414,114
060670003002,458,339,119,464,335,129,529,430,91,489,374,85
060670002003,684,504,180,687,496,191,786,629,139,686,507,139
060670016022,884,613,271,895,610,285,1037,766,246,908,623,211
060670002002,579,430,149,580,424,156,706,562,126,572,423,114
060670016011,614,452,162,616,445,171,734,559,159,632,455,135
060670015002,678,492,186,685,492,193,769,607,144,697,492,165
060670015003,431,314,117,437,314,123,508,409,92,445,340,72
060670016021,743,471,272,751,473,278,880,614,240,767,487,213
060670016012,520,386,134,526,381,145,627,475,142,552,396,119
060670016013,453,336,117,458,329,129,581,425,144,462,332,100
060670018002,376,320,56,376,320,56,437,377,50,385,314,42
060670018005,602,525,77,608,523,85,791,673,97,601,487,61
060670017021,760,621,139,765,615,150,987,804,159,797,610,129
060670017022,667,527,140,675,521,154,807,633,151,705,523,128
060670017023,409,305,104,418,307,111,552,412,124,408,282,95
060670017011,868,651,217,884,649,235,1102,838,234,905,619,214
060670001001,1191,771,420,1203,751,452,1406,971,398,1245,812,345
060670001002,585,425,160,586,420,166,660,488,156,600,420,143
060670001003,457,333,124,456,326,130,528,395,124,484,341,117
060670052011,264,236,28,271,232,39,326,272,46,303,241,40
060670052012,371,332,39,382,327,55,291,243,41,392,310,53
060670054032,673,453,220,672,442,230,774,568,191,711,485,190
060670054031,717,481,236,714,468,246,791,575,197,718,486,190
060670054042,370,227,143,370,221,149,490,338,143,438,268,135
060670052023,754,495,259,761,489,272,942,662,263,783,495,225
060670052022,170,115,55,171,114,57,263,190,68,163,125,25
060670052041,343,240,103,347,235,112,452,322,114,363,246,88
060670052051,302,202,100,312,200,112,529,380,138,281,174,92
060670052052,387,271,116,394,266,128,590,414,148,488,330,119
060670052042,414,266,148,422,262,160,546,374,164,478,301,149
060670052043,601,362,239,609,356,253,733,464,248,632,356,225
060670029003,372,294,78,382,294,88,476,380,90,377,277,71
060670029004,699,556,143,716,552,164,846,677,154,671,478,139
060670022001,428,371,57,431,365,66,574,493,66,432,380,36
060670022002,318,276,42,321,271,50,578,498,64,229,197,19
060670023001,430,335,95,431,332,99,509,414,83,419,310,71
060670023002,580,464,116,581,460,121,684,569,101,597,467,90
060670023003,686,527,159,689,521,168,783,627,138,701,554,109
060670023004,409,311,98,411,307,104,495,388,91,416,307,75
060670024003,456,368,88,459,368,91,542,453,77,464,370,67
060670027001,287,245,42,290,237,53,359,302,46,324,272,40
060670026001,543,461,82,546,450,96,707,584,88,576,446,72
060670025002,704,595,109,713,595,118,863,749,101,661,551,79
060670026002,469,398,71,471,394,77,524,451,61,456,380,55
060670026003,524,445,79,527,442,85,550,481,62,519,432,63
060670025001,570,478,92,579,481,98,635,547,75,564,463,72
060670022003,413,332,81,414,322,92,522,428,83,425,336,65
060670022004,525,421,104,526,410,116,655,534,104,533,421,81
060670024001,1015,742,273,1025,734,291,1147,894,235,1021,765,207
060670024004,578,424,154,579,419,160,615,481,128,545,409,111
060670024002,976,714,262,982,718,264,1111,859,238,954,719,188
060670039001,616,460,156,614,454,160,719,543,160,602,430,131
060670039002,586,411,175,585,402,183,736,565,149,650,472,133
060670039003,615,430,185,613,423,190,780,586,175,613,445,119
060670033003,995,745,250,996,735,261,1123,848,247,1005,745,212
060670033001,746,560,186,747,562,185,897,692,188,750,559,137
060670033002,700,536,164,715,542,173,846,660,173,725,542,134
060670035011,348,275,73,349,268,81,446,347,84,377,281,66
060670035012,563,445,118,564,434,130,674,522,125,558,418,97
060670035013,286,226,60,290,222,68,357,289,67,311,235,56
060670035021,569,429,140,580,430,150,700,516,170,583,416,133
060670035022,338,254,84,344,255,89,439,323,106,375,267,85
060670035023,303,229,74,308,229,79,410,299,101,323,224,77
060670027002,331,297,34,339,292,47,522,447,55,374,298,36
060670027003,237,212,25,237,209,28,343,299,33,221,182,16
060670027004,367,329,38,373,326,47,525,447,55,407,338,37
060670037003,337,280,57,339,271,68,521,425,83,370,311,46
060670037002,171,142,29,171,136,35,286,239,45,207,174,26
060670018003,271,236,35,273,235,38,376,327,42,246,204,23
060670018004,474,413,61,477,412,65,633,536,69,465,375,44
060670028001,363,320,43,366,316,50,513,420,69,392,315,34
060670028002,205,179,26,203,174,29,296,240,40,219,174,21
060670028003,378,331,47,378,326,52,506,426,70,359,304,42
060670036001,508,404,104,517,398,119,739,577,142,549,428,83
060670036002,244,193,51,246,190,56,371,284,75,259,199,39
060670037001,265,214,51,268,209,59,418,331,76,314,257,41
060670044022,316,228,88,318,215,103,478,349,106,394,287,83
060670044023,218,175,43,217,169,48,332,246,72,239,186,36
060670044011,226,183,43,230,177,53,352,269,68,244,190,37
060670044012,198,155,43,196,148,48,300,229,60,217,164,37
060670044021,194,156,38,197,151,46,297,221,73,205,156,33
060670044014,200,147,53,200,140,60,280,209,65,225,162,45
060670030022,573,440,133,578,428,150,776,582,170,621,454,131
060670030023,435,341,94,434,332,102,594,464,119,467,359,89
060670031023,270,203,67,277,199,78,413,309,94,304,211,72
060670044013,315,247,68,318,244,74,408,310,88,314,235,53
060670045011,265,215,50,265,199,66,432,319,102,303,236,51
060670045012,150,113,37,154,113,41,257,190,62,186,146,31
060670046021,318,248,70,325,244,81,550,404,136,375,289,68
060670046022,126,98,28,127,96,31,213,153,50,162,123,28
060670046023,255,188,67,254,182,72,431,307,114,308,226,63
060670046031,199,152,47,203,148,55,325,228,84,234,178,41
060670046032,207,158,49,209,152,57,323,233,85,244,192,45
060670046041,214,158,56,215,154,61,311,226,84,239,181,50
060670046042,355,261,94,362,253,109,539,376,149,443,327,94
060670046043,312,226,86,312,217,95,465,334,122,361,257,86
060670032022,212,155,57,216,151,65,362,254,99,255,178,58
060670032023,213,156,57,214,154,60,320,206,109,220,165,44
060670032021,236,175,61,236,169,67,400,285,112,302,209,70
060670047012,239,177,62,240,171,69,403,279,116,249,185,44
060670048011,251,183,68,253,181,72,352,230,120,269,201,54
060670047021,356,278,78,357,274,83,554,416,129,429,305,107
060670045021,192,151,41,193,147,46,322,230,83,223,173,40
060670045022,202,161,41,204,160,44,302,237,55,250,194,39
060670045023,299,237,62,302,235,67,446,357,81,352,278,56
060670047011,344,254,90,347,245,102,466,331,125,365,260,90
060670047022,299,232,67,298,229,69,471,351,108,358,273,73
060670047023,213,159,54,215,152,63,329,231,86,243,184,48
060670050021,343,255,88,346,247,99,540,378,153,454,347,85
060670050022,284,211,73,286,204,82,468,326,132,319,245,59
060670029001,703,575,128,710,569,141,913,730,162,775,613,119
060670029002,576,471,105,580,465,115,660,528,115,591,465,90
060670030021,702,531,171,715,515,200,864,642,205,731,523,170
060670031021,251,187,64,259,183,76,372,273,87,289,197,73
060670031022,377,282,95,383,272,111,549,406,128,428,293,108
060670030011,433,301,132,436,286,150,623,422,188,430,310,89
060670031011,295,219,76,297,209,88,424,310,96,338,236,76
060670030012,371,258,113,378,247,131,573,385,168,446,294,113
060670092013,236,116,120,243,116,127,285,143,142,251,115,127
060670031012,228,168,60,231,163,68,333,243,77,241,170,53
060670031013,284,211,73,286,203,83,408,299,94,280,198,63
060670031014,219,162,57,219,155,64,315,233,74,233,168,53
060670032024,267,198,69,272,188,84,429,297,115,335,227,75
060670032041,379,281,98,387,268,119,586,430,144,389,295,71
060670032042,199,147,52,202,140,62,306,215,83,196,150,36
060670032031,187,153,34,192,153,39,331,246,79,222,184,30
060670032032,242,197,45,247,197,50,479,357,111,299,244,42
060670032043,267,219,48,272,216,56,443,317,120,301,233,56
060670048012,269,211,58,271,205,66,444,319,114,321,254,48
060670048013,257,204,53,261,200,61,469,339,117,321,262,48
060670048014,265,212,53,266,208,58,424,315,109,300,248,40
060670048022,335,249,86,340,243,97,549,379,157,424,311,88
060670048021,549,380,169,551,374,177,836,554,266,670,466,159
060670040054,543,385,158,546,378,168,652,485,157,591,409,157
060670040061,345,246,99,349,242,107,529,391,123,427,309,83
060670034002,689,518,171,698,515,183,842,640,180,736,541,153
060670040141,564,428,136,573,427,146,718,547,151,598,439,129
060670040161,1202,792,410,1225,780,445,1457,1026,399,1250,814,369
060670040153,970,661,309,986,656,330,1209,883,306,1058,722,282
060670040151,572,390,182,579,380,199,744,532,201,601,422,151
060670040053,551,375,176,556,365,191,745,529,201,602,422,151
060670040052,295,212,83,300,214,86,397,308,80,329,242,69
060670040062,630,452,178,634,454,180,872,666,174,673,496,141
060670040063,517,361,156,520,358,162,619,447,165,525,358,144
060670040064,543,378,165,545,372,173,619,444,165,576,395,158
060670040051,686,472,214,690,464,226,810,588,205,698,480,176
060670040081,1196,860,336,1214,844,370,1468,1111,338,1243,895,286
060670040082,700,512,188,718,503,215,872,649,203,718,525,159
060670040152,505,361,144,516,347,169,663,483,168,566,398,137
060670040181,592,422,170,593,400,193,750,563,173,634,442,157
060670040182,394,279,115,391,268,123,531,386,133,459,315,116
060670040171,659,470,189,662,455,207,863,630,209,698,496,160
060670040201,371,275,96,376,269,107,610,465,132,439,324,93
060670040202,415,287,128,424,287,137,418,320,90,436,321,93
060670040191,723,539,184,732,527,205,960,719,223,813,584,183
060670040172,583,407,176,586,402,184,798,588,186,642,455,156
060670040192,454,327,127,457,327,130,612,460,129,482,351,108
060670040111,705,496,209,716,495,221,908,652,238,715,506,180
060670040112,918,621,297,926,609,317,1134,815,302,937,636,266
060670040122,575,381,194,578,369,209,713,505,194,592,397,165
060670040123,698,467,231,699,450,249,866,647,203,717,489,190
060670040121,478,320,158,480,311,169,566,427,133,483,327,128
060670034003,924,671,253,925,652,273,1089,815,255,912,667,199
060670040142,555,405,150,558,392,166,712,531,167,597,439,126
060670034001,438,358,80,452,361,91,671,527,128,511,402,93
060670040131,888,635,253,901,624,277,1108,813,272,948,656,233
060670040132,772,544,228,788,539,249,997,723,257,800,542,214
060670038001,619,469,150,618,446,172,836,601,212,666,504,111
060670038002,409,334,75,416,327,89,569,440,120,445,348,73
060670041002,457,337,120,451,312,139,617,437,165,538,373,132
060670038003,238,194,44,238,188,50,319,246,66,245,190,41
060670038004,310,253,57,314,249,65,448,343,92,323,250,52
060670041003,287,226,61,293,219,74,447,334,102,353,286,54
060670041001,331,258,73,336,252,84,573,424,130,411,314,72
060670042012,549,455,94,550,438,112,784,616,153,616,516,79
060670042013,619,485,134,624,472,152,871,640,189,715,563,111
060670042011,239,203,36,241,195,46,356,278,64,257,215,29
060670042021,532,456,76,535,453,82,697,567,117,594,511,69
060670042031,493,422,71,499,418,81,670,536,115,584,495,70
060670042022,392,341,51,397,337,60,588,469,100,456,399,41
060670042023,324,282,42,328,280,48,556,444,94,403,349,38
060670042032,471,399,72,477,387,90,888,696,166,599,499,73
060670043021,397,328,69,403,321,82,656,510,126,498,401,71
060670049083,374,294,80,375,286,89,613,455,147,483,383,75
060670049081,249,205,44,247,196,51,403,310,87,299,243,41
060670049072,85,74,11,86,72,14,144,114,26,105,90,10
060670049071,279,239,40,280,232,48,487,380,99,329,277,34
060670049082,262,229,33,268,227,41,468,365,96,327,276,28
060670043013,389,300,89,392,298,94,610,446,144,463,368,68
060670043022,421,322,99,429,321,108,717,523,182,499,397,75
060670096013,173,133,40,173,117,56,261,180,75,173,143,27
060670043012,198,160,38,202,159,43,336,256,70,229,194,27
060670043011,293,236,57,299,235,64,498,381,103,353,299,43
060670049061,470,358,112,470,341,129,686,510,161,522,404,94
060670049062,260,199,61,261,189,72,399,297,94,274,212,50
060670096014,553,455,98,559,441,118,896,683,199,686,536,114
060670096012,492,400,92,492,389,103,744,559,168,574,447,92
060670096011,240,197,43,242,191,51,381,287,88,268,208,46
060670096331,324,265,59,327,259,68,506,381,105,350,283,52
060670096332,344,270,74,344,258,86,544,407,114,414,337,61
060670049041,554,404,150,562,394,168,747,545,183,630,425,169
060670049043,434,321,113,435,308,127,656,471,172,491,358,111
060670049042,595,446,149,603,424,179,869,625,220,705,502,167
060670050033,428,315,113,431,310,121,626,412,196,454,319,115
060670050032,231,169,62,232,167,65,398,277,112,272,211,48
060670050031,392,289,103,391,282,109,629,437,179,475,373,85
060670050041,142,103,39,146,104,42,212,143,68,187,134,46
060670050042,296,218,78,299,213,86,511,361,143,348,257,72
060670050043,187,139,48,188,135,53,336,236,88,224,174,41
060670049103,298,224,74,299,216,83,428,333,89,332,261,58
060670049101,359,272,87,359,259,100,514,352,155,421,331,72
060670049092,602,470,132,610,476,134,879,678,189,666,534,102
060670049091,24,19,5,24,19,5,30,23,7,33,27,5
060670049102,114,89,25,116,90,26,199,151,41,180,142,28
060670050023,681,513,168,688,512,176,1001,744,239,737,537,169
060670096341,370,313,57,371,307,64,658,502,137,500,408,68
060670096342,193,164,29,193,159,34,341,253,80,212,175,30
060670096343,259,219,40,262,216,46,454,354,95,291,240,40
060670096402,299,230,69,300,219,81,494,355,134,351,272,64
060670096413,323,248,75,320,235,85,524,370,140,395,306,72
060670096411,281,217,64,287,215,72,449,329,114,367,267,84
060670096401,265,204,61,270,202,68,414,314,90,230,193,26
060670096412,355,273,82,365,272,93,606,444,151,481,349,112
060670093191,546,397,149,555,395,160,1063,726,314,633,464,134
060670093201,362,277,85,366,270,96,543,387,148,389,303,67
060670093202,488,366,122,495,363,132,736,498,224,560,408,123
060670093203,386,298,88,392,289,103,587,423,156,427,327,82
060670096082,572,460,112,580,453,127,1019,756,230,629,490,114
060670096101,359,282,77,361,278,83,574,432,126,392,302,64
060670096102,594,457,137,602,443,159,1017,749,245,614,462,112
060670096103,495,384,111,501,375,126,807,599,189,556,419,98
060670096093,540,420,120,543,410,133,861,632,207,612,480,105
060670096092,196,155,41,195,150,45,308,224,72,224,176,37
060670096091,561,417,144,555,403,152,898,645,231,600,468,105
060670096141,972,713,259,973,683,290,1425,1023,369,1065,738,257
060670096142,635,443,192,646,437,209,958,658,270,776,521,215
060670096084,394,315,79,399,308,91,673,535,121,487,389,76
060670096081,360,284,76,369,286,83,585,420,154,458,353,84
060670096083,572,444,128,578,447,131,1054,742,292,575,454,97
060670052021,617,369,248,626,366,260,806,516,269,636,372,217
060670091061,710,478,232,715,472,243,906,620,261,745,469,227
060670091062,622,420,202,630,417,213,782,532,229,639,406,192
060670091051,343,238,105,348,233,115,502,353,130,418,262,115
060670091052,291,202,89,294,198,96,418,292,109,333,208,91
060670091053,353,244,109,360,242,118,455,319,119,362,228,100
060670091063,509,341,168,505,328,177,645,453,176,505,312,160
060670091072,957,640,317,968,621,347,1357,862,450,1149,694,346
060670052044,397,239,158,402,235,167,527,332,179,448,250,161
060670052045,351,211,140,356,208,148,440,280,149,375,212,135
060670091101,145,103,42,147,100,47,181,135,38,167,128,30
060670091102,259,183,76,260,177,83,345,261,71,268,208,49
060670091111,716,446,270,723,448,275,1042,629,393,843,488,287
060670091112,427,273,154,429,273,156,640,453,166,521,356,133
060670091081,560,341,219,570,334,236,738,443,275,595,340,214
060670091082,450,266,184,459,261,198,582,352,217,484,273,178
060670091092,700,426,274,705,405,300,930,578,314,801,453,284
060670091093,535,329,206,546,324,222,693,448,219,556,322,193
060670091094,422,256,166,427,243,184,561,327,217,455,245,174
060670091083,523,290,233,531,286,245,729,422,281,595,327,227
060670091091,408,227,181,417,225,192,594,337,238,457,242,177
060670089092,246,146,100,250,141,109,346,205,130,290,159,106
060670091071,426,254,172,432,245,187,501,301,190,448,247,166
060670089091,549,306,243,553,308,245,797,465,303,609,337,226
060670089111,323,179,144,326,180,146,458,267,173,357,190,138
060670089112,234,131,103,236,131,105,347,210,120,282,173,89
060670089101,546,296,250,552,288,264,752,419,315,586,297,249
060670089102,647,349,298,654,344,310,878,501,353,718,387,277
060670090061,515,293,222,524,287,237,821,504,294,660,366,247
060670091031,605,356,249,618,356,262,905,505,370,716,402,252
060670091032,447,263,184,455,262,193,660,368,272,513,290,180
060670090041,776,475,301,778,465,313,1081,618,438,829,497,269
060670090042,444,272,172,442,264,178,673,387,272,476,274,163
060670090051,698,428,270,706,420,286,1107,645,427,801,470,269
060670090062,655,392,263,660,384,276,1039,571,431,754,450,247
060670090063,158,94,64,160,93,67,245,137,102,185,110,61
060670090052,179,122,57,181,114,67,288,187,94,201,106,80
060670089131,343,173,170,348,168,180,498,240,240,404,185,184
060670089132,537,262,275,547,257,290,747,348,377,561,252,262
060670089133,536,302,234,546,292,254,749,425,300,591,302,240
060670089121,383,208,175,389,201,188,500,261,224,426,218,178
060670089122,628,348,280,639,337,302,864,472,367,682,348,279
060670089123,371,200,171,378,194,184,466,242,210,409,208,171
060670089051,494,264,230,500,256,244,686,376,298,583,286,238
060670089052,489,252,237,499,250,249,709,390,296,598,295,238
060670089053,420,219,201,423,212,211,587,330,244,503,261,192
060670089073,368,197,171,369,191,178,516,280,224,395,191,166
060670089074,325,174,151,328,169,159,445,239,190,339,165,142
060670089081,625,309,316,629,293,336,871,430,423,702,330,316
060670089082,703,385,318,711,365,346,1004,490,482,801,414,320
060670089071,278,167,111,282,158,124,394,214,171,358,202,127
060670089072,434,260,174,439,247,192,640,351,276,494,263,192
060670090081,391,227,164,398,224,174,575,353,202,428,239,162
060670090082,369,215,154,371,209,162,534,313,209,438,232,164
060670090104,374,244,130,381,244,137,662,418,231,401,257,119
060670090083,352,206,146,353,199,154,510,297,199,414,231,156
060670090102,325,213,112,330,213,117,490,339,127,368,246,97
060670090103,246,164,82,250,164,86,420,290,109,303,202,79
060670090101,391,255,136,396,254,142,669,422,226,413,274,109
060670088031,195,108,87,198,106,92,333,174,150,220,112,84
060670090071,281,187,94,285,187,98,483,304,161,346,220,101
060670090072,270,179,91,272,180,92,467,306,144,323,206,96
060670090113,1095,566,529,1108,565,543,1657,875,743,1123,551,501
060670090111,571,294,277,577,292,285,813,429,368,623,305,279
060670090112,192,100,92,193,100,93,330,178,147,91,47,41
060670092012,310,135,175,315,133,182,407,183,219,355,174,157
060670091113,575,349,226,585,355,230,858,502,329,651,378,216
060670091121,602,382,220,600,363,237,857,571,262,670,432,192
060670091122,614,390,224,613,371,242,850,505,328,697,408,234
060670093263,836,393,443,850,388,462,1064,559,477,887,427,412
060670088023,423,214,209,427,208,219,628,323,290,467,223,204
060670088022,284,140,144,288,138,150,423,218,199,312,149,139
060670088032,208,109,99,211,106,105,306,161,135,233,114,96
060670088021,424,202,222,431,202,229,590,294,289,462,216,218
060670051011,378,265,113,384,256,128,612,372,225,442,298,117
060670051012,551,373,178,552,358,194,852,572,265,661,452,176
060670051021,584,365,219,585,354,231,909,580,308,698,466,197
060670051022,686,365,321,710,352,358,968,503,450,775,387,357
060670093181,495,343,152,502,344,158,810,560,235,589,423,139
060670093192,240,168,72,245,169,76,368,253,107,255,188,54
060670093193,255,184,71,259,183,76,414,280,121,326,239,71
060670093161,584,431,153,590,420,170,962,621,320,730,499,193
060670093162,469,348,121,479,341,138,816,545,250,515,373,110
060670093171,796,533,263,800,517,283,1331,869,434,807,533,221
060670093172,491,313,178,496,296,200,721,470,234,556,360,155
060670093173,675,473,202,682,468,214,1043,693,320,811,529,224
060670093342,447,299,148,459,301,158,731,493,228,507,350,134
060670093353,279,205,74,285,202,83,516,349,158,346,254,78
060670093213,689,492,197,697,483,214,1010,687,302,793,563,186
060670093211,276,205,71,280,200,80,436,302,124,319,236,70
060670093212,685,472,213,686,464,222,1028,689,322,793,566,185
060670092011,1273,835,438,1291,827,464,2346,1488,820,1060,646,357
060670093113,731,429,302,744,430,314,1069,619,426,806,469,278
060670093111,412,248,164,421,249,172,632,373,247,462,275,156
060670093112,872,544,328,884,539,345,1259,768,467,1003,621,324
060670093124,633,393,240,634,385,249,848,536,299,705,433,237
060670093123,810,542,268,823,532,291,1223,763,425,901,609,247
060670093122,456,320,136,465,313,152,827,562,251,580,410,144
060670093121,274,187,87,281,185,96,432,294,132,309,221,74
060670093291,292,200,92,299,197,102,461,282,171,336,212,106
060670093292,369,252,117,375,247,128,536,327,199,416,262,131
060670093261,696,408,288,712,406,306,1105,673,413,714,436,238
060670093262,590,319,271,603,318,285,810,490,305,616,349,235
060670093302,719,412,307,735,400,335,1229,665,537,769,442,286
060670093301,767,415,352,780,402,378,1128,607,500,820,452,327
060670089083,381,165,216,388,170,218,473,223,248,391,194,183
060670087021,1158,566,592,1170,561,609,1322,737,563,1171,597,511
060670087033,1005,479,526,1014,473,541,1155,622,514,997,509,441
060670087022,875,420,455,883,411,472,993,547,433,882,453,386
060670087032,242,124,118,244,127,117,415,238,161,258,132,104
060670087031,1035,529,506,1037,518,519,1313,750,528,1127,570,478
060670087034,506,257,249,509,254,255,705,399,287,520,263,219
060670087062,120,64,56,121,64,57,364,201,154,63,30,26
060670087061,313,166,147,315,166,149,684,383,288,98,48,41
060670087071,395,228,167,400,223,177,575,328,231,434,243,159
060670087072,30,17,13,30,16,14,37,21,16,30,16,12
060670087074,324,176,148,325,167,158,423,236,182,333,176,136
060670087075,862,500,362,869,488,381,1233,708,493,936,524,342
060670087076,413,221,192,422,214,208,625,344,267,414,214,171
060670087081,562,297,265,576,288,288,978,527,425,623,311,255
060670087082,14,7,7,14,7,7,47,27,20,16,8,7
060670087083,2,1,1,2,1,1,6,3,3,2,1,1
060670087084,0,0,0,0,0,0,0,0,0,0,0,0
060670087085,2,1,1,2,1,1,5,3,2,1,1,0
060670087086,456,239,217,464,232,232,758,407,332,479,236,194
060670086022,474,145,329,480,143,337,687,251,423,499,161,314
060670087042,30,17,13,31,17,14,77,46,31,20,12,7
060670087043,615,353,262,627,351,276,1220,719,474,593,337,217
060670087073,93,54,39,95,54,41,249,148,97,63,37,23
060670087041,350,200,150,356,200,156,504,298,197,522,296,191
060670086021,356,113,243,362,108,254,437,151,279,381,122,240
060670093361,450,167,283,458,155,303,612,254,352,480,167,293
060670086011,1382,469,913,1407,465,942,1680,633,1008,1401,473,835
060670086013,1059,351,708,1068,348,720,1295,494,777,1043,356,635
060670086012,938,323,615,942,315,627,1097,452,622,975,356,571
060670094042,801,260,541,810,242,568,899,318,566,793,253,508
060670096182,572,392,180,580,380,200,868,581,263,652,441,169
060670099004,181,81,100,183,77,106,244,123,118,198,88,101
060670096352,492,307,185,495,297,198,733,478,238,541,352,159
060670099001,431,220,211,437,209,228,558,296,253,443,230,187
060670096453,414,271,143,422,270,152,559,372,184,403,271,112
060670096451,799,530,269,812,528,284,1084,725,344,831,557,230
060670096442,863,579,284,875,577,298,1191,824,347,939,628,256
060670096441,595,396,199,603,394,209,802,558,230,650,434,176
060670096181,437,307,130,442,295,147,687,465,201,518,358,129
060670096452,429,277,152,431,273,158,618,434,174,487,327,134
060670096171,456,254,202,462,245,217,595,349,233,497,287,181
060670096172,1541,827,714,1566,804,762,1912,1127,739,1655,916,641
060670096183,595,385,210,599,377,222,806,545,249,682,441,201
060670096222,347,225,122,347,218,129,488,328,152,389,209,155
060670096225,306,187,119,312,186,126,413,279,121,356,220,121
060670096224,1357,866,491,1380,849,531,1803,1202,566,1429,915,439
060670096223,677,414,263,689,410,279,915,603,300,708,439,231
060670096221,504,330,174,512,322,190,717,502,204,545,365,151
060670096492,217,149,68,221,145,76,312,211,100,225,150,68
060670096493,449,304,145,456,297,159,653,448,194,493,328,147
060670096481,693,462,231,706,459,247,1051,706,330,869,584,241
060670096482,320,214,106,322,211,111,456,304,145,352,233,103
060670096491,743,500,243,760,492,268,1299,881,392,708,478,184
060670096351,740,471,269,752,462,290,1050,710,317,744,492,213
060670096353,885,606,279,896,593,303,1354,963,375,983,644,277
060670096462,870,609,261,890,609,281,1458,996,444,1009,695,260
060670096531,135,50,85,136,44,92,195,82,103,145,48,85
060670096533,184,69,115,186,61,125,227,86,137,202,74,114
060670096143,604,417,187,616,413,203,921,629,274,707,483,186
060670096431,532,359,173,542,352,190,781,533,230,595,390,166
060670096433,852,565,287,873,561,312,1158,780,347,914,609,250
060670096421,523,362,161,532,361,171,849,597,237,667,471,160
060670096432,501,341,160,505,329,176,729,495,215,556,354,170
060670096434,493,323,170,505,324,181,659,446,198,531,348,150
060670096161,668,375,293,677,367,310,906,527,355,730,407,282
060670096162,366,206,160,369,200,169,481,281,189,384,214,147
060670096163,993,581,412,1012,580,432,1371,845,486,1087,666,349
060670096164,508,292,216,519,291,228,643,389,234,532,315,184
060670096324,585,393,192,588,382,206,859,569,273,559,369,161
060670096321,474,316,158,480,315,165,740,494,231,549,369,153
060670096322,731,500,231,740,494,246,1068,703,346,788,547,206
060670096323,1119,720,399,1134,710,424,1585,1021,534,1424,947,406
060670096501,31,23,8,31,22,9,41,27,14,25,18,6
060670096502,28,23,5,27,22,5,44,30,14,23,17,5
060670096503,20,16,4,20,16,4,31,21,10,14,12,2
060670096512,712,419,293,720,418,302,951,598,346,697,423,239
060670096511,353,208,145,357,206,151,449,284,161,373,224,132
060670096473,648,459,189,667,464,203,1039,717,305,758,540,175
060670096472,510,361,149,518,362,156,768,534,221,586,420,133
060670096471,656,454,202,665,451,214,1029,692,315,713,497,171
060670096461,612,416,196,625,417,208,875,589,269,664,422,202
060670096372,925,620,305,940,629,311,1400,985,402,992,673,260
060670096373,691,466,225,710,467,243,1044,710,313,746,517,186
060670096371,334,225,109,339,227,112,514,375,129,396,266,102
060670098001,480,252,228,489,247,242,666,324,325,522,261,225
060670098002,218,105,113,222,105,117,379,179,190,222,100,107
060670099003,191,89,102,194,90,104,247,101,138,201,93,99
060670099002,407,180,227,412,175,237,539,267,263,434,197,213
060670096391,333,239,94,337,234,103,492,340,147,364,265,80
060670096392,264,191,73,269,188,81,492,338,148,301,223,68
060670096393,477,344,133,484,336,148,744,526,209,620,436,148
060670096122,880,593,287,890,585,305,1301,858,410,947,618,261
060670096123,987,661,326,1000,649,351,1430,938,460,1086,681,336
060670096121,448,296,152,455,295,160,639,418,205,546,327,186
060670096111,383,249,134,383,238,145,618,406,195,371,238,113
060670096112,779,510,269,781,482,299,1121,738,353,909,597,257
060670096522,1424,946,478,1445,927,518,2633,1835,765,942,629,268
060670096521,58,39,19,60,39,21,641,462,169,59,42,15
060670093351,401,278,123,410,277,133,900,587,298,477,347,108
060670093352,448,308,140,457,304,153,735,480,242,461,348,94
060670093231,1343,726,617,1369,701,668,1829,982,799,1481,764,630
060670093232,1117,631,486,1131,600,531,1524,927,557,1169,692,413
060670093343,492,325,167,501,324,177,763,508,248,549,374,149
060670093341,934,604,330,957,600,357,1445,923,498,1037,674,315
060670093331,713,466,247,724,452,272,1135,724,391,787,536,213
060670093141,556,375,181,562,362,200,922,595,305,622,411,179
060670093142,960,569,391,973,554,419,1380,805,549,1061,629,366
060670093143,419,224,195,424,221,203,568,309,249,503,232,240
060670093081,701,353,348,725,348,377,940,498,417,742,375,301
060670093082,1139,572,567,1165,560,605,1503,791,662,1284,569,621
060670093083,601,307,294,610,295,315,752,396,334,672,304,320
060670093071,644,303,341,657,299,358,870,425,423,694,324,320
060670093072,895,486,409,911,473,438,1226,659,530,997,556,394
060670093073,712,309,403,726,308,418,885,400,456,746,316,374
060670093091,787,354,433,800,342,458,1017,482,511,861,328,461
060670093101,544,246,298,557,241,316,781,365,393,596,268,282
060670093102,604,271,333,614,261,353,809,352,432,651,282,317
060670093092,355,159,196,359,152,207,464,209,243,394,150,212
060670093103,715,327,388,728,323,405,1074,502,540,769,344,367
060670093104,555,257,298,563,254,309,638,309,308,607,284,277
060670093105,373,194,179,384,183,201,580,298,263,452,190,228
060670093312,931,512,419,945,508,437,1278,757,499,956,579,322
060670093313,582,316,266,586,308,278,875,528,337,644,387,223
060670093321,630,306,324,635,305,330,901,447,437,647,267,349
060670093362,538,270,268,549,259,290,755,361,378,585,247,305
060670093363,839,320,519,850,300,550,1050,422,600,860,360,454
060670093311,531,299,232,536,289,247,773,459,298,611,349,225
060670093314,756,440,316,768,433,335,1039,610,412,782,448,292
060670093281,329,195,134,333,189,144,895,528,350,402,240,143
060670093282,1012,596,416,1030,576,454,1544,909,598,1180,697,427
060670093283,520,273,247,533,266,267,730,432,285,438,249,161
060670095021,682,243,439,695,232,463,893,322,548,736,266,419
060670095033,279,122,157,284,116,168,391,168,208,316,128,165
060670094031,949,282,667,950,258,692,1194,381,784,997,290,650
060670094091,815,330,485,829,317,512,1241,506,707,715,285,387
060670094081,731,254,477,752,247,505,948,331,603,767,295,427
060670095022,1046,436,610,1065,418,647,1405,568,791,1150,456,604
060670095023,405,194,211,407,184,223,614,300,288,463,208,221
060670095031,312,151,161,321,148,173,474,225,234,352,155,170
060670095032,200,96,104,207,96,111,320,154,159,252,110,123
060670095041,694,329,365,697,312,385,1063,495,549,708,336,333
060670095024,405,198,207,408,188,220,598,302,279,483,218,229
060670095012,469,221,248,475,212,263,663,305,340,484,246,215
060670094102,429,192,237,441,185,256,724,322,382,509,216,258
060670094103,734,324,410,748,309,439,974,427,521,835,351,423
060670094092,880,393,487,895,380,515,1295,586,671,1003,424,520
060670094101,748,300,448,760,288,472,1043,416,592,845,329,452
060670094043,647,202,445,654,186,468,798,259,525,699,221,446
060670094044,885,268,617,895,246,649,1188,390,764,920,287,587
060670094041,757,208,549,768,201,567,996,300,669,820,236,542
060430002003,331,133,198,329,132,197,415,173,230,366,138,206
060430003021,415,181,234,416,179,237,508,226,272,467,188,244
060430004001,471,387,84,467,390,77,567,464,81,511,382,74
060430001011,556,277,279,560,279,281,656,306,334,598,265,286
060430001012,543,237,306,549,235,314,688,294,374,583,230,319
060430004002,127,65,62,126,66,60,137,79,56,138,61,65
060430003023,402,148,254,405,145,260,527,200,320,438,142,267
060430002001,858,257,601,863,246,617,1135,353,759,906,266,593
060430002002,281,89,192,278,84,194,354,116,233,304,93,196
060430001013,607,232,375,617,230,387,764,299,447,676,226,409
060430001022,386,98,288,389,95,294,451,118,327,432,96,318
060430001014,290,84,206,295,85,210,364,104,250,331,86,230
060430001021,561,228,333,569,223,346,707,284,403,588,217,332
060430003011,630,223,407,637,222,415,782,286,475,656,198,425
060430003013,498,192,306,500,195,305,666,268,383,546,182,333
060430003012,845,272,573,848,258,590,1070,358,686,914,237,605
060430003022,375,125,250,378,119,259,489,160,320,423,115,283
060270002001,503,232,271,512,232,280,612,295,307,566,239,295
060270002002,319,107,212,322,104,218,395,156,228,381,107,247
060270001001,660,271,389,668,265,403,914,408,489,725,265,413
060270001002,649,282,367,657,276,381,859,390,451,714,266,397
060270004002,553,297,256,566,297,269,792,422,348,636,285,313
060270004003,459,246,213,463,239,224,675,370,286,496,224,238
060270004004,232,139,93,235,134,101,342,213,118,280,139,112
060270003001,692,301,391,697,299,398,855,412,429,742,276,412
060270003002,747,236,511,756,241,515,866,304,548,784,219,515
060270004001,280,201,79,287,193,94,459,328,118,307,179,90
060270005001,453,215,238,453,202,251,445,200,240,464,183,251
060270005002,645,296,349,648,285,363,909,439,448,707,259,375
060270008001,181,127,54,177,117,60,224,121,94,226,135,74
060270008002,280,114,166,279,111,168,331,147,169,312,108,174
060270008003,289,140,149,287,133,154,409,220,176,361,154,187
060270008004,250,117,133,255,116,139,394,209,171,295,117,155
061130101044,237,163,74,239,159,80,383,270,100,438,282,124
061130101051,441,320,121,447,313,134,649,448,189,549,380,133
061130101042,326,225,101,328,219,109,294,206,80,158,101,45
061130101041,415,298,117,419,290,129,644,441,192,476,319,123
061130101032,281,186,95,284,178,106,525,305,208,345,209,115
061130102011,686,457,229,691,445,246,1153,755,378,577,357,190
061130102031,214,128,86,216,126,90,409,263,136,246,146,85
061130102032,287,205,82,288,196,92,463,311,138,309,206,79
061130102044,338,242,96,338,231,107,536,363,160,501,342,125
061130102041,294,210,84,294,201,93,461,311,138,345,232,88
061130102012,542,331,211,546,318,228,672,440,223,543,309,200
061130102033,217,128,89,218,126,92,443,284,146,257,149,89
061130102034,124,75,49,127,74,53,230,151,75,150,87,51
061130102042,261,159,102,263,159,104,378,246,127,288,173,101
061130102043,628,383,245,629,369,260,834,536,272,696,395,251
061130103151,514,334,180,517,323,194,837,526,293,702,408,242
061130103121,1059,654,405,1075,631,444,1416,855,535,1269,738,447
061130103122,639,405,234,651,391,260,947,568,354,634,351,238
061130103141,867,539,328,877,527,350,1222,738,460,924,548,320
061130103131,1165,763,402,1174,746,428,1273,813,417,932,620,255
061130103132,968,614,354,982,604,378,1624,1021,572,1147,728,350
061130103102,700,435,265,715,424,291,881,567,293,707,434,224
061130103103,299,195,104,303,190,113,409,262,136,317,205,88
061130103123,339,195,144,349,188,161,485,290,181,391,205,164
061130103101,350,229,121,355,223,132,516,330,173,393,255,107
061130104021,648,404,244,651,390,261,885,533,334,696,418,234
061130103104,526,345,181,530,334,196,837,539,277,598,386,163
061130104022,944,589,355,937,561,376,1323,798,498,961,575,322
061130101021,441,232,209,436,213,223,573,309,249,411,190,194
061130101031,315,190,125,310,173,137,489,275,205,358,203,134
061130101033,551,369,182,547,341,206,897,490,372,673,433,198
061130101043,335,235,100,333,223,110,620,400,210,393,257,114
061130106021,462,413,49,468,414,54,542,467,59,517,438,45
061130106022,438,400,38,438,389,49,628,552,56,498,420,35
061130106024,261,239,22,260,232,28,332,285,34,321,269,23
061130105012,767,700,67,775,703,72,740,657,56,1578,1319,107
061130107014,318,291,27,318,289,29,482,434,38,378,320,28
061130107011,780,690,90,781,685,96,898,790,80,946,798,80
061130107013,268,241,27,269,241,28,299,270,27,246,213,20
061130107041,1088,937,151,1088,931,157,1308,1149,127,1218,1013,121
061130107012,544,496,48,545,493,52,662,584,58,597,519,34
061130107032,646,574,72,652,569,83,755,666,74,688,585,52
061130107033,417,368,49,423,366,57,469,409,51,506,428,42
061130107034,340,300,40,344,298,46,342,300,33,426,361,35
061130107031,397,355,42,396,350,46,491,428,48,415,356,29
061130105111,540,455,85,543,453,90,626,540,74,578,483,66
061130105112,989,831,158,994,826,168,1139,981,134,1052,880,116
061130105122,785,673,112,794,677,117,919,795,108,869,736,82
061130105131,527,458,69,529,456,73,602,517,71,604,518,50
061130105132,714,597,117,720,603,117,787,678,93,772,640,82
061130105081,658,530,128,658,522,136,734,634,86,744,595,110
061130105082,677,555,122,682,561,121,807,690,101,722,587,89
061130105011,185,168,17,188,170,18,248,193,50,133,98,27
061130105121,638,519,119,644,517,127,754,649,89,733,598,92
061130105051,348,249,99,346,241,105,386,285,89,288,217,49
061130105052,561,417,144,558,411,147,886,704,166,394,265,110
061130106023,404,371,33,407,371,36,493,426,54,432,364,19
061130106111,755,666,89,758,651,107,964,832,106,863,706,86
061130106092,936,797,139,950,786,164,1319,1093,192,946,756,124
061130106025,410,366,44,416,369,47,509,440,55,487,414,43
061130105054,594,488,106,604,497,107,744,611,113,682,552,83
061130105091,604,518,86,602,516,86,838,722,100,712,583,82
061130105092,1098,930,168,1104,929,175,1108,963,120,1126,924,141
061130105104,638,527,111,645,528,117,705,608,80,692,546,102
061130106091,537,448,89,543,446,97,625,511,95,626,501,85
061130106102,1114,908,206,1121,895,226,1100,905,165,1265,983,184
061130106101,413,326,87,417,326,91,579,475,88,674,537,97
061130106081,453,379,74,457,380,77,741,615,112,590,482,66
061130106084,236,204,32,234,197,37,315,250,50,295,254,20
061130106082,581,472,109,586,476,110,654,545,92,679,549,86
061130106071,532,403,129,537,409,128,595,492,90,444,347,73
061130106072,428,342,86,425,335,90,517,427,76,457,366,68
061130106074,710,542,168,713,546,167,863,713,130,782,613,126
061130106073,491,336,155,493,336,157,581,471,97,555,402,124
061130106051,1187,922,265,1191,924,267,1224,1012,186,988,772,153
061130104013,568,435,133,577,441,136,660,536,104,703,527,117
061130104014,539,383,156,542,383,159,714,542,154,570,396,124
061130105101,433,335,98,437,335,102,515,439,65,477,373,70
061130105102,858,744,114,856,732,124,1003,865,119,1072,908,98
061130106083,330,265,65,331,266,65,377,313,54,324,260,44
061130105053,1033,777,256,1045,796,249,1293,1063,197,1191,910,198
061130105103,393,345,48,393,344,49,471,406,57,455,382,39
061130106052,466,358,108,469,362,107,801,658,122,516,396,89
061130104012,574,337,237,570,329,241,702,421,261,598,373,191
061130110011,797,413,384,803,396,407,1044,557,464,865,455,353
061130110012,393,281,112,392,274,118,653,346,289,469,312,126
061130110013,610,388,222,610,375,235,871,511,342,792,419,312
061130110023,585,296,289,586,282,304,692,401,275,622,302,276
061130110022,544,234,310,547,230,317,654,350,293,577,253,294
061130112032,579,251,328,586,249,337,683,364,305,634,276,321
061130111011,501,294,207,499,285,214,647,372,260,516,301,175
061130111012,533,307,226,530,289,241,750,433,298,631,364,216
061130112031,795,404,391,794,385,409,949,506,424,843,421,364
061130112041,825,389,436,830,366,464,1002,563,410,708,319,338
061130112042,643,341,302,645,315,330,866,511,332,689,336,299
061130110021,479,208,271,480,201,279,614,326,273,504,231,237
061130111022,313,195,118,310,183,127,465,311,143,389,242,125
061130112043,374,230,144,372,210,162,998,686,285,441,283,133
061130112101,495,358,137,487,335,152,728,500,206,574,395,149
061130111032,946,629,317,945,615,330,871,576,269,482,293,148
061130112081,804,541,263,811,534,277,1404,968,399,985,653,265
061130112082,884,593,291,886,583,303,1611,1108,461,1014,672,275
061130108001,541,338,203,538,330,208,632,396,224,580,353,192
061130108003,164,119,45,165,115,50,289,191,92,148,100,38
061130109011,802,488,314,801,461,340,962,599,337,799,457,276
061130109012,299,187,112,301,177,124,454,282,159,353,205,118
061130109013,445,289,156,451,279,172,702,439,249,500,301,160
061130108002,392,268,124,393,253,140,558,353,193,437,280,128
061130112083,339,152,187,338,140,198,726,370,343,271,141,112
061130109021,583,369,214,583,347,236,834,513,289,615,356,218
061130109022,569,376,193,568,367,201,867,534,302,659,404,196
061130111031,463,313,150,465,301,164,713,471,223,589,387,157
061130112102,485,340,145,489,331,158,729,485,224,544,369,139
061130109023,405,277,128,403,269,134,612,408,184,500,319,140
061130111021,307,202,105,309,195,114,513,341,159,363,234,99
061130111023,354,232,122,355,224,131,537,360,167,427,275,119
061130112091,679,456,223,683,448,235,1054,719,310,996,670,263
061130112111,550,370,180,550,360,190,783,533,227,681,456,183
061130112092,499,332,167,495,325,170,675,466,194,454,304,122
061130104011,524,211,313,530,194,336,634,275,342,589,244,295
061130113011,469,235,234,472,231,241,598,324,253,527,267,225
061130113012,216,133,83,218,127,91,279,182,92,259,163,76
061130113031,549,343,206,551,338,213,741,451,273,511,306,180
061130113021,452,266,186,458,273,185,550,324,208,432,248,147
061130113022,1,1,0,1,0,1,2,1,1,1,1,0
061130113023,806,453,353,814,435,379,1301,704,560,886,484,342
061130113041,397,278,119,400,266,134,559,384,160,481,309,143
061130112071,499,180,319,503,178,325,545,230,301,887,386,438
061130112072,858,351,507,855,325,530,1059,460,570,807,326,435
061130114003,232,108,124,232,102,130,247,113,132,484,220,232
061130115001,624,298,326,624,283,341,742,356,366,1110,513,532
061130115002,152,70,82,152,68,84,239,117,119,154,71,74
061130115003,590,281,309,594,266,328,926,445,462,216,98,110
061130115004,163,80,83,165,78,87,287,139,145,13,6,6
061130115005,189,95,94,184,83,101,248,120,125,338,140,175
061130114001,506,220,286,509,191,318,680,319,347,692,289,361
061130114002,204,115,89,203,104,99,331,150,175,128,70,53
060290052071,396,110,286,400,115,285,384,110,268,334,87,227
060290052073,247,80,167,250,83,167,338,121,212,273,89,174
060290052031,587,171,416,599,183,416,785,233,542,677,171,471
060290052033,249,64,185,250,66,184,327,86,233,283,65,201
060290052032,719,194,525,726,194,532,956,248,694,842,189,611
060290052061,365,79,286,372,78,294,466,112,346,410,86,308
060290052051,239,64,175,243,64,179,399,109,275,283,70,194
060290052052,465,122,343,476,141,335,700,184,494,526,115,388
060290052063,241,78,163,242,83,159,354,115,231,338,95,220
060290052062,339,106,233,346,113,233,487,152,323,415,115,276
060290052053,286,92,194,291,100,191,432,139,283,385,108,258
060290005092,483,74,409,488,76,412,769,211,546,517,89,414
060290005091,545,79,466,548,79,469,720,140,568,610,96,496
060290048012,167,142,25,165,131,34,248,196,48,188,153,27
060290048013,211,180,31,212,169,43,302,241,58,235,193,33
060290049013,276,213,63,281,206,75,435,292,139,335,265,53
060290049011,101,78,23,102,75,27,167,112,53,118,92,19
060290046061,278,199,79,282,192,90,474,303,155,340,229,95
060290048011,238,183,55,240,181,59,342,232,101,298,232,56
060290050031,264,183,81,266,179,87,401,261,136,311,215,84
060290050032,197,138,59,198,133,65,308,199,99,248,176,58
060290050062,398,268,130,401,263,138,590,369,206,460,307,134
060290050061,405,281,124,412,275,137,588,382,197,494,340,129
060290049041,316,233,83,320,221,99,474,317,149,349,257,76
060290049042,313,230,83,318,220,98,460,305,144,356,261,77
060290049033,202,146,56,205,136,69,307,198,106,265,203,51
060290049034,226,163,63,227,151,76,321,205,112,292,223,59
060290049031,235,168,67,235,156,79,380,241,131,275,210,53
060290046074,178,148,30,181,143,38,290,213,71,231,194,28
060290046071,187,155,32,189,150,39,297,222,73,246,207,29
060290046072,202,169,33,207,163,44,362,265,88,243,205,28
060290048023,269,231,38,272,222,50,396,296,99,297,261,35
060290048021,198,170,28,200,163,37,344,250,84,242,202,31
060290048022,113,97,16,112,92,20,279,208,65,100,83,12
060290046073,110,94,16,109,87,22,166,131,30,138,117,14
060290049012,236,176,60,237,167,70,393,264,117,300,215,63
060290050052,307,229,78,310,220,90,487,329,149,404,290,102
060290050051,179,129,50,178,122,56,277,188,89,192,144,45
060290046052,458,310,148,462,295,167,784,492,282,517,383,103
060290049032,243,173,70,247,165,82,409,264,141,302,226,55
060290052083,667,129,538,671,128,543,817,180,620,732,124,584
060290052082,553,185,368,557,193,364,707,269,425,589,171,383
060290052081,239,76,163,242,83,159,308,110,191,270,75,179
060290055092,322,82,240,325,81,244,478,123,338,387,84,268
060290055101,382,112,270,386,116,270,521,151,354,492,122,330
060290055091,334,89,245,335,84,251,428,100,308,375,78,267
060290055102,362,71,291,367,75,292,569,128,428,512,103,373
060290047021,194,165,29,200,155,45,318,241,61,268,217,33
060290047023,177,147,30,180,136,44,260,197,58,237,191,32
060290047022,114,98,16,115,90,25,172,134,34,135,115,17
060290047042,134,90,44,135,84,51,196,133,63,185,129,46
060290047043,287,190,97,291,178,113,430,280,131,337,228,82
060290047032,90,64,26,90,61,29,159,112,46,84,63,16
060290047031,356,254,102,358,243,115,609,422,172,423,319,81
060290047041,274,199,75,271,190,81,447,316,124,316,242,55
060290001061,478,134,344,486,131,355,870,237,599,646,145,454
060290051031,603,140,463,609,140,469,899,216,668,752,145,569
060290001041,572,110,462,578,113,465,770,167,594,696,123,542
060290001052,677,156,521,683,161,522,1128,258,842,853,161,650
060290001021,454,104,350,462,110,352,719,165,539,596,114,452
060290001022,393,96,297,400,103,297,648,158,474,526,103,396
060290005082,596,133,463,608,140,468,588,112,468,532,84,430
060290005081,410,76,334,415,79,336,508,96,401,466,74,375
060290001051,633,169,464,644,166,478,990,286,685,726,143,530
060290054051,203,75,128,208,73,135,262,101,151,227,79,127
060290054052,429,157,272,435,150,285,673,254,393,501,170,284
060290054061,378,139,239,385,138,247,519,200,295,440,151,243
060290054021,447,153,294,451,156,295,664,235,396,514,166,302
060290054063,520,172,348,531,169,362,701,257,397,611,196,368
060290054022,645,195,450,657,202,455,844,276,524,792,237,489
060290054023,696,242,454,709,239,470,982,364,581,827,253,496
060290054083,436,153,283,443,151,292,678,256,394,509,160,297
060290054082,470,151,319,481,150,331,683,241,411,540,154,338
060290054071,617,208,409,627,214,413,864,264,553,759,221,463
060290054081,473,157,316,482,152,330,664,238,391,523,141,331
060290054084,182,73,109,189,71,118,297,117,173,213,60,132
060290054091,362,123,239,365,116,249,565,208,342,449,130,274
060290054092,784,267,517,791,253,538,1079,381,644,934,267,561
060290054072,644,182,462,650,174,476,1013,288,675,732,175,485
060290053002,227,80,147,231,78,153,372,140,219,229,72,137
060290054093,364,128,236,369,124,245,487,182,285,425,130,256
060290055093,1202,337,865,1219,328,891,1536,469,1012,1294,332,875
060290054062,657,217,440,663,201,462,845,288,527,752,226,458
060290052072,451,177,274,453,178,275,566,249,310,488,175,290
060290054102,210,59,151,216,57,159,253,77,168,232,61,153
060290040011,305,164,141,309,153,156,485,251,222,377,195,165
060290040021,174,89,85,172,81,91,251,123,124,183,94,80
060290040022,526,283,243,530,268,262,829,438,371,576,299,244
060290041011,696,341,355,701,329,372,985,463,506,815,403,369
060290040012,250,158,92,252,144,108,392,229,154,339,211,107
060290041023,198,123,75,199,113,86,305,177,128,256,154,87
060290041012,176,90,86,174,84,90,286,140,141,218,114,97
060290041013,263,126,137,263,116,147,416,190,216,320,155,147
060290041022,155,76,79,157,76,81,240,119,117,187,93,85
060290041021,226,149,77,226,139,87,436,229,197,324,209,105
060290009143,855,312,543,863,309,554,1197,466,709,684,227,419
060290009133,553,195,358,557,195,362,678,253,410,225,73,142
060290009132,332,147,185,337,142,195,555,250,298,809,297,475
060290051044,758,244,514,764,243,521,999,338,641,787,239,519
060290051041,850,231,619,855,232,623,1064,336,715,901,249,619
060290051042,593,153,440,597,160,437,657,195,458,614,163,435
060290005103,340,85,255,343,89,254,498,139,348,406,114,274
060290005101,489,139,350,491,145,346,743,217,512,586,165,399
060290038183,570,176,394,580,173,407,970,343,604,733,209,486
060290038141,597,164,433,602,172,430,952,268,664,691,191,467
060290005102,564,156,408,568,148,420,1120,305,791,659,170,463
060290038142,514,118,396,522,133,389,785,210,562,619,149,444
060290009131,289,136,153,292,129,163,445,206,228,350,149,182
060290056001,301,107,194,312,106,206,435,137,280,345,108,205
060290056002,266,101,165,270,97,173,365,128,233,308,101,183
060290031251,285,194,91,284,197,87,471,314,144,407,269,116
060290030011,321,227,94,328,223,105,534,357,163,414,286,110
060290030012,195,132,63,198,131,67,330,220,104,254,171,70
060290030022,82,62,20,84,59,25,175,113,57,128,88,34
060290031252,169,113,56,171,110,61,291,188,97,247,163,70
060290031332,408,186,222,416,182,234,655,315,328,539,226,279
060290031322,399,203,196,402,185,217,707,368,322,568,262,269
060290031371,280,184,96,286,180,106,457,285,161,369,229,116
060290031372,266,176,90,267,171,96,440,279,151,332,199,115
060290031361,350,231,119,353,222,131,579,355,212,441,270,141
060290031131,451,264,187,457,260,197,737,442,275,579,332,215
060290031132,284,172,112,291,161,130,474,277,188,376,208,152
060290031121,416,200,216,418,202,216,641,336,293,531,236,263
060290031123,288,153,135,294,150,144,430,220,198,383,192,170
060290031331,317,149,168,321,143,178,476,219,242,415,185,210
060290031321,442,210,232,445,202,243,675,318,346,553,249,281
060290032171,342,199,143,344,195,149,565,333,217,427,248,161
060290032102,621,362,259,629,356,273,1043,606,417,879,495,339
060290031122,387,223,164,390,210,180,660,397,235,524,292,201
060290031241,344,174,170,347,171,176,623,329,282,437,214,194
060290032092,349,242,107,353,236,117,640,394,236,458,312,131
060290032161,557,335,222,565,321,244,1010,605,382,767,455,275
060290032112,330,221,109,338,221,117,634,387,236,455,314,127
060290032111,323,208,115,328,206,122,562,358,192,466,316,132
060290031242,513,284,229,518,262,256,891,481,391,649,320,288
060290032181,219,127,92,221,127,94,1010,561,431,103,62,34
060290032182,272,158,114,276,158,118,476,265,203,442,264,151
060290032183,217,125,92,220,126,94,410,228,175,177,106,60
060290029011,304,187,117,305,181,124,500,292,194,382,214,134
060290029012,247,140,107,249,137,112,396,225,160,327,178,128
060290032101,707,443,264,710,429,281,1279,769,479,798,503,251
060290029021,354,232,122,354,224,130,534,303,207,526,330,171
060290029022,402,221,181,410,220,190,619,342,252,523,278,210
060290031301,500,251,249,505,257,248,868,446,395,655,317,294
060290032191,367,241,126,371,236,135,330,192,131,498,296,169
060290032192,647,407,240,659,399,260,1246,701,512,418,220,175
060290060091,453,101,352,452,105,347,548,144,391,477,96,359
060290060101,996,252,744,1008,248,760,1242,378,841,1041,251,739
060290060092,1021,266,755,1026,277,749,1337,391,916,1054,261,747
060290060102,975,235,740,993,236,757,1250,363,871,1032,236,741
060290055113,473,208,265,481,202,279,652,303,327,564,229,294
060290055112,169,73,96,167,69,98,240,112,125,195,80,106
060290055111,598,266,332,610,266,344,856,402,431,604,237,331
060290055081,370,151,219,373,147,226,550,260,276,609,222,347
060290065002,158,46,112,159,44,115,183,55,126,173,39,118
060290055083,349,161,188,350,163,187,536,278,240,440,191,229
060290055122,253,96,157,256,96,160,420,181,219,325,114,186
060290055082,361,123,238,362,125,237,528,214,297,433,149,262
060290055121,530,229,301,539,223,316,755,366,373,626,230,352
060290060062,509,118,391,519,123,396,594,159,418,563,126,407
060290060122,545,111,434,552,112,440,797,173,605,567,106,431
060290060111,934,205,729,946,207,739,1288,311,959,1005,198,759
060290060121,610,133,477,619,130,489,712,169,529,689,144,506
060290065001,352,101,251,361,102,259,435,119,292,416,98,279
060290032221,617,110,507,626,98,528,844,177,654,725,132,564
060290060031,720,189,531,729,195,534,954,249,678,775,179,542
060290060032,378,109,269,383,109,274,492,130,351,421,112,286
060290060033,627,162,465,634,167,467,871,237,605,631,141,443
060290060061,930,207,723,950,213,737,1268,326,901,979,207,719
060290060063,370,76,294,374,79,295,499,124,369,384,78,293
060290060034,349,107,242,356,114,242,525,173,327,448,117,292
060290028132,110,68,42,110,66,44,212,128,81,153,91,48
060290028133,267,188,79,270,182,88,484,314,161,377,226,115
060290028143,354,192,162,359,195,164,546,301,230,455,242,185
060290028242,98,63,35,99,63,36,170,116,50,141,96,34
060290028241,78,51,27,79,50,29,148,99,44,124,84,30
060290028243,118,77,41,118,75,43,209,141,63,155,106,37
060290028141,235,145,90,237,138,99,393,230,151,329,181,127
060290028142,197,120,77,198,116,82,340,200,131,270,149,106
060290028154,217,132,85,214,125,89,342,203,133,301,166,119
060290028151,252,133,119,254,135,119,380,209,156,340,179,137
060290028153,226,119,107,226,121,105,345,189,143,296,155,120
060290028152,138,73,65,138,73,65,235,128,97,184,96,73
060290031341,675,365,310,682,357,325,1280,690,570,1120,574,473
060290031292,168,84,84,174,82,92,317,146,165,233,106,114
060290031291,374,186,188,381,181,200,673,306,346,460,210,224
060290032172,382,225,157,388,218,170,660,376,275,455,247,182
060290031244,178,87,91,180,85,95,270,143,123,213,92,108
060290031243,265,128,137,270,126,144,436,230,200,343,146,168
060290031245,91,43,48,92,43,49,144,75,66,113,49,57
060290059001,114,48,66,119,47,72,143,62,77,153,58,83
060290059002,182,78,104,186,78,108,287,126,153,226,96,119
060290059003,361,161,200,360,153,207,563,241,295,488,196,247
060290060041,492,120,372,496,120,376,570,138,418,527,120,379
060290060042,185,57,128,188,59,129,221,64,155,215,55,149
060290058052,423,159,264,429,152,277,485,202,266,465,165,268
060290058031,273,111,162,277,109,168,429,191,218,329,125,175
060290055131,589,209,380,596,210,386,923,358,535,689,224,402
060290055132,159,64,95,161,63,98,247,102,137,196,71,107
060290058063,226,93,133,228,93,135,355,145,193,263,96,143
060290058032,370,160,210,374,160,214,605,279,306,437,173,229
060290058062,566,214,352,569,211,358,952,388,538,638,234,360
060290058061,334,139,195,338,134,204,525,218,293,482,180,261
060290058043,605,271,334,620,268,352,969,457,472,751,320,359
060290058041,296,135,161,302,132,170,475,227,229,373,160,176
060290058042,13,6,7,13,7,6,20,11,9,20,9,10
060290058051,363,125,238,363,124,239,770,335,414,447,161,253
060290055141,297,60,237,298,57,241,369,97,265,338,69,255
060290028252,321,155,166,321,154,167,499,259,233,436,198,199
060290028251,181,86,95,181,85,96,284,149,125,272,124,126
060290028131,287,142,145,288,139,149,448,245,190,384,186,179
060290061011,459,166,293,465,171,294,663,240,406,597,149,415
060290061024,647,196,451,660,198,462,919,292,601,674,206,416
060290061021,191,68,123,193,75,118,262,98,156,198,58,127
060290061012,528,169,359,534,170,364,711,234,461,520,149,341
060290061022,492,145,347,500,148,352,635,198,417,516,137,341
060290061023,353,100,253,357,99,258,472,142,317,342,113,199
060290061013,240,99,141,241,98,143,356,137,208,292,98,171
060290055142,474,127,347,480,126,354,675,207,452,449,114,312
060290055143,379,94,285,378,92,286,511,141,363,480,112,340
060290065003,190,52,138,191,46,145,274,89,178,217,47,157
060290031311,438,227,211,444,229,215,710,364,331,585,275,267
060290031313,408,209,199,414,211,203,668,342,308,547,255,255
060290031302,432,249,183,437,247,190,776,469,293,565,341,191
060290032091,404,222,182,404,213,191,649,353,281,508,276,203
060290001031,313,90,223,318,97,221,440,130,296,317,75,219
060290001032,197,63,134,199,67,132,301,94,201,323,81,222
060290001033,325,101,224,328,104,224,529,158,357,437,105,302
060290002022,197,68,129,195,71,124,378,118,255,280,74,187
060290002023,269,93,176,271,98,173,513,160,342,365,95,243
060290002014,116,39,77,122,44,78,230,72,153,186,49,129
060290003002,178,60,118,180,62,118,301,102,193,247,72,155
060290003003,136,53,83,137,55,82,253,82,165,190,59,114
060290003004,108,36,72,109,40,69,179,59,115,162,43,107
060290004001,164,58,106,168,63,105,304,97,194,251,73,155
060290004002,188,65,123,190,69,121,340,110,219,277,79,175
060290004003,207,67,140,214,76,138,347,112,229,303,85,202
060290002011,167,52,115,168,54,114,254,82,159,205,53,135
060290002012,161,58,103,162,59,103,283,97,172,232,66,149
060290003001,221,81,140,223,83,140,371,129,225,277,79,185
060290007011,436,215,221,439,213,226,662,336,303,534,243,258
060290007012,267,138,129,263,133,130,385,210,174,344,160,166
060290008002,227,126,101,227,125,102,396,218,170,293,148,132
060290008003,258,141,117,260,140,120,426,224,185,318,151,144
060290008004,207,112,95,210,112,98,301,161,133,250,120,116
060290008006,224,128,96,225,128,97,371,211,141,305,161,122
060290008001,277,159,118,279,157,122,462,270,181,362,195,147
060290009021,511,228,283,515,210,305,745,362,361,595,263,291
060290009141,518,225,293,524,216,308,707,333,365,624,249,340
060290009022,543,270,273,548,273,275,783,382,383,673,293,334
060290009085,162,82,80,162,81,81,279,137,134,216,96,107
060290009031,622,272,350,622,273,349,921,424,474,740,292,397
060290009032,185,80,105,185,80,105,259,127,124,199,87,96
060290009041,244,133,111,243,128,115,386,201,180,315,162,129
060290009043,382,214,168,384,214,170,580,298,271,491,246,219
060290009033,367,180,187,375,179,196,526,271,247,437,189,221
060290009084,296,140,156,299,140,159,443,212,216,356,152,180
060290009082,258,123,135,260,122,138,372,177,180,313,134,159
060290009081,361,158,203,361,149,212,503,228,256,424,165,230
060290006012,353,137,216,357,149,208,516,246,260,426,177,230
060290006011,159,61,98,162,66,96,233,103,125,216,92,114
060290006032,79,47,32,78,44,34,152,91,58,148,88,50
060290006031,91,55,36,91,53,38,209,129,71,178,112,54
060290009092,650,230,420,656,233,423,836,324,492,734,243,458
060290009122,385,157,228,389,158,231,615,283,318,461,177,264
060290009091,496,157,339,498,155,343,661,243,403,609,189,396
060290009142,219,82,137,222,81,141,310,128,175,257,84,158
060290009111,314,147,167,319,143,176,454,219,229,375,162,193
060290009112,377,176,201,381,171,210,531,252,264,449,192,232
060290018011,243,138,105,247,136,111,389,227,152,323,166,138
060290018014,344,185,159,350,177,173,571,309,251,466,221,219
060290018015,367,176,191,370,172,198,575,279,280,484,208,248
060290018012,80,40,40,80,38,42,141,71,68,110,47,57
060290018013,154,88,66,157,87,70,270,158,104,217,111,93
060290018042,311,150,161,314,146,168,417,213,188,378,170,186
060290018041,715,318,397,725,322,403,1017,468,522,850,346,451
060290018031,406,158,248,407,161,246,538,224,309,453,155,275
060290018032,290,111,179,298,114,184,397,168,217,332,106,203
060290018033,167,64,103,170,65,105,309,132,167,216,66,134
060290009083,406,188,218,406,188,218,586,267,297,479,204,245
060290009062,377,205,172,377,199,178,555,288,255,452,230,183
060290009063,148,88,60,150,87,63,237,134,99,187,105,71
060290038062,718,206,512,723,206,517,1027,332,677,807,222,551
060290038061,780,254,526,782,244,538,1090,394,666,925,266,607
060290038063,456,146,310,459,147,312,657,248,394,524,152,345
060290005051,895,194,701,903,204,699,1179,292,874,1007,219,744
060290005052,967,213,754,985,230,755,1274,328,930,1061,216,793
060290010012,496,194,302,496,190,306,699,295,391,613,222,368
060290005071,1007,220,787,1016,227,789,1393,348,1022,1113,233,844
060290005072,429,130,299,436,131,305,656,209,437,548,147,371
060290038181,495,134,361,502,133,369,834,239,574,614,166,408
060290038171,619,170,449,623,180,443,841,244,588,700,193,478
060290006022,123,80,43,125,80,45,255,174,70,183,109,54
060290006021,109,71,38,111,71,40,231,159,66,180,109,53
060290009042,369,207,162,375,211,164,540,274,250,455,229,205
060290011061,164,125,39,166,122,44,267,183,73,206,144,43
060290011072,139,111,28,138,106,32,211,149,56,185,130,38
060290011071,125,87,38,126,85,41,196,132,59,154,112,33
060290009071,511,267,244,513,262,251,727,372,334,627,306,282
060290009061,303,183,120,302,177,125,481,277,196,384,215,142
060290009051,302,160,142,304,157,147,443,237,193,379,194,162
060290009052,276,147,129,282,145,137,423,227,185,348,180,152
060290007022,514,231,283,513,225,288,745,331,393,624,259,322
060290007021,353,140,213,351,138,213,501,207,284,421,159,239
060290038111,603,145,458,611,152,459,1076,288,760,680,148,489
060290038112,332,78,254,334,85,249,481,104,365,413,79,315
060290038123,320,97,223,324,102,222,290,83,200,295,70,209
060290002021,148,54,94,150,63,87,267,100,163,236,56,156
060290011013,158,102,56,160,104,56,337,225,105,268,170,84
060290011011,230,159,71,234,163,71,385,267,113,328,215,88
060290011012,191,101,90,193,104,89,330,180,143,338,173,145
060290009121,320,110,210,326,129,197,469,193,270,405,161,227
060290002013,142,47,95,144,49,95,270,89,171,203,57,141
060290011051,89,63,26,88,58,30,149,100,45,124,88,31
060290011052,158,112,46,158,104,54,258,168,76,218,152,53
060290011053,158,115,43,164,108,56,269,183,83,213,153,55
060290011041,160,98,62,160,97,63,231,149,77,226,136,71
060290011042,171,104,67,172,104,68,278,178,91,232,143,73
060290005041,932,166,766,945,166,779,1203,254,927,1104,170,883
060290005042,387,120,267,389,118,271,609,207,386,484,131,328
060290005043,250,83,167,254,86,168,383,138,234,325,98,209
060290010032,386,241,145,392,238,154,619,366,236,482,287,170
060290010031,182,106,76,180,103,77,350,203,132,253,137,97
060290010022,244,138,106,247,136,111,466,264,191,339,194,124
060290010021,236,135,101,239,134,105,389,224,158,343,200,121
060290010013,208,99,109,207,98,109,340,153,172,276,120,137
060290038073,590,116,474,595,118,477,779,157,603,660,114,509
060290038102,655,154,501,664,154,510,927,252,663,733,160,541
060290038071,382,82,300,383,90,293,601,120,472,503,89,387
060290023031,172,118,54,173,117,56,235,143,85,201,140,59
060290023032,218,159,59,226,156,70,344,220,110,259,192,56
060290023041,206,156,50,208,141,67,312,215,90,257,177,67
060290023042,129,99,30,130,88,42,199,137,57,174,118,46
060290023051,149,113,36,148,106,42,222,160,58,198,150,37
060290023052,300,230,70,299,215,84,445,316,113,390,280,78
060290038172,456,136,320,454,129,325,676,220,446,540,154,358
060290038122,497,221,276,502,219,283,817,351,439,616,221,356
060290038173,605,180,425,610,179,431,800,253,519,699,181,464
060290038121,652,231,421,661,234,427,879,313,543,765,245,483
060290005061,524,173,351,536,177,359,809,285,510,345,98,224
060290005062,69,23,46,69,23,46,106,38,66,223,65,144
060290005063,73,24,49,73,24,49,106,39,67,247,72,158
060290038082,248,91,157,251,87,164,403,157,233,293,92,182
060290038083,498,162,336,499,165,334,805,285,493,621,209,372
060290038182,550,135,415,551,134,417,778,207,557,661,145,479
060290038211,772,257,515,783,258,525,1104,401,679,923,286,589
060290038203,399,137,262,402,144,258,591,231,350,486,157,310
060290038072,319,82,237,323,83,240,478,126,345,370,84,266
060290038081,668,186,482,679,184,495,1001,294,687,802,185,578
060290023033,259,159,100,263,155,108,361,200,146,319,200,98
060290028041,764,238,526,772,251,521,957,329,614,848,257,565
060290028042,744,232,512,752,252,500,891,323,559,818,262,533
060290028071,822,177,645,835,182,653,978,254,708,923,217,676
060290028073,295,108,187,296,109,187,404,167,231,367,133,217
060290028074,522,147,375,530,150,380,699,222,465,603,184,396
060290028181,788,295,493,795,297,498,1049,432,594,943,327,567
060290028182,779,297,482,783,295,488,1053,459,573,892,313,532
060290028192,711,326,385,714,311,403,1054,495,543,880,379,443
060290028191,555,227,328,564,238,326,876,385,463,705,288,390
060290028171,294,148,146,297,147,150,419,209,193,382,170,181
060290028173,222,120,102,227,122,105,359,204,144,318,169,130
060290028174,272,140,132,277,140,137,409,212,183,356,169,162
060290028172,285,155,130,291,155,136,449,231,202,353,166,160
060290028164,218,122,96,222,126,96,393,225,152,309,159,130
060290028163,205,116,89,208,116,92,344,182,151,276,135,122
060290028162,364,206,158,365,207,158,618,357,242,486,251,205
060290038263,604,142,462,611,139,472,334,101,227,520,104,395
060290038251,647,182,465,654,177,477,1100,331,743,776,199,539
060290038143,884,229,655,895,211,684,1437,398,1014,1102,264,789
060290028201,539,231,308,555,239,316,823,371,440,636,263,338
060290028161,202,111,91,206,111,95,317,183,125,264,144,106
060290038221,558,139,419,567,140,427,820,239,563,619,147,443
060290038201,534,137,397,544,139,405,749,223,511,636,161,441
060290038213,306,68,238,309,66,243,400,97,300,351,73,261
060290038151,765,257,508,777,251,526,1245,393,823,960,275,618
060290038161,419,106,313,424,108,316,733,233,480,579,149,404
060290038162,681,160,521,681,149,532,1006,223,767,835,191,607
060290038101,625,143,482,630,139,491,774,200,565,694,148,518
060290038191,479,144,335,483,143,340,688,236,444,619,186,401
060290038194,306,93,213,307,93,214,489,173,313,270,83,173
060290032031,1242,304,938,1253,303,950,1701,485,1170,1378,302,1012
060290028072,280,110,170,281,110,171,372,159,205,328,123,188
060290028111,993,242,751,995,243,752,1279,415,845,1047,304,705
060290028211,463,200,263,468,197,271,700,304,375,577,221,319
060290028212,332,132,200,336,130,206,509,208,293,437,172,250
060290028062,404,176,228,410,175,235,524,258,249,463,217,221
060290028061,179,76,103,182,75,107,258,124,126,202,91,99
060290038152,467,128,339,476,126,350,811,241,552,589,153,407
060290038153,491,129,362,496,130,366,780,245,519,642,154,460
060290028222,690,204,486,696,200,496,902,323,564,741,213,490
060290028223,429,134,295,434,135,299,561,211,339,466,161,279
060290028113,439,158,281,447,164,283,592,258,327,512,181,306
060290028112,446,161,285,453,168,285,630,273,345,540,191,320
060290028233,517,263,254,531,255,276,787,385,380,622,282,307
060290028231,208,104,104,213,102,111,351,177,166,283,124,139
060290028232,412,207,205,418,200,218,615,310,291,505,221,251
060290038212,748,204,544,754,190,564,1099,361,714,881,253,590
060290038202,514,116,398,515,117,398,656,189,463,569,148,401
060290028213,597,281,316,604,273,331,1399,641,718,723,279,391
060290028204,266,118,148,270,113,157,476,219,243,357,137,191
060290028205,373,173,200,375,164,211,528,247,268,464,188,248
060290031352,440,234,206,444,226,218,739,394,339,554,267,254
060290032201,376,194,182,376,187,189,777,388,376,335,156,160
060290028202,399,199,200,400,189,211,653,307,323,478,206,249
060290028221,618,216,402,619,220,399,770,318,437,687,229,417
060290032121,909,303,606,920,295,625,1300,542,732,1049,355,642
060290032123,466,166,300,467,157,310,706,304,396,464,167,279
060290032124,498,208,290,501,200,301,765,361,390,582,241,318
060290032122,468,196,272,471,188,283,713,338,362,545,224,298
060290032131,471,135,336,475,130,345,970,356,593,343,112,210
060290066001,205,118,87,208,111,97,303,137,161,231,132,89
060290033031,421,70,351,429,83,346,503,92,401,430,57,351
060290033043,56,23,33,57,23,34,84,37,47,79,35,44
060290034003,187,49,138,185,57,128,327,86,228,261,67,183
060290034002,183,49,134,182,54,128,293,75,209,253,65,177
060290034001,202,52,150,204,61,143,316,83,225,271,70,192
060290035005,339,54,285,343,56,287,572,96,464,469,72,386
060290033051,563,197,366,577,204,373,795,273,498,547,164,339
060290033052,185,68,117,189,70,119,275,95,175,213,69,129
060290033053,456,165,291,467,173,294,680,252,408,545,171,322
060290033082,450,136,314,462,144,318,561,173,375,605,177,396
060290038272,290,40,250,292,43,249,426,76,344,314,49,254
060290038231,832,122,710,841,126,715,1136,210,905,914,131,757
060290038271,458,94,364,462,94,368,711,155,540,508,95,383
060290038222,828,139,689,837,135,702,1120,215,888,922,147,743
060290045001,88,77,11,89,69,20,201,160,31,127,115,7
060290045002,143,73,70,143,67,76,240,132,105,145,77,64
060290033041,338,59,279,339,62,277,498,93,399,431,77,331
060290033042,262,32,230,265,34,231,341,37,300,386,56,311
060290033071,461,213,248,461,204,257,639,301,331,435,179,231
060290033081,306,106,200,313,109,204,398,133,256,359,103,231
060290038262,358,51,307,364,55,309,469,83,379,357,56,288
060290038261,230,33,197,233,34,199,1331,273,1033,271,49,215
060290038242,952,158,794,962,159,803,1251,275,955,981,186,758
060290038192,277,60,217,285,61,224,370,84,282,320,69,245
060290038193,449,98,351,458,98,360,609,138,463,550,115,422
060290038241,59,8,51,60,9,51,75,11,63,66,13,51
060290038232,1005,167,838,1018,160,858,1397,271,1107,1141,189,908
060290036001,74,18,56,74,17,57,109,30,79,109,21,86
060290036002,145,35,110,150,35,115,232,56,173,207,44,155
060290035003,132,45,87,135,48,87,204,57,142,140,43,90
060290036004,263,63,200,263,60,203,445,111,321,370,71,278
060290036003,245,39,206,245,38,207,337,61,266,294,43,242
060290035002,238,62,176,245,70,175,342,83,253,244,57,180
060290035004,424,56,368,432,62,370,560,87,464,498,69,423
060290035001,429,76,353,431,81,350,583,104,464,517,76,421
060290044031,291,186,105,297,179,118,466,253,199,362,227,110
060290044032,188,115,73,192,108,84,320,170,141,217,141,60
060290044021,203,141,62,203,139,64,249,159,87,274,176,81
060290044022,74,52,22,75,52,23,115,76,39,91,71,16
060290044042,275,145,130,272,134,138,458,216,233,254,127,117
060290044043,330,209,121,337,196,141,502,276,216,380,258,99
060290044041,303,126,177,304,122,182,425,184,225,374,151,196
060290043032,203,145,58,205,134,71,343,221,112,293,186,85
060290043051,267,125,142,269,121,148,464,234,222,310,149,137
060290043031,473,329,144,478,309,169,771,503,246,598,372,186
060290044023,202,142,60,204,132,72,306,205,96,240,189,36
060290043041,239,151,88,245,139,106,528,310,206,335,200,105
060290031351,727,408,319,736,393,343,802,437,352,624,349,243
060290032213,517,254,263,519,249,270,991,479,487,669,297,328
060290028203,451,180,271,457,178,279,650,276,364,539,214,288
060290031031,138,94,44,138,90,48,235,145,80,190,121,61
060290031032,197,133,64,200,132,68,327,210,105,272,182,74
060290031033,136,90,46,139,89,50,204,133,68,173,111,54
060290063011,313,231,82,319,226,93,485,341,127,392,296,75
060290063012,170,123,47,175,119,56,269,186,78,205,152,49
060290063031,262,210,52,258,196,62,423,320,95,359,285,56
060290063041,157,126,31,154,116,38,276,211,61,220,181,36
060290063042,148,122,26,154,117,37,251,192,57,212,172,35
060290063043,54,44,10,54,41,13,89,65,19,77,62,12
060290063033,115,93,22,117,90,27,205,154,47,144,116,20
060290063032,149,120,29,151,115,36,206,154,48,184,143,26
060290062023,293,244,49,293,223,70,372,275,84,165,134,22
060290062024,141,120,21,144,110,34,248,188,57,256,210,36
060290062021,147,123,24,147,113,34,248,185,57,193,153,26
060290062022,112,50,62,116,50,66,360,228,121,218,124,85
060290012022,140,112,28,138,106,32,259,180,70,213,167,34
060290012023,97,82,15,104,78,26,156,113,40,165,129,24
060290013012,115,94,21,118,88,30,177,123,49,150,119,23
060290013014,51,40,11,50,38,12,98,71,25,91,69,17
060290013011,150,126,24,148,111,37,270,190,69,215,171,31
060290013021,95,74,21,97,72,25,175,113,47,148,106,27
060290014012,127,99,28,129,99,30,206,142,54,183,135,38
060290014013,242,153,89,245,155,90,405,248,146,361,220,117
060290013013,57,46,11,57,42,15,114,78,32,102,73,25
060290013022,79,62,17,76,53,23,145,100,42,145,104,36
060290015001,156,117,39,158,119,39,228,151,69,248,184,48
060290015002,81,60,21,83,61,22,120,84,35,103,80,22
060290015003,97,73,24,98,73,25,144,102,39,137,102,27
060290021001,46,40,6,47,40,7,94,74,18,66,57,6
060290021003,101,87,14,103,84,19,151,121,26,152,133,11
060290021004,73,62,11,75,62,13,137,110,25,119,107,9
060290022021,114,96,18,115,96,19,206,165,39,180,154,17
060290022022,83,71,12,83,70,13,154,121,29,123,110,10
060290022023,116,99,17,115,96,19,188,153,35,176,154,16
060290021002,88,77,11,86,73,13,129,100,23,125,109,10
060290022011,118,106,12,121,100,21,185,145,32,172,154,12
060290022012,103,91,12,103,85,18,143,118,25,137,126,9
060290031281,304,233,71,300,225,75,652,459,178,337,248,69
060290031272,198,155,43,201,149,52,343,236,95,293,211,64
060290016002,168,117,51,167,114,53,284,187,93,213,113,85
060290017001,366,159,207,372,156,216,497,232,239,389,158,201
060290017002,401,176,225,406,177,229,497,247,244,485,206,245
060290017003,646,281,365,657,279,378,879,372,486,717,265,407
060290032072,376,275,101,379,265,114,600,411,175,453,334,96
060290017004,208,107,101,210,104,106,272,130,133,260,123,115
060290016001,276,184,92,281,188,93,462,276,163,297,180,91
060290020011,186,151,35,187,151,36,306,242,62,243,204,32
060290020012,237,196,41,241,191,50,411,308,78,371,312,40
060290020022,258,210,48,261,211,50,434,338,87,384,319,52
060290020021,164,136,28,164,132,32,304,229,60,254,215,25
060290032141,161,139,22,160,133,27,331,244,80,197,147,40
060290032082,290,238,52,295,224,71,481,337,126,390,286,83
060290025013,233,182,51,232,171,61,341,241,89,287,233,41
060290026001,141,109,32,142,105,37,219,154,57,202,145,43
060290026003,208,164,44,211,155,56,305,223,75,247,185,52
060290025031,163,134,29,165,134,31,246,204,38,224,181,36
060290026002,173,138,35,176,135,41,295,197,89,252,190,46
060290032071,386,298,88,389,284,105,671,475,181,515,391,91
060290031261,175,121,54,180,124,56,300,213,81,253,174,63
060290031263,279,188,91,278,184,94,452,286,153,340,234,89
060290032081,375,296,79,378,289,89,612,448,148,473,358,84
060290024032,88,65,23,92,65,27,173,132,38,155,121,23
060290025021,122,110,12,126,108,18,219,162,49,204,177,16
060290025032,97,88,9,97,85,12,176,134,40,171,149,13
060290024021,231,166,65,235,156,79,411,257,141,459,313,122
060290024022,268,192,76,272,183,89,571,362,198,189,136,51
060290031262,193,134,59,197,137,60,318,221,82,262,177,65
060290031282,411,265,146,418,251,167,653,387,251,533,323,182
060290031271,360,276,84,367,260,107,615,421,182,490,355,109
060290019022,181,103,78,186,104,82,289,174,107,254,131,99
060290019023,164,94,70,165,96,69,274,166,99,227,121,88
060290019024,347,195,152,348,192,156,523,303,198,454,232,180
060290019021,163,104,59,168,101,67,307,172,126,217,118,77
060290019011,287,149,138,295,148,147,436,231,191,374,175,166
060290019012,306,152,154,311,146,165,435,216,206,348,156,168
060290019013,208,104,104,211,104,107,304,155,145,268,123,130
060290019014,171,92,79,174,90,84,261,146,110,230,112,99
060290030021,205,150,55,208,151,57,338,223,102,264,193,62
060290032142,242,94,148,247,90,157,347,146,196,318,116,189
060290032151,456,181,275,464,172,292,625,269,342,575,213,333
060290025012,134,109,25,135,105,30,219,165,47,169,130,33
060290027021,127,78,49,126,75,51,237,136,100,197,98,82
060290027012,178,98,80,176,91,85,291,160,123,258,133,112
060290027011,318,174,144,327,170,157,499,272,211,415,214,175
060290027022,203,116,87,205,117,88,345,196,139,279,153,114
060290027023,147,84,63,149,85,64,251,141,100,178,97,74
060290024011,460,240,220,459,223,236,708,352,344,556,273,254
060290024031,188,87,101,192,83,109,314,146,163,275,120,143
060290025011,157,138,19,159,137,22,245,183,52,235,189,36
060290064041,180,131,49,181,129,52,229,160,66,209,156,44
060290064042,145,115,30,146,111,35,202,144,50,154,123,24
060290014021,144,111,33,144,106,38,248,178,66,207,154,45
060290014022,186,143,43,186,140,46,290,208,73,262,190,56
060290014011,151,119,32,154,119,35,246,178,65,218,161,45
060290012021,69,55,14,68,49,19,136,90,37,122,92,19
060290012024,45,37,8,45,33,12,84,60,24,77,60,12
060290064034,92,78,14,94,71,23,139,108,31,112,92,18
060290064033,205,170,35,205,152,53,301,229,67,259,193,39
060290064031,131,101,30,132,100,32,207,160,40,171,131,31
060290064032,101,78,23,102,77,25,160,124,32,127,96,26
060290064061,176,149,27,179,144,35,278,220,53,221,181,32
060290064062,173,144,29,175,140,35,280,211,54,220,174,32
060290064052,141,119,22,141,113,28,230,180,43,180,144,27
060290064063,162,138,24,164,132,32,232,187,45,184,155,26
060290064051,159,120,39,158,117,41,230,156,72,176,128,42
060290023021,158,129,29,159,127,32,250,190,55,214,172,34
060290023022,170,142,28,170,138,32,251,192,55,244,195,39
060290012011,242,189,53,239,179,60,368,252,106,303,218,61
060290012012,131,104,27,134,100,34,186,130,56,173,127,36
060290051032,405,73,332,410,80,330,501,95,403,456,95,341
060290046051,148,29,119,146,27,119,171,40,129,170,36,127
060290066003,533,142,391,533,138,395,697,189,503,603,149,426
060290039002,126,26,100,127,27,100,154,36,117,146,37,104
060290046011,0,0,0,0,0,0,0,0,0,1,1,0
060290053001,26,21,5,28,22,6,58,39,17,56,20,21
060290039001,340,97,243,347,104,243,890,346,522,100,24,74
060290032202,283,108,175,288,110,178,1269,626,613,243,87,142
060290032203,139,37,102,141,36,105,320,141,173,463,205,237
060290032152,338,144,194,341,139,202,518,238,270,413,176,222
060290062012,218,76,142,220,69,151,332,132,192,264,104,148
060290062011,188,102,86,189,93,96,289,149,131,243,129,107
060290057001,61,32,29,62,32,30,144,84,49,74,32,38
060290057002,6,3,3,6,3,3,11,6,4,52,20,25
060290010011,206,82,124,204,85,119,292,116,168,235,80,143
060290032212,133,51,82,139,57,82,644,294,338,23,13,10
060290066002,222,69,153,224,67,157,366,136,220,277,97,162
060290032211,90,35,55,91,40,51,353,172,172,39,24,14
060290032083,241,176,65,242,172,70,688,435,231,294,204,77
061050001011,256,99,157,261,94,167,775,319,433,603,216,342
061050001021,980,431,549,993,399,594,437,213,214,305,135,150
061050001012,892,401,491,914,386,528,1031,474,518,965,383,478
061050001022,575,246,329,587,229,358,710,300,382,945,349,500
061050001013,240,119,121,242,111,131,740,360,344,221,96,99
061050001023,475,205,270,484,194,290,575,264,298,608,242,307
061050005001,200,93,107,203,92,111,262,114,136,223,93,107
061050005002,265,133,132,270,125,145,365,182,167,268,112,132
061050005003,190,82,108,190,79,111,219,93,117,190,68,102
061050002001,505,275,230,511,272,239,627,336,270,737,354,300
061050002002,302,149,153,301,143,158,181,90,88,147,57,74
061050005004,369,134,235,369,126,243,336,106,221,376,109,221
060090003012,501,194,307,514,183,331,615,211,389,540,181,320
060090003013,547,206,341,556,190,366,686,232,438,598,192,359
060090001242,845,277,568,866,273,593,1456,467,954,619,204,377
060090001211,750,304,446,769,291,478,1004,376,601,962,340,539
060090002203,726,224,502,743,211,532,977,280,682,817,212,556
060090003011,757,317,440,779,308,471,942,360,562,961,365,520
060090003021,694,291,403,718,279,439,797,321,452,688,259,364
060090002213,987,340,647,1007,325,682,1318,411,872,1062,327,665
060090002212,776,249,527,788,226,562,1026,305,705,845,249,548
060090002211,878,231,647,898,220,678,1179,317,838,974,238,686
060090002221,967,289,678,989,274,715,1324,378,916,1089,290,735
060090002222,929,223,706,949,224,725,1305,315,965,1160,278,823
060090003022,505,231,274,515,226,289,549,246,284,419,169,209
060090004004,200,86,114,203,79,124,246,105,137,232,88,124
060090001222,228,97,131,233,96,137,269,115,151,242,94,132
060090004001,374,139,235,383,130,253,494,183,297,407,132,237
060090004005,192,81,111,197,74,123,258,104,147,231,78,131
060090004006,182,76,106,190,71,119,239,95,139,217,75,123
060090004002,172,63,109,177,60,117,206,73,127,190,58,112
060090004003,413,158,255,424,147,277,526,205,310,456,171,249
060090005011,598,293,305,604,288,316,758,392,347,784,349,379
060090005012,958,488,470,985,480,505,1149,598,528,984,482,434
060090005041,206,106,100,206,103,103,239,132,105,215,109,94
060090005042,86,45,41,88,44,44,110,61,49,84,45,39
060090005061,443,224,219,458,224,234,522,278,232,493,239,217
060090005051,310,148,162,314,148,166,397,195,193,336,138,173
060090005052,250,124,126,255,123,132,293,151,133,246,111,113
060090001221,1109,584,525,1140,569,571,1357,704,621,1130,526,520
060090001223,810,369,441,838,361,477,978,439,520,882,366,452
060090001213,712,282,430,729,269,460,894,364,510,732,264,418
060090001212,621,253,368,632,238,394,762,310,436,658,242,369
060090001232,617,201,416,631,192,439,579,185,383,661,187,441
060090001241,562,183,379,576,171,405,737,232,491,628,173,419
060090001231,676,225,451,685,225,460,939,300,612,733,220,467
060090002202,727,225,502,743,212,531,880,262,602,809,231,540
060090002201,812,236,576,828,231,597,1154,344,790,955,262,627
060350402002,255,105,150,258,99,159,344,139,202,323,110,182
060350402001,364,145,219,363,141,222,437,168,268,355,108,208
060350402003,398,94,304,397,87,310,560,128,425,485,105,352
060350403022,620,115,505,631,113,518,798,148,638,805,140,635
060350404001,703,108,595,703,94,609,907,127,766,672,105,538
060350405001,595,110,485,602,108,494,755,130,612,747,124,582
060350405002,742,138,604,748,138,610,988,169,803,829,143,643
060350406001,419,115,304,426,112,314,570,150,408,487,112,346
060350403021,440,90,350,446,85,361,639,124,500,673,120,515
060350403023,666,163,503,672,159,513,908,201,694,670,135,493
060350403031,360,84,276,362,81,281,644,162,475,503,112,363
060350401001,228,30,198,229,34,195,285,51,230,273,33,232
060350401002,334,58,276,341,58,283,418,88,319,390,73,298
060350403033,222,61,161,229,58,171,305,79,217,260,73,170
060350403051,658,174,484,665,170,495,896,246,635,761,182,541
060350403053,406,123,283,410,119,291,545,152,382,468,130,311
060350403032,335,79,256,338,82,256,416,112,296,356,88,242
060350406003,217,52,165,225,52,173,261,59,200,256,43,197
060350403042,169,48,121,168,49,119,257,86,160,215,58,132
060350403041,280,86,194,284,80,204,550,162,368,354,99,225
060350403052,295,91,204,299,87,212,236,67,161,343,103,214
060350401003,139,19,120,142,21,121,178,37,139,141,17,113
060350406002,19,6,13,20,9,11,16,5,11,38,8,28
060350404002,58,7,51,58,7,51,72,9,61,18,3,14
060110001001,201,87,114,208,84,124,275,125,136,215,93,105
060110001002,336,120,216,340,109,231,462,168,287,380,136,225
060110001003,586,258,328,591,232,359,822,355,455,641,297,311
060110001004,365,160,205,372,144,228,501,214,280,428,198,206
060110003021,264,85,179,272,79,193,364,136,219,313,106,191
060110002001,403,165,238,412,149,263,577,246,315,485,205,246
060110002003,296,124,172,307,111,196,437,191,241,370,156,192
060110002005,187,51,136,197,48,149,271,83,182,205,58,134
060110002004,398,122,276,405,110,295,489,165,313,439,137,273
060110003012,384,207,177,390,195,195,611,330,265,494,270,191
060110003022,232,170,62,235,157,78,400,275,114,315,232,65
060110003011,194,113,81,196,104,92,323,191,127,255,156,84
060110002002,441,122,319,449,104,345,620,175,427,511,136,339
060110004001,219,54,165,221,44,177,259,70,187,257,55,188
060110004002,281,64,217,286,56,230,364,97,263,305,77,216
060110004003,199,61,138,202,54,148,283,73,207,226,64,151
060110005001,96,33,63,96,31,65,145,50,92,119,38,72
060110005002,146,63,83,150,53,97,222,102,119,170,72,90
060110005003,259,83,176,260,76,184,300,100,192,285,98,170
060110005004,168,64,104,174,59,115,236,93,138,183,77,102
060390011005,260,78,182,259,81,178,337,115,220,294,96,193
060390011001,194,71,123,200,67,133,255,110,143,282,102,156
060390011004,246,103,143,242,85,157,284,132,149,247,99,134
060390005171,577,234,343,583,227,356,601,263,325,565,233,296
060390005161,977,264,713,993,258,735,1336,399,896,1097,276,760
060390005142,469,174,295,480,172,308,942,364,561,751,271,440
060390005141,170,62,108,173,61,112,260,102,156,189,70,113
060390005144,198,116,82,201,112,89,330,190,136,157,103,45
060390005143,274,211,63,272,196,76,479,354,110,360,265,68
060390005062,1063,511,552,1082,483,599,756,374,363,616,294,283
060390005151,261,156,105,264,146,118,427,253,161,331,193,119
060390006041,180,137,43,180,126,54,269,195,70,186,129,48
060390006043,228,177,51,233,164,69,365,264,93,250,173,62
060390006042,85,66,19,87,61,26,146,103,36,90,61,22
060390005094,918,249,669,923,240,683,1311,377,907,1024,254,721
060390005093,491,132,359,494,127,367,1560,518,995,537,132,375
060390011002,1163,355,808,1175,337,838,1170,399,751,1022,278,706
060390001023,183,60,123,189,61,128,358,112,233,387,106,264
060390005091,870,237,633,873,226,647,1062,325,728,919,236,642
060390005092,426,117,309,430,109,321,557,169,382,469,119,333
060390002042,317,72,245,322,75,247,301,77,217,303,71,218
060390002031,174,38,136,179,37,142,224,57,165,185,39,139
060390002032,165,48,117,175,47,128,254,88,165,209,63,142
060390002011,107,53,54,106,49,57,307,159,140,265,132,116
060390002043,981,304,677,989,296,693,1243,407,818,1037,329,665
060390002012,137,69,68,138,65,73,217,116,97,182,93,74
060390005061,422,203,219,433,190,243,606,302,300,497,238,231
060390005063,514,245,269,522,227,295,804,394,384,608,288,279
060390005152,688,327,361,697,304,393,930,456,447,822,383,375
060390003022,388,138,250,389,137,252,587,212,359,483,155,294
060390002041,288,116,172,288,110,178,789,284,488,553,176,346
060390003025,175,53,122,176,54,122,262,86,174,203,61,131
060390003012,176,75,101,179,75,104,347,156,181,240,111,115
060390003013,259,108,151,265,106,159,210,90,118,163,76,84
060390003024,120,48,72,125,50,75,190,81,109,147,60,86
060390003023,129,51,78,129,48,81,190,77,112,148,53,89
060390003021,215,89,126,219,86,133,327,133,186,257,99,143
060390003011,255,105,150,260,102,158,423,169,239,319,138,165
060390005122,757,300,457,766,297,469,1251,544,667,1539,630,825
060390005121,790,385,405,799,359,440,1110,553,543,785,382,340
060390005133,349,167,182,356,163,193,490,270,208,388,205,154
060390005132,266,65,201,264,76,188,389,122,254,310,85,214
060390005111,152,99,53,152,93,59,387,240,140,279,184,76
060390005112,296,189,107,299,177,122,490,297,179,323,207,95
060390005102,424,292,132,434,272,162,744,484,237,482,315,125
060390005113,545,388,157,549,367,182,1065,687,340,561,380,138
060390008011,222,130,92,221,123,98,169,97,70,142,77,57
060390007011,956,439,517,972,413,559,1454,677,749,1200,526,602
060390008021,102,55,47,105,49,56,165,90,69,123,68,47
060390008024,87,49,38,87,44,43,131,76,53,92,55,34
060390008012,206,125,81,208,121,87,300,185,111,260,145,103
060390009021,125,99,26,125,91,34,204,144,60,153,120,33
060390007023,353,177,176,355,166,189,491,246,227,454,208,219
060390007022,382,187,195,385,179,206,653,318,328,550,250,274
060390007024,170,83,87,173,81,92,286,139,140,222,103,109
060390007021,834,355,479,851,347,504,1255,579,647,471,194,249
060390007012,457,218,239,464,210,254,866,409,434,677,302,332
060390005131,401,193,208,406,187,219,570,319,242,428,228,167
060390006023,114,87,27,114,86,28,205,157,44,143,111,27
060390005101,301,194,107,305,170,135,484,313,163,364,226,121
060390009032,212,166,46,216,160,56,383,264,108,269,199,53
060390009022,158,124,34,157,116,41,280,195,78,195,141,40
060390009011,141,114,27,142,108,34,182,128,46,133,101,23
060390009012,140,113,27,141,106,35,247,177,64,191,148,34
060390009031,118,96,22,123,92,31,192,136,48,152,113,27
060390006021,191,105,86,196,93,103,271,150,116,230,128,87
060390006033,185,139,46,186,132,54,321,224,88,208,160,36
060390006032,84,62,22,85,60,25,153,107,41,107,81,19
060390006031,188,139,49,189,134,55,330,231,92,230,176,42
060390006022,126,93,33,130,93,37,220,167,46,162,124,31
060390008022,69,51,18,73,50,23,118,82,31,98,68,23
060390008023,63,45,18,66,44,22,91,61,25,82,56,20
060390005182,115,80,35,116,78,38,169,110,57,154,106,37
060390005181,187,131,56,188,124,64,269,174,93,254,180,60
060390001032,477,159,318,484,158,326,741,267,461,649,198,414
060390001033,595,189,406,600,185,415,754,248,493,660,200,420
060390001034,633,201,432,643,199,444,774,250,513,677,206,435
060390001112,805,256,549,808,250,558,645,212,421,567,163,372
060390001091,669,184,485,675,183,492,864,251,600,745,192,516
060390001021,303,96,207,307,100,207,578,205,361,519,168,331
060390001022,302,110,192,308,108,200,355,133,213,316,104,197
060390001031,751,258,493,759,250,509,831,301,515,768,239,487
060390001043,359,119,240,361,118,243,420,152,259,375,115,240
060390001044,718,239,479,726,237,489,841,301,520,783,242,496
060390001024,333,126,207,339,121,218,403,154,239,352,120,214
060390001025,415,155,260,422,150,272,513,194,303,478,159,286
060390001111,467,157,310,470,153,317,577,206,359,533,159,342
060390001041,361,121,240,364,119,245,467,169,284,386,119,242
060390001042,546,184,362,547,179,368,707,258,431,592,183,373
060390001061,1276,423,853,1292,424,868,2054,677,1322,1437,433,922
060390001062,684,229,455,692,229,463,873,309,539,727,224,459
060390001101,325,100,225,328,100,228,438,139,294,406,114,274
060390001102,682,208,474,688,206,482,901,288,600,733,206,488
060390001104,275,83,192,276,81,195,373,120,249,309,88,205
060390001103,572,175,397,576,173,403,689,220,456,611,172,407
060390001063,592,198,394,597,198,399,832,281,530,712,209,463
060390001092,641,160,481,648,168,480,344,85,254,314,75,226
061030002021,1152,326,826,1166,302,864,849,191,642,1377,351,943
061030002023,692,177,515,702,164,538,965,216,731,807,186,578
061030002022,372,109,263,375,99,276,679,151,514,449,119,301
061030003001,1158,270,888,1171,259,912,1704,391,1270,1462,325,1068
061030004003,794,190,604,804,176,628,999,268,719,840,201,605
061030004002,965,214,751,973,200,773,996,237,742,839,186,613
061030005001,451,137,314,454,127,327,796,290,481,505,139,333
061030004001,913,239,674,928,217,711,1146,320,807,997,250,705
061030005002,329,114,215,335,111,224,452,159,287,399,127,245
061030005003,151,54,97,154,52,102,474,188,280,225,78,140
061030005004,225,91,134,225,87,138,364,151,207,266,99,154
061030006001,695,270,425,700,237,463,897,323,549,660,215,400
061030007013,165,64,101,167,63,104,236,102,126,192,66,112
061030007011,500,171,329,507,156,351,779,257,500,586,171,373
061030008001,308,90,218,315,83,232,432,125,294,379,104,244
061030008002,237,66,171,238,63,175,299,86,209,269,73,177
061030007021,329,133,196,335,129,206,510,200,295,406,144,228
061030007022,492,167,325,503,155,348,577,192,357,506,176,295
061030007012,340,127,213,344,118,226,654,232,394,503,176,287
061030001001,375,135,240,376,122,254,484,153,316,437,124,271
061030002011,507,142,365,510,124,386,572,155,405,456,125,307
061030002012,914,254,660,923,223,700,1448,394,1012,1074,288,734
061030006002,614,198,416,627,180,447,963,319,625,747,226,480
061030006003,665,188,477,672,168,504,679,194,470,551,146,369
061030001004,335,101,234,334,84,250,622,174,432,489,126,332
061030001002,803,222,581,818,204,614,1252,349,869,1024,255,707
061030001003,267,82,185,269,70,199,358,105,247,304,80,213
061030003003,328,94,234,331,87,244,465,134,320,421,108,287
061030010002,779,222,557,785,211,574,1074,330,727,925,284,605
061030011011,322,87,235,321,76,245,552,185,357,350,93,241
061030011012,333,87,246,341,81,260,397,124,267,353,92,246
061030011022,294,118,176,295,104,191,475,194,264,372,149,189
061030011024,302,118,184,305,105,200,462,193,264,405,165,207
061030008003,195,58,137,197,56,141,278,83,190,220,65,146
061030009001,289,75,214,288,74,214,474,136,325,363,101,249
061030003002,321,143,178,320,134,186,453,196,243,384,148,212
061030010001,599,163,436,604,154,450,769,234,522,657,184,440
061030010004,400,142,258,403,133,270,493,192,297,439,166,254
061030008004,225,87,138,228,84,144,290,122,162,263,106,135
061030011021,209,81,128,213,75,138,192,75,104,290,107,161
061030011023,146,56,90,152,53,99,227,94,130,195,74,107
061030009002,455,171,284,463,150,313,532,193,325,440,142,274
061030009003,460,148,312,465,125,340,612,203,400,503,147,325
061030010003,255,88,167,257,81,176,420,157,250,355,122,202
060690005011,964,556,408,976,548,428,1369,818,531,1081,572,447
060690005013,438,260,178,443,249,194,634,385,234,485,277,172
060690005021,614,395,219,619,375,244,997,632,346,662,412,211
060690005022,520,356,164,521,338,183,946,634,291,549,375,143
060690001001,655,277,378,665,256,409,846,365,462,637,265,323
060690001002,707,372,335,715,362,353,760,396,350,590,302,252
060690001003,284,118,166,292,112,180,357,155,197,287,121,148
060690008022,9,5,4,6,3,3,312,175,132,6,3,3
060690008024,384,168,216,394,159,235,806,393,396,428,181,216
060690001004,496,249,247,499,247,252,609,323,276,525,255,229
060690002005,222,107,115,223,103,120,213,109,101,101,46,50
060690002006,603,431,172,618,437,181,1022,696,298,696,464,188
060690002007,424,199,225,429,197,232,491,257,226,387,180,190
060690002001,272,122,150,272,116,156,282,126,150,237,104,126
060690002002,84,59,25,83,58,25,111,77,33,102,71,28
060690002003,570,387,183,559,368,191,734,512,208,642,417,171
060690002004,291,146,145,290,142,148,492,253,228,520,258,227
060690007022,328,165,163,337,163,174,700,362,320,505,244,238
060690006021,442,252,190,446,238,208,607,383,210,489,285,179
060690006023,488,284,204,497,275,222,594,375,202,597,346,210
060690007024,617,360,257,627,344,283,925,520,384,811,455,311
060690006012,634,382,252,643,364,279,828,527,287,661,382,232
060690004003,168,118,50,168,113,55,254,171,74,179,125,45
060690004005,470,337,133,471,318,153,667,459,189,484,331,123
060690007011,539,384,155,542,366,176,869,604,243,507,348,128
060690004004,282,187,95,286,184,102,393,262,122,327,206,94
060690004006,245,167,78,242,157,85,305,228,77,277,203,62
060690005012,613,418,195,608,391,217,879,545,320,767,428,301
060690007021,962,580,382,970,547,423,1354,855,459,902,587,266
060690006024,31,17,14,32,16,16,37,25,12,35,23,11
060690007023,33,18,15,34,17,17,43,26,17,33,19,13
060690006022,325,189,136,330,179,151,473,299,165,359,189,149
060690006011,851,497,354,871,471,400,1242,760,443,889,513,318
060690006013,289,133,156,290,121,169,337,172,162,208,99,99
060690008011,765,341,424,776,329,447,1008,498,493,831,365,422
060690008012,901,400,501,913,389,524,1184,593,578,997,428,507
060690008021,324,114,210,334,108,226,364,144,219,346,83,235
060690008023,436,178,258,444,169,275,515,223,277,481,198,254
060690003002,178,134,44,177,125,52,747,565,163,210,156,38
060690003003,409,326,83,408,312,96,656,504,133,487,387,67
060690004002,203,147,56,205,142,63,283,215,62,197,140,46
060690004001,412,296,116,412,286,126,549,412,131,471,332,114
060690005023,363,264,99,361,251,110,486,375,99,447,312,105
060690003001,488,423,65,491,395,96,578,464,99,521,445,48
060690007012,320,254,66,323,241,82,554,438,106,415,338,59
060690005024,245,204,41,247,193,54,409,318,85,311,251,43
060971513105,0,0,0,0,0,0,891,640,224,176,139,20
060290031312,0,0,0,0,0,0,2,0,2,0,0,0
061110054042,0,0,0,0,0,0,1017,519,472,841,392,381
060670085084,0,0,0,0,0,0,435,270,153,0,0,0
060530141094,0,0,0,0,0,0,1,1,0,0,0,0
060855120581,0,0,0,0,0,0,0,0,0,0,0,0
060855120582,0,0,0,0,0,0,0,0,0,0,0,0
060855120583,0,0,0,0,0,0,0,0,0,0,0,0
060855043182,0,0,0,0,0,0,502,292,201,0,0,0
060839801001,0,0,0,0,0,0,2,2,0,0,0,0
060590525182,0,0,0,0,0,0,1,1,0,0,0,0
060590524391,0,0,0,0,0,0,35,21,13,0,0,0
060590524392,0,0,0,0,0,0,35,24,11,0,0,0
060590524395,0,0,0,0,0,0,1,1,0,1983,1281,609
060590524339,0,0,0,0,0,0,2,1,1,0,0,0
060379800031,0,0,0,0,0,0,3,1,2,1,0,1
060379202001,0,0,0,0,0,0,0,0,0,0,0,0
060375421063,0,0,0,0,0,0,1,1,0,0,0,0
060375991001,0,0,0,0,0,0,0,0,0,0,0,0
061090042013,0,0,0,0,0,0,28,16,8,0,0,0
061030005005,0,0,0,0,0,0,370,144,214,0,0,0
060730092031,0,0,0,0,0,0,866,590,255,0,0,0
060014272005,0,0,0,0,0,0,383,320,53,0,0,0
060014100003,0,0,0,0,0,0,70,62,4,1,1,0
060014415253,0,0,0,0,0,0,4,3,1,1,1,0
060014415031,0,0,0,0,0,0,39,28,11,0,0,0
060959800001,0,0,0,0,0,0,4,1,3,0,0,0
060659800041,0,0,0,0,0,0,36,20,16,0,0,0
060759902000,0,0,0,0,0,0,0,0,0,104,87,9
060650456181,0,0,0,0,0,0,0,0,0,1,1,0
060590755181,0,0,0,0,0,0,0,0,0,1,0,1
060376508021,0,0,0,0,0,0,0,0,0,0,0,0
060290060021,0,0,0,0,0,0,0,0,0,1,1,0
