GEOID20,Tot_2020_sen,D_2020_sen,R_2020_sen,Tot_2020_gov,D_2020_gov,R_2020_gov,Tot_2020_ltg,D_2020_ltg,R_2020_ltg,Tot_2020_pres,D_2020_pres,R_2020_pres,Tot_2018_sen,D_2018_sen,R_2018_sen,Tot_2018_ag,D_2018_ag,R_2018_ag,Tot_2016_gov,D_2016_gov,R_2016_gov,Tot_2016_ltg,D_2016_ltg,R_2016_ltg,Tot_2016_pres,D_2016_pres,R_2016_pres
10003008-09,1193,747,416,1198,746,430,1178,737,441,1215,748,448,811,504,287,789,496,293,807,456,338,802,469,333,836,429,367
10003011-04,1265,853,390,1263,833,413,1246,750,496,1268,810,440,969,631,309,953,645,308,1037,596,408,1013,560,453,1044,601,373
10003008-08,2000,1279,679,2008,1292,684,1973,1243,730,2047,1290,735,1206,753,434,1195,757,438,1121,665,429,1127,697,430,1165,624,491
10003003-23,1026,696,304,1029,695,308,1001,669,332,1042,704,317,860,572,247,844,579,265,968,593,338,951,608,343,988,568,349
10003007-07,1192,814,346,1190,820,344,1171,796,375,1223,829,375,857,597,240,841,592,249,1091,755,288,1070,765,305,1141,718,353
10003011-19,240,168,66,240,162,73,234,159,75,245,160,83,164,105,49,162,114,48,204,114,82,197,114,83,218,111,92
10003004-13,1257,777,438,1268,772,458,1233,767,466,1292,792,481,879,588,278,863,588,275,1135,710,384,1114,700,414,1173,621,492
10003014-01,743,533,188,741,545,182,721,506,215,746,538,198,596,436,140,592,424,168,700,481,190,686,474,212,713,459,213
10003004-22,1226,733,459,1221,726,479,1207,683,524,1232,709,500,985,579,389,980,587,393,1112,595,496,1079,581,498,1118,549,507
10003007-03,944,822,92,958,842,86,926,808,118,1049,920,122,661,583,53,648,564,84,1019,927,71,995,845,150,1124,1003,98
10003002-18,1039,746,262,1036,744,265,1018,737,281,1075,770,286,715,516,184,700,493,207,832,568,238,814,572,242,861,560,251
10003003-24,822,511,292,821,514,288,811,502,309,851,518,319,629,397,216,621,408,213,812,489,295,798,513,285,846,477,333
10003007-22,1887,1285,558,1889,1278,572,1852,1242,610,1926,1256,635,1483,1003,451,1460,1018,442,1695,1056,601,1655,1036,619,1727,1035,612
10003008-19,1143,658,451,1140,666,441,1106,665,441,1171,669,480,785,484,273,765,521,244,1033,610,388,1008,620,388,1067,529,464
10003009-18,938,641,276,934,639,279,921,635,286,964,665,291,711,504,192,701,492,209,856,591,245,845,581,264,899,579,285
10003010-21,1594,947,597,1595,946,612,1562,921,641,1611,941,642,1259,745,463,1222,771,451,1493,841,603,1450,858,592,1548,812,633
10003007-04,1085,855,196,1092,863,203,1062,821,241,1110,848,234,894,714,152,889,710,179,1022,755,235,994,719,275,1065,734,247
10003001-23,206,158,42,203,158,41,196,153,43,215,159,51,185,129,41,176,135,41,182,131,39,177,134,43,202,144,43
10003007-17,870,608,225,877,618,234,850,606,244,925,638,277,577,414,151,563,411,152,750,531,192,725,505,220,803,511,252
10003006-24,1023,633,348,1025,642,361,1001,624,377,1045,625,390,754,473,264,743,491,252,937,558,341,924,581,343,956,511,380
10003010-15,1516,1215,251,1524,1231,267,1496,1192,304,1562,1272,274,1147,929,187,1131,915,216,1378,1087,248,1358,1051,307,1447,1102,288
10003005-15,2287,1721,520,2290,1720,532,2259,1644,615,2346,1751,570,1528,1142,349,1511,1095,416,1657,1148,473,1651,1148,503,1733,1173,493
10003011-21,1526,935,542,1526,930,550,1481,892,589,1570,919,616,1155,726,388,1129,739,390,1363,807,501,1301,799,502,1418,757,570
10003009-27,1509,821,650,1506,834,644,1478,823,655,1520,811,694,1143,665,464,1123,654,469,1373,776,569,1356,740,616,1419,707,634
10003002-17,1713,1494,181,1709,1491,190,1670,1452,218,1778,1553,210,1349,1208,115,1335,1140,195,1521,1325,166,1508,1198,310,1640,1406,202
10003003-25,951,696,218,955,710,220,936,690,246,984,721,229,861,609,201,846,624,222,987,645,290,967,665,302,1013,649,273
10003002-04,1375,949,395,1376,933,425,1347,855,492,1375,896,466,1109,720,378,1090,723,367,1200,748,434,1178,670,508,1203,686,456
10003005-12,1498,948,512,1497,934,543,1470,891,579,1509,925,565,1281,804,460,1256,811,445,1373,814,538,1345,738,607,1358,744,545
10003009-17,856,560,275,855,549,285,828,550,278,881,545,322,614,398,210,606,412,194,759,482,264,742,478,264,775,427,314
10003009-03,886,773,80,907,806,82,862,755,107,962,856,97,665,598,47,654,551,103,909,804,89,904,736,168,1022,910,83
10003001-15,1656,898,699,1656,902,710,1618,899,719,1708,881,783,1184,715,432,1161,706,455,1475,877,543,1443,936,507,1527,762,681
10003001-09,1313,624,654,1311,590,690,1296,618,678,1350,608,721,969,490,458,948,491,457,1133,557,559,1130,614,516,1188,471,655
10003008-06,1700,1111,535,1688,1111,544,1668,1086,582,1719,1113,562,1360,910,401,1341,916,425,1604,974,584,1565,963,602,1646,936,602
10003002-11,1775,1112,603,1769,1115,624,1757,1124,633,1805,1118,662,1187,796,366,1170,787,383,1309,837,441,1290,860,430,1334,772,491
10003006-08,1528,860,612,1525,862,627,1518,910,608,1549,849,656,1106,649,433,1097,626,471,1346,763,555,1342,840,502,1378,655,644
10003005-07,686,561,114,684,557,115,673,548,125,691,559,126,588,471,90,583,490,93,646,491,123,619,502,117,647,488,113
10003007-16,844,706,125,848,714,127,829,691,138,876,739,131,665,566,82,652,542,110,778,658,100,762,619,143,829,680,124
10003008-05,1724,1257,423,1721,1249,441,1703,1258,445,1759,1286,451,1330,998,306,1303,953,350,1538,1100,410,1507,1061,446,1620,1117,442
10003008-21,1517,967,508,1523,964,516,1479,942,537,1549,982,541,1117,764,323,1103,769,334,1388,847,490,1349,862,487,1435,774,571
10003010-13,484,300,167,485,298,170,471,296,175,500,305,184,328,203,112,324,206,118,452,283,157,421,276,145,469,261,183
10003002-03,1158,905,219,1167,933,212,1121,867,254,1208,931,265,964,767,166,952,761,191,1151,909,215,1117,881,236,1215,879,282
10003010-06,1256,836,400,1261,833,406,1234,810,424,1276,830,424,1071,676,360,1063,694,369,1204,712,460,1171,690,481,1215,663,479
10003007-27,499,254,235,495,242,245,490,236,254,507,249,246,361,189,169,357,183,174,440,208,221,429,205,224,454,190,238
10003001-27,1850,1286,512,1849,1284,530,1833,1278,555,1892,1290,577,1436,1028,367,1402,1004,398,1667,1131,481,1667,1157,510,1724,1083,524
10003009-26,1424,1189,195,1434,1189,205,1404,1167,237,1502,1244,241,1009,847,133,988,825,163,1367,1103,224,1352,1061,291,1460,1154,242
10003008-04,1930,1228,663,1928,1232,671,1894,1187,707,1978,1215,746,1484,900,542,1460,946,514,1699,1003,671,1642,977,665,1732,926,721
10003008-13,1282,911,338,1292,926,337,1257,917,340,1351,935,394,899,665,209,878,656,222,1186,871,268,1141,843,298,1251,812,363
10003007-25,1279,800,434,1274,803,443,1259,798,461,1302,812,466,961,601,341,942,602,340,1200,712,441,1178,722,456,1240,677,496
10003005-25,1154,768,358,1157,759,376,1138,762,376,1178,768,387,819,544,252,805,540,265,1001,605,368,996,623,373,1018,574,387
10003002-25,1130,726,378,1133,725,385,1114,728,386,1142,734,386,922,579,320,899,562,337,1046,628,394,1037,646,391,1053,606,381
10003006-04,1028,803,197,1042,813,208,1012,773,239,1079,842,214,790,603,160,778,605,173,954,703,225,921,675,246,971,688,216
10005004-38,2187,1118,1036,2205,1148,1034,2162,1117,1045,2219,1150,1054,1772,883,870,1714,879,835,1844,865,959,1807,860,947,1864,785,1022
10003003-16,892,852,25,904,856,32,876,809,67,965,929,30,718,683,22,708,594,114,893,850,34,892,757,135,968,921,32
10005006-35,745,226,503,755,217,532,742,230,512,772,222,544,501,142,349,482,157,325,645,214,425,634,219,415,668,151,507
10005007-39,1182,489,659,1182,499,661,1152,488,664,1216,481,717,867,356,495,846,378,468,1115,521,565,1093,503,590,1161,410,711
10005002-35,2596,1010,1547,2620,1030,1545,2552,1001,1551,2656,1033,1595,1836,665,1149,1801,724,1077,2035,783,1215,1990,794,1196,2111,645,1384
10005005-14,2912,1465,1389,2930,1491,1397,2868,1491,1377,2961,1470,1462,2129,1039,1059,2075,1092,983,2296,1122,1123,2263,1188,1075,2354,995,1277
10005004-35,1696,820,828,1712,826,848,1655,801,854,1738,850,868,1199,563,611,1144,577,567,1504,804,676,1453,790,663,1563,704,806
10005001-37,1329,735,540,1359,739,590,1307,741,566,1420,770,625,953,492,451,921,518,403,1256,728,501,1228,728,500,1297,636,605
10005005-40,885,291,566,890,306,566,874,318,556,910,285,611,644,236,403,631,258,373,829,364,443,811,344,467,856,235,583
10003005-01,1187,1015,132,1200,1023,152,1150,949,201,1227,1057,151,1009,861,111,989,813,176,1137,930,171,1110,877,233,1219,987,169
10003005-08,2033,1456,518,2031,1460,533,1998,1433,565,2080,1487,557,1441,1065,344,1425,976,449,1729,1214,489,1748,1217,531,1800,1171,539
10003005-09,1323,836,453,1319,829,470,1310,830,480,1364,850,496,700,455,234,693,456,237,657,341,306,656,359,297,673,304,335
10003002-07,1455,970,452,1459,976,465,1438,928,510,1478,960,494,1153,747,377,1124,751,373,1365,848,482,1328,822,506,1395,835,478
10003005-19,1087,676,383,1097,659,416,1061,646,415,1138,668,457,738,439,280,719,457,262,951,571,358,923,567,356,1029,524,461
10003002-21,1126,666,435,1137,672,440,1110,656,454,1150,647,483,820,498,303,811,524,287,990,617,353,961,614,347,1030,519,454
10003007-06,1013,671,313,1010,663,332,991,620,371,1018,655,342,841,548,270,825,547,278,936,561,342,909,553,356,942,542,344
10003003-17,1284,1014,239,1297,1029,252,1271,980,291,1358,1074,267,1009,809,172,998,801,197,1178,920,231,1172,849,323,1240,915,276
10003006-16,760,665,64,782,690,62,745,653,92,833,754,73,542,500,31,536,446,90,692,612,59,672,542,130,769,680,66
10003002-16,1056,883,140,1066,887,133,1031,868,163,1125,965,150,795,689,82,776,606,170,984,863,100,976,792,184,1095,940,133
10003001-12,1359,912,412,1354,903,422,1333,877,456,1376,899,452,1144,779,343,1130,804,326,1259,788,433,1225,761,464,1263,729,448
10003001-07,1310,795,474,1314,794,486,1276,778,498,1349,800,524,969,606,333,950,610,340,1149,685,422,1106,682,424,1197,657,465
10003003-09,1830,1036,750,1830,1051,758,1805,1050,755,1861,1021,818,1353,784,542,1334,779,555,1646,927,679,1643,975,668,1699,838,761
10003005-26,1294,1006,245,1293,993,272,1270,963,307,1338,1045,270,1020,805,188,1006,803,203,1234,896,289,1217,901,316,1288,943,286
10003001-19,1119,700,380,1121,694,402,1100,707,393,1145,713,420,871,564,277,846,582,264,1106,721,350,1057,679,378,1154,663,429
10005003-14,2399,1534,825,2394,1553,821,2358,1514,844,2415,1530,860,1895,1193,677,1854,1209,645,2069,1245,776,2034,1238,796,2113,1198,839
10005007-20,2247,1489,726,2248,1486,733,2222,1456,766,2262,1495,743,1916,1214,664,1870,1233,637,2009,1189,781,1959,1213,746,2023,1117,802
10003010-09,1306,835,446,1300,828,447,1288,819,469,1344,849,482,937,599,319,927,581,346,827,493,320,815,486,329,853,465,342
10003012-02,480,449,12,486,455,7,461,422,39,534,515,16,385,370,8,376,335,41,529,513,8,522,456,66,597,582,7
10003006-06,551,437,93,559,450,91,547,441,106,580,466,107,419,343,66,408,339,69,521,413,91,515,401,114,550,423,105
10003009-19,1053,603,420,1060,603,434,1025,567,458,1101,603,476,768,435,308,758,462,296,1012,593,389,968,546,422,1063,534,481
10003008-02,536,499,22,548,505,26,519,471,48,596,572,23,355,326,12,349,296,53,523,491,17,511,421,90,594,564,15
10005003-38,2837,1236,1545,2862,1263,1570,2815,1261,1554,2895,1257,1610,2082,895,1152,2009,933,1076,2264,980,1247,2238,1033,1205,2302,842,1375
10005002-38,3236,1328,1841,3260,1369,1850,3173,1351,1822,3308,1352,1923,2310,938,1352,2252,980,1272,2265,937,1302,2232,984,1248,2350,810,1487
10005004-37,2751,1262,1435,2769,1286,1445,2705,1267,1438,2834,1294,1517,1847,850,967,1794,902,892,2130,1029,1066,2086,1044,1042,2218,894,1261
10005006-37,1327,542,747,1339,549,762,1308,556,752,1376,557,802,940,380,541,924,411,513,1112,494,589,1093,517,576,1172,433,708
10005005-37,2550,1146,1342,2564,1172,1350,2516,1150,1366,2619,1185,1409,1701,760,921,1664,807,857,1715,785,905,1681,782,899,1791,697,1043
10005001-36,1648,813,782,1658,804,813,1623,795,828,1694,827,839,1233,609,588,1199,625,574,1387,625,721,1368,669,699,1425,572,768
10005002-36,1810,639,1122,1829,637,1162,1795,635,1160,1840,641,1171,1252,397,827,1224,450,774,1479,493,954,1454,564,890,1491,383,1044
10005002-39,1751,860,830,1766,885,842,1718,847,871,1810,874,907,1295,612,658,1257,627,630,1636,811,774,1588,803,785,1703,749,872
10005003-40,942,524,398,939,528,392,928,506,422,971,521,435,638,378,249,629,389,240,840,501,319,823,475,348,872,462,383
10005006-36,1401,610,743,1411,617,763,1384,592,792,1448,653,774,1053,452,582,1026,482,544,1197,561,610,1175,566,609,1238,493,698
10005003-37,2910,1264,1582,2940,1280,1628,2870,1269,1601,2989,1291,1666,2100,861,1207,2058,933,1125,2118,876,1192,2068,915,1153,2183,755,1324
10005006-41,1190,471,700,1198,461,721,1173,481,692,1212,474,734,846,318,518,830,345,485,888,380,495,878,393,485,918,307,575
10005005-41,2447,1130,1242,2469,1151,1274,2414,1161,1253,2521,1158,1329,1679,819,838,1654,866,788,1970,1041,892,1925,1048,877,2040,851,1117
10005001-38,2414,873,1491,2430,885,1518,2379,897,1482,2459,847,1593,1809,622,1165,1775,704,1071,2030,745,1248,2001,820,1181,2082,583,1425
10005007-40,1684,582,1060,1685,605,1046,1658,580,1078,1727,579,1125,1188,442,720,1173,486,687,1554,637,866,1522,604,918,1609,476,1058
10005006-40,1467,374,1053,1476,403,1045,1444,388,1056,1506,362,1120,1004,255,735,986,307,679,1241,384,823,1231,388,843,1290,241,987
10005001-35,2553,714,1763,2557,727,1796,2505,724,1781,2599,705,1852,1897,560,1293,1856,632,1224,2300,768,1487,2241,834,1407,2367,583,1704
10005007-36,687,355,316,681,355,318,676,343,333,697,360,324,497,266,222,487,265,222,578,306,264,568,296,272,595,290,286
10005005-36,1710,691,969,1722,693,1000,1685,684,1001,1730,675,1025,1266,506,731,1234,557,677,1397,574,798,1375,626,749,1442,484,910
10005003-20,2905,1359,1473,2904,1363,1504,2843,1354,1489,2948,1363,1559,2155,1000,1115,2108,1013,1095,2152,966,1142,2118,976,1142,2213,835,1306
10005006-20,1853,958,844,1865,963,877,1816,913,903,1878,958,893,1484,757,697,1461,789,672,1596,771,800,1569,774,795,1614,679,863
10005009-20,323,118,189,321,118,190,322,123,199,328,124,196,247,80,163,237,101,136,270,108,159,266,118,148,275,68,186
10005002-20,2853,1389,1404,2862,1415,1410,2789,1407,1382,2916,1435,1451,2247,1060,1152,2195,1119,1076,2192,1026,1113,2148,1053,1095,2249,907,1262
10005007-38,3525,1463,1997,3538,1501,1989,3485,1490,1995,3596,1524,2036,2354,968,1353,2312,1042,1270,2260,836,1381,2219,931,1288,2326,717,1526
10005005-38,1608,646,935,1619,651,946,1585,625,960,1651,660,977,1196,491,689,1171,508,663,1330,527,794,1310,533,777,1379,463,888
10005007-37,1479,611,837,1487,599,867,1461,619,842,1523,593,918,1191,458,724,1174,507,667,1291,482,784,1272,511,761,1329,427,867
10005001-20,1276,734,499,1281,741,512,1252,733,519,1303,758,527,977,579,369,953,582,371,1090,627,417,1064,611,453,1132,570,488
10005001-14,3817,2201,1547,3836,2228,1569,3769,2165,1604,3861,2210,1612,2826,1593,1191,2777,1637,1140,3000,1583,1369,2934,1575,1359,3066,1459,1514
10005007-14,1429,911,490,1430,892,521,1402,885,517,1453,901,537,1111,687,401,1088,718,370,1224,745,456,1198,710,488,1240,699,500
10005005-20,4142,2272,1787,4155,2343,1765,4058,2275,1783,4214,2305,1880,2943,1573,1325,2879,1647,1232,2702,1348,1294,2644,1400,1244,2784,1254,1417
10001002-29,4772,2880,1747,4789,2913,1784,4728,2832,1896,4893,2950,1872,3279,2009,1200,3242,2013,1229,3690,2157,1469,3616,2176,1440,3825,2084,1579
10001001-29,5791,2888,2742,5817,2913,2800,5730,2926,2804,5930,2894,2954,3951,2107,1772,3896,2085,1811,4536,2374,2059,4441,2473,1968,4682,2028,2420
10001003-29,1746,776,917,1750,797,921,1723,774,949,1775,776,962,1185,549,618,1164,558,606,1397,603,766,1367,667,700,1430,529,839
10001005-30,1941,802,1079,1951,813,1100,1923,799,1124,2008,819,1164,1313,581,711,1283,621,662,1690,705,937,1646,794,852,1737,609,1033
10001004-30,803,247,538,802,239,553,797,252,545,813,228,576,549,183,356,537,197,340,725,246,462,705,284,421,752,182,539
10001003-30,1909,491,1360,1917,505,1374,1894,520,1374,1935,476,1423,1304,379,901,1282,430,852,1647,475,1131,1600,613,987,1681,336,1270
10001001-30,2832,1167,1586,2851,1183,1610,2806,1151,1655,2888,1161,1680,1867,773,1060,1836,842,994,2401,984,1366,2336,1082,1254,2455,860,1472
10001005-33,1268,461,769,1268,467,773,1249,454,795,1282,456,806,871,321,535,857,356,501,1102,389,692,1069,463,606,1125,348,734
10001006-33,1808,741,1027,1819,745,1054,1790,748,1042,1843,743,1085,1286,511,756,1263,552,711,1577,655,901,1532,719,813,1604,593,951
10001004-33,2953,1319,1551,2969,1324,1589,2923,1288,1635,3008,1303,1659,2006,870,1082,1969,891,1078,2427,989,1388,2374,1137,1237,2466,891,1431
10001005-28,4026,2388,1529,4045,2394,1555,3981,2379,1602,4134,2421,1645,2730,1692,985,2696,1672,1024,3346,1965,1297,3262,1969,1293,3460,1784,1524
10001006-28,293,146,141,294,146,143,291,149,142,301,145,154,222,118,101,218,115,103,276,149,123,271,154,117,282,125,148
10001007-30,1657,468,1138,1666,472,1170,1644,467,1177,1697,456,1209,1201,312,868,1191,341,850,1430,423,981,1383,466,917,1444,305,1079
10001007-33,866,452,385,873,461,392,863,451,412,891,470,399,622,332,276,615,347,268,759,411,334,743,419,324,778,385,349
10001008-33,553,288,247,558,292,253,550,287,263,566,298,256,398,212,176,395,223,172,486,262,213,473,266,207,498,248,224
10001008-34,844,453,369,850,466,371,840,442,398,860,460,387,573,307,256,571,312,259,600,279,309,586,304,282,606,273,303
10001002-33,3233,1674,1460,3247,1705,1486,3198,1614,1584,3293,1697,1535,2260,1174,1049,2238,1184,1054,2495,1138,1312,2451,1214,1237,2531,1109,1289
10001009-34,328,175,142,326,177,143,324,168,156,332,176,150,218,115,100,216,116,100,235,103,129,231,114,117,238,102,126
10001003-34,2650,1241,1336,2661,1258,1344,2617,1192,1425,2698,1239,1415,1871,882,951,1850,911,939,2276,1015,1224,2215,1061,1154,2326,946,1252
10001002-28,2026,1110,849,2032,1127,853,1990,1139,851,2077,1138,896,1411,814,565,1392,818,574,1801,1029,709,1770,1089,681,1853,883,874
10001003-28,321,176,137,320,176,138,323,180,143,329,176,147,221,128,88,215,127,88,276,157,113,277,174,103,288,136,136
10001004-34,3465,1925,1424,3496,1951,1462,3437,1857,1580,3575,1986,1515,2638,1478,1100,2584,1490,1094,3083,1506,1500,3002,1585,1417,3174,1418,1568
10001006-34,2356,1317,966,2361,1311,998,2325,1250,1075,2403,1317,1047,1756,931,784,1719,956,763,2046,987,1003,1996,1027,969,2094,961,1018
10005004-40,1536,462,1040,1541,477,1042,1510,468,1042,1572,432,1132,1100,325,762,1077,359,718,1419,521,876,1394,499,895,1459,311,1098
10001007-32,153,68,83,160,75,80,154,64,90,161,71,88,102,44,53,99,45,54,128,45,79,124,53,71,131,42,83
10001008-32,23,10,12,22,10,11,21,9,12,22,10,12,14,6,7,13,6,7,18,6,11,17,7,10,18,6,11
10001013-28,363,169,183,365,175,183,358,166,192,377,177,196,255,122,126,250,133,117,323,167,149,311,178,133,336,138,177
10001001-32,2134,1452,608,2156,1492,598,2103,1387,716,2237,1564,636,1405,983,389,1388,984,404,1712,1109,560,1678,1088,590,1803,1134,566
10001002-32,1369,820,486,1384,836,514,1373,794,579,1420,865,525,1000,591,380,977,609,368,1258,713,511,1229,745,484,1286,715,496
10001007-31,849,613,205,860,620,220,842,585,257,877,633,226,606,433,153,587,428,159,742,512,206,721,498,223,759,515,207
10001005-31,1258,850,369,1273,861,384,1250,834,416,1294,874,395,933,612,288,919,596,323,1166,746,396,1129,748,381,1181,723,374
10001003-31,2466,1602,796,2484,1605,828,2445,1528,917,2505,1602,868,1811,1136,643,1784,1105,679,2168,1276,846,2137,1303,834,2197,1247,834
10001001-34,207,115,87,208,108,95,206,104,102,209,112,90,172,89,81,170,90,80,193,92,97,190,104,86,199,92,92
10001005-34,869,404,444,868,408,448,858,383,475,874,394,464,668,286,367,660,300,360,832,302,510,805,388,417,823,288,474
10001006-32,166,141,17,172,144,21,167,130,37,178,157,16,106,92,11,105,93,12,162,134,24,159,114,45,169,143,19
10001003-33,1517,684,796,1522,687,809,1495,656,839,1554,688,842,1170,513,642,1154,556,598,1392,539,830,1338,618,720,1409,501,823
10001009-08,792,298,468,795,309,472,778,323,455,805,294,496,522,217,293,515,218,297,644,286,337,632,331,301,660,220,397
10001014-28,1392,851,501,1403,853,519,1382,830,552,1436,876,536,1020,640,359,995,627,368,1262,758,469,1219,749,470,1292,733,483
10001007-28,370,246,113,376,246,122,367,242,125,379,247,128,259,172,85,253,170,83,286,167,115,277,168,109,297,156,127
10005011-36,381,165,209,382,159,220,378,155,223,387,165,214,246,106,132,246,125,121,275,121,144,273,127,146,281,110,153
10005004-39,1216,648,527,1219,669,530,1191,634,557,1271,678,569,931,489,421,898,480,418,1086,599,455,1054,571,483,1153,543,557
10001002-31,1656,1123,495,1681,1123,526,1650,1061,589,1710,1147,532,1242,812,405,1220,787,433,1559,964,561,1539,956,583,1583,936,559
10001005-29,1223,361,829,1225,366,836,1210,383,827,1247,347,880,841,257,558,825,294,531,1122,389,706,1092,461,631,1150,280,809
10001004-29,400,165,222,401,170,222,394,164,230,407,168,231,284,125,154,280,131,149,337,142,189,329,158,171,341,127,202
10001001-31,262,109,145,265,112,148,260,109,151,268,111,151,187,81,102,183,85,98,223,93,125,216,103,113,227,84,133
10001007-29,1423,612,772,1425,609,790,1407,595,812,1447,592,836,1046,452,575,1037,473,564,1266,527,713,1231,568,663,1274,463,746
10001010-28,166,117,42,166,119,45,161,113,48,169,121,44,101,73,23,99,70,29,147,92,46,145,98,47,151,99,38
10001004-31,1147,784,333,1146,782,348,1123,722,401,1176,794,358,803,541,255,800,540,260,957,573,359,941,590,351,1000,606,325
10001012-28,285,185,88,286,190,87,282,175,107,297,197,91,190,125,56,185,124,61,254,163,80,245,160,85,263,166,82
10003009-06,1624,1138,436,1623,1130,462,1580,1096,484,1648,1133,493,1331,927,373,1313,927,386,1546,1036,473,1520,1019,501,1569,973,513
10003004-03,702,632,38,720,655,39,679,611,68,814,754,52,533,495,30,514,449,65,724,679,32,699,599,100,864,819,37
10003006-13,1371,866,454,1371,868,467,1341,861,480,1411,888,504,998,611,356,973,647,326,1286,797,434,1252,817,435,1320,733,507
10003005-13,1121,743,324,1121,733,333,1092,750,342,1176,774,374,756,510,208,731,511,220,980,650,285,950,645,305,1039,623,361
10003003-04,1408,1103,286,1403,1075,311,1368,1018,350,1404,1029,356,1133,843,262,1125,862,263,1271,905,349,1239,863,376,1267,822,380
10003004-10,1271,933,311,1275,950,305,1251,919,332,1314,961,342,1072,770,274,1068,782,286,1248,862,349,1218,834,384,1310,857,392
10003010-16,1100,770,295,1111,780,303,1085,772,313,1147,787,340,828,612,192,814,607,207,1005,748,231,978,703,275,1054,709,297
10003001-10,1463,899,534,1468,884,562,1441,865,576,1501,893,594,1155,718,409,1124,719,405,1370,797,537,1332,763,569,1423,753,606
10003007-18,806,554,233,808,546,246,795,537,258,834,553,269,542,351,177,532,367,165,694,437,229,691,444,247,724,416,272
10003006-09,1429,725,658,1432,740,669,1411,761,650,1463,731,706,928,478,427,919,483,436,1063,531,498,1057,597,460,1094,451,565
10003004-09,1152,608,522,1154,602,534,1147,613,534,1173,608,548,760,406,340,758,397,361,754,372,369,746,384,362,765,330,393
10003007-23,1069,683,357,1073,686,371,1063,669,394,1092,682,387,855,567,269,838,561,277,951,580,343,938,589,349,988,565,377
10003004-26,1225,892,302,1219,892,302,1194,849,345,1256,884,355,924,676,228,914,648,266,1158,836,293,1137,778,359,1207,800,351
10003002-09,1317,852,431,1325,844,458,1311,834,477,1348,851,479,831,555,252,816,539,277,1132,677,436,1115,663,452,1166,635,467
10003003-11,1365,411,915,1355,412,918,1346,475,871,1393,395,978,923,310,593,903,306,597,1167,423,716,1157,539,618,1220,289,863
10003001-24,1350,835,454,1348,839,474,1322,844,478,1387,849,510,893,583,278,875,586,289,1228,754,432,1222,765,457,1294,724,491
10003004-18,1333,1003,294,1336,1014,297,1304,983,321,1374,1046,316,1039,808,217,1025,770,255,1268,954,285,1243,894,349,1316,934,333
10003005-17,913,604,289,919,609,293,890,606,284,955,614,329,687,461,206,678,465,213,852,556,274,823,548,275,878,489,331
10003006-10,1321,790,507,1323,793,505,1297,754,543,1339,772,542,1088,645,424,1077,672,405,1230,655,546,1205,665,540,1252,645,540
10003005-27,1390,914,450,1393,896,468,1360,882,478,1414,913,484,1074,712,341,1056,711,345,1282,783,464,1258,787,471,1322,745,511
10003007-10,1570,1082,452,1571,1083,465,1541,1024,517,1592,1037,528,1280,857,401,1260,860,400,1452,903,516,1419,893,526,1455,835,539
10003008-01,158,116,37,160,122,34,157,117,40,164,123,38,141,107,29,138,104,34,152,108,37,152,111,41,155,107,38
10003012-01,409,316,83,411,315,86,403,312,91,423,330,87,287,226,53,280,211,69,384,280,92,373,258,115,389,276,97
10003010-01,1028,970,26,1036,975,33,1001,936,65,1104,1071,25,780,740,15,763,683,80,962,927,21,954,797,157,1091,1057,18
10003007-15,1277,851,401,1277,855,400,1256,842,414,1307,843,455,961,632,309,951,611,340,1124,693,404,1086,668,418,1143,671,436
10003010-02,995,865,96,1007,878,104,972,807,165,1054,933,110,574,503,52,567,470,97,708,589,75,695,544,151,772,656,74
10003011-13,655,510,129,654,505,136,636,503,133,675,524,145,342,261,72,332,265,67,466,354,100,444,342,102,477,333,126
10005002-41,2756,1104,1529,2761,1119,1604,2718,1141,1577,2805,1154,1625,1859,756,1088,1823,814,1009,1914,849,1025,1889,885,1004,1961,670,1232
10005004-14,2875,1697,1121,2879,1695,1149,2838,1689,1149,2914,1701,1192,2219,1235,934,2179,1319,860,2272,1309,922,2222,1327,895,2344,1220,1069
10005006-14,2115,1314,770,2122,1302,799,2090,1277,813,2135,1304,814,1630,990,619,1599,1005,594,1638,939,675,1617,951,666,1656,863,748
10005001-41,1882,425,1416,1893,430,1438,1859,482,1377,1914,406,1487,1308,308,978,1274,366,908,1544,537,983,1515,589,926,1589,279,1246
10005008-38,1794,574,1196,1799,588,1195,1758,576,1182,1849,560,1271,1194,363,816,1178,399,779,1093,371,706,1074,395,679,1132,293,794
10005007-41,1151,459,661,1164,478,663,1132,483,649,1207,476,713,875,339,522,858,382,476,1072,499,544,1055,518,537,1115,409,663
10001003-32,1469,888,534,1471,887,541,1453,840,613,1487,916,541,1165,677,451,1142,684,458,1364,758,582,1344,784,560,1405,763,567
10005001-39,1485,450,995,1486,465,999,1460,466,994,1526,448,1054,1118,342,757,1083,368,715,1354,469,848,1320,482,838,1395,332,1013
10005001-40,1091,384,680,1092,383,684,1067,385,682,1117,374,729,770,281,481,747,318,429,920,413,482,898,414,484,962,306,618
10001006-30,1680,538,1102,1691,532,1133,1664,535,1129,1711,550,1138,1173,403,753,1149,421,728,1456,521,905,1426,612,814,1489,437,980
10001010-08,852,491,339,851,490,341,842,480,362,871,496,356,564,339,204,554,335,219,730,429,276,715,466,249,758,380,322
10001011-08,14,8,6,14,8,6,14,8,6,14,8,6,9,6,3,10,6,4,12,7,5,11,7,4,12,6,5
10001012-08,326,202,114,326,202,118,322,200,122,335,204,125,226,148,72,221,142,79,241,151,84,236,149,87,251,139,100
10001008-28,726,324,382,731,330,388,719,323,396,743,328,405,535,250,277,527,261,266,646,316,319,628,343,285,669,267,376
10001006-31,1646,1235,352,1658,1268,348,1630,1174,456,1694,1297,372,1096,866,201,1084,842,242,1276,938,303,1253,867,386,1314,924,316
10005002-37,1327,465,833,1336,452,873,1311,478,833,1349,470,862,1027,372,645,1002,398,604,1189,488,694,1154,532,622,1193,368,793
10005003-41,1149,538,589,1165,550,597,1140,568,572,1182,543,629,807,382,407,769,410,359,991,533,434,984,581,403,1037,423,587
10005004-41,1122,433,668,1130,425,695,1121,478,643,1143,440,691,851,326,512,834,371,463,974,449,510,962,506,456,1000,335,617
10005009-36,109,27,79,112,26,82,107,29,78,112,29,81,78,23,55,75,22,53,95,36,59,94,35,59,97,30,66
10003004-25,988,618,346,992,622,350,976,624,352,1017,630,368,765,454,285,745,451,294,927,539,356,919,574,345,947,486,404
10003001-25,755,608,116,753,613,118,741,604,137,773,629,124,683,550,97,682,556,126,778,572,171,769,580,189,804,590,158
10003008-27,1638,1001,610,1638,1006,608,1623,1008,615,1674,1004,655,1247,780,443,1230,766,464,1446,823,593,1462,873,589,1519,781,671
10003007-26,1428,1037,344,1422,1035,351,1402,1000,402,1472,1056,392,1107,820,258,1095,825,270,1356,957,365,1323,962,361,1408,932,401
10003006-02,621,560,46,619,568,45,604,535,69,652,595,50,445,397,30,441,365,76,563,476,66,561,455,106,602,515,59
10003004-17,1058,736,297,1059,740,290,1039,728,311,1074,734,325,824,561,246,797,544,253,925,609,283,907,590,317,940,553,337
10003001-17,771,523,218,774,528,218,758,531,227,816,545,254,478,335,133,465,334,131,689,476,176,678,482,196,724,461,222
10003004-21,1218,864,304,1219,849,329,1198,834,364,1241,882,339,905,639,237,897,633,264,1060,674,340,1024,686,338,1088,703,313
10003005-04,179,150,20,184,157,19,178,152,26,186,160,24,96,83,10,97,85,12,166,130,24,165,133,32,186,157,19
10003011-22,1599,1028,540,1603,1020,561,1574,996,578,1619,1005,588,1249,804,422,1228,811,417,1430,874,535,1400,831,569,1451,814,579
10003006-26,1226,850,346,1223,851,351,1213,838,375,1243,849,372,962,678,266,947,653,294,1174,760,377,1159,781,378,1202,732,396
10003001-03,599,527,42,608,537,49,583,505,78,650,596,53,481,430,26,477,409,68,602,539,36,565,482,83,688,632,41
10003004-23,1508,1075,385,1520,1084,400,1490,1060,430,1532,1099,403,1313,916,330,1290,938,352,1424,940,445,1402,962,440,1446,927,432
10003011-17,1229,839,360,1231,840,360,1193,835,358,1270,854,401,830,599,211,813,583,230,1072,745,299,1046,718,328,1158,728,363
10003004-05,965,824,115,973,836,120,949,804,145,1009,876,124,742,647,73,696,587,109,918,766,120,912,756,156,990,825,134
10003005-06,1252,989,230,1258,993,238,1229,963,266,1307,1039,259,933,751,167,918,727,191,1105,835,247,1088,804,284,1132,824,255
10003003-15,1732,1237,456,1728,1234,468,1703,1185,518,1767,1225,520,1199,901,282,1180,850,330,1344,917,398,1316,891,425,1394,930,413
10003001-02,1072,1001,42,1078,1008,48,1055,965,90,1171,1107,53,742,695,28,736,595,141,1031,995,21,1019,870,149,1211,1172,22
10003013-04,213,151,53,216,154,51,207,148,59,223,158,61,153,112,30,149,116,33,189,140,44,176,131,45,191,130,50
10003004-06,1001,712,258,1002,708,274,982,696,286,1027,733,276,834,587,219,826,590,236,917,603,285,900,615,285,926,593,279
10003009-09,1039,404,602,1032,390,624,1023,398,625,1053,367,669,712,278,408,700,297,403,941,410,515,938,467,471,972,329,601
10003004-11,851,347,486,859,348,492,850,390,460,880,335,532,600,290,303,587,302,285,738,369,354,733,401,332,769,299,428
10003011-02,933,875,30,933,882,23,896,816,80,1008,971,34,702,671,17,676,578,98,892,855,29,883,743,140,1009,980,19
10003014-12,831,557,263,828,540,278,810,501,309,829,519,299,722,460,248,712,479,233,797,465,318,762,420,342,780,429,310
10003007-24,1234,941,248,1235,951,255,1211,920,291,1269,966,288,879,687,175,870,673,197,1070,788,250,1040,791,249,1128,818,255
10003012-09,1596,915,650,1600,919,670,1577,917,660,1626,909,703,940,549,380,923,523,400,951,537,400,952,556,396,986,506,433
10003005-10,1273,845,402,1272,844,415,1244,785,459,1277,818,442,1075,685,362,1060,687,373,1179,674,477,1151,632,519,1201,637,492
10003009-07,1084,704,352,1082,704,354,1073,713,360,1109,717,376,843,551,268,833,569,264,1042,650,361,1017,648,369,1084,623,412
10005005-39,1239,383,824,1243,381,832,1223,398,825,1278,373,883,949,302,626,935,334,601,1165,411,729,1142,426,716,1187,284,854
10003010-27,1720,1077,604,1722,1062,632,1703,1067,636,1752,1055,667,1312,802,488,1291,797,494,1510,843,638,1489,867,622,1548,812,666
10003010-24,984,672,275,986,648,296,962,657,305,1022,695,312,649,425,201,638,449,189,876,556,273,861,565,296,907,539,295
10005002-14,2903,1651,1201,2913,1667,1214,2872,1652,1220,2950,1642,1287,2077,1136,914,2034,1200,834,2201,1243,924,2155,1221,934,2243,1082,1085
10003005-18,1010,644,332,1011,649,329,986,624,362,1049,659,376,739,494,216,736,505,231,885,564,290,866,561,305,958,547,359
10003011-12,1215,707,488,1213,670,531,1184,617,567,1223,668,544,1019,543,457,1011,538,473,1130,567,541,1091,495,596,1131,518,559
10003002-26,875,661,183,879,674,185,857,657,200,916,696,205,619,493,111,616,499,117,775,588,166,773,574,199,823,605,189
10003004-01,1064,976,52,1080,997,54,1032,932,100,1158,1082,63,819,768,31,803,703,100,975,914,42,962,844,118,1081,1011,45
10003007-01,456,414,29,463,422,30,443,398,45,496,456,31,326,292,26,317,265,52,398,362,31,410,338,72,455,416,31
10003007-02,531,460,62,533,460,65,524,450,74,571,491,76,365,329,26,357,318,39,473,395,56,454,383,71,516,429,67
10003001-06,926,618,280,923,610,293,902,592,310,950,625,310,681,454,212,673,449,224,791,485,273,781,488,293,830,487,308
10003002-15,1723,1090,595,1725,1103,590,1694,1060,634,1772,1090,657,1276,812,439,1254,792,462,1585,938,617,1547,957,590,1631,923,653
10005002-40,2009,473,1492,2018,488,1505,1988,511,1477,2043,467,1561,1485,375,1098,1458,446,1012,1941,635,1265,1903,666,1237,1996,386,1535
10003013-09,1974,1251,659,1977,1280,665,1947,1229,718,2000,1259,706,1137,738,375,1123,711,412,949,537,397,946,553,393,984,504,438
10003009-21,698,449,236,693,446,237,681,424,257,703,439,254,527,338,182,515,326,189,645,385,250,630,367,263,665,367,263
10003002-01,1174,1089,54,1178,1103,49,1139,1015,124,1245,1179,59,1001,938,36,996,836,160,1138,1060,54,1101,930,171,1246,1177,45
10003004-07,1884,1396,439,1884,1404,436,1839,1346,493,1943,1430,484,1349,987,323,1326,982,344,1539,1065,416,1512,1068,444,1620,1064,476
10005008-40,827,280,513,836,271,535,817,301,516,850,278,558,598,218,369,580,237,343,717,299,404,711,340,371,726,196,493
10005008-41,750,312,419,756,310,436,747,327,420,772,305,462,531,210,309,523,232,291,642,284,346,632,304,328,655,205,421
10005003-35,1201,552,619,1209,555,628,1182,537,645,1245,562,664,825,385,429,806,394,412,1022,540,464,1002,520,482,1063,468,565
10001002-30,316,147,164,324,150,167,317,140,177,325,147,176,213,100,111,215,106,109,268,122,143,260,115,145,272,102,157
10001010-34,822,240,556,820,252,554,809,249,560,846,239,585,588,179,395,570,194,376,677,201,460,658,274,384,700,157,492
10001009-32,1188,714,438,1191,713,449,1181,664,517,1217,729,463,807,469,323,801,469,332,1048,546,477,1032,571,461,1081,528,471
10001007-34,1952,1120,780,1955,1116,811,1930,1048,882,1999,1138,822,1396,774,590,1363,780,583,1734,865,828,1702,928,774,1782,867,816
10001005-32,571,314,237,576,322,240,575,314,261,599,335,251,408,230,168,402,240,162,512,263,236,499,283,216,521,260,230
10005004-36,1020,481,505,1023,470,536,1003,458,545,1045,500,532,736,342,368,720,358,362,893,409,462,878,421,457,927,377,503
10001006-29,1474,424,1009,1482,436,1017,1464,440,1024,1513,406,1083,1046,323,700,1039,354,685,1353,405,918,1319,502,817,1379,314,989
10001002-34,214,66,141,214,68,142,210,69,141,219,67,148,153,50,100,153,54,99,193,64,125,190,78,112,194,48,133
10001004-28,86,40,44,86,42,44,86,43,43,88,40,48,55,23,32,56,24,32,61,32,29,59,31,28,62,25,36
10005007-35,1093,388,676,1099,382,699,1085,388,697,1122,391,712,887,342,530,861,358,503,1064,417,621,1046,447,599,1089,352,684
10003012-19,762,546,190,762,545,193,751,547,204,786,565,206,546,417,112,539,406,133,704,536,145,693,515,178,755,542,181
10003001-16,1146,770,346,1147,776,337,1119,767,352,1215,809,397,832,610,202,815,587,228,1046,739,269,1016,696,320,1111,688,368
10003011-09,1995,1049,902,1996,1044,915,1975,1055,920,2037,1042,964,1497,792,672,1440,795,645,1588,809,743,1577,856,721,1626,721,816
10003006-17,175,82,85,176,86,88,171,88,83,182,84,96,105,43,60,102,48,54,143,79,56,139,82,57,150,64,80
10003002-24,1371,946,383,1374,935,397,1337,901,436,1407,961,423,906,625,251,885,626,259,1116,744,321,1081,752,329,1172,749,363
10003004-24,611,471,123,607,471,121,585,448,137,644,492,141,435,327,95,426,325,101,554,412,129,545,402,143,597,428,138
10003006-18,1139,867,239,1144,876,240,1118,842,276,1199,914,272,896,725,159,880,706,174,1049,800,214,1033,786,247,1112,816,239
10003004-16,580,423,138,588,422,142,558,414,144,627,451,164,411,321,83,400,315,85,521,393,111,509,388,121,565,389,158
10003003-21,1307,768,500,1308,757,518,1287,749,538,1325,751,548,1103,620,454,1078,645,433,1310,717,553,1268,718,550,1348,664,607
10003007-19,784,479,286,795,481,295,771,481,290,801,479,304,581,368,194,573,388,185,727,454,253,706,471,235,756,403,312
10003009-13,1123,787,302,1137,802,309,1095,783,312,1169,813,339,823,583,211,809,588,221,1029,707,288,1014,698,316,1076,682,348
10003009-01,903,816,69,908,821,77,890,767,123,943,864,71,750,677,58,745,607,138,799,706,81,788,620,168,853,743,83
10003012-12,1185,689,469,1190,663,508,1175,646,529,1202,667,520,933,516,395,913,517,396,1074,550,498,1052,529,523,1078,497,513
10005006-39,1662,614,1003,1675,611,1027,1627,597,1030,1722,626,1067,1174,445,709,1134,463,671,1517,623,857,1478,627,851,1574,506,1004
10005003-39,1253,492,723,1260,496,743,1241,495,746,1289,495,779,937,371,553,918,386,532,1125,462,642,1087,433,654,1161,392,716
10005004-20,3319,1579,1668,3350,1618,1681,3286,1576,1710,3383,1587,1763,2264,1082,1159,2219,1135,1084,2407,1137,1225,2365,1147,1218,2461,980,1400
10005008-20,424,134,282,431,146,278,422,144,278,445,141,299,329,112,211,321,129,192,413,155,246,394,153,241,423,127,278
10001001-33,462,230,223,465,229,228,459,228,231,469,228,235,328,171,152,321,177,144,381,187,188,376,205,171,386,184,182
10003005-16,1149,1051,76,1153,1053,76,1119,1020,99,1216,1119,89,877,821,44,852,710,142,1078,1004,55,1062,923,139,1164,1064,71
10003003-18,631,458,154,636,468,151,624,450,174,660,483,167,471,367,90,461,355,106,614,438,153,610,408,202,649,442,173
10003005-21,1537,948,552,1534,929,574,1495,896,599,1542,883,624,1255,749,484,1227,772,455,1394,779,579,1358,780,578,1431,735,621
10003013-12,898,589,290,901,586,308,882,530,352,915,584,327,785,490,287,776,458,318,869,477,378,840,444,396,884,502,336
10003010-03,255,186,60,260,195,60,243,175,68,267,200,64,196,148,41,194,148,46,260,194,62,253,188,65,271,187,71
10003012-04,1350,847,475,1356,823,522,1337,800,537,1374,804,551,1138,695,418,1126,732,394,1292,747,514,1251,705,546,1296,679,539
10003002-13,798,513,252,805,513,262,794,505,289,816,513,279,590,387,180,580,400,180,785,504,246,766,517,249,826,460,317
10003003-08,1123,761,339,1116,752,342,1107,747,360,1144,776,351,804,556,231,791,537,254,1008,642,347,1016,687,329,1048,611,387
10003002-08,1526,1012,478,1525,1010,482,1514,1014,500,1547,1003,524,1124,732,375,1109,712,397,1396,878,482,1400,905,495,1463,834,568
10003001-11,1445,792,622,1450,803,621,1416,831,585,1478,805,648,934,532,380,920,513,407,1111,596,480,1110,640,470,1149,497,580
10003005-24,1278,857,379,1277,861,366,1247,843,404,1334,890,416,911,590,281,895,610,285,1237,775,405,1212,813,399,1312,783,450
10003010-19,733,484,222,735,477,231,725,484,241,750,475,253,539,346,172,532,341,191,682,430,228,662,420,242,718,382,290
10003001-01,763,684,53,759,681,62,742,624,118,792,727,51,644,582,51,640,515,125,732,649,65,720,528,192,767,679,68
10003001-04,1539,1191,315,1543,1175,344,1502,1101,401,1561,1157,382,1220,929,261,1216,952,264,1364,1015,323,1314,955,359,1379,942,370
10003001-05,1456,1145,281,1453,1150,282,1419,1107,312,1511,1183,314,1038,831,187,1031,792,239,1309,1037,243,1296,994,302,1408,1053,309
10003008-15,727,429,279,725,432,276,705,420,285,745,429,302,473,257,200,466,268,198,662,357,277,651,380,271,707,336,319
10003010-12,1439,847,557,1441,837,588,1411,812,599,1446,831,598,1121,670,422,1109,683,426,1347,720,595,1314,702,612,1353,703,568
10003003-19,1100,662,412,1103,660,427,1070,631,439,1125,630,478,876,516,333,859,539,320,1071,634,400,1041,631,410,1100,540,499
10003003-01,767,713,30,783,732,34,745,670,75,815,780,33,574,542,20,561,478,83,719,681,24,728,588,140,787,763,19
10003006-15,1189,927,227,1188,926,237,1167,892,275,1210,936,250,873,682,168,865,669,196,1079,809,238,1062,771,291,1119,809,246
10003006-01,386,357,15,394,362,22,374,340,34,428,410,13,315,295,12,309,268,41,386,361,18,371,317,54,425,398,15
10003006-03,516,464,29,536,485,33,503,458,45,578,532,43,328,306,12,322,278,44,545,507,24,514,450,64,629,592,27
10003001-26,1192,777,382,1198,771,397,1180,782,398,1218,790,405,853,559,269,842,569,273,1049,655,356,1039,668,371,1076,617,396
10003008-23,1082,735,320,1084,729,337,1075,720,355,1106,724,361,935,613,291,917,613,304,1046,613,401,1028,643,385,1063,602,386
10001001-28,835,562,240,841,566,244,817,558,259,857,580,263,549,405,128,544,402,142,721,520,179,714,517,197,769,499,225
10001009-28,84,47,36,84,48,36,84,45,39,87,48,39,53,30,23,53,30,23,54,30,24,55,32,23,56,30,26
10003002-19,873,531,308,866,535,310,838,529,309,903,543,345,618,399,200,607,403,204,815,526,267,796,514,282,839,469,326
10003001-18,1473,1092,341,1479,1093,343,1439,1055,384,1535,1121,388,999,757,218,982,753,229,1340,960,338,1315,957,358,1434,963,397
10003006-07,839,584,237,842,591,242,824,565,259,848,584,253,677,482,180,666,496,170,761,513,225,739,504,235,788,482,261
10003010-07,1368,1006,316,1370,1013,315,1338,982,356,1415,1056,348,1031,766,246,1010,758,252,1234,904,298,1200,881,319,1317,905,354
10003010-10,710,554,138,715,556,145,705,545,160,770,607,156,554,445,96,544,443,101,634,494,117,623,492,131,694,522,136
10005006-38,2805,1054,1713,2817,1105,1690,2759,1060,1699,2874,1065,1786,2174,759,1387,2133,847,1286,2118,766,1329,2084,759,1325,2226,638,1538
10005005-35,545,158,374,550,162,378,547,173,374,566,152,408,386,107,276,378,130,248,463,171,286,472,173,299,489,110,366
10003005-22,1816,1050,732,1817,1022,771,1786,987,799,1833,1019,793,1508,848,631,1484,843,641,1706,877,797,1666,878,788,1737,829,807
10003010-17,858,602,228,861,598,231,839,590,249,908,638,261,579,414,148,559,401,158,720,525,171,711,519,192,794,534,224
10003008-26,348,237,98,347,236,103,340,235,105,362,250,109,266,183,77,262,168,94,303,203,92,300,198,102,320,196,109
10003005-05,963,836,103,970,849,109,955,828,127,1009,880,123,753,657,76,742,623,119,876,756,98,875,720,155,949,807,109
10003008-16,1249,1028,186,1268,1039,202,1227,994,233,1335,1098,218,989,827,142,979,779,200,1198,999,179,1189,937,252,1290,1029,209
10003003-26,811,558,228,811,561,231,792,540,252,831,572,250,647,463,165,634,452,182,784,540,224,778,543,235,816,529,241
10003007-08,1534,752,743,1536,766,745,1520,786,734,1567,715,821,1067,541,502,1047,534,513,1363,682,661,1362,733,629,1396,553,766
10003008-17,556,426,118,560,426,127,546,408,138,592,461,126,434,348,74,427,329,98,540,426,104,522,404,118,572,434,125
10003005-02,586,517,54,601,529,59,572,485,87,631,557,67,484,426,44,481,400,81,621,549,58,619,503,116,678,587,70
10003001-13,1186,755,389,1191,772,387,1164,749,415,1210,761,429,877,577,273,861,593,268,1126,671,418,1093,683,410,1170,637,467
10003003-12,1007,676,300,1010,661,330,996,636,360,1017,670,330,771,519,235,759,525,234,890,555,307,861,543,318,902,512,328
10003006-19,239,166,60,241,170,61,231,165,66,251,187,60,150,111,34,143,107,36,196,134,55,190,137,53,206,143,48
10003003-22,1249,796,419,1256,779,457,1243,748,495,1264,769,479,981,560,401,948,564,384,1167,628,515,1133,629,504,1177,598,522
10001004-32,478,350,118,480,346,131,480,310,170,493,352,133,308,220,80,303,205,98,414,276,135,399,263,136,433,293,120
10001011-28,727,543,153,732,565,152,717,514,203,755,570,170,530,407,109,527,402,125,672,480,169,655,446,209,702,506,169
10005008-36,213,74,129,218,69,142,212,69,143,226,74,147,159,45,110,156,54,102,203,72,126,198,69,129,211,51,155
10003010-08,1262,868,365,1259,850,386,1246,856,390,1285,854,417,862,606,240,854,567,287,1060,692,351,1065,718,347,1102,682,374
10003009-02,622,410,192,623,407,198,609,397,212,638,413,215,444,307,123,433,313,120,582,384,173,565,385,180,618,363,221
10003003-07,1214,805,377,1213,808,382,1196,786,410,1229,806,403,1001,668,313,984,662,322,1109,689,383,1080,657,423,1139,670,414
10003008-12,1325,816,476,1325,792,514,1305,751,554,1341,792,533,1081,637,417,1065,634,431,1261,660,565,1232,646,586,1263,674,530
10003009-23,489,286,185,488,286,191,475,271,204,492,285,194,386,207,170,383,217,166,447,239,197,437,218,219,441,207,200
10003006-05,1003,838,141,1007,837,150,989,821,168,1042,885,150,829,713,104,815,674,141,985,832,132,972,796,176,1038,869,140
10003008-22,910,542,337,908,528,350,886,516,370,932,542,367,731,425,289,714,427,287,896,482,387,876,499,377,927,446,416
10003012-06,1401,915,455,1397,912,463,1364,846,518,1423,891,504,1166,731,393,1138,763,375,1297,776,484,1274,769,505,1314,759,477
10003003-05,801,661,126,795,659,122,784,641,143,830,693,135,630,521,95,623,502,121,783,645,123,774,613,161,824,655,141
10003010-18,570,444,113,569,441,110,566,433,133,600,463,130,414,333,73,414,326,88,527,379,135,518,369,149,553,373,145
10003009-24,602,361,223,605,365,225,593,367,226,622,380,231,446,249,177,435,261,174,556,318,212,558,334,224,575,302,222
10003002-05,691,482,188,694,473,198,676,473,203,717,486,219,524,392,119,521,390,131,688,498,163,673,481,192,735,495,205
10003002-06,1384,910,443,1385,913,449,1356,845,511,1406,870,520,1111,687,392,1087,692,395,1267,720,525,1224,701,523,1283,701,521
10003010-22,1150,727,394,1154,716,418,1135,704,431,1160,704,444,913,553,343,905,580,325,1079,630,432,1061,603,458,1100,606,447
10003013-01,743,641,82,748,642,91,727,622,105,761,659,91,597,512,66,590,491,99,688,566,101,676,533,143,728,589,107
10003001-08,1058,422,602,1055,419,620,1051,480,571,1067,423,630,783,339,435,778,329,449,947,408,522,951,464,487,974,318,598
10003005-23,979,744,199,984,750,199,959,739,220,1027,779,223,725,563,133,714,560,154,939,657,225,927,687,240,959,688,191
10003003-03,473,416,40,483,422,46,454,385,69,508,463,37,351,319,25,340,280,60,388,340,36,380,316,64,435,398,24
10003003-27,967,721,229,963,713,232,958,708,250,987,730,245,702,531,159,694,517,177,871,596,243,875,604,271,916,594,271
10003002-02,416,393,11,422,402,9,407,387,20,461,448,13,320,305,8,318,275,43,408,393,11,394,338,56,460,441,14
10003002-10,1185,759,404,1187,766,408,1178,754,424,1206,761,429,880,575,286,865,584,281,1036,622,377,1010,644,366,1059,600,391
10003002-27,964,619,304,958,622,308,940,640,300,989,655,307,759,510,228,741,523,218,906,577,295,896,589,307,936,542,347
10003006-12,623,380,227,626,361,259,610,337,273,631,353,268,504,283,204,500,287,213,567,295,260,547,269,278,573,279,268
10003008-10,893,687,168,905,708,168,865,680,185,949,739,201,664,535,113,653,528,125,858,675,146,843,669,174,929,696,184
10001010-32,122,46,70,118,47,70,117,45,72,123,48,73,79,32,43,78,39,39,107,48,55,102,52,50,104,39,58
10003005-03,84,80,3,83,79,3,81,76,5,90,86,3,55,49,3,54,49,5,66,61,3,69,56,13,77,71,3
10003007-21,176,83,86,180,77,98,176,75,101,179,68,102,139,51,81,133,57,76,161,57,101,157,54,103,164,56,96
10005003-36,2099,953,1091,2112,981,1098,2077,960,1117,2130,957,1149,1599,729,847,1567,753,814,1807,788,991,1755,815,940,1850,666,1099
10003001-21,665,434,222,664,429,225,654,418,236,674,419,247,528,353,170,515,337,178,622,358,248,603,352,251,623,333,257
10003015-04,511,336,165,507,319,183,497,296,201,512,325,181,382,241,137,383,239,144,463,264,194,456,248,208,466,248,202
10003006-21,1424,964,418,1420,956,442,1397,925,472,1438,952,461,1068,714,317,1037,720,317,1275,792,431,1233,768,465,1306,766,466
10003014-04,245,194,41,249,198,46,241,188,53,259,205,52,189,149,29,189,156,33,210,158,50,207,152,55,214,143,65
10003008-24,1158,688,426,1162,678,454,1131,679,452,1201,706,465,811,487,286,790,497,293,1045,635,366,1018,633,385,1102,575,448
10003006-27,929,724,177,926,714,188,913,706,207,960,751,193,664,523,123,659,516,143,834,615,201,832,609,223,884,617,231
10003008-03,946,724,193,943,726,200,920,694,226,984,739,231,699,539,133,684,543,141,926,719,185,903,673,230,990,696,256
10003004-12,1030,635,375,1032,635,386,1009,580,429,1036,622,402,853,496,342,834,514,320,906,454,442,886,411,475,912,459,415
10003008-18,963,743,203,964,751,198,950,724,226,994,775,206,718,564,143,707,540,167,919,688,208,905,665,240,956,687,215
10003004-19,1201,744,425,1211,733,446,1160,722,438,1248,767,455,855,526,315,830,528,302,1102,656,412,1072,657,415,1163,629,468
10003006-23,1391,889,463,1403,876,499,1378,870,508,1424,887,516,1138,684,423,1124,716,408,1328,767,532,1304,775,529,1339,749,513
10003010-05,948,820,99,938,819,99,920,797,123,982,862,108,689,621,59,679,596,83,848,758,78,833,710,123,911,788,98
10003003-10,1103,701,373,1098,684,397,1085,668,417,1117,693,409,879,558,305,860,555,305,1026,575,422,1003,573,430,1070,566,461
10003004-08,1047,820,203,1045,823,203,1038,813,225,1090,863,213,804,655,126,793,636,157,946,752,169,955,768,187,1008,773,190
10003006-22,608,362,232,608,360,239,601,344,257,623,359,253,484,283,194,480,287,193,561,312,239,554,299,255,571,269,271
10003007-13,351,240,104,353,236,109,346,237,109,362,246,110,259,175,75,256,177,79,320,204,103,312,212,100,330,192,118
10003008-07,1349,867,454,1348,860,468,1321,816,505,1371,859,496,1079,688,371,1058,684,374,1230,736,456,1176,704,472,1260,710,490
10003007-12,1073,670,374,1074,661,388,1052,638,414,1092,663,409,836,526,285,823,529,294,949,522,409,937,528,409,957,492,417
10003010-04,212,161,44,216,168,43,210,156,54,222,167,51,160,130,24,153,129,24,179,125,46,165,116,49,187,117,56
10003012-22,971,536,415,969,521,437,947,514,433,987,525,440,731,405,312,720,402,318,843,429,382,824,442,382,857,384,419
10003009-22,1007,584,404,1007,587,405,995,555,440,1023,561,443,825,469,341,811,484,327,977,536,420,954,510,444,1005,486,461
10003002-22,1124,719,371,1116,700,399,1088,651,437,1133,689,421,852,518,319,836,520,316,978,554,404,945,511,434,972,499,410
10003004-02,100,77,22,100,76,23,99,71,28,100,76,21,81,60,17,81,61,20,70,46,18,70,49,21,71,51,19
10003013-13,97,83,12,98,83,14,95,77,18,105,86,19,74,66,7,70,61,9,108,87,19,108,82,26,119,86,26
10003002-12,1081,723,332,1083,721,342,1062,698,364,1095,725,356,850,556,266,837,568,269,965,585,346,935,578,357,985,569,348
10003011-01,623,548,51,625,554,55,601,511,90,639,583,51,518,465,32,512,423,89,578,505,53,580,438,142,616,529,66
10003004-04,542,459,72,540,448,81,523,429,94,559,471,80,444,372,62,433,368,65,490,383,91,474,361,113,544,421,98
10003006-25,1205,826,336,1212,825,345,1173,813,360,1247,841,376,830,560,244,819,575,244,1102,710,355,1093,739,354,1153,707,381
10003008-25,560,379,167,564,378,174,556,378,178,579,380,192,437,297,127,429,304,125,502,338,148,511,359,152,540,325,178
10003007-09,605,328,262,601,308,284,596,333,263,605,311,279,418,219,193,409,219,190,501,250,245,507,269,238,523,223,272
10003001-22,1366,860,471,1366,834,509,1350,792,558,1379,838,521,1110,672,411,1086,677,409,1271,693,551,1246,687,559,1278,653,576
10003009-10,1036,622,386,1032,620,392,1018,595,423,1049,601,424,804,479,303,793,491,302,920,539,357,898,524,374,958,512,401
10003003-06,321,236,77,323,232,82,318,214,104,330,229,95,273,185,84,274,184,90,311,188,114,308,183,125,311,185,109
10003002-23,1315,884,378,1308,874,399,1279,863,416,1336,901,405,1112,747,324,1094,725,369,1294,798,458,1273,826,447,1298,775,420
10003009-16,280,180,88,275,186,82,268,182,86,285,177,103,216,141,70,210,139,71,244,164,74,239,162,77,257,151,99
10003007-05,874,691,166,870,697,159,856,680,176,911,718,181,604,498,90,599,484,115,684,545,130,674,515,159,724,552,150
10003012-13,5,5,0,5,5,0,5,5,0,5,4,0,1,1,0,1,1,0,4,4,0,4,4,0,4,4,0
10003003-02,231,201,25,227,194,28,225,182,43,233,202,27,178,151,19,180,152,28,192,151,35,190,148,42,195,156,23
10003014-13,0,0,0,0,0,0,0,0,0,0,0,0,0,0,0,0,0,0,0,0,0,0,0,0,0,0,0
10003009-08,297,144,147,297,141,150,291,139,152,303,136,163,181,95,85,180,101,79,258,132,120,255,138,117,257,118,125
10003016-04,109,91,16,112,92,18,112,88,24,117,97,19,74,59,14,73,57,16,104,83,17,101,76,25,111,84,22
10003004-27,1459,960,461,1458,964,466,1436,974,462,1488,968,489,1047,721,307,1024,712,312,1225,747,442,1211,781,430,1271,722,477
10003009-04,573,485,63,573,484,73,560,469,91,595,513,77,466,398,50,464,396,68,523,406,98,507,407,100,548,425,84
10003011-06,1090,723,347,1092,704,369,1073,663,410,1089,705,372,909,597,297,895,597,298,1025,633,371,996,621,375,1026,627,351
10003009-12,1136,744,371,1137,733,388,1106,684,422,1152,723,413,800,516,272,785,515,270,979,571,384,962,545,417,996,544,402
10005010-36,129,47,80,129,52,74,125,46,79,134,49,84,85,38,47,83,39,44,124,53,70,117,50,67,127,38,85
10005010-20,315,114,195,313,112,197,308,112,196,320,109,206,242,91,147,240,100,140,270,97,167,263,98,165,276,78,187
10003009-15,624,356,252,623,358,258,611,362,249,634,356,265,427,262,152,420,269,151,523,301,208,522,307,215,542,276,239
10003013-02,0,0,0,0,0,0,0,0,0,0,0,0,0,0,0,0,0,0,0,0,0,0,0,0,0,0,0
10003004-15,908,622,267,909,620,278,891,617,274,934,629,293,666,464,185,658,450,208,840,552,267,836,558,278,864,506,306
10003003-13,267,217,41,270,225,41,263,215,48,301,238,58,182,156,16,183,163,20,278,254,22,273,228,45,304,263,36
10003009-05,862,736,102,859,725,111,840,718,122,907,782,116,649,565,64,637,527,110,775,678,84,774,653,121,839,717,104
