GEOID20,Tot_2016_ag,D_2016_ag,R_2016_ag,Tot_2016_pres,D_2016_pres,R_2016_pres,Tot_2016_gov,D_2016_gov,R_2016_gov,Tot_2018_sen,D_2018_sen,R_2018_sen,Tot_2020_ag,D_2020_ag,R_2020_ag,Tot_2020_gov,D_2020_gov,R_2020_gov,Tot_2020_sen,D_2020_sen,R_2020_sen,Tot_2020_pres,D_2020_pres,R_2020_pres
30039000009,336,70,266,342,75,249,352,126,216,349,108,232,397,87,310,396,91,293,404,104,300,401,91,304
30069000001,324,29,295,322,30,278,331,74,247,312,58,248,346,40,306,350,44,299,351,51,300,348,39,298
30085000002,237,44,193,245,33,195,247,58,180,213,45,159,287,46,241,290,48,228,291,54,237,289,42,242
30083000012,553,66,487,579,73,479,576,125,423,506,135,340,692,114,578,701,115,551,708,143,565,714,102,594
30085000010,183,48,135,189,38,139,189,67,112,171,62,101,194,46,148,194,51,136,196,59,137,196,46,142
30105000033,1513,338,1175,1549,352,1070,1573,582,936,1570,657,824,1732,468,1264,1747,513,1149,1752,553,1199,1764,433,1279
30105000034,1519,292,1227,1557,282,1161,1591,526,1002,1556,535,934,1595,325,1270,1618,341,1217,1623,396,1227,1618,299,1294
30105000031,763,245,518,770,252,467,788,357,405,756,353,379,878,323,555,883,328,533,884,357,527,879,298,562
30053000011,635,118,517,661,97,537,658,181,456,664,132,519,832,136,696,841,152,662,838,172,666,842,147,684
30053000010,780,175,605,795,171,578,814,305,474,819,276,526,884,203,681,891,236,636,893,242,651,893,220,656
30053000003,1623,305,1318,1644,320,1250,1670,477,1137,1762,464,1263,2288,506,1782,2305,540,1698,2310,567,1743,2308,497,1754
30053000004,465,102,363,463,91,339,473,160,292,437,135,281,579,148,431,588,158,402,595,167,428,596,148,435
30035000008,451,405,46,447,403,27,460,435,17,431,415,14,489,458,31,487,447,23,491,468,23,489,447,34
30035000015,224,132,92,230,139,80,233,159,65,248,176,67,257,172,85,260,177,74,262,183,79,257,165,88
30059000005,966,151,815,975,193,729,997,364,602,976,319,629,1095,246,849,1112,256,823,1118,306,812,1110,258,833
30085000012,489,76,413,506,91,387,512,146,345,449,152,292,532,156,376,539,122,397,537,128,409,539,107,421
30017000003,1215,253,962,1227,314,835,1255,516,706,1157,485,640,1374,405,969,1393,417,918,1390,466,924,1389,395,963
30017000001,825,244,581,825,209,545,852,396,406,760,366,357,944,320,624,952,307,563,949,380,569,953,298,627
30053000006,263,71,192,270,65,184,275,105,160,263,88,166,298,89,209,304,82,205,302,94,208,303,88,211
30053000005,152,42,110,150,35,112,161,51,98,154,45,107,206,49,157,208,57,144,209,50,159,208,51,153
30053000001,434,84,350,445,80,344,444,113,307,459,119,330,575,120,455,579,123,440,579,134,445,582,118,456
30049000033,580,107,473,577,109,426,595,232,340,597,194,384,720,161,559,730,159,542,735,174,561,738,146,585
30057000020,1630,444,1186,1649,458,1111,1689,668,972,1764,679,1036,2349,784,1565,2367,792,1505,2381,866,1515,2375,800,1533
30055000008,338,37,301,342,46,283,346,70,268,342,64,268,364,47,317,366,49,310,365,51,314,369,48,316
30055000004,427,57,370,444,59,367,445,96,336,410,96,304,451,65,386,448,63,368,455,74,381,458,62,386
30055000027,276,55,221,274,49,212,279,82,194,277,67,201,302,49,253,303,53,243,303,52,251,301,45,254
30035000005,479,146,333,484,133,325,497,223,261,466,218,243,533,191,342,538,183,337,545,216,329,548,180,358
30073000035,432,84,348,435,81,329,447,157,282,432,142,270,470,111,359,477,113,351,475,118,357,475,108,357
30035000002,327,81,246,324,91,202,340,163,171,318,153,149,353,127,226,357,130,216,362,150,212,362,125,228
30039000002,563,185,378,557,184,337,575,301,255,537,253,268,623,223,400,629,238,370,631,267,364,631,231,385
30039000010,461,88,373,461,91,347,480,171,299,478,150,320,536,136,400,547,132,384,545,150,395,543,121,409
30035000011,132,83,49,128,76,39,131,98,28,136,101,34,195,135,60,205,149,49,206,156,50,140,82,54
30085000027,381,263,118,382,262,100,391,299,78,304,237,64,356,237,119,356,226,110,359,245,114,357,226,121
30017000006,151,22,129,152,21,123,154,46,105,152,36,116,179,23,156,180,24,155,180,30,150,177,21,154
30017000004,1118,260,858,1138,265,771,1159,500,598,1048,473,521,1249,371,878,1263,383,808,1260,437,823,1269,338,890
30049000001,1107,208,899,1092,264,729,1135,560,533,1111,515,553,1340,444,896,1351,452,848,1354,486,868,1341,405,900
3004700POL3,496,181,315,498,220,251,514,281,215,501,276,211,577,273,304,584,281,278,585,299,286,584,285,285
30049000005,984,458,526,988,548,343,1021,743,242,977,698,246,1162,729,433,1178,729,399,1173,757,416,1162,693,431
30077000007,346,145,201,343,76,234,347,161,171,350,145,180,416,129,287,415,116,269,410,142,268,411,103,296
30085000024,364,217,147,359,183,135,374,259,90,347,245,90,399,250,149,400,260,111,400,283,117,398,245,136
30085000026,501,172,329,512,167,287,526,242,255,500,244,240,579,213,366,566,225,319,579,253,326,577,219,339
30033000014,91,4,87,91,4,87,89,8,80,85,7,77,99,5,94,98,5,93,100,6,94,100,6,94
30025000001,1423,163,1260,1484,154,1279,1477,368,1062,1289,281,951,1509,166,1343,1555,218,1288,1576,235,1341,1575,172,1375
30035000019,178,150,28,176,137,28,177,155,19,188,164,21,192,161,31,198,159,33,199,166,33,195,156,37
30035000009,1186,1017,169,1153,967,125,1188,1084,85,1191,1103,77,1428,1255,173,1427,1217,148,1434,1295,139,1425,1201,190
30035000004,205,69,136,204,60,128,208,115,77,176,83,79,221,73,148,224,70,136,222,90,132,221,67,145
30053000012,1025,189,836,1033,173,800,1055,346,655,1026,296,686,1258,246,1012,1267,267,944,1272,295,977,1280,246,1002
30035000003,299,103,196,302,101,171,310,151,141,286,147,132,335,143,192,337,142,175,338,163,175,338,134,192
30057000007,730,138,592,737,152,539,756,272,467,776,258,485,864,199,665,872,214,638,876,232,644,874,197,665
30001000017,108,22,86,106,18,82,108,33,75,111,29,78,137,33,104,137,32,101,136,39,97,137,34,96
30091000002,376,109,267,372,107,244,389,167,214,373,164,196,428,114,314,433,142,278,430,152,278,429,122,290
30091000005,204,33,171,209,34,163,212,69,131,196,61,127,210,38,172,210,48,154,212,57,155,215,41,170
30091000006,210,47,163,217,67,134,228,99,120,214,94,108,242,75,167,246,89,138,248,100,148,243,82,151
30091000001,154,33,121,167,35,126,168,64,102,178,54,121,197,34,163,199,37,160,197,40,157,197,40,155
30035000010,311,241,70,310,240,56,325,280,41,317,281,35,319,262,57,323,264,49,324,276,48,324,266,51
30077000002,95,25,70,96,18,73,99,27,70,95,29,63,127,31,96,129,30,93,128,38,90,127,29,96
30051000001,285,28,257,283,42,226,287,85,195,312,89,213,328,52,276,332,54,272,332,57,275,330,41,287
30051000002,230,50,180,236,66,159,242,121,117,245,120,122,255,97,158,256,91,155,259,106,153,259,90,166
30065000005,610,67,543,608,70,506,624,165,436,613,112,480,722,73,649,734,86,621,733,97,636,736,75,657
30037000002,241,32,209,239,31,188,244,80,158,233,62,163,253,39,214,252,37,209,253,44,209,253,33,212
30065000001,435,61,374,438,83,328,450,164,267,421,145,249,484,100,384,485,106,360,491,132,359,488,98,377
3006300098N,563,260,303,569,296,213,594,402,182,608,420,171,726,444,282,737,439,268,740,471,269,737,444,277
30061000025,423,85,338,429,113,288,443,186,238,435,156,269,517,132,385,526,131,369,527,153,374,528,132,382
30061000024,162,39,123,172,57,99,178,93,72,174,82,78,193,67,126,193,67,119,192,75,117,196,64,128
300570001-2,182,28,154,191,36,145,194,82,104,175,63,106,196,40,156,196,45,146,201,44,157,198,38,159
3006300092C,585,164,421,588,173,373,602,305,276,627,297,305,719,278,441,729,290,405,732,313,419,726,272,434
3006300089C,459,122,337,461,145,270,479,250,205,465,220,230,524,200,324,529,216,286,535,229,306,535,203,313
30061000022,360,125,235,367,115,208,370,175,170,355,179,163,451,171,280,454,172,262,458,199,259,449,164,277
30053000009,1093,317,776,1112,312,726,1143,518,582,1107,468,586,1349,460,889,1378,477,838,1380,522,858,1379,465,883
30053000013,945,249,696,958,245,657,972,388,547,932,340,560,1195,310,885,1212,341,829,1208,374,834,1222,322,886
30053000008,767,200,567,780,202,544,793,287,472,760,242,489,941,237,704,949,265,667,952,274,678,945,247,679
30053000007,399,121,278,408,122,260,416,181,216,413,148,250,467,149,318,471,149,290,467,173,294,471,140,314
30053000014,252,65,187,266,61,184,269,101,153,244,73,166,300,68,232,305,70,224,305,79,226,304,66,229
300570015-1,218,32,186,211,36,161,224,73,146,211,52,155,250,51,199,253,55,191,254,52,202,252,46,198
300570001-1,174,71,103,177,66,102,183,98,77,172,87,79,221,102,119,225,108,109,226,109,117,225,96,123
30073000024,554,111,443,567,135,393,586,266,310,563,250,292,646,180,466,652,181,444,652,216,436,646,162,470
3010100Sh-6,172,18,154,177,24,142,181,52,127,163,35,123,163,33,130,164,34,128,165,36,129,164,30,132
30035000006,71,12,59,73,15,55,74,21,51,68,20,46,70,18,52,70,17,52,72,19,53,71,16,54
30041000014,351,72,279,359,67,265,366,151,198,335,129,186,368,80,288,381,86,274,382,104,278,380,81,290
30041000015,255,66,189,259,63,181,265,119,140,251,101,143,291,78,213,297,78,203,298,87,211,296,75,213
30041000007,633,186,447,646,230,369,667,372,281,644,368,247,705,299,406,708,299,375,717,339,378,706,293,390
30041000020,265,42,223,256,51,179,275,123,147,248,128,112,285,66,219,284,73,196,289,80,209,285,59,217
30041000021,134,40,94,136,35,91,139,66,73,140,59,77,148,46,102,150,46,100,150,48,102,145,44,99
30073000019,323,77,246,324,75,226,334,152,172,308,126,171,353,107,246,353,104,234,357,132,225,356,104,245
30099000017,322,91,231,325,100,213,330,159,164,306,137,162,353,114,239,354,115,221,355,127,228,351,113,231
300710011-N,1587,226,1361,1578,248,1235,1637,393,1212,1494,434,991,1681,326,1355,1689,315,1333,1696,369,1327,1700,309,1366
300710011-S,572,61,511,583,70,488,594,100,481,588,143,435,679,107,572,684,97,575,682,114,568,682,107,570
30073000020,280,245,35,277,241,19,283,269,13,293,279,11,263,240,23,263,230,18,264,248,16,260,235,18
30051000004,205,36,169,208,41,160,212,81,123,195,62,122,221,50,171,228,48,174,231,54,177,228,44,179
30021000001,349,87,262,354,83,247,363,111,232,507,211,279,631,208,423,644,212,401,645,217,428,647,186,445
30021000003,778,163,615,787,185,565,811,230,559,551,181,361,634,162,472,647,185,443,642,186,456,641,151,469
30021000007,1066,180,886,1083,174,871,1107,246,810,1053,291,719,1225,221,1004,1240,227,962,1244,271,973,1239,210,1014
30021000004,441,121,320,446,106,302,454,135,289,366,145,208,446,125,321,453,125,298,450,131,319,456,109,331
30021000006,875,123,752,877,106,736,899,171,678,858,175,654,962,140,822,965,166,776,967,157,810,966,126,824
300630089CS,1482,488,994,1480,636,734,1551,813,701,1582,874,674,1996,968,1028,2036,994,985,2040,1076,964,2033,1013,972
3006300089L,616,168,448,621,207,368,636,284,335,658,313,337,766,308,458,773,307,441,774,337,437,768,303,449
300630099CS,1484,455,1029,1460,666,703,1539,831,677,1506,873,609,1758,840,918,1786,889,852,1787,952,835,1769,883,838
3006300096E,3761,1401,2360,3815,1725,1765,3935,2265,1539,4165,2540,1511,5308,2848,2460,5391,2895,2233,5430,3202,2228,5431,2910,2346
3006300094H,1518,649,869,1524,790,624,1567,933,601,1548,986,540,1787,1032,755,1817,1050,720,1823,1112,711,1817,1075,695
3006300095L,1856,1311,545,1904,1295,348,1940,1591,264,1896,1634,222,2094,1693,401,2123,1671,341,2121,1776,345,2118,1692,368
300630095He,675,321,354,695,356,265,706,448,207,727,504,191,900,552,348,924,554,306,923,603,320,918,535,357
30063091RsW,1873,1176,697,1885,1414,351,1943,1580,344,1973,1652,307,2116,1742,374,2143,1760,367,2145,1785,360,2126,1761,340
300570015-2,335,70,265,334,64,250,343,125,203,350,119,210,396,109,287,402,110,265,402,123,279,397,103,283
30041000001,633,258,375,637,241,318,656,384,246,586,364,199,674,341,333,680,345,293,681,392,289,680,331,321
30041000003,556,182,374,549,183,319,570,322,228,533,289,230,624,243,381,624,262,335,628,287,341,625,244,366
30041000009,487,167,320,471,199,242,502,307,187,484,289,179,516,223,293,515,233,264,518,242,276,512,209,294
30073000023,112,14,98,115,14,91,117,40,73,116,27,82,143,22,121,144,25,117,144,28,116,144,23,120
3002305-77N,584,258,326,578,266,268,606,404,188,588,399,174,663,376,287,671,372,278,670,393,277,668,348,309
30023004-77,103,34,69,99,29,61,103,55,45,100,42,54,121,40,81,124,44,77,122,48,74,123,40,79
3002301-77W,511,268,243,524,302,195,541,402,134,524,404,109,580,374,206,585,380,191,594,409,185,591,361,217
3002305-77S,467,212,255,462,223,207,488,311,162,477,309,156,521,276,245,523,287,222,524,293,231,525,267,245
3004700RON1,1318,399,919,1322,447,778,1355,681,611,1223,652,530,1456,650,806,1466,668,716,1476,742,734,1476,645,792
3004700PAB1,357,106,251,366,123,212,365,182,165,394,153,234,471,128,343,471,136,318,477,165,312,481,132,341
3004700PAB2,801,322,479,799,318,421,826,449,337,954,553,374,1092,530,562,1102,489,537,1099,593,506,1104,497,564
30049000022,673,343,330,695,422,195,702,523,158,625,481,132,784,579,205,796,578,181,796,603,193,790,554,206
30081000001,602,120,482,615,122,461,621,197,389,579,160,405,699,157,542,708,157,523,708,176,532,709,155,536
30081000023,1199,270,929,1194,324,798,1236,505,689,1292,512,744,1567,518,1049,1585,541,989,1587,579,1008,1574,512,1025
30081000008,1166,464,702,1152,492,575,1193,664,484,1191,672,481,1368,666,702,1374,668,661,1384,716,668,1378,650,697
30081000002,1001,193,808,1009,211,754,1027,325,663,1026,305,690,1193,277,916,1205,275,896,1204,304,900,1206,280,912
30081000004,731,155,576,731,187,514,746,258,472,733,230,491,840,221,619,845,227,592,840,236,604,843,226,605
30081000016,787,169,618,785,173,568,808,296,473,786,265,496,978,274,704,985,260,677,986,308,678,988,260,702
30081000012,839,195,644,846,231,563,879,368,484,935,363,559,1092,307,785,1109,320,757,1105,339,766,1100,307,767
30051000003,230,52,178,229,57,153,237,91,138,229,94,129,267,86,181,267,75,187,266,82,184,266,74,189
3002304-78W,270,104,166,266,98,156,278,153,111,307,146,148,352,122,230,357,128,206,354,141,213,355,117,230
3006300092B,1313,519,794,1328,527,679,1369,794,497,1334,771,526,1520,806,714,1545,815,659,1547,894,653,1554,797,715
3006300098S,1433,611,822,1428,701,587,1478,929,513,1473,992,450,1656,997,659,1674,1005,601,1681,1083,598,1675,1009,609
300630092Se,1162,329,833,1180,337,758,1203,595,574,1206,516,653,1363,446,917,1369,451,869,1379,520,859,1373,453,896
30005000010,432,51,381,444,54,367,449,126,312,440,131,293,472,83,389,473,77,383,477,93,384,474,66,401
30005000011,602,150,452,606,172,384,617,269,325,618,301,288,665,219,446,679,214,432,678,253,425,682,206,461
30005000001,268,32,236,260,32,217,278,65,203,285,75,199,298,58,240,302,58,235,304,67,237,300,48,242
30041000018,117,87,30,123,80,31,120,97,22,156,129,23,185,142,43,181,135,40,185,144,41,183,134,45
30041000025,531,152,379,537,140,332,553,278,257,543,273,243,612,242,370,613,235,335,619,263,356,613,210,377
30037000001,235,30,205,233,40,178,245,86,150,222,68,141,251,39,212,252,43,201,252,55,197,251,45,203
30107000003,89,13,76,89,17,69,91,25,65,90,21,65,114,17,97,113,18,95,113,19,94,114,15,99
30087000003,457,88,369,463,100,333,477,175,282,463,189,261,531,157,374,532,158,348,532,175,357,534,150,371
30005000013,118,14,104,116,16,97,123,30,90,118,28,86,127,22,105,128,20,104,127,25,102,127,15,110
30005000003,370,291,79,365,300,35,381,341,30,457,434,17,428,377,51,428,362,38,435,396,39,428,377,44
30015000004,248,36,212,249,56,181,256,104,148,248,90,154,282,75,207,287,77,202,288,81,207,285,69,209
30015000003,299,43,256,299,75,198,306,138,157,301,132,162,334,98,236,337,94,230,338,123,215,337,86,242
30015000006,268,35,233,267,52,202,272,97,170,268,89,176,291,68,223,292,74,209,294,86,208,293,71,215
30077000005,340,149,191,347,97,215,357,165,175,343,170,158,367,116,251,366,132,217,369,140,229,367,110,242
30087000020,209,21,188,208,29,170,214,58,151,197,48,143,213,40,173,213,41,165,214,37,177,215,37,174
30087000026,63,5,58,67,4,60,67,18,48,62,13,48,76,5,71,76,6,70,76,9,67,76,5,70
30077000012,145,26,119,146,20,116,152,51,100,146,43,101,172,37,135,176,46,124,177,50,127,175,40,130
30077000014,160,26,134,163,31,121,169,70,98,165,49,109,202,44,158,202,47,151,204,48,156,204,43,159
30077000010,76,9,67,83,9,70,83,29,50,80,20,56,92,13,79,92,21,67,92,20,72,94,14,79
30077000011,99,10,89,104,7,93,103,20,79,103,13,83,121,15,106,121,15,102,121,19,102,121,15,105
30015000008,267,48,219,265,62,187,280,110,164,270,124,141,282,76,206,282,77,200,287,91,196,282,73,204
30081000017,877,231,646,859,260,561,900,360,515,929,357,552,1159,349,810,1172,359,774,1175,403,772,1170,370,786
30081000024,1173,340,833,1181,392,710,1213,578,592,1272,591,645,1441,521,920,1455,529,860,1456,594,862,1455,525,894
30081000019,1048,249,799,1062,294,710,1076,438,604,1213,487,700,1504,449,1055,1516,465,992,1519,508,1011,1517,457,1027
30065000007,125,8,117,127,10,114,126,35,86,126,21,99,143,16,127,144,16,120,145,23,122,144,16,127
300630095SC,745,556,189,774,561,121,795,669,92,928,813,102,1176,942,234,1202,950,199,1211,1002,209,1205,967,205
30049000002,1143,252,891,1119,334,707,1166,564,576,1178,546,603,1411,541,870,1437,533,867,1443,569,874,1440,506,909
30049000010,1490,276,1214,1477,391,996,1535,725,779,1603,652,915,1878,609,1269,1913,636,1232,1926,667,1259,1902,572,1285
30049000029,457,126,331,456,160,268,468,235,222,503,246,247,579,235,344,586,237,335,582,244,338,588,227,347
3004700CHA1,596,168,428,606,184,383,622,277,320,642,281,334,734,257,477,740,256,443,741,282,459,743,256,478
3004700DAY1,510,126,384,521,139,359,530,189,327,526,187,322,653,204,449,650,197,432,656,226,430,655,213,431
300470000NA,0,0,0,0,0,0,0,0,0,0,0,0,0,0,0,0,0,0,0,0,0,0,0,0
30081000007,1191,297,894,1200,369,758,1231,571,624,1238,546,665,1515,557,958,1545,565,924,1551,627,924,1539,578,929
30081000020,884,253,631,878,283,525,905,433,423,901,437,440,1141,419,722,1162,441,658,1154,491,663,1160,426,690
3002302-77E,281,154,127,287,159,104,292,206,66,273,203,58,331,203,128,332,205,110,335,228,107,336,200,122
3002301-77E,478,266,212,475,260,157,497,380,95,481,371,96,549,361,188,556,353,170,561,374,187,563,332,212
30023001-78,87,40,47,92,44,41,95,61,30,94,57,37,108,55,53,106,60,44,108,63,45,106,52,52
30065000006,770,114,656,791,111,643,804,235,508,817,180,597,963,142,821,973,152,784,973,176,797,978,144,810
30065000003,356,42,314,362,50,296,366,120,230,367,100,245,425,75,350,431,78,344,434,95,339,432,67,362
30079000004,197,14,183,202,14,179,204,37,161,201,31,166,206,18,188,211,30,179,210,22,188,210,20,188
30017000014,33,1,32,33,1,32,33,5,28,29,2,26,26,1,25,26,1,24,26,1,25,26,1,25
30081000009,945,330,615,964,371,513,983,523,392,990,498,449,1180,470,710,1197,476,652,1211,550,661,1210,467,702
30081000006,933,245,688,945,254,636,960,429,504,954,390,538,1139,374,765,1151,372,735,1157,417,740,1155,358,769
30081000005,1205,297,908,1209,368,779,1243,555,649,1258,524,708,1468,509,959,1485,531,917,1490,564,926,1489,518,948
3004700ARL1,737,344,393,736,365,320,752,481,248,749,478,256,976,544,432,984,550,400,982,576,406,974,533,412
3006300097L,2860,862,1998,2837,998,1637,2962,1450,1395,2957,1484,1395,3493,1443,2050,3546,1490,1900,3546,1657,1889,3533,1485,1955
300630097TR,1038,380,658,1026,459,490,1072,570,467,1112,626,457,1204,592,612,1227,606,593,1233,648,585,1212,631,566
30057000005,972,190,782,959,210,702,994,406,563,1013,395,593,1146,300,846,1156,307,807,1159,322,837,1147,268,859
3006300094L,1251,914,337,1276,899,223,1313,1086,167,1380,1202,153,1615,1309,306,1631,1284,258,1638,1367,271,1629,1298,279
30041000022,258,57,201,258,75,170,265,125,138,241,124,111,287,87,200,293,90,194,294,97,197,293,84,202
30073000029,159,17,142,158,24,127,162,57,100,155,46,104,160,33,127,166,34,130,165,34,131,165,33,130
30073000034,270,47,223,267,43,206,276,95,170,260,91,161,288,80,208,289,75,208,290,85,205,289,76,208
300630091SC,1066,808,258,1115,893,118,1135,996,111,1163,1052,101,1096,966,130,1117,974,110,1121,1013,108,1105,966,123
30001000020,80,2,78,77,2,74,81,12,66,89,12,72,98,8,90,97,10,86,97,10,87,97,7,88
30001000019,112,18,94,114,14,92,115,27,83,117,31,81,145,33,112,148,33,111,142,34,108,148,32,110
30001000021,150,22,128,154,25,117,161,53,108,152,54,96,165,46,119,165,45,114,167,53,114,165,44,120
30049000031,588,120,468,602,114,450,611,247,330,623,218,384,731,177,554,738,170,534,738,201,537,739,165,563
30077000001,159,16,143,160,11,146,166,29,134,151,19,131,181,23,158,183,20,160,183,20,163,183,17,164
30043009-75,960,256,704,940,317,549,989,494,487,977,463,489,1127,450,677,1136,464,644,1136,475,661,1122,433,668
30043003-75,63,18,45,61,18,35,64,35,25,68,34,34,71,25,46,71,28,42,70,28,42,71,24,47
3004700POL5,1422,447,975,1422,525,797,1465,704,696,1464,766,645,1759,742,1017,1778,751,941,1776,854,922,1784,769,984
3004700STI2,661,295,366,647,279,308,678,398,245,733,464,255,874,460,414,888,453,385,888,486,402,886,450,414
3004700STI1,635,241,394,640,267,344,654,347,282,662,341,298,772,327,445,774,333,407,773,360,413,771,324,432
30049000021,1184,271,913,1180,327,765,1213,602,585,1314,558,723,1687,524,1163,1711,560,1102,1719,573,1146,1714,491,1190
30061000027,144,24,120,147,21,120,151,46,91,147,35,102,183,23,160,186,27,148,184,37,147,187,27,158
3010100Sh-1,1158,211,947,1185,258,838,1203,508,660,1092,393,660,1215,324,891,1238,297,868,1244,378,866,1248,301,912
30089000003,825,138,687,840,147,653,853,287,535,878,256,597,1101,236,865,1108,236,827,1113,277,836,1116,233,876
30045000001,102,15,87,106,26,69,108,43,61,112,37,72,128,23,105,130,25,102,130,26,104,130,28,97
30045000004,471,60,411,467,87,345,484,168,307,442,137,292,508,112,396,513,110,388,515,127,388,510,110,391
30045000003,467,79,388,473,86,348,485,207,268,491,172,292,539,105,434,544,114,403,541,130,411,542,104,425
3004700POL4,1045,371,674,1055,403,588,1078,550,477,1212,659,529,1455,643,812,1463,635,736,1463,733,730,1463,644,765
3004700POL2,889,248,641,894,308,539,922,397,512,868,367,484,995,366,629,1006,374,609,1012,405,607,1015,380,621
3004700POL6,230,41,189,238,48,177,238,71,154,242,82,152,283,63,220,284,66,205,287,79,208,288,68,213
30021000005,273,47,226,279,39,228,281,49,229,266,60,201,308,37,271,310,41,265,314,49,265,313,40,266
30027000008,316,53,263,323,58,239,330,120,195,312,108,189,388,97,291,398,91,283,400,116,284,403,83,305
30027000011,439,113,326,445,132,288,450,198,232,424,177,224,468,143,325,470,141,305,475,176,299,476,138,323
30027000014,345,50,295,334,61,248,345,136,204,330,110,207,339,63,276,337,65,263,342,76,266,339,66,267
30027000016,240,29,211,239,27,196,247,58,182,241,46,186,260,28,232,264,35,226,264,30,234,266,33,228
30027000004,327,33,294,319,42,253,332,106,220,330,99,223,361,72,289,368,65,290,369,72,297,365,57,301
30027000005,320,33,287,332,34,286,333,96,233,306,77,220,343,46,297,343,39,294,345,48,297,346,40,303
30061000026,340,82,258,338,80,230,351,142,191,374,138,220,454,114,340,460,105,321,461,129,332,467,110,350
3010100Ke-1,122,21,101,125,21,101,127,42,81,127,40,81,141,26,115,140,19,111,140,32,108,141,17,121
30001000008,73,9,64,73,14,56,74,16,55,70,14,53,76,15,61,75,17,55,76,16,60,76,19,57
30001000003,712,125,587,702,158,507,737,252,470,739,246,471,853,227,626,863,225,621,873,246,627,869,227,625
30001000006,505,120,385,500,129,324,523,235,265,484,226,239,468,167,301,470,167,280,473,198,275,473,157,303
30001000001,434,159,275,442,175,203,458,267,176,422,251,159,369,171,198,376,167,190,375,187,188,373,166,192
30001000005,115,10,105,113,9,99,118,17,99,133,28,104,146,22,124,151,32,117,149,30,119,149,24,120
30001000004,172,29,143,172,34,131,173,60,109,168,50,109,216,35,181,219,43,168,221,46,175,221,34,181
30043006-75,408,104,304,402,104,278,417,178,230,461,178,277,577,169,408,577,163,393,581,179,402,583,163,414
3006300094E,450,206,244,456,235,189,467,292,164,462,288,168,590,316,274,592,317,247,596,351,245,591,324,252
3006300092P,724,219,505,733,229,439,752,363,359,759,364,378,866,314,552,887,326,529,892,363,529,892,321,555
30081000003,658,143,515,668,129,506,673,232,411,656,209,430,798,197,601,799,193,570,798,232,566,802,201,590
30081000013,860,149,711,831,166,610,871,282,543,894,298,560,1153,285,868,1158,283,831,1158,344,814,1158,290,842
30049000013,1862,916,946,1844,1213,514,1926,1416,494,1904,1455,421,2073,1483,590,2086,1500,559,2094,1519,575,2054,1471,551
30043004-75,969,301,668,980,304,594,985,401,534,933,446,447,1123,386,737,1139,403,685,1142,430,712,1145,366,743
30043001-71,829,176,653,822,168,613,850,300,518,858,288,521,1025,254,771,1041,237,753,1037,277,760,1041,227,785
30063098CSP,1606,737,869,1616,839,613,1685,1119,471,1700,1151,486,1983,1217,766,2017,1232,665,2019,1342,677,2020,1218,726
30001000012,462,109,353,452,157,270,477,256,210,494,235,249,609,246,363,616,254,334,609,274,335,613,243,359
3006300089P,1447,997,450,1470,1107,231,1514,1222,264,1515,1318,181,1627,1350,277,1647,1371,246,1654,1404,250,1641,1371,232
30001000023,121,31,90,125,29,91,127,50,74,125,42,82,160,50,110,159,51,101,157,61,96,159,54,103
30093000028,117,32,85,118,33,78,123,58,61,128,68,58,142,52,90,145,55,85,146,59,87,142,54,84
30011000003,70,3,67,69,4,64,71,13,56,69,10,59,80,6,74,80,10,70,80,6,74,80,8,72
30011000014,373,31,342,379,28,343,384,61,319,357,56,292,394,20,374,399,33,363,403,34,369,402,24,375
3003100064C,1846,597,1249,1853,676,1036,1912,843,1013,1937,921,970,2224,934,1290,2305,971,1251,2303,1021,1282,2293,966,1274
3003100064D,2512,770,1742,2501,799,1489,2602,1105,1413,2761,1256,1413,3445,1346,2099,3516,1372,2038,3536,1466,2070,3515,1350,2055
3003100066B,1772,1047,725,1806,1046,549,1859,1265,512,1861,1381,429,2115,1463,652,2199,1507,604,2204,1587,617,2178,1478,621
3003100069D,1241,387,854,1231,384,763,1283,535,720,1321,557,729,1503,522,981,1540,539,966,1538,561,977,1535,555,946
30075000011,403,49,354,415,51,349,420,113,293,385,74,297,442,53,389,451,60,373,455,72,383,459,60,392
30083000019,123,10,113,119,14,101,125,23,100,107,29,74,125,16,109,128,17,107,128,16,112,128,14,110
30085000016,241,177,64,231,163,52,241,194,39,258,216,38,276,219,57,278,218,52,277,224,53,275,208,62
30083000017,127,10,117,130,13,111,130,24,104,126,30,90,152,22,130,150,21,126,152,18,134,150,14,133
30085000015,161,135,26,164,138,14,166,147,16,146,132,10,202,173,29,202,169,25,206,183,23,202,175,24
30083000005,339,60,279,343,48,278,354,82,258,315,91,213,398,54,344,400,69,319,404,73,331,400,55,342
30083000009,248,39,209,255,35,211,256,63,186,240,54,181,313,42,271,322,52,259,323,52,271,322,45,272
30083000004,288,43,245,297,36,247,291,63,215,249,67,174,327,55,272,333,64,253,334,70,264,332,51,277
30007000001,669,111,558,665,150,484,679,287,372,718,247,456,893,221,672,904,237,638,906,239,667,901,205,681
30007000011,646,83,563,649,100,513,659,237,404,666,188,450,790,158,632,802,160,617,806,173,633,808,148,647
301110055.3,1061,210,851,1055,234,743,1083,395,647,1095,358,693,1271,281,990,1276,304,933,1284,330,954,1287,278,976
301110055.4,1171,324,847,1183,344,732,1215,594,529,1067,501,490,1373,495,878,1391,471,793,1390,566,824,1397,472,863
301110054.1,4626,1108,3518,4661,1516,2806,4818,2239,2421,4795,2234,2440,5770,2091,3679,5838,2183,3423,5862,2433,3429,5847,2192,3517
300670060EL,713,415,298,727,411,230,749,545,181,767,559,183,1019,662,357,1032,656,335,1035,693,342,1025,639,360
3006700059B,1205,393,812,1222,393,751,1246,563,646,1293,566,693,1485,555,930,1502,587,870,1511,615,896,1503,568,919
30097000005,275,30,245,275,31,236,282,65,206,290,59,222,322,37,285,321,37,278,324,49,275,323,37,282
30097000003,462,58,404,470,82,369,479,140,331,447,122,310,517,112,405,524,114,397,528,126,402,523,118,400
30097000004,482,85,397,479,96,366,490,151,333,527,159,355,614,130,484,618,143,459,616,152,464,615,140,462
30087000017,271,124,147,270,150,103,282,184,87,277,193,81,304,179,125,301,173,113,311,194,117,311,179,124
30043007-75,873,246,627,853,301,481,896,454,422,890,420,445,1062,427,635,1074,419,625,1076,442,634,1072,403,645
30043008-75,488,152,336,499,173,283,500,247,243,494,220,260,562,208,354,566,212,343,566,223,343,563,200,354
30043002-75,980,221,759,974,210,689,1008,393,574,982,344,592,1160,301,859,1166,287,828,1168,334,834,1165,274,874
3010100DG-1,130,16,114,132,25,101,135,50,84,131,37,89,133,27,106,134,31,102,134,32,102,131,28,98
301110056.3,775,164,611,785,215,523,801,333,448,830,329,472,1001,298,703,1014,312,671,1015,348,667,1002,298,688
301110042.2,235,50,185,237,59,169,242,91,141,237,90,137,281,71,210,284,71,206,285,81,204,283,65,211
301110056.2,3190,777,2413,3208,849,2144,3288,1545,1578,3211,1306,1779,3904,1187,2717,3941,1182,2502,3941,1355,2586,3951,1141,2680
301110047.1,1404,659,745,1442,724,571,1470,951,447,1431,938,429,1657,945,712,1676,909,649,1688,1025,663,1679,937,690
30049000026,1694,573,1121,1675,709,823,1749,1016,687,1762,998,730,2082,994,1088,2117,1051,1022,2122,1063,1059,2090,983,1066
30049000025,1082,448,634,1061,552,405,1116,773,310,1086,729,334,1259,755,504,1272,755,470,1276,780,496,1273,707,518
30049000028,1088,255,833,1094,281,741,1129,525,573,1151,473,647,1461,471,990,1473,505,916,1481,530,951,1477,456,982
30103000001,443,65,378,443,59,351,448,160,276,414,129,279,457,75,382,460,89,358,464,88,376,460,78,373
30087000030,346,50,296,351,59,274,357,88,260,343,124,206,391,102,289,391,103,271,393,119,274,394,91,286
30087000032,782,122,660,775,138,592,796,180,599,727,234,469,807,180,627,813,187,603,817,197,620,813,168,625
30079000002,154,23,131,158,26,118,162,54,102,150,51,92,161,31,130,162,41,114,164,41,123,166,33,128
30083000007,207,53,154,212,40,158,215,68,135,201,77,114,235,51,184,239,55,172,239,57,182,236,46,179
3003100059A,325,156,169,332,179,130,339,203,130,341,207,130,410,223,187,425,234,183,422,238,184,419,236,177
3003100069A,1509,412,1097,1509,367,995,1569,710,786,1520,625,829,1914,563,1351,1959,582,1289,1958,660,1298,1962,532,1372
30007000013,667,96,571,668,86,532,689,232,431,725,213,486,1024,172,852,1050,188,823,1051,213,838,1048,166,857
3003100067B,1867,614,1253,1886,606,1081,1958,914,965,2079,1055,966,2969,1205,1764,3041,1214,1658,3067,1336,1731,3041,1176,1733
3003100068A,2058,558,1500,2037,599,1268,2138,898,1163,2223,974,1185,2827,980,1847,2900,993,1796,2906,1118,1788,2884,1002,1805
30083000023,749,93,656,760,98,630,767,146,594,667,138,506,888,128,760,901,146,732,901,147,754,907,119,773
30109000001,522,74,448,537,55,463,545,143,381,542,140,390,584,88,496,585,105,465,596,105,491,598,77,516
3009300008W,1230,605,625,1224,576,545,1260,878,335,1179,821,330,1378,777,601,1387,835,484,1394,875,519,1383,702,636
30093000017,870,484,386,878,464,308,906,644,211,829,600,195,962,614,348,976,610,296,984,662,322,967,575,345
30093000011,179,101,78,177,97,64,185,136,45,182,139,40,194,118,76,201,126,68,200,133,67,199,112,82
30087000011,97,5,92,93,3,88,97,12,85,88,9,74,103,5,98,105,7,95,105,7,98,105,6,97
3003100064A,782,358,424,795,327,403,807,410,369,777,420,333,967,453,514,989,455,493,998,498,500,995,474,496
3003100062D,2219,978,1241,2210,1142,866,2314,1325,936,2493,1571,880,3222,1813,1409,3308,1847,1345,3330,1978,1352,3293,1916,1282
3003100062C,1641,917,724,1640,1015,505,1723,1171,527,1753,1269,455,1970,1344,626,2008,1337,628,2012,1411,601,1998,1370,593
3003100065A,1687,1056,631,1749,1060,503,1796,1295,416,1881,1434,400,2218,1532,686,2272,1517,641,2282,1627,655,2268,1530,667
3003100061D,1804,876,928,1793,976,701,1876,1131,717,1873,1206,642,2080,1251,829,2140,1275,832,2145,1319,826,2119,1309,769
30075000012,328,23,305,332,27,291,341,65,266,303,56,243,346,33,313,350,41,305,350,43,307,349,38,307
3003100061A,1732,816,916,1733,881,745,1798,1052,720,1896,1189,678,2126,1209,917,2168,1238,896,2181,1282,899,2164,1254,865
3003100064B,1372,707,665,1420,746,521,1446,920,469,1497,1003,452,1983,1263,720,2041,1273,707,2059,1343,716,2048,1281,700
3003100066C,1780,1286,494,1867,1329,317,1901,1538,302,1812,1562,218,2049,1671,378,2122,1669,358,2126,1755,371,2122,1683,368
30007000012,675,143,532,671,132,485,696,306,359,646,238,387,709,185,524,717,183,512,721,207,514,720,170,536
30089000009,155,73,82,158,68,76,161,90,65,172,99,70,218,119,99,216,118,82,218,126,92,217,116,98
30089000005,959,170,789,973,196,707,986,387,553,1043,339,659,1280,287,993,1286,296,939,1290,338,952,1294,292,976
30089000004,940,172,768,940,194,682,977,368,561,972,338,599,1193,286,907,1189,281,856,1195,346,849,1198,283,891
30019000003,289,30,259,295,36,243,301,56,240,281,58,221,306,52,254,311,53,251,310,57,253,310,51,252
3003100068B,1408,394,1014,1435,406,864,1479,651,764,1351,642,659,1683,665,1018,1727,673,957,1746,756,990,1744,659,1011
30089000008,614,217,397,633,180,378,645,300,286,647,313,304,829,326,503,835,334,428,823,377,446,842,304,507
30089000006,940,135,805,948,152,741,979,326,616,1010,280,693,1172,210,962,1184,202,927,1186,263,923,1188,197,966
3009300027S,313,99,214,320,129,177,335,188,140,333,185,133,412,171,241,420,182,222,418,201,217,416,166,243
3009300026E,123,42,81,122,43,71,126,72,49,134,67,64,175,67,108,177,84,89,179,85,94,175,68,103
3009300008E,1679,781,898,1699,945,635,1759,1196,535,1724,1212,489,1903,1152,751,1926,1194,698,1933,1260,673,1916,1124,756
30029000033,365,81,284,372,75,272,370,123,215,368,137,215,519,143,376,520,142,337,520,165,355,526,139,374
30029000003,853,285,568,871,316,493,878,413,430,876,439,405,1015,437,578,1036,432,548,1038,489,549,1040,445,567
30029000043,1651,362,1289,1653,400,1168,1700,591,1067,1671,555,1083,2002,515,1487,2017,531,1442,2026,579,1447,2020,522,1470
30029000048,842,226,616,844,281,516,864,383,460,871,402,453,1116,454,662,1139,463,640,1149,495,654,1142,477,643
30029000013,1389,301,1088,1396,350,962,1437,476,909,1389,506,845,1795,550,1245,1814,568,1197,1827,606,1221,1822,584,1201
30029000017,282,125,157,285,125,144,287,159,122,304,174,125,348,194,154,347,190,146,350,197,153,348,191,148
30029000018,1356,384,972,1372,400,883,1397,637,696,1422,605,774,1815,628,1187,1849,660,1112,1853,723,1130,1847,644,1159
30029000041,1474,387,1087,1475,476,906,1522,642,841,1453,662,753,1696,623,1073,1723,644,1031,1721,711,1010,1717,672,1012
30029000031,2044,485,1559,2055,572,1358,2108,797,1239,2174,910,1208,2696,906,1790,2718,950,1652,2733,1048,1685,2713,941,1712
30019000002,126,23,103,137,25,102,134,49,75,126,38,82,143,34,109,144,37,102,147,33,114,148,28,115
30019000006,231,51,180,231,49,173,237,88,146,239,84,143,248,53,195,250,47,195,263,65,198,247,44,199
30093000029,78,20,58,76,16,53,80,37,42,78,37,41,78,25,53,81,33,48,80,32,48,77,23,53
30009000008,499,198,301,510,245,223,522,303,206,504,304,184,566,324,242,570,325,228,575,349,226,566,323,231
30093000022,1265,630,635,1265,622,520,1305,935,327,1214,862,320,1379,821,558,1393,827,486,1395,901,494,1397,744,616
30093000003,415,213,202,412,235,154,432,336,82,428,310,105,461,284,177,471,301,144,474,320,154,464,258,187
30093000014,1068,650,418,1061,639,307,1097,820,222,1008,799,184,1163,789,374,1172,795,325,1177,813,364,1169,733,391
3009300026W,172,58,114,171,57,107,175,103,66,161,83,71,209,94,115,209,93,101,208,102,106,206,80,124
3009300027N,95,24,71,98,22,71,102,45,54,97,46,49,123,34,89,125,45,74,126,46,80,123,31,91
30009000006,315,74,241,319,72,217,325,141,171,306,114,174,360,93,267,366,93,253,366,102,264,366,87,269
30009000005,344,44,300,350,50,280,361,122,225,355,102,241,422,88,334,426,97,314,429,101,328,430,87,337
30009000015,554,94,460,564,102,424,573,213,341,543,169,359,638,115,523,639,113,493,637,127,510,641,112,520
30009000011,899,321,578,898,400,454,922,486,418,965,542,406,1107,519,588,1113,526,560,1116,555,561,1108,527,552
30009000001,527,89,438,525,100,402,539,193,333,519,165,341,622,130,492,638,140,469,644,161,483,638,127,495
30003000005,190,112,78,190,136,48,193,151,37,217,171,45,222,162,60,222,158,57,223,169,54,221,161,58
30003000007,710,485,225,704,554,89,727,631,74,844,739,95,782,620,162,789,605,157,784,627,157,780,585,183
30095000011,197,35,162,189,46,133,199,75,118,191,71,112,189,66,123,191,62,125,191,70,121,189,63,125
30095000010,144,40,104,140,46,86,147,67,78,134,48,82,143,49,94,144,50,88,143,54,89,145,48,91
30003000010,63,8,55,63,12,49,65,22,42,66,18,43,65,11,54,65,14,50,65,12,53,66,11,53
3009300019N,303,162,141,301,173,101,311,226,76,292,221,69,377,245,132,380,247,120,380,262,118,376,227,140
3009300009E,562,189,373,570,239,281,591,324,254,599,348,241,667,313,354,679,332,324,678,362,316,673,316,341
30093000006,1612,846,766,1624,938,562,1698,1278,395,1611,1213,369,1779,1139,640,1795,1192,555,1804,1257,547,1781,1082,652
30029000042,1425,297,1128,1457,325,1067,1491,483,969,1497,477,983,1815,473,1342,1823,479,1297,1836,521,1315,1832,477,1329
30029000025,1094,226,868,1092,209,806,1113,397,654,1055,375,632,1336,315,1021,1360,310,970,1359,379,980,1369,306,1027
30029000006,2302,507,1795,2287,633,1547,2366,860,1443,2474,952,1477,3212,980,2232,3242,1018,2128,3260,1119,2141,3242,1043,2131
301110047.2,2512,858,1654,2501,1159,1165,2617,1416,1151,2604,1476,1080,2859,1436,1423,2905,1447,1348,2929,1557,1372,2895,1495,1325
300670060DL,739,356,383,739,322,345,765,471,248,757,469,266,895,498,397,918,480,386,919,533,386,917,484,408
30075000003,47,4,43,47,9,35,49,12,37,52,15,36,57,7,50,57,13,44,57,12,45,56,12,44
3006700059A,844,224,620,839,186,607,860,321,512,861,298,547,1002,267,735,1009,272,712,1011,300,711,1004,262,726
301110048.1,2455,967,1488,2508,1159,1105,2589,1538,952,2477,1532,872,2853,1564,1289,2897,1566,1187,2909,1678,1231,2894,1541,1257
301110044.1,951,246,705,935,266,596,977,487,457,895,419,429,1075,372,703,1084,394,648,1088,433,655,1087,359,697
301110053.2,1417,210,1207,1424,258,1063,1464,497,934,1488,469,954,1876,399,1477,1891,443,1351,1897,501,1396,1897,407,1422
301110039.2,1647,282,1365,1631,296,1242,1691,649,977,1606,505,1044,1891,386,1505,1899,404,1404,1909,462,1447,1912,373,1505
301110040.1,1708,272,1436,1728,297,1319,1780,638,1070,1733,490,1171,2116,415,1701,2129,418,1595,2132,464,1668,2130,366,1713
301110039.1,178,16,162,177,21,151,179,45,128,157,37,115,186,22,164,188,28,154,188,33,155,186,23,160
301110053.1,4537,805,3732,4454,1233,2980,4680,1683,2920,4999,1874,3044,6456,1972,4484,6531,2055,4336,6570,2257,4313,6490,2079,4277
30111040-45,881,152,729,884,192,643,910,326,559,928,315,584,1162,294,868,1168,304,826,1176,348,828,1175,290,863
301110049.2,1806,659,1147,1807,758,869,1879,1090,712,1799,1068,666,2116,1061,1055,2138,1043,966,2142,1184,958,2153,1035,1039
30013000023,3645,1293,2352,3623,1534,1798,3731,2239,1354,3492,1997,1372,4121,2012,2109,4172,1944,2024,4183,2171,2012,4162,1887,2143
3001300022A,2872,984,1888,2883,1130,1492,2966,1831,1015,2806,1649,1070,3198,1488,1710,3244,1469,1607,3275,1681,1594,3258,1402,1761
300130019B2,1022,209,813,1018,271,692,1048,439,589,1039,400,600,1192,341,851,1211,332,847,1211,364,847,1209,326,862
300130019A3,372,66,306,370,73,280,377,146,225,369,129,225,438,94,344,442,100,331,444,110,334,445,90,351
3001300019C,613,135,478,603,151,417,623,291,322,608,259,333,701,190,511,715,210,484,720,224,496,714,189,515
300130019A4,449,111,338,443,139,272,458,220,232,438,195,229,571,195,376,575,186,377,577,202,375,580,182,387
3001300022B,1063,269,794,1055,301,671,1092,548,505,1047,484,534,1178,385,793,1218,399,740,1219,450,769,1221,363,804
30013000024,3968,1303,2665,3963,1599,2024,4076,2383,1584,3953,2267,1559,4435,2108,2327,4510,2102,2207,4541,2292,2249,4512,1998,2364
30003000003,136,9,127,137,20,114,140,38,100,133,29,97,153,25,128,151,19,123,150,28,122,152,26,126
3000300004N,146,10,136,144,16,124,146,37,103,152,30,119,168,29,139,166,26,137,167,33,134,167,28,137
30003000006,67,13,54,66,14,50,68,18,49,62,17,42,56,13,43,55,15,39,54,15,39,56,14,41
30003000021,330,191,139,333,228,93,345,256,82,399,317,79,336,240,96,338,233,100,337,237,100,335,214,118
30003000015,278,149,129,267,129,107,285,204,74,294,211,77,284,152,132,289,151,120,283,161,122,284,149,128
30003000014,138,82,56,131,70,51,138,94,38,182,133,47,162,102,60,164,94,65,165,96,69,160,84,75
30003000025,121,55,66,124,64,57,122,72,46,154,100,52,121,63,58,123,64,56,122,64,58,123,64,58
30003000001,155,34,121,153,56,93,158,71,84,164,68,93,171,57,114,170,56,107,172,60,112,172,58,110
3001300020A,4394,968,3426,4350,1385,2726,4528,2144,2320,4411,1935,2387,4947,1782,3165,5006,1772,3097,5045,1916,3129,5006,1764,3140
30013000025,3920,1310,2610,3897,1533,2027,4017,2287,1577,3757,2123,1508,4357,2071,2286,4434,2026,2194,4457,2263,2194,4458,1972,2328
30013000030,486,94,392,489,101,351,507,232,269,499,181,300,564,143,421,578,144,415,575,160,415,580,134,434
300130019A1,440,100,340,431,94,309,451,178,250,424,160,247,491,113,378,501,109,373,502,130,372,494,108,379
30099000006,307,52,255,308,79,210,321,154,164,325,134,185,365,106,259,366,104,249,367,114,253,365,99,262
3001300021A,4263,1195,3068,4256,1549,2419,4384,2444,1820,4223,2278,1813,4733,2123,2610,4851,2053,2623,4881,2283,2598,4857,2004,2717
3001300021B,388,141,247,393,141,220,397,246,136,399,232,156,453,209,244,456,208,218,457,243,214,460,198,247
30099000001,1418,308,1110,1424,384,928,1470,675,755,1409,613,749,1628,497,1131,1633,500,1070,1641,561,1080,1631,483,1115
30099000011,149,22,127,149,27,112,155,63,90,155,57,94,176,38,138,179,39,136,181,38,143,178,36,139
30095000001,2081,284,1797,2126,363,1649,2150,712,1362,2110,594,1444,2496,459,2037,2525,490,1958,2536,542,1994,2516,455,2014
30095000004,192,30,162,194,31,146,194,71,120,181,62,112,221,46,175,227,41,178,228,54,174,232,46,182
30009000003,590,84,506,592,104,461,603,189,393,595,157,423,669,123,546,671,139,516,672,140,532,667,122,535
30029000037,1752,390,1362,1784,412,1252,1809,711,1025,1716,658,980,2223,645,1578,2258,686,1461,2259,774,1485,2253,656,1526
30027000007,335,67,268,333,77,233,345,131,190,328,137,174,354,111,243,360,115,234,361,135,226,360,104,244
30077000006,352,142,210,349,73,241,363,159,184,351,167,173,395,125,270,394,136,244,392,153,239,394,117,265
30077000004,273,101,172,272,61,197,277,115,151,249,100,142,320,80,240,319,90,211,316,100,216,317,81,223
30013000027,676,154,522,687,194,456,694,319,360,782,310,451,972,315,657,992,315,642,992,343,649,993,315,661
3001300019E,285,61,224,288,88,183,293,134,153,319,136,178,321,114,207,327,121,198,329,116,213,326,113,212
3002304-78E,271,132,139,277,102,141,292,204,71,283,160,111,315,160,155,321,159,138,318,172,146,318,146,162
3002303-77E,306,172,134,302,144,124,317,225,75,296,213,73,360,211,149,361,203,129,357,222,135,362,192,156
3001300026A,2465,860,1605,2454,986,1249,2546,1509,940,2409,1387,949,2799,1361,1438,2848,1298,1372,2862,1492,1370,2853,1287,1474
3001300026B,327,93,234,349,101,200,336,132,181,183,94,87,411,159,252,431,143,243,445,185,260,449,160,253
30095000009,166,15,151,165,17,139,169,50,114,161,37,120,176,25,151,179,27,145,178,26,152,178,23,150
30083000003,401,78,323,413,73,311,406,101,295,428,114,298,569,109,460,578,124,428,586,135,451,586,108,466
30027000002,848,137,711,852,157,643,878,282,567,864,264,576,944,209,735,956,220,714,961,246,715,952,202,726
30099000007,991,171,820,972,218,706,1016,390,604,961,349,593,1149,285,864,1152,295,820,1161,325,836,1153,276,860
301110055.1,535,120,415,531,118,385,546,213,311,462,154,285,587,153,434,594,155,417,594,170,424,593,139,440
301110040.3,337,46,291,333,49,266,343,117,210,349,100,243,430,78,352,428,85,334,431,91,340,426,79,340
301110040.4,268,49,219,268,60,195,279,103,165,277,86,177,337,64,273,339,69,254,337,79,258,338,69,264
301110046.1,252,58,194,249,70,163,256,96,155,287,107,175,298,81,217,301,78,215,302,89,213,299,78,210
30003000008,153,47,106,151,46,98,157,58,93,154,76,78,162,60,102,165,61,98,165,63,102,164,62,97
30003000026,335,201,134,318,224,73,339,263,65,329,277,48,384,296,88,390,290,85,391,310,81,390,296,86
30003000002,106,39,67,109,46,56,110,66,42,117,69,46,137,65,72,138,67,65,137,66,71,138,61,72
30003000018,314,59,255,307,81,194,317,141,164,319,152,158,361,137,224,361,123,212,362,154,208,362,132,219
3003100061B,1742,779,963,1764,842,787,1810,1018,743,1882,1148,700,2133,1174,959,2186,1184,935,2203,1260,943,2192,1200,932
30011000001,111,4,107,111,6,101,112,13,99,109,12,96,123,6,117,125,12,112,125,11,114,125,10,115
30029NAHD15,0,0,0,0,0,0,0,0,0,0,0,0,0,0,0,0,0,0,0,0,0,0,0,0
30029000004,956,336,620,965,350,519,987,489,444,932,463,441,1121,471,650,1147,481,602,1147,518,629,1147,477,629
30029000035,1271,360,911,1292,378,812,1319,595,666,1243,574,629,1582,562,1020,1607,593,939,1613,664,949,1612,579,991
30029000039,660,244,416,679,258,368,688,344,314,664,345,297,803,351,452,818,361,420,817,377,440,824,354,451
30029000024,683,90,593,690,92,570,701,172,493,720,150,546,888,153,735,893,156,713,900,184,716,894,142,724
30029000019,972,177,795,995,166,763,1005,313,640,1079,291,747,1342,262,1080,1355,278,1028,1363,325,1038,1362,274,1061
30029000008,767,110,657,781,151,588,793,242,523,849,232,595,1117,238,879,1135,261,851,1135,273,862,1137,259,862
30029000011,1023,181,842,1012,196,758,1047,325,681,1051,315,717,1268,288,980,1288,302,954,1292,336,956,1279,304,954
3006700059C,930,298,632,950,286,620,970,408,530,1010,418,576,1230,459,771,1237,461,745,1241,487,754,1236,470,748
301110048.2,2125,645,1480,2130,866,1107,2213,1187,975,2155,1118,968,2335,1019,1316,2368,1042,1219,2389,1158,1231,2369,1073,1239
30029000001,587,163,424,611,184,373,620,272,305,578,295,261,669,266,403,679,276,366,682,310,372,682,275,387
30029000007,998,222,776,1004,254,697,1019,376,608,1073,385,659,1328,364,964,1345,390,895,1342,424,918,1338,373,931
30029000036,1542,297,1245,1567,335,1157,1592,529,1012,1589,490,1055,1907,447,1460,1946,478,1399,1954,524,1430,1939,471,1427
301110046.2,5406,1382,4024,5330,1971,3017,5576,2647,2832,5496,2636,2729,6117,2481,3636,6208,2526,3499,6227,2715,3512,6164,2566,3458
301110052.1,1615,567,1048,1614,608,830,1680,968,598,1577,899,584,1891,820,1071,1921,813,940,1917,963,954,1925,787,1061
30029000029,1388,249,1139,1408,282,1039,1431,468,912,1483,451,988,1852,411,1441,1872,443,1372,1879,475,1404,1879,445,1403
301110052.2,2158,612,1546,2154,780,1214,2233,1216,937,2064,1045,955,2360,965,1395,2391,975,1291,2402,1107,1295,2397,956,1363
30029000045,1187,485,702,1221,587,565,1251,683,533,1317,765,532,1642,873,769,1670,899,734,1679,946,733,1669,921,719
30029000049,979,383,596,1006,450,476,1018,515,480,1041,592,432,1283,671,612,1303,691,582,1313,719,594,1308,710,563
30029000016,900,299,601,929,318,526,951,494,412,946,498,409,1247,559,688,1263,555,640,1266,610,656,1264,541,684
30011000013,216,31,185,220,32,170,227,41,176,217,50,155,249,41,208,253,36,203,253,43,210,257,32,213
30053000002,284,71,213,299,67,214,299,95,179,297,76,208,403,88,315,406,84,300,408,85,323,414,80,330
3003100063B,1199,591,608,1294,637,440,1274,779,397,1355,993,318,1384,955,429,1446,943,387,1503,1091,412,1505,1004,438
3003100061C,1640,1150,490,1683,1147,371,1740,1355,336,1769,1426,311,2034,1552,482,2085,1559,485,2094,1637,457,2080,1570,470
300670060GL,861,433,428,865,444,352,894,577,286,915,569,317,999,582,417,1022,605,379,1016,637,379,1013,596,391
3006700060B,735,231,504,760,229,464,773,360,370,752,356,370,947,354,593,960,347,567,963,401,562,961,338,596
3006700060A,722,215,507,732,245,443,754,357,380,790,365,405,795,322,473,807,316,468,804,348,456,804,317,470
301110055.5,1655,423,1232,1659,501,1027,1708,865,787,1664,765,853,1918,670,1248,1936,678,1170,1934,764,1170,1935,647,1243
301110045.2,3955,896,3059,3939,1181,2408,4080,1777,2173,4037,1748,2178,5072,1726,3346,5120,1760,3161,5152,1994,3158,5116,1769,3229
30027000018,178,11,167,184,14,165,183,33,146,187,27,158,190,14,176,190,14,173,191,18,173,190,13,176
30027000003,385,50,335,387,59,313,401,124,272,393,105,277,432,72,360,432,69,361,432,77,355,430,71,356
30017000008,283,31,252,287,31,242,289,71,210,277,68,200,329,52,277,331,52,273,333,61,272,330,50,279
301110050.2,2026,610,1416,2042,751,1101,2113,1112,902,1968,1066,831,2256,961,1295,2287,966,1199,2299,1087,1212,2292,962,1249
300130019A2,947,203,744,925,197,676,965,354,590,895,311,563,1070,231,839,1090,227,828,1087,257,830,1094,221,854
3003100066A,1995,967,1028,2023,1071,713,2120,1307,736,2061,1480,542,2551,1599,952,2632,1616,885,2668,1755,913,2660,1649,922
3003100063C,1755,935,820,1819,956,609,1861,1182,607,1599,1045,501,2042,1246,796,2117,1225,755,2134,1335,799,2126,1254,760
3003100063A,1922,858,1064,1926,895,802,2015,1117,813,2152,1251,839,2585,1411,1174,2657,1397,1130,2677,1519,1158,2660,1409,1143
3003100068C,1604,317,1287,1619,325,1157,1670,553,1060,1621,532,1034,1961,511,1450,2019,536,1395,2027,595,1432,2015,510,1452
3003100069B,1416,241,1175,1370,220,1079,1458,366,1065,1375,325,1022,1675,324,1351,1707,313,1347,1709,351,1358,1700,321,1347
3006700059D,866,402,464,869,402,392,892,514,349,855,491,346,976,502,474,984,513,441,987,539,448,983,505,463
30009000009,365,191,174,371,199,140,388,273,108,400,289,104,439,290,149,452,303,127,349,223,126,449,288,141
30009000016,301,67,234,302,86,202,312,120,186,334,123,200,379,111,268,380,116,255,380,119,261,374,114,255
30009000004,307,62,245,317,65,227,318,124,176,308,113,181,353,72,281,352,69,265,352,84,268,353,68,274
30017000009,88,7,81,93,8,83,92,16,75,83,10,70,94,8,86,94,7,84,94,7,87,94,5,87
30039000001,403,107,296,415,122,259,419,192,209,429,184,226,517,199,318,522,198,301,521,220,301,527,195,321
30049000011,1250,297,953,1227,390,708,1275,730,495,1223,621,561,1498,575,923,1511,586,857,1522,636,886,1515,527,930
30049000008,1418,707,711,1413,980,324,1480,1144,315,1462,1157,285,1577,1198,379,1592,1213,350,1594,1232,362,1583,1195,350
30049000030,165,36,129,169,47,114,169,69,94,175,67,106,203,57,146,208,53,144,206,59,147,207,49,150
30093000016,1077,588,489,1097,631,363,1133,835,274,1033,784,227,1227,796,431,1239,826,359,1241,864,377,1234,777,431
3004700RON2,500,201,299,502,199,262,516,279,211,660,366,277,786,368,418,789,367,374,795,414,381,785,370,397
3004700SWA2,115,30,85,116,31,81,119,36,77,111,32,78,124,30,94,124,29,90,124,30,94,123,29,93
30049000024,1355,442,913,1345,627,616,1404,902,481,1441,905,506,1577,872,705,1596,901,652,1597,917,680,1577,855,686
30049000018,1085,344,741,1060,451,513,1109,691,390,1107,668,411,1282,653,629,1301,670,587,1300,707,593,1288,618,642
30017000007,165,30,135,170,39,124,175,59,112,179,64,105,196,31,165,195,35,151,193,38,155,195,34,155
30017000005,181,37,144,178,46,126,187,66,119,187,85,98,220,66,154,224,75,146,223,73,150,220,69,147
30107000002,412,96,316,413,92,290,415,194,214,389,145,230,433,110,323,438,124,290,438,129,309,440,110,320
30107000009,240,40,200,236,38,180,249,92,150,255,89,160,282,67,215,285,63,210,286,75,211,290,56,228
30107000004,132,28,104,135,27,102,137,65,68,122,42,76,138,32,106,138,32,100,136,31,105,138,29,106
30091000003,366,95,271,366,103,237,378,166,198,364,156,181,408,131,277,409,152,245,418,157,261,419,138,275
30015000002,472,113,359,467,158,269,490,265,213,478,257,202,503,188,315,512,204,287,516,222,294,508,185,303
30005000015,453,354,99,433,350,43,461,421,31,561,540,19,566,509,57,568,490,54,570,525,45,560,486,65
30015000007,116,19,97,118,20,90,120,42,74,111,41,64,127,34,93,129,34,91,130,44,86,128,33,91
30033000019,88,5,83,87,5,80,90,15,73,71,6,64,99,3,96,98,5,92,99,5,94,98,5,92
30033000007,88,4,84,88,4,80,90,8,81,80,9,66,100,9,91,103,10,90,101,10,91,101,6,94
30061000030,547,107,440,550,133,385,569,236,303,573,195,349,624,193,431,733,204,496,729,223,506,736,189,533
30017000011,45,0,45,46,0,46,45,2,42,39,3,36,49,0,49,48,1,45,49,1,48,49,0,49
30081000022,1184,308,876,1170,364,755,1218,515,668,1253,516,709,1542,486,1056,1554,519,982,1566,572,994,1562,494,1025
30033000001,451,23,428,450,21,406,463,83,369,446,59,364,502,32,470,514,28,476,509,52,457,514,24,484
30045000002,155,34,121,155,36,110,159,67,85,146,42,96,160,30,130,159,32,124,162,39,123,162,33,127
30049000016,1256,444,812,1233,605,527,1284,801,457,1369,872,468,1738,985,753,1763,993,711,1767,1054,713,1763,961,758
301110051.2,896,277,619,923,363,491,940,494,419,1028,554,444,1611,731,880,1633,768,796,1645,846,799,1650,754,846
3006300096W,777,211,566,774,258,460,796,377,398,830,371,441,997,390,607,1003,405,570,1007,441,566,1000,406,577
300630098TR,1635,582,1053,1635,718,799,1690,987,657,1694,991,664,1860,956,904,1890,981,843,1894,1051,843,1882,967,872
30041000010,332,134,198,330,127,157,341,199,119,304,189,109,357,181,176,357,164,167,357,190,167,354,161,173
30027000017,429,81,348,426,100,304,444,156,277,410,130,275,459,110,349,462,112,340,465,123,342,460,110,343
30041000013,230,85,145,236,79,129,244,143,90,216,126,82,307,127,180,307,117,162,310,134,176,312,107,188
30041000016,259,66,193,257,64,181,267,126,134,242,111,118,282,77,205,282,82,188,283,84,199,287,72,207
30049000006,1228,411,817,1198,478,606,1265,725,516,1271,719,518,1472,713,759,1485,723,702,1490,784,706,1488,689,754
300630099RN,912,462,450,933,518,311,960,676,247,992,725,235,1162,774,388,1181,796,342,1183,850,333,1175,783,354
3006300091L,1830,1379,451,1895,1391,289,1928,1629,223,1942,1730,191,2186,1805,381,2231,1819,317,2239,1895,344,2225,1812,366
30107000001,73,12,61,71,5,61,74,23,50,77,18,55,85,11,74,86,14,72,86,16,70,86,15,70
300630089UC,622,418,204,674,422,154,665,498,128,544,460,70,377,285,92,385,290,77,390,308,82,394,298,86
30085000018,646,440,206,638,393,185,660,490,141,656,520,121,700,496,204,699,486,180,703,529,174,698,489,195
30085000017,105,26,79,108,21,80,109,38,68,101,45,50,113,28,85,114,31,77,115,42,73,116,31,79
30043010-75,999,252,747,989,355,565,1032,519,493,1026,496,514,1215,494,721,1237,527,682,1238,531,707,1227,491,704
3006300096F,559,122,437,558,128,382,571,241,306,617,246,354,783,248,535,792,262,486,795,292,503,802,234,538
30001000002,724,124,600,732,127,550,754,249,482,713,233,452,858,191,667,859,201,627,867,222,645,863,181,670
30001000014,387,136,251,387,125,226,396,210,161,354,189,150,514,211,303,516,194,290,516,240,276,519,189,305
30087000010,139,11,128,139,11,126,140,39,99,140,34,101,164,22,142,163,22,131,163,30,133,165,18,147
30009000002,268,60,208,271,73,178,280,120,149,269,107,152,304,86,218,306,95,200,310,102,208,309,92,211
30029000021,881,198,683,890,180,649,907,333,533,932,319,591,1174,296,878,1183,302,844,1195,334,861,1193,304,863
30029000014,592,123,469,597,135,436,605,204,383,611,221,369,771,203,568,773,214,534,770,224,546,773,205,557
30029000044,1303,426,877,1306,460,757,1334,607,686,1331,622,674,1635,638,997,1661,666,952,1669,715,954,1668,679,965
30083000022,540,75,465,561,62,465,556,107,428,453,99,341,551,72,479,555,74,462,560,90,470,564,75,483
30087000015,533,403,130,508,400,61,540,471,49,518,482,35,494,422,72,497,417,61,500,430,70,497,427,64
301110055.2,87,12,75,86,13,67,91,25,63,106,32,70,121,28,93,123,29,90,123,29,94,122,29,91
30075000005,130,17,113,130,20,105,131,37,91,124,35,87,141,25,116,143,29,113,145,29,116,143,25,117
30083000008,581,85,496,591,87,466,600,134,442,518,139,358,697,130,567,707,127,557,712,150,562,711,113,576
30089000001,297,69,228,297,61,224,302,105,184,336,95,229,406,78,328,414,87,318,416,90,326,415,82,328
30089000002,419,88,331,442,88,332,449,163,257,429,136,276,518,119,399,520,127,369,516,137,379,516,121,385
30089000007,666,117,549,679,132,493,687,241,413,667,215,429,831,198,633,834,189,600,829,237,592,836,192,633
30009000007,525,101,424,524,111,379,537,203,311,526,181,331,629,157,472,631,160,435,632,183,449,624,152,457
30029000023,814,249,565,827,233,519,842,386,403,816,368,426,988,329,659,1013,361,598,1016,382,634,1014,344,647
301110044.2,1971,506,1465,1977,627,1145,2041,1053,897,1908,944,890,2343,878,1465,2379,903,1348,2393,1029,1364,2399,881,1445
30029000089,490,89,401,503,82,396,507,157,318,507,138,347,591,121,470,591,125,446,592,146,446,595,120,467
301110050.1,1795,686,1109,1781,702,850,1842,1109,630,1702,1047,559,2013,1011,1002,2037,989,864,2041,1145,896,2043,994,961
301110049.1,1487,690,797,1496,726,584,1568,1016,464,1511,1053,406,1769,1052,717,1787,1007,631,1782,1140,642,1782,1031,667
3003100065B,2086,977,1109,2128,1072,770,2211,1337,787,2289,1546,684,3338,1965,1373,3440,2007,1286,3472,2187,1285,3468,2037,1306
30095000002,1127,207,920,1123,212,831,1154,439,674,1139,386,721,1334,286,1048,1344,326,979,1350,336,1014,1349,271,1054
30095000007,70,3,67,70,6,62,70,10,59,66,10,56,71,6,65,72,8,64,72,8,64,71,7,64
3003100069C,1479,365,1114,1468,362,1003,1525,568,894,1597,571,975,1961,532,1429,1994,554,1378,1997,605,1392,1991,527,1400
301110043.2,741,139,602,743,165,530,764,320,419,741,264,450,894,241,653,909,256,612,909,281,628,907,226,656
301110043.3,3160,854,2306,3148,927,1941,3244,1592,1520,3210,1488,1586,3822,1403,2419,3868,1444,2164,3879,1619,2260,3882,1364,2394
301110051.3,1780,523,1257,1784,613,984,1842,969,780,1652,836,731,2032,876,1156,2044,857,1057,2045,969,1076,2047,824,1157
30035000012,226,201,25,223,188,16,227,214,9,216,203,13,229,203,26,229,196,23,229,207,22,223,195,25
30049000020,1148,338,810,1141,392,633,1176,679,444,1176,612,506,1411,591,820,1414,615,727,1413,625,788,1414,519,843
30049000032,80,9,71,81,8,66,81,26,53,79,17,62,79,8,71,79,10,68,79,10,69,79,9,70
30035000001,465,105,360,472,108,321,485,200,274,396,160,215,472,109,363,470,107,336,472,140,332,470,108,352
30065000008,89,8,81,89,8,79,95,22,72,87,15,72,100,11,89,102,12,88,102,15,87,102,13,89
300630092Sw,330,71,259,335,88,236,338,123,203,323,103,209,400,111,289,404,117,277,405,122,283,409,111,293
30081000015,1117,262,855,1117,299,772,1141,452,660,1161,408,731,1365,388,977,1375,384,939,1384,441,943,1379,396,958
30063091RsE,1391,819,572,1392,984,330,1446,1101,319,1473,1153,290,1530,1165,365,1563,1203,335,1564,1239,325,1551,1198,322
30081000018,1010,245,765,999,262,680,1033,420,584,1102,395,675,1310,366,944,1327,377,905,1325,420,905,1313,359,928
30077000008,205,41,164,211,46,155,209,77,126,212,69,138,225,48,177,228,60,164,227,57,170,227,49,178
30081000010,1108,238,870,1103,284,745,1136,431,670,1114,388,694,1317,358,959,1331,373,919,1338,402,936,1333,362,942
30077000003,362,112,250,381,68,279,382,143,224,367,133,231,404,94,310,410,92,312,406,100,306,406,89,313
30081000011,1053,202,851,1052,248,744,1077,392,649,1100,398,677,1329,360,969,1338,363,940,1354,410,944,1338,360,949
30057000021,481,164,317,485,158,287,494,258,213,498,237,234,606,248,358,617,246,331,619,267,352,619,223,371
30063100SJE,1626,1149,477,1667,1293,237,1712,1446,218,1722,1526,173,1806,1523,283,1828,1520,262,1831,1570,261,1824,1528,257
3006300090W,2079,1094,985,2112,1361,594,2203,1599,546,2242,1714,489,2426,1740,686,2470,1778,631,2478,1852,626,2460,1778,627
3006300090R,516,295,221,532,307,149,549,374,139,505,373,114,553,393,160,565,381,152,567,415,152,569,386,161
30021000002,489,103,386,505,94,371,511,135,350,472,170,278,559,158,401,567,168,379,561,178,383,563,140,409
30079000003,149,16,133,154,19,134,156,30,119,137,36,94,155,31,124,157,34,118,156,32,124,159,27,129
30049000003,1083,266,817,1066,345,625,1106,638,449,1093,573,485,1248,519,729,1262,527,684,1262,570,692,1258,483,753
30049000007,1047,425,622,1023,573,362,1077,778,278,1106,759,328,1189,759,430,1213,789,386,1212,798,414,1207,738,435
30005000008,301,151,150,287,152,113,307,229,75,346,266,73,354,236,118,350,234,103,357,262,95,358,235,119
3010100Su-1,418,73,345,411,74,315,423,147,262,390,121,255,439,95,344,439,87,337,440,117,323,435,91,333
30049000017,1134,643,491,1145,784,268,1172,929,216,1168,925,219,1318,1022,296,1331,1023,267,1332,1051,281,1326,993,298
300630090CC,1262,523,739,1269,660,522,1318,818,462,1325,883,418,1470,871,599,1501,887,557,1506,964,542,1491,895,550
30063100SJW,2011,1452,559,2065,1511,333,2121,1797,259,2090,1833,234,2278,1912,366,2325,1937,319,2328,2011,317,2309,1925,345
30049000014,1092,682,410,1105,805,194,1138,955,149,1098,943,131,1217,1006,211,1233,997,189,1230,1037,193,1224,981,203
300630097PC,350,100,250,355,106,230,361,157,198,374,154,213,406,140,266,416,151,255,415,152,263,418,144,273
300630089LC,241,117,124,245,134,88,249,158,86,258,170,86,271,167,104,272,167,99,272,175,97,269,169,96
301110043.1,498,65,433,492,82,382,513,170,332,503,156,337,597,123,474,604,136,455,610,160,450,611,135,466
3009300012E,225,112,113,225,113,100,236,157,75,232,158,66,256,139,117,260,145,109,264,156,108,263,132,127
3009300009N,749,303,446,757,332,370,781,489,270,808,530,265,905,467,438,919,504,396,922,518,404,911,454,448
3003100065C,2444,1056,1388,2488,1205,1034,2595,1473,1042,2977,1886,1020,4349,2479,1870,4494,2540,1775,4509,2718,1791,4489,2573,1753
30075000009,53,9,44,60,15,43,57,16,39,48,12,36,53,11,42,54,11,42,55,13,42,55,13,42
30029000026,610,115,495,623,124,472,634,187,424,627,166,438,817,151,666,822,152,622,828,176,652,827,153,656
30019000005,284,49,235,292,58,212,299,96,188,295,101,185,303,79,224,304,80,220,310,88,222,309,72,233
3009300002W,551,292,259,557,290,207,566,422,123,531,401,107,572,356,216,584,370,189,578,393,185,579,334,225
30075000004,42,1,41,44,3,40,45,10,35,42,9,32,50,3,47,51,4,47,52,6,46,51,3,48
3009300019W,100,35,65,100,46,45,104,66,38,101,68,30,123,67,56,125,70,50,125,73,52,123,61,58
3009300012W,175,116,59,174,98,54,183,139,36,158,122,32,178,124,54,179,126,42,180,129,51,179,107,64
30075000008,23,2,21,23,2,21,23,4,19,19,2,17,23,3,20,23,4,19,23,5,18,23,3,20
30003000019,482,128,354,485,172,269,491,262,206,472,252,203,557,250,307,559,245,283,561,257,304,560,240,308
3001300019D,468,119,349,461,128,289,482,247,220,461,210,238,524,170,354,529,157,348,533,181,352,529,156,357
30095000013,838,153,685,859,187,615,862,324,511,882,293,559,1022,229,793,1044,259,755,1046,284,762,1044,243,782
30029000020,1566,759,807,1610,851,615,1644,1053,535,1786,1251,489,2020,1313,707,2051,1357,624,2079,1414,665,2069,1352,661
30029000047,1090,600,490,1147,669,367,1169,777,340,1215,885,318,1415,941,474,1446,959,447,1453,1002,451,1452,954,455
3001300020B,1305,304,1001,1321,456,799,1353,651,672,1391,660,704,1546,584,962,1570,581,948,1572,630,942,1554,560,970
30083000001,213,36,177,226,35,165,225,57,152,203,66,126,294,65,229,299,66,212,301,79,222,300,63,229
301110056.1,331,54,277,324,64,235,337,126,202,334,118,203,397,103,294,396,99,283,398,108,290,398,95,298
301110053.3,1079,182,897,1083,221,791,1107,398,680,1087,342,707,1264,286,978,1273,302,925,1276,334,942,1275,273,962
3003100067C,1649,463,1186,1674,427,1036,1734,745,909,1574,696,806,2447,895,1552,2528,909,1460,2541,1044,1497,2532,871,1545
30029000050,1049,180,869,1063,170,824,1077,364,646,1077,338,695,1366,299,1067,1379,308,1011,1379,346,1033,1391,281,1064
300670060CL,911,317,594,927,317,525,954,503,418,1019,512,481,1254,569,685,1272,597,623,1279,638,641,1273,577,655
30029000032,807,263,544,821,265,483,827,385,380,794,374,377,1022,410,612,1040,399,557,1035,448,587,1048,388,608
301110051.1,1168,410,758,1186,425,652,1209,697,437,1102,625,411,1398,614,784,1411,613,684,1413,713,700,1420,587,778
30093000004,1023,521,502,1015,570,356,1067,777,254,1065,791,250,1147,712,435,1168,753,380,1169,785,384,1153,663,459
3003100062B,1377,884,493,1436,956,302,1464,1096,314,1450,1147,273,1665,1271,394,1713,1275,365,1718,1334,384,1701,1259,374
3003100067A,1296,451,845,1308,484,715,1355,664,661,1392,693,662,1569,691,878,1601,686,878,1615,744,871,1603,712,859
30027000009,352,68,284,350,76,238,358,146,203,361,144,207,416,134,282,420,135,273,423,153,270,418,131,279
300670060FL,669,367,302,676,360,251,693,447,214,705,511,173,832,531,301,837,530,272,841,575,266,847,524,289
30085000022,182,63,119,190,57,116,189,85,95,187,99,83,232,110,122,235,114,106,235,127,108,235,111,113
30017000002,920,185,735,924,236,627,949,374,540,874,337,512,1054,301,753,1062,310,713,1063,361,702,1057,297,738
30017000010,28,2,26,30,2,26,29,3,26,25,5,20,32,4,28,32,3,27,32,4,28,32,2,27
300630092EM,834,420,414,839,421,316,874,585,235,925,635,253,1117,679,438,1131,687,355,1132,755,377,1138,676,410
30015000009,338,57,281,342,59,263,350,121,220,323,118,193,347,64,283,356,68,278,356,80,276,356,66,283
30041000028,442,416,26,437,406,8,453,437,13,533,527,5,495,465,30,497,451,28,499,475,24,494,458,25
30041000002,354,148,206,361,136,169,373,243,108,329,205,106,376,182,194,379,188,156,376,216,160,376,167,184
30073000027,576,106,470,574,125,409,596,274,303,559,215,323,645,162,483,654,150,480,659,211,448,661,162,484
30027000006,392,111,281,398,134,239,404,192,195,367,174,181,418,150,268,427,149,269,428,166,262,426,142,277
30027000013,523,87,436,507,125,352,537,229,299,512,188,308,585,166,419,588,169,399,594,184,410,591,163,417
30085000028,115,8,107,124,14,107,123,14,106,115,16,98,133,12,121,134,11,118,135,15,120,135,11,122
30043005-75,143,54,89,148,48,90,150,65,76,144,65,74,159,54,105,162,51,102,159,48,111,162,44,111
30087000006,385,77,308,389,70,300,397,159,229,380,133,231,445,81,364,446,85,336,451,96,355,452,80,361
30087000021,131,10,121,131,10,116,131,28,101,124,28,92,135,17,118,139,17,119,141,21,120,140,19,119
30029000002,817,305,512,839,318,451,859,432,367,821,407,387,1003,421,582,1021,424,531,1019,455,564,1021,411,575
30029000005,1111,239,872,1116,270,777,1141,419,670,1120,413,669,1380,395,985,1398,419,932,1399,464,935,1396,412,958
3009300010N,122,77,45,122,63,37,127,97,26,152,116,32,157,103,54,164,106,47,166,115,51,162,92,62
30009000010,413,205,208,424,221,161,433,288,128,443,314,113,522,311,211,532,322,188,533,345,188,527,322,191
30029000015,918,173,745,930,168,718,943,273,622,961,271,661,1215,246,969,1236,255,935,1240,288,952,1239,253,957
30003000009,137,92,45,130,97,28,141,114,21,174,144,28,163,122,41,163,116,38,162,128,34,163,119,43
3003100062A,1453,1025,428,1495,1109,248,1512,1232,248,1464,1240,193,1637,1340,297,1677,1348,265,1689,1409,280,1679,1377,261
301110044.3,1490,375,1115,1481,463,882,1540,744,757,1484,688,747,1765,676,1089,1789,719,990,1807,791,1016,1778,675,1050
30035000007,39,30,9,37,28,5,39,34,5,52,49,3,55,47,8,55,45,8,55,48,7,55,48,6
300630095Ha,1223,658,565,1254,707,405,1287,902,326,1340,953,349,1611,1090,521,1636,1088,482,1637,1162,475,1639,1080,516
3006300100S,799,485,314,820,482,229,838,610,186,857,681,162,1013,787,226,1038,768,215,1042,832,210,1033,783,218
30041000008,571,158,413,574,195,337,596,319,261,605,318,264,631,268,363,633,262,332,637,295,342,641,252,366
30081000021,534,132,402,540,137,361,551,207,321,527,191,315,727,210,517,736,195,506,736,218,518,740,198,524
300630099RS,1330,577,753,1321,710,494,1378,895,440,1385,934,420,1565,936,629,1591,965,569,1598,1030,568,1587,960,588
3006300097H,1025,335,690,1035,434,519,1063,565,465,1083,596,456,1266,557,709,1279,574,656,1286,639,647,1274,570,666
30097000001,453,81,372,460,85,343,468,175,277,437,161,258,525,136,389,526,130,357,529,151,378,525,124,379
30015000005,127,111,16,125,115,4,131,121,6,196,193,2,230,218,12,230,211,9,234,230,4,233,219,7
30049000019,767,186,581,767,211,487,788,400,357,756,369,359,932,335,597,938,348,540,937,393,544,939,307,589
3004700FER1,680,180,500,694,203,459,710,291,391,718,273,427,906,278,628,908,287,588,913,305,608,912,288,611
3006300090E,1347,716,631,1378,853,421,1410,975,404,1431,1022,389,1569,1092,477,1589,1108,445,1592,1128,464,1581,1113,442
3006300014S,222,60,162,217,72,129,228,116,100,245,115,127,251,94,157,250,87,148,252,97,155,252,92,155
3004700POL1,777,232,545,787,273,478,807,353,427,862,403,439,1064,414,650,1067,406,606,1062,451,611,1068,416,625
3004700BEA1,537,172,365,542,197,321,560,249,289,493,245,241,605,253,352,613,252,334,617,281,336,616,259,339
30049000015,827,275,552,828,332,413,863,522,299,793,447,312,1006,498,508,1011,478,479,1012,534,478,1002,450,516
300630099MH,1668,696,972,1694,900,652,1743,1128,574,1811,1202,562,1990,1212,778,2009,1237,708,2015,1316,699,2001,1219,735
30079000001,171,34,137,175,41,125,179,52,119,165,59,98,196,53,143,200,55,133,217,66,151,209,46,158
30093000018,606,337,269,604,312,230,619,453,137,563,424,125,662,415,247,666,408,199,664,454,210,660,381,255
30093000021,531,317,214,523,319,157,547,423,110,520,411,91,589,393,196,592,403,158,589,417,172,589,370,198
3009300010S,178,110,68,179,106,52,181,143,32,166,124,35,193,126,67,197,130,53,197,142,55,197,119,71
300130019B1,73,12,61,72,12,55,75,26,49,72,22,50,90,18,72,91,16,75,91,21,70,90,16,73
3002302-77W,343,193,150,346,185,123,358,269,72,306,223,72,364,225,139,367,219,119,363,240,123,370,208,147
3001300022C,53,11,42,53,12,27,55,19,30,32,16,13,39,13,26,41,10,30,41,13,28,41,11,29
30017000013,53,2,51,55,3,51,55,5,49,51,5,42,41,3,38,43,3,39,42,4,38,43,3,39
30091000004,471,113,358,501,131,337,508,208,268,487,183,284,519,143,376,519,166,325,519,162,357,527,151,362
30049000023,1100,243,857,1082,373,624,1125,597,510,1056,553,477,1269,556,713,1293,564,702,1291,588,703,1285,531,726
30049000004,987,227,760,980,319,565,1025,541,454,1130,580,521,1428,613,815,1453,637,757,1458,675,783,1447,590,807
30023002-78,67,38,29,68,35,25,68,50,11,74,52,14,88,50,38,86,59,23,89,65,24,87,49,33
30023003-78,116,61,55,116,66,47,117,85,32,131,90,40,141,87,54,141,80,57,142,94,48,143,76,66
3002303-77W,293,178,115,302,145,114,307,229,55,302,223,66,342,199,143,343,198,117,345,219,126,344,174,156
30029NAHD10,0,0,0,0,0,0,0,0,0,0,0,0,0,0,0,0,0,0,0,0,0,0,0,0
30087000007,45,13,32,46,13,30,48,18,28,48,24,24,71,21,50,71,20,51,71,23,48,71,19,48
30029000038,1679,411,1268,1682,462,1154,1733,654,1034,1838,666,1135,2230,696,1534,2246,713,1474,2247,755,1492,2250,704,1521
301110042.1,110,12,98,109,17,86,115,29,84,114,30,82,129,33,96,129,32,94,129,37,92,126,33,91
30077000016,131,45,86,139,34,89,140,57,77,148,69,76,150,41,109,152,44,98,151,49,102,153,45,105
3006300100N,1283,841,442,1319,900,271,1351,1063,231,1379,1156,194,1551,1212,339,1583,1241,277,1581,1281,300,1581,1215,325
3006300094F,1242,279,963,1254,350,814,1288,555,685,1242,519,692,1468,471,997,1484,490,950,1490,537,953,1488,490,976
30049000012,733,190,543,720,194,468,758,383,350,739,333,378,934,340,594,942,344,539,946,392,554,945,316,604
30049000027,1497,331,1166,1479,382,975,1534,756,735,1516,688,767,1917,667,1250,1945,707,1155,1939,734,1205,1942,610,1276
30027000010,320,84,236,320,91,207,336,150,166,333,152,168,371,126,245,380,132,226,379,150,229,380,126,239
3009300019S,215,117,98,210,113,83,225,156,61,222,165,54,260,146,114,263,160,99,272,172,100,267,139,121
30007000007,485,91,394,479,105,334,501,220,261,506,185,307,621,162,459,626,160,442,626,171,455,620,146,452
30003000004,76,8,68,77,13,60,77,28,45,80,25,55,89,20,69,88,18,69,90,21,69,91,19,70
30029000034,1436,293,1143,1437,331,1037,1466,482,950,1489,515,942,1772,471,1301,1798,496,1250,1807,540,1267,1795,492,1282
3004700SWA1,89,11,78,91,18,72,91,31,58,90,24,66,102,30,72,103,32,71,102,29,73,103,32,71
30027000012,94,9,85,91,15,65,97,19,76,95,26,67,101,14,87,104,16,87,105,18,87,105,17,85
30005000009,166,131,35,160,126,12,166,148,14,194,186,7,190,170,20,189,164,16,187,171,16,188,156,27
300630096SM,233,57,176,234,67,145,239,113,112,226,104,119,344,125,219,352,137,194,355,152,203,358,127,216
3009300002E,474,247,227,482,256,185,496,357,121,508,381,113,578,351,227,583,361,191,585,400,185,581,315,250
30083000002,347,60,287,361,57,286,362,92,245,319,97,202,438,81,357,441,87,328,443,92,351,448,70,366
3003500021C,279,234,45,268,236,21,279,259,15,286,269,17,288,256,32,288,240,28,292,262,30,284,238,43
30097000002,425,87,338,416,108,281,429,175,238,397,151,227,458,130,328,459,129,310,462,147,315,460,130,317
3006300014N,203,51,152,212,58,142,211,88,110,198,84,113,235,75,160,240,80,152,241,84,157,244,79,158
301110054.2,881,165,716,871,200,616,913,361,526,907,340,548,1017,271,746,1029,285,709,1034,324,710,1026,271,729
30049000009,1336,541,795,1323,758,445,1378,936,425,1347,935,387,1464,965,499,1481,979,466,1483,993,490,1468,946,486
30081000014,287,5,282,236,3,212,285,24,250,297,16,268,387,10,377,391,10,358,388,17,371,389,14,367
30017000012,27,1,26,27,1,26,27,6,21,22,3,19,26,2,24,26,1,25,26,2,24,26,1,25
30035000013,227,190,37,230,199,21,234,208,17,221,212,8,214,191,23,216,187,22,216,193,23,215,182,27
3006300089B,140,38,102,130,57,65,143,72,68,180,105,74,213,105,108,213,104,103,214,109,105,207,112,93
30015000001,454,107,347,457,135,285,481,262,205,462,231,218,543,206,337,547,209,310,549,222,327,543,189,337
30001000007,290,36,254,289,40,231,298,93,199,293,78,207,319,78,241,321,74,239,320,89,231,318,76,239
30003000017,337,88,249,335,116,200,344,198,132,364,199,153,400,167,233,398,158,217,403,186,217,400,168,225
3004700POL7,460,144,316,478,170,290,487,248,230,501,243,249,587,237,350,590,237,325,596,261,335,590,236,342
3009300009W,70,36,34,66,38,17,73,58,14,77,58,18,78,48,30,78,53,24,78,52,26,77,45,29
300630094SM,645,147,498,637,165,435,661,282,348,674,260,393,908,271,637,917,280,592,921,309,612,926,276,630
3004700BEA2,130,36,94,130,49,75,134,54,76,140,61,74,168,71,97,171,73,97,170,78,92,171,75,93
3004700POL8,27,10,17,26,10,15,28,13,15,27,10,16,33,13,20,34,13,21,34,15,19,34,15,19
301110040.5,192,28,164,191,28,150,196,53,141,181,43,134,233,28,205,235,32,193,236,36,200,236,31,202
30001000009,412,67,345,411,87,300,419,159,248,433,158,264,483,126,357,484,123,345,487,145,342,481,121,355
30093000001,213,112,101,212,104,86,218,159,47,179,128,43,216,123,93,219,129,75,218,143,75,219,108,103
